Transcript for tournament #1597684053 requested by JJin91 (jamiejin91@g=
mail.com)

*********** # 1 **************
PokerStars Hand #169474662145: Tournament #1597684053, $13.50+$1.50 USD=
 Hold'em No Limit - Level III (40/80) - 2017/05/06 13:52:05 ET
Table '1597684053 5' 6-max Seat #5 is the button
Seat 1: MyManPotnPan (19530 in chips)=20
Seat 2: DaMiJKoNtRoL (10250 in chips)=20
Seat 3: JJin91 (10000 in chips)=20
Seat 4: catman0926 (5485 in chips)=20
Seat 5: Ninja Stax (31855 in chips)=20
Seat 6: mojorisin22 (12515 in chips)=20
mojorisin22: posts small blind 40
MyManPotnPan: posts big blind 80
*** HOLE CARDS ***
Dealt to JJin91 [2h Kc]
DaMiJKoNtRoL: calls 80
JJin91: folds=20
catman0926: raises 80 to 160
Ninja Stax: calls 160
mojorisin22: folds=20
MyManPotnPan: folds=20
DaMiJKoNtRoL: calls 80
*** FLOP *** [3d 4c Ts]
DaMiJKoNtRoL: checks=20
catman0926: bets 80
Ninja Stax: folds=20
DaMiJKoNtRoL: folds=20
Uncalled bet (80) returned to catman0926
catman0926 collected 600 from pot
catman0926: doesn't show hand=20
*** SUMMARY ***
Total pot 600 | Rake 0=20
Board [3d 4c Ts]
Seat 1: MyManPotnPan (big blind) folded before Flop
Seat 2: DaMiJKoNtRoL folded on the Flop
Seat 3: JJin91 folded before Flop (didn't bet)
Seat 4: catman0926 collected (600)
Seat 5: Ninja Stax (button) folded on the Flop
Seat 6: mojorisin22 (small blind) folded before Flop


*********** # 2 **************
PokerStars Hand #169474662233: Tournament #1597684053, $13.50+$1.50 USD=
 Hold'em No Limit - Level III (40/80) - 2017/05/06 13:52:40 ET
Table '1597684053 5' 6-max Seat #6 is the button
Seat 1: MyManPotnPan (19450 in chips)=20
Seat 2: DaMiJKoNtRoL (10090 in chips)=20
Seat 3: JJin91 (10000 in chips)=20
Seat 4: catman0926 (5925 in chips)=20
Seat 5: Ninja Stax (31695 in chips)=20
Seat 6: mojorisin22 (12475 in chips)=20
MyManPotnPan: posts small blind 40
DaMiJKoNtRoL: posts big blind 80
*** HOLE CARDS ***
Dealt to JJin91 [5d 3s]
JJin91: folds=20
catman0926: raises 80 to 160
Ninja Stax: folds=20
mojorisin22: calls 160
MyManPotnPan: folds=20
DaMiJKoNtRoL: calls 80
*** FLOP *** [Th 8h Jc]
DaMiJKoNtRoL: checks=20
catman0926: bets 520
mojorisin22: calls 520
DaMiJKoNtRoL: folds=20
*** TURN *** [Th 8h Jc] [2h]
catman0926: bets 1560
mojorisin22: folds=20
Uncalled bet (1560) returned to catman0926
catman0926 collected 1560 from pot
catman0926: doesn't show hand=20
*** SUMMARY ***
Total pot 1560 | Rake 0=20
Board [Th 8h Jc 2h]
Seat 1: MyManPotnPan (small blind) folded before Flop
Seat 2: DaMiJKoNtRoL (big blind) folded on the Flop
Seat 3: JJin91 folded before Flop (didn't bet)
Seat 4: catman0926 collected (1560)
Seat 5: Ninja Stax folded before Flop (didn't bet)
Seat 6: mojorisin22 (button) folded on the Turn


*********** # 3 **************
PokerStars Hand #169474662322: Tournament #1597684053, $13.50+$1.50 USD=
 Hold'em No Limit - Level III (40/80) - 2017/05/06 13:53:18 ET
Table '1597684053 5' 6-max Seat #1 is the button
Seat 1: MyManPotnPan (19410 in chips)=20
Seat 2: DaMiJKoNtRoL (9930 in chips)=20
Seat 3: JJin91 (10000 in chips)=20
Seat 4: catman0926 (6805 in chips)=20
Seat 5: Ninja Stax (31695 in chips)=20
Seat 6: mojorisin22 (11795 in chips)=20
DaMiJKoNtRoL: posts small blind 40
JJin91: posts big blind 80
*** HOLE CARDS ***
Dealt to JJin91 [7h 8s]
catman0926: raises 80 to 160
Ninja Stax: folds=20
mojorisin22: folds=20
MyManPotnPan: folds=20
DaMiJKoNtRoL: folds=20
JJin91: calls 80
*** FLOP *** [8c 7c As]
JJin91: checks=20
catman0926: bets 80
JJin91: calls 80
*** TURN *** [8c 7c As] [Ah]
JJin91: checks=20
catman0926: bets 520
JJin91: folds=20
Uncalled bet (520) returned to catman0926
catman0926 collected 520 from pot
*** SUMMARY ***
Total pot 520 | Rake 0=20
Board [8c 7c As Ah]
Seat 1: MyManPotnPan (button) folded before Flop (didn't bet)
Seat 2: DaMiJKoNtRoL (small blind) folded before Flop
Seat 3: JJin91 (big blind) folded on the Turn
Seat 4: catman0926 collected (520)
Seat 5: Ninja Stax folded before Flop (didn't bet)
Seat 6: mojorisin22 folded before Flop (didn't bet)


*********** # 4 **************
PokerStars Hand #169474662448: Tournament #1597684053, $13.50+$1.50 USD=
 Hold'em No Limit - Level III (40/80) - 2017/05/06 13:54:00 ET
Table '1597684053 5' 6-max Seat #2 is the button
Seat 1: MyManPotnPan (19410 in chips)=20
Seat 2: DaMiJKoNtRoL (9890 in chips)=20
Seat 3: JJin91 (9760 in chips)=20
Seat 5: Ninja Stax (31695 in chips)=20
Seat 6: mojorisin22 (11795 in chips)=20
JJin91: posts small blind 40
Ninja Stax: posts big blind 80
*** HOLE CARDS ***
Dealt to JJin91 [Td Kc]
mojorisin22: calls 80
MyManPotnPan: folds=20
DaMiJKoNtRoL: calls 80
JJin91: calls 40
Ninja Stax: checks=20
*** FLOP *** [6h Qc 3c]
JJin91: checks=20
Ninja Stax: checks=20
mojorisin22: bets 150
DaMiJKoNtRoL: calls 150
JJin91: folds=20
Ninja Stax: folds=20
*** TURN *** [6h Qc 3c] [7d]
mojorisin22: bets 175
DaMiJKoNtRoL: calls 175
*** RIVER *** [6h Qc 3c 7d] [2d]
mojorisin22: checks=20
DaMiJKoNtRoL: bets 485
mojorisin22: calls 485
*** SHOW DOWN ***
DaMiJKoNtRoL: shows [Qh 8h] (a pair of Queens)
mojorisin22: mucks hand=20
DaMiJKoNtRoL collected 1940 from pot
*** SUMMARY ***
Total pot 1940 | Rake 0=20
Board [6h Qc 3c 7d 2d]
Seat 1: MyManPotnPan folded before Flop (didn't bet)
Seat 2: DaMiJKoNtRoL (button) showed [Qh 8h] and won (1940) with a pair=
 of Queens
Seat 3: JJin91 (small blind) folded on the Flop
Seat 5: Ninja Stax (big blind) folded on the Flop
Seat 6: mojorisin22 mucked [5c 6s]


*********** # 5 **************
PokerStars Hand #169474663575: Tournament #1597684053, $13.50+$1.50 USD=
 Hold'em No Limit - Level III (40/80) - 2017/05/06 14:01:00 ET
Table '1597684053 5' 6-max Seat #3 is the button
Seat 1: MyManPotnPan (19410 in chips)=20
Seat 2: DaMiJKoNtRoL (10940 in chips)=20
Seat 3: JJin91 (9680 in chips)=20
Seat 5: Ninja Stax (31615 in chips)=20
Seat 6: mojorisin22 (10905 in chips)=20
Ninja Stax: posts small blind 40
mojorisin22: posts big blind 80
*** HOLE CARDS ***
Dealt to JJin91 [3d Kc]
MyManPotnPan: folds=20
DaMiJKoNtRoL: folds=20
JJin91: folds=20
Ninja Stax: calls 40
mojorisin22: checks=20
*** FLOP *** [2s 6c 8s]
Ninja Stax: checks=20
mojorisin22: bets 160
Ninja Stax: folds=20
Uncalled bet (160) returned to mojorisin22
mojorisin22 collected 160 from pot
mojorisin22: doesn't show hand=20
*** SUMMARY ***
Total pot 160 | Rake 0=20
Board [2s 6c 8s]
Seat 1: MyManPotnPan folded before Flop (didn't bet)
Seat 2: DaMiJKoNtRoL folded before Flop (didn't bet)
Seat 3: JJin91 (button) folded before Flop (didn't bet)
Seat 5: Ninja Stax (small blind) folded on the Flop
Seat 6: mojorisin22 (big blind) collected (160)


*********** # 6 **************
PokerStars Hand #169474663761: Tournament #1597684053, $13.50+$1.50 USD=
 Hold'em No Limit - Level III (40/80) - 2017/05/06 14:02:10 ET
Table '1597684053 5' 6-max Seat #5 is the button
Seat 1: MyManPotnPan (19410 in chips)=20
Seat 2: DaMiJKoNtRoL (10940 in chips)=20
Seat 3: JJin91 (9680 in chips)=20
Seat 5: Ninja Stax (31535 in chips)=20
Seat 6: mojorisin22 (10985 in chips)=20
mojorisin22: posts small blind 40
MyManPotnPan: posts big blind 80
*** HOLE CARDS ***
Dealt to JJin91 [2d 2s]
DaMiJKoNtRoL: folds=20
JJin91: raises 95 to 175
Ninja Stax: calls 175
mojorisin22: calls 135
MyManPotnPan: calls 95
*** FLOP *** [7s Js 8d]
mojorisin22: checks=20
MyManPotnPan: bets 350
JJin91: folds=20
Ninja Stax: calls 350
mojorisin22: calls 350
*** TURN *** [7s Js 8d] [9h]
mojorisin22: checks=20
MyManPotnPan: checks=20
Ninja Stax: checks=20
*** RIVER *** [7s Js 8d 9h] [Qs]
mojorisin22: checks=20
MyManPotnPan: checks=20
Ninja Stax: checks=20
*** SHOW DOWN ***
mojorisin22: shows [8s 7d] (two pair, Eights and Sevens)
MyManPotnPan: mucks hand=20
Ninja Stax: mucks hand=20
mojorisin22 collected 1750 from pot
*** SUMMARY ***
Total pot 1750 | Rake 0=20
Board [7s Js 8d 9h Qs]
Seat 1: MyManPotnPan (big blind) mucked [Kd Jd]
Seat 2: DaMiJKoNtRoL folded before Flop (didn't bet)
Seat 3: JJin91 folded on the Flop
Seat 5: Ninja Stax (button) mucked [5h 8h]
Seat 6: mojorisin22 (small blind) showed [8s 7d] and won (1750) with tw=
o pair, Eights and Sevens


*********** # 7 **************
PokerStars Hand #169474663946: Tournament #1597684053, $13.50+$1.50 USD=
 Hold'em No Limit - Level III (40/80) - 2017/05/06 14:03:20 ET
Table '1597684053 5' 6-max Seat #6 is the button
Seat 1: MyManPotnPan (18885 in chips)=20
Seat 2: DaMiJKoNtRoL (10940 in chips)=20
Seat 3: JJin91 (9505 in chips)=20
Seat 5: Ninja Stax (31010 in chips)=20
Seat 6: mojorisin22 (12210 in chips)=20
MyManPotnPan: posts small blind 40
DaMiJKoNtRoL: posts big blind 80
*** HOLE CARDS ***
Dealt to JJin91 [Qs 2h]
JJin91: folds=20
Ninja Stax: folds=20
mojorisin22: folds=20
MyManPotnPan: calls 40
DaMiJKoNtRoL: checks=20
*** FLOP *** [2d 4d Kd]
MyManPotnPan: checks=20
DaMiJKoNtRoL: checks=20
*** TURN *** [2d 4d Kd] [4h]
MyManPotnPan: checks=20
DaMiJKoNtRoL: checks=20
*** RIVER *** [2d 4d Kd 4h] [8s]
MyManPotnPan: checks=20
DaMiJKoNtRoL: checks=20
*** SHOW DOWN ***
MyManPotnPan: shows [6h 5s] (a pair of Fours)
DaMiJKoNtRoL: shows [Td 6c] (a pair of Fours - King+Ten kicker)
DaMiJKoNtRoL collected 160 from pot
*** SUMMARY ***
Total pot 160 | Rake 0=20
Board [2d 4d Kd 4h 8s]
Seat 1: MyManPotnPan (small blind) showed [6h 5s] and lost with a pair =
of Fours
Seat 2: DaMiJKoNtRoL (big blind) showed [Td 6c] and won (160) with a pa=
ir of Fours
Seat 3: JJin91 folded before Flop (didn't bet)
Seat 5: Ninja Stax folded before Flop (didn't bet)
Seat 6: mojorisin22 (button) folded before Flop (didn't bet)


*********** # 8 **************
PokerStars Hand #169474664045: Tournament #1597684053, $13.50+$1.50 USD=
 Hold'em No Limit - Level III (40/80) - 2017/05/06 14:03:55 ET
Table '1597684053 5' 6-max Seat #1 is the button
Seat 1: MyManPotnPan (18805 in chips)=20
Seat 2: DaMiJKoNtRoL (11020 in chips)=20
Seat 3: JJin91 (9505 in chips)=20
Seat 5: Ninja Stax (31010 in chips)=20
Seat 6: mojorisin22 (12210 in chips)=20
DaMiJKoNtRoL: posts small blind 40
JJin91: posts big blind 80
*** HOLE CARDS ***
Dealt to JJin91 [Ts 4s]
Ninja Stax: folds=20
DaMiJKoNtRoL said, "z"
mojorisin22: raises 145 to 225
MyManPotnPan: folds=20
DaMiJKoNtRoL: folds=20
JJin91: folds=20
Uncalled bet (145) returned to mojorisin22
mojorisin22 collected 200 from pot
mojorisin22: doesn't show hand=20
*** SUMMARY ***
Total pot 200 | Rake 0=20
Seat 1: MyManPotnPan (button) folded before Flop (didn't bet)
Seat 2: DaMiJKoNtRoL (small blind) folded before Flop
Seat 3: JJin91 (big blind) folded before Flop
Seat 5: Ninja Stax folded before Flop (didn't bet)
Seat 6: mojorisin22 collected (200)


*********** # 9 **************
PokerStars Hand #169474664144: Tournament #1597684053, $13.50+$1.50 USD=
 Hold'em No Limit - Level III (40/80) - 2017/05/06 14:04:27 ET
Table '1597684053 5' 6-max Seat #2 is the button
Seat 1: MyManPotnPan (18805 in chips)=20
Seat 2: DaMiJKoNtRoL (10980 in chips)=20
Seat 3: JJin91 (9425 in chips)=20
Seat 5: Ninja Stax (31010 in chips)=20
Seat 6: mojorisin22 (12330 in chips)=20
JJin91: posts small blind 40
Ninja Stax: posts big blind 80
*** HOLE CARDS ***
Dealt to JJin91 [6d Ac]
mojorisin22: folds=20
MyManPotnPan: folds=20
DaMiJKoNtRoL: folds=20
JJin91: raises 160 to 240
Ninja Stax: folds=20
Uncalled bet (160) returned to JJin91
JJin91 collected 160 from pot
JJin91: doesn't show hand=20
*** SUMMARY ***
Total pot 160 | Rake 0=20
Seat 1: MyManPotnPan folded before Flop (didn't bet)
Seat 2: DaMiJKoNtRoL (button) folded before Flop (didn't bet)
Seat 3: JJin91 (small blind) collected (160)
Seat 5: Ninja Stax (big blind) folded before Flop
Seat 6: mojorisin22 folded before Flop (didn't bet)


*********** # 10 **************
PokerStars Hand #169474664184: Tournament #1597684053, $13.50+$1.50 USD=
 Hold'em No Limit - Level III (40/80) - 2017/05/06 14:04:42 ET
Table '1597684053 5' 6-max Seat #3 is the button
Seat 1: MyManPotnPan (18805 in chips)=20
Seat 2: DaMiJKoNtRoL (10980 in chips)=20
Seat 3: JJin91 (9505 in chips)=20
Seat 5: Ninja Stax (30930 in chips)=20
Seat 6: mojorisin22 (12330 in chips)=20
Ninja Stax: posts small blind 40
mojorisin22: posts big blind 80
*** HOLE CARDS ***
Dealt to JJin91 [3h Js]
MyManPotnPan: calls 80
DaMiJKoNtRoL: folds=20
JJin91: folds=20
Ninja Stax: folds=20
mojorisin22: checks=20
*** FLOP *** [6c Kh 8c]
mojorisin22: checks=20
MyManPotnPan: bets 160
mojorisin22: folds=20
Uncalled bet (160) returned to MyManPotnPan
MyManPotnPan collected 200 from pot
MyManPotnPan: doesn't show hand=20
*** SUMMARY ***
Total pot 200 | Rake 0=20
Board [6c Kh 8c]
Seat 1: MyManPotnPan collected (200)
Seat 2: DaMiJKoNtRoL folded before Flop (didn't bet)
Seat 3: JJin91 (button) folded before Flop (didn't bet)
Seat 5: Ninja Stax (small blind) folded before Flop
Seat 6: mojorisin22 (big blind) folded on the Flop


*********** # 11 **************
PokerStars Hand #169474664271: Tournament #1597684053, $13.50+$1.50 USD=
 Hold'em No Limit - Level III (40/80) - 2017/05/06 14:05:17 ET
Table '1597684053 5' 6-max Seat #5 is the button
Seat 1: MyManPotnPan (18925 in chips)=20
Seat 2: DaMiJKoNtRoL (10980 in chips)=20
Seat 3: JJin91 (9505 in chips)=20
Seat 5: Ninja Stax (30890 in chips)=20
Seat 6: mojorisin22 (12250 in chips)=20
mojorisin22: posts small blind 40
MyManPotnPan: posts big blind 80
*** HOLE CARDS ***
Dealt to JJin91 [Js As]
DaMiJKoNtRoL: calls 80
JJin91: raises 240 to 320
Ninja Stax: folds=20
mojorisin22: calls 280
MyManPotnPan: calls 240
DaMiJKoNtRoL: calls 240
*** FLOP *** [Jh 5s 7s]
mojorisin22: checks=20
MyManPotnPan: checks=20
DaMiJKoNtRoL: checks=20
JJin91: bets 678
mojorisin22: folds=20
MyManPotnPan: folds=20
DaMiJKoNtRoL: folds=20
Uncalled bet (678) returned to JJin91
JJin91 collected 1280 from pot
JJin91: doesn't show hand=20
*** SUMMARY ***
Total pot 1280 | Rake 0=20
Board [Jh 5s 7s]
Seat 1: MyManPotnPan (big blind) folded on the Flop
Seat 2: DaMiJKoNtRoL folded on the Flop
Seat 3: JJin91 collected (1280)
Seat 5: Ninja Stax (button) folded before Flop (didn't bet)
Seat 6: mojorisin22 (small blind) folded on the Flop


*********** # 12 **************
PokerStars Hand #169474664402: Tournament #1597684053, $13.50+$1.50 USD=
 Hold'em No Limit - Level IV (50/100) - 2017/05/06 14:06:11 ET
Table '1597684053 5' 6-max Seat #6 is the button
Seat 1: MyManPotnPan (18605 in chips)=20
Seat 2: DaMiJKoNtRoL (10660 in chips)=20
Seat 3: JJin91 (10465 in chips)=20
Seat 5: Ninja Stax (30890 in chips)=20
Seat 6: mojorisin22 (11930 in chips)=20
MyManPotnPan: posts the ante 10
DaMiJKoNtRoL: posts the ante 10
JJin91: posts the ante 10
Ninja Stax: posts the ante 10
mojorisin22: posts the ante 10
MyManPotnPan: posts small blind 50
DaMiJKoNtRoL: posts big blind 100
*** HOLE CARDS ***
Dealt to JJin91 [4s Js]
JJin91: folds=20
Ninja Stax: calls 100
mojorisin22: folds=20
MyManPotnPan: calls 50
DaMiJKoNtRoL: checks=20
*** FLOP *** [Th 7s 7c]
MyManPotnPan: checks=20
DaMiJKoNtRoL: checks=20
Ninja Stax: bets 100
MyManPotnPan: folds=20
DaMiJKoNtRoL: folds=20
Uncalled bet (100) returned to Ninja Stax
Ninja Stax collected 350 from pot
Ninja Stax: doesn't show hand=20
*** SUMMARY ***
Total pot 350 | Rake 0=20
Board [Th 7s 7c]
Seat 1: MyManPotnPan (small blind) folded on the Flop
Seat 2: DaMiJKoNtRoL (big blind) folded on the Flop
Seat 3: JJin91 folded before Flop (didn't bet)
Seat 5: Ninja Stax collected (350)
Seat 6: mojorisin22 (button) folded before Flop (didn't bet)


*********** # 13 **************
PokerStars Hand #169474664564: Tournament #1597684053, $13.50+$1.50 USD=
 Hold'em No Limit - Level IV (50/100) - 2017/05/06 14:07:09 ET
Table '1597684053 5' 6-max Seat #1 is the button
Seat 1: MyManPotnPan (18495 in chips)=20
Seat 2: DaMiJKoNtRoL (10550 in chips)=20
Seat 3: JJin91 (10455 in chips)=20
Seat 5: Ninja Stax (31130 in chips)=20
Seat 6: mojorisin22 (11920 in chips)=20
MyManPotnPan: posts the ante 10
DaMiJKoNtRoL: posts the ante 10
JJin91: posts the ante 10
Ninja Stax: posts the ante 10
mojorisin22: posts the ante 10
DaMiJKoNtRoL: posts small blind 50
JJin91: posts big blind 100
*** HOLE CARDS ***
Dealt to JJin91 [Js 5d]
Ninja Stax: calls 100
mojorisin22: calls 100
MyManPotnPan: folds=20
DaMiJKoNtRoL: calls 50
JJin91: checks=20
*** FLOP *** [Tc 9d 3h]
DaMiJKoNtRoL: checks=20
JJin91: checks=20
Ninja Stax: bets 200
mojorisin22: raises 300 to 500
DaMiJKoNtRoL: folds=20
JJin91: folds=20
Ninja Stax: calls 300
*** TURN *** [Tc 9d 3h] [7s]
Ninja Stax: checks=20
mojorisin22: bets 725
Ninja Stax: folds=20
Uncalled bet (725) returned to mojorisin22
mojorisin22 collected 1450 from pot
mojorisin22: doesn't show hand=20
*** SUMMARY ***
Total pot 1450 | Rake 0=20
Board [Tc 9d 3h 7s]
Seat 1: MyManPotnPan (button) folded before Flop (didn't bet)
Seat 2: DaMiJKoNtRoL (small blind) folded on the Flop
Seat 3: JJin91 (big blind) folded on the Flop
Seat 5: Ninja Stax folded on the Turn
Seat 6: mojorisin22 collected (1450)


*********** # 14 **************
PokerStars Hand #169474664758: Tournament #1597684053, $13.50+$1.50 USD=
 Hold'em No Limit - Level IV (50/100) - 2017/05/06 14:08:20 ET
Table '1597684053 5' 6-max Seat #2 is the button
Seat 1: MyManPotnPan (18485 in chips)=20
Seat 2: DaMiJKoNtRoL (10440 in chips)=20
Seat 3: JJin91 (10345 in chips)=20
Seat 5: Ninja Stax (30520 in chips)=20
Seat 6: mojorisin22 (12760 in chips)=20
MyManPotnPan: posts the ante 10
DaMiJKoNtRoL: posts the ante 10
JJin91: posts the ante 10
Ninja Stax: posts the ante 10
mojorisin22: posts the ante 10
JJin91: posts small blind 50
Ninja Stax: posts big blind 100
*** HOLE CARDS ***
Dealt to JJin91 [Jh Ts]
mojorisin22: calls 100
MyManPotnPan: folds=20
DaMiJKoNtRoL: folds=20
JJin91: calls 50
Ninja Stax: checks=20
*** FLOP *** [2c 4s Qd]
JJin91: bets 186
Ninja Stax: folds=20
mojorisin22: folds=20
Uncalled bet (186) returned to JJin91
JJin91 collected 350 from pot
JJin91: doesn't show hand=20
Ninja Stax is sitting out
*** SUMMARY ***
Total pot 350 | Rake 0=20
Board [2c 4s Qd]
Seat 1: MyManPotnPan folded before Flop (didn't bet)
Seat 2: DaMiJKoNtRoL (button) folded before Flop (didn't bet)
Seat 3: JJin91 (small blind) collected (350)
Seat 5: Ninja Stax (big blind) folded on the Flop
Seat 6: mojorisin22 folded on the Flop


*********** # 15 **************
PokerStars Hand #169474664896: Tournament #1597684053, $13.50+$1.50 USD=
 Hold'em No Limit - Level IV (50/100) - 2017/05/06 14:09:17 ET
Table '1597684053 5' 6-max Seat #3 is the button
Seat 1: MyManPotnPan (18475 in chips)=20
Seat 2: DaMiJKoNtRoL (10430 in chips)=20
Seat 3: JJin91 (10585 in chips)=20
Seat 4: skonnybobo (10000 in chips) out of hand (moved from another tab=
le into small blind)
Seat 5: Ninja Stax (30410 in chips) is sitting out
MyManPotnPan: posts the ante 10
DaMiJKoNtRoL: posts the ante 10
JJin91: posts the ante 10
Ninja Stax: posts the ante 10
Ninja Stax: posts small blind 50
MyManPotnPan: posts big blind 100
*** HOLE CARDS ***
Dealt to JJin91 [Tc Ad]
DaMiJKoNtRoL: folds=20
JJin91: raises 200 to 300
Ninja Stax: folds=20
MyManPotnPan: folds=20
Uncalled bet (200) returned to JJin91
JJin91 collected 290 from pot
JJin91: doesn't show hand=20
*** SUMMARY ***
Total pot 290 | Rake 0=20
Seat 1: MyManPotnPan (big blind) folded before Flop
Seat 2: DaMiJKoNtRoL folded before Flop (didn't bet)
Seat 3: JJin91 (button) collected (290)
Seat 5: Ninja Stax (small blind) folded before Flop


*********** # 16 **************
PokerStars Hand #169474664957: Tournament #1597684053, $13.50+$1.50 USD=
 Hold'em No Limit - Level IV (50/100) - 2017/05/06 14:09:40 ET
Table '1597684053 5' 6-max Seat #5 is the button
Seat 1: MyManPotnPan (18365 in chips)=20
Seat 2: DaMiJKoNtRoL (10420 in chips)=20
Seat 3: JJin91 (10765 in chips)=20
Seat 4: skonnybobo (10000 in chips)=20
Seat 5: Ninja Stax (30350 in chips) is sitting out
MyManPotnPan: posts the ante 10
DaMiJKoNtRoL: posts the ante 10
JJin91: posts the ante 10
skonnybobo: posts the ante 10
Ninja Stax: posts the ante 10
MyManPotnPan: posts small blind 50
DaMiJKoNtRoL: posts big blind 100
*** HOLE CARDS ***
Dealt to JJin91 [4c Td]
JJin91: folds=20
skonnybobo: folds=20
Ninja Stax: folds=20
MyManPotnPan: folds=20
Uncalled bet (50) returned to DaMiJKoNtRoL
DaMiJKoNtRoL collected 150 from pot
DaMiJKoNtRoL: doesn't show hand=20
*** SUMMARY ***
Total pot 150 | Rake 0=20
Seat 1: MyManPotnPan (small blind) folded before Flop
Seat 2: DaMiJKoNtRoL (big blind) collected (150)
Seat 3: JJin91 folded before Flop (didn't bet)
Seat 4: skonnybobo folded before Flop (didn't bet)
Seat 5: Ninja Stax (button) folded before Flop (didn't bet)


*********** # 17 **************
PokerStars Hand #169474665014: Tournament #1597684053, $13.50+$1.50 USD=
 Hold'em No Limit - Level IV (50/100) - 2017/05/06 14:10:04 ET
Table '1597684053 5' 6-max Seat #1 is the button
Seat 1: MyManPotnPan (18305 in chips)=20
Seat 2: DaMiJKoNtRoL (10510 in chips)=20
Seat 3: JJin91 (10755 in chips)=20
Seat 4: skonnybobo (9990 in chips)=20
Seat 5: Ninja Stax (30340 in chips) is sitting out
MyManPotnPan: posts the ante 10
DaMiJKoNtRoL: posts the ante 10
JJin91: posts the ante 10
skonnybobo: posts the ante 10
Ninja Stax: posts the ante 10
DaMiJKoNtRoL: posts small blind 50
JJin91: posts big blind 100
*** HOLE CARDS ***
Dealt to JJin91 [9h Ts]
skonnybobo: folds=20
Ninja Stax: folds=20
MyManPotnPan: folds=20
DaMiJKoNtRoL: folds=20
Uncalled bet (50) returned to JJin91
JJin91 collected 150 from pot
JJin91: doesn't show hand=20
*** SUMMARY ***
Total pot 150 | Rake 0=20
Seat 1: MyManPotnPan (button) folded before Flop (didn't bet)
Seat 2: DaMiJKoNtRoL (small blind) folded before Flop
Seat 3: JJin91 (big blind) collected (150)
Seat 4: skonnybobo folded before Flop (didn't bet)
Seat 5: Ninja Stax folded before Flop (didn't bet)


*********** # 18 **************
PokerStars Hand #169474665044: Tournament #1597684053, $13.50+$1.50 USD=
 Hold'em No Limit - Level IV (50/100) - 2017/05/06 14:10:14 ET
Table '1597684053 5' 6-max Seat #2 is the button
Seat 1: MyManPotnPan (18295 in chips)=20
Seat 2: DaMiJKoNtRoL (10450 in chips)=20
Seat 3: JJin91 (10845 in chips)=20
Seat 4: skonnybobo (9980 in chips)=20
Seat 5: Ninja Stax (30330 in chips) is sitting out
MyManPotnPan: posts the ante 10
DaMiJKoNtRoL: posts the ante 10
JJin91: posts the ante 10
skonnybobo: posts the ante 10
Ninja Stax: posts the ante 10
JJin91: posts small blind 50
skonnybobo: posts big blind 100
*** HOLE CARDS ***
Dealt to JJin91 [6d Js]
Ninja Stax: folds=20
MyManPotnPan: folds=20
DaMiJKoNtRoL: folds=20
JJin91: raises 200 to 300
skonnybobo: calls 200
*** FLOP *** [8h 3c 9d]
JJin91: checks=20
skonnybobo: bets 300
JJin91: folds=20
Uncalled bet (300) returned to skonnybobo
skonnybobo collected 650 from pot
skonnybobo: doesn't show hand=20
*** SUMMARY ***
Total pot 650 | Rake 0=20
Board [8h 3c 9d]
Seat 1: MyManPotnPan folded before Flop (didn't bet)
Seat 2: DaMiJKoNtRoL (button) folded before Flop (didn't bet)
Seat 3: JJin91 (small blind) folded on the Flop
Seat 4: skonnybobo (big blind) collected (650)
Seat 5: Ninja Stax folded before Flop (didn't bet)


*********** # 19 **************
PokerStars Hand #169474665114: Tournament #1597684053, $13.50+$1.50 USD=
 Hold'em No Limit - Level IV (50/100) - 2017/05/06 14:10:38 ET
Table '1597684053 5' 6-max Seat #3 is the button
Seat 1: MyManPotnPan (18285 in chips)=20
Seat 2: DaMiJKoNtRoL (10440 in chips)=20
Seat 3: JJin91 (10535 in chips)=20
Seat 4: skonnybobo (10320 in chips)=20
Seat 5: Ninja Stax (30320 in chips) is sitting out
MyManPotnPan: posts the ante 10
DaMiJKoNtRoL: posts the ante 10
JJin91: posts the ante 10
skonnybobo: posts the ante 10
Ninja Stax: posts the ante 10
skonnybobo: posts small blind 50
Ninja Stax: posts big blind 100
*** HOLE CARDS ***
Dealt to JJin91 [As Tc]
MyManPotnPan: folds=20
DaMiJKoNtRoL: folds=20
JJin91: raises 200 to 300
skonnybobo: calls 250
Ninja Stax: folds=20
*** FLOP *** [2h 8h 3c]
skonnybobo: checks=20
JJin91: bets 398
skonnybobo: folds=20
Uncalled bet (398) returned to JJin91
JJin91 collected 750 from pot
JJin91: doesn't show hand=20
*** SUMMARY ***
Total pot 750 | Rake 0=20
Board [2h 8h 3c]
Seat 1: MyManPotnPan folded before Flop (didn't bet)
Seat 2: DaMiJKoNtRoL folded before Flop (didn't bet)
Seat 3: JJin91 (button) collected (750)
Seat 4: skonnybobo (small blind) folded on the Flop
Seat 5: Ninja Stax (big blind) folded before Flop


*********** # 20 **************
PokerStars Hand #169474665176: Tournament #1597684053, $13.50+$1.50 USD=
 Hold'em No Limit - Level IV (50/100) - 2017/05/06 14:11:01 ET
Table '1597684053 5' 6-max Seat #4 is the button
Seat 1: MyManPotnPan (18275 in chips)=20
Seat 2: DaMiJKoNtRoL (10430 in chips)=20
Seat 3: JJin91 (10975 in chips)=20
Seat 4: skonnybobo (10010 in chips)=20
Seat 5: Ninja Stax (30210 in chips) is sitting out
MyManPotnPan: posts the ante 10
DaMiJKoNtRoL: posts the ante 10
JJin91: posts the ante 10
skonnybobo: posts the ante 10
Ninja Stax: posts the ante 10
Ninja Stax: posts small blind 50
MyManPotnPan: posts big blind 100
*** HOLE CARDS ***
Dealt to JJin91 [Ah Ks]
DaMiJKoNtRoL: folds=20
JJin91: raises 200 to 300
skonnybobo: folds=20
Ninja Stax: folds=20
MyManPotnPan: folds=20
Uncalled bet (200) returned to JJin91
JJin91 collected 300 from pot
JJin91: doesn't show hand=20
*** SUMMARY ***
Total pot 300 | Rake 0=20
Seat 1: MyManPotnPan (big blind) folded before Flop
Seat 2: DaMiJKoNtRoL folded before Flop (didn't bet)
Seat 3: JJin91 collected (300)
Seat 4: skonnybobo (button) folded before Flop (didn't bet)
Seat 5: Ninja Stax (small blind) folded before Flop


*********** # 21 **************
PokerStars Hand #169474665209: Tournament #1597684053, $13.50+$1.50 USD=
 Hold'em No Limit - Level IV (50/100) - 2017/05/06 14:11:11 ET
Table '1597684053 5' 6-max Seat #5 is the button
Seat 1: MyManPotnPan (18165 in chips)=20
Seat 2: DaMiJKoNtRoL (10420 in chips)=20
Seat 3: JJin91 (11165 in chips)=20
Seat 4: skonnybobo (10000 in chips)=20
Seat 5: Ninja Stax (30150 in chips) is sitting out
MyManPotnPan: posts the ante 10
DaMiJKoNtRoL: posts the ante 10
JJin91: posts the ante 10
skonnybobo: posts the ante 10
Ninja Stax: posts the ante 10
MyManPotnPan: posts small blind 50
DaMiJKoNtRoL: posts big blind 100
*** HOLE CARDS ***
Dealt to JJin91 [8s Kh]
JJin91: folds=20
skonnybobo: raises 100 to 200
Ninja Stax: folds=20
MyManPotnPan: folds=20
DaMiJKoNtRoL: folds=20
Uncalled bet (100) returned to skonnybobo
skonnybobo collected 300 from pot
skonnybobo: doesn't show hand=20
*** SUMMARY ***
Total pot 300 | Rake 0=20
Seat 1: MyManPotnPan (small blind) folded before Flop
Seat 2: DaMiJKoNtRoL (big blind) folded before Flop
Seat 3: JJin91 folded before Flop (didn't bet)
Seat 4: skonnybobo collected (300)
Seat 5: Ninja Stax (button) folded before Flop (didn't bet)


*********** # 22 **************
PokerStars Hand #169474665255: Tournament #1597684053, $13.50+$1.50 USD=
 Hold'em No Limit - Level IV (50/100) - 2017/05/06 14:11:28 ET
Table '1597684053 5' 6-max Seat #1 is the button
Seat 1: MyManPotnPan (18105 in chips)=20
Seat 2: DaMiJKoNtRoL (10310 in chips)=20
Seat 3: JJin91 (11155 in chips)=20
Seat 4: skonnybobo (10190 in chips)=20
Seat 5: Ninja Stax (30140 in chips) is sitting out
MyManPotnPan: posts the ante 10
DaMiJKoNtRoL: posts the ante 10
JJin91: posts the ante 10
skonnybobo: posts the ante 10
Ninja Stax: posts the ante 10
DaMiJKoNtRoL: posts small blind 50
JJin91: posts big blind 100
*** HOLE CARDS ***
Dealt to JJin91 [9c Kc]
skonnybobo: folds=20
Ninja Stax: folds=20
MyManPotnPan: folds=20
DaMiJKoNtRoL: folds=20
Uncalled bet (50) returned to JJin91
JJin91 collected 150 from pot
JJin91: doesn't show hand=20
*** SUMMARY ***
Total pot 150 | Rake 0=20
Seat 1: MyManPotnPan (button) folded before Flop (didn't bet)
Seat 2: DaMiJKoNtRoL (small blind) folded before Flop
Seat 3: JJin91 (big blind) collected (150)
Seat 4: skonnybobo folded before Flop (didn't bet)
Seat 5: Ninja Stax folded before Flop (didn't bet)


*********** # 23 **************
PokerStars Hand #169474665277: Tournament #1597684053, $13.50+$1.50 USD=
 Hold'em No Limit - Level IV (50/100) - 2017/05/06 14:11:36 ET
Table '1597684053 5' 6-max Seat #2 is the button
Seat 1: MyManPotnPan (18095 in chips)=20
Seat 2: DaMiJKoNtRoL (10250 in chips)=20
Seat 3: JJin91 (11245 in chips)=20
Seat 4: skonnybobo (10180 in chips)=20
Seat 5: Ninja Stax (30130 in chips) is sitting out
MyManPotnPan: posts the ante 10
DaMiJKoNtRoL: posts the ante 10
JJin91: posts the ante 10
skonnybobo: posts the ante 10
Ninja Stax: posts the ante 10
JJin91: posts small blind 50
skonnybobo: posts big blind 100
*** HOLE CARDS ***
Dealt to JJin91 [9s Th]
Ninja Stax: folds=20
MyManPotnPan: raises 300 to 400
DaMiJKoNtRoL: folds=20
JJin91: folds=20
skonnybobo: folds=20
Uncalled bet (300) returned to MyManPotnPan
MyManPotnPan collected 300 from pot
MyManPotnPan: doesn't show hand=20
*** SUMMARY ***
Total pot 300 | Rake 0=20
Seat 1: MyManPotnPan collected (300)
Seat 2: DaMiJKoNtRoL (button) folded before Flop (didn't bet)
Seat 3: JJin91 (small blind) folded before Flop
Seat 4: skonnybobo (big blind) folded before Flop
Seat 5: Ninja Stax folded before Flop (didn't bet)


*********** # 24 **************
PokerStars Hand #169474665324: Tournament #1597684053, $13.50+$1.50 USD=
 Hold'em No Limit - Level IV (50/100) - 2017/05/06 14:11:54 ET
Table '1597684053 5' 6-max Seat #3 is the button
Seat 1: MyManPotnPan (18285 in chips)=20
Seat 2: DaMiJKoNtRoL (10240 in chips)=20
Seat 3: JJin91 (11185 in chips)=20
Seat 4: skonnybobo (10070 in chips)=20
Seat 5: Ninja Stax (30120 in chips) is sitting out
MyManPotnPan: posts the ante 10
DaMiJKoNtRoL: posts the ante 10
JJin91: posts the ante 10
skonnybobo: posts the ante 10
Ninja Stax: posts the ante 10
skonnybobo: posts small blind 50
Ninja Stax: posts big blind 100
*** HOLE CARDS ***
Dealt to JJin91 [8c Th]
MyManPotnPan: folds=20
DaMiJKoNtRoL: folds=20
JJin91: folds=20
skonnybobo: raises 100 to 200
Ninja Stax: folds=20
Uncalled bet (100) returned to skonnybobo
skonnybobo collected 250 from pot
skonnybobo: doesn't show hand=20
*** SUMMARY ***
Total pot 250 | Rake 0=20
Seat 1: MyManPotnPan folded before Flop (didn't bet)
Seat 2: DaMiJKoNtRoL folded before Flop (didn't bet)
Seat 3: JJin91 (button) folded before Flop (didn't bet)
Seat 4: skonnybobo (small blind) collected (250)
Seat 5: Ninja Stax (big blind) folded before Flop


*********** # 25 **************
PokerStars Hand #169474665359: Tournament #1597684053, $13.50+$1.50 USD=
 Hold'em No Limit - Level IV (50/100) - 2017/05/06 14:12:05 ET
Table '1597684053 5' 6-max Seat #4 is the button
Seat 1: MyManPotnPan (18275 in chips)=20
Seat 2: DaMiJKoNtRoL (10230 in chips)=20
Seat 3: JJin91 (11175 in chips)=20
Seat 4: skonnybobo (10210 in chips)=20
Seat 5: Ninja Stax (30010 in chips) is sitting out
MyManPotnPan: posts the ante 10
DaMiJKoNtRoL: posts the ante 10
JJin91: posts the ante 10
skonnybobo: posts the ante 10
Ninja Stax: posts the ante 10
Ninja Stax: posts small blind 50
MyManPotnPan: posts big blind 100
*** HOLE CARDS ***
Dealt to JJin91 [Td 3h]
DaMiJKoNtRoL: folds=20
JJin91: folds=20
skonnybobo: folds=20
Ninja Stax: folds=20
Uncalled bet (50) returned to MyManPotnPan
MyManPotnPan collected 150 from pot
MyManPotnPan: doesn't show hand=20
*** SUMMARY ***
Total pot 150 | Rake 0=20
Seat 1: MyManPotnPan (big blind) collected (150)
Seat 2: DaMiJKoNtRoL folded before Flop (didn't bet)
Seat 3: JJin91 folded before Flop (didn't bet)
Seat 4: skonnybobo (button) folded before Flop (didn't bet)
Seat 5: Ninja Stax (small blind) folded before Flop


*********** # 26 **************
PokerStars Hand #169474665392: Tournament #1597684053, $13.50+$1.50 USD=
 Hold'em No Limit - Level IV (50/100) - 2017/05/06 14:12:14 ET
Table '1597684053 5' 6-max Seat #5 is the button
Seat 1: MyManPotnPan (18365 in chips)=20
Seat 2: DaMiJKoNtRoL (10220 in chips)=20
Seat 3: JJin91 (11165 in chips)=20
Seat 4: skonnybobo (10200 in chips)=20
Seat 5: Ninja Stax (29950 in chips) is sitting out
MyManPotnPan: posts the ante 10
DaMiJKoNtRoL: posts the ante 10
JJin91: posts the ante 10
skonnybobo: posts the ante 10
Ninja Stax: posts the ante 10
MyManPotnPan: posts small blind 50
DaMiJKoNtRoL: posts big blind 100
*** HOLE CARDS ***
Dealt to JJin91 [7d 4c]
JJin91: folds=20
skonnybobo: folds=20
Ninja Stax: folds=20
MyManPotnPan: calls 50
DaMiJKoNtRoL: checks=20
*** FLOP *** [7h As Qc]
MyManPotnPan: bets 100
DaMiJKoNtRoL: folds=20
Uncalled bet (100) returned to MyManPotnPan
MyManPotnPan collected 250 from pot
MyManPotnPan: doesn't show hand=20
*** SUMMARY ***
Total pot 250 | Rake 0=20
Board [7h As Qc]
Seat 1: MyManPotnPan (small blind) collected (250)
Seat 2: DaMiJKoNtRoL (big blind) folded on the Flop
Seat 3: JJin91 folded before Flop (didn't bet)
Seat 4: skonnybobo folded before Flop (didn't bet)
Seat 5: Ninja Stax (button) folded before Flop (didn't bet)


*********** # 27 **************
PokerStars Hand #169474665470: Tournament #1597684053, $13.50+$1.50 USD=
 Hold'em No Limit - Level IV (50/100) - 2017/05/06 14:12:43 ET
Table '1597684053 5' 6-max Seat #1 is the button
Seat 1: MyManPotnPan (18505 in chips)=20
Seat 2: DaMiJKoNtRoL (10110 in chips)=20
Seat 3: JJin91 (11155 in chips)=20
Seat 4: skonnybobo (10190 in chips)=20
Seat 5: Ninja Stax (29940 in chips) is sitting out
MyManPotnPan: posts the ante 10
DaMiJKoNtRoL: posts the ante 10
JJin91: posts the ante 10
skonnybobo: posts the ante 10
Ninja Stax: posts the ante 10
DaMiJKoNtRoL: posts small blind 50
JJin91: posts big blind 100
*** HOLE CARDS ***
Dealt to JJin91 [Qh Ts]
skonnybobo: folds=20
Ninja Stax: folds=20
MyManPotnPan: folds=20
DaMiJKoNtRoL: folds=20
Uncalled bet (50) returned to JJin91
JJin91 collected 150 from pot
JJin91: doesn't show hand=20
*** SUMMARY ***
Total pot 150 | Rake 0=20
Seat 1: MyManPotnPan (button) folded before Flop (didn't bet)
Seat 2: DaMiJKoNtRoL (small blind) folded before Flop
Seat 3: JJin91 (big blind) collected (150)
Seat 4: skonnybobo folded before Flop (didn't bet)
Seat 5: Ninja Stax folded before Flop (didn't bet)


*********** # 28 **************
PokerStars Hand #169474665499: Tournament #1597684053, $13.50+$1.50 USD=
 Hold'em No Limit - Level IV (50/100) - 2017/05/06 14:12:53 ET
Table '1597684053 5' 6-max Seat #2 is the button
Seat 1: MyManPotnPan (18495 in chips)=20
Seat 2: DaMiJKoNtRoL (10050 in chips)=20
Seat 3: JJin91 (11245 in chips)=20
Seat 4: skonnybobo (10180 in chips)=20
Seat 5: Ninja Stax (29930 in chips) is sitting out
Seat 6: albyal420 (10000 in chips)=20
MyManPotnPan: posts the ante 10
DaMiJKoNtRoL: posts the ante 10
JJin91: posts the ante 10
skonnybobo: posts the ante 10
Ninja Stax: posts the ante 10
albyal420: posts the ante 10
JJin91: posts small blind 50
skonnybobo: posts big blind 100
*** HOLE CARDS ***
Dealt to JJin91 [Ac 8c]
Ninja Stax: folds=20
albyal420: calls 100
MyManPotnPan: folds=20
DaMiJKoNtRoL: folds=20
JJin91: raises 300 to 400
skonnybobo: folds=20
albyal420: calls 300
*** FLOP *** [8h Kd Td]
JJin91: checks=20
albyal420: bets 500
JJin91: calls 500
*** TURN *** [8h Kd Td] [9d]
JJin91: bets 1200
albyal420: calls 1200
*** RIVER *** [8h Kd Td 9d] [Kh]
JJin91: checks=20
albyal420: checks=20
*** SHOW DOWN ***
JJin91: shows [Ac 8c] (two pair, Kings and Eights)
albyal420: mucks hand=20
JJin91 collected 4360 from pot
*** SUMMARY ***
Total pot 4360 | Rake 0=20
Board [8h Kd Td 9d Kh]
Seat 1: MyManPotnPan folded before Flop (didn't bet)
Seat 2: DaMiJKoNtRoL (button) folded before Flop (didn't bet)
Seat 3: JJin91 (small blind) showed [Ac 8c] and won (4360) with two pai=
r, Kings and Eights
Seat 4: skonnybobo (big blind) folded before Flop
Seat 5: Ninja Stax folded before Flop (didn't bet)
Seat 6: albyal420 mucked [3h Ad]


*********** # 29 **************
PokerStars Hand #169474665622: Tournament #1597684053, $13.50+$1.50 USD=
 Hold'em No Limit - Level IV (50/100) - 2017/05/06 14:13:37 ET
Table '1597684053 5' 6-max Seat #3 is the button
Seat 1: MyManPotnPan (18485 in chips)=20
Seat 2: DaMiJKoNtRoL (10040 in chips)=20
Seat 3: JJin91 (13495 in chips)=20
Seat 4: skonnybobo (10070 in chips)=20
Seat 5: Ninja Stax (29920 in chips) is sitting out
Seat 6: albyal420 (7890 in chips)=20
MyManPotnPan: posts the ante 10
DaMiJKoNtRoL: posts the ante 10
JJin91: posts the ante 10
skonnybobo: posts the ante 10
Ninja Stax: posts the ante 10
albyal420: posts the ante 10
skonnybobo: posts small blind 50
Ninja Stax: posts big blind 100
*** HOLE CARDS ***
Dealt to JJin91 [Th 5d]
albyal420: calls 100
MyManPotnPan: calls 100
DaMiJKoNtRoL: folds=20
JJin91: folds=20
skonnybobo: folds=20
Ninja Stax: folds=20
*** FLOP *** [2c 6c 3s]
albyal420: checks=20
MyManPotnPan: checks=20
*** TURN *** [2c 6c 3s] [4h]
albyal420: checks=20
MyManPotnPan: checks=20
*** RIVER *** [2c 6c 3s 4h] [Qs]
albyal420: checks=20
MyManPotnPan: checks=20
*** SHOW DOWN ***
albyal420: shows [9c 8d] (high card Queen)
MyManPotnPan: shows [7d Ad] (high card Ace)
MyManPotnPan collected 410 from pot
*** SUMMARY ***
Total pot 410 | Rake 0=20
Board [2c 6c 3s 4h Qs]
Seat 1: MyManPotnPan showed [7d Ad] and won (410) with high card Ace
Seat 2: DaMiJKoNtRoL folded before Flop (didn't bet)
Seat 3: JJin91 (button) folded before Flop (didn't bet)
Seat 4: skonnybobo (small blind) folded before Flop
Seat 5: Ninja Stax (big blind) folded before Flop
Seat 6: albyal420 showed [9c 8d] and lost with high card Queen


*********** # 30 **************
PokerStars Hand #169474665733: Tournament #1597684053, $13.50+$1.50 USD=
 Hold'em No Limit - Level IV (50/100) - 2017/05/06 14:14:18 ET
Table '1597684053 5' 6-max Seat #4 is the button
Seat 1: MyManPotnPan (18785 in chips)=20
Seat 2: DaMiJKoNtRoL (10030 in chips)=20
Seat 3: JJin91 (13485 in chips)=20
Seat 4: skonnybobo (10010 in chips)=20
Seat 5: Ninja Stax (29810 in chips) is sitting out
Seat 6: albyal420 (7780 in chips)=20
MyManPotnPan: posts the ante 10
DaMiJKoNtRoL: posts the ante 10
JJin91: posts the ante 10
skonnybobo: posts the ante 10
Ninja Stax: posts the ante 10
albyal420: posts the ante 10
Ninja Stax: posts small blind 50
albyal420: posts big blind 100
*** HOLE CARDS ***
Dealt to JJin91 [8s Kd]
MyManPotnPan: folds=20
DaMiJKoNtRoL: folds=20
JJin91: folds=20
skonnybobo: raises 100 to 200
Ninja Stax: folds=20
albyal420: raises 510 to 710
skonnybobo: folds=20
Uncalled bet (510) returned to albyal420
albyal420 collected 510 from pot
albyal420: doesn't show hand=20
*** SUMMARY ***
Total pot 510 | Rake 0=20
Seat 1: MyManPotnPan folded before Flop (didn't bet)
Seat 2: DaMiJKoNtRoL folded before Flop (didn't bet)
Seat 3: JJin91 folded before Flop (didn't bet)
Seat 4: skonnybobo (button) folded before Flop
Seat 5: Ninja Stax (small blind) folded before Flop
Seat 6: albyal420 (big blind) collected (510)


*********** # 31 **************
PokerStars Hand #169474665812: Tournament #1597684053, $13.50+$1.50 USD=
 Hold'em No Limit - Level IV (50/100) - 2017/05/06 14:14:43 ET
Table '1597684053 5' 6-max Seat #5 is the button
Seat 1: MyManPotnPan (18775 in chips)=20
Seat 2: DaMiJKoNtRoL (10020 in chips)=20
Seat 3: JJin91 (13475 in chips)=20
Seat 4: skonnybobo (9800 in chips)=20
Seat 5: Ninja Stax (29750 in chips) is sitting out
Seat 6: albyal420 (8080 in chips)=20
MyManPotnPan: posts the ante 10
DaMiJKoNtRoL: posts the ante 10
JJin91: posts the ante 10
skonnybobo: posts the ante 10
Ninja Stax: posts the ante 10
albyal420: posts the ante 10
albyal420: posts small blind 50
MyManPotnPan: posts big blind 100
*** HOLE CARDS ***
Dealt to JJin91 [8h Kd]
DaMiJKoNtRoL: folds=20
JJin91: folds=20
skonnybobo: raises 100 to 200
Ninja Stax: folds=20
albyal420: calls 150
MyManPotnPan: folds=20
*** FLOP *** [As 3h 8d]
albyal420: checks=20
skonnybobo: bets 200
albyal420: calls 200
*** TURN *** [As 3h 8d] [Ac]
albyal420: checks=20
skonnybobo: bets 400
albyal420: calls 400
*** RIVER *** [As 3h 8d Ac] [7c]
albyal420: checks=20
skonnybobo: bets 900
albyal420: calls 900
*** SHOW DOWN ***
skonnybobo: shows [9s 9h] (two pair, Aces and Nines)
albyal420: mucks hand=20
skonnybobo collected 3560 from pot
*** SUMMARY ***
Total pot 3560 | Rake 0=20
Board [As 3h 8d Ac 7c]
Seat 1: MyManPotnPan (big blind) folded before Flop
Seat 2: DaMiJKoNtRoL folded before Flop (didn't bet)
Seat 3: JJin91 folded before Flop (didn't bet)
Seat 4: skonnybobo showed [9s 9h] and won (3560) with two pair, Aces an=
d Nines
Seat 5: Ninja Stax (button) folded before Flop (didn't bet)
Seat 6: albyal420 (small blind) mucked [8s Jd]


*********** # 32 **************
PokerStars Hand #169474665948: Tournament #1597684053, $13.50+$1.50 USD=
 Hold'em No Limit - Level IV (50/100) - 2017/05/06 14:15:35 ET
Table '1597684053 5' 6-max Seat #6 is the button
Seat 1: MyManPotnPan (18665 in chips)=20
Seat 2: DaMiJKoNtRoL (10010 in chips)=20
Seat 3: JJin91 (13465 in chips)=20
Seat 4: skonnybobo (11650 in chips)=20
Seat 5: Ninja Stax (29740 in chips) is sitting out
Seat 6: albyal420 (6370 in chips)=20
MyManPotnPan: posts the ante 10
DaMiJKoNtRoL: posts the ante 10
JJin91: posts the ante 10
skonnybobo: posts the ante 10
Ninja Stax: posts the ante 10
albyal420: posts the ante 10
MyManPotnPan: posts small blind 50
DaMiJKoNtRoL: posts big blind 100
*** HOLE CARDS ***
Dealt to JJin91 [2h 5h]
JJin91: folds=20
skonnybobo: folds=20
Ninja Stax: folds=20
albyal420: calls 100
MyManPotnPan: calls 50
DaMiJKoNtRoL: raises 200 to 300
albyal420: calls 200
MyManPotnPan: calls 200
*** FLOP *** [4s 2c 8s]
MyManPotnPan: bets 480
DaMiJKoNtRoL: folds=20
albyal420: raises 5580 to 6060 and is all-in
MyManPotnPan: calls 5580
*** TURN *** [4s 2c 8s] [Ah]
*** RIVER *** [4s 2c 8s Ah] [As]
*** SHOW DOWN ***
MyManPotnPan: shows [Qs Ks] (a flush, Ace high)
albyal420: shows [8d Js] (two pair, Aces and Eights)
MyManPotnPan collected 13080 from pot
albyal420 finished the tournament in 98th place
*** SUMMARY ***
Total pot 13080 | Rake 0=20
Board [4s 2c 8s Ah As]
Seat 1: MyManPotnPan (small blind) showed [Qs Ks] and won (13080) with =
a flush, Ace high
Seat 2: DaMiJKoNtRoL (big blind) folded on the Flop
Seat 3: JJin91 folded before Flop (didn't bet)
Seat 4: skonnybobo folded before Flop (didn't bet)
Seat 5: Ninja Stax folded before Flop (didn't bet)
Seat 6: albyal420 (button) showed [8d Js] and lost with two pair, Aces =
and Eights


*********** # 33 **************
PokerStars Hand #169474666074: Tournament #1597684053, $13.50+$1.50 USD=
 Hold'em No Limit - Level V (60/120) - 2017/05/06 14:16:23 ET
Table '1597684053 5' 6-max Seat #1 is the button
Seat 1: MyManPotnPan (25375 in chips)=20
Seat 2: DaMiJKoNtRoL (9700 in chips)=20
Seat 3: JJin91 (13455 in chips)=20
Seat 4: skonnybobo (11640 in chips)=20
Seat 5: Ninja Stax (29730 in chips) is sitting out
MyManPotnPan: posts the ante 15
DaMiJKoNtRoL: posts the ante 15
JJin91: posts the ante 15
skonnybobo: posts the ante 15
Ninja Stax: posts the ante 15
DaMiJKoNtRoL: posts small blind 60
JJin91: posts big blind 120
*** HOLE CARDS ***
Dealt to JJin91 [Qc Qs]
skonnybobo: folds=20
Ninja Stax: folds=20
MyManPotnPan: folds=20
DaMiJKoNtRoL: folds=20
Uncalled bet (60) returned to JJin91
JJin91 collected 195 from pot
JJin91: doesn't show hand=20
*** SUMMARY ***
Total pot 195 | Rake 0=20
Seat 1: MyManPotnPan (button) folded before Flop (didn't bet)
Seat 2: DaMiJKoNtRoL (small blind) folded before Flop
Seat 3: JJin91 (big blind) collected (195)
Seat 4: skonnybobo folded before Flop (didn't bet)
Seat 5: Ninja Stax folded before Flop (didn't bet)


*********** # 34 **************
PokerStars Hand #169474666102: Tournament #1597684053, $13.50+$1.50 USD=
 Hold'em No Limit - Level V (60/120) - 2017/05/06 14:16:35 ET
Table '1597684053 5' 6-max Seat #2 is the button
Seat 1: MyManPotnPan (25360 in chips)=20
Seat 2: DaMiJKoNtRoL (9625 in chips)=20
Seat 3: JJin91 (13575 in chips)=20
Seat 4: skonnybobo (11625 in chips)=20
Seat 5: Ninja Stax (29715 in chips) is sitting out
MyManPotnPan: posts the ante 15
DaMiJKoNtRoL: posts the ante 15
JJin91: posts the ante 15
skonnybobo: posts the ante 15
Ninja Stax: posts the ante 15
JJin91: posts small blind 60
skonnybobo: posts big blind 120
*** HOLE CARDS ***
Dealt to JJin91 [9h 4c]
Ninja Stax: folds=20
MyManPotnPan: folds=20
DaMiJKoNtRoL: folds=20
JJin91: folds=20
Uncalled bet (60) returned to skonnybobo
skonnybobo collected 195 from pot
skonnybobo: doesn't show hand=20
*** SUMMARY ***
Total pot 195 | Rake 0=20
Seat 1: MyManPotnPan folded before Flop (didn't bet)
Seat 2: DaMiJKoNtRoL (button) folded before Flop (didn't bet)
Seat 3: JJin91 (small blind) folded before Flop
Seat 4: skonnybobo (big blind) collected (195)
Seat 5: Ninja Stax folded before Flop (didn't bet)


*********** # 35 **************
PokerStars Hand #169474666127: Tournament #1597684053, $13.50+$1.50 USD=
 Hold'em No Limit - Level V (60/120) - 2017/05/06 14:16:44 ET
Table '1597684053 5' 6-max Seat #3 is the button
Seat 1: MyManPotnPan (25345 in chips)=20
Seat 2: DaMiJKoNtRoL (9610 in chips)=20
Seat 3: JJin91 (13500 in chips)=20
Seat 4: skonnybobo (11745 in chips)=20
Seat 5: Ninja Stax (29700 in chips) is sitting out
MyManPotnPan: posts the ante 15
DaMiJKoNtRoL: posts the ante 15
JJin91: posts the ante 15
skonnybobo: posts the ante 15
Ninja Stax: posts the ante 15
skonnybobo: posts small blind 60
Ninja Stax: posts big blind 120
*** HOLE CARDS ***
Dealt to JJin91 [5s 9c]
MyManPotnPan: folds=20
DaMiJKoNtRoL: folds=20
JJin91: folds=20
skonnybobo: raises 120 to 240
Ninja Stax: folds=20
Uncalled bet (120) returned to skonnybobo
skonnybobo collected 315 from pot
skonnybobo: doesn't show hand=20
*** SUMMARY ***
Total pot 315 | Rake 0=20
Seat 1: MyManPotnPan folded before Flop (didn't bet)
Seat 2: DaMiJKoNtRoL folded before Flop (didn't bet)
Seat 3: JJin91 (button) folded before Flop (didn't bet)
Seat 4: skonnybobo (small blind) collected (315)
Seat 5: Ninja Stax (big blind) folded before Flop


*********** # 36 **************
PokerStars Hand #169474666172: Tournament #1597684053, $13.50+$1.50 USD=
 Hold'em No Limit - Level V (60/120) - 2017/05/06 14:17:02 ET
Table '1597684053 5' 6-max Seat #4 is the button
Seat 1: MyManPotnPan (25330 in chips)=20
Seat 2: DaMiJKoNtRoL (9595 in chips)=20
Seat 3: JJin91 (13485 in chips)=20
Seat 4: skonnybobo (11925 in chips)=20
Seat 5: Ninja Stax (29565 in chips) is sitting out
MyManPotnPan: posts the ante 15
DaMiJKoNtRoL: posts the ante 15
JJin91: posts the ante 15
skonnybobo: posts the ante 15
Ninja Stax: posts the ante 15
Ninja Stax: posts small blind 60
MyManPotnPan: posts big blind 120
*** HOLE CARDS ***
Dealt to JJin91 [7c 4s]
DaMiJKoNtRoL: folds=20
JJin91: folds=20
skonnybobo: folds=20
Ninja Stax: folds=20
Uncalled bet (60) returned to MyManPotnPan
MyManPotnPan collected 195 from pot
MyManPotnPan: doesn't show hand=20
*** SUMMARY ***
Total pot 195 | Rake 0=20
Seat 1: MyManPotnPan (big blind) collected (195)
Seat 2: DaMiJKoNtRoL folded before Flop (didn't bet)
Seat 3: JJin91 folded before Flop (didn't bet)
Seat 4: skonnybobo (button) folded before Flop (didn't bet)
Seat 5: Ninja Stax (small blind) folded before Flop


*********** # 37 **************
PokerStars Hand #169474666210: Tournament #1597684053, $13.50+$1.50 USD=
 Hold'em No Limit - Level V (60/120) - 2017/05/06 14:17:15 ET
Table '1597684053 5' 6-max Seat #5 is the button
Seat 1: MyManPotnPan (25450 in chips)=20
Seat 2: DaMiJKoNtRoL (9580 in chips)=20
Seat 3: JJin91 (13470 in chips)=20
Seat 4: skonnybobo (11910 in chips)=20
Seat 5: Ninja Stax (29490 in chips) is sitting out
MyManPotnPan: posts the ante 15
DaMiJKoNtRoL: posts the ante 15
JJin91: posts the ante 15
skonnybobo: posts the ante 15
Ninja Stax: posts the ante 15
MyManPotnPan: posts small blind 60
DaMiJKoNtRoL: posts big blind 120
*** HOLE CARDS ***
Dealt to JJin91 [3s 7c]
JJin91: folds=20
skonnybobo: raises 120 to 240
Ninja Stax: folds=20
MyManPotnPan: folds=20
DaMiJKoNtRoL: folds=20
Uncalled bet (120) returned to skonnybobo
skonnybobo collected 375 from pot
skonnybobo: doesn't show hand=20
*** SUMMARY ***
Total pot 375 | Rake 0=20
Seat 1: MyManPotnPan (small blind) folded before Flop
Seat 2: DaMiJKoNtRoL (big blind) folded before Flop
Seat 3: JJin91 folded before Flop (didn't bet)
Seat 4: skonnybobo collected (375)
Seat 5: Ninja Stax (button) folded before Flop (didn't bet)


*********** # 38 **************
PokerStars Hand #169474666237: Tournament #1597684053, $13.50+$1.50 USD=
 Hold'em No Limit - Level V (60/120) - 2017/05/06 14:17:28 ET
Table '1597684053 5' 6-max Seat #1 is the button
Seat 1: MyManPotnPan (25375 in chips)=20
Seat 2: DaMiJKoNtRoL (9445 in chips)=20
Seat 3: JJin91 (13455 in chips)=20
Seat 4: skonnybobo (12150 in chips)=20
Seat 5: Ninja Stax (29475 in chips) is sitting out
MyManPotnPan: posts the ante 15
DaMiJKoNtRoL: posts the ante 15
JJin91: posts the ante 15
skonnybobo: posts the ante 15
Ninja Stax: posts the ante 15
DaMiJKoNtRoL: posts small blind 60
JJin91: posts big blind 120
*** HOLE CARDS ***
Dealt to JJin91 [3c 2c]
skonnybobo: raises 120 to 240
Ninja Stax: folds=20
MyManPotnPan: folds=20
DaMiJKoNtRoL: folds=20
JJin91: calls 120
*** FLOP *** [Ah As Jh]
JJin91: checks=20
skonnybobo: bets 240
JJin91: folds=20
Uncalled bet (240) returned to skonnybobo
skonnybobo collected 615 from pot
skonnybobo: doesn't show hand=20
*** SUMMARY ***
Total pot 615 | Rake 0=20
Board [Ah As Jh]
Seat 1: MyManPotnPan (button) folded before Flop (didn't bet)
Seat 2: DaMiJKoNtRoL (small blind) folded before Flop
Seat 3: JJin91 (big blind) folded on the Flop
Seat 4: skonnybobo collected (615)
Seat 5: Ninja Stax folded before Flop (didn't bet)


*********** # 39 **************
PokerStars Hand #169474666297: Tournament #1597684053, $13.50+$1.50 USD=
 Hold'em No Limit - Level V (60/120) - 2017/05/06 14:17:53 ET
Table '1597684053 5' 6-max Seat #2 is the button
Seat 1: MyManPotnPan (25360 in chips)=20
Seat 2: DaMiJKoNtRoL (9370 in chips)=20
Seat 3: JJin91 (13200 in chips)=20
Seat 4: skonnybobo (12510 in chips)=20
Seat 5: Ninja Stax (29460 in chips) is sitting out
MyManPotnPan: posts the ante 15
DaMiJKoNtRoL: posts the ante 15
JJin91: posts the ante 15
skonnybobo: posts the ante 15
Ninja Stax: posts the ante 15
JJin91: posts small blind 60
skonnybobo: posts big blind 120
*** HOLE CARDS ***
Dealt to JJin91 [5c Tc]
Ninja Stax: folds=20
MyManPotnPan: folds=20
DaMiJKoNtRoL: folds=20
JJin91: folds=20
Uncalled bet (60) returned to skonnybobo
skonnybobo collected 195 from pot
skonnybobo: doesn't show hand=20
*** SUMMARY ***
Total pot 195 | Rake 0=20
Seat 1: MyManPotnPan folded before Flop (didn't bet)
Seat 2: DaMiJKoNtRoL (button) folded before Flop (didn't bet)
Seat 3: JJin91 (small blind) folded before Flop
Seat 4: skonnybobo (big blind) collected (195)
Seat 5: Ninja Stax folded before Flop (didn't bet)


*********** # 40 **************
PokerStars Hand #169474666327: Tournament #1597684053, $13.50+$1.50 USD=
 Hold'em No Limit - Level V (60/120) - 2017/05/06 14:18:03 ET
Table '1597684053 5' 6-max Seat #3 is the button
Seat 1: MyManPotnPan (25345 in chips)=20
Seat 2: DaMiJKoNtRoL (9355 in chips)=20
Seat 3: JJin91 (13125 in chips)=20
Seat 4: skonnybobo (12630 in chips)=20
Seat 5: Ninja Stax (29445 in chips) is sitting out
MyManPotnPan: posts the ante 15
DaMiJKoNtRoL: posts the ante 15
JJin91: posts the ante 15
skonnybobo: posts the ante 15
Ninja Stax: posts the ante 15
skonnybobo: posts small blind 60
Ninja Stax: posts big blind 120
*** HOLE CARDS ***
Dealt to JJin91 [8c 7h]
MyManPotnPan: folds=20
DaMiJKoNtRoL: folds=20
JJin91: raises 240 to 360
skonnybobo: raises 720 to 1080
Ninja Stax: folds=20
JJin91: folds=20
Uncalled bet (720) returned to skonnybobo
skonnybobo collected 915 from pot
skonnybobo: doesn't show hand=20
*** SUMMARY ***
Total pot 915 | Rake 0=20
Seat 1: MyManPotnPan folded before Flop (didn't bet)
Seat 2: DaMiJKoNtRoL folded before Flop (didn't bet)
Seat 3: JJin91 (button) folded before Flop
Seat 4: skonnybobo (small blind) collected (915)
Seat 5: Ninja Stax (big blind) folded before Flop


*********** # 41 **************
PokerStars Hand #169474666382: Tournament #1597684053, $13.50+$1.50 USD=
 Hold'em No Limit - Level V (60/120) - 2017/05/06 14:18:28 ET
Table '1597684053 5' 6-max Seat #4 is the button
Seat 1: MyManPotnPan (25330 in chips)=20
Seat 2: DaMiJKoNtRoL (9340 in chips)=20
Seat 3: JJin91 (12750 in chips)=20
Seat 4: skonnybobo (13170 in chips)=20
Seat 5: Ninja Stax (29310 in chips) is sitting out
MyManPotnPan: posts the ante 15
DaMiJKoNtRoL: posts the ante 15
JJin91: posts the ante 15
skonnybobo: posts the ante 15
Ninja Stax: posts the ante 15
Ninja Stax: posts small blind 60
MyManPotnPan: posts big blind 120
*** HOLE CARDS ***
Dealt to JJin91 [3h Jh]
DaMiJKoNtRoL: folds=20
JJin91: folds=20
skonnybobo: raises 120 to 240
Ninja Stax: folds=20
MyManPotnPan: folds=20
Uncalled bet (120) returned to skonnybobo
skonnybobo collected 375 from pot
skonnybobo: doesn't show hand=20
*** SUMMARY ***
Total pot 375 | Rake 0=20
Seat 1: MyManPotnPan (big blind) folded before Flop
Seat 2: DaMiJKoNtRoL folded before Flop (didn't bet)
Seat 3: JJin91 folded before Flop (didn't bet)
Seat 4: skonnybobo (button) collected (375)
Seat 5: Ninja Stax (small blind) folded before Flop


*********** # 42 **************
PokerStars Hand #169474666412: Tournament #1597684053, $13.50+$1.50 USD=
 Hold'em No Limit - Level V (60/120) - 2017/05/06 14:18:41 ET
Table '1597684053 5' 6-max Seat #5 is the button
Seat 1: MyManPotnPan (25195 in chips)=20
Seat 2: DaMiJKoNtRoL (9325 in chips)=20
Seat 3: JJin91 (12735 in chips)=20
Seat 4: skonnybobo (13410 in chips)=20
Seat 5: Ninja Stax (29235 in chips) is sitting out
MyManPotnPan: posts the ante 15
DaMiJKoNtRoL: posts the ante 15
JJin91: posts the ante 15
skonnybobo: posts the ante 15
Ninja Stax: posts the ante 15
MyManPotnPan: posts small blind 60
DaMiJKoNtRoL: posts big blind 120
*** HOLE CARDS ***
Dealt to JJin91 [Qs 3h]
JJin91: folds=20
skonnybobo: folds=20
Ninja Stax: folds=20
MyManPotnPan: calls 60
DaMiJKoNtRoL: checks=20
*** FLOP *** [Kh 4s 7d]
MyManPotnPan: checks=20
DaMiJKoNtRoL: bets 158
MyManPotnPan: folds=20
Uncalled bet (158) returned to DaMiJKoNtRoL
DaMiJKoNtRoL collected 315 from pot
DaMiJKoNtRoL: doesn't show hand=20
*** SUMMARY ***
Total pot 315 | Rake 0=20
Board [Kh 4s 7d]
Seat 1: MyManPotnPan (small blind) folded on the Flop
Seat 2: DaMiJKoNtRoL (big blind) collected (315)
Seat 3: JJin91 folded before Flop (didn't bet)
Seat 4: skonnybobo folded before Flop (didn't bet)
Seat 5: Ninja Stax (button) folded before Flop (didn't bet)


*********** # 43 **************
PokerStars Hand #169474666471: Tournament #1597684053, $13.50+$1.50 USD=
 Hold'em No Limit - Level V (60/120) - 2017/05/06 14:19:06 ET
Table '1597684053 5' 6-max Seat #1 is the button
Seat 1: MyManPotnPan (25060 in chips)=20
Seat 2: DaMiJKoNtRoL (9505 in chips)=20
Seat 3: JJin91 (12720 in chips)=20
Seat 4: skonnybobo (13395 in chips)=20
Seat 5: Ninja Stax (29220 in chips) is sitting out
MyManPotnPan: posts the ante 15
DaMiJKoNtRoL: posts the ante 15
JJin91: posts the ante 15
skonnybobo: posts the ante 15
Ninja Stax: posts the ante 15
DaMiJKoNtRoL: posts small blind 60
JJin91: posts big blind 120
*** HOLE CARDS ***
Dealt to JJin91 [8c Ah]
skonnybobo: folds=20
Ninja Stax: folds=20
MyManPotnPan: calls 120
DaMiJKoNtRoL: calls 60
JJin91: checks=20
*** FLOP *** [8s As 6c]
DaMiJKoNtRoL: checks=20
JJin91: checks=20
MyManPotnPan: bets 240
DaMiJKoNtRoL: calls 240
JJin91: calls 240
*** TURN *** [8s As 6c] [3h]
DaMiJKoNtRoL: checks=20
JJin91: checks=20
MyManPotnPan: bets 1155
Ninja Stax has returned
DaMiJKoNtRoL: folds=20
JJin91: raises 1965 to 3120
MyManPotnPan: calls 1965
*** RIVER *** [8s As 6c 3h] [5d]
JJin91: checks=20
MyManPotnPan: checks=20
*** SHOW DOWN ***
JJin91: shows [8c Ah] (two pair, Aces and Eights)
MyManPotnPan: mucks hand=20
JJin91 collected 7395 from pot
*** SUMMARY ***
Total pot 7395 | Rake 0=20
Board [8s As 6c 3h 5d]
Seat 1: MyManPotnPan (button) mucked [6d 8d]
Seat 2: DaMiJKoNtRoL (small blind) folded on the Turn
Seat 3: JJin91 (big blind) showed [8c Ah] and won (7395) with two pair,=
 Aces and Eights
Seat 4: skonnybobo folded before Flop (didn't bet)
Seat 5: Ninja Stax folded before Flop (didn't bet)


*********** # 44 **************
PokerStars Hand #169474666649: Tournament #1597684053, $13.50+$1.50 USD=
 Hold'em No Limit - Level V (60/120) - 2017/05/06 14:20:22 ET
Table '1597684053 5' 6-max Seat #2 is the button
Seat 1: MyManPotnPan (21565 in chips)=20
Seat 2: DaMiJKoNtRoL (9130 in chips)=20
Seat 3: JJin91 (16620 in chips)=20
Seat 4: skonnybobo (13380 in chips)=20
Seat 5: Ninja Stax (29205 in chips)=20
MyManPotnPan: posts the ante 15
DaMiJKoNtRoL: posts the ante 15
JJin91: posts the ante 15
skonnybobo: posts the ante 15
Ninja Stax: posts the ante 15
JJin91: posts small blind 60
skonnybobo: posts big blind 120
*** HOLE CARDS ***
Dealt to JJin91 [2c Jc]
Ninja Stax: folds=20
MyManPotnPan: calls 120
DaMiJKoNtRoL: folds=20
JJin91: calls 60
skonnybobo: checks=20
*** FLOP *** [8h Qd Qh]
JJin91: checks=20
skonnybobo: checks=20
MyManPotnPan: checks=20
*** TURN *** [8h Qd Qh] [7c]
JJin91: bets 231
skonnybobo: folds=20
MyManPotnPan: folds=20
Uncalled bet (231) returned to JJin91
JJin91 collected 435 from pot
JJin91: doesn't show hand=20
*** SUMMARY ***
Total pot 435 | Rake 0=20
Board [8h Qd Qh 7c]
Seat 1: MyManPotnPan folded on the Turn
Seat 2: DaMiJKoNtRoL (button) folded before Flop (didn't bet)
Seat 3: JJin91 (small blind) collected (435)
Seat 4: skonnybobo (big blind) folded on the Turn
Seat 5: Ninja Stax folded before Flop (didn't bet)


*********** # 45 **************
PokerStars Hand #169474666736: Tournament #1597684053, $13.50+$1.50 USD=
 Hold'em No Limit - Level V (60/120) - 2017/05/06 14:21:00 ET
Table '1597684053 5' 6-max Seat #3 is the button
Seat 1: MyManPotnPan (21430 in chips)=20
Seat 2: DaMiJKoNtRoL (9115 in chips)=20
Seat 3: JJin91 (16920 in chips)=20
Seat 4: skonnybobo (13245 in chips)=20
Seat 5: Ninja Stax (29190 in chips)=20
MyManPotnPan: posts the ante 15
DaMiJKoNtRoL: posts the ante 15
JJin91: posts the ante 15
skonnybobo: posts the ante 15
Ninja Stax: posts the ante 15
skonnybobo: posts small blind 60
Ninja Stax: posts big blind 120
*** HOLE CARDS ***
Dealt to JJin91 [6c Ac]
MyManPotnPan: folds=20
DaMiJKoNtRoL: folds=20
JJin91: raises 240 to 360
skonnybobo: folds=20
Ninja Stax: folds=20
Uncalled bet (240) returned to JJin91
JJin91 collected 375 from pot
JJin91: doesn't show hand=20
*** SUMMARY ***
Total pot 375 | Rake 0=20
Seat 1: MyManPotnPan folded before Flop (didn't bet)
Seat 2: DaMiJKoNtRoL folded before Flop (didn't bet)
Seat 3: JJin91 (button) collected (375)
Seat 4: skonnybobo (small blind) folded before Flop
Seat 5: Ninja Stax (big blind) folded before Flop


*********** # 46 **************
PokerStars Hand #169474666852: Tournament #1597684053, $13.50+$1.50 USD=
 Hold'em No Limit - Level V (60/120) - 2017/05/06 14:21:47 ET
Table '1597684053 5' 6-max Seat #4 is the button
Seat 1: MyManPotnPan (21415 in chips)=20
Seat 2: DaMiJKoNtRoL (9100 in chips)=20
Seat 3: JJin91 (17160 in chips)=20
Seat 4: skonnybobo (13170 in chips)=20
Seat 5: Ninja Stax (29055 in chips)=20
MyManPotnPan: posts the ante 15
DaMiJKoNtRoL: posts the ante 15
JJin91: posts the ante 15
skonnybobo: posts the ante 15
Ninja Stax: posts the ante 15
Ninja Stax: posts small blind 60
MyManPotnPan: posts big blind 120
*** HOLE CARDS ***
Dealt to JJin91 [2s 5s]
DaMiJKoNtRoL: folds=20
JJin91: folds=20
skonnybobo: raises 120 to 240
Ninja Stax: calls 180
MyManPotnPan: calls 120
*** FLOP *** [Ts Kc 2h]
Ninja Stax: checks=20
MyManPotnPan: checks=20
skonnybobo: bets 360
Ninja Stax: folds=20
MyManPotnPan: folds=20
Uncalled bet (360) returned to skonnybobo
skonnybobo collected 795 from pot
skonnybobo: doesn't show hand=20
*** SUMMARY ***
Total pot 795 | Rake 0=20
Board [Ts Kc 2h]
Seat 1: MyManPotnPan (big blind) folded on the Flop
Seat 2: DaMiJKoNtRoL folded before Flop (didn't bet)
Seat 3: JJin91 folded before Flop (didn't bet)
Seat 4: skonnybobo (button) collected (795)
Seat 5: Ninja Stax (small blind) folded on the Flop


*********** # 47 **************
PokerStars Hand #169474666983: Tournament #1597684053, $13.50+$1.50 USD=
 Hold'em No Limit - Level V (60/120) - 2017/05/06 14:22:36 ET
Table '1597684053 5' 6-max Seat #5 is the button
Seat 1: MyManPotnPan (21160 in chips)=20
Seat 2: DaMiJKoNtRoL (9085 in chips)=20
Seat 3: JJin91 (17145 in chips)=20
Seat 4: skonnybobo (13710 in chips)=20
Seat 5: Ninja Stax (28800 in chips)=20
MyManPotnPan: posts the ante 15
DaMiJKoNtRoL: posts the ante 15
JJin91: posts the ante 15
skonnybobo: posts the ante 15
Ninja Stax: posts the ante 15
MyManPotnPan: posts small blind 60
DaMiJKoNtRoL: posts big blind 120
*** HOLE CARDS ***
Dealt to JJin91 [6d 4s]
JJin91: folds=20
skonnybobo: raises 120 to 240
Ninja Stax: folds=20
MyManPotnPan: folds=20
DaMiJKoNtRoL: folds=20
Uncalled bet (120) returned to skonnybobo
skonnybobo collected 375 from pot
skonnybobo: doesn't show hand=20
*** SUMMARY ***
Total pot 375 | Rake 0=20
Seat 1: MyManPotnPan (small blind) folded before Flop
Seat 2: DaMiJKoNtRoL (big blind) folded before Flop
Seat 3: JJin91 folded before Flop (didn't bet)
Seat 4: skonnybobo collected (375)
Seat 5: Ninja Stax (button) folded before Flop (didn't bet)


*********** # 48 **************
PokerStars Hand #169474667066: Tournament #1597684053, $13.50+$1.50 USD=
 Hold'em No Limit - Level V (60/120) - 2017/05/06 14:23:06 ET
Table '1597684053 5' 6-max Seat #1 is the button
Seat 1: MyManPotnPan (21085 in chips)=20
Seat 2: DaMiJKoNtRoL (8950 in chips)=20
Seat 3: JJin91 (17130 in chips)=20
Seat 4: skonnybobo (13950 in chips)=20
Seat 5: Ninja Stax (28785 in chips)=20
MyManPotnPan: posts the ante 15
DaMiJKoNtRoL: posts the ante 15
JJin91: posts the ante 15
skonnybobo: posts the ante 15
Ninja Stax: posts the ante 15
DaMiJKoNtRoL: posts small blind 60
JJin91: posts big blind 120
*** HOLE CARDS ***
Dealt to JJin91 [Td Jh]
skonnybobo: raises 120 to 240
Ninja Stax has timed out
Ninja Stax: folds=20
Ninja Stax is sitting out
MyManPotnPan: folds=20
DaMiJKoNtRoL: folds=20
JJin91: calls 120
*** FLOP *** [8h Ts 6h]
JJin91: bets 326
skonnybobo: folds=20
Uncalled bet (326) returned to JJin91
JJin91 collected 615 from pot
JJin91: doesn't show hand=20
*** SUMMARY ***
Total pot 615 | Rake 0=20
Board [8h Ts 6h]
Seat 1: MyManPotnPan (button) folded before Flop (didn't bet)
Seat 2: DaMiJKoNtRoL (small blind) folded before Flop
Seat 3: JJin91 (big blind) collected (615)
Seat 4: skonnybobo folded on the Flop
Seat 5: Ninja Stax folded before Flop (didn't bet)


*********** # 49 **************
PokerStars Hand #169474667234: Tournament #1597684053, $13.50+$1.50 USD=
 Hold'em No Limit - Level V (60/120) - 2017/05/06 14:24:10 ET
Table '1597684053 5' 6-max Seat #2 is the button
Seat 1: MyManPotnPan (21070 in chips)=20
Seat 2: DaMiJKoNtRoL (8875 in chips)=20
Seat 3: JJin91 (17490 in chips)=20
Seat 4: skonnybobo (13695 in chips)=20
Seat 5: Ninja Stax (28770 in chips) is sitting out
MyManPotnPan: posts the ante 15
DaMiJKoNtRoL: posts the ante 15
JJin91: posts the ante 15
skonnybobo: posts the ante 15
Ninja Stax: posts the ante 15
JJin91: posts small blind 60
skonnybobo: posts big blind 120
*** HOLE CARDS ***
Dealt to JJin91 [9h 6c]
Ninja Stax: folds=20
MyManPotnPan: folds=20
DaMiJKoNtRoL: folds=20
JJin91: folds=20
Uncalled bet (60) returned to skonnybobo
skonnybobo collected 195 from pot
skonnybobo: doesn't show hand=20
*** SUMMARY ***
Total pot 195 | Rake 0=20
Seat 1: MyManPotnPan folded before Flop (didn't bet)
Seat 2: DaMiJKoNtRoL (button) folded before Flop (didn't bet)
Seat 3: JJin91 (small blind) folded before Flop
Seat 4: skonnybobo (big blind) collected (195)
Seat 5: Ninja Stax folded before Flop (didn't bet)


*********** # 50 **************
PokerStars Hand #169474667270: Tournament #1597684053, $13.50+$1.50 USD=
 Hold'em No Limit - Level V (60/120) - 2017/05/06 14:24:21 ET
Table '1597684053 5' 6-max Seat #3 is the button
Seat 1: MyManPotnPan (21055 in chips)=20
Seat 2: DaMiJKoNtRoL (8860 in chips)=20
Seat 3: JJin91 (17415 in chips)=20
Seat 4: skonnybobo (13815 in chips)=20
Seat 5: Ninja Stax (28755 in chips) is sitting out
MyManPotnPan: posts the ante 15
DaMiJKoNtRoL: posts the ante 15
JJin91: posts the ante 15
skonnybobo: posts the ante 15
Ninja Stax: posts the ante 15
skonnybobo: posts small blind 60
Ninja Stax: posts big blind 120
*** HOLE CARDS ***
Dealt to JJin91 [Tc Th]
MyManPotnPan: folds=20
DaMiJKoNtRoL: calls 120
JJin91: raises 360 to 480
skonnybobo: folds=20
Ninja Stax: folds=20
DaMiJKoNtRoL: calls 360
*** FLOP *** [3s 8c 3h]
DaMiJKoNtRoL: checks=20
JJin91: bets 644
DaMiJKoNtRoL: folds=20
Uncalled bet (644) returned to JJin91
JJin91 collected 1215 from pot
*** SUMMARY ***
Total pot 1215 | Rake 0=20
Board [3s 8c 3h]
Seat 1: MyManPotnPan folded before Flop (didn't bet)
Seat 2: DaMiJKoNtRoL folded on the Flop
Seat 3: JJin91 (button) collected (1215)
Seat 4: skonnybobo (small blind) folded before Flop
Seat 5: Ninja Stax (big blind) folded before Flop


*********** # 51 **************
PokerStars Hand #169474667374: Tournament #1597684053, $13.50+$1.50 USD=
 Hold'em No Limit - Level V (60/120) - 2017/05/06 14:24:54 ET
Table '1597684053 8' 6-max Seat #6 is the button
Seat 1: skroob9918 (9502 in chips)=20
Seat 2: albyal420 (17035 in chips)=20
Seat 3: D_Rannn22 (37146 in chips)=20
Seat 4: JJin91 (18135 in chips)=20
Seat 6: JerseyJinx28 (10015 in chips)=20
skroob9918: posts the ante 15
albyal420: posts the ante 15
D_Rannn22: posts the ante 15
JJin91: posts the ante 15
JerseyJinx28: posts the ante 15
skroob9918: posts small blind 60
albyal420: posts big blind 120
*** HOLE CARDS ***
Dealt to JJin91 [7c Jc]
D_Rannn22: folds=20
JJin91: folds=20
JerseyJinx28: folds=20
skroob9918: folds=20
Uncalled bet (60) returned to albyal420
albyal420 collected 195 from pot
albyal420: doesn't show hand=20
*** SUMMARY ***
Total pot 195 | Rake 0=20
Seat 1: skroob9918 (small blind) folded before Flop
Seat 2: albyal420 (big blind) collected (195)
Seat 3: D_Rannn22 folded before Flop (didn't bet)
Seat 4: JJin91 folded before Flop (didn't bet)
Seat 6: JerseyJinx28 (button) folded before Flop (didn't bet)


*********** # 52 **************
PokerStars Hand #169474667403: Tournament #1597684053, $13.50+$1.50 USD=
 Hold'em No Limit - Level V (60/120) - 2017/05/06 14:25:04 ET
Table '1597684053 8' 6-max Seat #1 is the button
Seat 1: skroob9918 (9427 in chips)=20
Seat 2: albyal420 (17155 in chips)=20
Seat 3: D_Rannn22 (37131 in chips)=20
Seat 4: JJin91 (18120 in chips)=20
Seat 6: JerseyJinx28 (10000 in chips)=20
skroob9918: posts the ante 15
albyal420: posts the ante 15
D_Rannn22: posts the ante 15
JJin91: posts the ante 15
JerseyJinx28: posts the ante 15
albyal420: posts small blind 60
D_Rannn22: posts big blind 120
*** HOLE CARDS ***
Dealt to JJin91 [Th 7c]
JJin91: folds=20
JerseyJinx28: raises 300 to 420
skroob9918: calls 420
albyal420: folds=20
D_Rannn22: folds=20
*** FLOP *** [Tc Td 8h]
JerseyJinx28: checks=20
skroob9918: checks=20
*** TURN *** [Tc Td 8h] [5c]
JerseyJinx28: checks=20
skroob9918: checks=20
*** RIVER *** [Tc Td 8h 5c] [4s]
JerseyJinx28: bets 383
skroob9918: calls 383
*** SHOW DOWN ***
JerseyJinx28: shows [Ac 6h] (a pair of Tens)
skroob9918: shows [Ad Qs] (a pair of Tens - Ace+Queen kicker)
skroob9918 collected 1861 from pot
*** SUMMARY ***
Total pot 1861 | Rake 0=20
Board [Tc Td 8h 5c 4s]
Seat 1: skroob9918 (button) showed [Ad Qs] and won (1861) with a pair o=
f Tens
Seat 2: albyal420 (small blind) folded before Flop
Seat 3: D_Rannn22 (big blind) folded before Flop
Seat 4: JJin91 folded before Flop (didn't bet)
Seat 6: JerseyJinx28 showed [Ac 6h] and lost with a pair of Tens


*********** # 53 **************
PokerStars Hand #169474667482: Tournament #1597684053, $13.50+$1.50 USD=
 Hold'em No Limit - Level V (60/120) - 2017/05/06 14:25:31 ET
Table '1597684053 8' 6-max Seat #2 is the button
Seat 1: skroob9918 (10470 in chips)=20
Seat 2: albyal420 (17080 in chips)=20
Seat 3: D_Rannn22 (36996 in chips)=20
Seat 4: JJin91 (18105 in chips)=20
Seat 6: JerseyJinx28 (9182 in chips)=20
skroob9918: posts the ante 15
albyal420: posts the ante 15
D_Rannn22: posts the ante 15
JJin91: posts the ante 15
JerseyJinx28: posts the ante 15
D_Rannn22: posts small blind 60
JJin91: posts big blind 120
*** HOLE CARDS ***
Dealt to JJin91 [Th Qs]
JerseyJinx28: folds=20
skroob9918: folds=20
albyal420: folds=20
D_Rannn22: calls 60
JJin91: checks=20
*** FLOP *** [2d Ad 8h]
D_Rannn22: checks=20
JJin91: checks=20
*** TURN *** [2d Ad 8h] [Js]
D_Rannn22: bets 300
JJin91: calls 300
*** RIVER *** [2d Ad 8h Js] [Qh]
D_Rannn22: bets 458
JJin91: calls 458
*** SHOW DOWN ***
D_Rannn22: shows [Ah 3h] (a pair of Aces)
JJin91: mucks hand=20
D_Rannn22 collected 1831 from pot
*** SUMMARY ***
Total pot 1831 | Rake 0=20
Board [2d Ad 8h Js Qh]
Seat 1: skroob9918 folded before Flop (didn't bet)
Seat 2: albyal420 (button) folded before Flop (didn't bet)
Seat 3: D_Rannn22 (small blind) showed [Ah 3h] and won (1831) with a pa=
ir of Aces
Seat 4: JJin91 (big blind) mucked [Th Qs]
Seat 6: JerseyJinx28 folded before Flop (didn't bet)


*********** # 54 **************
PokerStars Hand #169474667581: Tournament #1597684053, $13.50+$1.50 USD=
 Hold'em No Limit - Level VI (75/150) - 2017/05/06 14:26:10 ET
Table '1597684053 8' 6-max Seat #3 is the button
Seat 1: skroob9918 (10455 in chips)=20
Seat 2: albyal420 (17065 in chips)=20
Seat 3: D_Rannn22 (37934 in chips)=20
Seat 4: JJin91 (17212 in chips)=20
Seat 6: JerseyJinx28 (9167 in chips)=20
skroob9918: posts the ante 20
albyal420: posts the ante 20
D_Rannn22: posts the ante 20
JJin91: posts the ante 20
JerseyJinx28: posts the ante 20
JJin91: posts small blind 75
JerseyJinx28: posts big blind 150
*** HOLE CARDS ***
Dealt to JJin91 [As 8d]
skroob9918: folds=20
albyal420: folds=20
D_Rannn22: raises 150 to 300
JJin91: calls 225
JerseyJinx28: calls 150
*** FLOP *** [7s 4h Ah]
JJin91: bets 530
JerseyJinx28: folds=20
D_Rannn22: folds=20
Uncalled bet (530) returned to JJin91
JJin91 collected 1000 from pot
JJin91: doesn't show hand=20
*** SUMMARY ***
Total pot 1000 | Rake 0=20
Board [7s 4h Ah]
Seat 1: skroob9918 folded before Flop (didn't bet)
Seat 2: albyal420 folded before Flop (didn't bet)
Seat 3: D_Rannn22 (button) folded on the Flop
Seat 4: JJin91 (small blind) collected (1000)
Seat 6: JerseyJinx28 (big blind) folded on the Flop


*********** # 55 **************
PokerStars Hand #169474667664: Tournament #1597684053, $13.50+$1.50 USD=
 Hold'em No Limit - Level VI (75/150) - 2017/05/06 14:26:37 ET
Table '1597684053 8' 6-max Seat #4 is the button
Seat 1: skroob9918 (10435 in chips)=20
Seat 2: albyal420 (17045 in chips)=20
Seat 3: D_Rannn22 (37614 in chips)=20
Seat 4: JJin91 (17892 in chips)=20
Seat 6: JerseyJinx28 (8847 in chips)=20
skroob9918: posts the ante 20
albyal420: posts the ante 20
D_Rannn22: posts the ante 20
JJin91: posts the ante 20
JerseyJinx28: posts the ante 20
JerseyJinx28: posts small blind 75
skroob9918: posts big blind 150
*** HOLE CARDS ***
Dealt to JJin91 [Tc Ts]
albyal420: calls 150
D_Rannn22: calls 150
JJin91: raises 450 to 600
JerseyJinx28: folds=20
skroob9918: folds=20
albyal420: calls 450
D_Rannn22: calls 450
*** FLOP *** [Jc 4s 5h]
albyal420: checks=20
D_Rannn22: checks=20
JJin91: bets 1126
albyal420: folds=20
D_Rannn22: folds=20
Uncalled bet (1126) returned to JJin91
JJin91 collected 2125 from pot
JJin91: doesn't show hand=20
*** SUMMARY ***
Total pot 2125 | Rake 0=20
Board [Jc 4s 5h]
Seat 1: skroob9918 (big blind) folded before Flop
Seat 2: albyal420 folded on the Flop
Seat 3: D_Rannn22 folded on the Flop
Seat 4: JJin91 (button) collected (2125)
Seat 6: JerseyJinx28 (small blind) folded before Flop


*********** # 56 **************
PokerStars Hand #169474667749: Tournament #1597684053, $13.50+$1.50 USD=
 Hold'em No Limit - Level VI (75/150) - 2017/05/06 14:27:08 ET
Table '1597684053 8' 6-max Seat #6 is the button
Seat 1: skroob9918 (10265 in chips)=20
Seat 2: albyal420 (16425 in chips)=20
Seat 3: D_Rannn22 (36994 in chips)=20
Seat 4: JJin91 (19397 in chips)=20
Seat 6: JerseyJinx28 (8752 in chips)=20
skroob9918: posts the ante 20
albyal420: posts the ante 20
D_Rannn22: posts the ante 20
JJin91: posts the ante 20
JerseyJinx28: posts the ante 20
skroob9918: posts small blind 75
albyal420: posts big blind 150
*** HOLE CARDS ***
Dealt to JJin91 [Qs 9c]
D_Rannn22: folds=20
JJin91: folds=20
JerseyJinx28: raises 225 to 375
skroob9918: calls 300
albyal420: calls 225
*** FLOP *** [3h 3d 6s]
skroob9918: checks=20
albyal420: bets 600
JerseyJinx28: raises 849 to 1449
skroob9918: folds=20
albyal420: calls 849
*** TURN *** [3h 3d 6s] [4h]
albyal420: checks=20
JerseyJinx28: checks=20
*** RIVER *** [3h 3d 6s 4h] [Jc]
albyal420: checks=20
JerseyJinx28: bets 1855
albyal420: calls 1855
*** SHOW DOWN ***
JerseyJinx28: shows [Js Tc] (two pair, Jacks and Threes)
albyal420: mucks hand=20
JerseyJinx28 collected 7833 from pot
*** SUMMARY ***
Total pot 7833 | Rake 0=20
Board [3h 3d 6s 4h Jc]
Seat 1: skroob9918 (small blind) folded on the Flop
Seat 2: albyal420 (big blind) mucked [6d 9h]
Seat 3: D_Rannn22 folded before Flop (didn't bet)
Seat 4: JJin91 folded before Flop (didn't bet)
Seat 6: JerseyJinx28 (button) showed [Js Tc] and won (7833) with two pa=
ir, Jacks and Threes


*********** # 57 **************
PokerStars Hand #169474667870: Tournament #1597684053, $13.50+$1.50 USD=
 Hold'em No Limit - Level VI (75/150) - 2017/05/06 14:27:52 ET
Table '1597684053 8' 6-max Seat #1 is the button
Seat 1: skroob9918 (9870 in chips)=20
Seat 2: albyal420 (12726 in chips)=20
Seat 3: D_Rannn22 (36974 in chips)=20
Seat 4: JJin91 (19377 in chips)=20
Seat 6: JerseyJinx28 (12886 in chips)=20
skroob9918: posts the ante 20
albyal420: posts the ante 20
D_Rannn22: posts the ante 20
JJin91: posts the ante 20
JerseyJinx28: posts the ante 20
albyal420: posts small blind 75
D_Rannn22: posts big blind 150
*** HOLE CARDS ***
Dealt to JJin91 [Ks 2s]
JJin91: folds=20
JerseyJinx28: raises 150 to 300
skroob9918: calls 300
albyal420: calls 225
D_Rannn22: calls 150
*** FLOP *** [3c 5c 3h]
albyal420: checks=20
D_Rannn22: checks=20
JerseyJinx28: checks=20
skroob9918: checks=20
*** TURN *** [3c 5c 3h] [7d]
albyal420: checks=20
D_Rannn22: bets 400
albyal420 said, "betting with nothing"
JerseyJinx28: folds=20
skroob9918: folds=20
albyal420: folds=20
Uncalled bet (400) returned to D_Rannn22
D_Rannn22 collected 1300 from pot
D_Rannn22: doesn't show hand=20
*** SUMMARY ***
Total pot 1300 | Rake 0=20
Board [3c 5c 3h 7d]
Seat 1: skroob9918 (button) folded on the Turn
Seat 2: albyal420 (small blind) folded on the Turn
Seat 3: D_Rannn22 (big blind) collected (1300)
Seat 4: JJin91 folded before Flop (didn't bet)
Seat 6: JerseyJinx28 folded on the Turn


*********** # 58 **************
PokerStars Hand #169474667994: Tournament #1597684053, $13.50+$1.50 USD=
 Hold'em No Limit - Level VI (75/150) - 2017/05/06 14:28:32 ET
Table '1597684053 8' 6-max Seat #2 is the button
Seat 1: skroob9918 (9550 in chips)=20
Seat 2: albyal420 (12406 in chips)=20
Seat 3: D_Rannn22 (37954 in chips)=20
Seat 4: JJin91 (19357 in chips)=20
Seat 6: JerseyJinx28 (12566 in chips)=20
skroob9918: posts the ante 20
albyal420: posts the ante 20
D_Rannn22: posts the ante 20
JJin91: posts the ante 20
JerseyJinx28: posts the ante 20
D_Rannn22: posts small blind 75
JJin91: posts big blind 150
*** HOLE CARDS ***
Dealt to JJin91 [Td Kd]
JerseyJinx28: folds=20
skroob9918: folds=20
albyal420: folds=20
D_Rannn22: calls 75
JJin91: checks=20
*** FLOP *** [Js 8s 9h]
albyal420 said, "jersey donk"
D_Rannn22: checks=20
JerseyJinx28 said, "like everyone else"
JJin91: checks=20
*** TURN *** [Js 8s 9h] [Ad]
D_Rannn22: checks=20
JJin91: checks=20
*** RIVER *** [Js 8s 9h Ad] [4s]
D_Rannn22: checks=20
albyal420 said, "keepbetting like that"
JJin91: bets 212
JerseyJinx28 said, "i will"
D_Rannn22: folds=20
Uncalled bet (212) returned to JJin91
JJin91 collected 400 from pot
JJin91: doesn't show hand=20
*** SUMMARY ***
Total pot 400 | Rake 0=20
Board [Js 8s 9h Ad 4s]
Seat 1: skroob9918 folded before Flop (didn't bet)
Seat 2: albyal420 (button) folded before Flop (didn't bet)
Seat 3: D_Rannn22 (small blind) folded on the River
Seat 4: JJin91 (big blind) collected (400)
Seat 6: JerseyJinx28 folded before Flop (didn't bet)


*********** # 59 **************
PokerStars Hand #169474668118: Tournament #1597684053, $13.50+$1.50 USD=
 Hold'em No Limit - Level VI (75/150) - 2017/05/06 14:29:16 ET
Table '1597684053 8' 6-max Seat #3 is the button
Seat 1: skroob9918 (9530 in chips)=20
Seat 2: albyal420 (12386 in chips)=20
Seat 3: D_Rannn22 (37784 in chips)=20
Seat 4: JJin91 (19587 in chips)=20
Seat 6: JerseyJinx28 (12546 in chips)=20
skroob9918: posts the ante 20
albyal420: posts the ante 20
D_Rannn22: posts the ante 20
JJin91: posts the ante 20
JerseyJinx28: posts the ante 20
JJin91: posts small blind 75
JerseyJinx28: posts big blind 150
*** HOLE CARDS ***
Dealt to JJin91 [Ah 7d]
skroob9918: folds=20
albyal420: raises 475 to 625
D_Rannn22: folds=20
albyal420 said, "call"
JJin91: folds=20
JerseyJinx28 said, "come get it"
JerseyJinx28: calls 475
*** FLOP *** [8h Kd 4s]
D_Rannn22 said, "lol"
JerseyJinx28: checks=20
albyal420: bets 750
JerseyJinx28: calls 750
*** TURN *** [8h Kd 4s] [Jh]
JerseyJinx28: checks=20
albyal420: bets 1500
JerseyJinx28: calls 1500
*** RIVER *** [8h Kd 4s Jh] [Qd]
JerseyJinx28: checks=20
albyal420: checks=20
*** SHOW DOWN ***
JerseyJinx28: shows [8s 2s] (a pair of Eights)
albyal420: shows [Td Tc] (a pair of Tens)
albyal420 collected 5925 from pot
*** SUMMARY ***
Total pot 5925 | Rake 0=20
Board [8h Kd 4s Jh Qd]
Seat 1: skroob9918 folded before Flop (didn't bet)
Seat 2: albyal420 showed [Td Tc] and won (5925) with a pair of Tens
Seat 3: D_Rannn22 (button) folded before Flop (didn't bet)
Seat 4: JJin91 (small blind) folded before Flop
Seat 6: JerseyJinx28 (big blind) showed [8s 2s] and lost with a pair of=
 Eights


*********** # 60 **************
PokerStars Hand #169474668219: Tournament #1597684053, $13.50+$1.50 USD=
 Hold'em No Limit - Level VI (75/150) - 2017/05/06 14:29:56 ET
Table '1597684053 8' 6-max Seat #4 is the button
Seat 1: skroob9918 (9510 in chips)=20
Seat 2: albyal420 (15416 in chips)=20
Seat 3: D_Rannn22 (37764 in chips)=20
Seat 4: JJin91 (19492 in chips)=20
Seat 6: JerseyJinx28 (9651 in chips)=20
skroob9918: posts the ante 20
albyal420: posts the ante 20
D_Rannn22: posts the ante 20
JJin91: posts the ante 20
JerseyJinx28: posts the ante 20
JerseyJinx28: posts small blind 75
skroob9918: posts big blind 150
*** HOLE CARDS ***
Dealt to JJin91 [9d Ad]
albyal420: folds=20
D_Rannn22: folds=20
albyal420 said, "bum"
JJin91: raises 300 to 450
JerseyJinx28 said, "lol"
JerseyJinx28: folds=20
skroob9918: folds=20
Uncalled bet (300) returned to JJin91
JJin91 collected 475 from pot
JJin91: doesn't show hand=20
*** SUMMARY ***
Total pot 475 | Rake 0=20
Seat 1: skroob9918 (big blind) folded before Flop
Seat 2: albyal420 folded before Flop (didn't bet)
Seat 3: D_Rannn22 folded before Flop (didn't bet)
Seat 4: JJin91 (button) collected (475)
Seat 6: JerseyJinx28 (small blind) folded before Flop


*********** # 61 **************
PokerStars Hand #169474668271: Tournament #1597684053, $13.50+$1.50 USD=
 Hold'em No Limit - Level VI (75/150) - 2017/05/06 14:30:11 ET
Table '1597684053 8' 6-max Seat #6 is the button
Seat 1: skroob9918 (9340 in chips)=20
Seat 2: albyal420 (15396 in chips)=20
Seat 3: D_Rannn22 (37744 in chips)=20
Seat 4: JJin91 (19797 in chips)=20
Seat 6: JerseyJinx28 (9556 in chips)=20
skroob9918: posts the ante 20
albyal420: posts the ante 20
D_Rannn22: posts the ante 20
JJin91: posts the ante 20
JerseyJinx28: posts the ante 20
skroob9918: posts small blind 75
albyal420: posts big blind 150
*** HOLE CARDS ***
Dealt to JJin91 [6c 4d]
D_Rannn22: calls 150
JJin91: folds=20
JerseyJinx28: raises 225 to 375
skroob9918: folds=20
albyal420: folds=20
D_Rannn22: calls 225
*** FLOP *** [Ad Qd 8s]
D_Rannn22: checks=20
JerseyJinx28: bets 376
D_Rannn22: folds=20
Uncalled bet (376) returned to JerseyJinx28
JerseyJinx28 collected 1075 from pot
JerseyJinx28: shows [6h 7s] (high card Ace)
*** SUMMARY ***
Total pot 1075 | Rake 0=20
Board [Ad Qd 8s]
Seat 1: skroob9918 (small blind) folded before Flop
Seat 2: albyal420 (big blind) folded before Flop
Seat 3: D_Rannn22 folded on the Flop
Seat 4: JJin91 folded before Flop (didn't bet)
Seat 6: JerseyJinx28 (button) collected (1075)


*********** # 62 **************
PokerStars Hand #169474668340: Tournament #1597684053, $13.50+$1.50 USD=
 Hold'em No Limit - Level VI (75/150) - 2017/05/06 14:30:36 ET
Table '1597684053 8' 6-max Seat #1 is the button
Seat 1: skroob9918 (9245 in chips)=20
Seat 2: albyal420 (15226 in chips)=20
Seat 3: D_Rannn22 (37349 in chips)=20
Seat 4: JJin91 (19777 in chips)=20
Seat 6: JerseyJinx28 (10236 in chips)=20
skroob9918: posts the ante 20
albyal420: posts the ante 20
D_Rannn22: posts the ante 20
JJin91: posts the ante 20
JerseyJinx28: posts the ante 20
albyal420: posts small blind 75
D_Rannn22: posts big blind 150
*** HOLE CARDS ***
Dealt to JJin91 [7d Qd]
JJin91: folds=20
JerseyJinx28: calls 150
albyal420 said, "your good"
skroob9918: calls 150
albyal420: folds=20
D_Rannn22: checks=20
*** FLOP *** [Jh 9h 5s]
D_Rannn22: checks=20
JerseyJinx28: checks=20
skroob9918: bets 300
D_Rannn22: calls 300
JerseyJinx28: folds=20
*** TURN *** [Jh 9h 5s] [2d]
D_Rannn22: checks=20
D_Rannn22 said, "you're*"
skroob9918: bets 400
D_Rannn22: folds=20
Uncalled bet (400) returned to skroob9918
skroob9918 collected 1225 from pot
skroob9918: doesn't show hand=20
*** SUMMARY ***
Total pot 1225 | Rake 0=20
Board [Jh 9h 5s 2d]
Seat 1: skroob9918 (button) collected (1225)
Seat 2: albyal420 (small blind) folded before Flop
Seat 3: D_Rannn22 (big blind) folded on the Turn
Seat 4: JJin91 folded before Flop (didn't bet)
Seat 6: JerseyJinx28 folded on the Flop


*********** # 63 **************
PokerStars Hand #169474668468: Tournament #1597684053, $13.50+$1.50 USD=
 Hold'em No Limit - Level VI (75/150) - 2017/05/06 14:31:23 ET
Table '1597684053 8' 6-max Seat #2 is the button
Seat 1: skroob9918 (10000 in chips)=20
Seat 2: albyal420 (15131 in chips)=20
Seat 3: D_Rannn22 (36879 in chips)=20
Seat 4: JJin91 (19757 in chips)=20
Seat 5: NancyShay (10000 in chips)=20
Seat 6: JerseyJinx28 (10066 in chips)=20
skroob9918: posts the ante 20
albyal420: posts the ante 20
D_Rannn22: posts the ante 20
JJin91: posts the ante 20
NancyShay: posts the ante 20
JerseyJinx28: posts the ante 20
D_Rannn22: posts small blind 75
JJin91: posts big blind 150
*** HOLE CARDS ***
Dealt to JJin91 [3h 4h]
NancyShay: folds=20
JerseyJinx28: raises 225 to 375
skroob9918: calls 375
albyal420: folds=20
D_Rannn22: calls 300
JJin91: calls 225
*** FLOP *** [7h 3d 4c]
D_Rannn22: bets 500
JJin91: raises 1600 to 2100
JerseyJinx28: calls 2100
skroob9918: folds=20
D_Rannn22: calls 1600
*** TURN *** [7h 3d 4c] [Td]
D_Rannn22: checks=20
JJin91: checks=20
JerseyJinx28: checks=20
*** RIVER *** [7h 3d 4c Td] [8c]
D_Rannn22: checks=20
JJin91: bets 2455
JerseyJinx28: folds=20
D_Rannn22: calls 2455
*** SHOW DOWN ***
JJin91: shows [3h 4h] (two pair, Fours and Threes)
D_Rannn22: mucks hand=20
JJin91 collected 12830 from pot
*** SUMMARY ***
Total pot 12830 | Rake 0=20
Board [7h 3d 4c Td 8c]
Seat 1: skroob9918 folded on the Flop
Seat 2: albyal420 (button) folded before Flop (didn't bet)
Seat 3: D_Rannn22 (small blind) mucked [7s Js]
Seat 4: JJin91 (big blind) showed [3h 4h] and won (12830) with two pair=
, Fours and Threes
Seat 5: NancyShay folded before Flop (didn't bet)
Seat 6: JerseyJinx28 folded on the River


*********** # 64 **************
PokerStars Hand #169474668676: Tournament #1597684053, $13.50+$1.50 USD=
 Hold'em No Limit - Level VI (75/150) - 2017/05/06 14:32:38 ET
Table '1597684053 8' 6-max Seat #3 is the button
Seat 1: skroob9918 (9605 in chips)=20
Seat 2: albyal420 (15111 in chips)=20
Seat 3: D_Rannn22 (31929 in chips)=20
Seat 4: JJin91 (27637 in chips)=20
Seat 5: NancyShay (9980 in chips)=20
Seat 6: JerseyJinx28 (7571 in chips)=20
skroob9918: posts the ante 20
albyal420: posts the ante 20
D_Rannn22: posts the ante 20
JJin91: posts the ante 20
NancyShay: posts the ante 20
JerseyJinx28: posts the ante 20
JJin91: posts small blind 75
NancyShay: posts big blind 150
*** HOLE CARDS ***
Dealt to JJin91 [2s Ac]
JerseyJinx28: raises 225 to 375
skroob9918: folds=20
albyal420: raises 1095 to 1470
D_Rannn22: folds=20
JJin91: folds=20
NancyShay: folds=20
JerseyJinx28: calls 1095
*** FLOP *** [4s Kh 6s]
JerseyJinx28: checks=20
albyal420: bets 1650
JerseyJinx28: raises 4431 to 6081 and is all-in
albyal420: calls 4431
*** TURN *** [4s Kh 6s] [8d]
*** RIVER *** [4s Kh 6s 8d] [5d]
*** SHOW DOWN ***
JerseyJinx28: shows [4c 6h] (two pair, Sixes and Fours)
albyal420: shows [Qh Qd] (a pair of Queens)
JerseyJinx28 collected 15447 from pot
*** SUMMARY ***
Total pot 15447 | Rake 0=20
Board [4s Kh 6s 8d 5d]
Seat 1: skroob9918 folded before Flop (didn't bet)
Seat 2: albyal420 showed [Qh Qd] and lost with a pair of Queens
Seat 3: D_Rannn22 (button) folded before Flop (didn't bet)
Seat 4: JJin91 (small blind) folded before Flop
Seat 5: NancyShay (big blind) folded before Flop
Seat 6: JerseyJinx28 showed [4c 6h] and won (15447) with two pair, Sixe=
s and Fours


*********** # 65 **************
PokerStars Hand #169474668741: Tournament #1597684053, $13.50+$1.50 USD=
 Hold'em No Limit - Level VI (75/150) - 2017/05/06 14:33:03 ET
Table '1597684053 8' 6-max Seat #4 is the button
Seat 1: skroob9918 (9585 in chips)=20
Seat 2: albyal420 (7540 in chips)=20
Seat 3: D_Rannn22 (31909 in chips)=20
Seat 4: JJin91 (27542 in chips)=20
Seat 5: NancyShay (9810 in chips)=20
Seat 6: JerseyJinx28 (15447 in chips)=20
skroob9918: posts the ante 20
albyal420: posts the ante 20
D_Rannn22: posts the ante 20
JJin91: posts the ante 20
NancyShay: posts the ante 20
JerseyJinx28: posts the ante 20
NancyShay: posts small blind 75
JerseyJinx28: posts big blind 150
*** HOLE CARDS ***
Dealt to JJin91 [2c Ks]
JerseyJinx28 said, "ty"
skroob9918: folds=20
albyal420: calls 150
D_Rannn22: folds=20
JJin91: folds=20
NancyShay: folds=20
JerseyJinx28 said, "give me rest"
JerseyJinx28: checks=20
*** FLOP *** [Ad 7h 6c]
albyal420 said, "yw donk"
JerseyJinx28: checks=20
albyal420: bets 450
JerseyJinx28: folds=20
Uncalled bet (450) returned to albyal420
albyal420 collected 495 from pot
albyal420: doesn't show hand=20
*** SUMMARY ***
Total pot 495 | Rake 0=20
Board [Ad 7h 6c]
Seat 1: skroob9918 folded before Flop (didn't bet)
Seat 2: albyal420 collected (495)
Seat 3: D_Rannn22 folded before Flop (didn't bet)
Seat 4: JJin91 (button) folded before Flop (didn't bet)
Seat 5: NancyShay (small blind) folded before Flop
Seat 6: JerseyJinx28 (big blind) folded on the Flop


*********** # 66 **************
PokerStars Hand #169474668800: Tournament #1597684053, $13.50+$1.50 USD=
 Hold'em No Limit - Level VI (75/150) - 2017/05/06 14:33:24 ET
Table '1597684053 8' 6-max Seat #5 is the button
Seat 1: skroob9918 (9565 in chips)=20
Seat 2: albyal420 (7865 in chips)=20
Seat 3: D_Rannn22 (31889 in chips)=20
Seat 4: JJin91 (27522 in chips)=20
Seat 5: NancyShay (9715 in chips)=20
Seat 6: JerseyJinx28 (15277 in chips)=20
skroob9918: posts the ante 20
albyal420: posts the ante 20
D_Rannn22: posts the ante 20
JJin91: posts the ante 20
NancyShay: posts the ante 20
JerseyJinx28: posts the ante 20
JerseyJinx28: posts small blind 75
skroob9918: posts big blind 150
*** HOLE CARDS ***
Dealt to JJin91 [Tc As]
albyal420: raises 495 to 645
D_Rannn22: folds=20
JJin91: folds=20
NancyShay: folds=20
JerseyJinx28: folds=20
skroob9918: folds=20
Uncalled bet (495) returned to albyal420
albyal420 collected 495 from pot
albyal420: doesn't show hand=20
*** SUMMARY ***
Total pot 495 | Rake 0=20
Seat 1: skroob9918 (big blind) folded before Flop
Seat 2: albyal420 collected (495)
Seat 3: D_Rannn22 folded before Flop (didn't bet)
Seat 4: JJin91 folded before Flop (didn't bet)
Seat 5: NancyShay (button) folded before Flop (didn't bet)
Seat 6: JerseyJinx28 (small blind) folded before Flop


*********** # 67 **************
PokerStars Hand #169474668835: Tournament #1597684053, $13.50+$1.50 USD=
 Hold'em No Limit - Level VI (75/150) - 2017/05/06 14:33:36 ET
Table '1597684053 8' 6-max Seat #6 is the button
Seat 1: skroob9918 (9395 in chips)=20
Seat 2: albyal420 (8190 in chips)=20
Seat 3: D_Rannn22 (31869 in chips)=20
Seat 4: JJin91 (27502 in chips)=20
Seat 5: NancyShay (9695 in chips)=20
Seat 6: JerseyJinx28 (15182 in chips)=20
skroob9918: posts the ante 20
albyal420: posts the ante 20
D_Rannn22: posts the ante 20
JJin91: posts the ante 20
NancyShay: posts the ante 20
JerseyJinx28: posts the ante 20
skroob9918: posts small blind 75
albyal420: posts big blind 150
*** HOLE CARDS ***
Dealt to JJin91 [Js Kc]
D_Rannn22: calls 150
JJin91: calls 150
NancyShay: folds=20
JerseyJinx28: raises 225 to 375
skroob9918: folds=20
albyal420: calls 225
D_Rannn22: calls 225
JJin91: calls 225
*** FLOP *** [3h Tc Ac]
albyal420: checks=20
D_Rannn22: checks=20
JJin91: checks=20
JerseyJinx28: checks=20
*** TURN *** [3h Tc Ac] [2h]
albyal420: checks=20
D_Rannn22: checks=20
JJin91: checks=20
JerseyJinx28: bets 593
albyal420: folds=20
D_Rannn22: calls 593
JJin91: folds=20
*** RIVER *** [3h Tc Ac 2h] [4h]
D_Rannn22: bets 1441
JerseyJinx28: folds=20
Uncalled bet (1441) returned to D_Rannn22
D_Rannn22 collected 2881 from pot
D_Rannn22: doesn't show hand=20
*** SUMMARY ***
Total pot 2881 | Rake 0=20
Board [3h Tc Ac 2h 4h]
Seat 1: skroob9918 (small blind) folded before Flop
Seat 2: albyal420 (big blind) folded on the Turn
Seat 3: D_Rannn22 collected (2881)
Seat 4: JJin91 folded on the Turn
Seat 5: NancyShay folded before Flop (didn't bet)
Seat 6: JerseyJinx28 (button) folded on the River


*********** # 68 **************
PokerStars Hand #169474669009: Tournament #1597684053, $13.50+$1.50 USD=
 Hold'em No Limit - Level VI (75/150) - 2017/05/06 14:34:31 ET
Table '1597684053 8' 6-max Seat #1 is the button
Seat 1: skroob9918 (9300 in chips)=20
Seat 2: albyal420 (7795 in chips)=20
Seat 3: D_Rannn22 (33762 in chips)=20
Seat 4: JJin91 (27107 in chips)=20
Seat 5: NancyShay (9675 in chips)=20
Seat 6: JerseyJinx28 (14194 in chips)=20
skroob9918: posts the ante 20
albyal420: posts the ante 20
D_Rannn22: posts the ante 20
JJin91: posts the ante 20
NancyShay: posts the ante 20
JerseyJinx28: posts the ante 20
albyal420: posts small blind 75
D_Rannn22: posts big blind 150
*** HOLE CARDS ***
Dealt to JJin91 [8h 4h]
JJin91: folds=20
NancyShay: calls 150
JerseyJinx28: calls 150
skroob9918: raises 400 to 550
albyal420: folds=20
D_Rannn22: folds=20
NancyShay: calls 400
JerseyJinx28: calls 400
*** FLOP *** [6d Ks Ad]
NancyShay: checks=20
JerseyJinx28: checks=20
skroob9918: bets 750
NancyShay: folds=20
JerseyJinx28: calls 750
*** TURN *** [6d Ks Ad] [6c]
JerseyJinx28: checks=20
skroob9918: bets 1200
JerseyJinx28: calls 1200
*** RIVER *** [6d Ks Ad 6c] [Ac]
JerseyJinx28: checks=20
skroob9918: bets 1500
JerseyJinx28: calls 1500
*** SHOW DOWN ***
skroob9918: shows [Qs Ah] (a full house, Aces full of Sixes)
JerseyJinx28: mucks hand=20
skroob9918 collected 8895 from pot
*** SUMMARY ***
Total pot 8895 | Rake 0=20
Board [6d Ks Ad 6c Ac]
Seat 1: skroob9918 (button) showed [Qs Ah] and won (8895) with a full h=
ouse, Aces full of Sixes
Seat 2: albyal420 (small blind) folded before Flop
Seat 3: D_Rannn22 (big blind) folded before Flop
Seat 4: JJin91 folded before Flop (didn't bet)
Seat 5: NancyShay folded on the Flop
Seat 6: JerseyJinx28 mucked [Kc Qd]


*********** # 69 **************
PokerStars Hand #169474669151: Tournament #1597684053, $13.50+$1.50 USD=
 Hold'em No Limit - Level VI (75/150) - 2017/05/06 14:35:21 ET
Table '1597684053 8' 6-max Seat #2 is the button
Seat 1: skroob9918 (14175 in chips)=20
Seat 2: albyal420 (7700 in chips)=20
Seat 3: D_Rannn22 (33592 in chips)=20
Seat 4: JJin91 (27087 in chips)=20
Seat 5: NancyShay (9105 in chips)=20
Seat 6: JerseyJinx28 (10174 in chips)=20
skroob9918: posts the ante 20
albyal420: posts the ante 20
D_Rannn22: posts the ante 20
JJin91: posts the ante 20
NancyShay: posts the ante 20
JerseyJinx28: posts the ante 20
D_Rannn22: posts small blind 75
JJin91: posts big blind 150
*** HOLE CARDS ***
Dealt to JJin91 [Td Ah]
albyal420 said, "lol"
NancyShay: calls 150
JerseyJinx28: raises 225 to 375
skroob9918: folds=20
albyal420: raises 1245 to 1620
JerseyJinx28 said, "had king"
D_Rannn22: folds=20
JerseyJinx28 said, "2 aces"
JJin91: folds=20
NancyShay: calls 1470
JerseyJinx28 said, "thought he didnt have it"
JerseyJinx28 said, "was wrong"
JerseyJinx28: calls 1245
*** FLOP *** [As Qd 5d]
NancyShay: checks=20
JerseyJinx28: checks=20
albyal420: checks=20
*** TURN *** [As Qd 5d] [2c]
NancyShay: checks=20
JerseyJinx28: checks=20
albyal420: bets 2100
NancyShay: folds=20
JerseyJinx28: calls 2100
*** RIVER *** [As Qd 5d 2c] [9d]
JerseyJinx28: checks=20
albyal420: bets 3960 and is all-in
JerseyJinx28: calls 3960
*** SHOW DOWN ***
albyal420: shows [Qh Qs] (three of a kind, Queens)
JerseyJinx28: shows [5c 6c] (a pair of Fives)
albyal420 collected 17325 from pot
JerseyJinx28 said, "lol"
JerseyJinx28 said, "nh"
*** SUMMARY ***
Total pot 17325 | Rake 0=20
Board [As Qd 5d 2c 9d]
Seat 1: skroob9918 folded before Flop (didn't bet)
Seat 2: albyal420 (button) showed [Qh Qs] and won (17325) with three of=
 a kind, Queens
Seat 3: D_Rannn22 (small blind) folded before Flop
Seat 4: JJin91 (big blind) folded before Flop
Seat 5: NancyShay folded on the Turn
Seat 6: JerseyJinx28 showed [5c 6c] and lost with a pair of Fives


*********** # 70 **************
PokerStars Hand #169474669282: Tournament #1597684053, $13.50+$1.50 USD=
 Hold'em No Limit - Level VII (100/200) - 2017/05/06 14:36:13 ET
Table '1597684053 8' 6-max Seat #3 is the button
Seat 1: skroob9918 (14155 in chips)=20
Seat 2: albyal420 (17325 in chips)=20
Seat 3: D_Rannn22 (33497 in chips)=20
Seat 4: JJin91 (26917 in chips)=20
Seat 5: NancyShay (7465 in chips)=20
Seat 6: JerseyJinx28 (2474 in chips)=20
skroob9918: posts the ante 25
albyal420: posts the ante 25
D_Rannn22: posts the ante 25
JJin91: posts the ante 25
NancyShay: posts the ante 25
JerseyJinx28: posts the ante 25
JJin91: posts small blind 100
NancyShay: posts big blind 200
*** HOLE CARDS ***
Dealt to JJin91 [7c Tc]
JerseyJinx28: folds=20
albyal420 said, "lol donk"
skroob9918: calls 200
albyal420: folds=20
D_Rannn22: folds=20
JJin91: calls 100
NancyShay: checks=20
*** FLOP *** [Ac 6s 7d]
D_Rannn22 said, "lol"
JJin91: checks=20
NancyShay: checks=20
skroob9918: bets 400
JerseyJinx28 said, "only did it because i want your chips"
JerseyJinx28 said, "lol"
JerseyJinx28 said, "nh little boy"
JJin91: calls 400
NancyShay: calls 400
*** TURN *** [Ac 6s 7d] [Ks]
JJin91: checks=20
NancyShay: checks=20
skroob9918: checks=20
*** RIVER *** [Ac 6s 7d Ks] [3c]
JJin91: checks=20
NancyShay: checks=20
albyal420 said, "ty homo"
skroob9918: bets 1200
JerseyJinx28 said, "lol"
JJin91: folds=20
NancyShay: folds=20
Uncalled bet (1200) returned to skroob9918
skroob9918 collected 1950 from pot
skroob9918: doesn't show hand=20
*** SUMMARY ***
Total pot 1950 | Rake 0=20
Board [Ac 6s 7d Ks 3c]
Seat 1: skroob9918 collected (1950)
Seat 2: albyal420 folded before Flop (didn't bet)
Seat 3: D_Rannn22 (button) folded before Flop (didn't bet)
Seat 4: JJin91 (small blind) folded on the River
Seat 5: NancyShay (big blind) folded on the River
Seat 6: JerseyJinx28 folded before Flop (didn't bet)


*********** # 71 **************
PokerStars Hand #169474669468: Tournament #1597684053, $13.50+$1.50 USD=
 Hold'em No Limit - Level VII (100/200) - 2017/05/06 14:37:20 ET
Table '1597684053 8' 6-max Seat #4 is the button
Seat 1: skroob9918 (15480 in chips)=20
Seat 2: albyal420 (17300 in chips)=20
Seat 3: D_Rannn22 (33472 in chips)=20
Seat 4: JJin91 (26292 in chips)=20
Seat 5: NancyShay (6840 in chips)=20
Seat 6: JerseyJinx28 (2449 in chips)=20
skroob9918: posts the ante 25
albyal420: posts the ante 25
D_Rannn22: posts the ante 25
JJin91: posts the ante 25
NancyShay: posts the ante 25
JerseyJinx28: posts the ante 25
NancyShay: posts small blind 100
JerseyJinx28: posts big blind 200
*** HOLE CARDS ***
Dealt to JJin91 [3d 8h]
skroob9918: calls 200
albyal420: calls 200
D_Rannn22: folds=20
JJin91: folds=20
NancyShay: calls 100
JerseyJinx28: raises 2224 to 2424 and is all-in
skroob9918: folds=20
albyal420: folds=20
NancyShay: folds=20
Uncalled bet (2224) returned to JerseyJinx28
JerseyJinx28 collected 950 from pot
*** SUMMARY ***
Total pot 950 | Rake 0=20
Seat 1: skroob9918 folded before Flop
Seat 2: albyal420 folded before Flop
Seat 3: D_Rannn22 folded before Flop (didn't bet)
Seat 4: JJin91 (button) folded before Flop (didn't bet)
Seat 5: NancyShay (small blind) folded before Flop
Seat 6: JerseyJinx28 (big blind) collected (950)


*********** # 72 **************
PokerStars Hand #169474669522: Tournament #1597684053, $13.50+$1.50 USD=
 Hold'em No Limit - Level VII (100/200) - 2017/05/06 14:37:40 ET
Table '1597684053 8' 6-max Seat #5 is the button
Seat 1: skroob9918 (15255 in chips)=20
Seat 2: albyal420 (17075 in chips)=20
Seat 3: D_Rannn22 (33447 in chips)=20
Seat 4: JJin91 (26267 in chips)=20
Seat 5: NancyShay (6615 in chips)=20
Seat 6: JerseyJinx28 (3174 in chips)=20
skroob9918: posts the ante 25
albyal420: posts the ante 25
D_Rannn22: posts the ante 25
JJin91: posts the ante 25
NancyShay: posts the ante 25
JerseyJinx28: posts the ante 25
JerseyJinx28: posts small blind 100
skroob9918: posts big blind 200
*** HOLE CARDS ***
Dealt to JJin91 [Ks Qh]
albyal420: folds=20
D_Rannn22: folds=20
JJin91: raises 400 to 600
NancyShay: folds=20
JerseyJinx28: calls 500
skroob9918: folds=20
*** FLOP *** [Qd 2c 8h]
JerseyJinx28: checks=20
JJin91: bets 25642 and is all-in
JerseyJinx28: folds=20
Uncalled bet (25642) returned to JJin91
JJin91 collected 1550 from pot
JJin91: doesn't show hand=20
*** SUMMARY ***
Total pot 1550 | Rake 0=20
Board [Qd 2c 8h]
Seat 1: skroob9918 (big blind) folded before Flop
Seat 2: albyal420 folded before Flop (didn't bet)
Seat 3: D_Rannn22 folded before Flop (didn't bet)
Seat 4: JJin91 collected (1550)
Seat 5: NancyShay (button) folded before Flop (didn't bet)
Seat 6: JerseyJinx28 (small blind) folded on the Flop


*********** # 73 **************
PokerStars Hand #169474669612: Tournament #1597684053, $13.50+$1.50 USD=
 Hold'em No Limit - Level VII (100/200) - 2017/05/06 14:38:08 ET
Table '1597684053 8' 6-max Seat #6 is the button
Seat 1: skroob9918 (15030 in chips)=20
Seat 2: albyal420 (17050 in chips)=20
Seat 3: D_Rannn22 (33422 in chips)=20
Seat 4: JJin91 (27192 in chips)=20
Seat 5: NancyShay (6590 in chips)=20
Seat 6: JerseyJinx28 (2549 in chips)=20
skroob9918: posts the ante 25
albyal420: posts the ante 25
D_Rannn22: posts the ante 25
JJin91: posts the ante 25
NancyShay: posts the ante 25
JerseyJinx28: posts the ante 25
skroob9918: posts small blind 100
albyal420: posts big blind 200
*** HOLE CARDS ***
Dealt to JJin91 [Qh 2s]
albyal420 said, "bye donk"
D_Rannn22: folds=20
JJin91: folds=20
NancyShay: calls 200
JerseyJinx28 said, "rebuy son"
JerseyJinx28: raises 2324 to 2524 and is all-in
skroob9918: folds=20
albyal420: folds=20
NancyShay: folds=20
Uncalled bet (2324) returned to JerseyJinx28
JerseyJinx28 collected 850 from pot
JerseyJinx28: doesn't show hand=20
*** SUMMARY ***
Total pot 850 | Rake 0=20
Seat 1: skroob9918 (small blind) folded before Flop
Seat 2: albyal420 (big blind) folded before Flop
Seat 3: D_Rannn22 folded before Flop (didn't bet)
Seat 4: JJin91 folded before Flop (didn't bet)
Seat 5: NancyShay folded before Flop
Seat 6: JerseyJinx28 (button) collected (850)


*********** # 74 **************
PokerStars Hand #169474669656: Tournament #1597684053, $13.50+$1.50 USD=
 Hold'em No Limit - Level VII (100/200) - 2017/05/06 14:38:25 ET
Table '1597684053 8' 6-max Seat #1 is the button
Seat 1: skroob9918 (14905 in chips)=20
Seat 2: albyal420 (16825 in chips)=20
Seat 3: D_Rannn22 (33397 in chips)=20
Seat 4: JJin91 (27167 in chips)=20
Seat 5: NancyShay (6365 in chips)=20
Seat 6: JerseyJinx28 (3174 in chips)=20
skroob9918: posts the ante 25
albyal420: posts the ante 25
D_Rannn22: posts the ante 25
JJin91: posts the ante 25
NancyShay: posts the ante 25
JerseyJinx28: posts the ante 25
albyal420: posts small blind 100
D_Rannn22: posts big blind 200
*** HOLE CARDS ***
Dealt to JJin91 [Js Jh]
JJin91: raises 400 to 600
NancyShay: folds=20
JerseyJinx28: raises 2549 to 3149 and is all-in
skroob9918: folds=20
albyal420: folds=20
D_Rannn22: folds=20
JJin91: calls 2549
*** FLOP *** [3d Td 6h]
*** TURN *** [3d Td 6h] [4s]
*** RIVER *** [3d Td 6h 4s] [Ac]
*** SHOW DOWN ***
JJin91: shows [Js Jh] (a pair of Jacks)
JerseyJinx28: shows [9s Qs] (high card Ace)
JJin91 collected 6748 from pot
JerseyJinx28 finished the tournament in 86th place
*** SUMMARY ***
Total pot 6748 | Rake 0=20
Board [3d Td 6h 4s Ac]
Seat 1: skroob9918 (button) folded before Flop (didn't bet)
Seat 2: albyal420 (small blind) folded before Flop
Seat 3: D_Rannn22 (big blind) folded before Flop
Seat 4: JJin91 showed [Js Jh] and won (6748) with a pair of Jacks
Seat 5: NancyShay folded before Flop (didn't bet)
Seat 6: JerseyJinx28 showed [9s Qs] and lost with high card Ace


*********** # 75 **************
PokerStars Hand #169474669723: Tournament #1597684053, $13.50+$1.50 USD=
 Hold'em No Limit - Level VII (100/200) - 2017/05/06 14:38:48 ET
Table '1597684053 8' 6-max Seat #2 is the button
Seat 1: skroob9918 (14880 in chips)=20
Seat 2: albyal420 (16700 in chips)=20
Seat 3: D_Rannn22 (33172 in chips)=20
Seat 4: JJin91 (30741 in chips)=20
Seat 5: NancyShay (6340 in chips)=20
skroob9918: posts the ante 25
albyal420: posts the ante 25
D_Rannn22: posts the ante 25
JJin91: posts the ante 25
NancyShay: posts the ante 25
D_Rannn22: posts small blind 100
JJin91: posts big blind 200
*** HOLE CARDS ***
Dealt to JJin91 [7d Td]
NancyShay: folds=20
skroob9918: folds=20
albyal420: calls 200
D_Rannn22: folds=20
JJin91: checks=20
*** FLOP *** [8c 4s 2h]
JJin91: checks=20
albyal420: bets 400
JJin91: folds=20
Uncalled bet (400) returned to albyal420
albyal420 collected 625 from pot
albyal420: doesn't show hand=20
*** SUMMARY ***
Total pot 625 | Rake 0=20
Board [8c 4s 2h]
Seat 1: skroob9918 folded before Flop (didn't bet)
Seat 2: albyal420 (button) collected (625)
Seat 3: D_Rannn22 (small blind) folded before Flop
Seat 4: JJin91 (big blind) folded on the Flop
Seat 5: NancyShay folded before Flop (didn't bet)


*********** # 76 **************
PokerStars Hand #169474669772: Tournament #1597684053, $13.50+$1.50 USD=
 Hold'em No Limit - Level VII (100/200) - 2017/05/06 14:39:06 ET
Table '1597684053 8' 6-max Seat #3 is the button
Seat 1: skroob9918 (14855 in chips)=20
Seat 2: albyal420 (17100 in chips)=20
Seat 3: D_Rannn22 (33047 in chips)=20
Seat 4: JJin91 (30516 in chips)=20
Seat 5: NancyShay (6315 in chips)=20
skroob9918: posts the ante 25
albyal420: posts the ante 25
D_Rannn22: posts the ante 25
JJin91: posts the ante 25
NancyShay: posts the ante 25
JJin91: posts small blind 100
NancyShay: posts big blind 200
*** HOLE CARDS ***
Dealt to JJin91 [Qd 5c]
skroob9918: folds=20
albyal420: folds=20
D_Rannn22: calls 200
JJin91: folds=20
NancyShay: checks=20
*** FLOP *** [Ks 3d Td]
NancyShay: checks=20
D_Rannn22: bets 200
NancyShay: folds=20
Uncalled bet (200) returned to D_Rannn22
D_Rannn22 collected 625 from pot
D_Rannn22: doesn't show hand=20
*** SUMMARY ***
Total pot 625 | Rake 0=20
Board [Ks 3d Td]
Seat 1: skroob9918 folded before Flop (didn't bet)
Seat 2: albyal420 folded before Flop (didn't bet)
Seat 3: D_Rannn22 (button) collected (625)
Seat 4: JJin91 (small blind) folded before Flop
Seat 5: NancyShay (big blind) folded on the Flop


*********** # 77 **************
PokerStars Hand #169474669866: Tournament #1597684053, $13.50+$1.50 USD=
 Hold'em No Limit - Level VII (100/200) - 2017/05/06 14:39:36 ET
Table '1597684053 8' 6-max Seat #4 is the button
Seat 1: skroob9918 (14830 in chips)=20
Seat 2: albyal420 (17075 in chips)=20
Seat 3: D_Rannn22 (33447 in chips)=20
Seat 4: JJin91 (30391 in chips)=20
Seat 5: NancyShay (6090 in chips)=20
Seat 6: deeeeeeeeez (10000 in chips)=20
skroob9918: posts the ante 25
albyal420: posts the ante 25
D_Rannn22: posts the ante 25
JJin91: posts the ante 25
NancyShay: posts the ante 25
deeeeeeeeez: posts the ante 25
NancyShay: posts small blind 100
deeeeeeeeez: posts big blind 200
*** HOLE CARDS ***
Dealt to JJin91 [Ad Qh]
skroob9918: folds=20
albyal420: raises 200 to 400
D_Rannn22: calls 400
JJin91: calls 400
NancyShay: folds=20
deeeeeeeeez: calls 200
*** FLOP *** [7h Tc 4d]
deeeeeeeeez: checks=20
albyal420: bets 1800
D_Rannn22: calls 1800
JJin91: calls 1800
deeeeeeeeez: raises 7775 to 9575 and is all-in
albyal420: raises 7075 to 16650 and is all-in
D_Rannn22: folds=20
JJin91: folds=20
Uncalled bet (7075) returned to albyal420
*** TURN *** [7h Tc 4d] [Jh]
*** RIVER *** [7h Tc 4d Jh] [4c]
*** SHOW DOWN ***
deeeeeeeeez: shows [Qs Td] (two pair, Tens and Fours)
albyal420: shows [Jd Th] (two pair, Jacks and Tens)
albyal420 collected 24600 from pot
deeeeeeeeez finished the tournament in 84th place
*** SUMMARY ***
Total pot 24600 | Rake 0=20
Board [7h Tc 4d Jh 4c]
Seat 1: skroob9918 folded before Flop (didn't bet)
Seat 2: albyal420 showed [Jd Th] and won (24600) with two pair, Jacks a=
nd Tens
Seat 3: D_Rannn22 folded on the Flop
Seat 4: JJin91 (button) folded on the Flop
Seat 5: NancyShay (small blind) folded before Flop
Seat 6: deeeeeeeeez (big blind) showed [Qs Td] and lost with two pair, =
Tens and Fours


*********** # 78 **************
PokerStars Hand #169475428711: Tournament #1597684053, $13.50+$1.50 USD=
 Hold'em No Limit - Level VII (100/200) - 2017/05/06 14:40:26 ET
Table '1597684053 8' 6-max Seat #5 is the button
Seat 1: skroob9918 (14805 in chips)=20
Seat 2: albyal420 (31675 in chips)=20
Seat 3: D_Rannn22 (31222 in chips)=20
Seat 4: JJin91 (28166 in chips)=20
Seat 5: NancyShay (5965 in chips)=20
skroob9918: posts the ante 25
albyal420: posts the ante 25
D_Rannn22: posts the ante 25
JJin91: posts the ante 25
NancyShay: posts the ante 25
skroob9918: posts small blind 100
albyal420: posts big blind 200
*** HOLE CARDS ***
Dealt to JJin91 [Td Ah]
D_Rannn22: folds=20
JJin91: raises 238 to 438
NancyShay: folds=20
skroob9918: folds=20
albyal420: calls 238
*** FLOP *** [5d 3c 9c]
albyal420: checks=20
JJin91: bets 584
albyal420: calls 584
*** TURN *** [5d 3c 9c] [2d]
albyal420: checks=20
JJin91: checks=20
*** RIVER *** [5d 3c 9c 2d] [Kd]
albyal420: bets 2200
JJin91: folds=20
Uncalled bet (2200) returned to albyal420
albyal420 collected 2269 from pot
albyal420: doesn't show hand=20
*** SUMMARY ***
Total pot 2269 | Rake 0=20
Board [5d 3c 9c 2d Kd]
Seat 1: skroob9918 (small blind) folded before Flop
Seat 2: albyal420 (big blind) collected (2269)
Seat 3: D_Rannn22 folded before Flop (didn't bet)
Seat 4: JJin91 folded on the River
Seat 5: NancyShay (button) folded before Flop (didn't bet)


*********** # 79 **************
PokerStars Hand #169475428820: Tournament #1597684053, $13.50+$1.50 USD=
 Hold'em No Limit - Level VII (100/200) - 2017/05/06 14:41:01 ET
Table '1597684053 8' 6-max Seat #1 is the button
Seat 1: skroob9918 (14680 in chips)=20
Seat 2: albyal420 (32897 in chips)=20
Seat 3: D_Rannn22 (31197 in chips)=20
Seat 4: JJin91 (27119 in chips)=20
Seat 5: NancyShay (5940 in chips)=20
skroob9918: posts the ante 25
albyal420: posts the ante 25
D_Rannn22: posts the ante 25
JJin91: posts the ante 25
NancyShay: posts the ante 25
albyal420: posts small blind 100
D_Rannn22: posts big blind 200
*** HOLE CARDS ***
Dealt to JJin91 [8d 9d]
JJin91: raises 238 to 438
NancyShay: folds=20
skroob9918: folds=20
albyal420: folds=20
D_Rannn22: calls 238
*** FLOP *** [Qd Jd 2d]
D_Rannn22: checks=20
JJin91: checks=20
*** TURN *** [Qd Jd 2d] [9c]
D_Rannn22: bets 400
JJin91: calls 400
*** RIVER *** [Qd Jd 2d 9c] [8s]
D_Rannn22: bets 951
JJin91: calls 951
*** SHOW DOWN ***
D_Rannn22: shows [7d Tc] (a straight, Eight to Queen)
JJin91: shows [8d 9d] (a flush, Queen high)
JJin91 collected 3803 from pot
*** SUMMARY ***
Total pot 3803 | Rake 0=20
Board [Qd Jd 2d 9c 8s]
Seat 1: skroob9918 (button) folded before Flop (didn't bet)
Seat 2: albyal420 (small blind) folded before Flop
Seat 3: D_Rannn22 (big blind) showed [7d Tc] and lost with a straight, =
Eight to Queen
Seat 4: JJin91 showed [8d 9d] and won (3803) with a flush, Queen high
Seat 5: NancyShay folded before Flop (didn't bet)


*********** # 80 **************
PokerStars Hand #169475428952: Tournament #1597684053, $13.50+$1.50 USD=
 Hold'em No Limit - Level VII (100/200) - 2017/05/06 14:41:48 ET
Table '1597684053 8' 6-max Seat #2 is the button
Seat 1: skroob9918 (14655 in chips)=20
Seat 2: albyal420 (32772 in chips)=20
Seat 3: D_Rannn22 (29383 in chips)=20
Seat 4: JJin91 (29108 in chips)=20
Seat 5: NancyShay (5915 in chips)=20
skroob9918: posts the ante 25
albyal420: posts the ante 25
D_Rannn22: posts the ante 25
JJin91: posts the ante 25
NancyShay: posts the ante 25
D_Rannn22: posts small blind 100
JJin91: posts big blind 200
*** HOLE CARDS ***
Dealt to JJin91 [8c 2h]
NancyShay: folds=20
skroob9918: folds=20
albyal420: folds=20
D_Rannn22: calls 100
JJin91: checks=20
*** FLOP *** [3d 9d 5s]
D_Rannn22: checks=20
JJin91: checks=20
*** TURN *** [3d 9d 5s] [8s]
D_Rannn22: checks=20
JJin91: bets 278
D_Rannn22: folds=20
Uncalled bet (278) returned to JJin91
JJin91 collected 525 from pot
JJin91: doesn't show hand=20
*** SUMMARY ***
Total pot 525 | Rake 0=20
Board [3d 9d 5s 8s]
Seat 1: skroob9918 folded before Flop (didn't bet)
Seat 2: albyal420 (button) folded before Flop (didn't bet)
Seat 3: D_Rannn22 (small blind) folded on the Turn
Seat 4: JJin91 (big blind) collected (525)
Seat 5: NancyShay folded before Flop (didn't bet)


*********** # 81 **************
PokerStars Hand #169475429021: Tournament #1597684053, $13.50+$1.50 USD=
 Hold'em No Limit - Level VII (100/200) - 2017/05/06 14:42:13 ET
Table '1597684053 8' 6-max Seat #3 is the button
Seat 1: skroob9918 (14630 in chips)=20
Seat 2: albyal420 (32747 in chips)=20
Seat 3: D_Rannn22 (29158 in chips)=20
Seat 4: JJin91 (29408 in chips)=20
Seat 5: NancyShay (5890 in chips)=20
skroob9918: posts the ante 25
albyal420: posts the ante 25
D_Rannn22: posts the ante 25
JJin91: posts the ante 25
NancyShay: posts the ante 25
JJin91: posts small blind 100
NancyShay: posts big blind 200
*** HOLE CARDS ***
Dealt to JJin91 [4c Qs]
skroob9918: folds=20
albyal420: raises 200 to 400
D_Rannn22: calls 400
JJin91: folds=20
NancyShay: calls 200
*** FLOP *** [5s 3c Ac]
NancyShay: checks=20
albyal420: bets 800
D_Rannn22: calls 800
NancyShay: calls 800
*** TURN *** [5s 3c Ac] [2h]
NancyShay: checks=20
albyal420: checks=20
D_Rannn22: bets 3825
NancyShay: calls 3825
albyal420: folds=20
*** RIVER *** [5s 3c Ac 2h] [5d]
NancyShay: checks=20
D_Rannn22: bets 24108 and is all-in
NancyShay: folds=20
Uncalled bet (24108) returned to D_Rannn22
D_Rannn22 collected 11475 from pot
D_Rannn22: doesn't show hand=20
*** SUMMARY ***
Total pot 11475 | Rake 0=20
Board [5s 3c Ac 2h 5d]
Seat 1: skroob9918 folded before Flop (didn't bet)
Seat 2: albyal420 folded on the Turn
Seat 3: D_Rannn22 (button) collected (11475)
Seat 4: JJin91 (small blind) folded before Flop
Seat 5: NancyShay (big blind) folded on the River


*********** # 82 **************
PokerStars Hand #169475429155: Tournament #1597684053, $13.50+$1.50 USD=
 Hold'em No Limit - Level VII (100/200) - 2017/05/06 14:42:58 ET
Table '1597684053 8' 6-max Seat #4 is the button
Seat 1: skroob9918 (14605 in chips)=20
Seat 2: albyal420 (31522 in chips)=20
Seat 3: D_Rannn22 (35583 in chips)=20
Seat 4: JJin91 (29283 in chips)=20
Seat 5: NancyShay (840 in chips)=20
skroob9918: posts the ante 25
albyal420: posts the ante 25
D_Rannn22: posts the ante 25
JJin91: posts the ante 25
NancyShay: posts the ante 25
NancyShay: posts small blind 100
skroob9918: posts big blind 200
*** HOLE CARDS ***
Dealt to JJin91 [Js 5d]
albyal420: calls 200
D_Rannn22: calls 200
JJin91: folds=20
NancyShay: raises 615 to 815 and is all-in
skroob9918: calls 615
albyal420: calls 615
D_Rannn22: folds=20
*** FLOP *** [4c Qs 2c]
skroob9918: checks=20
albyal420: bets 200
skroob9918: folds=20
Uncalled bet (200) returned to albyal420
*** TURN *** [4c Qs 2c] [Ad]
*** RIVER *** [4c Qs 2c Ad] [Tc]
*** SHOW DOWN ***
NancyShay: shows [9s 9d] (a pair of Nines)
albyal420: shows [7c Kc] (a flush, King high)
albyal420 collected 2770 from pot
NancyShay finished the tournament in 81st place
*** SUMMARY ***
Total pot 2770 | Rake 0=20
Board [4c Qs 2c Ad Tc]
Seat 1: skroob9918 (big blind) folded on the Flop
Seat 2: albyal420 showed [7c Kc] and won (2770) with a flush, King high
Seat 3: D_Rannn22 folded before Flop
Seat 4: JJin91 (button) folded before Flop (didn't bet)
Seat 5: NancyShay (small blind) showed [9s 9d] and lost with a pair of =
Nines


*********** # 83 **************
PokerStars Hand #169475429244: Tournament #1597684053, $13.50+$1.50 USD=
 Hold'em No Limit - Level VII (100/200) - 2017/05/06 14:43:29 ET
Table '1597684053 8' 6-max Seat #1 is the button
Seat 1: skroob9918 (13765 in chips)=20
Seat 2: albyal420 (33452 in chips)=20
Seat 3: D_Rannn22 (35358 in chips)=20
Seat 4: JJin91 (29258 in chips)=20
skroob9918: posts the ante 25
albyal420: posts the ante 25
D_Rannn22: posts the ante 25
JJin91: posts the ante 25
albyal420: posts small blind 100
D_Rannn22: posts big blind 200
*** HOLE CARDS ***
Dealt to JJin91 [7c 7d]
JJin91: raises 238 to 438
skroob9918: calls 438
albyal420: folds=20
D_Rannn22: calls 238
*** FLOP *** [Qh 3h Tc]
D_Rannn22: checks=20
albyal420 said, "welcome back donk"
JJin91: checks=20
JerseyJinx28 said, "thank you"
skroob9918: bets 600
D_Rannn22: calls 600
JJin91: calls 600
*** TURN *** [Qh 3h Tc] [4s]
D_Rannn22: checks=20
JerseyJinx28 said, "love the greatings"
JJin91: checks=20
skroob9918: checks=20
*** RIVER *** [Qh 3h Tc 4s] [Jd]
D_Rannn22: bets 1657
JJin91: folds=20
albyal420 said, "np"
skroob9918 said, "i feel like you have 2 pair"
skroob9918: calls 1657
*** SHOW DOWN ***
D_Rannn22: shows [Ac Kd] (a straight, Ten to Ace)
skroob9918: mucks hand=20
D_Rannn22 collected 6628 from pot
*** SUMMARY ***
Total pot 6628 | Rake 0=20
Board [Qh 3h Tc 4s Jd]
Seat 1: skroob9918 (button) mucked [Kh Qd]
Seat 2: albyal420 (small blind) folded before Flop
Seat 3: D_Rannn22 (big blind) showed [Ac Kd] and won (6628) with a stra=
ight, Ten to Ace
Seat 4: JJin91 folded on the River


*********** # 84 **************
PokerStars Hand #169475429459: Tournament #1597684053, $13.50+$1.50 USD=
 Hold'em No Limit - Level VII (100/200) - 2017/05/06 14:44:41 ET
Table '1597684053 7' 6-max Seat #5 is the button
Seat 1: JJin91 (28195 in chips)=20
Seat 3: TrademarkTer (4912 in chips)=20
Seat 4: craze609 (10085 in chips)=20
Seat 5: VinnieB118 (18560 in chips)=20
Seat 6: jtsox4life13 (33407 in chips)=20
JJin91: posts the ante 25
TrademarkTer: posts the ante 25
craze609: posts the ante 25
VinnieB118: posts the ante 25
jtsox4life13: posts the ante 25
jtsox4life13: posts small blind 100
JJin91: posts big blind 200
*** HOLE CARDS ***
Dealt to JJin91 [7s Kh]
TrademarkTer: folds=20
craze609: folds=20
VinnieB118: folds=20
jtsox4life13: folds=20
Uncalled bet (100) returned to JJin91
JJin91 collected 325 from pot
JJin91: doesn't show hand=20
*** SUMMARY ***
Total pot 325 | Rake 0=20
Seat 1: JJin91 (big blind) collected (325)
Seat 3: TrademarkTer folded before Flop (didn't bet)
Seat 4: craze609 folded before Flop (didn't bet)
Seat 5: VinnieB118 (button) folded before Flop (didn't bet)
Seat 6: jtsox4life13 (small blind) folded before Flop


*********** # 85 **************
PokerStars Hand #169475429486: Tournament #1597684053, $13.50+$1.50 USD=
 Hold'em No Limit - Level VII (100/200) - 2017/05/06 14:44:49 ET
Table '1597684053 7' 6-max Seat #6 is the button
Seat 1: JJin91 (28395 in chips)=20
Seat 3: TrademarkTer (4887 in chips)=20
Seat 4: craze609 (10060 in chips)=20
Seat 5: VinnieB118 (18535 in chips)=20
Seat 6: jtsox4life13 (33282 in chips)=20
JJin91: posts the ante 25
TrademarkTer: posts the ante 25
craze609: posts the ante 25
VinnieB118: posts the ante 25
jtsox4life13: posts the ante 25
JJin91: posts small blind 100
TrademarkTer: posts big blind 200
*** HOLE CARDS ***
Dealt to JJin91 [Tc Ad]
craze609: folds=20
VinnieB118: folds=20
jtsox4life13: folds=20
JJin91: raises 400 to 600
TrademarkTer: folds=20
Uncalled bet (400) returned to JJin91
JJin91 collected 525 from pot
JJin91: doesn't show hand=20
*** SUMMARY ***
Total pot 525 | Rake 0=20
Seat 1: JJin91 (small blind) collected (525)
Seat 3: TrademarkTer (big blind) folded before Flop
Seat 4: craze609 folded before Flop (didn't bet)
Seat 5: VinnieB118 folded before Flop (didn't bet)
Seat 6: jtsox4life13 (button) folded before Flop (didn't bet)


*********** # 86 **************
PokerStars Hand #169475429526: Tournament #1597684053, $13.50+$1.50 USD=
 Hold'em No Limit - Level VII (100/200) - 2017/05/06 14:45:05 ET
Table '1597684053 7' 6-max Seat #1 is the button
Seat 1: JJin91 (28695 in chips)=20
Seat 3: TrademarkTer (4662 in chips)=20
Seat 4: craze609 (10035 in chips)=20
Seat 5: VinnieB118 (18510 in chips)=20
Seat 6: jtsox4life13 (33257 in chips)=20
JJin91: posts the ante 25
TrademarkTer: posts the ante 25
craze609: posts the ante 25
VinnieB118: posts the ante 25
jtsox4life13: posts the ante 25
TrademarkTer: posts small blind 100
craze609: posts big blind 200
*** HOLE CARDS ***
Dealt to JJin91 [9d Td]
VinnieB118: folds=20
jtsox4life13: raises 400 to 600
JJin91: calls 600
TrademarkTer: folds=20
craze609: folds=20
*** FLOP *** [Ah Tc Jh]
jtsox4life13: bets 800
JJin91: folds=20
Uncalled bet (800) returned to jtsox4life13
jtsox4life13 collected 1625 from pot
*** SUMMARY ***
Total pot 1625 | Rake 0=20
Board [Ah Tc Jh]
Seat 1: JJin91 (button) folded on the Flop
Seat 3: TrademarkTer (small blind) folded before Flop
Seat 4: craze609 (big blind) folded before Flop
Seat 5: VinnieB118 folded before Flop (didn't bet)
Seat 6: jtsox4life13 collected (1625)


*********** # 87 **************
PokerStars Hand #169475429605: Tournament #1597684053, $13.50+$1.50 USD=
 Hold'em No Limit - Level VII (100/200) - 2017/05/06 14:45:32 ET
Table '1597684053 7' 6-max Seat #3 is the button
Seat 1: JJin91 (28070 in chips)=20
Seat 2: rbonessss333 (10000 in chips)=20
Seat 3: TrademarkTer (4537 in chips)=20
Seat 4: craze609 (9810 in chips)=20
Seat 5: VinnieB118 (18485 in chips)=20
Seat 6: jtsox4life13 (34257 in chips)=20
JJin91: posts the ante 25
rbonessss333: posts the ante 25
TrademarkTer: posts the ante 25
craze609: posts the ante 25
VinnieB118: posts the ante 25
jtsox4life13: posts the ante 25
craze609: posts small blind 100
VinnieB118: posts big blind 200
*** HOLE CARDS ***
Dealt to JJin91 [Jh Td]
jtsox4life13: folds=20
JJin91: folds=20
rbonessss333: raises 200 to 400
TrademarkTer: raises 4112 to 4512 and is all-in
craze609: folds=20
VinnieB118: folds=20
rbonessss333: folds=20
Uncalled bet (4112) returned to TrademarkTer
TrademarkTer collected 1250 from pot
*** SUMMARY ***
Total pot 1250 | Rake 0=20
Seat 1: JJin91 folded before Flop (didn't bet)
Seat 2: rbonessss333 folded before Flop
Seat 3: TrademarkTer (button) collected (1250)
Seat 4: craze609 (small blind) folded before Flop
Seat 5: VinnieB118 (big blind) folded before Flop
Seat 6: jtsox4life13 folded before Flop (didn't bet)


*********** # 88 **************
PokerStars Hand #169475429657: Tournament #1597684053, $13.50+$1.50 USD=
 Hold'em No Limit - Level VII (100/200) - 2017/05/06 14:45:50 ET
Table '1597684053 7' 6-max Seat #4 is the button
Seat 1: JJin91 (28045 in chips)=20
Seat 2: rbonessss333 (9575 in chips)=20
Seat 3: TrademarkTer (5362 in chips)=20
Seat 4: craze609 (9685 in chips)=20
Seat 5: VinnieB118 (18260 in chips)=20
Seat 6: jtsox4life13 (34232 in chips)=20
JJin91: posts the ante 25
rbonessss333: posts the ante 25
TrademarkTer: posts the ante 25
craze609: posts the ante 25
VinnieB118: posts the ante 25
jtsox4life13: posts the ante 25
VinnieB118: posts small blind 100
jtsox4life13: posts big blind 200
*** HOLE CARDS ***
Dealt to JJin91 [8h 5c]
JJin91: folds=20
rbonessss333: folds=20
TrademarkTer: calls 200
craze609: folds=20
VinnieB118: folds=20
jtsox4life13: checks=20
*** FLOP *** [Jh Ac 4d]
jtsox4life13: checks=20
TrademarkTer: checks=20
*** TURN *** [Jh Ac 4d] [3c]
jtsox4life13: checks=20
TrademarkTer: checks=20
*** RIVER *** [Jh Ac 4d 3c] [6s]
jtsox4life13: checks=20
TrademarkTer: checks=20
*** SHOW DOWN ***
jtsox4life13: shows [7d 8c] (high card Ace)
TrademarkTer: shows [Td Qd] (high card Ace - Queen kicker)
TrademarkTer collected 650 from pot
*** SUMMARY ***
Total pot 650 | Rake 0=20
Board [Jh Ac 4d 3c 6s]
Seat 1: JJin91 folded before Flop (didn't bet)
Seat 2: rbonessss333 folded before Flop (didn't bet)
Seat 3: TrademarkTer showed [Td Qd] and won (650) with high card Ace
Seat 4: craze609 (button) folded before Flop (didn't bet)
Seat 5: VinnieB118 (small blind) folded before Flop
Seat 6: jtsox4life13 (big blind) showed [7d 8c] and lost with high card=
 Ace


*********** # 89 **************
PokerStars Hand #169475429730: Tournament #1597684053, $13.50+$1.50 USD=
 Hold'em No Limit - Level VIII (125/250) - 2017/05/06 14:46:15 ET
Table '1597684053 7' 6-max Seat #5 is the button
Seat 1: JJin91 (28020 in chips)=20
Seat 2: rbonessss333 (9550 in chips)=20
Seat 4: craze609 (9660 in chips)=20
Seat 5: VinnieB118 (18135 in chips)=20
Seat 6: jtsox4life13 (34007 in chips)=20
JJin91: posts the ante 30
rbonessss333: posts the ante 30
craze609: posts the ante 30
VinnieB118: posts the ante 30
jtsox4life13: posts the ante 30
jtsox4life13: posts small blind 125
JJin91: posts big blind 250
*** HOLE CARDS ***
Dealt to JJin91 [3c 4c]
rbonessss333: folds=20
craze609: folds=20
VinnieB118: folds=20
jtsox4life13: raises 500 to 750
JJin91: folds=20
Uncalled bet (500) returned to jtsox4life13
jtsox4life13 collected 650 from pot
*** SUMMARY ***
Total pot 650 | Rake 0=20
Seat 1: JJin91 (big blind) folded before Flop
Seat 2: rbonessss333 folded before Flop (didn't bet)
Seat 4: craze609 folded before Flop (didn't bet)
Seat 5: VinnieB118 (button) folded before Flop (didn't bet)
Seat 6: jtsox4life13 (small blind) collected (650)


*********** # 90 **************
PokerStars Hand #169475429791: Tournament #1597684053, $13.50+$1.50 USD=
 Hold'em No Limit - Level VIII (125/250) - 2017/05/06 14:46:32 ET
Table '1597684053 7' 6-max Seat #6 is the button
Seat 1: JJin91 (27740 in chips)=20
Seat 2: rbonessss333 (9520 in chips)=20
Seat 4: craze609 (9630 in chips)=20
Seat 5: VinnieB118 (18105 in chips)=20
Seat 6: jtsox4life13 (34377 in chips)=20
JJin91: posts the ante 30
rbonessss333: posts the ante 30
craze609: posts the ante 30
VinnieB118: posts the ante 30
jtsox4life13: posts the ante 30
JJin91: posts small blind 125
rbonessss333: posts big blind 250
*** HOLE CARDS ***
Dealt to JJin91 [5c 3d]
craze609: folds=20
VinnieB118: folds=20
jtsox4life13: calls 250
JJin91: folds=20
rbonessss333: checks=20
*** FLOP *** [7c 8d Jh]
rbonessss333: bets 250
jtsox4life13: calls 250
*** TURN *** [7c 8d Jh] [7s]
rbonessss333: bets 250
jtsox4life13: folds=20
Uncalled bet (250) returned to rbonessss333
rbonessss333 collected 1275 from pot
*** SUMMARY ***
Total pot 1275 | Rake 0=20
Board [7c 8d Jh 7s]
Seat 1: JJin91 (small blind) folded before Flop
Seat 2: rbonessss333 (big blind) collected (1275)
Seat 4: craze609 folded before Flop (didn't bet)
Seat 5: VinnieB118 folded before Flop (didn't bet)
Seat 6: jtsox4life13 (button) folded on the Turn


*********** # 91 **************
PokerStars Hand #169475429860: Tournament #1597684053, $13.50+$1.50 USD=
 Hold'em No Limit - Level VIII (125/250) - 2017/05/06 14:46:54 ET
Table '1597684053 7' 6-max Seat #1 is the button
Seat 1: JJin91 (27585 in chips)=20
Seat 2: rbonessss333 (10265 in chips)=20
Seat 4: craze609 (9600 in chips)=20
Seat 5: VinnieB118 (18075 in chips)=20
Seat 6: jtsox4life13 (33847 in chips)=20
JJin91: posts the ante 30
rbonessss333: posts the ante 30
craze609: posts the ante 30
VinnieB118: posts the ante 30
jtsox4life13: posts the ante 30
rbonessss333: posts small blind 125
craze609: posts big blind 250
*** HOLE CARDS ***
Dealt to JJin91 [4c 4s]
VinnieB118: folds=20
jtsox4life13: folds=20
JJin91: raises 297 to 547
rbonessss333: folds=20
craze609: folds=20
Uncalled bet (297) returned to JJin91
JJin91 collected 775 from pot
JJin91: doesn't show hand=20
*** SUMMARY ***
Total pot 775 | Rake 0=20
Seat 1: JJin91 (button) collected (775)
Seat 2: rbonessss333 (small blind) folded before Flop
Seat 4: craze609 (big blind) folded before Flop
Seat 5: VinnieB118 folded before Flop (didn't bet)
Seat 6: jtsox4life13 folded before Flop (didn't bet)


*********** # 92 **************
PokerStars Hand #169475429901: Tournament #1597684053, $13.50+$1.50 USD=
 Hold'em No Limit - Level VIII (125/250) - 2017/05/06 14:47:08 ET
Table '1597684053 7' 6-max Seat #2 is the button
Seat 1: JJin91 (28080 in chips)=20
Seat 2: rbonessss333 (10110 in chips)=20
Seat 4: craze609 (9320 in chips)=20
Seat 5: VinnieB118 (18045 in chips)=20
Seat 6: jtsox4life13 (33817 in chips)=20
JJin91: posts the ante 30
rbonessss333: posts the ante 30
craze609: posts the ante 30
VinnieB118: posts the ante 30
jtsox4life13: posts the ante 30
craze609: posts small blind 125
VinnieB118: posts big blind 250
*** HOLE CARDS ***
Dealt to JJin91 [8h Th]
jtsox4life13: folds=20
JJin91: folds=20
rbonessss333: raises 250 to 500
craze609: folds=20
VinnieB118: calls 250
*** FLOP *** [Tc Kh 3d]
VinnieB118: checks=20
rbonessss333: bets 638
VinnieB118: folds=20
Uncalled bet (638) returned to rbonessss333
rbonessss333 collected 1275 from pot
*** SUMMARY ***
Total pot 1275 | Rake 0=20
Board [Tc Kh 3d]
Seat 1: JJin91 folded before Flop (didn't bet)
Seat 2: rbonessss333 (button) collected (1275)
Seat 4: craze609 (small blind) folded before Flop
Seat 5: VinnieB118 (big blind) folded on the Flop
Seat 6: jtsox4life13 folded before Flop (didn't bet)


*********** # 93 **************
PokerStars Hand #169475429978: Tournament #1597684053, $13.50+$1.50 USD=
 Hold'em No Limit - Level VIII (125/250) - 2017/05/06 14:47:28 ET
Table '1597684053 7' 6-max Seat #4 is the button
Seat 1: JJin91 (28050 in chips)=20
Seat 2: rbonessss333 (10855 in chips)=20
Seat 4: craze609 (9165 in chips)=20
Seat 5: VinnieB118 (17515 in chips)=20
Seat 6: jtsox4life13 (33787 in chips)=20
JJin91: posts the ante 30
rbonessss333: posts the ante 30
craze609: posts the ante 30
VinnieB118: posts the ante 30
jtsox4life13: posts the ante 30
VinnieB118: posts small blind 125
jtsox4life13: posts big blind 250
*** HOLE CARDS ***
Dealt to JJin91 [8c Js]
JJin91: folds=20
rbonessss333: folds=20
craze609: folds=20
VinnieB118: raises 250 to 500
jtsox4life13: calls 250
*** FLOP *** [2d 2s 7c]
VinnieB118: checks=20
jtsox4life13: bets 1000
VinnieB118: folds=20
Uncalled bet (1000) returned to jtsox4life13
jtsox4life13 collected 1150 from pot
jtsox4life13: shows [7h]
*** SUMMARY ***
Total pot 1150 | Rake 0=20
Board [2d 2s 7c]
Seat 1: JJin91 folded before Flop (didn't bet)
Seat 2: rbonessss333 folded before Flop (didn't bet)
Seat 4: craze609 (button) folded before Flop (didn't bet)
Seat 5: VinnieB118 (small blind) folded on the Flop
Seat 6: jtsox4life13 (big blind) collected (1150)


*********** # 94 **************
PokerStars Hand #169475528347: Tournament #1597684053, $13.50+$1.50 USD=
 Hold'em No Limit - Level VIII (125/250) - 2017/05/06 14:47:52 ET
Table '1597684053 7' 6-max Seat #5 is the button
Seat 1: JJin91 (28020 in chips)=20
Seat 2: rbonessss333 (10825 in chips)=20
Seat 4: craze609 (9135 in chips)=20
Seat 5: VinnieB118 (16985 in chips)=20
Seat 6: jtsox4life13 (34407 in chips)=20
JJin91: posts the ante 30
rbonessss333: posts the ante 30
craze609: posts the ante 30
VinnieB118: posts the ante 30
jtsox4life13: posts the ante 30
jtsox4life13: posts small blind 125
JJin91: posts big blind 250
*** HOLE CARDS ***
Dealt to JJin91 [7d Qc]
rbonessss333: folds=20
craze609: folds=20
VinnieB118: folds=20
jtsox4life13: folds=20
Uncalled bet (125) returned to JJin91
JJin91 collected 400 from pot
JJin91: doesn't show hand=20
*** SUMMARY ***
Total pot 400 | Rake 0=20
Seat 1: JJin91 (big blind) collected (400)
Seat 2: rbonessss333 folded before Flop (didn't bet)
Seat 4: craze609 folded before Flop (didn't bet)
Seat 5: VinnieB118 (button) folded before Flop (didn't bet)
Seat 6: jtsox4life13 (small blind) folded before Flop


*********** # 95 **************
PokerStars Hand #169475528426: Tournament #1597684053, $13.50+$1.50 USD=
 Hold'em No Limit - Level VIII (125/250) - 2017/05/06 14:48:20 ET
Table '1597684053 7' 6-max Seat #6 is the button
Seat 1: JJin91 (28265 in chips)=20
Seat 2: rbonessss333 (10795 in chips)=20
Seat 4: craze609 (9105 in chips)=20
Seat 5: VinnieB118 (16955 in chips)=20
Seat 6: jtsox4life13 (34252 in chips)=20
JJin91: posts the ante 30
rbonessss333: posts the ante 30
craze609: posts the ante 30
VinnieB118: posts the ante 30
jtsox4life13: posts the ante 30
JJin91: posts small blind 125
rbonessss333: posts big blind 250
*** HOLE CARDS ***
Dealt to JJin91 [Ks 9h]
craze609: folds=20
VinnieB118: folds=20
jtsox4life13: folds=20
JJin91: raises 500 to 750
rbonessss333: calls 500
*** FLOP *** [Qc Tc Ts]
JJin91: checks=20
rbonessss333: bets 250
JJin91: calls 250
*** TURN *** [Qc Tc Ts] [Qd]
JJin91: checks=20
rbonessss333: bets 1075
VinnieB118 is disconnected=20
JJin91: calls 1075
*** RIVER *** [Qc Tc Ts Qd] [2c]
JJin91: checks=20
rbonessss333: checks=20
*** SHOW DOWN ***
JJin91: shows [Ks 9h] (two pair, Queens and Tens)
rbonessss333: mucks hand=20
JJin91 collected 4300 from pot
*** SUMMARY ***
Total pot 4300 | Rake 0=20
Board [Qc Tc Ts Qd 2c]
Seat 1: JJin91 (small blind) showed [Ks 9h] and won (4300) with two pai=
r, Queens and Tens
Seat 2: rbonessss333 (big blind) mucked [7h 8s]
Seat 4: craze609 folded before Flop (didn't bet)
Seat 5: VinnieB118 folded before Flop (didn't bet)
Seat 6: jtsox4life13 (button) folded before Flop (didn't bet)


*********** # 96 **************
PokerStars Hand #169475528541: Tournament #1597684053, $13.50+$1.50 USD=
 Hold'em No Limit - Level VIII (125/250) - 2017/05/06 14:49:01 ET
Table '1597684053 7' 6-max Seat #1 is the button
Seat 1: JJin91 (30460 in chips)=20
Seat 2: rbonessss333 (8690 in chips)=20
Seat 4: craze609 (9075 in chips)=20
Seat 5: VinnieB118 (16925 in chips)=20
Seat 6: jtsox4life13 (34222 in chips)=20
JJin91: posts the ante 30
rbonessss333: posts the ante 30
craze609: posts the ante 30
VinnieB118: posts the ante 30
jtsox4life13: posts the ante 30
rbonessss333: posts small blind 125
craze609: posts big blind 250
*** HOLE CARDS ***
Dealt to JJin91 [9c 9d]
VinnieB118 has timed out while disconnected
VinnieB118: folds=20
VinnieB118 is sitting out
jtsox4life13: calls 250
JJin91: raises 402 to 652
rbonessss333: calls 527
craze609: folds=20
jtsox4life13: calls 402
*** FLOP *** [Td 9s Th]
rbonessss333: checks=20
jtsox4life13: checks=20
JJin91: checks=20
*** TURN *** [Td 9s Th] [Qc]
rbonessss333: bets 250
jtsox4life13: folds=20
JJin91: calls 250
*** RIVER *** [Td 9s Th Qc] [Ts]
rbonessss333: bets 250
JJin91: raises 1000 to 1250
rbonessss333: calls 1000
*** SHOW DOWN ***
JJin91: shows [9c 9d] (a full house, Tens full of Nines)
rbonessss333: shows [Kh Qs] (a full house, Tens full of Queens)
rbonessss333 collected 5356 from pot
*** SUMMARY ***
Total pot 5356 | Rake 0=20
Board [Td 9s Th Qc Ts]
Seat 1: JJin91 (button) showed [9c 9d] and lost with a full house, Tens=
 full of Nines
Seat 2: rbonessss333 (small blind) showed [Kh Qs] and won (5356) with a=
 full house, Tens full of Queens
Seat 4: craze609 (big blind) folded before Flop
Seat 5: VinnieB118 folded before Flop (didn't bet)
Seat 6: jtsox4life13 folded on the Turn


*********** # 97 **************
PokerStars Hand #169475528723: Tournament #1597684053, $13.50+$1.50 USD=
 Hold'em No Limit - Level VIII (125/250) - 2017/05/06 14:50:01 ET
Table '1597684053 7' 6-max Seat #2 is the button
Seat 1: JJin91 (28278 in chips)=20
Seat 2: rbonessss333 (11864 in chips)=20
Seat 4: craze609 (8795 in chips)=20
Seat 5: VinnieB118 (16895 in chips) is sitting out
Seat 6: jtsox4life13 (33540 in chips)=20
JJin91: posts the ante 30
rbonessss333: posts the ante 30
craze609: posts the ante 30
VinnieB118: posts the ante 30
jtsox4life13: posts the ante 30
craze609: posts small blind 125
VinnieB118: posts big blind 250
*** HOLE CARDS ***
Dealt to JJin91 [Ts 6c]
jtsox4life13: calls 250
JJin91: folds=20
rbonessss333: folds=20
craze609: folds=20
VinnieB118: folds=20
jtsox4life13 collected 775 from pot
*** SUMMARY ***
Total pot 775 | Rake 0=20
Seat 1: JJin91 folded before Flop (didn't bet)
Seat 2: rbonessss333 (button) folded before Flop (didn't bet)
Seat 4: craze609 (small blind) folded before Flop
Seat 5: VinnieB118 (big blind) folded before Flop
Seat 6: jtsox4life13 collected (775)


*********** # 98 **************
PokerStars Hand #169475528766: Tournament #1597684053, $13.50+$1.50 USD=
 Hold'em No Limit - Level VIII (125/250) - 2017/05/06 14:50:17 ET
Table '1597684053 7' 6-max Seat #4 is the button
Seat 1: JJin91 (28248 in chips)=20
Seat 2: rbonessss333 (11834 in chips)=20
Seat 3: CookeNJ (10000 in chips)=20
Seat 4: craze609 (8640 in chips)=20
Seat 5: VinnieB118 (16615 in chips) is sitting out
Seat 6: jtsox4life13 (34035 in chips)=20
JJin91: posts the ante 30
rbonessss333: posts the ante 30
CookeNJ: posts the ante 30
craze609: posts the ante 30
VinnieB118: posts the ante 30
jtsox4life13: posts the ante 30
VinnieB118: posts small blind 125
jtsox4life13: posts big blind 250
*** HOLE CARDS ***
Dealt to JJin91 [Qh Tc]
JJin91: folds=20
rbonessss333: folds=20
CookeNJ: folds=20
craze609: calls 250
VinnieB118: folds=20
jtsox4life13: checks=20
*** FLOP *** [Kh 8d Qs]
jtsox4life13: checks=20
craze609: checks=20
*** TURN *** [Kh 8d Qs] [4h]
jtsox4life13: bets 250
craze609: folds=20
Uncalled bet (250) returned to jtsox4life13
jtsox4life13 collected 805 from pot
*** SUMMARY ***
Total pot 805 | Rake 0=20
Board [Kh 8d Qs 4h]
Seat 1: JJin91 folded before Flop (didn't bet)
Seat 2: rbonessss333 folded before Flop (didn't bet)
Seat 3: CookeNJ folded before Flop (didn't bet)
Seat 4: craze609 (button) folded on the Turn
Seat 5: VinnieB118 (small blind) folded before Flop
Seat 6: jtsox4life13 (big blind) collected (805)


*********** # 99 **************
PokerStars Hand #169475528842: Tournament #1597684053, $13.50+$1.50 USD=
 Hold'em No Limit - Level VIII (125/250) - 2017/05/06 14:50:40 ET
Table '1597684053 7' 6-max Seat #5 is the button
Seat 1: JJin91 (28218 in chips)=20
Seat 2: rbonessss333 (11804 in chips)=20
Seat 3: CookeNJ (9970 in chips)=20
Seat 4: craze609 (8360 in chips)=20
Seat 5: VinnieB118 (16460 in chips) is sitting out
Seat 6: jtsox4life13 (34560 in chips)=20
JJin91: posts the ante 30
rbonessss333: posts the ante 30
CookeNJ: posts the ante 30
craze609: posts the ante 30
VinnieB118: posts the ante 30
jtsox4life13: posts the ante 30
jtsox4life13: posts small blind 125
JJin91: posts big blind 250
*** HOLE CARDS ***
Dealt to JJin91 [4c 3h]
rbonessss333: calls 250
CookeNJ: folds=20
craze609: folds=20
VinnieB118: folds=20
jtsox4life13: raises 500 to 750
JJin91: folds=20
VinnieB118 has returned
rbonessss333: calls 500
*** FLOP *** [Jc 3c Ah]
jtsox4life13: bets 1000
rbonessss333: raises 1000 to 2000
jtsox4life13: calls 1000
*** TURN *** [Jc 3c Ah] [8h]
jtsox4life13: checks=20
rbonessss333: checks=20
*** RIVER *** [Jc 3c Ah 8h] [5d]
jtsox4life13: checks=20
rbonessss333: checks=20
*** SHOW DOWN ***
jtsox4life13: shows [Td Ks] (high card Ace)
rbonessss333: shows [2c As] (a pair of Aces)
rbonessss333 collected 5930 from pot
*** SUMMARY ***
Total pot 5930 | Rake 0=20
Board [Jc 3c Ah 8h 5d]
Seat 1: JJin91 (big blind) folded before Flop
Seat 2: rbonessss333 showed [2c As] and won (5930) with a pair of Aces
Seat 3: CookeNJ folded before Flop (didn't bet)
Seat 4: craze609 folded before Flop (didn't bet)
Seat 5: VinnieB118 (button) folded before Flop (didn't bet)
Seat 6: jtsox4life13 (small blind) showed [Td Ks] and lost with high ca=
rd Ace


*********** # 100 **************
PokerStars Hand #169475528976: Tournament #1597684053, $13.50+$1.50 USD=
 Hold'em No Limit - Level VIII (125/250) - 2017/05/06 14:51:24 ET
Table '1597684053 7' 6-max Seat #6 is the button
Seat 1: JJin91 (27938 in chips)=20
Seat 2: rbonessss333 (14954 in chips)=20
Seat 3: CookeNJ (9940 in chips)=20
Seat 4: craze609 (8330 in chips)=20
Seat 5: VinnieB118 (16430 in chips)=20
Seat 6: jtsox4life13 (31780 in chips)=20
JJin91: posts the ante 30
rbonessss333: posts the ante 30
CookeNJ: posts the ante 30
craze609: posts the ante 30
VinnieB118: posts the ante 30
jtsox4life13: posts the ante 30
JJin91: posts small blind 125
rbonessss333: posts big blind 250
*** HOLE CARDS ***
Dealt to JJin91 [4h 2d]
CookeNJ: folds=20
craze609: folds=20
VinnieB118 is disconnected=20
VinnieB118 is connected=20
VinnieB118: folds=20
jtsox4life13: calls 250
JJin91: folds=20
rbonessss333: checks=20
*** FLOP *** [Th Ad 7s]
rbonessss333: checks=20
jtsox4life13: checks=20
*** TURN *** [Th Ad 7s] [Jh]
rbonessss333: bets 250
jtsox4life13: calls 250
*** RIVER *** [Th Ad 7s Jh] [Jd]
rbonessss333: checks=20
jtsox4life13: checks=20
*** SHOW DOWN ***
rbonessss333: shows [8s Kc] (a pair of Jacks)
jtsox4life13: shows [5h 7h] (two pair, Jacks and Sevens)
jtsox4life13 collected 1305 from pot
*** SUMMARY ***
Total pot 1305 | Rake 0=20
Board [Th Ad 7s Jh Jd]
Seat 1: JJin91 (small blind) folded before Flop
Seat 2: rbonessss333 (big blind) showed [8s Kc] and lost with a pair of=
 Jacks
Seat 3: CookeNJ folded before Flop (didn't bet)
Seat 4: craze609 folded before Flop (didn't bet)
Seat 5: VinnieB118 folded before Flop (didn't bet)
Seat 6: jtsox4life13 (button) showed [5h 7h] and won (1305) with two pa=
ir, Jacks and Sevens


*********** # 101 **************
PokerStars Hand #169475529123: Tournament #1597684053, $13.50+$1.50 USD=
 Hold'em No Limit - Level VIII (125/250) - 2017/05/06 14:52:19 ET
Table '1597684053 7' 6-max Seat #1 is the button
Seat 1: JJin91 (27783 in chips)=20
Seat 2: rbonessss333 (14424 in chips)=20
Seat 3: CookeNJ (9910 in chips)=20
Seat 4: craze609 (8300 in chips)=20
Seat 5: VinnieB118 (16400 in chips)=20
Seat 6: jtsox4life13 (32555 in chips)=20
JJin91: posts the ante 30
rbonessss333: posts the ante 30
CookeNJ: posts the ante 30
craze609: posts the ante 30
VinnieB118: posts the ante 30
jtsox4life13: posts the ante 30
rbonessss333: posts small blind 125
CookeNJ: posts big blind 250
*** HOLE CARDS ***
Dealt to JJin91 [2s Kc]
craze609: raises 500 to 750
VinnieB118: folds=20
jtsox4life13: folds=20
JJin91: folds=20
rbonessss333: folds=20
CookeNJ: calls 500
*** FLOP *** [9s 4h 9d]
CookeNJ: checks=20
craze609: bets 1000
CookeNJ: folds=20
Uncalled bet (1000) returned to craze609
craze609 collected 1805 from pot
craze609: doesn't show hand=20
*** SUMMARY ***
Total pot 1805 | Rake 0=20
Board [9s 4h 9d]
Seat 1: JJin91 (button) folded before Flop (didn't bet)
Seat 2: rbonessss333 (small blind) folded before Flop
Seat 3: CookeNJ (big blind) folded on the Flop
Seat 4: craze609 collected (1805)
Seat 5: VinnieB118 folded before Flop (didn't bet)
Seat 6: jtsox4life13 folded before Flop (didn't bet)


*********** # 102 **************
PokerStars Hand #169475529215: Tournament #1597684053, $13.50+$1.50 USD=
 Hold'em No Limit - Level VIII (125/250) - 2017/05/06 14:52:51 ET
Table '1597684053 7' 6-max Seat #2 is the button
Seat 1: JJin91 (27753 in chips)=20
Seat 2: rbonessss333 (14269 in chips)=20
Seat 3: CookeNJ (9130 in chips)=20
Seat 4: craze609 (9325 in chips)=20
Seat 5: VinnieB118 (16370 in chips)=20
Seat 6: jtsox4life13 (32525 in chips)=20
JJin91: posts the ante 30
rbonessss333: posts the ante 30
CookeNJ: posts the ante 30
craze609: posts the ante 30
VinnieB118: posts the ante 30
jtsox4life13: posts the ante 30
CookeNJ: posts small blind 125
craze609: posts big blind 250
*** HOLE CARDS ***
Dealt to JJin91 [6d Ac]
VinnieB118: folds=20
jtsox4life13: folds=20
JJin91: raises 402 to 652
rbonessss333: folds=20
CookeNJ: folds=20
craze609: folds=20
Uncalled bet (402) returned to JJin91
JJin91 collected 805 from pot
JJin91: doesn't show hand=20
*** SUMMARY ***
Total pot 805 | Rake 0=20
Seat 1: JJin91 collected (805)
Seat 2: rbonessss333 (button) folded before Flop (didn't bet)
Seat 3: CookeNJ (small blind) folded before Flop
Seat 4: craze609 (big blind) folded before Flop
Seat 5: VinnieB118 folded before Flop (didn't bet)
Seat 6: jtsox4life13 folded before Flop (didn't bet)


*********** # 103 **************
PokerStars Hand #169475529266: Tournament #1597684053, $13.50+$1.50 USD=
 Hold'em No Limit - Level VIII (125/250) - 2017/05/06 14:53:09 ET
Table '1597684053 7' 6-max Seat #3 is the button
Seat 1: JJin91 (28278 in chips)=20
Seat 2: rbonessss333 (14239 in chips)=20
Seat 3: CookeNJ (8975 in chips)=20
Seat 4: craze609 (9045 in chips)=20
Seat 5: VinnieB118 (16340 in chips)=20
Seat 6: jtsox4life13 (32495 in chips)=20
JJin91: posts the ante 30
rbonessss333: posts the ante 30
CookeNJ: posts the ante 30
craze609: posts the ante 30
VinnieB118: posts the ante 30
jtsox4life13: posts the ante 30
craze609: posts small blind 125
VinnieB118: posts big blind 250
*** HOLE CARDS ***
Dealt to JJin91 [8s Kd]
jtsox4life13: folds=20
JJin91: folds=20
rbonessss333: folds=20
CookeNJ: calls 250
craze609: folds=20
VinnieB118: checks=20
*** FLOP *** [9c 7c 9d]
VinnieB118: checks=20
CookeNJ: bets 805
VinnieB118: folds=20
Uncalled bet (805) returned to CookeNJ
CookeNJ collected 805 from pot
CookeNJ: doesn't show hand=20
*** SUMMARY ***
Total pot 805 | Rake 0=20
Board [9c 7c 9d]
Seat 1: JJin91 folded before Flop (didn't bet)
Seat 2: rbonessss333 folded before Flop (didn't bet)
Seat 3: CookeNJ (button) collected (805)
Seat 4: craze609 (small blind) folded before Flop
Seat 5: VinnieB118 (big blind) folded on the Flop
Seat 6: jtsox4life13 folded before Flop (didn't bet)


*********** # 104 **************
PokerStars Hand #169475529332: Tournament #1597684053, $13.50+$1.50 USD=
 Hold'em No Limit - Level VIII (125/250) - 2017/05/06 14:53:31 ET
Table '1597684053 7' 6-max Seat #4 is the button
Seat 1: JJin91 (28248 in chips)=20
Seat 2: rbonessss333 (14209 in chips)=20
Seat 3: CookeNJ (9500 in chips)=20
Seat 4: craze609 (8890 in chips)=20
Seat 5: VinnieB118 (16060 in chips)=20
Seat 6: jtsox4life13 (32465 in chips)=20
JJin91: posts the ante 30
rbonessss333: posts the ante 30
CookeNJ: posts the ante 30
craze609: posts the ante 30
VinnieB118: posts the ante 30
jtsox4life13: posts the ante 30
VinnieB118: posts small blind 125
jtsox4life13: posts big blind 250
*** HOLE CARDS ***
Dealt to JJin91 [8s 7s]
JJin91: folds=20
rbonessss333: folds=20
CookeNJ: folds=20
craze609: folds=20
VinnieB118: folds=20
Uncalled bet (125) returned to jtsox4life13
jtsox4life13 collected 430 from pot
*** SUMMARY ***
Total pot 430 | Rake 0=20
Seat 1: JJin91 folded before Flop (didn't bet)
Seat 2: rbonessss333 folded before Flop (didn't bet)
Seat 3: CookeNJ folded before Flop (didn't bet)
Seat 4: craze609 (button) folded before Flop (didn't bet)
Seat 5: VinnieB118 (small blind) folded before Flop
Seat 6: jtsox4life13 (big blind) collected (430)


*********** # 105 **************
PokerStars Hand #169475529364: Tournament #1597684053, $13.50+$1.50 USD=
 Hold'em No Limit - Level VIII (125/250) - 2017/05/06 14:53:40 ET
Table '1597684053 7' 6-max Seat #5 is the button
Seat 1: JJin91 (28218 in chips)=20
Seat 2: rbonessss333 (14179 in chips)=20
Seat 3: CookeNJ (9470 in chips)=20
Seat 4: craze609 (8860 in chips)=20
Seat 5: VinnieB118 (15905 in chips)=20
Seat 6: jtsox4life13 (32740 in chips)=20
JJin91: posts the ante 30
rbonessss333: posts the ante 30
CookeNJ: posts the ante 30
craze609: posts the ante 30
VinnieB118: posts the ante 30
jtsox4life13: posts the ante 30
jtsox4life13: posts small blind 125
JJin91: posts big blind 250
*** HOLE CARDS ***
Dealt to JJin91 [Ks Ah]
rbonessss333: folds=20
CookeNJ: folds=20
craze609: raises 500 to 750
VinnieB118: folds=20
jtsox4life13: folds=20
JJin91: raises 27438 to 28188 and is all-in
craze609: folds=20
Uncalled bet (27438) returned to JJin91
JJin91 collected 1805 from pot
JJin91: doesn't show hand=20
*** SUMMARY ***
Total pot 1805 | Rake 0=20
Seat 1: JJin91 (big blind) collected (1805)
Seat 2: rbonessss333 folded before Flop (didn't bet)
Seat 3: CookeNJ folded before Flop (didn't bet)
Seat 4: craze609 folded before Flop
Seat 5: VinnieB118 (button) folded before Flop (didn't bet)
Seat 6: jtsox4life13 (small blind) folded before Flop


*********** # 106 **************
PokerStars Hand #169475529437: Tournament #1597684053, $13.50+$1.50 USD=
 Hold'em No Limit - Level VIII (125/250) - 2017/05/06 14:54:04 ET
Table '1597684053 7' 6-max Seat #6 is the button
Seat 1: JJin91 (29243 in chips)=20
Seat 2: rbonessss333 (14149 in chips)=20
Seat 3: CookeNJ (9440 in chips)=20
Seat 4: craze609 (8080 in chips)=20
Seat 5: VinnieB118 (15875 in chips)=20
Seat 6: jtsox4life13 (32585 in chips)=20
JJin91: posts the ante 30
rbonessss333: posts the ante 30
CookeNJ: posts the ante 30
craze609: posts the ante 30
VinnieB118: posts the ante 30
jtsox4life13: posts the ante 30
JJin91: posts small blind 125
rbonessss333: posts big blind 250
*** HOLE CARDS ***
Dealt to JJin91 [6h 5c]
CookeNJ: folds=20
craze609: folds=20
VinnieB118: raises 750 to 1000
jtsox4life13: calls 1000
JJin91: folds=20
rbonessss333: folds=20
*** FLOP *** [7c 9s Jh]
VinnieB118: bets 2000
jtsox4life13: calls 2000
*** TURN *** [7c 9s Jh] [Kd]
VinnieB118: bets 500
jtsox4life13: calls 500
*** RIVER *** [7c 9s Jh Kd] [Kh]
VinnieB118: bets 1250
jtsox4life13: calls 1250
*** SHOW DOWN ***
VinnieB118: shows [Jd Qd] (two pair, Kings and Jacks)
jtsox4life13: shows [Jc Tc] (two pair, Kings and Jacks - lower kicker)
VinnieB118 collected 10055 from pot
*** SUMMARY ***
Total pot 10055 | Rake 0=20
Board [7c 9s Jh Kd Kh]
Seat 1: JJin91 (small blind) folded before Flop
Seat 2: rbonessss333 (big blind) folded before Flop
Seat 3: CookeNJ folded before Flop (didn't bet)
Seat 4: craze609 folded before Flop (didn't bet)
Seat 5: VinnieB118 showed [Jd Qd] and won (10055) with two pair, Kings =
and Jacks
Seat 6: jtsox4life13 (button) showed [Jc Tc] and lost with two pair, Ki=
ngs and Jacks


*********** # 107 **************
PokerStars Hand #169475529550: Tournament #1597684053, $13.50+$1.50 USD=
 Hold'em No Limit - Level VIII (125/250) - 2017/05/06 14:54:43 ET
Table '1597684053 7' 6-max Seat #1 is the button
Seat 1: JJin91 (29088 in chips)=20
Seat 2: rbonessss333 (13869 in chips)=20
Seat 3: CookeNJ (9410 in chips)=20
Seat 4: craze609 (8050 in chips)=20
Seat 5: VinnieB118 (21150 in chips)=20
Seat 6: jtsox4life13 (27805 in chips)=20
JJin91: posts the ante 30
rbonessss333: posts the ante 30
CookeNJ: posts the ante 30
craze609: posts the ante 30
VinnieB118: posts the ante 30
jtsox4life13: posts the ante 30
rbonessss333: posts small blind 125
CookeNJ: posts big blind 250
*** HOLE CARDS ***
Dealt to JJin91 [2c Kh]
craze609: raises 500 to 750
VinnieB118: raises 2250 to 3000
jtsox4life13: folds=20
JJin91: folds=20
rbonessss333: folds=20
CookeNJ: folds=20
craze609: calls 2250
*** FLOP *** [Ah 9d 5s]
craze609: checks=20
VinnieB118: bets 4750
craze609: raises 270 to 5020 and is all-in
VinnieB118: calls 270
*** TURN *** [Ah 9d 5s] [7d]
*** RIVER *** [Ah 9d 5s 7d] [2d]
*** SHOW DOWN ***
craze609: shows [9s As] (two pair, Aces and Nines)
VinnieB118: shows [Qd Ac] (a pair of Aces)
craze609 collected 16595 from pot
*** SUMMARY ***
Total pot 16595 | Rake 0=20
Board [Ah 9d 5s 7d 2d]
Seat 1: JJin91 (button) folded before Flop (didn't bet)
Seat 2: rbonessss333 (small blind) folded before Flop
Seat 3: CookeNJ (big blind) folded before Flop
Seat 4: craze609 showed [9s As] and won (16595) with two pair, Aces and=
 Nines
Seat 5: VinnieB118 showed [Qd Ac] and lost with a pair of Aces
Seat 6: jtsox4life13 folded before Flop (didn't bet)


*********** # 108 **************
PokerStars Hand #169475655832: Tournament #1597684053, $13.50+$1.50 USD=
 Hold'em No Limit - Level VIII (125/250) - 2017/05/06 15:00:44 ET
Table '1597684053 7' 6-max Seat #2 is the button
Seat 1: JJin91 (29058 in chips)=20
Seat 2: rbonessss333 (13714 in chips)=20
Seat 4: craze609 (16595 in chips)=20
Seat 5: VinnieB118 (13100 in chips)=20
Seat 6: jtsox4life13 (27775 in chips)=20
JJin91: posts the ante 30
rbonessss333: posts the ante 30
craze609: posts the ante 30
VinnieB118: posts the ante 30
jtsox4life13: posts the ante 30
craze609: posts small blind 125
VinnieB118: posts big blind 250
*** HOLE CARDS ***
Dealt to JJin91 [Kh Td]
jtsox4life13: calls 250
JJin91: folds=20
rbonessss333: calls 250
craze609 has timed out
craze609: folds=20
craze609 is sitting out
VinnieB118: checks=20
*** FLOP *** [8d Kc 3c]
VinnieB118: checks=20
jtsox4life13: checks=20
rbonessss333: bets 1025
VinnieB118: folds=20
jtsox4life13: folds=20
Uncalled bet (1025) returned to rbonessss333
rbonessss333 collected 1025 from pot
*** SUMMARY ***
Total pot 1025 | Rake 0=20
Board [8d Kc 3c]
Seat 1: JJin91 folded before Flop (didn't bet)
Seat 2: rbonessss333 (button) collected (1025)
Seat 4: craze609 (small blind) folded before Flop
Seat 5: VinnieB118 (big blind) folded on the Flop
Seat 6: jtsox4life13 folded on the Flop


*********** # 109 **************
PokerStars Hand #169475656077: Tournament #1597684053, $13.50+$1.50 USD=
 Hold'em No Limit - Level IX (150/300) - 2017/05/06 15:02:10 ET
Table '1597684053 7' 6-max Seat #4 is the button
Seat 1: JJin91 (29028 in chips)=20
Seat 2: rbonessss333 (14459 in chips)=20
Seat 3: NJPLandy15 (10000 in chips)=20
Seat 4: craze609 (16440 in chips) is sitting out
Seat 5: VinnieB118 (12820 in chips)=20
Seat 6: jtsox4life13 (27495 in chips)=20
JJin91: posts the ante 40
rbonessss333: posts the ante 40
NJPLandy15: posts the ante 40
craze609: posts the ante 40
VinnieB118: posts the ante 40
jtsox4life13: posts the ante 40
VinnieB118: posts small blind 150
jtsox4life13: posts big blind 300
*** HOLE CARDS ***
Dealt to JJin91 [6d As]
JJin91: folds=20
rbonessss333: folds=20
NJPLandy15: folds=20
craze609: folds=20
VinnieB118: folds=20
Uncalled bet (150) returned to jtsox4life13
jtsox4life13 collected 540 from pot
*** SUMMARY ***
Total pot 540 | Rake 0=20
Seat 1: JJin91 folded before Flop (didn't bet)
Seat 2: rbonessss333 folded before Flop (didn't bet)
Seat 3: NJPLandy15 folded before Flop (didn't bet)
Seat 4: craze609 (button) folded before Flop (didn't bet)
Seat 5: VinnieB118 (small blind) folded before Flop
Seat 6: jtsox4life13 (big blind) collected (540)


*********** # 110 **************
PokerStars Hand #169475656104: Tournament #1597684053, $13.50+$1.50 USD=
 Hold'em No Limit - Level IX (150/300) - 2017/05/06 15:02:18 ET
Table '1597684053 7' 6-max Seat #5 is the button
Seat 1: JJin91 (28988 in chips)=20
Seat 2: rbonessss333 (14419 in chips)=20
Seat 3: NJPLandy15 (9960 in chips)=20
Seat 4: craze609 (16400 in chips) is sitting out
Seat 5: VinnieB118 (12630 in chips)=20
Seat 6: jtsox4life13 (27845 in chips)=20
JJin91: posts the ante 40
rbonessss333: posts the ante 40
NJPLandy15: posts the ante 40
craze609: posts the ante 40
VinnieB118: posts the ante 40
jtsox4life13: posts the ante 40
jtsox4life13: posts small blind 150
JJin91: posts big blind 300
*** HOLE CARDS ***
Dealt to JJin91 [9s Qd]
rbonessss333: folds=20
NJPLandy15: folds=20
craze609: folds=20
VinnieB118: folds=20
jtsox4life13: calls 150
JJin91: checks=20
*** FLOP *** [Ks Qc 7c]
jtsox4life13: checks=20
JJin91: bets 445
jtsox4life13: folds=20
Uncalled bet (445) returned to JJin91
JJin91 collected 840 from pot
JJin91: doesn't show hand=20
*** SUMMARY ***
Total pot 840 | Rake 0=20
Board [Ks Qc 7c]
Seat 1: JJin91 (big blind) collected (840)
Seat 2: rbonessss333 folded before Flop (didn't bet)
Seat 3: NJPLandy15 folded before Flop (didn't bet)
Seat 4: craze609 folded before Flop (didn't bet)
Seat 5: VinnieB118 (button) folded before Flop (didn't bet)
Seat 6: jtsox4life13 (small blind) folded on the Flop


*********** # 111 **************
PokerStars Hand #169475656152: Tournament #1597684053, $13.50+$1.50 USD=
 Hold'em No Limit - Level IX (150/300) - 2017/05/06 15:02:40 ET
Table '1597684053 7' 6-max Seat #6 is the button
Seat 1: JJin91 (29488 in chips)=20
Seat 2: rbonessss333 (14379 in chips)=20
Seat 3: NJPLandy15 (9920 in chips)=20
Seat 4: craze609 (16360 in chips) is sitting out
Seat 5: VinnieB118 (12590 in chips)=20
Seat 6: jtsox4life13 (27505 in chips)=20
JJin91: posts the ante 40
rbonessss333: posts the ante 40
NJPLandy15: posts the ante 40
craze609: posts the ante 40
VinnieB118: posts the ante 40
jtsox4life13: posts the ante 40
JJin91: posts small blind 150
rbonessss333: posts big blind 300
*** HOLE CARDS ***
Dealt to JJin91 [2s Jc]
NJPLandy15: calls 300
craze609: folds=20
VinnieB118: folds=20
jtsox4life13: folds=20
JJin91: folds=20
rbonessss333: checks=20
*** FLOP *** [7h 8c 7c]
rbonessss333: bets 495
NJPLandy15: calls 495
*** TURN *** [7h 8c 7c] [8h]
rbonessss333: checks=20
NJPLandy15: checks=20
*** RIVER *** [7h 8c 7c 8h] [6h]
rbonessss333: bets 300
NJPLandy15: raises 900 to 1200
rbonessss333: raises 900 to 2100
craze609 is disconnected=20
NJPLandy15: raises 1500 to 3600
rbonessss333: raises 9944 to 13544 and is all-in
NJPLandy15: calls 5485 and is all-in
Uncalled bet (4459) returned to rbonessss333
*** SHOW DOWN ***
rbonessss333: shows [Qs 8s] (a full house, Eights full of Sevens)
NJPLandy15: shows [9d 8d] (a full house, Eights full of Sevens)
rbonessss333 collected 10075 from pot
NJPLandy15 collected 10075 from pot
*** SUMMARY ***
Total pot 20150 | Rake 0=20
Board [7h 8c 7c 8h 6h]
Seat 1: JJin91 (small blind) folded before Flop
Seat 2: rbonessss333 (big blind) showed [Qs 8s] and won (10075) with a =
full house, Eights full of Sevens
Seat 3: NJPLandy15 showed [9d 8d] and won (10075) with a full house, Ei=
ghts full of Sevens
Seat 4: craze609 folded before Flop (didn't bet)
Seat 5: VinnieB118 folded before Flop (didn't bet)
Seat 6: jtsox4life13 (button) folded before Flop (didn't bet)


*********** # 112 **************
PokerStars Hand #169475656288: Tournament #1597684053, $13.50+$1.50 USD=
 Hold'em No Limit - Level IX (150/300) - 2017/05/06 15:03:34 ET
Table '1597684053 7' 6-max Seat #1 is the button
Seat 1: JJin91 (29298 in chips)=20
Seat 2: rbonessss333 (14534 in chips)=20
Seat 3: NJPLandy15 (10075 in chips)=20
Seat 4: craze609 (16320 in chips) is sitting out
Seat 5: VinnieB118 (12550 in chips)=20
Seat 6: jtsox4life13 (27465 in chips)=20
JJin91: posts the ante 40
rbonessss333: posts the ante 40
NJPLandy15: posts the ante 40
craze609: posts the ante 40
VinnieB118: posts the ante 40
jtsox4life13: posts the ante 40
rbonessss333: posts small blind 150
NJPLandy15: posts big blind 300
*** HOLE CARDS ***
Dealt to JJin91 [5c 9h]
craze609: folds=20
VinnieB118: folds=20
jtsox4life13: folds=20
JJin91: folds=20
rbonessss333: calls 150
NJPLandy15: raises 900 to 1200
rbonessss333: folds=20
Uncalled bet (900) returned to NJPLandy15
NJPLandy15 collected 840 from pot
NJPLandy15: doesn't show hand=20
*** SUMMARY ***
Total pot 840 | Rake 0=20
Seat 1: JJin91 (button) folded before Flop (didn't bet)
Seat 2: rbonessss333 (small blind) folded before Flop
Seat 3: NJPLandy15 (big blind) collected (840)
Seat 4: craze609 folded before Flop (didn't bet)
Seat 5: VinnieB118 folded before Flop (didn't bet)
Seat 6: jtsox4life13 folded before Flop (didn't bet)


*********** # 113 **************
PokerStars Hand #169475656337: Tournament #1597684053, $13.50+$1.50 USD=
 Hold'em No Limit - Level IX (150/300) - 2017/05/06 15:03:51 ET
Table '1597684053 7' 6-max Seat #2 is the button
Seat 1: JJin91 (29258 in chips)=20
Seat 2: rbonessss333 (14194 in chips)=20
Seat 3: NJPLandy15 (10575 in chips)=20
Seat 5: VinnieB118 (12510 in chips)=20
Seat 6: jtsox4life13 (27425 in chips)=20
JJin91: posts the ante 40
rbonessss333: posts the ante 40
NJPLandy15: posts the ante 40
VinnieB118: posts the ante 40
jtsox4life13: posts the ante 40
NJPLandy15: posts small blind 150
VinnieB118: posts big blind 300
*** HOLE CARDS ***
Dealt to JJin91 [5c 4d]
jtsox4life13: raises 600 to 900
JJin91: folds=20
rbonessss333: folds=20
NJPLandy15: folds=20
VinnieB118 is disconnected=20
VinnieB118 is connected=20
VinnieB118: raises 11570 to 12470 and is all-in
jtsox4life13: folds=20
Uncalled bet (11570) returned to VinnieB118
VinnieB118 collected 2150 from pot
VinnieB118: doesn't show hand=20
*** SUMMARY ***
Total pot 2150 | Rake 0=20
Seat 1: JJin91 folded before Flop (didn't bet)
Seat 2: rbonessss333 (button) folded before Flop (didn't bet)
Seat 3: NJPLandy15 (small blind) folded before Flop
Seat 5: VinnieB118 (big blind) collected (2150)
Seat 6: jtsox4life13 folded before Flop


*********** # 114 **************
PokerStars Hand #169475656517: Tournament #1597684053, $13.50+$1.50 USD=
 Hold'em No Limit - Level IX (150/300) - 2017/05/06 15:05:00 ET
Table '1597684053 7' 6-max Seat #3 is the button
Seat 1: JJin91 (29218 in chips)=20
Seat 2: rbonessss333 (14154 in chips)=20
Seat 3: NJPLandy15 (10385 in chips)=20
Seat 5: VinnieB118 (13720 in chips)=20
Seat 6: jtsox4life13 (26485 in chips)=20
JJin91: posts the ante 40
rbonessss333: posts the ante 40
NJPLandy15: posts the ante 40
VinnieB118: posts the ante 40
jtsox4life13: posts the ante 40
VinnieB118: posts small blind 150
jtsox4life13: posts big blind 300
*** HOLE CARDS ***
Dealt to JJin91 [Qd Kh]
JJin91: raises 357 to 657
rbonessss333: folds=20
NJPLandy15: folds=20
VinnieB118: raises 13023 to 13680 and is all-in
jtsox4life13: folds=20
JJin91: folds=20
Uncalled bet (13023) returned to VinnieB118
VinnieB118 collected 1814 from pot
VinnieB118: doesn't show hand=20
*** SUMMARY ***
Total pot 1814 | Rake 0=20
Seat 1: JJin91 folded before Flop
Seat 2: rbonessss333 folded before Flop (didn't bet)
Seat 3: NJPLandy15 (button) folded before Flop (didn't bet)
Seat 5: VinnieB118 (small blind) collected (1814)
Seat 6: jtsox4life13 (big blind) folded before Flop


*********** # 115 **************
PokerStars Hand #169475656579: Tournament #1597684053, $13.50+$1.50 USD=
 Hold'em No Limit - Level IX (150/300) - 2017/05/06 15:05:20 ET
Table '1597684053 7' 6-max Seat #5 is the button
Seat 1: JJin91 (28521 in chips)=20
Seat 2: rbonessss333 (14114 in chips)=20
Seat 3: NJPLandy15 (10345 in chips)=20
Seat 5: VinnieB118 (14837 in chips)=20
Seat 6: jtsox4life13 (26145 in chips)=20
JJin91: posts the ante 40
rbonessss333: posts the ante 40
NJPLandy15: posts the ante 40
VinnieB118: posts the ante 40
jtsox4life13: posts the ante 40
jtsox4life13: posts small blind 150
JJin91: posts big blind 300
*** HOLE CARDS ***
Dealt to JJin91 [9c 4s]
rbonessss333: folds=20
NJPLandy15: folds=20
VinnieB118: folds=20
jtsox4life13: folds=20
Uncalled bet (150) returned to JJin91
JJin91 collected 500 from pot
JJin91: doesn't show hand=20
*** SUMMARY ***
Total pot 500 | Rake 0=20
Seat 1: JJin91 (big blind) collected (500)
Seat 2: rbonessss333 folded before Flop (didn't bet)
Seat 3: NJPLandy15 folded before Flop (didn't bet)
Seat 5: VinnieB118 (button) folded before Flop (didn't bet)
Seat 6: jtsox4life13 (small blind) folded before Flop


*********** # 116 **************
PokerStars Hand #169475656609: Tournament #1597684053, $13.50+$1.50 USD=
 Hold'em No Limit - Level IX (150/300) - 2017/05/06 15:05:30 ET
Table '1597684053 7' 6-max Seat #6 is the button
Seat 1: JJin91 (28831 in chips)=20
Seat 2: rbonessss333 (14074 in chips)=20
Seat 3: NJPLandy15 (10305 in chips)=20
Seat 5: VinnieB118 (14797 in chips)=20
Seat 6: jtsox4life13 (25955 in chips)=20
JJin91: posts the ante 40
rbonessss333: posts the ante 40
NJPLandy15: posts the ante 40
VinnieB118: posts the ante 40
jtsox4life13: posts the ante 40
JJin91: posts small blind 150
rbonessss333: posts big blind 300
*** HOLE CARDS ***
Dealt to JJin91 [Th 9d]
NJPLandy15: raises 600 to 900
VinnieB118: folds=20
jtsox4life13: calls 900
JJin91: folds=20
rbonessss333: folds=20
*** FLOP *** [9h Ah 9c]
NJPLandy15: bets 1200
jtsox4life13: folds=20
Uncalled bet (1200) returned to NJPLandy15
NJPLandy15 collected 2450 from pot
NJPLandy15: doesn't show hand=20
*** SUMMARY ***
Total pot 2450 | Rake 0=20
Board [9h Ah 9c]
Seat 1: JJin91 (small blind) folded before Flop
Seat 2: rbonessss333 (big blind) folded before Flop
Seat 3: NJPLandy15 collected (2450)
Seat 5: VinnieB118 folded before Flop (didn't bet)
Seat 6: jtsox4life13 (button) folded on the Flop


*********** # 117 **************
PokerStars Hand #169475656686: Tournament #1597684053, $13.50+$1.50 USD=
 Hold'em No Limit - Level IX (150/300) - 2017/05/06 15:05:56 ET
Table '1597684053 7' 6-max Seat #1 is the button
Seat 1: JJin91 (28641 in chips)=20
Seat 2: rbonessss333 (13734 in chips)=20
Seat 3: NJPLandy15 (11815 in chips)=20
Seat 5: VinnieB118 (14757 in chips)=20
Seat 6: jtsox4life13 (25015 in chips)=20
JJin91: posts the ante 40
rbonessss333: posts the ante 40
NJPLandy15: posts the ante 40
VinnieB118: posts the ante 40
jtsox4life13: posts the ante 40
rbonessss333: posts small blind 150
NJPLandy15: posts big blind 300
*** HOLE CARDS ***
Dealt to JJin91 [Qh 9c]
VinnieB118: folds=20
jtsox4life13: folds=20
JJin91: raises 357 to 657
rbonessss333: calls 507
NJPLandy15: calls 357
*** FLOP *** [2s 5s Jd]
rbonessss333: bets 300
NJPLandy15: folds=20
JJin91: raises 900 to 1200
rbonessss333: raises 900 to 2100
JJin91: folds=20
Uncalled bet (900) returned to rbonessss333
rbonessss333 collected 4571 from pot
*** SUMMARY ***
Total pot 4571 | Rake 0=20
Board [2s 5s Jd]
Seat 1: JJin91 (button) folded on the Flop
Seat 2: rbonessss333 (small blind) collected (4571)
Seat 3: NJPLandy15 (big blind) folded on the Flop
Seat 5: VinnieB118 folded before Flop (didn't bet)
Seat 6: jtsox4life13 folded before Flop (didn't bet)


*********** # 118 **************
PokerStars Hand #169475656845: Tournament #1597684053, $13.50+$1.50 USD=
 Hold'em No Limit - Level IX (150/300) - 2017/05/06 15:06:45 ET
Table '1597684053 7' 6-max Seat #2 is the button
Seat 1: JJin91 (26744 in chips)=20
Seat 2: rbonessss333 (16408 in chips)=20
Seat 3: NJPLandy15 (11118 in chips)=20
Seat 5: VinnieB118 (14717 in chips)=20
Seat 6: jtsox4life13 (24975 in chips)=20
JJin91: posts the ante 40
rbonessss333: posts the ante 40
NJPLandy15: posts the ante 40
VinnieB118: posts the ante 40
jtsox4life13: posts the ante 40
NJPLandy15: posts small blind 150
VinnieB118: posts big blind 300
*** HOLE CARDS ***
Dealt to JJin91 [Ah 7h]
jtsox4life13: folds=20
JJin91: raises 357 to 657
rbonessss333: folds=20
NJPLandy15: folds=20
VinnieB118: folds=20
Uncalled bet (357) returned to JJin91
JJin91 collected 950 from pot
JJin91: doesn't show hand=20
*** SUMMARY ***
Total pot 950 | Rake 0=20
Seat 1: JJin91 collected (950)
Seat 2: rbonessss333 (button) folded before Flop (didn't bet)
Seat 3: NJPLandy15 (small blind) folded before Flop
Seat 5: VinnieB118 (big blind) folded before Flop
Seat 6: jtsox4life13 folded before Flop (didn't bet)


*********** # 119 **************
PokerStars Hand #169475656881: Tournament #1597684053, $13.50+$1.50 USD=
 Hold'em No Limit - Level IX (150/300) - 2017/05/06 15:06:59 ET
Table '1597684053 7' 6-max Seat #3 is the button
Seat 1: JJin91 (27354 in chips)=20
Seat 2: rbonessss333 (16368 in chips)=20
Seat 3: NJPLandy15 (10928 in chips)=20
Seat 5: VinnieB118 (14377 in chips)=20
Seat 6: jtsox4life13 (24935 in chips)=20
JJin91: posts the ante 40
rbonessss333: posts the ante 40
NJPLandy15: posts the ante 40
VinnieB118: posts the ante 40
jtsox4life13: posts the ante 40
VinnieB118: posts small blind 150
jtsox4life13: posts big blind 300
*** HOLE CARDS ***
Dealt to JJin91 [2s 9h]
JJin91: folds=20
rbonessss333: folds=20
NJPLandy15: folds=20
VinnieB118: folds=20
Uncalled bet (150) returned to jtsox4life13
jtsox4life13 collected 500 from pot
*** SUMMARY ***
Total pot 500 | Rake 0=20
Seat 1: JJin91 folded before Flop (didn't bet)
Seat 2: rbonessss333 folded before Flop (didn't bet)
Seat 3: NJPLandy15 (button) folded before Flop (didn't bet)
Seat 5: VinnieB118 (small blind) folded before Flop
Seat 6: jtsox4life13 (big blind) collected (500)


*********** # 120 **************
PokerStars Hand #169475656956: Tournament #1597684053, $13.50+$1.50 USD=
 Hold'em No Limit - Level IX (150/300) - 2017/05/06 15:07:19 ET
Table '1597684053 7' 6-max Seat #5 is the button
Seat 1: JJin91 (27314 in chips)=20
Seat 2: rbonessss333 (16328 in chips)=20
Seat 3: NJPLandy15 (10888 in chips)=20
Seat 4: gator856500 (53170 in chips)=20
Seat 5: VinnieB118 (14187 in chips)=20
Seat 6: jtsox4life13 (25245 in chips)=20
JJin91: posts the ante 40
rbonessss333: posts the ante 40
NJPLandy15: posts the ante 40
gator856500: posts the ante 40
VinnieB118: posts the ante 40
jtsox4life13: posts the ante 40
jtsox4life13: posts small blind 150
JJin91: posts big blind 300
*** HOLE CARDS ***
Dealt to JJin91 [4d 7d]
rbonessss333: folds=20
NJPLandy15: calls 300
gator856500: folds=20
VinnieB118: folds=20
jtsox4life13: calls 150
JJin91: checks=20
*** FLOP *** [2s As Jh]
jtsox4life13: checks=20
JJin91: checks=20
NJPLandy15: checks=20
*** TURN *** [2s As Jh] [6s]
jtsox4life13: bets 600
JJin91: folds=20
NJPLandy15: calls 600
*** RIVER *** [2s As Jh 6s] [Jc]
jtsox4life13: bets 2400
NJPLandy15: folds=20
Uncalled bet (2400) returned to jtsox4life13
jtsox4life13 collected 2340 from pot
*** SUMMARY ***
Total pot 2340 | Rake 0=20
Board [2s As Jh 6s Jc]
Seat 1: JJin91 (big blind) folded on the Turn
Seat 2: rbonessss333 folded before Flop (didn't bet)
Seat 3: NJPLandy15 folded on the River
Seat 4: gator856500 folded before Flop (didn't bet)
Seat 5: VinnieB118 (button) folded before Flop (didn't bet)
Seat 6: jtsox4life13 (small blind) collected (2340)


*********** # 121 **************
PokerStars Hand #169475657068: Tournament #1597684053, $13.50+$1.50 USD=
 Hold'em No Limit - Level IX (150/300) - 2017/05/06 15:07:55 ET
Table '1597684053 7' 6-max Seat #6 is the button
Seat 1: JJin91 (26974 in chips)=20
Seat 2: rbonessss333 (16288 in chips)=20
Seat 3: NJPLandy15 (9948 in chips)=20
Seat 4: gator856500 (53130 in chips)=20
Seat 5: VinnieB118 (14147 in chips)=20
Seat 6: jtsox4life13 (26645 in chips)=20
JJin91: posts the ante 40
rbonessss333: posts the ante 40
NJPLandy15: posts the ante 40
gator856500: posts the ante 40
VinnieB118: posts the ante 40
jtsox4life13: posts the ante 40
JJin91: posts small blind 150
rbonessss333: posts big blind 300
*** HOLE CARDS ***
Dealt to JJin91 [7c 6s]
NJPLandy15: folds=20
gator856500: folds=20
VinnieB118: folds=20
jtsox4life13: folds=20
JJin91: calls 150
rbonessss333: checks=20
*** FLOP *** [Ts Ac Qc]
JJin91: checks=20
rbonessss333: checks=20
*** TURN *** [Ts Ac Qc] [4s]
JJin91: bets 445
rbonessss333: calls 445
*** RIVER *** [Ts Ac Qc 4s] [Kc]
JJin91: checks=20
rbonessss333: checks=20
*** SHOW DOWN ***
JJin91: shows [7c 6s] (high card Ace)
rbonessss333: shows [4d 6d] (a pair of Fours)
rbonessss333 collected 1730 from pot
*** SUMMARY ***
Total pot 1730 | Rake 0=20
Board [Ts Ac Qc 4s Kc]
Seat 1: JJin91 (small blind) showed [7c 6s] and lost with high card Ace
Seat 2: rbonessss333 (big blind) showed [4d 6d] and won (1730) with a p=
air of Fours
Seat 3: NJPLandy15 folded before Flop (didn't bet)
Seat 4: gator856500 folded before Flop (didn't bet)
Seat 5: VinnieB118 folded before Flop (didn't bet)
Seat 6: jtsox4life13 (button) folded before Flop (didn't bet)


*********** # 122 **************
PokerStars Hand #169475657188: Tournament #1597684053, $13.50+$1.50 USD=
 Hold'em No Limit - Level IX (150/300) - 2017/05/06 15:08:34 ET
Table '1597684053 7' 6-max Seat #1 is the button
Seat 1: JJin91 (26189 in chips)=20
Seat 2: rbonessss333 (17233 in chips)=20
Seat 3: NJPLandy15 (9908 in chips)=20
Seat 4: gator856500 (53090 in chips)=20
Seat 5: VinnieB118 (14107 in chips)=20
Seat 6: jtsox4life13 (26605 in chips)=20
JJin91: posts the ante 40
rbonessss333: posts the ante 40
NJPLandy15: posts the ante 40
gator856500: posts the ante 40
VinnieB118: posts the ante 40
jtsox4life13: posts the ante 40
rbonessss333: posts small blind 150
NJPLandy15: posts big blind 300
*** HOLE CARDS ***
Dealt to JJin91 [6s Jc]
gator856500: folds=20
VinnieB118: folds=20
jtsox4life13: folds=20
JJin91: folds=20
rbonessss333: folds=20
Uncalled bet (150) returned to NJPLandy15
NJPLandy15 collected 540 from pot
NJPLandy15: doesn't show hand=20
*** SUMMARY ***
Total pot 540 | Rake 0=20
Seat 1: JJin91 (button) folded before Flop (didn't bet)
Seat 2: rbonessss333 (small blind) folded before Flop
Seat 3: NJPLandy15 (big blind) collected (540)
Seat 4: gator856500 folded before Flop (didn't bet)
Seat 5: VinnieB118 folded before Flop (didn't bet)
Seat 6: jtsox4life13 folded before Flop (didn't bet)


*********** # 123 **************
PokerStars Hand #169475657234: Tournament #1597684053, $13.50+$1.50 USD=
 Hold'em No Limit - Level IX (150/300) - 2017/05/06 15:08:49 ET
Table '1597684053 7' 6-max Seat #2 is the button
Seat 1: JJin91 (26149 in chips)=20
Seat 2: rbonessss333 (17043 in chips)=20
Seat 3: NJPLandy15 (10258 in chips)=20
Seat 4: gator856500 (53050 in chips)=20
Seat 5: VinnieB118 (14067 in chips)=20
Seat 6: jtsox4life13 (26565 in chips)=20
JJin91: posts the ante 40
rbonessss333: posts the ante 40
NJPLandy15: posts the ante 40
gator856500: posts the ante 40
VinnieB118: posts the ante 40
jtsox4life13: posts the ante 40
NJPLandy15: posts small blind 150
gator856500: posts big blind 300
*** HOLE CARDS ***
Dealt to JJin91 [4d Qh]
VinnieB118: folds=20
jtsox4life13: folds=20
JJin91: folds=20
rbonessss333: folds=20
NJPLandy15: calls 150
gator856500: checks=20
*** FLOP *** [2h 8c Kc]
NJPLandy15: checks=20
gator856500: checks=20
*** TURN *** [2h 8c Kc] [3h]
NJPLandy15: checks=20
gator856500: checks=20
*** RIVER *** [2h 8c Kc 3h] [6d]
NJPLandy15: checks=20
gator856500: checks=20
*** SHOW DOWN ***
NJPLandy15: shows [9s Jd] (high card King)
gator856500: shows [6s 7h] (a pair of Sixes)
gator856500 collected 840 from pot
*** SUMMARY ***
Total pot 840 | Rake 0=20
Board [2h 8c Kc 3h 6d]
Seat 1: JJin91 folded before Flop (didn't bet)
Seat 2: rbonessss333 (button) folded before Flop (didn't bet)
Seat 3: NJPLandy15 (small blind) showed [9s Jd] and lost with high card=
 King
Seat 4: gator856500 (big blind) showed [6s 7h] and won (840) with a pai=
r of Sixes
Seat 5: VinnieB118 folded before Flop (didn't bet)
Seat 6: jtsox4life13 folded before Flop (didn't bet)


*********** # 124 **************
PokerStars Hand #169475657342: Tournament #1597684053, $13.50+$1.50 USD=
 Hold'em No Limit - Level IX (150/300) - 2017/05/06 15:09:20 ET
Table '1597684053 7' 6-max Seat #3 is the button
Seat 1: JJin91 (26109 in chips)=20
Seat 2: rbonessss333 (17003 in chips)=20
Seat 3: NJPLandy15 (9918 in chips)=20
Seat 4: gator856500 (53550 in chips)=20
Seat 5: VinnieB118 (14027 in chips)=20
Seat 6: jtsox4life13 (26525 in chips)=20
JJin91: posts the ante 40
rbonessss333: posts the ante 40
NJPLandy15: posts the ante 40
gator856500: posts the ante 40
VinnieB118: posts the ante 40
jtsox4life13: posts the ante 40
gator856500: posts small blind 150
VinnieB118: posts big blind 300
*** HOLE CARDS ***
Dealt to JJin91 [3d 9d]
jtsox4life13: calls 300
JJin91: folds=20
rbonessss333: folds=20
NJPLandy15: raises 600 to 900
gator856500: folds=20
VinnieB118: folds=20
jtsox4life13: calls 600
*** FLOP *** [2s 3c 7h]
jtsox4life13: checks=20
NJPLandy15: bets 1245
jtsox4life13: folds=20
Uncalled bet (1245) returned to NJPLandy15
NJPLandy15 collected 2490 from pot
NJPLandy15: doesn't show hand=20
*** SUMMARY ***
Total pot 2490 | Rake 0=20
Board [2s 3c 7h]
Seat 1: JJin91 folded before Flop (didn't bet)
Seat 2: rbonessss333 folded before Flop (didn't bet)
Seat 3: NJPLandy15 (button) collected (2490)
Seat 4: gator856500 (small blind) folded before Flop
Seat 5: VinnieB118 (big blind) folded before Flop
Seat 6: jtsox4life13 folded on the Flop


*********** # 125 **************
PokerStars Hand #169475657449: Tournament #1597684053, $13.50+$1.50 USD=
 Hold'em No Limit - Level IX (150/300) - 2017/05/06 15:09:56 ET
Table '1597684053 7' 6-max Seat #4 is the button
Seat 1: JJin91 (26069 in chips)=20
Seat 2: rbonessss333 (16963 in chips)=20
Seat 3: NJPLandy15 (11468 in chips)=20
Seat 4: gator856500 (53360 in chips)=20
Seat 5: VinnieB118 (13687 in chips)=20
Seat 6: jtsox4life13 (25585 in chips)=20
JJin91: posts the ante 40
rbonessss333: posts the ante 40
NJPLandy15: posts the ante 40
gator856500: posts the ante 40
VinnieB118: posts the ante 40
jtsox4life13: posts the ante 40
VinnieB118: posts small blind 150
jtsox4life13: posts big blind 300
*** HOLE CARDS ***
Dealt to JJin91 [Kd 2d]
JJin91: folds=20
rbonessss333: folds=20
NJPLandy15: folds=20
gator856500: folds=20
VinnieB118: folds=20
Uncalled bet (150) returned to jtsox4life13
jtsox4life13 collected 540 from pot
*** SUMMARY ***
Total pot 540 | Rake 0=20
Seat 1: JJin91 folded before Flop (didn't bet)
Seat 2: rbonessss333 folded before Flop (didn't bet)
Seat 3: NJPLandy15 folded before Flop (didn't bet)
Seat 4: gator856500 (button) folded before Flop (didn't bet)
Seat 5: VinnieB118 (small blind) folded before Flop
Seat 6: jtsox4life13 (big blind) collected (540)


*********** # 126 **************
PokerStars Hand #169475657505: Tournament #1597684053, $13.50+$1.50 USD=
 Hold'em No Limit - Level IX (150/300) - 2017/05/06 15:10:15 ET
Table '1597684053 7' 6-max Seat #5 is the button
Seat 1: JJin91 (26029 in chips)=20
Seat 2: rbonessss333 (16923 in chips)=20
Seat 3: NJPLandy15 (11428 in chips)=20
Seat 4: gator856500 (53320 in chips)=20
Seat 5: VinnieB118 (13497 in chips)=20
Seat 6: jtsox4life13 (25935 in chips)=20
JJin91: posts the ante 40
rbonessss333: posts the ante 40
NJPLandy15: posts the ante 40
gator856500: posts the ante 40
VinnieB118: posts the ante 40
jtsox4life13: posts the ante 40
jtsox4life13: posts small blind 150
JJin91: posts big blind 300
*** HOLE CARDS ***
Dealt to JJin91 [Td 9c]
rbonessss333: folds=20
NJPLandy15: folds=20
gator856500: folds=20
VinnieB118: folds=20
jtsox4life13: folds=20
Uncalled bet (150) returned to JJin91
JJin91 collected 540 from pot
JJin91: doesn't show hand=20
*** SUMMARY ***
Total pot 540 | Rake 0=20
Seat 1: JJin91 (big blind) collected (540)
Seat 2: rbonessss333 folded before Flop (didn't bet)
Seat 3: NJPLandy15 folded before Flop (didn't bet)
Seat 4: gator856500 folded before Flop (didn't bet)
Seat 5: VinnieB118 (button) folded before Flop (didn't bet)
Seat 6: jtsox4life13 (small blind) folded before Flop


*********** # 127 **************
PokerStars Hand #169475657537: Tournament #1597684053, $13.50+$1.50 USD=
 Hold'em No Limit - Level IX (150/300) - 2017/05/06 15:10:24 ET
Table '1597684053 7' 6-max Seat #6 is the button
Seat 1: JJin91 (26379 in chips)=20
Seat 2: rbonessss333 (16883 in chips)=20
Seat 3: NJPLandy15 (11388 in chips)=20
Seat 4: gator856500 (53280 in chips)=20
Seat 5: VinnieB118 (13457 in chips)=20
Seat 6: jtsox4life13 (25745 in chips)=20
JJin91: posts the ante 40
rbonessss333: posts the ante 40
NJPLandy15: posts the ante 40
gator856500: posts the ante 40
VinnieB118: posts the ante 40
jtsox4life13: posts the ante 40
JJin91: posts small blind 150
rbonessss333: posts big blind 300
*** HOLE CARDS ***
Dealt to JJin91 [8c Ac]
NJPLandy15: folds=20
gator856500: folds=20
VinnieB118: raises 600 to 900
jtsox4life13: folds=20
JJin91: calls 750
rbonessss333: folds=20
*** FLOP *** [Kh Js 6c]
JJin91: bets 1240
VinnieB118: folds=20
Uncalled bet (1240) returned to JJin91
JJin91 collected 2340 from pot
JJin91: doesn't show hand=20
*** SUMMARY ***
Total pot 2340 | Rake 0=20
Board [Kh Js 6c]
Seat 1: JJin91 (small blind) collected (2340)
Seat 2: rbonessss333 (big blind) folded before Flop
Seat 3: NJPLandy15 folded before Flop (didn't bet)
Seat 4: gator856500 folded before Flop (didn't bet)
Seat 5: VinnieB118 folded on the Flop
Seat 6: jtsox4life13 (button) folded before Flop (didn't bet)


*********** # 128 **************
PokerStars Hand #169475657616: Tournament #1597684053, $13.50+$1.50 USD=
 Hold'em No Limit - Level IX (150/300) - 2017/05/06 15:10:47 ET
Table '1597684053 7' 6-max Seat #1 is the button
Seat 1: JJin91 (27779 in chips)=20
Seat 2: rbonessss333 (16543 in chips)=20
Seat 4: gator856500 (53240 in chips)=20
Seat 5: VinnieB118 (12517 in chips)=20
Seat 6: jtsox4life13 (25705 in chips)=20
JJin91: posts the ante 40
rbonessss333: posts the ante 40
gator856500: posts the ante 40
VinnieB118: posts the ante 40
jtsox4life13: posts the ante 40
rbonessss333: posts small blind 150
gator856500: posts big blind 300
*** HOLE CARDS ***
Dealt to JJin91 [4s Tc]
VinnieB118: folds=20
jtsox4life13: raises 300 to 600
JJin91: folds=20
rbonessss333: folds=20
gator856500: calls 300
*** FLOP *** [Ts 4c Kd]
gator856500: checks=20
jtsox4life13: bets 1500
gator856500: folds=20
Uncalled bet (1500) returned to jtsox4life13
jtsox4life13 collected 1550 from pot
*** SUMMARY ***
Total pot 1550 | Rake 0=20
Board [Ts 4c Kd]
Seat 1: JJin91 (button) folded before Flop (didn't bet)
Seat 2: rbonessss333 (small blind) folded before Flop
Seat 4: gator856500 (big blind) folded on the Flop
Seat 5: VinnieB118 folded before Flop (didn't bet)
Seat 6: jtsox4life13 collected (1550)


*********** # 129 **************
PokerStars Hand #169475657691: Tournament #1597684053, $13.50+$1.50 USD=
 Hold'em No Limit - Level IX (150/300) - 2017/05/06 15:11:10 ET
Table '1597684053 7' 6-max Seat #2 is the button
Seat 1: JJin91 (27739 in chips)=20
Seat 2: rbonessss333 (16353 in chips)=20
Seat 4: gator856500 (52600 in chips)=20
Seat 5: VinnieB118 (12477 in chips)=20
Seat 6: jtsox4life13 (26615 in chips)=20
JJin91: posts the ante 40
rbonessss333: posts the ante 40
gator856500: posts the ante 40
VinnieB118: posts the ante 40
jtsox4life13: posts the ante 40
gator856500: posts small blind 150
VinnieB118: posts big blind 300
*** HOLE CARDS ***
Dealt to JJin91 [Qc Kd]
jtsox4life13: calls 300
JJin91: calls 300
rbonessss333: calls 300
gator856500: folds=20
VinnieB118: checks=20
*** FLOP *** [4s 5s 7h]
VinnieB118: checks=20
jtsox4life13: checks=20
JJin91: checks=20
rbonessss333: bets 600
VinnieB118: folds=20
jtsox4life13: calls 600
JJin91: calls 600
*** TURN *** [4s 5s 7h] [4d]
jtsox4life13: checks=20
JJin91: checks=20
rbonessss333: bets 300
jtsox4life13: calls 300
JJin91: calls 300
*** RIVER *** [4s 5s 7h 4d] [2c]
jtsox4life13: checks=20
JJin91: checks=20
rbonessss333: checks=20
*** SHOW DOWN ***
jtsox4life13: shows [Qh 8h] (a pair of Fours)
JJin91: shows [Qc Kd] (a pair of Fours - King kicker)
rbonessss333: shows [2h 3h] (two pair, Fours and Deuces)
rbonessss333 collected 4250 from pot
*** SUMMARY ***
Total pot 4250 | Rake 0=20
Board [4s 5s 7h 4d 2c]
Seat 1: JJin91 showed [Qc Kd] and lost with a pair of Fours
Seat 2: rbonessss333 (button) showed [2h 3h] and won (4250) with two pa=
ir, Fours and Deuces
Seat 4: gator856500 (small blind) folded before Flop
Seat 5: VinnieB118 (big blind) folded on the Flop
Seat 6: jtsox4life13 showed [Qh 8h] and lost with a pair of Fours


*********** # 130 **************
PokerStars Hand #169475657887: Tournament #1597684053, $13.50+$1.50 USD=
 Hold'em No Limit - Level X (200/400) - 2017/05/06 15:12:10 ET
Table '1597684053 7' 6-max Seat #4 is the button
Seat 1: JJin91 (26499 in chips)=20
Seat 2: rbonessss333 (19363 in chips)=20
Seat 4: gator856500 (52410 in chips)=20
Seat 5: VinnieB118 (12137 in chips)=20
Seat 6: jtsox4life13 (25375 in chips)=20
JJin91: posts the ante 50
rbonessss333: posts the ante 50
gator856500: posts the ante 50
VinnieB118: posts the ante 50
jtsox4life13: posts the ante 50
VinnieB118: posts small blind 200
jtsox4life13: posts big blind 400
*** HOLE CARDS ***
Dealt to JJin91 [Jd 5s]
JJin91: folds=20
rbonessss333: folds=20
gator856500: calls 400
VinnieB118: folds=20
jtsox4life13: checks=20
*** FLOP *** [7c 9c 8c]
jtsox4life13: checks=20
gator856500: bets 1250
jtsox4life13: raises 1250 to 2500
gator856500: calls 1250
*** TURN *** [7c 9c 8c] [2d]
jtsox4life13: bets 2400
gator856500: calls 2400
*** RIVER *** [7c 9c 8c 2d] [Ts]
jtsox4life13: bets 5600
gator856500: calls 5600
*** SHOW DOWN ***
jtsox4life13: shows [6h Tc] (a straight, Six to Ten)
gator856500: mucks hand=20
jtsox4life13 collected 22250 from pot
*** SUMMARY ***
Total pot 22250 | Rake 0=20
Board [7c 9c 8c 2d Ts]
Seat 1: JJin91 folded before Flop (didn't bet)
Seat 2: rbonessss333 folded before Flop (didn't bet)
Seat 4: gator856500 (button) mucked [Td Th]
Seat 5: VinnieB118 (small blind) folded before Flop
Seat 6: jtsox4life13 (big blind) showed [6h Tc] and won (22250) with a =
straight, Six to Ten


*********** # 131 **************
PokerStars Hand #169475658004: Tournament #1597684053, $13.50+$1.50 USD=
 Hold'em No Limit - Level X (200/400) - 2017/05/06 15:12:42 ET
Table '1597684053 7' 6-max Seat #5 is the button
Seat 1: JJin91 (26449 in chips)=20
Seat 2: rbonessss333 (19313 in chips)=20
Seat 3: FootPerv (10000 in chips)=20
Seat 4: gator856500 (41460 in chips)=20
Seat 5: VinnieB118 (11887 in chips)=20
Seat 6: jtsox4life13 (36675 in chips)=20
JJin91: posts the ante 50
rbonessss333: posts the ante 50
FootPerv: posts the ante 50
gator856500: posts the ante 50
VinnieB118: posts the ante 50
jtsox4life13: posts the ante 50
jtsox4life13: posts small blind 200
JJin91: posts big blind 400
*** HOLE CARDS ***
Dealt to JJin91 [8s 4s]
rbonessss333: folds=20
FootPerv: folds=20
gator856500: folds=20
VinnieB118: folds=20
jtsox4life13: folds=20
Uncalled bet (200) returned to JJin91
JJin91 collected 700 from pot
*** SUMMARY ***
Total pot 700 | Rake 0=20
Seat 1: JJin91 (big blind) collected (700)
Seat 2: rbonessss333 folded before Flop (didn't bet)
Seat 3: FootPerv folded before Flop (didn't bet)
Seat 4: gator856500 folded before Flop (didn't bet)
Seat 5: VinnieB118 (button) folded before Flop (didn't bet)
Seat 6: jtsox4life13 (small blind) folded before Flop


*********** # 132 **************
PokerStars Hand #169475658062: Tournament #1597684053, $13.50+$1.50 USD=
 Hold'em No Limit - Level X (200/400) - 2017/05/06 15:12:58 ET
Table '1597684053 7' 6-max Seat #6 is the button
Seat 1: JJin91 (26899 in chips)=20
Seat 2: rbonessss333 (19263 in chips)=20
Seat 3: FootPerv (9950 in chips)=20
Seat 4: gator856500 (41410 in chips)=20
Seat 5: VinnieB118 (11837 in chips)=20
Seat 6: jtsox4life13 (36425 in chips)=20
JJin91: posts the ante 50
rbonessss333: posts the ante 50
FootPerv: posts the ante 50
gator856500: posts the ante 50
VinnieB118: posts the ante 50
jtsox4life13: posts the ante 50
JJin91: posts small blind 200
rbonessss333: posts big blind 400
*** HOLE CARDS ***
Dealt to JJin91 [Qs 6c]
FootPerv: raises 400 to 800
gator856500: folds=20
VinnieB118: calls 800
jtsox4life13: folds=20
JJin91: folds=20
rbonessss333: folds=20
*** FLOP *** [7s 9c 2s]
FootPerv: bets 1200
VinnieB118: folds=20
Uncalled bet (1200) returned to FootPerv
FootPerv collected 2500 from pot
FootPerv: doesn't show hand=20
*** SUMMARY ***
Total pot 2500 | Rake 0=20
Board [7s 9c 2s]
Seat 1: JJin91 (small blind) folded before Flop
Seat 2: rbonessss333 (big blind) folded before Flop
Seat 3: FootPerv collected (2500)
Seat 4: gator856500 folded before Flop (didn't bet)
Seat 5: VinnieB118 folded on the Flop
Seat 6: jtsox4life13 (button) folded before Flop (didn't bet)


*********** # 133 **************
PokerStars Hand #169475658166: Tournament #1597684053, $13.50+$1.50 USD=
 Hold'em No Limit - Level X (200/400) - 2017/05/06 15:13:29 ET
Table '1597684053 7' 6-max Seat #1 is the button
Seat 1: JJin91 (26649 in chips)=20
Seat 2: rbonessss333 (18813 in chips)=20
Seat 3: FootPerv (11600 in chips)=20
Seat 4: gator856500 (41360 in chips)=20
Seat 5: VinnieB118 (10987 in chips)=20
Seat 6: jtsox4life13 (36375 in chips)=20
JJin91: posts the ante 50
rbonessss333: posts the ante 50
FootPerv: posts the ante 50
gator856500: posts the ante 50
VinnieB118: posts the ante 50
jtsox4life13: posts the ante 50
rbonessss333: posts small blind 200
FootPerv: posts big blind 400
*** HOLE CARDS ***
Dealt to JJin91 [Qs 2s]
gator856500: folds=20
VinnieB118: folds=20
jtsox4life13: folds=20
JJin91: raises 476 to 876
rbonessss333: folds=20
FootPerv: calls 476
*** FLOP *** [Jd 4d 4h]
FootPerv: checks=20
JJin91: checks=20
*** TURN *** [Jd 4d 4h] [5d]
FootPerv: bets 2400
JJin91: folds=20
Uncalled bet (2400) returned to FootPerv
FootPerv collected 2252 from pot
FootPerv: doesn't show hand=20
*** SUMMARY ***
Total pot 2252 | Rake 0=20
Board [Jd 4d 4h 5d]
Seat 1: JJin91 (button) folded on the Turn
Seat 2: rbonessss333 (small blind) folded before Flop
Seat 3: FootPerv (big blind) collected (2252)
Seat 4: gator856500 folded before Flop (didn't bet)
Seat 5: VinnieB118 folded before Flop (didn't bet)
Seat 6: jtsox4life13 folded before Flop (didn't bet)


*********** # 134 **************
PokerStars Hand #169475658307: Tournament #1597684053, $13.50+$1.50 USD=
 Hold'em No Limit - Level X (200/400) - 2017/05/06 15:14:16 ET
Table '1597684053 7' 6-max Seat #2 is the button
Seat 1: JJin91 (25723 in chips)=20
Seat 2: rbonessss333 (18563 in chips)=20
Seat 3: FootPerv (12926 in chips)=20
Seat 4: gator856500 (41310 in chips)=20
Seat 5: VinnieB118 (10937 in chips)=20
Seat 6: jtsox4life13 (36325 in chips)=20
JJin91: posts the ante 50
rbonessss333: posts the ante 50
FootPerv: posts the ante 50
gator856500: posts the ante 50
VinnieB118: posts the ante 50
jtsox4life13: posts the ante 50
FootPerv: posts small blind 200
gator856500: posts big blind 400
*** HOLE CARDS ***
Dealt to JJin91 [5d 8s]
VinnieB118: raises 10487 to 10887 and is all-in
jtsox4life13: folds=20
JJin91: folds=20
rbonessss333: calls 10887
FootPerv: folds=20
gator856500: folds=20
*** FLOP *** [Js Ah Jd]
*** TURN *** [Js Ah Jd] [4d]
*** RIVER *** [Js Ah Jd 4d] [3h]
*** SHOW DOWN ***
VinnieB118: shows [Kc Ac] (two pair, Aces and Jacks)
rbonessss333: shows [Kd As] (two pair, Aces and Jacks)
VinnieB118 collected 11337 from pot
rbonessss333 collected 11337 from pot
*** SUMMARY ***
Total pot 22674 | Rake 0=20
Board [Js Ah Jd 4d 3h]
Seat 1: JJin91 folded before Flop (didn't bet)
Seat 2: rbonessss333 (button) showed [Kd As] and won (11337) with two p=
air, Aces and Jacks
Seat 3: FootPerv (small blind) folded before Flop
Seat 4: gator856500 (big blind) folded before Flop
Seat 5: VinnieB118 showed [Kc Ac] and won (11337) with two pair, Aces a=
nd Jacks
Seat 6: jtsox4life13 folded before Flop (didn't bet)


*********** # 135 **************
PokerStars Hand #169475658410: Tournament #1597684053, $13.50+$1.50 USD=
 Hold'em No Limit - Level X (200/400) - 2017/05/06 15:14:44 ET
Table '1597684053 7' 6-max Seat #3 is the button
Seat 1: JJin91 (25673 in chips)=20
Seat 3: FootPerv (12676 in chips)=20
Seat 4: gator856500 (40860 in chips)=20
Seat 5: VinnieB118 (11337 in chips)=20
Seat 6: jtsox4life13 (36275 in chips)=20
JJin91: posts the ante 50
FootPerv: posts the ante 50
gator856500: posts the ante 50
VinnieB118: posts the ante 50
jtsox4life13: posts the ante 50
gator856500: posts small blind 200
VinnieB118: posts big blind 400
*** HOLE CARDS ***
Dealt to JJin91 [Ts Ad]
jtsox4life13: folds=20
JJin91: raises 476 to 876
FootPerv: folds=20
gator856500: folds=20
VinnieB118: folds=20
Uncalled bet (476) returned to JJin91
JJin91 collected 1250 from pot
JJin91: doesn't show hand=20
*** SUMMARY ***
Total pot 1250 | Rake 0=20
Seat 1: JJin91 collected (1250)
Seat 3: FootPerv (button) folded before Flop (didn't bet)
Seat 4: gator856500 (small blind) folded before Flop
Seat 5: VinnieB118 (big blind) folded before Flop
Seat 6: jtsox4life13 folded before Flop (didn't bet)


*********** # 136 **************
PokerStars Hand #169475658474: Tournament #1597684053, $13.50+$1.50 USD=
 Hold'em No Limit - Level X (200/400) - 2017/05/06 15:15:01 ET
Table '1597684053 7' 6-max Seat #4 is the button
Seat 1: JJin91 (26473 in chips)=20
Seat 3: FootPerv (12626 in chips)=20
Seat 4: gator856500 (40610 in chips)=20
Seat 5: VinnieB118 (10887 in chips)=20
Seat 6: jtsox4life13 (36225 in chips)=20
JJin91: posts the ante 50
FootPerv: posts the ante 50
gator856500: posts the ante 50
VinnieB118: posts the ante 50
jtsox4life13: posts the ante 50
VinnieB118: posts small blind 200
jtsox4life13: posts big blind 400
*** HOLE CARDS ***
Dealt to JJin91 [7d 8d]
JJin91: raises 476 to 876
FootPerv: folds=20
gator856500: calls 876
VinnieB118: folds=20
jtsox4life13: folds=20
*** FLOP *** [9s 6h 4c]
JJin91: bets 1379
gator856500: calls 1379
*** TURN *** [9s 6h 4c] [6d]
JJin91: bets 2841
gator856500: folds=20
Uncalled bet (2841) returned to JJin91
JJin91 collected 5360 from pot
JJin91: doesn't show hand=20
*** SUMMARY ***
Total pot 5360 | Rake 0=20
Board [9s 6h 4c 6d]
Seat 1: JJin91 collected (5360)
Seat 3: FootPerv folded before Flop (didn't bet)
Seat 4: gator856500 (button) folded on the Turn
Seat 5: VinnieB118 (small blind) folded before Flop
Seat 6: jtsox4life13 (big blind) folded before Flop


*********** # 137 **************
PokerStars Hand #169475658584: Tournament #1597684053, $13.50+$1.50 USD=
 Hold'em No Limit - Level X (200/400) - 2017/05/06 15:15:35 ET
Table '1597684053 7' 6-max Seat #5 is the button
Seat 1: JJin91 (29528 in chips)=20
Seat 2: albyal420 (10000 in chips)=20
Seat 3: FootPerv (12576 in chips)=20
Seat 4: gator856500 (38305 in chips)=20
Seat 5: VinnieB118 (10637 in chips)=20
Seat 6: jtsox4life13 (35775 in chips)=20
JJin91: posts the ante 50
albyal420: posts the ante 50
FootPerv: posts the ante 50
gator856500: posts the ante 50
VinnieB118: posts the ante 50
jtsox4life13: posts the ante 50
jtsox4life13: posts small blind 200
JJin91: posts big blind 400
*** HOLE CARDS ***
Dealt to JJin91 [3s Qh]
albyal420: calls 400
FootPerv: folds=20
gator856500: folds=20
VinnieB118: folds=20
jtsox4life13: calls 200
JJin91: checks=20
*** FLOP *** [Ad 7s 2c]
jtsox4life13: checks=20
JJin91: checks=20
albyal420: bets 800
jtsox4life13: folds=20
JJin91: folds=20
Uncalled bet (800) returned to albyal420
albyal420 collected 1500 from pot
albyal420: doesn't show hand=20
*** SUMMARY ***
Total pot 1500 | Rake 0=20
Board [Ad 7s 2c]
Seat 1: JJin91 (big blind) folded on the Flop
Seat 2: albyal420 collected (1500)
Seat 3: FootPerv folded before Flop (didn't bet)
Seat 4: gator856500 folded before Flop (didn't bet)
Seat 5: VinnieB118 (button) folded before Flop (didn't bet)
Seat 6: jtsox4life13 (small blind) folded on the Flop


*********** # 138 **************
PokerStars Hand #169475658737: Tournament #1597684053, $13.50+$1.50 USD=
 Hold'em No Limit - Level X (200/400) - 2017/05/06 15:16:22 ET
Table '1597684053 7' 6-max Seat #6 is the button
Seat 1: JJin91 (29078 in chips)=20
Seat 2: albyal420 (11050 in chips)=20
Seat 3: FootPerv (12526 in chips)=20
Seat 4: gator856500 (38255 in chips)=20
Seat 5: VinnieB118 (10587 in chips)=20
Seat 6: jtsox4life13 (35325 in chips)=20
JJin91: posts the ante 50
albyal420: posts the ante 50
FootPerv: posts the ante 50
gator856500: posts the ante 50
VinnieB118: posts the ante 50
jtsox4life13: posts the ante 50
JJin91: posts small blind 200
albyal420: posts big blind 400
*** HOLE CARDS ***
Dealt to JJin91 [9d Jh]
FootPerv: raises 400 to 800
gator856500: folds=20
VinnieB118: folds=20
jtsox4life13: calls 800
JJin91: folds=20
albyal420: raises 2900 to 3700
FootPerv: folds=20
jtsox4life13: folds=20
Uncalled bet (2900) returned to albyal420
albyal420 collected 2900 from pot
albyal420: doesn't show hand=20
*** SUMMARY ***
Total pot 2900 | Rake 0=20
Seat 1: JJin91 (small blind) folded before Flop
Seat 2: albyal420 (big blind) collected (2900)
Seat 3: FootPerv folded before Flop
Seat 4: gator856500 folded before Flop (didn't bet)
Seat 5: VinnieB118 folded before Flop (didn't bet)
Seat 6: jtsox4life13 (button) folded before Flop


*********** # 139 **************
PokerStars Hand #169475658876: Tournament #1597684053, $13.50+$1.50 USD=
 Hold'em No Limit - Level X (200/400) - 2017/05/06 15:17:05 ET
Table '1597684053 7' 6-max Seat #1 is the button
Seat 1: JJin91 (28828 in chips)=20
Seat 2: albyal420 (13100 in chips)=20
Seat 3: FootPerv (11676 in chips)=20
Seat 4: gator856500 (38205 in chips)=20
Seat 5: VinnieB118 (10537 in chips)=20
Seat 6: jtsox4life13 (34475 in chips)=20
JJin91: posts the ante 50
albyal420: posts the ante 50
FootPerv: posts the ante 50
gator856500: posts the ante 50
VinnieB118: posts the ante 50
jtsox4life13: posts the ante 50
albyal420: posts small blind 200
FootPerv: posts big blind 400
*** HOLE CARDS ***
Dealt to JJin91 [Kc 5d]
gator856500: folds=20
VinnieB118: calls 400
jtsox4life13: folds=20
JJin91: folds=20
albyal420: folds=20
FootPerv: checks=20
*** FLOP *** [4h 3c 9d]
FootPerv: checks=20
VinnieB118: bets 10087 and is all-in
FootPerv: folds=20
Uncalled bet (10087) returned to VinnieB118
VinnieB118 collected 1300 from pot
VinnieB118: doesn't show hand=20
*** SUMMARY ***
Total pot 1300 | Rake 0=20
Board [4h 3c 9d]
Seat 1: JJin91 (button) folded before Flop (didn't bet)
Seat 2: albyal420 (small blind) folded before Flop
Seat 3: FootPerv (big blind) folded on the Flop
Seat 4: gator856500 folded before Flop (didn't bet)
Seat 5: VinnieB118 collected (1300)
Seat 6: jtsox4life13 folded before Flop (didn't bet)


*********** # 140 **************
PokerStars Hand #169475659033: Tournament #1597684053, $13.50+$1.50 USD=
 Hold'em No Limit - Level X (200/400) - 2017/05/06 15:17:53 ET
Table '1597684053 7' 6-max Seat #2 is the button
Seat 1: JJin91 (28778 in chips)=20
Seat 2: albyal420 (12850 in chips)=20
Seat 3: FootPerv (11226 in chips)=20
Seat 4: gator856500 (38155 in chips)=20
Seat 5: VinnieB118 (11387 in chips)=20
Seat 6: jtsox4life13 (34425 in chips)=20
JJin91: posts the ante 50
albyal420: posts the ante 50
FootPerv: posts the ante 50
gator856500: posts the ante 50
VinnieB118: posts the ante 50
jtsox4life13: posts the ante 50
FootPerv: posts small blind 200
gator856500: posts big blind 400
*** HOLE CARDS ***
Dealt to JJin91 [5d Js]
VinnieB118: folds=20
jtsox4life13: calls 400
JJin91: folds=20
albyal420: folds=20
FootPerv: calls 200
gator856500: checks=20
*** FLOP *** [Ah Ad As]
FootPerv: checks=20
gator856500: checks=20
jtsox4life13: checks=20
*** TURN *** [Ah Ad As] [4d]
FootPerv: checks=20
gator856500: checks=20
jtsox4life13: bets 800
FootPerv: folds=20
gator856500: folds=20
Uncalled bet (800) returned to jtsox4life13
jtsox4life13 collected 1500 from pot
*** SUMMARY ***
Total pot 1500 | Rake 0=20
Board [Ah Ad As 4d]
Seat 1: JJin91 folded before Flop (didn't bet)
Seat 2: albyal420 (button) folded before Flop (didn't bet)
Seat 3: FootPerv (small blind) folded on the Turn
Seat 4: gator856500 (big blind) folded on the Turn
Seat 5: VinnieB118 folded before Flop (didn't bet)
Seat 6: jtsox4life13 collected (1500)


*********** # 141 **************
PokerStars Hand #169475659161: Tournament #1597684053, $13.50+$1.50 USD=
 Hold'em No Limit - Level X (200/400) - 2017/05/06 15:18:34 ET
Table '1597684053 7' 6-max Seat #3 is the button
Seat 1: JJin91 (28728 in chips)=20
Seat 2: albyal420 (12800 in chips)=20
Seat 3: FootPerv (10776 in chips)=20
Seat 4: gator856500 (37705 in chips)=20
Seat 5: VinnieB118 (11337 in chips)=20
Seat 6: jtsox4life13 (35475 in chips)=20
JJin91: posts the ante 50
albyal420: posts the ante 50
FootPerv: posts the ante 50
gator856500: posts the ante 50
VinnieB118: posts the ante 50
jtsox4life13: posts the ante 50
gator856500: posts small blind 200
VinnieB118: posts big blind 400
*** HOLE CARDS ***
Dealt to JJin91 [As 7d]
jtsox4life13: folds=20
JJin91: folds=20
albyal420: folds=20
FootPerv: folds=20
gator856500: calls 200
VinnieB118: raises 10887 to 11287 and is all-in
gator856500: calls 10887
*** FLOP *** [Ts 5d Jc]
*** TURN *** [Ts 5d Jc] [7c]
*** RIVER *** [Ts 5d Jc 7c] [5s]
*** SHOW DOWN ***
gator856500: shows [6c Ac] (a pair of Fives)
VinnieB118: shows [Ah Jh] (two pair, Jacks and Fives)
VinnieB118 collected 22874 from pot
*** SUMMARY ***
Total pot 22874 | Rake 0=20
Board [Ts 5d Jc 7c 5s]
Seat 1: JJin91 folded before Flop (didn't bet)
Seat 2: albyal420 folded before Flop (didn't bet)
Seat 3: FootPerv (button) folded before Flop (didn't bet)
Seat 4: gator856500 (small blind) showed [6c Ac] and lost with a pair o=
f Fives
Seat 5: VinnieB118 (big blind) showed [Ah Jh] and won (22874) with two =
pair, Jacks and Fives
Seat 6: jtsox4life13 folded before Flop (didn't bet)


*********** # 142 **************
PokerStars Hand #169475659252: Tournament #1597684053, $13.50+$1.50 USD=
 Hold'em No Limit - Level X (200/400) - 2017/05/06 15:18:58 ET
Table '1597684053 7' 6-max Seat #4 is the button
Seat 1: JJin91 (28678 in chips)=20
Seat 2: albyal420 (12750 in chips)=20
Seat 3: FootPerv (10726 in chips)=20
Seat 4: gator856500 (26368 in chips)=20
Seat 5: VinnieB118 (22874 in chips)=20
Seat 6: jtsox4life13 (35425 in chips)=20
JJin91: posts the ante 50
albyal420: posts the ante 50
FootPerv: posts the ante 50
gator856500: posts the ante 50
VinnieB118: posts the ante 50
jtsox4life13: posts the ante 50
VinnieB118: posts small blind 200
jtsox4life13: posts big blind 400
*** HOLE CARDS ***
Dealt to JJin91 [7d 3s]
JJin91: folds=20
albyal420: calls 400
FootPerv: folds=20
gator856500: folds=20
VinnieB118: folds=20
jtsox4life13: checks=20
*** FLOP *** [Ts 2s 6c]
jtsox4life13: checks=20
albyal420: bets 800
jtsox4life13: folds=20
Uncalled bet (800) returned to albyal420
albyal420 collected 1300 from pot
albyal420: doesn't show hand=20
*** SUMMARY ***
Total pot 1300 | Rake 0=20
Board [Ts 2s 6c]
Seat 1: JJin91 folded before Flop (didn't bet)
Seat 2: albyal420 collected (1300)
Seat 3: FootPerv folded before Flop (didn't bet)
Seat 4: gator856500 (button) folded before Flop (didn't bet)
Seat 5: VinnieB118 (small blind) folded before Flop
Seat 6: jtsox4life13 (big blind) folded on the Flop


*********** # 143 **************
PokerStars Hand #169475659326: Tournament #1597684053, $13.50+$1.50 USD=
 Hold'em No Limit - Level X (200/400) - 2017/05/06 15:19:21 ET
Table '1597684053 7' 6-max Seat #5 is the button
Seat 1: JJin91 (28628 in chips)=20
Seat 2: albyal420 (13600 in chips)=20
Seat 3: FootPerv (10676 in chips)=20
Seat 4: gator856500 (26318 in chips)=20
Seat 5: VinnieB118 (22624 in chips)=20
Seat 6: jtsox4life13 (34975 in chips)=20
JJin91: posts the ante 50
albyal420: posts the ante 50
FootPerv: posts the ante 50
gator856500: posts the ante 50
VinnieB118: posts the ante 50
jtsox4life13: posts the ante 50
jtsox4life13: posts small blind 200
JJin91: posts big blind 400
*** HOLE CARDS ***
Dealt to JJin91 [6s 8h]
albyal420: folds=20
FootPerv: folds=20
gator856500: folds=20
VinnieB118: folds=20
jtsox4life13: calls 200
JJin91: checks=20
*** FLOP *** [4h 3c Qd]
jtsox4life13: checks=20
JJin91: checks=20
*** TURN *** [4h 3c Qd] [Ks]
jtsox4life13: bets 400
JJin91: folds=20
Uncalled bet (400) returned to jtsox4life13
jtsox4life13 collected 1100 from pot
*** SUMMARY ***
Total pot 1100 | Rake 0=20
Board [4h 3c Qd Ks]
Seat 1: JJin91 (big blind) folded on the Turn
Seat 2: albyal420 folded before Flop (didn't bet)
Seat 3: FootPerv folded before Flop (didn't bet)
Seat 4: gator856500 folded before Flop (didn't bet)
Seat 5: VinnieB118 (button) folded before Flop (didn't bet)
Seat 6: jtsox4life13 (small blind) collected (1100)


*********** # 144 **************
PokerStars Hand #169475659412: Tournament #1597684053, $13.50+$1.50 USD=
 Hold'em No Limit - Level X (200/400) - 2017/05/06 15:19:48 ET
Table '1597684053 7' 6-max Seat #6 is the button
Seat 1: JJin91 (28178 in chips)=20
Seat 2: albyal420 (13550 in chips)=20
Seat 3: FootPerv (10626 in chips)=20
Seat 4: gator856500 (26268 in chips)=20
Seat 5: VinnieB118 (22574 in chips)=20
Seat 6: jtsox4life13 (35625 in chips)=20
JJin91: posts the ante 50
albyal420: posts the ante 50
FootPerv: posts the ante 50
gator856500: posts the ante 50
VinnieB118: posts the ante 50
jtsox4life13: posts the ante 50
JJin91: posts small blind 200
albyal420: posts big blind 400
*** HOLE CARDS ***
Dealt to JJin91 [Js Qd]
FootPerv: folds=20
gator856500: calls 400
VinnieB118: folds=20
jtsox4life13: folds=20
JJin91: calls 200
albyal420: checks=20
*** FLOP *** [6s Ad Kc]
JJin91: checks=20
albyal420: checks=20
gator856500: checks=20
*** TURN *** [6s Ad Kc] [6c]
JJin91: checks=20
albyal420: checks=20
gator856500: checks=20
*** RIVER *** [6s Ad Kc 6c] [Qc]
JJin91: checks=20
albyal420: checks=20
gator856500: checks=20
*** SHOW DOWN ***
JJin91: shows [Js Qd] (two pair, Queens and Sixes)
albyal420: mucks hand=20
gator856500: shows [9s Ks] (two pair, Kings and Sixes)
gator856500 collected 1500 from pot
*** SUMMARY ***
Total pot 1500 | Rake 0=20
Board [6s Ad Kc 6c Qc]
Seat 1: JJin91 (small blind) showed [Js Qd] and lost with two pair, Que=
ens and Sixes
Seat 2: albyal420 (big blind) mucked [8h 5c]
Seat 3: FootPerv folded before Flop (didn't bet)
Seat 4: gator856500 showed [9s Ks] and won (1500) with two pair, Kings =
and Sixes
Seat 5: VinnieB118 folded before Flop (didn't bet)
Seat 6: jtsox4life13 (button) folded before Flop (didn't bet)


*********** # 145 **************
PokerStars Hand #169475659568: Tournament #1597684053, $13.50+$1.50 USD=
 Hold'em No Limit - Level X (200/400) - 2017/05/06 15:20:42 ET
Table '1597684053 7' 6-max Seat #1 is the button
Seat 1: JJin91 (27728 in chips)=20
Seat 2: albyal420 (13100 in chips)=20
Seat 3: FootPerv (10576 in chips)=20
Seat 4: gator856500 (27318 in chips)=20
Seat 5: VinnieB118 (22524 in chips)=20
Seat 6: jtsox4life13 (35575 in chips)=20
JJin91: posts the ante 50
albyal420: posts the ante 50
FootPerv: posts the ante 50
gator856500: posts the ante 50
VinnieB118: posts the ante 50
jtsox4life13: posts the ante 50
albyal420: posts small blind 200
FootPerv: posts big blind 400
*** HOLE CARDS ***
Dealt to JJin91 [9h 4d]
gator856500: folds=20
VinnieB118: calls 400
jtsox4life13: raises 800 to 1200
JJin91: folds=20
albyal420: folds=20
FootPerv: calls 800
VinnieB118: calls 800
*** FLOP *** [As 2d 5h]
FootPerv: bets 2400
VinnieB118: folds=20
jtsox4life13: folds=20
Uncalled bet (2400) returned to FootPerv
FootPerv collected 4100 from pot
FootPerv: doesn't show hand=20
*** SUMMARY ***
Total pot 4100 | Rake 0=20
Board [As 2d 5h]
Seat 1: JJin91 (button) folded before Flop (didn't bet)
Seat 2: albyal420 (small blind) folded before Flop
Seat 3: FootPerv (big blind) collected (4100)
Seat 4: gator856500 folded before Flop (didn't bet)
Seat 5: VinnieB118 folded on the Flop
Seat 6: jtsox4life13 folded on the Flop


*********** # 146 **************
PokerStars Hand #169475659665: Tournament #1597684053, $13.50+$1.50 USD=
 Hold'em No Limit - Level X (200/400) - 2017/05/06 15:21:15 ET
Table '1597684053 7' 6-max Seat #2 is the button
Seat 1: JJin91 (27678 in chips)=20
Seat 2: albyal420 (12850 in chips)=20
Seat 3: FootPerv (13426 in chips)=20
Seat 4: gator856500 (27268 in chips)=20
Seat 6: jtsox4life13 (34325 in chips)=20
JJin91: posts the ante 50
albyal420: posts the ante 50
FootPerv: posts the ante 50
gator856500: posts the ante 50
jtsox4life13: posts the ante 50
FootPerv: posts small blind 200
gator856500: posts big blind 400
*** HOLE CARDS ***
Dealt to JJin91 [4s 8h]
jtsox4life13: folds=20
JJin91: folds=20
albyal420: raises 400 to 800
FootPerv: folds=20
gator856500: raises 26418 to 27218 and is all-in
albyal420: folds=20
Uncalled bet (26418) returned to gator856500
gator856500 collected 2050 from pot
gator856500: doesn't show hand=20
*** SUMMARY ***
Total pot 2050 | Rake 0=20
Seat 1: JJin91 folded before Flop (didn't bet)
Seat 2: albyal420 (button) folded before Flop
Seat 3: FootPerv (small blind) folded before Flop
Seat 4: gator856500 (big blind) collected (2050)
Seat 6: jtsox4life13 folded before Flop (didn't bet)


*********** # 147 **************
PokerStars Hand #169475659751: Tournament #1597684053, $13.50+$1.50 USD=
 Hold'em No Limit - Level XI (250/500) - 2017/05/06 15:21:47 ET
Table '1597684053 7' 6-max Seat #3 is the button
Seat 1: JJin91 (27628 in chips)=20
Seat 2: albyal420 (12000 in chips)=20
Seat 3: FootPerv (13176 in chips)=20
Seat 4: gator856500 (28468 in chips)=20
Seat 6: jtsox4life13 (34275 in chips)=20
JJin91: posts the ante 60
albyal420: posts the ante 60
FootPerv: posts the ante 60
gator856500: posts the ante 60
jtsox4life13: posts the ante 60
gator856500: posts small blind 250
jtsox4life13: posts big blind 500
*** HOLE CARDS ***
Dealt to JJin91 [As 3s]
JJin91: raises 595 to 1095
albyal420: folds=20
FootPerv: folds=20
gator856500: folds=20
jtsox4life13: folds=20
Uncalled bet (595) returned to JJin91
JJin91 collected 1550 from pot
JJin91: doesn't show hand=20
*** SUMMARY ***
Total pot 1550 | Rake 0=20
Seat 1: JJin91 collected (1550)
Seat 2: albyal420 folded before Flop (didn't bet)
Seat 3: FootPerv (button) folded before Flop (didn't bet)
Seat 4: gator856500 (small blind) folded before Flop
Seat 6: jtsox4life13 (big blind) folded before Flop


*********** # 148 **************
PokerStars Hand #169475659816: Tournament #1597684053, $13.50+$1.50 USD=
 Hold'em No Limit - Level XI (250/500) - 2017/05/06 15:22:08 ET
Table '1597684053 7' 6-max Seat #4 is the button
Seat 1: JJin91 (28618 in chips)=20
Seat 2: albyal420 (11940 in chips)=20
Seat 3: FootPerv (13116 in chips)=20
Seat 4: gator856500 (28158 in chips)=20
Seat 6: jtsox4life13 (33715 in chips)=20
JJin91: posts the ante 60
albyal420: posts the ante 60
FootPerv: posts the ante 60
gator856500: posts the ante 60
jtsox4life13: posts the ante 60
jtsox4life13: posts small blind 250
JJin91: posts big blind 500
*** HOLE CARDS ***
Dealt to JJin91 [7h 6s]
albyal420: calls 500
FootPerv: raises 500 to 1000
gator856500: calls 1000
jtsox4life13: folds=20
JJin91: folds=20
albyal420: calls 500
*** FLOP *** [3c 3d Ac]
albyal420: checks=20
FootPerv: checks=20
gator856500: checks=20
*** TURN *** [3c 3d Ac] [6d]
albyal420: bets 10880 and is all-in
FootPerv: raises 1176 to 12056 and is all-in
gator856500: calls 12056
*** RIVER *** [3c 3d Ac 6d] [5d]
*** SHOW DOWN ***
FootPerv: shows [6c 6h] (a full house, Sixes full of Threes)
gator856500: shows [2d Ad] (a flush, Ace high)
FootPerv collected 2352 from side pot
albyal420: shows [Js 8d] (a pair of Threes)
FootPerv collected 36690 from main pot
albyal420 finished the tournament in 54th place
*** SUMMARY ***
Total pot 39042 Main pot 36690. Side pot 2352. | Rake 0=20
Board [3c 3d Ac 6d 5d]
Seat 1: JJin91 (big blind) folded before Flop
Seat 2: albyal420 showed [Js 8d] and lost with a pair of Threes
Seat 3: FootPerv showed [6c 6h] and won (39042) with a full house, Sixe=
s full of Threes
Seat 4: gator856500 (button) showed [2d Ad] and lost with a flush, Ace =
high
Seat 6: jtsox4life13 (small blind) folded before Flop


*********** # 149 **************
PokerStars Hand #169475659931: Tournament #1597684053, $13.50+$1.50 USD=
 Hold'em No Limit - Level XI (250/500) - 2017/05/06 15:22:52 ET
Table '1597684053 7' 6-max Seat #6 is the button
Seat 1: JJin91 (28058 in chips)=20
Seat 3: FootPerv (39042 in chips)=20
Seat 4: gator856500 (15042 in chips)=20
Seat 5: RunsDeep84 (10000 in chips)=20
Seat 6: jtsox4life13 (33405 in chips)=20
JJin91: posts the ante 60
FootPerv: posts the ante 60
gator856500: posts the ante 60
RunsDeep84: posts the ante 60
jtsox4life13: posts the ante 60
JJin91: posts small blind 250
FootPerv: posts big blind 500
*** HOLE CARDS ***
Dealt to JJin91 [5c 4d]
gator856500: raises 14482 to 14982 and is all-in
RunsDeep84: folds=20
jtsox4life13: folds=20
JJin91: folds=20
FootPerv: folds=20
Uncalled bet (14482) returned to gator856500
gator856500 collected 1550 from pot
gator856500: doesn't show hand=20
*** SUMMARY ***
Total pot 1550 | Rake 0=20
Seat 1: JJin91 (small blind) folded before Flop
Seat 3: FootPerv (big blind) folded before Flop
Seat 4: gator856500 collected (1550)
Seat 5: RunsDeep84 folded before Flop (didn't bet)
Seat 6: jtsox4life13 (button) folded before Flop (didn't bet)


*********** # 150 **************
PokerStars Hand #169475659981: Tournament #1597684053, $13.50+$1.50 USD=
 Hold'em No Limit - Level XI (250/500) - 2017/05/06 15:23:08 ET
Table '1597684053 7' 6-max Seat #1 is the button
Seat 1: JJin91 (27748 in chips)=20
Seat 2: albyal420 (10000 in chips) out of hand (moved from another tabl=
e into small blind)
Seat 3: FootPerv (38482 in chips)=20
Seat 4: gator856500 (16032 in chips)=20
Seat 5: RunsDeep84 (9940 in chips)=20
Seat 6: jtsox4life13 (33345 in chips)=20
JJin91: posts the ante 60
FootPerv: posts the ante 60
gator856500: posts the ante 60
RunsDeep84: posts the ante 60
jtsox4life13: posts the ante 60
FootPerv: posts small blind 250
gator856500: posts big blind 500
*** HOLE CARDS ***
Dealt to JJin91 [Ac Qd]
RunsDeep84: folds=20
jtsox4life13: folds=20
JJin91: raises 595 to 1095
FootPerv: calls 845
gator856500: calls 595
*** FLOP *** [3h 6c 5h]
FootPerv: checks=20
gator856500: checks=20
JJin91: bets 1611
FootPerv: raises 4111 to 5722
gator856500: folds=20
JJin91: folds=20
Uncalled bet (4111) returned to FootPerv
FootPerv collected 6807 from pot
FootPerv: doesn't show hand=20
*** SUMMARY ***
Total pot 6807 | Rake 0=20
Board [3h 6c 5h]
Seat 1: JJin91 (button) folded on the Flop
Seat 3: FootPerv (small blind) collected (6807)
Seat 4: gator856500 (big blind) folded on the Flop
Seat 5: RunsDeep84 folded before Flop (didn't bet)
Seat 6: jtsox4life13 folded before Flop (didn't bet)


*********** # 151 **************
PokerStars Hand #169475986032: Tournament #1597684053, $13.50+$1.50 USD=
 Hold'em No Limit - Level XI (250/500) - 2017/05/06 15:24:06 ET
Table '1597684053 7' 6-max Seat #3 is the button
Seat 1: JJin91 (24982 in chips)=20
Seat 2: albyal420 (10000 in chips)=20
Seat 3: FootPerv (42523 in chips)=20
Seat 4: gator856500 (14877 in chips)=20
Seat 5: RunsDeep84 (9880 in chips)=20
Seat 6: jtsox4life13 (33285 in chips)=20
JJin91: posts the ante 60
albyal420: posts the ante 60
FootPerv: posts the ante 60
gator856500: posts the ante 60
RunsDeep84: posts the ante 60
jtsox4life13: posts the ante 60
gator856500: posts small blind 250
RunsDeep84: posts big blind 500
*** HOLE CARDS ***
Dealt to JJin91 [Qd 8h]
jtsox4life13: folds=20
JJin91: folds=20
albyal420: calls 500
FootPerv: folds=20
gator856500: calls 250
RunsDeep84: raises 9320 to 9820 and is all-in
albyal420: folds=20
gator856500: calls 9320
*** FLOP *** [Ah 6h 4h]
*** TURN *** [Ah 6h 4h] [Kc]
*** RIVER *** [Ah 6h 4h Kc] [Kh]
*** SHOW DOWN ***
gator856500: shows [8c As] (two pair, Aces and Kings)
RunsDeep84: shows [Ad 7h] (a flush, Ace high)
RunsDeep84 collected 20500 from pot
*** SUMMARY ***
Total pot 20500 | Rake 0=20
Board [Ah 6h 4h Kc Kh]
Seat 1: JJin91 folded before Flop (didn't bet)
Seat 2: albyal420 folded before Flop
Seat 3: FootPerv (button) folded before Flop (didn't bet)
Seat 4: gator856500 (small blind) showed [8c As] and lost with two pair=
, Aces and Kings
Seat 5: RunsDeep84 (big blind) showed [Ad 7h] and won (20500) with a fl=
ush, Ace high
Seat 6: jtsox4life13 folded before Flop (didn't bet)


*********** # 152 **************
PokerStars Hand #169475986102: Tournament #1597684053, $13.50+$1.50 USD=
 Hold'em No Limit - Level XI (250/500) - 2017/05/06 15:24:35 ET
Table '1597684053 7' 6-max Seat #4 is the button
Seat 1: JJin91 (24922 in chips)=20
Seat 2: albyal420 (9440 in chips)=20
Seat 3: FootPerv (42463 in chips)=20
Seat 4: gator856500 (4997 in chips)=20
Seat 5: RunsDeep84 (20500 in chips)=20
Seat 6: jtsox4life13 (33225 in chips)=20
JJin91: posts the ante 60
albyal420: posts the ante 60
FootPerv: posts the ante 60
gator856500: posts the ante 60
RunsDeep84: posts the ante 60
jtsox4life13: posts the ante 60
RunsDeep84: posts small blind 250
jtsox4life13: posts big blind 500
*** HOLE CARDS ***
Dealt to JJin91 [Kc 6d]
JJin91: folds=20
albyal420: folds=20
FootPerv: folds=20
gator856500: folds=20
RunsDeep84: folds=20
Uncalled bet (250) returned to jtsox4life13
jtsox4life13 collected 860 from pot
*** SUMMARY ***
Total pot 860 | Rake 0=20
Seat 1: JJin91 folded before Flop (didn't bet)
Seat 2: albyal420 folded before Flop (didn't bet)
Seat 3: FootPerv folded before Flop (didn't bet)
Seat 4: gator856500 (button) folded before Flop (didn't bet)
Seat 5: RunsDeep84 (small blind) folded before Flop
Seat 6: jtsox4life13 (big blind) collected (860)


*********** # 153 **************
PokerStars Hand #169475986152: Tournament #1597684053, $13.50+$1.50 USD=
 Hold'em No Limit - Level XI (250/500) - 2017/05/06 15:24:52 ET
Table '1597684053 7' 6-max Seat #5 is the button
Seat 1: JJin91 (24862 in chips)=20
Seat 2: albyal420 (9380 in chips)=20
Seat 3: FootPerv (42403 in chips)=20
Seat 4: gator856500 (4937 in chips)=20
Seat 5: RunsDeep84 (20190 in chips)=20
Seat 6: jtsox4life13 (33775 in chips)=20
JJin91: posts the ante 60
albyal420: posts the ante 60
FootPerv: posts the ante 60
gator856500: posts the ante 60
RunsDeep84: posts the ante 60
jtsox4life13: posts the ante 60
jtsox4life13: posts small blind 250
JJin91: posts big blind 500
*** HOLE CARDS ***
Dealt to JJin91 [2s 5d]
albyal420: folds=20
FootPerv: folds=20
gator856500: raises 4377 to 4877 and is all-in
RunsDeep84: folds=20
jtsox4life13: folds=20
JJin91: folds=20
Uncalled bet (4377) returned to gator856500
gator856500 collected 1610 from pot
gator856500: doesn't show hand=20
*** SUMMARY ***
Total pot 1610 | Rake 0=20
Seat 1: JJin91 (big blind) folded before Flop
Seat 2: albyal420 folded before Flop (didn't bet)
Seat 3: FootPerv folded before Flop (didn't bet)
Seat 4: gator856500 collected (1610)
Seat 5: RunsDeep84 (button) folded before Flop (didn't bet)
Seat 6: jtsox4life13 (small blind) folded before Flop


*********** # 154 **************
PokerStars Hand #169475986195: Tournament #1597684053, $13.50+$1.50 USD=
 Hold'em No Limit - Level XI (250/500) - 2017/05/06 15:25:11 ET
Table '1597684053 7' 6-max Seat #6 is the button
Seat 1: JJin91 (24302 in chips)=20
Seat 2: albyal420 (9320 in chips)=20
Seat 3: FootPerv (42343 in chips)=20
Seat 4: gator856500 (5987 in chips)=20
Seat 5: RunsDeep84 (20130 in chips)=20
Seat 6: jtsox4life13 (33465 in chips)=20
JJin91: posts the ante 60
albyal420: posts the ante 60
FootPerv: posts the ante 60
gator856500: posts the ante 60
RunsDeep84: posts the ante 60
jtsox4life13: posts the ante 60
JJin91: posts small blind 250
albyal420: posts big blind 500
*** HOLE CARDS ***
Dealt to JJin91 [Qd Qs]
FootPerv: raises 500 to 1000
gator856500: folds=20
RunsDeep84: folds=20
jtsox4life13: folds=20
JJin91: raises 2000 to 3000
albyal420: folds=20
FootPerv: folds=20
Uncalled bet (2000) returned to JJin91
JJin91 collected 2860 from pot
JJin91: doesn't show hand=20
*** SUMMARY ***
Total pot 2860 | Rake 0=20
Seat 1: JJin91 (small blind) collected (2860)
Seat 2: albyal420 (big blind) folded before Flop
Seat 3: FootPerv folded before Flop
Seat 4: gator856500 folded before Flop (didn't bet)
Seat 5: RunsDeep84 folded before Flop (didn't bet)
Seat 6: jtsox4life13 (button) folded before Flop (didn't bet)


*********** # 155 **************
PokerStars Hand #169475986255: Tournament #1597684053, $13.50+$1.50 USD=
 Hold'em No Limit - Level XI (250/500) - 2017/05/06 15:25:36 ET
Table '1597684053 7' 6-max Seat #1 is the button
Seat 1: JJin91 (26102 in chips)=20
Seat 2: albyal420 (8760 in chips)=20
Seat 3: FootPerv (41283 in chips)=20
Seat 4: gator856500 (5927 in chips)=20
Seat 5: RunsDeep84 (20070 in chips)=20
Seat 6: jtsox4life13 (33405 in chips)=20
JJin91: posts the ante 60
albyal420: posts the ante 60
FootPerv: posts the ante 60
gator856500: posts the ante 60
RunsDeep84: posts the ante 60
jtsox4life13: posts the ante 60
albyal420: posts small blind 250
FootPerv: posts big blind 500
*** HOLE CARDS ***
Dealt to JJin91 [Th 4h]
gator856500: folds=20
RunsDeep84: raises 750 to 1250
jtsox4life13: calls 1250
JJin91: folds=20
albyal420: folds=20
FootPerv: folds=20
*** FLOP *** [5d 6s 8c]
RunsDeep84: bets 1500
jtsox4life13: calls 1500
*** TURN *** [5d 6s 8c] [9c]
RunsDeep84: checks=20
jtsox4life13: checks=20
*** RIVER *** [5d 6s 8c 9c] [5c]
RunsDeep84: bets 6610
jtsox4life13: folds=20
Uncalled bet (6610) returned to RunsDeep84
RunsDeep84 collected 6610 from pot
RunsDeep84: doesn't show hand=20
*** SUMMARY ***
Total pot 6610 | Rake 0=20
Board [5d 6s 8c 9c 5c]
Seat 1: JJin91 (button) folded before Flop (didn't bet)
Seat 2: albyal420 (small blind) folded before Flop
Seat 3: FootPerv (big blind) folded before Flop
Seat 4: gator856500 folded before Flop (didn't bet)
Seat 5: RunsDeep84 collected (6610)
Seat 6: jtsox4life13 folded on the River


*********** # 156 **************
PokerStars Hand #169475986375: Tournament #1597684053, $13.50+$1.50 USD=
 Hold'em No Limit - Level XI (250/500) - 2017/05/06 15:26:20 ET
Table '1597684053 7' 6-max Seat #2 is the button
Seat 1: JJin91 (26042 in chips)=20
Seat 2: albyal420 (8450 in chips)=20
Seat 3: FootPerv (40723 in chips)=20
Seat 4: gator856500 (5867 in chips)=20
Seat 5: RunsDeep84 (23870 in chips)=20
Seat 6: jtsox4life13 (30595 in chips)=20
JJin91: posts the ante 60
albyal420: posts the ante 60
FootPerv: posts the ante 60
gator856500: posts the ante 60
RunsDeep84: posts the ante 60
jtsox4life13: posts the ante 60
FootPerv: posts small blind 250
gator856500: posts big blind 500
*** HOLE CARDS ***
Dealt to JJin91 [7h Ks]
RunsDeep84: raises 500 to 1000
jtsox4life13: folds=20
JJin91: folds=20
albyal420: folds=20
FootPerv: folds=20
gator856500: calls 500
*** FLOP *** [6h 2h 3h]
gator856500: checks=20
RunsDeep84: checks=20
*** TURN *** [6h 2h 3h] [4c]
gator856500: bets 4807 and is all-in
RunsDeep84: folds=20
Uncalled bet (4807) returned to gator856500
gator856500 collected 2610 from pot
gator856500: doesn't show hand=20
*** SUMMARY ***
Total pot 2610 | Rake 0=20
Board [6h 2h 3h 4c]
Seat 1: JJin91 folded before Flop (didn't bet)
Seat 2: albyal420 (button) folded before Flop (didn't bet)
Seat 3: FootPerv (small blind) folded before Flop
Seat 4: gator856500 (big blind) collected (2610)
Seat 5: RunsDeep84 folded on the Turn
Seat 6: jtsox4life13 folded before Flop (didn't bet)


*********** # 157 **************
PokerStars Hand #169475986487: Tournament #1597684053, $13.50+$1.50 USD=
 Hold'em No Limit - Level XI (250/500) - 2017/05/06 15:27:01 ET
Table '1597684053 7' 6-max Seat #3 is the button
Seat 1: JJin91 (25982 in chips)=20
Seat 2: albyal420 (8390 in chips)=20
Seat 3: FootPerv (40413 in chips)=20
Seat 4: gator856500 (7417 in chips)=20
Seat 5: RunsDeep84 (22810 in chips)=20
Seat 6: jtsox4life13 (30535 in chips)=20
JJin91: posts the ante 60
albyal420: posts the ante 60
FootPerv: posts the ante 60
gator856500: posts the ante 60
RunsDeep84: posts the ante 60
jtsox4life13: posts the ante 60
gator856500: posts small blind 250
RunsDeep84: posts big blind 500
*** HOLE CARDS ***
Dealt to JJin91 [4s 3s]
jtsox4life13: folds=20
JJin91: folds=20
albyal420: folds=20
FootPerv: raises 500 to 1000
gator856500: folds=20
RunsDeep84: calls 500
*** FLOP *** [Qs Qd Js]
RunsDeep84: checks=20
FootPerv: bets 1500
RunsDeep84: calls 1500
*** TURN *** [Qs Qd Js] [7s]
RunsDeep84: checks=20
FootPerv: checks=20
*** RIVER *** [Qs Qd Js 7s] [4h]
RunsDeep84: checks=20
FootPerv: bets 2000
RunsDeep84: calls 2000
*** SHOW DOWN ***
FootPerv: shows [Qh Th] (three of a kind, Queens)
RunsDeep84: mucks hand=20
FootPerv collected 9610 from pot
*** SUMMARY ***
Total pot 9610 | Rake 0=20
Board [Qs Qd Js 7s 4h]
Seat 1: JJin91 folded before Flop (didn't bet)
Seat 2: albyal420 folded before Flop (didn't bet)
Seat 3: FootPerv (button) showed [Qh Th] and won (9610) with three of a=
 kind, Queens
Seat 4: gator856500 (small blind) folded before Flop
Seat 5: RunsDeep84 (big blind) mucked [7h Jc]
Seat 6: jtsox4life13 folded before Flop (didn't bet)


*********** # 158 **************
PokerStars Hand #169475986692: Tournament #1597684053, $13.50+$1.50 USD=
 Hold'em No Limit - Level XI (250/500) - 2017/05/06 15:28:12 ET
Table '1597684053 7' 6-max Seat #4 is the button
Seat 1: JJin91 (25922 in chips)=20
Seat 2: albyal420 (8330 in chips)=20
Seat 3: FootPerv (45463 in chips)=20
Seat 4: gator856500 (7107 in chips)=20
Seat 5: RunsDeep84 (18250 in chips)=20
Seat 6: jtsox4life13 (30475 in chips)=20
JJin91: posts the ante 60
albyal420: posts the ante 60
FootPerv: posts the ante 60
gator856500: posts the ante 60
RunsDeep84: posts the ante 60
jtsox4life13: posts the ante 60
RunsDeep84: posts small blind 250
jtsox4life13: posts big blind 500
*** HOLE CARDS ***
Dealt to JJin91 [6s 9s]
JJin91: folds=20
albyal420: folds=20
FootPerv: folds=20
gator856500: folds=20
RunsDeep84: folds=20
Uncalled bet (250) returned to jtsox4life13
jtsox4life13 collected 860 from pot
*** SUMMARY ***
Total pot 860 | Rake 0=20
Seat 1: JJin91 folded before Flop (didn't bet)
Seat 2: albyal420 folded before Flop (didn't bet)
Seat 3: FootPerv folded before Flop (didn't bet)
Seat 4: gator856500 (button) folded before Flop (didn't bet)
Seat 5: RunsDeep84 (small blind) folded before Flop
Seat 6: jtsox4life13 (big blind) collected (860)


*********** # 159 **************
PokerStars Hand #169475986754: Tournament #1597684053, $13.50+$1.50 USD=
 Hold'em No Limit - Level XI (250/500) - 2017/05/06 15:28:36 ET
Table '1597684053 7' 6-max Seat #5 is the button
Seat 1: JJin91 (25862 in chips)=20
Seat 2: albyal420 (8270 in chips)=20
Seat 3: FootPerv (45403 in chips)=20
Seat 4: gator856500 (7047 in chips)=20
Seat 5: RunsDeep84 (17940 in chips)=20
Seat 6: jtsox4life13 (31025 in chips)=20
JJin91: posts the ante 60
albyal420: posts the ante 60
FootPerv: posts the ante 60
gator856500: posts the ante 60
RunsDeep84: posts the ante 60
jtsox4life13: posts the ante 60
jtsox4life13: posts small blind 250
JJin91: posts big blind 500
*** HOLE CARDS ***
Dealt to JJin91 [4s 7h]
albyal420: folds=20
FootPerv: folds=20
gator856500: calls 500
RunsDeep84: folds=20
jtsox4life13: calls 250
JJin91: checks=20
*** FLOP *** [Ac Qd 9h]
jtsox4life13: checks=20
JJin91: checks=20
gator856500: bets 6487 and is all-in
jtsox4life13: folds=20
JJin91: folds=20
Uncalled bet (6487) returned to gator856500
gator856500 collected 1860 from pot
gator856500: doesn't show hand=20
*** SUMMARY ***
Total pot 1860 | Rake 0=20
Board [Ac Qd 9h]
Seat 1: JJin91 (big blind) folded on the Flop
Seat 2: albyal420 folded before Flop (didn't bet)
Seat 3: FootPerv folded before Flop (didn't bet)
Seat 4: gator856500 collected (1860)
Seat 5: RunsDeep84 (button) folded before Flop (didn't bet)
Seat 6: jtsox4life13 (small blind) folded on the Flop


*********** # 160 **************
PokerStars Hand #169475986832: Tournament #1597684053, $13.50+$1.50 USD=
 Hold'em No Limit - Level XI (250/500) - 2017/05/06 15:29:03 ET
Table '1597684053 7' 6-max Seat #6 is the button
Seat 1: JJin91 (25302 in chips)=20
Seat 2: albyal420 (8210 in chips)=20
Seat 3: FootPerv (45343 in chips)=20
Seat 4: gator856500 (8347 in chips)=20
Seat 5: RunsDeep84 (17880 in chips)=20
Seat 6: jtsox4life13 (30465 in chips)=20
JJin91: posts the ante 60
albyal420: posts the ante 60
FootPerv: posts the ante 60
gator856500: posts the ante 60
RunsDeep84: posts the ante 60
jtsox4life13: posts the ante 60
JJin91: posts small blind 250
albyal420: posts big blind 500
*** HOLE CARDS ***
Dealt to JJin91 [9h 4c]
FootPerv: raises 500 to 1000
gator856500: folds=20
RunsDeep84: folds=20
jtsox4life13: raises 3110 to 4110
JJin91: folds=20
albyal420: folds=20
FootPerv: folds=20
Uncalled bet (3110) returned to jtsox4life13
jtsox4life13 collected 3110 from pot
*** SUMMARY ***
Total pot 3110 | Rake 0=20
Seat 1: JJin91 (small blind) folded before Flop
Seat 2: albyal420 (big blind) folded before Flop
Seat 3: FootPerv folded before Flop
Seat 4: gator856500 folded before Flop (didn't bet)
Seat 5: RunsDeep84 folded before Flop (didn't bet)
Seat 6: jtsox4life13 (button) collected (3110)


*********** # 161 **************
PokerStars Hand #169475986907: Tournament #1597684053, $13.50+$1.50 USD=
 Hold'em No Limit - Level XI (250/500) - 2017/05/06 15:29:30 ET
Table '1597684053 7' 6-max Seat #1 is the button
Seat 1: JJin91 (24992 in chips)=20
Seat 2: albyal420 (7650 in chips)=20
Seat 3: FootPerv (44283 in chips)=20
Seat 4: gator856500 (8287 in chips)=20
Seat 5: RunsDeep84 (17820 in chips)=20
Seat 6: jtsox4life13 (32515 in chips)=20
JJin91: posts the ante 60
albyal420: posts the ante 60
FootPerv: posts the ante 60
gator856500: posts the ante 60
RunsDeep84: posts the ante 60
jtsox4life13: posts the ante 60
albyal420: posts small blind 250
FootPerv: posts big blind 500
*** HOLE CARDS ***
Dealt to JJin91 [Td Ts]
gator856500: calls 500
RunsDeep84: calls 500
jtsox4life13: folds=20
JJin91: raises 2000 to 2500
albyal420: folds=20
FootPerv: calls 2000
gator856500: calls 2000
RunsDeep84: calls 2000
*** FLOP *** [4d Th 5c]
FootPerv: checks=20
gator856500: checks=20
RunsDeep84: checks=20
JJin91: bets 5727
FootPerv: folds=20
gator856500: folds=20
RunsDeep84: folds=20
Uncalled bet (5727) returned to JJin91
JJin91 collected 10610 from pot
JJin91: doesn't show hand=20
*** SUMMARY ***
Total pot 10610 | Rake 0=20
Board [4d Th 5c]
Seat 1: JJin91 (button) collected (10610)
Seat 2: albyal420 (small blind) folded before Flop
Seat 3: FootPerv (big blind) folded on the Flop
Seat 4: gator856500 folded on the Flop
Seat 5: RunsDeep84 folded on the Flop
Seat 6: jtsox4life13 folded before Flop (didn't bet)


*********** # 162 **************
PokerStars Hand #169475987099: Tournament #1597684053, $13.50+$1.50 USD=
 Hold'em No Limit - Level XI (250/500) - 2017/05/06 15:30:41 ET
Table '1597684053 7' 6-max Seat #2 is the button
Seat 1: JJin91 (33042 in chips)=20
Seat 2: albyal420 (7340 in chips)=20
Seat 3: FootPerv (41723 in chips)=20
Seat 4: gator856500 (5727 in chips)=20
Seat 5: RunsDeep84 (15260 in chips)=20
Seat 6: jtsox4life13 (32455 in chips)=20
JJin91: posts the ante 60
albyal420: posts the ante 60
FootPerv: posts the ante 60
gator856500: posts the ante 60
RunsDeep84: posts the ante 60
jtsox4life13: posts the ante 60
FootPerv: posts small blind 250
gator856500: posts big blind 500
*** HOLE CARDS ***
Dealt to JJin91 [Kh 8c]
RunsDeep84: folds=20
jtsox4life13: calls 500
JJin91: folds=20
albyal420: raises 6780 to 7280 and is all-in
FootPerv: folds=20
gator856500: folds=20
jtsox4life13: folds=20
Uncalled bet (6780) returned to albyal420
albyal420 collected 2110 from pot
albyal420: doesn't show hand=20
*** SUMMARY ***
Total pot 2110 | Rake 0=20
Seat 1: JJin91 folded before Flop (didn't bet)
Seat 2: albyal420 (button) collected (2110)
Seat 3: FootPerv (small blind) folded before Flop
Seat 4: gator856500 (big blind) folded before Flop
Seat 5: RunsDeep84 folded before Flop (didn't bet)
Seat 6: jtsox4life13 folded before Flop


*********** # 163 **************
PokerStars Hand #169475987208: Tournament #1597684053, $13.50+$1.50 USD=
 Hold'em No Limit - Level XI (250/500) - 2017/05/06 15:31:12 ET
Table '1597684053 7' 6-max Seat #3 is the button
Seat 1: JJin91 (32982 in chips)=20
Seat 2: albyal420 (8890 in chips)=20
Seat 3: FootPerv (41413 in chips)=20
Seat 4: gator856500 (5167 in chips)=20
Seat 5: RunsDeep84 (15200 in chips)=20
Seat 6: jtsox4life13 (31895 in chips)=20
JJin91: posts the ante 60
albyal420: posts the ante 60
FootPerv: posts the ante 60
gator856500: posts the ante 60
RunsDeep84: posts the ante 60
jtsox4life13: posts the ante 60
gator856500: posts small blind 250
RunsDeep84: posts big blind 500
*** HOLE CARDS ***
Dealt to JJin91 [9d Js]
jtsox4life13: calls 500
JJin91: folds=20
albyal420: folds=20
FootPerv: folds=20
gator856500: folds=20
RunsDeep84: checks=20
*** FLOP *** [8s Tc 4h]
RunsDeep84: checks=20
jtsox4life13: bets 1000
RunsDeep84: calls 1000
*** TURN *** [8s Tc 4h] [6d]
RunsDeep84: checks=20
jtsox4life13: bets 3500
RunsDeep84: folds=20
Uncalled bet (3500) returned to jtsox4life13
jtsox4life13 collected 3610 from pot
*** SUMMARY ***
Total pot 3610 | Rake 0=20
Board [8s Tc 4h 6d]
Seat 1: JJin91 folded before Flop (didn't bet)
Seat 2: albyal420 folded before Flop (didn't bet)
Seat 3: FootPerv (button) folded before Flop (didn't bet)
Seat 4: gator856500 (small blind) folded before Flop
Seat 5: RunsDeep84 (big blind) folded on the Turn
Seat 6: jtsox4life13 collected (3610)


*********** # 164 **************
PokerStars Hand #169475987341: Tournament #1597684053, $13.50+$1.50 USD=
 Hold'em No Limit - Level XII (300/600) - 2017/05/06 15:31:57 ET
Table '1597684053 7' 6-max Seat #4 is the button
Seat 1: JJin91 (32922 in chips)=20
Seat 2: albyal420 (8830 in chips)=20
Seat 3: FootPerv (41353 in chips)=20
Seat 4: gator856500 (4857 in chips)=20
Seat 5: RunsDeep84 (13640 in chips)=20
Seat 6: jtsox4life13 (33945 in chips)=20
JJin91: posts the ante 70
albyal420: posts the ante 70
FootPerv: posts the ante 70
gator856500: posts the ante 70
RunsDeep84: posts the ante 70
jtsox4life13: posts the ante 70
RunsDeep84: posts small blind 300
jtsox4life13: posts big blind 600
*** HOLE CARDS ***
Dealt to JJin91 [4d 8h]
JJin91: folds=20
albyal420: calls 600
FootPerv: folds=20
gator856500: calls 600
RunsDeep84: calls 300
jtsox4life13: checks=20
*** FLOP *** [Qd 5d 4s]
RunsDeep84: checks=20
jtsox4life13: checks=20
albyal420: bets 8160 and is all-in
gator856500: calls 4187 and is all-in
RunsDeep84: folds=20
jtsox4life13: folds=20
Uncalled bet (3973) returned to albyal420
*** TURN *** [Qd 5d 4s] [5c]
*** RIVER *** [Qd 5d 4s 5c] [Kc]
*** SHOW DOWN ***
albyal420: shows [Jd 9d] (a pair of Fives)
gator856500: shows [Qc 8d] (two pair, Queens and Fives)
gator856500 collected 11194 from pot
*** SUMMARY ***
Total pot 11194 | Rake 0=20
Board [Qd 5d 4s 5c Kc]
Seat 1: JJin91 folded before Flop (didn't bet)
Seat 2: albyal420 showed [Jd 9d] and lost with a pair of Fives
Seat 3: FootPerv folded before Flop (didn't bet)
Seat 4: gator856500 (button) showed [Qc 8d] and won (11194) with two pa=
ir, Queens and Fives
Seat 5: RunsDeep84 (small blind) folded on the Flop
Seat 6: jtsox4life13 (big blind) folded on the Flop


*********** # 165 **************
PokerStars Hand #169475987539: Tournament #1597684053, $13.50+$1.50 USD=
 Hold'em No Limit - Level XII (300/600) - 2017/05/06 15:33:09 ET
Table '1597684053 7' 6-max Seat #5 is the button
Seat 1: JJin91 (32852 in chips)=20
Seat 2: albyal420 (3973 in chips)=20
Seat 3: FootPerv (41283 in chips)=20
Seat 4: gator856500 (11194 in chips)=20
Seat 5: RunsDeep84 (12970 in chips)=20
Seat 6: jtsox4life13 (33275 in chips)=20
JJin91: posts the ante 70
albyal420: posts the ante 70
FootPerv: posts the ante 70
gator856500: posts the ante 70
RunsDeep84: posts the ante 70
jtsox4life13: posts the ante 70
jtsox4life13: posts small blind 300
JJin91: posts big blind 600
*** HOLE CARDS ***
Dealt to JJin91 [Ad Td]
albyal420: raises 3303 to 3903 and is all-in
FootPerv: folds=20
gator856500: folds=20
RunsDeep84: raises 8997 to 12900 and is all-in
jtsox4life13: folds=20
JJin91: calls 12300
*** FLOP *** [Ah 4c 2s]
*** TURN *** [Ah 4c 2s] [5s]
*** RIVER *** [Ah 4c 2s 5s] [7s]
*** SHOW DOWN ***
JJin91: shows [Ad Td] (a pair of Aces)
RunsDeep84: shows [Jd Ks] (high card Ace)
JJin91 collected 17994 from side pot
albyal420: shows [Jc Ts] (high card Ace)
JJin91 collected 12429 from main pot
RunsDeep84 finished the tournament in 40th place
albyal420 finished the tournament in 41st place
*** SUMMARY ***
Total pot 30423 Main pot 12429. Side pot 17994. | Rake 0=20
Board [Ah 4c 2s 5s 7s]
Seat 1: JJin91 (big blind) showed [Ad Td] and won (30423) with a pair o=
f Aces
Seat 2: albyal420 showed [Jc Ts] and lost with high card Ace
Seat 3: FootPerv folded before Flop (didn't bet)
Seat 4: gator856500 folded before Flop (didn't bet)
Seat 5: RunsDeep84 (button) showed [Jd Ks] and lost with high card Ace
Seat 6: jtsox4life13 (small blind) folded before Flop


*********** # 166 **************
PokerStars Hand #169475987636: Tournament #1597684053, $13.50+$1.50 USD=
 Hold'em No Limit - Level XII (300/600) - 2017/05/06 15:33:47 ET
Table '1597684053 7' 6-max Seat #6 is the button
Seat 1: JJin91 (50305 in chips)=20
Seat 3: FootPerv (41213 in chips)=20
Seat 4: gator856500 (11124 in chips)=20
Seat 6: jtsox4life13 (32905 in chips)=20
JJin91: posts the ante 70
FootPerv: posts the ante 70
gator856500: posts the ante 70
jtsox4life13: posts the ante 70
JJin91: posts small blind 300
FootPerv: posts big blind 600
*** HOLE CARDS ***
Dealt to JJin91 [Jc Jh]
gator856500: calls 600
jtsox4life13: folds=20
JJin91: raises 1800 to 2400
FootPerv: folds=20
gator856500: calls 1800
*** FLOP *** [4c Ks 6d]
JJin91: checks=20
gator856500: bets 8654 and is all-in
JJin91: calls 8654
*** TURN *** [4c Ks 6d] [Qc]
*** RIVER *** [4c Ks 6d Qc] [2c]
*** SHOW DOWN ***
JJin91: shows [Jc Jh] (a pair of Jacks)
gator856500: shows [6c Ad] (a pair of Sixes)
JJin91 collected 22988 from pot
gator856500 finished the tournament in 37th place
*** SUMMARY ***
Total pot 22988 | Rake 0=20
Board [4c Ks 6d Qc 2c]
Seat 1: JJin91 (small blind) showed [Jc Jh] and won (22988) with a pair=
 of Jacks
Seat 3: FootPerv (big blind) folded before Flop
Seat 4: gator856500 showed [6c Ad] and lost with a pair of Sixes
Seat 6: jtsox4life13 (button) folded before Flop (didn't bet)


*********** # 167 **************
PokerStars Hand #169475987949: Tournament #1597684053, $13.50+$1.50 USD=
 Hold'em No Limit - Level XII (300/600) - 2017/05/06 15:35:39 ET
Table '1597684053 5' 6-max Seat #2 is the button
Seat 1: MyManPotnPan (4487 in chips)=20
Seat 2: asremb (12690 in chips)=20
Seat 3: rbonessss333 (49123 in chips)=20
Seat 4: J_C9292 (21560 in chips)=20
Seat 5: Ninja Stax (35373 in chips) is sitting out
Seat 6: JJin91 (62169 in chips)=20
MyManPotnPan: posts the ante 70
asremb: posts the ante 70
rbonessss333: posts the ante 70
J_C9292: posts the ante 70
Ninja Stax: posts the ante 70
JJin91: posts the ante 70
rbonessss333: posts small blind 300
J_C9292: posts big blind 600
*** HOLE CARDS ***
Dealt to JJin91 [Ad Td]
Ninja Stax: folds=20
JJin91: raises 714 to 1314
MyManPotnPan: folds=20
asremb: folds=20
rbonessss333: folds=20
J_C9292: folds=20
Uncalled bet (714) returned to JJin91
JJin91 collected 1920 from pot
JJin91: doesn't show hand=20
*** SUMMARY ***
Total pot 1920 | Rake 0=20
Seat 1: MyManPotnPan folded before Flop (didn't bet)
Seat 2: asremb (button) folded before Flop (didn't bet)
Seat 3: rbonessss333 (small blind) folded before Flop
Seat 4: J_C9292 (big blind) folded before Flop
Seat 5: Ninja Stax folded before Flop (didn't bet)
Seat 6: JJin91 collected (1920)


*********** # 168 **************
PokerStars Hand #169475987993: Tournament #1597684053, $13.50+$1.50 USD=
 Hold'em No Limit - Level XII (300/600) - 2017/05/06 15:35:53 ET
Table '1597684053 5' 6-max Seat #3 is the button
Seat 1: MyManPotnPan (4417 in chips)=20
Seat 2: asremb (12620 in chips)=20
Seat 3: rbonessss333 (48753 in chips)=20
Seat 4: J_C9292 (20890 in chips)=20
Seat 5: Ninja Stax (35303 in chips) is sitting out
Seat 6: JJin91 (63419 in chips)=20
MyManPotnPan: posts the ante 70
asremb: posts the ante 70
rbonessss333: posts the ante 70
J_C9292: posts the ante 70
Ninja Stax: posts the ante 70
JJin91: posts the ante 70
J_C9292: posts small blind 300
Ninja Stax: posts big blind 600
*** HOLE CARDS ***
Dealt to JJin91 [6h 8h]
JJin91: folds=20
MyManPotnPan: folds=20
asremb: folds=20
rbonessss333: calls 600
J_C9292: calls 300
Ninja Stax: folds=20
*** FLOP *** [Jh 4h 7s]
J_C9292: checks=20
rbonessss333: checks=20
*** TURN *** [Jh 4h 7s] [2s]
J_C9292: bets 1110
rbonessss333: folds=20
Uncalled bet (1110) returned to J_C9292
J_C9292 collected 2220 from pot
*** SUMMARY ***
Total pot 2220 | Rake 0=20
Board [Jh 4h 7s 2s]
Seat 1: MyManPotnPan folded before Flop (didn't bet)
Seat 2: asremb folded before Flop (didn't bet)
Seat 3: rbonessss333 (button) folded on the Turn
Seat 4: J_C9292 (small blind) collected (2220)
Seat 5: Ninja Stax (big blind) folded before Flop
Seat 6: JJin91 folded before Flop (didn't bet)


*********** # 169 **************
PokerStars Hand #169475988079: Tournament #1597684053, $13.50+$1.50 USD=
 Hold'em No Limit - Level XII (300/600) - 2017/05/06 15:36:22 ET
Table '1597684053 5' 6-max Seat #4 is the button
Seat 1: MyManPotnPan (4347 in chips)=20
Seat 2: asremb (12550 in chips)=20
Seat 3: rbonessss333 (48083 in chips)=20
Seat 4: J_C9292 (22440 in chips)=20
Seat 5: Ninja Stax (34633 in chips) is sitting out
Seat 6: JJin91 (63349 in chips)=20
MyManPotnPan: posts the ante 70
asremb: posts the ante 70
rbonessss333: posts the ante 70
J_C9292: posts the ante 70
Ninja Stax: posts the ante 70
JJin91: posts the ante 70
Ninja Stax: posts small blind 300
JJin91: posts big blind 600
*** HOLE CARDS ***
Dealt to JJin91 [5d Qd]
MyManPotnPan: folds=20
asremb: folds=20
rbonessss333: folds=20
J_C9292: folds=20
Ninja Stax: folds=20
Uncalled bet (300) returned to JJin91
JJin91 collected 1020 from pot
JJin91: doesn't show hand=20
*** SUMMARY ***
Total pot 1020 | Rake 0=20
Seat 1: MyManPotnPan folded before Flop (didn't bet)
Seat 2: asremb folded before Flop (didn't bet)
Seat 3: rbonessss333 folded before Flop (didn't bet)
Seat 4: J_C9292 (button) folded before Flop (didn't bet)
Seat 5: Ninja Stax (small blind) folded before Flop
Seat 6: JJin91 (big blind) collected (1020)


*********** # 170 **************
PokerStars Hand #169475988115: Tournament #1597684053, $13.50+$1.50 USD=
 Hold'em No Limit - Level XII (300/600) - 2017/05/06 15:36:34 ET
Table '1597684053 5' 6-max Seat #5 is the button
Seat 1: MyManPotnPan (4277 in chips)=20
Seat 2: asremb (12480 in chips)=20
Seat 3: rbonessss333 (48013 in chips)=20
Seat 4: J_C9292 (22370 in chips)=20
Seat 5: Ninja Stax (34263 in chips) is sitting out
Seat 6: JJin91 (63999 in chips)=20
MyManPotnPan: posts the ante 70
asremb: posts the ante 70
rbonessss333: posts the ante 70
J_C9292: posts the ante 70
Ninja Stax: posts the ante 70
JJin91: posts the ante 70
JJin91: posts small blind 300
MyManPotnPan: posts big blind 600
*** HOLE CARDS ***
Dealt to JJin91 [3d Jh]
asremb: folds=20
rbonessss333: calls 600
J_C9292: folds=20
Ninja Stax: folds=20
JJin91: folds=20
MyManPotnPan: checks=20
*** FLOP *** [9s 2d 9h]
MyManPotnPan: checks=20
rbonessss333: bets 960
MyManPotnPan: folds=20
Uncalled bet (960) returned to rbonessss333
rbonessss333 collected 1920 from pot
*** SUMMARY ***
Total pot 1920 | Rake 0=20
Board [9s 2d 9h]
Seat 1: MyManPotnPan (big blind) folded on the Flop
Seat 2: asremb folded before Flop (didn't bet)
Seat 3: rbonessss333 collected (1920)
Seat 4: J_C9292 folded before Flop (didn't bet)
Seat 5: Ninja Stax (button) folded before Flop (didn't bet)
Seat 6: JJin91 (small blind) folded before Flop


*********** # 171 **************
PokerStars Hand #169475988194: Tournament #1597684053, $13.50+$1.50 USD=
 Hold'em No Limit - Level XII (300/600) - 2017/05/06 15:37:01 ET
Table '1597684053 5' 6-max Seat #6 is the button
Seat 1: MyManPotnPan (3607 in chips)=20
Seat 2: asremb (12410 in chips)=20
Seat 3: rbonessss333 (49263 in chips)=20
Seat 4: J_C9292 (22300 in chips)=20
Seat 5: Ninja Stax (34193 in chips) is sitting out
Seat 6: JJin91 (63629 in chips)=20
MyManPotnPan: posts the ante 70
asremb: posts the ante 70
rbonessss333: posts the ante 70
J_C9292: posts the ante 70
Ninja Stax: posts the ante 70
JJin91: posts the ante 70
MyManPotnPan: posts small blind 300
asremb: posts big blind 600
*** HOLE CARDS ***
Dealt to JJin91 [7d Kd]
rbonessss333: folds=20
J_C9292: folds=20
Ninja Stax: folds=20
JJin91: raises 714 to 1314
MyManPotnPan: folds=20
asremb: calls 714
*** FLOP *** [Qh Ah 3h]
asremb: checks=20
JJin91: bets 1774
asremb: raises 9252 to 11026 and is all-in
JJin91: folds=20
Uncalled bet (9252) returned to asremb
asremb collected 6896 from pot
asremb: doesn't show hand=20
*** SUMMARY ***
Total pot 6896 | Rake 0=20
Board [Qh Ah 3h]
Seat 1: MyManPotnPan (small blind) folded before Flop
Seat 2: asremb (big blind) collected (6896)
Seat 3: rbonessss333 folded before Flop (didn't bet)
Seat 4: J_C9292 folded before Flop (didn't bet)
Seat 5: Ninja Stax folded before Flop (didn't bet)
Seat 6: JJin91 (button) folded on the Flop


*********** # 172 **************
PokerStars Hand #169475988259: Tournament #1597684053, $13.50+$1.50 USD=
 Hold'em No Limit - Level XII (300/600) - 2017/05/06 15:37:27 ET
Table '1597684053 5' 6-max Seat #1 is the button
Seat 1: MyManPotnPan (3237 in chips)=20
Seat 2: asremb (16148 in chips)=20
Seat 3: rbonessss333 (49193 in chips)=20
Seat 4: J_C9292 (22230 in chips)=20
Seat 5: Ninja Stax (34123 in chips) is sitting out
Seat 6: JJin91 (60471 in chips)=20
MyManPotnPan: posts the ante 70
asremb: posts the ante 70
rbonessss333: posts the ante 70
J_C9292: posts the ante 70
Ninja Stax: posts the ante 70
JJin91: posts the ante 70
asremb: posts small blind 300
rbonessss333: posts big blind 600
*** HOLE CARDS ***
Dealt to JJin91 [Qh 4h]
J_C9292: folds=20
Ninja Stax: folds=20
JJin91: folds=20
MyManPotnPan: folds=20
asremb: raises 600 to 1200
rbonessss333: folds=20
Uncalled bet (600) returned to asremb
asremb collected 1620 from pot
asremb: doesn't show hand=20
*** SUMMARY ***
Total pot 1620 | Rake 0=20
Seat 1: MyManPotnPan (button) folded before Flop (didn't bet)
Seat 2: asremb (small blind) collected (1620)
Seat 3: rbonessss333 (big blind) folded before Flop
Seat 4: J_C9292 folded before Flop (didn't bet)
Seat 5: Ninja Stax folded before Flop (didn't bet)
Seat 6: JJin91 folded before Flop (didn't bet)


*********** # 173 **************
PokerStars Hand #169475988322: Tournament #1597684053, $13.50+$1.50 USD=
 Hold'em No Limit - Level XII (300/600) - 2017/05/06 15:37:47 ET
Table '1597684053 5' 6-max Seat #2 is the button
Seat 1: MyManPotnPan (3167 in chips)=20
Seat 2: asremb (17098 in chips)=20
Seat 3: rbonessss333 (48523 in chips)=20
Seat 4: J_C9292 (22160 in chips)=20
Seat 5: Ninja Stax (34053 in chips) is sitting out
Seat 6: JJin91 (60401 in chips)=20
MyManPotnPan: posts the ante 70
asremb: posts the ante 70
rbonessss333: posts the ante 70
J_C9292: posts the ante 70
Ninja Stax: posts the ante 70
JJin91: posts the ante 70
rbonessss333: posts small blind 300
J_C9292: posts big blind 600
*** HOLE CARDS ***
Dealt to JJin91 [4s 9d]
Ninja Stax: folds=20
JJin91: folds=20
MyManPotnPan: raises 2497 to 3097 and is all-in
asremb: folds=20
rbonessss333: folds=20
J_C9292: folds=20
Uncalled bet (2497) returned to MyManPotnPan
MyManPotnPan collected 1920 from pot
MyManPotnPan: doesn't show hand=20
*** SUMMARY ***
Total pot 1920 | Rake 0=20
Seat 1: MyManPotnPan collected (1920)
Seat 2: asremb (button) folded before Flop (didn't bet)
Seat 3: rbonessss333 (small blind) folded before Flop
Seat 4: J_C9292 (big blind) folded before Flop
Seat 5: Ninja Stax folded before Flop (didn't bet)
Seat 6: JJin91 folded before Flop (didn't bet)


*********** # 174 **************
PokerStars Hand #169475988401: Tournament #1597684053, $13.50+$1.50 USD=
 Hold'em No Limit - Level XII (300/600) - 2017/05/06 15:38:13 ET
Table '1597684053 5' 6-max Seat #3 is the button
Seat 1: MyManPotnPan (4417 in chips)=20
Seat 2: asremb (17028 in chips)=20
Seat 3: rbonessss333 (48153 in chips)=20
Seat 4: J_C9292 (21490 in chips)=20
Seat 5: Ninja Stax (33983 in chips) is sitting out
Seat 6: JJin91 (60331 in chips)=20
MyManPotnPan: posts the ante 70
asremb: posts the ante 70
rbonessss333: posts the ante 70
J_C9292: posts the ante 70
Ninja Stax: posts the ante 70
JJin91: posts the ante 70
J_C9292: posts small blind 300
Ninja Stax: posts big blind 600
*** HOLE CARDS ***
Dealt to JJin91 [4d Qc]
JJin91: folds=20
MyManPotnPan: folds=20
asremb: folds=20
rbonessss333: raises 1920 to 2520
J_C9292: folds=20
Ninja Stax: folds=20
Uncalled bet (1920) returned to rbonessss333
rbonessss333 collected 1920 from pot
*** SUMMARY ***
Total pot 1920 | Rake 0=20
Seat 1: MyManPotnPan folded before Flop (didn't bet)
Seat 2: asremb folded before Flop (didn't bet)
Seat 3: rbonessss333 (button) collected (1920)
Seat 4: J_C9292 (small blind) folded before Flop
Seat 5: Ninja Stax (big blind) folded before Flop
Seat 6: JJin91 folded before Flop (didn't bet)


*********** # 175 **************
PokerStars Hand #169475988460: Tournament #1597684053, $13.50+$1.50 USD=
 Hold'em No Limit - Level XII (300/600) - 2017/05/06 15:38:34 ET
Table '1597684053 5' 6-max Seat #4 is the button
Seat 1: MyManPotnPan (4347 in chips)=20
Seat 2: asremb (16958 in chips)=20
Seat 3: rbonessss333 (49403 in chips)=20
Seat 4: J_C9292 (21120 in chips)=20
Seat 5: Ninja Stax (33313 in chips) is sitting out
Seat 6: JJin91 (60261 in chips)=20
MyManPotnPan: posts the ante 70
asremb: posts the ante 70
rbonessss333: posts the ante 70
J_C9292: posts the ante 70
Ninja Stax: posts the ante 70
JJin91: posts the ante 70
Ninja Stax: posts small blind 300
JJin91: posts big blind 600
*** HOLE CARDS ***
Dealt to JJin91 [Jd Qs]
MyManPotnPan: folds=20
asremb: folds=20
rbonessss333: calls 600
J_C9292: folds=20
Ninja Stax: folds=20
JJin91: checks=20
*** FLOP *** [7h 9h 6d]
JJin91: checks=20
rbonessss333: checks=20
*** TURN *** [7h 9h 6d] [4c]
JJin91: checks=20
rbonessss333: bets 600
JJin91: folds=20
Uncalled bet (600) returned to rbonessss333
rbonessss333 collected 1920 from pot
*** SUMMARY ***
Total pot 1920 | Rake 0=20
Board [7h 9h 6d 4c]
Seat 1: MyManPotnPan folded before Flop (didn't bet)
Seat 2: asremb folded before Flop (didn't bet)
Seat 3: rbonessss333 collected (1920)
Seat 4: J_C9292 (button) folded before Flop (didn't bet)
Seat 5: Ninja Stax (small blind) folded before Flop
Seat 6: JJin91 (big blind) folded on the Turn


*********** # 176 **************
PokerStars Hand #169475988564: Tournament #1597684053, $13.50+$1.50 USD=
 Hold'em No Limit - Level XII (300/600) - 2017/05/06 15:39:09 ET
Table '1597684053 5' 6-max Seat #5 is the button
Seat 1: MyManPotnPan (4277 in chips)=20
Seat 2: asremb (16888 in chips)=20
Seat 3: rbonessss333 (50653 in chips)=20
Seat 4: J_C9292 (21050 in chips)=20
Seat 5: Ninja Stax (32943 in chips) is sitting out
Seat 6: JJin91 (59591 in chips)=20
MyManPotnPan: posts the ante 70
asremb: posts the ante 70
rbonessss333: posts the ante 70
J_C9292: posts the ante 70
Ninja Stax: posts the ante 70
JJin91: posts the ante 70
JJin91: posts small blind 300
MyManPotnPan: posts big blind 600
*** HOLE CARDS ***
Dealt to JJin91 [Ah As]
asremb: folds=20
rbonessss333: calls 600
J_C9292: folds=20
Ninja Stax: folds=20
JJin91: raises 1200 to 1800
MyManPotnPan: folds=20
rbonessss333: calls 1200
*** FLOP *** [6c Jc Kh]
JJin91: bets 2449
rbonessss333: folds=20
Uncalled bet (2449) returned to JJin91
JJin91 collected 4620 from pot
JJin91: doesn't show hand=20
*** SUMMARY ***
Total pot 4620 | Rake 0=20
Board [6c Jc Kh]
Seat 1: MyManPotnPan (big blind) folded before Flop
Seat 2: asremb folded before Flop (didn't bet)
Seat 3: rbonessss333 folded on the Flop
Seat 4: J_C9292 folded before Flop (didn't bet)
Seat 5: Ninja Stax (button) folded before Flop (didn't bet)
Seat 6: JJin91 (small blind) collected (4620)


*********** # 177 **************
PokerStars Hand #169475988635: Tournament #1597684053, $13.50+$1.50 USD=
 Hold'em No Limit - Level XII (300/600) - 2017/05/06 15:39:36 ET
Table '1597684053 5' 6-max Seat #6 is the button
Seat 1: MyManPotnPan (3607 in chips)=20
Seat 2: asremb (16818 in chips)=20
Seat 3: rbonessss333 (48783 in chips)=20
Seat 4: J_C9292 (20980 in chips)=20
Seat 5: Ninja Stax (32873 in chips) is sitting out
Seat 6: JJin91 (62341 in chips)=20
MyManPotnPan: posts the ante 70
asremb: posts the ante 70
rbonessss333: posts the ante 70
J_C9292: posts the ante 70
Ninja Stax: posts the ante 70
JJin91: posts the ante 70
MyManPotnPan: posts small blind 300
asremb: posts big blind 600
*** HOLE CARDS ***
Dealt to JJin91 [9d 9h]
rbonessss333: folds=20
J_C9292: folds=20
Ninja Stax: folds=20
JJin91: raises 714 to 1314
MyManPotnPan: raises 2223 to 3537 and is all-in
asremb: folds=20
JJin91: calls 2223
*** FLOP *** [3h 2s 6h]
*** TURN *** [3h 2s 6h] [Tc]
*** RIVER *** [3h 2s 6h Tc] [Ad]
*** SHOW DOWN ***
MyManPotnPan: shows [Ah Kh] (a pair of Aces)
JJin91: shows [9d 9h] (a pair of Nines)
MyManPotnPan collected 8094 from pot
*** SUMMARY ***
Total pot 8094 | Rake 0=20
Board [3h 2s 6h Tc Ad]
Seat 1: MyManPotnPan (small blind) showed [Ah Kh] and won (8094) with a=
 pair of Aces
Seat 2: asremb (big blind) folded before Flop
Seat 3: rbonessss333 folded before Flop (didn't bet)
Seat 4: J_C9292 folded before Flop (didn't bet)
Seat 5: Ninja Stax folded before Flop (didn't bet)
Seat 6: JJin91 (button) showed [9d 9h] and lost with a pair of Nines


*********** # 178 **************
PokerStars Hand #169475988713: Tournament #1597684053, $13.50+$1.50 USD=
 Hold'em No Limit - Level XII (300/600) - 2017/05/06 15:40:03 ET
Table '1597684053 5' 6-max Seat #1 is the button
Seat 1: MyManPotnPan (8094 in chips)=20
Seat 2: asremb (16148 in chips)=20
Seat 3: rbonessss333 (48713 in chips)=20
Seat 4: J_C9292 (20910 in chips)=20
Seat 5: Ninja Stax (32803 in chips) is sitting out
Seat 6: JJin91 (58734 in chips)=20
MyManPotnPan: posts the ante 70
asremb: posts the ante 70
rbonessss333: posts the ante 70
J_C9292: posts the ante 70
Ninja Stax: posts the ante 70
JJin91: posts the ante 70
asremb: posts small blind 300
rbonessss333: posts big blind 600
*** HOLE CARDS ***
Dealt to JJin91 [Qc 4h]
J_C9292: folds=20
Ninja Stax: folds=20
JJin91: folds=20
MyManPotnPan: raises 7424 to 8024 and is all-in
asremb: folds=20
rbonessss333: folds=20
Uncalled bet (7424) returned to MyManPotnPan
MyManPotnPan collected 1920 from pot
MyManPotnPan: doesn't show hand=20
*** SUMMARY ***
Total pot 1920 | Rake 0=20
Seat 1: MyManPotnPan (button) collected (1920)
Seat 2: asremb (small blind) folded before Flop
Seat 3: rbonessss333 (big blind) folded before Flop
Seat 4: J_C9292 folded before Flop (didn't bet)
Seat 5: Ninja Stax folded before Flop (didn't bet)
Seat 6: JJin91 folded before Flop (didn't bet)


*********** # 179 **************
PokerStars Hand #169475988771: Tournament #1597684053, $13.50+$1.50 USD=
 Hold'em No Limit - Level XII (300/600) - 2017/05/06 15:40:23 ET
Table '1597684053 5' 6-max Seat #2 is the button
Seat 1: MyManPotnPan (9344 in chips)=20
Seat 2: asremb (15778 in chips)=20
Seat 3: rbonessss333 (48043 in chips)=20
Seat 4: J_C9292 (20840 in chips)=20
Seat 5: Ninja Stax (32733 in chips) is sitting out
Seat 6: JJin91 (58664 in chips)=20
MyManPotnPan: posts the ante 70
asremb: posts the ante 70
rbonessss333: posts the ante 70
J_C9292: posts the ante 70
Ninja Stax: posts the ante 70
JJin91: posts the ante 70
rbonessss333: posts small blind 300
J_C9292: posts big blind 600
*** HOLE CARDS ***
Dealt to JJin91 [3s Td]
Ninja Stax: folds=20
JJin91: folds=20
MyManPotnPan: raises 8674 to 9274 and is all-in
asremb: folds=20
rbonessss333: folds=20
J_C9292: folds=20
Uncalled bet (8674) returned to MyManPotnPan
MyManPotnPan collected 1920 from pot
MyManPotnPan: doesn't show hand=20
*** SUMMARY ***
Total pot 1920 | Rake 0=20
Seat 1: MyManPotnPan collected (1920)
Seat 2: asremb (button) folded before Flop (didn't bet)
Seat 3: rbonessss333 (small blind) folded before Flop
Seat 4: J_C9292 (big blind) folded before Flop
Seat 5: Ninja Stax folded before Flop (didn't bet)
Seat 6: JJin91 folded before Flop (didn't bet)


*********** # 180 **************
PokerStars Hand #169475988815: Tournament #1597684053, $13.50+$1.50 USD=
 Hold'em No Limit - Level XII (300/600) - 2017/05/06 15:40:37 ET
Table '1597684053 5' 6-max Seat #3 is the button
Seat 1: MyManPotnPan (10594 in chips)=20
Seat 2: asremb (15708 in chips)=20
Seat 3: rbonessss333 (47673 in chips)=20
Seat 4: J_C9292 (20170 in chips)=20
Seat 5: Ninja Stax (32663 in chips) is sitting out
Seat 6: JJin91 (58594 in chips)=20
MyManPotnPan: posts the ante 70
asremb: posts the ante 70
rbonessss333: posts the ante 70
J_C9292: posts the ante 70
Ninja Stax: posts the ante 70
JJin91: posts the ante 70
J_C9292: posts small blind 300
Ninja Stax: posts big blind 600
*** HOLE CARDS ***
Dealt to JJin91 [Kc 9d]
JJin91: folds=20
MyManPotnPan: folds=20
asremb: folds=20
rbonessss333: folds=20
J_C9292: raises 600 to 1200
Ninja Stax: folds=20
Uncalled bet (600) returned to J_C9292
J_C9292 collected 1620 from pot
*** SUMMARY ***
Total pot 1620 | Rake 0=20
Seat 1: MyManPotnPan folded before Flop (didn't bet)
Seat 2: asremb folded before Flop (didn't bet)
Seat 3: rbonessss333 (button) folded before Flop (didn't bet)
Seat 4: J_C9292 (small blind) collected (1620)
Seat 5: Ninja Stax (big blind) folded before Flop
Seat 6: JJin91 folded before Flop (didn't bet)


*********** # 181 **************
PokerStars Hand #169475988860: Tournament #1597684053, $13.50+$1.50 USD=
 Hold'em No Limit - Level XII (300/600) - 2017/05/06 15:40:50 ET
Table '1597684053 5' 6-max Seat #4 is the button
Seat 1: MyManPotnPan (10524 in chips)=20
Seat 2: asremb (15638 in chips)=20
Seat 3: rbonessss333 (47603 in chips)=20
Seat 4: J_C9292 (21120 in chips)=20
Seat 5: Ninja Stax (31993 in chips) is sitting out
Seat 6: JJin91 (58524 in chips)=20
MyManPotnPan: posts the ante 70
asremb: posts the ante 70
rbonessss333: posts the ante 70
J_C9292: posts the ante 70
Ninja Stax: posts the ante 70
JJin91: posts the ante 70
Ninja Stax: posts small blind 300
JJin91: posts big blind 600
*** HOLE CARDS ***
Dealt to JJin91 [As Ah]
MyManPotnPan: folds=20
asremb: folds=20
rbonessss333: calls 600
J_C9292: raises 1200 to 1800
Ninja Stax: folds=20
JJin91: raises 2434 to 4234
rbonessss333: folds=20
J_C9292: calls 2434
*** FLOP *** [Tc 8d 7d]
JJin91: checks=20
J_C9292: checks=20
*** TURN *** [Tc 8d 7d] [Ac]
JJin91: checks=20
J_C9292: bets 4894
JJin91: raises 49326 to 54220 and is all-in
J_C9292: calls 11922 and is all-in
Uncalled bet (37404) returned to JJin91
*** RIVER *** [Tc 8d 7d Ac] [Jh]
*** SHOW DOWN ***
JJin91: shows [As Ah] (three of a kind, Aces)
J_C9292: shows [Ad Qh] (a pair of Aces)
JJin91 collected 43420 from pot
J_C9292 finished the tournament in 33rd place
*** SUMMARY ***
Total pot 43420 | Rake 0=20
Board [Tc 8d 7d Ac Jh]
Seat 1: MyManPotnPan folded before Flop (didn't bet)
Seat 2: asremb folded before Flop (didn't bet)
Seat 3: rbonessss333 folded before Flop
Seat 4: J_C9292 (button) showed [Ad Qh] and lost with a pair of Aces
Seat 5: Ninja Stax (small blind) folded before Flop
Seat 6: JJin91 (big blind) showed [As Ah] and won (43420) with three of=
 a kind, Aces


*********** # 182 **************
PokerStars Hand #169475989159: Tournament #1597684053, $13.50+$1.50 USD=
 Hold'em No Limit - Level XIII (350/700) - 2017/05/06 15:42:31 ET
Table '1597684053 5' 6-max Seat #5 is the button
Seat 1: MyManPotnPan (10454 in chips)=20
Seat 2: asremb (15568 in chips)=20
Seat 3: rbonessss333 (46933 in chips)=20
Seat 5: Ninja Stax (31623 in chips) is sitting out
Seat 6: JJin91 (80824 in chips)=20
MyManPotnPan: posts the ante 85
asremb: posts the ante 85
rbonessss333: posts the ante 85
Ninja Stax: posts the ante 85
JJin91: posts the ante 85
JJin91: posts small blind 350
MyManPotnPan: posts big blind 700
*** HOLE CARDS ***
Dealt to JJin91 [3c 8d]
asremb: folds=20
rbonessss333: raises 700 to 1400
Ninja Stax: folds=20
JJin91: folds=20
MyManPotnPan: folds=20
Uncalled bet (700) returned to rbonessss333
rbonessss333 collected 2175 from pot
*** SUMMARY ***
Total pot 2175 | Rake 0=20
Seat 1: MyManPotnPan (big blind) folded before Flop
Seat 2: asremb folded before Flop (didn't bet)
Seat 3: rbonessss333 collected (2175)
Seat 5: Ninja Stax (button) folded before Flop (didn't bet)
Seat 6: JJin91 (small blind) folded before Flop


*********** # 183 **************
PokerStars Hand #169475989239: Tournament #1597684053, $13.50+$1.50 USD=
 Hold'em No Limit - Level XIII (350/700) - 2017/05/06 15:42:58 ET
Table '1597684053 5' 6-max Seat #6 is the button
Seat 1: MyManPotnPan (9669 in chips)=20
Seat 2: asremb (15483 in chips)=20
Seat 3: rbonessss333 (48323 in chips)=20
Seat 5: Ninja Stax (31538 in chips) is sitting out
Seat 6: JJin91 (80389 in chips)=20
MyManPotnPan: posts the ante 85
asremb: posts the ante 85
rbonessss333: posts the ante 85
Ninja Stax: posts the ante 85
JJin91: posts the ante 85
MyManPotnPan: posts small blind 350
asremb: posts big blind 700
*** HOLE CARDS ***
Dealt to JJin91 [Ac Jd]
rbonessss333: folds=20
Ninja Stax: folds=20
JJin91: raises 833 to 1533
MyManPotnPan: folds=20
asremb: folds=20
Uncalled bet (833) returned to JJin91
JJin91 collected 2175 from pot
JJin91: doesn't show hand=20
*** SUMMARY ***
Total pot 2175 | Rake 0=20
Seat 1: MyManPotnPan (small blind) folded before Flop
Seat 2: asremb (big blind) folded before Flop
Seat 3: rbonessss333 folded before Flop (didn't bet)
Seat 5: Ninja Stax folded before Flop (didn't bet)
Seat 6: JJin91 (button) collected (2175)


*********** # 184 **************
PokerStars Hand #169475989345: Tournament #1597684053, $13.50+$1.50 USD=
 Hold'em No Limit - Level XIII (350/700) - 2017/05/06 15:43:30 ET
Table '1597684053 5' 6-max Seat #1 is the button
Seat 1: MyManPotnPan (9234 in chips)=20
Seat 2: asremb (14698 in chips)=20
Seat 3: rbonessss333 (48238 in chips)=20
Seat 4: Bsgwolfpack4 (7185 in chips)=20
Seat 5: Ninja Stax (31453 in chips) is sitting out
Seat 6: JJin91 (81779 in chips)=20
MyManPotnPan: posts the ante 85
asremb: posts the ante 85
rbonessss333: posts the ante 85
Bsgwolfpack4: posts the ante 85
Ninja Stax: posts the ante 85
JJin91: posts the ante 85
asremb: posts small blind 350
rbonessss333: posts big blind 700
*** HOLE CARDS ***
Dealt to JJin91 [4s Qs]
Bsgwolfpack4: calls 700
Ninja Stax: folds=20
JJin91: folds=20
MyManPotnPan: folds=20
asremb: calls 350
rbonessss333: checks=20
*** FLOP *** [8s Td 4d]
asremb: checks=20
rbonessss333: bets 700
Bsgwolfpack4: raises 1100 to 1800
asremb: folds=20
rbonessss333: folds=20
Uncalled bet (1100) returned to Bsgwolfpack4
Bsgwolfpack4 collected 4010 from pot
Bsgwolfpack4: doesn't show hand=20
*** SUMMARY ***
Total pot 4010 | Rake 0=20
Board [8s Td 4d]
Seat 1: MyManPotnPan (button) folded before Flop (didn't bet)
Seat 2: asremb (small blind) folded on the Flop
Seat 3: rbonessss333 (big blind) folded on the Flop
Seat 4: Bsgwolfpack4 collected (4010)
Seat 5: Ninja Stax folded before Flop (didn't bet)
Seat 6: JJin91 folded before Flop (didn't bet)


*********** # 185 **************
PokerStars Hand #169475989510: Tournament #1597684053, $13.50+$1.50 USD=
 Hold'em No Limit - Level XIII (350/700) - 2017/05/06 15:44:19 ET
Table '1597684053 5' 6-max Seat #2 is the button
Seat 1: MyManPotnPan (9149 in chips)=20
Seat 2: asremb (13913 in chips)=20
Seat 3: rbonessss333 (46753 in chips)=20
Seat 4: Bsgwolfpack4 (9710 in chips)=20
Seat 5: Ninja Stax (31368 in chips) is sitting out
Seat 6: JJin91 (81694 in chips)=20
MyManPotnPan: posts the ante 85
asremb: posts the ante 85
rbonessss333: posts the ante 85
Bsgwolfpack4: posts the ante 85
Ninja Stax: posts the ante 85
JJin91: posts the ante 85
rbonessss333: posts small blind 350
Bsgwolfpack4: posts big blind 700
*** HOLE CARDS ***
Dealt to JJin91 [Jc 4d]
Ninja Stax: folds=20
JJin91: folds=20
MyManPotnPan: folds=20
asremb: folds=20
rbonessss333: calls 350
Bsgwolfpack4: checks=20
*** FLOP *** [Th Kc 9h]
rbonessss333: checks=20
Bsgwolfpack4: checks=20
*** TURN *** [Th Kc 9h] [7d]
rbonessss333: checks=20
Bsgwolfpack4: checks=20
*** RIVER *** [Th Kc 9h 7d] [6d]
rbonessss333: checks=20
Bsgwolfpack4: checks=20
*** SHOW DOWN ***
rbonessss333: shows [Qc 5s] (high card King)
Bsgwolfpack4: shows [Qd 9d] (a pair of Nines)
Bsgwolfpack4 collected 1910 from pot
*** SUMMARY ***
Total pot 1910 | Rake 0=20
Board [Th Kc 9h 7d 6d]
Seat 1: MyManPotnPan folded before Flop (didn't bet)
Seat 2: asremb (button) folded before Flop (didn't bet)
Seat 3: rbonessss333 (small blind) showed [Qc 5s] and lost with high ca=
rd King
Seat 4: Bsgwolfpack4 (big blind) showed [Qd 9d] and won (1910) with a p=
air of Nines
Seat 5: Ninja Stax folded before Flop (didn't bet)
Seat 6: JJin91 folded before Flop (didn't bet)


*********** # 186 **************
PokerStars Hand #169475989653: Tournament #1597684053, $13.50+$1.50 USD=
 Hold'em No Limit - Level XIII (350/700) - 2017/05/06 15:44:59 ET
Table '1597684053 5' 6-max Seat #3 is the button
Seat 1: MyManPotnPan (9064 in chips)=20
Seat 2: asremb (13828 in chips)=20
Seat 3: rbonessss333 (45968 in chips)=20
Seat 4: Bsgwolfpack4 (10835 in chips)=20
Seat 5: Ninja Stax (31283 in chips) is sitting out
Seat 6: JJin91 (81609 in chips)=20
MyManPotnPan: posts the ante 85
asremb: posts the ante 85
rbonessss333: posts the ante 85
Bsgwolfpack4: posts the ante 85
Ninja Stax: posts the ante 85
JJin91: posts the ante 85
Bsgwolfpack4: posts small blind 350
Ninja Stax: posts big blind 700
*** HOLE CARDS ***
Dealt to JJin91 [2s Js]
JJin91: folds=20
MyManPotnPan: folds=20
asremb: raises 1400 to 2100
rbonessss333: folds=20
Bsgwolfpack4: folds=20
Ninja Stax: folds=20
Uncalled bet (1400) returned to asremb
asremb collected 2260 from pot
asremb: doesn't show hand=20
*** SUMMARY ***
Total pot 2260 | Rake 0=20
Seat 1: MyManPotnPan folded before Flop (didn't bet)
Seat 2: asremb collected (2260)
Seat 3: rbonessss333 (button) folded before Flop (didn't bet)
Seat 4: Bsgwolfpack4 (small blind) folded before Flop
Seat 5: Ninja Stax (big blind) folded before Flop
Seat 6: JJin91 folded before Flop (didn't bet)


*********** # 187 **************
PokerStars Hand #169475989707: Tournament #1597684053, $13.50+$1.50 USD=
 Hold'em No Limit - Level XIII (350/700) - 2017/05/06 15:45:15 ET
Table '1597684053 5' 6-max Seat #4 is the button
Seat 1: MyManPotnPan (8979 in chips)=20
Seat 2: asremb (15303 in chips)=20
Seat 3: rbonessss333 (45883 in chips)=20
Seat 4: Bsgwolfpack4 (10400 in chips)=20
Seat 5: Ninja Stax (30498 in chips) is sitting out
Seat 6: JJin91 (81524 in chips)=20
MyManPotnPan: posts the ante 85
asremb: posts the ante 85
rbonessss333: posts the ante 85
Bsgwolfpack4: posts the ante 85
Ninja Stax: posts the ante 85
JJin91: posts the ante 85
Ninja Stax: posts small blind 350
JJin91: posts big blind 700
*** HOLE CARDS ***
Dealt to JJin91 [3h 3c]
MyManPotnPan: folds=20
asremb: folds=20
rbonessss333: folds=20
Bsgwolfpack4: folds=20
Ninja Stax: folds=20
Uncalled bet (350) returned to JJin91
JJin91 collected 1210 from pot
JJin91: doesn't show hand=20
*** SUMMARY ***
Total pot 1210 | Rake 0=20
Seat 1: MyManPotnPan folded before Flop (didn't bet)
Seat 2: asremb folded before Flop (didn't bet)
Seat 3: rbonessss333 folded before Flop (didn't bet)
Seat 4: Bsgwolfpack4 (button) folded before Flop (didn't bet)
Seat 5: Ninja Stax (small blind) folded before Flop
Seat 6: JJin91 (big blind) collected (1210)


*********** # 188 **************
PokerStars Hand #169475989733: Tournament #1597684053, $13.50+$1.50 USD=
 Hold'em No Limit - Level XIII (350/700) - 2017/05/06 15:45:23 ET
Table '1597684053 5' 6-max Seat #5 is the button
Seat 1: MyManPotnPan (8894 in chips)=20
Seat 2: asremb (15218 in chips)=20
Seat 3: rbonessss333 (45798 in chips)=20
Seat 4: Bsgwolfpack4 (10315 in chips)=20
Seat 5: Ninja Stax (30063 in chips) is sitting out
Seat 6: JJin91 (82299 in chips)=20
MyManPotnPan: posts the ante 85
asremb: posts the ante 85
rbonessss333: posts the ante 85
Bsgwolfpack4: posts the ante 85
Ninja Stax: posts the ante 85
JJin91: posts the ante 85
JJin91: posts small blind 350
MyManPotnPan: posts big blind 700
*** HOLE CARDS ***
Dealt to JJin91 [9h 9c]
asremb: folds=20
rbonessss333: raises 2260 to 2960
Bsgwolfpack4: folds=20
Ninja Stax: folds=20
JJin91: calls 2610
MyManPotnPan: folds=20
*** FLOP *** [Js 3d 5s]
JJin91: checks=20
rbonessss333: bets 3565
JJin91: calls 3565
*** TURN *** [Js 3d 5s] [Jd]
JJin91: checks=20
rbonessss333: checks=20
*** RIVER *** [Js 3d 5s Jd] [8d]
JJin91: checks=20
rbonessss333: checks=20
*** SHOW DOWN ***
JJin91: shows [9h 9c] (two pair, Jacks and Nines)
rbonessss333: mucks hand=20
JJin91 collected 14260 from pot
*** SUMMARY ***
Total pot 14260 | Rake 0=20
Board [Js 3d 5s Jd 8d]
Seat 1: MyManPotnPan (big blind) folded before Flop
Seat 2: asremb folded before Flop (didn't bet)
Seat 3: rbonessss333 mucked [7h 7s]
Seat 4: Bsgwolfpack4 folded before Flop (didn't bet)
Seat 5: Ninja Stax (button) folded before Flop (didn't bet)
Seat 6: JJin91 (small blind) showed [9h 9c] and won (14260) with two pa=
ir, Jacks and Nines


*********** # 189 **************
PokerStars Hand #169476261901: Tournament #1597684053, $13.50+$1.50 USD=
 Hold'em No Limit - Level XIII (350/700) - 2017/05/06 15:46:30 ET
Table '1597684053 5' 6-max Seat #6 is the button
Seat 1: MyManPotnPan (8109 in chips)=20
Seat 2: asremb (15133 in chips)=20
Seat 3: rbonessss333 (39188 in chips)=20
Seat 4: Bsgwolfpack4 (10230 in chips)=20
Seat 5: Ninja Stax (29978 in chips) is sitting out
Seat 6: JJin91 (89949 in chips)=20
MyManPotnPan: posts the ante 85
asremb: posts the ante 85
rbonessss333: posts the ante 85
Bsgwolfpack4: posts the ante 85
Ninja Stax: posts the ante 85
JJin91: posts the ante 85
MyManPotnPan: posts small blind 350
asremb: posts big blind 700
*** HOLE CARDS ***
Dealt to JJin91 [4s Jc]
rbonessss333: folds=20
Bsgwolfpack4: raises 1350 to 2050
Ninja Stax: folds=20
JJin91: folds=20
MyManPotnPan: folds=20
asremb: calls 1350
*** FLOP *** [7h 2c As]
asremb: checks=20
Bsgwolfpack4: bets 2800
asremb: folds=20
Uncalled bet (2800) returned to Bsgwolfpack4
Bsgwolfpack4 collected 4960 from pot
Bsgwolfpack4: doesn't show hand=20
*** SUMMARY ***
Total pot 4960 | Rake 0=20
Board [7h 2c As]
Seat 1: MyManPotnPan (small blind) folded before Flop
Seat 2: asremb (big blind) folded on the Flop
Seat 3: rbonessss333 folded before Flop (didn't bet)
Seat 4: Bsgwolfpack4 collected (4960)
Seat 5: Ninja Stax folded before Flop (didn't bet)
Seat 6: JJin91 (button) folded before Flop (didn't bet)


*********** # 190 **************
PokerStars Hand #169476262023: Tournament #1597684053, $13.50+$1.50 USD=
 Hold'em No Limit - Level XIII (350/700) - 2017/05/06 15:47:03 ET
Table '1597684053 5' 6-max Seat #1 is the button
Seat 1: MyManPotnPan (7674 in chips)=20
Seat 2: asremb (12998 in chips)=20
Seat 3: rbonessss333 (39103 in chips)=20
Seat 4: Bsgwolfpack4 (13055 in chips)=20
Seat 5: Ninja Stax (29893 in chips) is sitting out
Seat 6: JJin91 (89864 in chips)=20
MyManPotnPan: posts the ante 85
asremb: posts the ante 85
rbonessss333: posts the ante 85
Bsgwolfpack4: posts the ante 85
Ninja Stax: posts the ante 85
JJin91: posts the ante 85
asremb: posts small blind 350
rbonessss333: posts big blind 700
*** HOLE CARDS ***
Dealt to JJin91 [4s Tc]
Bsgwolfpack4: folds=20
Ninja Stax: folds=20
JJin91: folds=20
MyManPotnPan: folds=20
asremb: calls 350
rbonessss333: checks=20
*** FLOP *** [Td Ks 6s]
asremb: checks=20
rbonessss333: bets 1910
asremb: folds=20
Uncalled bet (1910) returned to rbonessss333
rbonessss333 collected 1910 from pot
*** SUMMARY ***
Total pot 1910 | Rake 0=20
Board [Td Ks 6s]
Seat 1: MyManPotnPan (button) folded before Flop (didn't bet)
Seat 2: asremb (small blind) folded on the Flop
Seat 3: rbonessss333 (big blind) collected (1910)
Seat 4: Bsgwolfpack4 folded before Flop (didn't bet)
Seat 5: Ninja Stax folded before Flop (didn't bet)
Seat 6: JJin91 folded before Flop (didn't bet)


*********** # 191 **************
PokerStars Hand #169476262103: Tournament #1597684053, $13.50+$1.50 USD=
 Hold'em No Limit - Level XIII (350/700) - 2017/05/06 15:47:27 ET
Table '1597684053 5' 6-max Seat #2 is the button
Seat 1: MyManPotnPan (7589 in chips)=20
Seat 2: asremb (12213 in chips)=20
Seat 3: rbonessss333 (40228 in chips)=20
Seat 4: Bsgwolfpack4 (12970 in chips)=20
Seat 5: Ninja Stax (29808 in chips) is sitting out
Seat 6: JJin91 (89779 in chips)=20
MyManPotnPan: posts the ante 85
asremb: posts the ante 85
rbonessss333: posts the ante 85
Bsgwolfpack4: posts the ante 85
Ninja Stax: posts the ante 85
JJin91: posts the ante 85
rbonessss333: posts small blind 350
Bsgwolfpack4: posts big blind 700
*** HOLE CARDS ***
Dealt to JJin91 [8d 7h]
Ninja Stax: folds=20
JJin91: folds=20
MyManPotnPan: folds=20
asremb: raises 1400 to 2100
rbonessss333: folds=20
Bsgwolfpack4: folds=20
Uncalled bet (1400) returned to asremb
asremb collected 2260 from pot
asremb: doesn't show hand=20
*** SUMMARY ***
Total pot 2260 | Rake 0=20
Seat 1: MyManPotnPan folded before Flop (didn't bet)
Seat 2: asremb (button) collected (2260)
Seat 3: rbonessss333 (small blind) folded before Flop
Seat 4: Bsgwolfpack4 (big blind) folded before Flop
Seat 5: Ninja Stax folded before Flop (didn't bet)
Seat 6: JJin91 folded before Flop (didn't bet)


*********** # 192 **************
PokerStars Hand #169476262151: Tournament #1597684053, $13.50+$1.50 USD=
 Hold'em No Limit - Level XIII (350/700) - 2017/05/06 15:47:43 ET
Table '1597684053 5' 6-max Seat #3 is the button
Seat 1: MyManPotnPan (7504 in chips)=20
Seat 2: asremb (13688 in chips)=20
Seat 3: rbonessss333 (39793 in chips)=20
Seat 4: Bsgwolfpack4 (12185 in chips)=20
Seat 5: Ninja Stax (29723 in chips) is sitting out
Seat 6: JJin91 (89694 in chips)=20
MyManPotnPan: posts the ante 85
asremb: posts the ante 85
rbonessss333: posts the ante 85
Bsgwolfpack4: posts the ante 85
Ninja Stax: posts the ante 85
JJin91: posts the ante 85
Bsgwolfpack4: posts small blind 350
Ninja Stax: posts big blind 700
*** HOLE CARDS ***
Dealt to JJin91 [7h Ks]
JJin91: folds=20
MyManPotnPan: folds=20
asremb: folds=20
rbonessss333: raises 1400 to 2100
Bsgwolfpack4: folds=20
Ninja Stax: folds=20
Uncalled bet (1400) returned to rbonessss333
rbonessss333 collected 2260 from pot
*** SUMMARY ***
Total pot 2260 | Rake 0=20
Seat 1: MyManPotnPan folded before Flop (didn't bet)
Seat 2: asremb folded before Flop (didn't bet)
Seat 3: rbonessss333 (button) collected (2260)
Seat 4: Bsgwolfpack4 (small blind) folded before Flop
Seat 5: Ninja Stax (big blind) folded before Flop
Seat 6: JJin91 folded before Flop (didn't bet)


*********** # 193 **************
PokerStars Hand #169476262246: Tournament #1597684053, $13.50+$1.50 USD=
 Hold'em No Limit - Level XIII (350/700) - 2017/05/06 15:48:16 ET
Table '1597684053 5' 6-max Seat #4 is the button
Seat 1: MyManPotnPan (7419 in chips)=20
Seat 3: rbonessss333 (41268 in chips)=20
Seat 4: Bsgwolfpack4 (11750 in chips)=20
Seat 5: Ninja Stax (28938 in chips) is sitting out
Seat 6: JJin91 (89609 in chips)=20
MyManPotnPan: posts the ante 85
rbonessss333: posts the ante 85
Bsgwolfpack4: posts the ante 85
Ninja Stax: posts the ante 85
JJin91: posts the ante 85
Ninja Stax: posts small blind 350
JJin91: posts big blind 700
*** HOLE CARDS ***
Dealt to JJin91 [Jh 3h]
MyManPotnPan: raises 6634 to 7334 and is all-in
rbonessss333: folds=20
Bsgwolfpack4: folds=20
Ninja Stax: folds=20
JJin91: folds=20
Uncalled bet (6634) returned to MyManPotnPan
MyManPotnPan collected 2175 from pot
MyManPotnPan: doesn't show hand=20
*** SUMMARY ***
Total pot 2175 | Rake 0=20
Seat 1: MyManPotnPan collected (2175)
Seat 3: rbonessss333 folded before Flop (didn't bet)
Seat 4: Bsgwolfpack4 (button) folded before Flop (didn't bet)
Seat 5: Ninja Stax (small blind) folded before Flop
Seat 6: JJin91 (big blind) folded before Flop


*********** # 194 **************
PokerStars Hand #169476262284: Tournament #1597684053, $13.50+$1.50 USD=
 Hold'em No Limit - Level XIII (350/700) - 2017/05/06 15:48:28 ET
Table '1597684053 5' 6-max Seat #5 is the button
Seat 1: MyManPotnPan (8809 in chips)=20
Seat 3: rbonessss333 (41183 in chips)=20
Seat 4: Bsgwolfpack4 (11665 in chips)=20
Seat 5: Ninja Stax (28503 in chips) is sitting out
Seat 6: JJin91 (88824 in chips)=20
MyManPotnPan: posts the ante 85
rbonessss333: posts the ante 85
Bsgwolfpack4: posts the ante 85
Ninja Stax: posts the ante 85
JJin91: posts the ante 85
JJin91: posts small blind 350
MyManPotnPan: posts big blind 700
*** HOLE CARDS ***
Dealt to JJin91 [9d Kc]
rbonessss333: raises 2175 to 2875
Bsgwolfpack4: folds=20
Ninja Stax: folds=20
JJin91: folds=20
MyManPotnPan: folds=20
Uncalled bet (2175) returned to rbonessss333
rbonessss333 collected 2175 from pot
*** SUMMARY ***
Total pot 2175 | Rake 0=20
Seat 1: MyManPotnPan (big blind) folded before Flop
Seat 3: rbonessss333 collected (2175)
Seat 4: Bsgwolfpack4 folded before Flop (didn't bet)
Seat 5: Ninja Stax (button) folded before Flop (didn't bet)
Seat 6: JJin91 (small blind) folded before Flop


*********** # 195 **************
PokerStars Hand #169476262322: Tournament #1597684053, $13.50+$1.50 USD=
 Hold'em No Limit - Level XIII (350/700) - 2017/05/06 15:48:42 ET
Table '1597684053 5' 6-max Seat #6 is the button
Seat 1: MyManPotnPan (8024 in chips)=20
Seat 3: rbonessss333 (42573 in chips)=20
Seat 4: Bsgwolfpack4 (11580 in chips)=20
Seat 5: Ninja Stax (28418 in chips) is sitting out
Seat 6: JJin91 (88389 in chips)=20
MyManPotnPan: posts the ante 85
rbonessss333: posts the ante 85
Bsgwolfpack4: posts the ante 85
Ninja Stax: posts the ante 85
JJin91: posts the ante 85
MyManPotnPan: posts small blind 350
rbonessss333: posts big blind 700
*** HOLE CARDS ***
Dealt to JJin91 [6c Jd]
Bsgwolfpack4: raises 1400 to 2100
Ninja Stax: folds=20
JJin91: folds=20
MyManPotnPan: folds=20
rbonessss333: folds=20
Uncalled bet (1400) returned to Bsgwolfpack4
Bsgwolfpack4 collected 2175 from pot
Bsgwolfpack4: doesn't show hand=20
*** SUMMARY ***
Total pot 2175 | Rake 0=20
Seat 1: MyManPotnPan (small blind) folded before Flop
Seat 3: rbonessss333 (big blind) folded before Flop
Seat 4: Bsgwolfpack4 collected (2175)
Seat 5: Ninja Stax folded before Flop (didn't bet)
Seat 6: JJin91 (button) folded before Flop (didn't bet)


*********** # 196 **************
PokerStars Hand #169476262386: Tournament #1597684053, $13.50+$1.50 USD=
 Hold'em No Limit - Level XIII (350/700) - 2017/05/06 15:49:04 ET
Table '1597684053 5' 6-max Seat #1 is the button
Seat 1: MyManPotnPan (7589 in chips)=20
Seat 3: rbonessss333 (41788 in chips)=20
Seat 4: Bsgwolfpack4 (12970 in chips)=20
Seat 5: Ninja Stax (28333 in chips) is sitting out
Seat 6: JJin91 (88304 in chips)=20
MyManPotnPan: posts the ante 85
rbonessss333: posts the ante 85
Bsgwolfpack4: posts the ante 85
Ninja Stax: posts the ante 85
JJin91: posts the ante 85
rbonessss333: posts small blind 350
Bsgwolfpack4: posts big blind 700
*** HOLE CARDS ***
Dealt to JJin91 [Kd Th]
Ninja Stax: folds=20
JJin91: raises 833 to 1533
MyManPotnPan: folds=20
rbonessss333: folds=20
Bsgwolfpack4: raises 11352 to 12885 and is all-in
JJin91: folds=20
Uncalled bet (11352) returned to Bsgwolfpack4
Bsgwolfpack4 collected 3841 from pot
Bsgwolfpack4: doesn't show hand=20
*** SUMMARY ***
Total pot 3841 | Rake 0=20
Seat 1: MyManPotnPan (button) folded before Flop (didn't bet)
Seat 3: rbonessss333 (small blind) folded before Flop
Seat 4: Bsgwolfpack4 (big blind) collected (3841)
Seat 5: Ninja Stax folded before Flop (didn't bet)
Seat 6: JJin91 folded before Flop


*********** # 197 **************
PokerStars Hand #169476262460: Tournament #1597684053, $13.50+$1.50 USD=
 Hold'em No Limit - Level XIII (350/700) - 2017/05/06 15:49:28 ET
Table '1597684053 5' 6-max Seat #3 is the button
Seat 1: MyManPotnPan (7504 in chips)=20
Seat 3: rbonessss333 (41353 in chips)=20
Seat 4: Bsgwolfpack4 (15193 in chips)=20
Seat 5: Ninja Stax (28248 in chips) is sitting out
Seat 6: JJin91 (86686 in chips)=20
MyManPotnPan: posts the ante 85
rbonessss333: posts the ante 85
Bsgwolfpack4: posts the ante 85
Ninja Stax: posts the ante 85
JJin91: posts the ante 85
Bsgwolfpack4: posts small blind 350
Ninja Stax: posts big blind 700
*** HOLE CARDS ***
Dealt to JJin91 [4c 8c]
JJin91: folds=20
MyManPotnPan: raises 6719 to 7419 and is all-in
rbonessss333: folds=20
Bsgwolfpack4: folds=20
Ninja Stax: folds=20
Uncalled bet (6719) returned to MyManPotnPan
MyManPotnPan collected 2175 from pot
MyManPotnPan: doesn't show hand=20
*** SUMMARY ***
Total pot 2175 | Rake 0=20
Seat 1: MyManPotnPan collected (2175)
Seat 3: rbonessss333 (button) folded before Flop (didn't bet)
Seat 4: Bsgwolfpack4 (small blind) folded before Flop
Seat 5: Ninja Stax (big blind) folded before Flop
Seat 6: JJin91 folded before Flop (didn't bet)


*********** # 198 **************
PokerStars Hand #169476262504: Tournament #1597684053, $13.50+$1.50 USD=
 Hold'em No Limit - Level XIII (350/700) - 2017/05/06 15:49:43 ET
Table '1597684053 5' 6-max Seat #4 is the button
Seat 1: MyManPotnPan (8894 in chips)=20
Seat 3: rbonessss333 (41268 in chips)=20
Seat 4: Bsgwolfpack4 (14758 in chips)=20
Seat 5: Ninja Stax (27463 in chips) is sitting out
Seat 6: JJin91 (86601 in chips)=20
MyManPotnPan: posts the ante 85
rbonessss333: posts the ante 85
Bsgwolfpack4: posts the ante 85
Ninja Stax: posts the ante 85
JJin91: posts the ante 85
Ninja Stax: posts small blind 350
JJin91: posts big blind 700
*** HOLE CARDS ***
Dealt to JJin91 [3s 2c]
MyManPotnPan: folds=20
rbonessss333: raises 700 to 1400
Bsgwolfpack4: folds=20
Ninja Stax: folds=20
JJin91: folds=20
Uncalled bet (700) returned to rbonessss333
rbonessss333 collected 2175 from pot
*** SUMMARY ***
Total pot 2175 | Rake 0=20
Seat 1: MyManPotnPan folded before Flop (didn't bet)
Seat 3: rbonessss333 collected (2175)
Seat 4: Bsgwolfpack4 (button) folded before Flop (didn't bet)
Seat 5: Ninja Stax (small blind) folded before Flop
Seat 6: JJin91 (big blind) folded before Flop


*********** # 199 **************
PokerStars Hand #169476262541: Tournament #1597684053, $13.50+$1.50 USD=
 Hold'em No Limit - Level XIII (350/700) - 2017/05/06 15:49:54 ET
Table '1597684053 5' 6-max Seat #5 is the button
Seat 1: MyManPotnPan (8809 in chips)=20
Seat 3: rbonessss333 (42658 in chips)=20
Seat 4: Bsgwolfpack4 (14673 in chips)=20
Seat 5: Ninja Stax (27028 in chips) is sitting out
Seat 6: JJin91 (85816 in chips)=20
MyManPotnPan: posts the ante 85
rbonessss333: posts the ante 85
Bsgwolfpack4: posts the ante 85
Ninja Stax: posts the ante 85
JJin91: posts the ante 85
JJin91: posts small blind 350
MyManPotnPan: posts big blind 700
*** HOLE CARDS ***
Dealt to JJin91 [7s Jd]
rbonessss333: raises 700 to 1400
Bsgwolfpack4: folds=20
Ninja Stax: folds=20
JJin91: folds=20
MyManPotnPan: calls 700
*** FLOP *** [6s 9d 9h]
MyManPotnPan: checks=20
rbonessss333: checks=20
*** TURN *** [6s 9d 9h] [As]
MyManPotnPan: checks=20
rbonessss333: bets 3575
MyManPotnPan: folds=20
Uncalled bet (3575) returned to rbonessss333
rbonessss333 collected 3575 from pot
*** SUMMARY ***
Total pot 3575 | Rake 0=20
Board [6s 9d 9h As]
Seat 1: MyManPotnPan (big blind) folded on the Turn
Seat 3: rbonessss333 collected (3575)
Seat 4: Bsgwolfpack4 folded before Flop (didn't bet)
Seat 5: Ninja Stax (button) folded before Flop (didn't bet)
Seat 6: JJin91 (small blind) folded before Flop


*********** # 200 **************
PokerStars Hand #169476262646: Tournament #1597684053, $13.50+$1.50 USD=
 Hold'em No Limit - Level XIII (350/700) - 2017/05/06 15:50:24 ET
Table '1597684053 5' 6-max Seat #6 is the button
Seat 1: MyManPotnPan (7324 in chips)=20
Seat 3: rbonessss333 (44748 in chips)=20
Seat 4: Bsgwolfpack4 (14588 in chips)=20
Seat 5: Ninja Stax (26943 in chips) is sitting out
Seat 6: JJin91 (85381 in chips)=20
MyManPotnPan: posts the ante 85
rbonessss333: posts the ante 85
Bsgwolfpack4: posts the ante 85
Ninja Stax: posts the ante 85
JJin91: posts the ante 85
MyManPotnPan: posts small blind 350
rbonessss333: posts big blind 700
*** HOLE CARDS ***
Dealt to JJin91 [2d Kc]
Bsgwolfpack4: folds=20
Ninja Stax: folds=20
JJin91: folds=20
MyManPotnPan: calls 350
rbonessss333: checks=20
*** FLOP *** [As 4c 3c]
MyManPotnPan: checks=20
rbonessss333: checks=20
*** TURN *** [As 4c 3c] [Tc]
MyManPotnPan: checks=20
rbonessss333: bets 1825
MyManPotnPan: folds=20
Uncalled bet (1825) returned to rbonessss333
rbonessss333 collected 1825 from pot
*** SUMMARY ***
Total pot 1825 | Rake 0=20
Board [As 4c 3c Tc]
Seat 1: MyManPotnPan (small blind) folded on the Turn
Seat 3: rbonessss333 (big blind) collected (1825)
Seat 4: Bsgwolfpack4 folded before Flop (didn't bet)
Seat 5: Ninja Stax folded before Flop (didn't bet)
Seat 6: JJin91 (button) folded before Flop (didn't bet)


*********** # 201 **************
PokerStars Hand #169476262752: Tournament #1597684053, $13.50+$1.50 USD=
 Hold'em No Limit - Level XIII (350/700) - 2017/05/06 15:50:58 ET
Table '1597684053 5' 6-max Seat #1 is the button
Seat 1: MyManPotnPan (6539 in chips)=20
Seat 3: rbonessss333 (45788 in chips)=20
Seat 4: Bsgwolfpack4 (14503 in chips)=20
Seat 5: Ninja Stax (26858 in chips) is sitting out
Seat 6: JJin91 (85296 in chips)=20
MyManPotnPan: posts the ante 85
rbonessss333: posts the ante 85
Bsgwolfpack4: posts the ante 85
Ninja Stax: posts the ante 85
JJin91: posts the ante 85
rbonessss333: posts small blind 350
Bsgwolfpack4: posts big blind 700
*** HOLE CARDS ***
Dealt to JJin91 [5h 5c]
Ninja Stax: folds=20
JJin91: raises 833 to 1533
MyManPotnPan: folds=20
rbonessss333: folds=20
Bsgwolfpack4: folds=20
Uncalled bet (833) returned to JJin91
JJin91 collected 2175 from pot
JJin91: doesn't show hand=20
*** SUMMARY ***
Total pot 2175 | Rake 0=20
Seat 1: MyManPotnPan (button) folded before Flop (didn't bet)
Seat 3: rbonessss333 (small blind) folded before Flop
Seat 4: Bsgwolfpack4 (big blind) folded before Flop
Seat 5: Ninja Stax folded before Flop (didn't bet)
Seat 6: JJin91 collected (2175)


*********** # 202 **************
PokerStars Hand #169476262799: Tournament #1597684053, $13.50+$1.50 USD=
 Hold'em No Limit - Level XIII (350/700) - 2017/05/06 15:51:15 ET
Table '1597684053 5' 6-max Seat #3 is the button
Seat 1: MyManPotnPan (6454 in chips)=20
Seat 3: rbonessss333 (45353 in chips)=20
Seat 4: Bsgwolfpack4 (13718 in chips)=20
Seat 5: Ninja Stax (26773 in chips) is sitting out
Seat 6: JJin91 (86686 in chips)=20
MyManPotnPan: posts the ante 85
rbonessss333: posts the ante 85
Bsgwolfpack4: posts the ante 85
Ninja Stax: posts the ante 85
JJin91: posts the ante 85
Bsgwolfpack4: posts small blind 350
Ninja Stax: posts big blind 700
*** HOLE CARDS ***
Dealt to JJin91 [Qs 2h]
JJin91: folds=20
MyManPotnPan: folds=20
rbonessss333: calls 700
Bsgwolfpack4: folds=20
Ninja Stax: folds=20
rbonessss333 collected 2175 from pot
*** SUMMARY ***
Total pot 2175 | Rake 0=20
Seat 1: MyManPotnPan folded before Flop (didn't bet)
Seat 3: rbonessss333 (button) collected (2175)
Seat 4: Bsgwolfpack4 (small blind) folded before Flop
Seat 5: Ninja Stax (big blind) folded before Flop
Seat 6: JJin91 folded before Flop (didn't bet)


*********** # 203 **************
PokerStars Hand #169476262863: Tournament #1597684053, $13.50+$1.50 USD=
 Hold'em No Limit - Level XIII (350/700) - 2017/05/06 15:51:32 ET
Table '1597684053 5' 6-max Seat #4 is the button
Seat 1: MyManPotnPan (6369 in chips)=20
Seat 3: rbonessss333 (46743 in chips)=20
Seat 4: Bsgwolfpack4 (13283 in chips)=20
Seat 5: Ninja Stax (25988 in chips) is sitting out
Seat 6: JJin91 (86601 in chips)=20
MyManPotnPan: posts the ante 85
rbonessss333: posts the ante 85
Bsgwolfpack4: posts the ante 85
Ninja Stax: posts the ante 85
JJin91: posts the ante 85
Ninja Stax: posts small blind 350
JJin91: posts big blind 700
*** HOLE CARDS ***
Dealt to JJin91 [5c Ad]
MyManPotnPan: raises 5584 to 6284 and is all-in
rbonessss333: folds=20
Bsgwolfpack4: folds=20
Ninja Stax: folds=20
JJin91: folds=20
Uncalled bet (5584) returned to MyManPotnPan
MyManPotnPan collected 2175 from pot
MyManPotnPan: doesn't show hand=20
*** SUMMARY ***
Total pot 2175 | Rake 0=20
Seat 1: MyManPotnPan collected (2175)
Seat 3: rbonessss333 folded before Flop (didn't bet)
Seat 4: Bsgwolfpack4 (button) folded before Flop (didn't bet)
Seat 5: Ninja Stax (small blind) folded before Flop
Seat 6: JJin91 (big blind) folded before Flop


*********** # 204 **************
PokerStars Hand #169476262924: Tournament #1597684053, $13.50+$1.50 USD=
 Hold'em No Limit - Level XIV (400/800) - 2017/05/06 15:51:50 ET
Table '1597684053 5' 6-max Seat #5 is the button
Seat 1: MyManPotnPan (7759 in chips)=20
Seat 3: rbonessss333 (46658 in chips)=20
Seat 4: Bsgwolfpack4 (13198 in chips)=20
Seat 5: Ninja Stax (25553 in chips) is sitting out
Seat 6: JJin91 (85816 in chips)=20
MyManPotnPan: posts the ante 100
rbonessss333: posts the ante 100
Bsgwolfpack4: posts the ante 100
Ninja Stax: posts the ante 100
JJin91: posts the ante 100
JJin91: posts small blind 400
MyManPotnPan: posts big blind 800
*** HOLE CARDS ***
Dealt to JJin91 [4c 4d]
rbonessss333: folds=20
Bsgwolfpack4: raises 1450 to 2250
Ninja Stax: folds=20
JJin91: folds=20
MyManPotnPan: raises 5409 to 7659 and is all-in
Bsgwolfpack4: folds=20
Uncalled bet (5409) returned to MyManPotnPan
MyManPotnPan collected 5400 from pot
MyManPotnPan: doesn't show hand=20
*** SUMMARY ***
Total pot 5400 | Rake 0=20
Seat 1: MyManPotnPan (big blind) collected (5400)
Seat 3: rbonessss333 folded before Flop (didn't bet)
Seat 4: Bsgwolfpack4 folded before Flop
Seat 5: Ninja Stax (button) folded before Flop (didn't bet)
Seat 6: JJin91 (small blind) folded before Flop


*********** # 205 **************
PokerStars Hand #169476263025: Tournament #1597684053, $13.50+$1.50 USD=
 Hold'em No Limit - Level XIV (400/800) - 2017/05/06 15:52:17 ET
Table '1597684053 5' 6-max Seat #6 is the button
Seat 1: MyManPotnPan (10809 in chips)=20
Seat 3: rbonessss333 (46558 in chips)=20
Seat 4: Bsgwolfpack4 (10848 in chips)=20
Seat 5: Ninja Stax (25453 in chips) is sitting out
Seat 6: JJin91 (85316 in chips)=20
MyManPotnPan: posts the ante 100
rbonessss333: posts the ante 100
Bsgwolfpack4: posts the ante 100
Ninja Stax: posts the ante 100
JJin91: posts the ante 100
MyManPotnPan: posts small blind 400
rbonessss333: posts big blind 800
*** HOLE CARDS ***
Dealt to JJin91 [4h 7s]
Bsgwolfpack4: folds=20
Ninja Stax: folds=20
JJin91: folds=20
MyManPotnPan: raises 9909 to 10709 and is all-in
rbonessss333: folds=20
Uncalled bet (9909) returned to MyManPotnPan
MyManPotnPan collected 2100 from pot
MyManPotnPan: doesn't show hand=20
*** SUMMARY ***
Total pot 2100 | Rake 0=20
Seat 1: MyManPotnPan (small blind) collected (2100)
Seat 3: rbonessss333 (big blind) folded before Flop
Seat 4: Bsgwolfpack4 folded before Flop (didn't bet)
Seat 5: Ninja Stax folded before Flop (didn't bet)
Seat 6: JJin91 (button) folded before Flop (didn't bet)


*********** # 206 **************
PokerStars Hand #169476263086: Tournament #1597684053, $13.50+$1.50 USD=
 Hold'em No Limit - Level XIV (400/800) - 2017/05/06 15:52:32 ET
Table '1597684053 5' 6-max Seat #1 is the button
Seat 1: MyManPotnPan (12009 in chips)=20
Seat 3: rbonessss333 (45658 in chips)=20
Seat 4: Bsgwolfpack4 (10748 in chips)=20
Seat 5: Ninja Stax (25353 in chips) is sitting out
Seat 6: JJin91 (85216 in chips)=20
MyManPotnPan: posts the ante 100
rbonessss333: posts the ante 100
Bsgwolfpack4: posts the ante 100
Ninja Stax: posts the ante 100
JJin91: posts the ante 100
rbonessss333: posts small blind 400
Bsgwolfpack4: posts big blind 800
*** HOLE CARDS ***
Dealt to JJin91 [2d Js]
Ninja Stax: folds=20
JJin91: folds=20
MyManPotnPan: folds=20
rbonessss333: raises 800 to 1600
Bsgwolfpack4: folds=20
Uncalled bet (800) returned to rbonessss333
rbonessss333 collected 2100 from pot
*** SUMMARY ***
Total pot 2100 | Rake 0=20
Seat 1: MyManPotnPan (button) folded before Flop (didn't bet)
Seat 3: rbonessss333 (small blind) collected (2100)
Seat 4: Bsgwolfpack4 (big blind) folded before Flop
Seat 5: Ninja Stax folded before Flop (didn't bet)
Seat 6: JJin91 folded before Flop (didn't bet)


*********** # 207 **************
PokerStars Hand #169476263126: Tournament #1597684053, $13.50+$1.50 USD=
 Hold'em No Limit - Level XIV (400/800) - 2017/05/06 15:52:45 ET
Table '1597684053 5' 6-max Seat #3 is the button
Seat 1: MyManPotnPan (11909 in chips)=20
Seat 3: rbonessss333 (46858 in chips)=20
Seat 4: Bsgwolfpack4 (9848 in chips)=20
Seat 5: Ninja Stax (25253 in chips) is sitting out
Seat 6: JJin91 (85116 in chips)=20
MyManPotnPan: posts the ante 100
rbonessss333: posts the ante 100
Bsgwolfpack4: posts the ante 100
Ninja Stax: posts the ante 100
JJin91: posts the ante 100
Bsgwolfpack4: posts small blind 400
Ninja Stax: posts big blind 800
*** HOLE CARDS ***
Dealt to JJin91 [5c Th]
JJin91: folds=20
MyManPotnPan: folds=20
rbonessss333: raises 45958 to 46758 and is all-in
Bsgwolfpack4: folds=20
Ninja Stax: folds=20
Uncalled bet (45958) returned to rbonessss333
rbonessss333 collected 2500 from pot
*** SUMMARY ***
Total pot 2500 | Rake 0=20
Seat 1: MyManPotnPan folded before Flop (didn't bet)
Seat 3: rbonessss333 (button) collected (2500)
Seat 4: Bsgwolfpack4 (small blind) folded before Flop
Seat 5: Ninja Stax (big blind) folded before Flop
Seat 6: JJin91 folded before Flop (didn't bet)


*********** # 208 **************
PokerStars Hand #169476263173: Tournament #1597684053, $13.50+$1.50 USD=
 Hold'em No Limit - Level XIV (400/800) - 2017/05/06 15:52:59 ET
Table '1597684053 5' 6-max Seat #4 is the button
Seat 1: MyManPotnPan (11809 in chips)=20
Seat 3: rbonessss333 (48458 in chips)=20
Seat 4: Bsgwolfpack4 (9348 in chips)=20
Seat 5: Ninja Stax (24353 in chips) is sitting out
Seat 6: JJin91 (85016 in chips)=20
MyManPotnPan: posts the ante 100
rbonessss333: posts the ante 100
Bsgwolfpack4: posts the ante 100
Ninja Stax: posts the ante 100
JJin91: posts the ante 100
Ninja Stax: posts small blind 400
JJin91: posts big blind 800
*** HOLE CARDS ***
Dealt to JJin91 [Kd Th]
MyManPotnPan: raises 10909 to 11709 and is all-in
rbonessss333: folds=20
Bsgwolfpack4: folds=20
Ninja Stax: folds=20
JJin91: folds=20
Uncalled bet (10909) returned to MyManPotnPan
MyManPotnPan collected 2500 from pot
MyManPotnPan: doesn't show hand=20
*** SUMMARY ***
Total pot 2500 | Rake 0=20
Seat 1: MyManPotnPan collected (2500)
Seat 3: rbonessss333 folded before Flop (didn't bet)
Seat 4: Bsgwolfpack4 (button) folded before Flop (didn't bet)
Seat 5: Ninja Stax (small blind) folded before Flop
Seat 6: JJin91 (big blind) folded before Flop


*********** # 209 **************
PokerStars Hand #169476263229: Tournament #1597684053, $13.50+$1.50 USD=
 Hold'em No Limit - Level XIV (400/800) - 2017/05/06 15:53:17 ET
Table '1597684053 5' 6-max Seat #5 is the button
Seat 1: MyManPotnPan (13409 in chips)=20
Seat 3: rbonessss333 (48358 in chips)=20
Seat 4: Bsgwolfpack4 (9248 in chips)=20
Seat 5: Ninja Stax (23853 in chips) is sitting out
Seat 6: JJin91 (84116 in chips)=20
MyManPotnPan: posts the ante 100
rbonessss333: posts the ante 100
Bsgwolfpack4: posts the ante 100
Ninja Stax: posts the ante 100
JJin91: posts the ante 100
JJin91: posts small blind 400
MyManPotnPan: posts big blind 800
*** HOLE CARDS ***
Dealt to JJin91 [Qh 3s]
rbonessss333: raises 800 to 1600
Bsgwolfpack4: folds=20
Ninja Stax: folds=20
JJin91: folds=20
MyManPotnPan: folds=20
Uncalled bet (800) returned to rbonessss333
rbonessss333 collected 2500 from pot
*** SUMMARY ***
Total pot 2500 | Rake 0=20
Seat 1: MyManPotnPan (big blind) folded before Flop
Seat 3: rbonessss333 collected (2500)
Seat 4: Bsgwolfpack4 folded before Flop (didn't bet)
Seat 5: Ninja Stax (button) folded before Flop (didn't bet)
Seat 6: JJin91 (small blind) folded before Flop


*********** # 210 **************
PokerStars Hand #169476263285: Tournament #1597684053, $13.50+$1.50 USD=
 Hold'em No Limit - Level XIV (400/800) - 2017/05/06 15:53:30 ET
Table '1597684053 5' 6-max Seat #6 is the button
Seat 1: MyManPotnPan (12509 in chips)=20
Seat 3: rbonessss333 (49958 in chips)=20
Seat 4: Bsgwolfpack4 (9148 in chips)=20
Seat 5: Ninja Stax (23753 in chips) is sitting out
Seat 6: JJin91 (83616 in chips)=20
MyManPotnPan: posts the ante 100
rbonessss333: posts the ante 100
Bsgwolfpack4: posts the ante 100
Ninja Stax: posts the ante 100
JJin91: posts the ante 100
MyManPotnPan: posts small blind 400
rbonessss333: posts big blind 800
*** HOLE CARDS ***
Dealt to JJin91 [8h 3h]
Bsgwolfpack4: folds=20
Ninja Stax: folds=20
JJin91: folds=20
MyManPotnPan: folds=20
Uncalled bet (400) returned to rbonessss333
rbonessss333 collected 1300 from pot
*** SUMMARY ***
Total pot 1300 | Rake 0=20
Seat 1: MyManPotnPan (small blind) folded before Flop
Seat 3: rbonessss333 (big blind) collected (1300)
Seat 4: Bsgwolfpack4 folded before Flop (didn't bet)
Seat 5: Ninja Stax folded before Flop (didn't bet)
Seat 6: JJin91 (button) folded before Flop (didn't bet)


*********** # 211 **************
PokerStars Hand #169476263320: Tournament #1597684053, $13.50+$1.50 USD=
 Hold'em No Limit - Level XIV (400/800) - 2017/05/06 15:53:40 ET
Table '1597684053 5' 6-max Seat #1 is the button
Seat 1: MyManPotnPan (12009 in chips)=20
Seat 3: rbonessss333 (50758 in chips)=20
Seat 4: Bsgwolfpack4 (9048 in chips)=20
Seat 5: Ninja Stax (23653 in chips) is sitting out
Seat 6: JJin91 (83516 in chips)=20
MyManPotnPan: posts the ante 100
rbonessss333: posts the ante 100
Bsgwolfpack4: posts the ante 100
Ninja Stax: posts the ante 100
JJin91: posts the ante 100
rbonessss333: posts small blind 400
Bsgwolfpack4: posts big blind 800
*** HOLE CARDS ***
Dealt to JJin91 [9h 5c]
Ninja Stax: folds=20
JJin91: folds=20
MyManPotnPan: folds=20
rbonessss333: calls 400
Bsgwolfpack4: raises 8148 to 8948 and is all-in
rbonessss333: folds=20
Uncalled bet (8148) returned to Bsgwolfpack4
Bsgwolfpack4 collected 2100 from pot
Bsgwolfpack4: doesn't show hand=20
*** SUMMARY ***
Total pot 2100 | Rake 0=20
Seat 1: MyManPotnPan (button) folded before Flop (didn't bet)
Seat 3: rbonessss333 (small blind) folded before Flop
Seat 4: Bsgwolfpack4 (big blind) collected (2100)
Seat 5: Ninja Stax folded before Flop (didn't bet)
Seat 6: JJin91 folded before Flop (didn't bet)


*********** # 212 **************
PokerStars Hand #169476263379: Tournament #1597684053, $13.50+$1.50 USD=
 Hold'em No Limit - Level XIV (400/800) - 2017/05/06 15:54:01 ET
Table '1597684053 5' 6-max Seat #3 is the button
Seat 1: MyManPotnPan (11909 in chips)=20
Seat 3: rbonessss333 (49858 in chips)=20
Seat 4: Bsgwolfpack4 (10248 in chips)=20
Seat 5: Ninja Stax (23553 in chips) is sitting out
Seat 6: JJin91 (83416 in chips)=20
MyManPotnPan: posts the ante 100
rbonessss333: posts the ante 100
Bsgwolfpack4: posts the ante 100
Ninja Stax: posts the ante 100
JJin91: posts the ante 100
Bsgwolfpack4: posts small blind 400
Ninja Stax: posts big blind 800
*** HOLE CARDS ***
Dealt to JJin91 [8d As]
JJin91: raises 952 to 1752
MyManPotnPan: folds=20
rbonessss333: calls 1752
Bsgwolfpack4: folds=20
Ninja Stax: folds=20
*** FLOP *** [Ah 5s 9c]
JJin91: checks=20
rbonessss333: checks=20
*** TURN *** [Ah 5s 9c] [2s]
JJin91: bets 2758
rbonessss333: raises 10720 to 13478
JJin91: calls 10720
*** RIVER *** [Ah 5s 9c 2s] [Jd]
JJin91: checks=20
rbonessss333: bets 16080
JJin91: raises 52006 to 68086 and is all-in
rbonessss333: calls 18448 and is all-in
Uncalled bet (33558) returned to JJin91
*** SHOW DOWN ***
JJin91: shows [8d As] (a pair of Aces)
rbonessss333: shows [5d 5h] (three of a kind, Fives)
rbonessss333 collected 101216 from pot
*** SUMMARY ***
Total pot 101216 | Rake 0=20
Board [Ah 5s 9c 2s Jd]
Seat 1: MyManPotnPan folded before Flop (didn't bet)
Seat 3: rbonessss333 (button) showed [5d 5h] and won (101216) with thre=
e of a kind, Fives
Seat 4: Bsgwolfpack4 (small blind) folded before Flop
Seat 5: Ninja Stax (big blind) folded before Flop
Seat 6: JJin91 showed [8d As] and lost with a pair of Aces


*********** # 213 **************
PokerStars Hand #169476263548: Tournament #1597684053, $13.50+$1.50 USD=
 Hold'em No Limit - Level XIV (400/800) - 2017/05/06 15:54:53 ET
Table '1597684053 5' 6-max Seat #4 is the button
Seat 1: MyManPotnPan (11809 in chips)=20
Seat 3: rbonessss333 (101216 in chips)=20
Seat 4: Bsgwolfpack4 (9748 in chips)=20
Seat 5: Ninja Stax (22653 in chips) is sitting out
Seat 6: JJin91 (33558 in chips)=20
MyManPotnPan: posts the ante 100
rbonessss333: posts the ante 100
Bsgwolfpack4: posts the ante 100
Ninja Stax: posts the ante 100
JJin91: posts the ante 100
Ninja Stax: posts small blind 400
JJin91: posts big blind 800
*** HOLE CARDS ***
Dealt to JJin91 [7h 9d]
MyManPotnPan: raises 10909 to 11709 and is all-in
rbonessss333: folds=20
Bsgwolfpack4: folds=20
Ninja Stax: folds=20
JJin91: folds=20
Uncalled bet (10909) returned to MyManPotnPan
MyManPotnPan collected 2500 from pot
MyManPotnPan: doesn't show hand=20
*** SUMMARY ***
Total pot 2500 | Rake 0=20
Seat 1: MyManPotnPan collected (2500)
Seat 3: rbonessss333 folded before Flop (didn't bet)
Seat 4: Bsgwolfpack4 (button) folded before Flop (didn't bet)
Seat 5: Ninja Stax (small blind) folded before Flop
Seat 6: JJin91 (big blind) folded before Flop


*********** # 214 **************
PokerStars Hand #169476263600: Tournament #1597684053, $13.50+$1.50 USD=
 Hold'em No Limit - Level XIV (400/800) - 2017/05/06 15:55:07 ET
Table '1597684053 5' 6-max Seat #5 is the button
Seat 1: MyManPotnPan (13409 in chips)=20
Seat 3: rbonessss333 (101116 in chips)=20
Seat 4: Bsgwolfpack4 (9648 in chips)=20
Seat 5: Ninja Stax (22153 in chips) is sitting out
Seat 6: JJin91 (32658 in chips)=20
MyManPotnPan: posts the ante 100
rbonessss333: posts the ante 100
Bsgwolfpack4: posts the ante 100
Ninja Stax: posts the ante 100
JJin91: posts the ante 100
JJin91: posts small blind 400
MyManPotnPan: posts big blind 800
*** HOLE CARDS ***
Dealt to JJin91 [9c 4c]
rbonessss333: folds=20
Bsgwolfpack4: folds=20
Ninja Stax: folds=20
JJin91: folds=20
Uncalled bet (400) returned to MyManPotnPan
MyManPotnPan collected 1300 from pot
MyManPotnPan: doesn't show hand=20
*** SUMMARY ***
Total pot 1300 | Rake 0=20
Seat 1: MyManPotnPan (big blind) collected (1300)
Seat 3: rbonessss333 folded before Flop (didn't bet)
Seat 4: Bsgwolfpack4 folded before Flop (didn't bet)
Seat 5: Ninja Stax (button) folded before Flop (didn't bet)
Seat 6: JJin91 (small blind) folded before Flop


*********** # 215 **************
PokerStars Hand #169476264580: Tournament #1597684053, $13.50+$1.50 USD=
 Hold'em No Limit - Level XIV (400/800) - 2017/05/06 16:00:32 ET
Table '1597684053 5' 6-max Seat #6 is the button
Seat 1: MyManPotnPan (14209 in chips)=20
Seat 2: VinnieB118 (91063 in chips)=20
Seat 3: rbonessss333 (101016 in chips)=20
Seat 4: Bsgwolfpack4 (9548 in chips)=20
Seat 5: Ninja Stax (22053 in chips)=20
Seat 6: JJin91 (32158 in chips)=20
MyManPotnPan: posts the ante 100
VinnieB118: posts the ante 100
rbonessss333: posts the ante 100
Bsgwolfpack4: posts the ante 100
Ninja Stax: posts the ante 100
JJin91: posts the ante 100
MyManPotnPan: posts small blind 400
VinnieB118: posts big blind 800
*** HOLE CARDS ***
Dealt to JJin91 [Ac 3h]
rbonessss333: folds=20
Bsgwolfpack4: folds=20
Ninja Stax: folds=20
JJin91: raises 952 to 1752
MyManPotnPan: folds=20
VinnieB118: folds=20
Uncalled bet (952) returned to JJin91
JJin91 collected 2600 from pot
JJin91: doesn't show hand=20
*** SUMMARY ***
Total pot 2600 | Rake 0=20
Seat 1: MyManPotnPan (small blind) folded before Flop
Seat 2: VinnieB118 (big blind) folded before Flop
Seat 3: rbonessss333 folded before Flop (didn't bet)
Seat 4: Bsgwolfpack4 folded before Flop (didn't bet)
Seat 5: Ninja Stax folded before Flop (didn't bet)
Seat 6: JJin91 (button) collected (2600)


*********** # 216 **************
PokerStars Hand #169476264838: Tournament #1597684053, $13.50+$1.50 USD=
 Hold'em No Limit - Level XIV (400/800) - 2017/05/06 16:01:43 ET
Table '1597684053 5' 6-max Seat #1 is the button
Seat 1: MyManPotnPan (13709 in chips)=20
Seat 2: VinnieB118 (90163 in chips)=20
Seat 3: rbonessss333 (100916 in chips)=20
Seat 4: Bsgwolfpack4 (9448 in chips)=20
Seat 5: Ninja Stax (21953 in chips)=20
Seat 6: JJin91 (33858 in chips)=20
MyManPotnPan: posts the ante 100
VinnieB118: posts the ante 100
rbonessss333: posts the ante 100
Bsgwolfpack4: posts the ante 100
Ninja Stax: posts the ante 100
JJin91: posts the ante 100
VinnieB118: posts small blind 400
rbonessss333: posts big blind 800
*** HOLE CARDS ***
Dealt to JJin91 [Jd As]
Bsgwolfpack4: folds=20
Ninja Stax: folds=20
JJin91: raises 1288 to 2088
MyManPotnPan: raises 11521 to 13609 and is all-in
VinnieB118: folds=20
rbonessss333: folds=20
JJin91: calls 11521
*** FLOP *** [7d 3h Ts]
*** TURN *** [7d 3h Ts] [9s]
*** RIVER *** [7d 3h Ts 9s] [8h]
*** SHOW DOWN ***
JJin91: shows [Jd As] (a straight, Seven to Jack)
MyManPotnPan: shows [2c 2h] (a pair of Deuces)
JJin91 collected 29018 from pot
MyManPotnPan finished the tournament in 22nd place
*** SUMMARY ***
Total pot 29018 | Rake 0=20
Board [7d 3h Ts 9s 8h]
Seat 1: MyManPotnPan (button) showed [2c 2h] and lost with a pair of De=
uces
Seat 2: VinnieB118 (small blind) folded before Flop
Seat 3: rbonessss333 (big blind) folded before Flop
Seat 4: Bsgwolfpack4 folded before Flop (didn't bet)
Seat 5: Ninja Stax folded before Flop (didn't bet)
Seat 6: JJin91 showed [Jd As] and won (29018) with a straight, Seven to=
 Jack


*********** # 217 **************
PokerStars Hand #169476265014: Tournament #1597684053, $13.50+$1.50 USD=
 Hold'em No Limit - Level XIV (400/800) - 2017/05/06 16:02:33 ET
Table '1597684053 5' 6-max Seat #2 is the button
Seat 2: VinnieB118 (89663 in chips)=20
Seat 3: rbonessss333 (100016 in chips)=20
Seat 4: Bsgwolfpack4 (9348 in chips)=20
Seat 5: Ninja Stax (21853 in chips)=20
Seat 6: JJin91 (49167 in chips)=20
VinnieB118: posts the ante 100
rbonessss333: posts the ante 100
Bsgwolfpack4: posts the ante 100
Ninja Stax: posts the ante 100
JJin91: posts the ante 100
rbonessss333: posts small blind 400
Bsgwolfpack4: posts big blind 800
*** HOLE CARDS ***
Dealt to JJin91 [Ks 9h]
Ninja Stax: calls 800
JJin91: folds=20
VinnieB118: folds=20
rbonessss333: raises 1600 to 2400
Bsgwolfpack4: folds=20
Ninja Stax: calls 1600
*** FLOP *** [6c 2c Td]
rbonessss333: bets 3050
Ninja Stax: calls 3050
*** TURN *** [6c 2c Td] [Qh]
rbonessss333: checks=20
Ninja Stax: checks=20
*** RIVER *** [6c 2c Td Qh] [4d]
rbonessss333: bets 800
Ninja Stax: calls 800
*** SHOW DOWN ***
rbonessss333: shows [Ah Jh] (high card Ace)
Ninja Stax: shows [6s 5s] (a pair of Sixes)
Ninja Stax collected 13800 from pot
*** SUMMARY ***
Total pot 13800 | Rake 0=20
Board [6c 2c Td Qh 4d]
Seat 2: VinnieB118 (button) folded before Flop (didn't bet)
Seat 3: rbonessss333 (small blind) showed [Ah Jh] and lost with high ca=
rd Ace
Seat 4: Bsgwolfpack4 (big blind) folded before Flop
Seat 5: Ninja Stax showed [6s 5s] and won (13800) with a pair of Sixes
Seat 6: JJin91 folded before Flop (didn't bet)


*********** # 218 **************
PokerStars Hand #169476265223: Tournament #1597684053, $13.50+$1.50 USD=
 Hold'em No Limit - Level XIV (400/800) - 2017/05/06 16:03:35 ET
Table '1597684053 5' 6-max Seat #3 is the button
Seat 2: VinnieB118 (89563 in chips)=20
Seat 3: rbonessss333 (93666 in chips)=20
Seat 4: Bsgwolfpack4 (8448 in chips)=20
Seat 5: Ninja Stax (29303 in chips)=20
Seat 6: JJin91 (49067 in chips)=20
VinnieB118: posts the ante 100
rbonessss333: posts the ante 100
Bsgwolfpack4: posts the ante 100
Ninja Stax: posts the ante 100
JJin91: posts the ante 100
Bsgwolfpack4: posts small blind 400
Ninja Stax: posts big blind 800
*** HOLE CARDS ***
Dealt to JJin91 [8c Qh]
JJin91: folds=20
VinnieB118: raises 800 to 1600
rbonessss333: folds=20
Bsgwolfpack4: folds=20
Ninja Stax: calls 800
*** FLOP *** [4c 2s 7s]
Ninja Stax: checks=20
VinnieB118: bets 4000
Ninja Stax: calls 4000
*** TURN *** [4c 2s 7s] [3c]
Ninja Stax: checks=20
VinnieB118: checks=20
*** RIVER *** [4c 2s 7s 3c] [2d]
Ninja Stax: bets 4000
VinnieB118: calls 4000
*** SHOW DOWN ***
Ninja Stax: shows [9c Jd] (a pair of Deuces)
VinnieB118: shows [As 6c] (a pair of Deuces - Ace kicker)
VinnieB118 collected 20100 from pot
*** SUMMARY ***
Total pot 20100 | Rake 0=20
Board [4c 2s 7s 3c 2d]
Seat 2: VinnieB118 showed [As 6c] and won (20100) with a pair of Deuces
Seat 3: rbonessss333 (button) folded before Flop (didn't bet)
Seat 4: Bsgwolfpack4 (small blind) folded before Flop
Seat 5: Ninja Stax (big blind) showed [9c Jd] and lost with a pair of D=
euces
Seat 6: JJin91 folded before Flop (didn't bet)


*********** # 219 **************
PokerStars Hand #169476265468: Tournament #1597684053, $13.50+$1.50 USD=
 Hold'em No Limit - Level XIV (400/800) - 2017/05/06 16:04:44 ET
Table '1597684053 5' 6-max Seat #4 is the button
Seat 2: VinnieB118 (99963 in chips)=20
Seat 3: rbonessss333 (93566 in chips)=20
Seat 4: Bsgwolfpack4 (7948 in chips)=20
Seat 5: Ninja Stax (19603 in chips)=20
Seat 6: JJin91 (48967 in chips)=20
VinnieB118: posts the ante 100
rbonessss333: posts the ante 100
Bsgwolfpack4: posts the ante 100
Ninja Stax: posts the ante 100
JJin91: posts the ante 100
Ninja Stax: posts small blind 400
JJin91: posts big blind 800
*** HOLE CARDS ***
Dealt to JJin91 [3d 2s]
VinnieB118: raises 1600 to 2400
rbonessss333: folds=20
Bsgwolfpack4: folds=20
Ninja Stax: folds=20
JJin91: folds=20
Uncalled bet (1600) returned to VinnieB118
VinnieB118 collected 2500 from pot
VinnieB118: doesn't show hand=20
*** SUMMARY ***
Total pot 2500 | Rake 0=20
Seat 2: VinnieB118 collected (2500)
Seat 3: rbonessss333 folded before Flop (didn't bet)
Seat 4: Bsgwolfpack4 (button) folded before Flop (didn't bet)
Seat 5: Ninja Stax (small blind) folded before Flop
Seat 6: JJin91 (big blind) folded before Flop


*********** # 220 **************
PokerStars Hand #169476265519: Tournament #1597684053, $13.50+$1.50 USD=
 Hold'em No Limit - Level XIV (400/800) - 2017/05/06 16:04:59 ET
Table '1597684053 5' 6-max Seat #5 is the button
Seat 2: VinnieB118 (101563 in chips)=20
Seat 3: rbonessss333 (93466 in chips)=20
Seat 4: Bsgwolfpack4 (7848 in chips)=20
Seat 5: Ninja Stax (19103 in chips)=20
Seat 6: JJin91 (48067 in chips)=20
VinnieB118: posts the ante 100
rbonessss333: posts the ante 100
Bsgwolfpack4: posts the ante 100
Ninja Stax: posts the ante 100
JJin91: posts the ante 100
JJin91: posts small blind 400
VinnieB118: posts big blind 800
*** HOLE CARDS ***
Dealt to JJin91 [Jc Kd]
rbonessss333: folds=20
Bsgwolfpack4: folds=20
Ninja Stax: folds=20
JJin91: raises 1288 to 2088
VinnieB118: folds=20
Uncalled bet (1288) returned to JJin91
JJin91 collected 2100 from pot
JJin91: doesn't show hand=20
*** SUMMARY ***
Total pot 2100 | Rake 0=20
Seat 2: VinnieB118 (big blind) folded before Flop
Seat 3: rbonessss333 folded before Flop (didn't bet)
Seat 4: Bsgwolfpack4 folded before Flop (didn't bet)
Seat 5: Ninja Stax (button) folded before Flop (didn't bet)
Seat 6: JJin91 (small blind) collected (2100)


*********** # 221 **************
PokerStars Hand #169476265567: Tournament #1597684053, $13.50+$1.50 USD=
 Hold'em No Limit - Level XIV (400/800) - 2017/05/06 16:05:11 ET
Table '1597684053 5' 6-max Seat #6 is the button
Seat 2: VinnieB118 (100663 in chips)=20
Seat 3: rbonessss333 (93366 in chips)=20
Seat 4: Bsgwolfpack4 (7748 in chips)=20
Seat 5: Ninja Stax (19003 in chips)=20
Seat 6: JJin91 (49267 in chips)=20
VinnieB118: posts the ante 100
rbonessss333: posts the ante 100
Bsgwolfpack4: posts the ante 100
Ninja Stax: posts the ante 100
JJin91: posts the ante 100
VinnieB118: posts small blind 400
rbonessss333: posts big blind 800
*** HOLE CARDS ***
Dealt to JJin91 [5h 8c]
Bsgwolfpack4: folds=20
Ninja Stax: raises 800 to 1600
JJin91: folds=20
VinnieB118: folds=20
rbonessss333: folds=20
Uncalled bet (800) returned to Ninja Stax
Ninja Stax collected 2500 from pot
Ninja Stax: doesn't show hand=20
*** SUMMARY ***
Total pot 2500 | Rake 0=20
Seat 2: VinnieB118 (small blind) folded before Flop
Seat 3: rbonessss333 (big blind) folded before Flop
Seat 4: Bsgwolfpack4 folded before Flop (didn't bet)
Seat 5: Ninja Stax collected (2500)
Seat 6: JJin91 (button) folded before Flop (didn't bet)


*********** # 222 **************
PokerStars Hand #169476265628: Tournament #1597684053, $13.50+$1.50 USD=
 Hold'em No Limit - Level XIV (400/800) - 2017/05/06 16:05:30 ET
Table '1597684053 5' 6-max Seat #2 is the button
Seat 2: VinnieB118 (100163 in chips)=20
Seat 3: rbonessss333 (92466 in chips)=20
Seat 4: Bsgwolfpack4 (7648 in chips)=20
Seat 5: Ninja Stax (20603 in chips)=20
Seat 6: JJin91 (49167 in chips)=20
VinnieB118: posts the ante 100
rbonessss333: posts the ante 100
Bsgwolfpack4: posts the ante 100
Ninja Stax: posts the ante 100
JJin91: posts the ante 100
rbonessss333: posts small blind 400
Bsgwolfpack4: posts big blind 800
*** HOLE CARDS ***
Dealt to JJin91 [Th 7s]
Ninja Stax: folds=20
JJin91: folds=20
VinnieB118: folds=20
rbonessss333: raises 2100 to 2900
Bsgwolfpack4: folds=20
Uncalled bet (2100) returned to rbonessss333
rbonessss333 collected 2100 from pot
*** SUMMARY ***
Total pot 2100 | Rake 0=20
Seat 2: VinnieB118 (button) folded before Flop (didn't bet)
Seat 3: rbonessss333 (small blind) collected (2100)
Seat 4: Bsgwolfpack4 (big blind) folded before Flop
Seat 5: Ninja Stax folded before Flop (didn't bet)
Seat 6: JJin91 folded before Flop (didn't bet)


*********** # 223 **************
PokerStars Hand #169476265679: Tournament #1597684053, $13.50+$1.50 USD=
 Hold'em No Limit - Level XIV (400/800) - 2017/05/06 16:05:44 ET
Table '1597684053 5' 6-max Seat #3 is the button
Seat 2: VinnieB118 (100063 in chips)=20
Seat 3: rbonessss333 (93666 in chips)=20
Seat 4: Bsgwolfpack4 (6748 in chips)=20
Seat 5: Ninja Stax (20503 in chips)=20
Seat 6: JJin91 (49067 in chips)=20
VinnieB118: posts the ante 100
rbonessss333: posts the ante 100
Bsgwolfpack4: posts the ante 100
Ninja Stax: posts the ante 100
JJin91: posts the ante 100
Bsgwolfpack4: posts small blind 400
Ninja Stax: posts big blind 800
*** HOLE CARDS ***
Dealt to JJin91 [3h 9d]
JJin91: folds=20
VinnieB118: raises 3200 to 4000
rbonessss333: folds=20
Bsgwolfpack4: folds=20
Ninja Stax: folds=20
Uncalled bet (3200) returned to VinnieB118
VinnieB118 collected 2500 from pot
VinnieB118: doesn't show hand=20
*** SUMMARY ***
Total pot 2500 | Rake 0=20
Seat 2: VinnieB118 collected (2500)
Seat 3: rbonessss333 (button) folded before Flop (didn't bet)
Seat 4: Bsgwolfpack4 (small blind) folded before Flop
Seat 5: Ninja Stax (big blind) folded before Flop
Seat 6: JJin91 folded before Flop (didn't bet)


*********** # 224 **************
PokerStars Hand #169476265736: Tournament #1597684053, $13.50+$1.50 USD=
 Hold'em No Limit - Level XIV (400/800) - 2017/05/06 16:06:02 ET
Table '1597684053 5' 6-max Seat #4 is the button
Seat 2: VinnieB118 (101663 in chips)=20
Seat 3: rbonessss333 (93566 in chips)=20
Seat 4: Bsgwolfpack4 (6248 in chips)=20
Seat 5: Ninja Stax (19603 in chips)=20
Seat 6: JJin91 (48967 in chips)=20
VinnieB118: posts the ante 100
rbonessss333: posts the ante 100
Bsgwolfpack4: posts the ante 100
Ninja Stax: posts the ante 100
JJin91: posts the ante 100
Ninja Stax: posts small blind 400
JJin91: posts big blind 800
*** HOLE CARDS ***
Dealt to JJin91 [9s 4s]
VinnieB118: folds=20
rbonessss333: raises 800 to 1600
Bsgwolfpack4: folds=20
Ninja Stax: calls 1200
JJin91: calls 800
*** FLOP *** [6s 2d 4c]
Ninja Stax: bets 1600
JJin91: folds=20
rbonessss333: raises 8500 to 10100
Ninja Stax: folds=20
Uncalled bet (8500) returned to rbonessss333
rbonessss333 collected 8500 from pot
*** SUMMARY ***
Total pot 8500 | Rake 0=20
Board [6s 2d 4c]
Seat 2: VinnieB118 folded before Flop (didn't bet)
Seat 3: rbonessss333 collected (8500)
Seat 4: Bsgwolfpack4 (button) folded before Flop (didn't bet)
Seat 5: Ninja Stax (small blind) folded on the Flop
Seat 6: JJin91 (big blind) folded on the Flop


*********** # 225 **************
PokerStars Hand #169476265921: Tournament #1597684053, $13.50+$1.50 USD=
 Hold'em No Limit - Level XIV (400/800) - 2017/05/06 16:06:53 ET
Table '1597684053 5' 6-max Seat #5 is the button
Seat 2: VinnieB118 (101563 in chips)=20
Seat 3: rbonessss333 (98766 in chips)=20
Seat 4: Bsgwolfpack4 (6148 in chips)=20
Seat 5: Ninja Stax (16303 in chips)=20
Seat 6: JJin91 (47267 in chips)=20
VinnieB118: posts the ante 100
rbonessss333: posts the ante 100
Bsgwolfpack4: posts the ante 100
Ninja Stax: posts the ante 100
JJin91: posts the ante 100
JJin91: posts small blind 400
VinnieB118: posts big blind 800
*** HOLE CARDS ***
Dealt to JJin91 [3c Qs]
rbonessss333: folds=20
Bsgwolfpack4: folds=20
Ninja Stax: folds=20
JJin91: folds=20
Uncalled bet (400) returned to VinnieB118
VinnieB118 collected 1300 from pot
VinnieB118: doesn't show hand=20
*** SUMMARY ***
Total pot 1300 | Rake 0=20
Seat 2: VinnieB118 (big blind) collected (1300)
Seat 3: rbonessss333 folded before Flop (didn't bet)
Seat 4: Bsgwolfpack4 folded before Flop (didn't bet)
Seat 5: Ninja Stax (button) folded before Flop (didn't bet)
Seat 6: JJin91 (small blind) folded before Flop


*********** # 226 **************
PokerStars Hand #169476265967: Tournament #1597684053, $13.50+$1.50 USD=
 Hold'em No Limit - Level XV (500/1000) - 2017/05/06 16:07:07 ET
Table '1597684053 5' 6-max Seat #6 is the button
Seat 2: VinnieB118 (102363 in chips)=20
Seat 3: rbonessss333 (98666 in chips)=20
Seat 4: Bsgwolfpack4 (6048 in chips)=20
Seat 5: Ninja Stax (16203 in chips)=20
Seat 6: JJin91 (46767 in chips)=20
VinnieB118: posts the ante 125
rbonessss333: posts the ante 125
Bsgwolfpack4: posts the ante 125
Ninja Stax: posts the ante 125
JJin91: posts the ante 125
VinnieB118: posts small blind 500
rbonessss333: posts big blind 1000
*** HOLE CARDS ***
Dealt to JJin91 [Qh 5s]
Bsgwolfpack4: raises 4923 to 5923 and is all-in
Ninja Stax: folds=20
JJin91: folds=20
VinnieB118: calls 5423
rbonessss333: folds=20
*** FLOP *** [2c 3d 3s]
*** TURN *** [2c 3d 3s] [Td]
*** RIVER *** [2c 3d 3s Td] [6d]
*** SHOW DOWN ***
VinnieB118: shows [4s As] (a pair of Threes)
Bsgwolfpack4: shows [7d Qd] (a flush, Queen high)
Bsgwolfpack4 collected 13471 from pot
*** SUMMARY ***
Total pot 13471 | Rake 0=20
Board [2c 3d 3s Td 6d]
Seat 2: VinnieB118 (small blind) showed [4s As] and lost with a pair of=
 Threes
Seat 3: rbonessss333 (big blind) folded before Flop
Seat 4: Bsgwolfpack4 showed [7d Qd] and won (13471) with a flush, Queen=
 high
Seat 5: Ninja Stax folded before Flop (didn't bet)
Seat 6: JJin91 (button) folded before Flop (didn't bet)


*********** # 227 **************
PokerStars Hand #169476266064: Tournament #1597684053, $13.50+$1.50 USD=
 Hold'em No Limit - Level XV (500/1000) - 2017/05/06 16:07:33 ET
Table '1597684053 5' 6-max Seat #2 is the button
Seat 2: VinnieB118 (96315 in chips)=20
Seat 3: rbonessss333 (97541 in chips)=20
Seat 4: Bsgwolfpack4 (13471 in chips)=20
Seat 5: Ninja Stax (16078 in chips)=20
Seat 6: JJin91 (46642 in chips)=20
VinnieB118: posts the ante 125
rbonessss333: posts the ante 125
Bsgwolfpack4: posts the ante 125
Ninja Stax: posts the ante 125
JJin91: posts the ante 125
rbonessss333: posts small blind 500
Bsgwolfpack4: posts big blind 1000
*** HOLE CARDS ***
Dealt to JJin91 [Ah 7h]
Ninja Stax: folds=20
JJin91: raises 1190 to 2190
VinnieB118: folds=20
rbonessss333: folds=20
Bsgwolfpack4: folds=20
Uncalled bet (1190) returned to JJin91
JJin91 collected 3125 from pot
JJin91: doesn't show hand=20
*** SUMMARY ***
Total pot 3125 | Rake 0=20
Seat 2: VinnieB118 (button) folded before Flop (didn't bet)
Seat 3: rbonessss333 (small blind) folded before Flop
Seat 4: Bsgwolfpack4 (big blind) folded before Flop
Seat 5: Ninja Stax folded before Flop (didn't bet)
Seat 6: JJin91 collected (3125)


*********** # 228 **************
PokerStars Hand #169476266120: Tournament #1597684053, $13.50+$1.50 USD=
 Hold'em No Limit - Level XV (500/1000) - 2017/05/06 16:07:51 ET
Table '1597684053 5' 6-max Seat #3 is the button
Seat 2: VinnieB118 (96190 in chips)=20
Seat 3: rbonessss333 (96916 in chips)=20
Seat 4: Bsgwolfpack4 (12346 in chips)=20
Seat 5: Ninja Stax (15953 in chips)=20
Seat 6: JJin91 (48642 in chips)=20
VinnieB118: posts the ante 125
rbonessss333: posts the ante 125
Bsgwolfpack4: posts the ante 125
Ninja Stax: posts the ante 125
JJin91: posts the ante 125
Bsgwolfpack4: posts small blind 500
Ninja Stax: posts big blind 1000
*** HOLE CARDS ***
Dealt to JJin91 [Ac Ks]
JJin91: raises 1190 to 2190
VinnieB118: folds=20
rbonessss333: folds=20
Bsgwolfpack4: folds=20
Ninja Stax: calls 1190
*** FLOP *** [4d Jd 4c]
Ninja Stax: checks=20
JJin91: checks=20
*** TURN *** [4d Jd 4c] [2c]
Ninja Stax: bets 2000
JJin91: raises 44327 to 46327 and is all-in
Ninja Stax: folds=20
Uncalled bet (44327) returned to JJin91
JJin91 collected 9505 from pot
JJin91: doesn't show hand=20
*** SUMMARY ***
Total pot 9505 | Rake 0=20
Board [4d Jd 4c 2c]
Seat 2: VinnieB118 folded before Flop (didn't bet)
Seat 3: rbonessss333 (button) folded before Flop (didn't bet)
Seat 4: Bsgwolfpack4 (small blind) folded before Flop
Seat 5: Ninja Stax (big blind) folded on the Turn
Seat 6: JJin91 collected (9505)


*********** # 229 **************
PokerStars Hand #169476266274: Tournament #1597684053, $13.50+$1.50 USD=
 Hold'em No Limit - Level XV (500/1000) - 2017/05/06 16:08:40 ET
Table '1597684053 5' 6-max Seat #4 is the button
Seat 2: VinnieB118 (96065 in chips)=20
Seat 3: rbonessss333 (96791 in chips)=20
Seat 4: Bsgwolfpack4 (11721 in chips)=20
Seat 5: Ninja Stax (11638 in chips)=20
Seat 6: JJin91 (53832 in chips)=20
VinnieB118: posts the ante 125
rbonessss333: posts the ante 125
Bsgwolfpack4: posts the ante 125
Ninja Stax: posts the ante 125
JJin91: posts the ante 125
Ninja Stax: posts small blind 500
JJin91: posts big blind 1000
*** HOLE CARDS ***
Dealt to JJin91 [Qd Js]
VinnieB118: raises 4000 to 5000
rbonessss333: folds=20
Bsgwolfpack4: folds=20
Ninja Stax: folds=20
JJin91: folds=20
Uncalled bet (4000) returned to VinnieB118
VinnieB118 collected 3125 from pot
VinnieB118: doesn't show hand=20
*** SUMMARY ***
Total pot 3125 | Rake 0=20
Seat 2: VinnieB118 collected (3125)
Seat 3: rbonessss333 folded before Flop (didn't bet)
Seat 4: Bsgwolfpack4 (button) folded before Flop (didn't bet)
Seat 5: Ninja Stax (small blind) folded before Flop
Seat 6: JJin91 (big blind) folded before Flop


*********** # 230 **************
PokerStars Hand #169476266320: Tournament #1597684053, $13.50+$1.50 USD=
 Hold'em No Limit - Level XV (500/1000) - 2017/05/06 16:08:55 ET
Table '1597684053 5' 6-max Seat #5 is the button
Seat 2: VinnieB118 (98065 in chips)=20
Seat 3: rbonessss333 (96666 in chips)=20
Seat 4: Bsgwolfpack4 (11596 in chips)=20
Seat 5: Ninja Stax (11013 in chips)=20
Seat 6: JJin91 (52707 in chips)=20
VinnieB118: posts the ante 125
rbonessss333: posts the ante 125
Bsgwolfpack4: posts the ante 125
Ninja Stax: posts the ante 125
JJin91: posts the ante 125
JJin91: posts small blind 500
VinnieB118: posts big blind 1000
*** HOLE CARDS ***
Dealt to JJin91 [Ac 6c]
rbonessss333: folds=20
Bsgwolfpack4: folds=20
Ninja Stax: folds=20
JJin91: raises 1190 to 2190
VinnieB118: folds=20
Uncalled bet (1190) returned to JJin91
JJin91 collected 2625 from pot
JJin91: doesn't show hand=20
*** SUMMARY ***
Total pot 2625 | Rake 0=20
Seat 2: VinnieB118 (big blind) folded before Flop
Seat 3: rbonessss333 folded before Flop (didn't bet)
Seat 4: Bsgwolfpack4 folded before Flop (didn't bet)
Seat 5: Ninja Stax (button) folded before Flop (didn't bet)
Seat 6: JJin91 (small blind) collected (2625)


*********** # 231 **************
PokerStars Hand #169476266394: Tournament #1597684053, $13.50+$1.50 USD=
 Hold'em No Limit - Level XV (500/1000) - 2017/05/06 16:09:15 ET
Table '1597684053 5' 6-max Seat #6 is the button
Seat 2: VinnieB118 (96940 in chips)=20
Seat 3: rbonessss333 (96541 in chips)=20
Seat 4: Bsgwolfpack4 (11471 in chips)=20
Seat 5: Ninja Stax (10888 in chips)=20
Seat 6: JJin91 (54207 in chips)=20
VinnieB118: posts the ante 125
rbonessss333: posts the ante 125
Bsgwolfpack4: posts the ante 125
Ninja Stax: posts the ante 125
JJin91: posts the ante 125
VinnieB118: posts small blind 500
rbonessss333: posts big blind 1000
*** HOLE CARDS ***
Dealt to JJin91 [5h 5d]
Bsgwolfpack4: folds=20
Ninja Stax: folds=20
JJin91: calls 1000
VinnieB118: calls 500
rbonessss333: raises 2000 to 3000
JJin91: calls 2000
VinnieB118: folds=20
*** FLOP *** [Tc 7c Qd]
rbonessss333: bets 7625
JJin91: folds=20
Uncalled bet (7625) returned to rbonessss333
rbonessss333 collected 7625 from pot
*** SUMMARY ***
Total pot 7625 | Rake 0=20
Board [Tc 7c Qd]
Seat 2: VinnieB118 (small blind) folded before Flop
Seat 3: rbonessss333 (big blind) collected (7625)
Seat 4: Bsgwolfpack4 folded before Flop (didn't bet)
Seat 5: Ninja Stax folded before Flop (didn't bet)
Seat 6: JJin91 (button) folded on the Flop


*********** # 232 **************
PokerStars Hand #169476266519: Tournament #1597684053, $13.50+$1.50 USD=
 Hold'em No Limit - Level XV (500/1000) - 2017/05/06 16:09:49 ET
Table '1597684053 5' 6-max Seat #2 is the button
Seat 2: VinnieB118 (95815 in chips)=20
Seat 3: rbonessss333 (101041 in chips)=20
Seat 4: Bsgwolfpack4 (11346 in chips)=20
Seat 5: Ninja Stax (10763 in chips)=20
Seat 6: JJin91 (51082 in chips)=20
VinnieB118: posts the ante 125
rbonessss333: posts the ante 125
Bsgwolfpack4: posts the ante 125
Ninja Stax: posts the ante 125
JJin91: posts the ante 125
rbonessss333: posts small blind 500
Bsgwolfpack4: posts big blind 1000
*** HOLE CARDS ***
Dealt to JJin91 [Th Jc]
Ninja Stax: folds=20
JJin91: folds=20
VinnieB118: raises 2000 to 3000
rbonessss333: folds=20
Bsgwolfpack4: folds=20
Uncalled bet (2000) returned to VinnieB118
VinnieB118 collected 3125 from pot
VinnieB118: doesn't show hand=20
*** SUMMARY ***
Total pot 3125 | Rake 0=20
Seat 2: VinnieB118 (button) collected (3125)
Seat 3: rbonessss333 (small blind) folded before Flop
Seat 4: Bsgwolfpack4 (big blind) folded before Flop
Seat 5: Ninja Stax folded before Flop (didn't bet)
Seat 6: JJin91 folded before Flop (didn't bet)


*********** # 233 **************
PokerStars Hand #169476266622: Tournament #1597684053, $13.50+$1.50 USD=
 Hold'em No Limit - Level XV (500/1000) - 2017/05/06 16:10:15 ET
Table '1597684053 5' 6-max Seat #3 is the button
Seat 2: VinnieB118 (97815 in chips)=20
Seat 3: rbonessss333 (100416 in chips)=20
Seat 4: Bsgwolfpack4 (10221 in chips)=20
Seat 5: Ninja Stax (10638 in chips)=20
Seat 6: JJin91 (50957 in chips)=20
VinnieB118: posts the ante 125
rbonessss333: posts the ante 125
Bsgwolfpack4: posts the ante 125
Ninja Stax: posts the ante 125
JJin91: posts the ante 125
Bsgwolfpack4: posts small blind 500
Ninja Stax: posts big blind 1000
*** HOLE CARDS ***
Dealt to JJin91 [Jd Jh]
JJin91: raises 1190 to 2190
VinnieB118: folds=20
rbonessss333: folds=20
Bsgwolfpack4: folds=20
Ninja Stax: folds=20
Uncalled bet (1190) returned to JJin91
JJin91 collected 3125 from pot
JJin91: doesn't show hand=20
*** SUMMARY ***
Total pot 3125 | Rake 0=20
Seat 2: VinnieB118 folded before Flop (didn't bet)
Seat 3: rbonessss333 (button) folded before Flop (didn't bet)
Seat 4: Bsgwolfpack4 (small blind) folded before Flop
Seat 5: Ninja Stax (big blind) folded before Flop
Seat 6: JJin91 collected (3125)


*********** # 234 **************
PokerStars Hand #169476266711: Tournament #1597684053, $13.50+$1.50 USD=
 Hold'em No Limit - Level XV (500/1000) - 2017/05/06 16:10:38 ET
Table '1597684053 5' 6-max Seat #4 is the button
Seat 2: VinnieB118 (97690 in chips)=20
Seat 3: rbonessss333 (100291 in chips)=20
Seat 4: Bsgwolfpack4 (9596 in chips)=20
Seat 5: Ninja Stax (9513 in chips)=20
Seat 6: JJin91 (52957 in chips)=20
VinnieB118: posts the ante 125
rbonessss333: posts the ante 125
Bsgwolfpack4: posts the ante 125
Ninja Stax: posts the ante 125
JJin91: posts the ante 125
Ninja Stax: posts small blind 500
JJin91: posts big blind 1000
*** HOLE CARDS ***
Dealt to JJin91 [6d 3s]
VinnieB118: folds=20
rbonessss333: folds=20
Bsgwolfpack4: folds=20
Ninja Stax: raises 8388 to 9388 and is all-in
JJin91: folds=20
Uncalled bet (8388) returned to Ninja Stax
Ninja Stax collected 2625 from pot
Ninja Stax: doesn't show hand=20
*** SUMMARY ***
Total pot 2625 | Rake 0=20
Seat 2: VinnieB118 folded before Flop (didn't bet)
Seat 3: rbonessss333 folded before Flop (didn't bet)
Seat 4: Bsgwolfpack4 (button) folded before Flop (didn't bet)
Seat 5: Ninja Stax (small blind) collected (2625)
Seat 6: JJin91 (big blind) folded before Flop


*********** # 235 **************
PokerStars Hand #169476266782: Tournament #1597684053, $13.50+$1.50 USD=
 Hold'em No Limit - Level XV (500/1000) - 2017/05/06 16:10:54 ET
Table '1597684053 5' 6-max Seat #5 is the button
Seat 2: VinnieB118 (97565 in chips)=20
Seat 3: rbonessss333 (100166 in chips)=20
Seat 4: Bsgwolfpack4 (9471 in chips)=20
Seat 5: Ninja Stax (11013 in chips)=20
Seat 6: JJin91 (51832 in chips)=20
VinnieB118: posts the ante 125
rbonessss333: posts the ante 125
Bsgwolfpack4: posts the ante 125
Ninja Stax: posts the ante 125
JJin91: posts the ante 125
JJin91: posts small blind 500
VinnieB118: posts big blind 1000
*** HOLE CARDS ***
Dealt to JJin91 [Ts 3s]
rbonessss333: raises 2000 to 3000
Bsgwolfpack4: folds=20
Ninja Stax: folds=20
JJin91: folds=20
VinnieB118: folds=20
Uncalled bet (2000) returned to rbonessss333
rbonessss333 collected 3125 from pot
*** SUMMARY ***
Total pot 3125 | Rake 0=20
Seat 2: VinnieB118 (big blind) folded before Flop
Seat 3: rbonessss333 collected (3125)
Seat 4: Bsgwolfpack4 folded before Flop (didn't bet)
Seat 5: Ninja Stax (button) folded before Flop (didn't bet)
Seat 6: JJin91 (small blind) folded before Flop


*********** # 236 **************
PokerStars Hand #169476266828: Tournament #1597684053, $13.50+$1.50 USD=
 Hold'em No Limit - Level XV (500/1000) - 2017/05/06 16:11:06 ET
Table '1597684053 5' 6-max Seat #6 is the button
Seat 2: VinnieB118 (96440 in chips)=20
Seat 3: rbonessss333 (102166 in chips)=20
Seat 4: Bsgwolfpack4 (9346 in chips)=20
Seat 5: Ninja Stax (10888 in chips)=20
Seat 6: JJin91 (51207 in chips)=20
VinnieB118: posts the ante 125
rbonessss333: posts the ante 125
Bsgwolfpack4: posts the ante 125
Ninja Stax: posts the ante 125
JJin91: posts the ante 125
VinnieB118: posts small blind 500
rbonessss333: posts big blind 1000
*** HOLE CARDS ***
Dealt to JJin91 [5c Qs]
Bsgwolfpack4: folds=20
Ninja Stax: calls 1000
JJin91: folds=20
VinnieB118: folds=20
rbonessss333: checks=20
*** FLOP *** [4s 7s 3s]
rbonessss333: bets 1000
Ninja Stax: folds=20
Uncalled bet (1000) returned to rbonessss333
rbonessss333 collected 3125 from pot
*** SUMMARY ***
Total pot 3125 | Rake 0=20
Board [4s 7s 3s]
Seat 2: VinnieB118 (small blind) folded before Flop
Seat 3: rbonessss333 (big blind) collected (3125)
Seat 4: Bsgwolfpack4 folded before Flop (didn't bet)
Seat 5: Ninja Stax folded on the Flop
Seat 6: JJin91 (button) folded before Flop (didn't bet)


*********** # 237 **************
PokerStars Hand #169476266941: Tournament #1597684053, $13.50+$1.50 USD=
 Hold'em No Limit - Level XV (500/1000) - 2017/05/06 16:11:43 ET
Table '1597684053 5' 6-max Seat #2 is the button
Seat 2: VinnieB118 (95815 in chips)=20
Seat 3: rbonessss333 (104166 in chips)=20
Seat 4: Bsgwolfpack4 (9221 in chips)=20
Seat 5: Ninja Stax (9763 in chips)=20
Seat 6: JJin91 (51082 in chips)=20
VinnieB118: posts the ante 125
rbonessss333: posts the ante 125
Bsgwolfpack4: posts the ante 125
Ninja Stax: posts the ante 125
JJin91: posts the ante 125
rbonessss333: posts small blind 500
Bsgwolfpack4: posts big blind 1000
*** HOLE CARDS ***
Dealt to JJin91 [6c 6d]
Ninja Stax: folds=20
JJin91: raises 1190 to 2190
VinnieB118: folds=20
rbonessss333: folds=20
Bsgwolfpack4: calls 1190
*** FLOP *** [9c 4d 7h]
Bsgwolfpack4: checks=20
JJin91: checks=20
*** TURN *** [9c 4d 7h] [3c]
Bsgwolfpack4: bets 6906 and is all-in
JJin91: calls 6906
*** RIVER *** [9c 4d 7h 3c] [7c]
*** SHOW DOWN ***
Bsgwolfpack4: shows [Kc 8c] (a flush, King high)
JJin91: shows [6c 6d] (two pair, Sevens and Sixes)
Bsgwolfpack4 collected 19317 from pot
*** SUMMARY ***
Total pot 19317 | Rake 0=20
Board [9c 4d 7h 3c 7c]
Seat 2: VinnieB118 (button) folded before Flop (didn't bet)
Seat 3: rbonessss333 (small blind) folded before Flop
Seat 4: Bsgwolfpack4 (big blind) showed [Kc 8c] and won (19317) with a =
flush, King high
Seat 5: Ninja Stax folded before Flop (didn't bet)
Seat 6: JJin91 showed [6c 6d] and lost with two pair, Sevens and Sixes


*********** # 238 **************
PokerStars Hand #169476267068: Tournament #1597684053, $13.50+$1.50 USD=
 Hold'em No Limit - Level XV (500/1000) - 2017/05/06 16:12:21 ET
Table '1597684053 5' 6-max Seat #3 is the button
Seat 2: VinnieB118 (95690 in chips)=20
Seat 3: rbonessss333 (103541 in chips)=20
Seat 4: Bsgwolfpack4 (19317 in chips)=20
Seat 5: Ninja Stax (9638 in chips)=20
Seat 6: JJin91 (41861 in chips)=20
VinnieB118: posts the ante 125
rbonessss333: posts the ante 125
Bsgwolfpack4: posts the ante 125
Ninja Stax: posts the ante 125
JJin91: posts the ante 125
Bsgwolfpack4: posts small blind 500
Ninja Stax: posts big blind 1000
*** HOLE CARDS ***
Dealt to JJin91 [2d 4d]
JJin91: folds=20
VinnieB118: folds=20
rbonessss333: folds=20
Bsgwolfpack4: folds=20
Uncalled bet (500) returned to Ninja Stax
Ninja Stax collected 1625 from pot
Ninja Stax: doesn't show hand=20
*** SUMMARY ***
Total pot 1625 | Rake 0=20
Seat 2: VinnieB118 folded before Flop (didn't bet)
Seat 3: rbonessss333 (button) folded before Flop (didn't bet)
Seat 4: Bsgwolfpack4 (small blind) folded before Flop
Seat 5: Ninja Stax (big blind) collected (1625)
Seat 6: JJin91 folded before Flop (didn't bet)


*********** # 239 **************
PokerStars Hand #169476267114: Tournament #1597684053, $13.50+$1.50 USD=
 Hold'em No Limit - Level XV (500/1000) - 2017/05/06 16:12:32 ET
Table '1597684053 5' 6-max Seat #4 is the button
Seat 2: VinnieB118 (95565 in chips)=20
Seat 3: rbonessss333 (103416 in chips)=20
Seat 4: Bsgwolfpack4 (18692 in chips)=20
Seat 5: Ninja Stax (10638 in chips)=20
Seat 6: JJin91 (41736 in chips)=20
VinnieB118: posts the ante 125
rbonessss333: posts the ante 125
Bsgwolfpack4: posts the ante 125
Ninja Stax: posts the ante 125
JJin91: posts the ante 125
Ninja Stax: posts small blind 500
JJin91: posts big blind 1000
*** HOLE CARDS ***
Dealt to JJin91 [6s Ah]
VinnieB118: folds=20
rbonessss333: folds=20
Bsgwolfpack4: raises 2000 to 3000
Ninja Stax: folds=20
JJin91: folds=20
Uncalled bet (2000) returned to Bsgwolfpack4
Bsgwolfpack4 collected 3125 from pot
Bsgwolfpack4: doesn't show hand=20
*** SUMMARY ***
Total pot 3125 | Rake 0=20
Seat 2: VinnieB118 folded before Flop (didn't bet)
Seat 3: rbonessss333 folded before Flop (didn't bet)
Seat 4: Bsgwolfpack4 (button) collected (3125)
Seat 5: Ninja Stax (small blind) folded before Flop
Seat 6: JJin91 (big blind) folded before Flop


*********** # 240 **************
PokerStars Hand #169476267157: Tournament #1597684053, $13.50+$1.50 USD=
 Hold'em No Limit - Level XV (500/1000) - 2017/05/06 16:12:43 ET
Table '1597684053 5' 6-max Seat #5 is the button
Seat 2: VinnieB118 (95440 in chips)=20
Seat 3: rbonessss333 (103291 in chips)=20
Seat 4: Bsgwolfpack4 (20692 in chips)=20
Seat 5: Ninja Stax (10013 in chips)=20
Seat 6: JJin91 (40611 in chips)=20
VinnieB118: posts the ante 125
rbonessss333: posts the ante 125
Bsgwolfpack4: posts the ante 125
Ninja Stax: posts the ante 125
JJin91: posts the ante 125
JJin91: posts small blind 500
VinnieB118: posts big blind 1000
*** HOLE CARDS ***
Dealt to JJin91 [3c Qc]
rbonessss333: folds=20
Bsgwolfpack4: folds=20
Ninja Stax: folds=20
JJin91: calls 500
VinnieB118: checks=20
*** FLOP *** [7d Th 3h]
JJin91: checks=20
VinnieB118: checks=20
*** TURN *** [7d Th 3h] [Kd]
JJin91: bets 2625
VinnieB118: raises 4625 to 7250
JJin91: folds=20
Uncalled bet (4625) returned to VinnieB118
VinnieB118 collected 7875 from pot
VinnieB118: doesn't show hand=20
*** SUMMARY ***
Total pot 7875 | Rake 0=20
Board [7d Th 3h Kd]
Seat 2: VinnieB118 (big blind) collected (7875)
Seat 3: rbonessss333 folded before Flop (didn't bet)
Seat 4: Bsgwolfpack4 folded before Flop (didn't bet)
Seat 5: Ninja Stax (button) folded before Flop (didn't bet)
Seat 6: JJin91 (small blind) folded on the Turn


*********** # 241 **************
PokerStars Hand #169476267311: Tournament #1597684053, $13.50+$1.50 USD=
 Hold'em No Limit - Level XV (500/1000) - 2017/05/06 16:13:32 ET
Table '1597684053 5' 6-max Seat #6 is the button
Seat 2: VinnieB118 (99565 in chips)=20
Seat 3: rbonessss333 (103166 in chips)=20
Seat 4: Bsgwolfpack4 (20567 in chips)=20
Seat 5: Ninja Stax (9888 in chips)=20
Seat 6: JJin91 (36861 in chips)=20
VinnieB118: posts the ante 125
rbonessss333: posts the ante 125
Bsgwolfpack4: posts the ante 125
Ninja Stax: posts the ante 125
JJin91: posts the ante 125
VinnieB118: posts small blind 500
rbonessss333: posts big blind 1000
*** HOLE CARDS ***
Dealt to JJin91 [6c 8s]
Bsgwolfpack4: raises 2000 to 3000
Ninja Stax: folds=20
JJin91: folds=20
VinnieB118: folds=20
rbonessss333: folds=20
Uncalled bet (2000) returned to Bsgwolfpack4
Bsgwolfpack4 collected 3125 from pot
Bsgwolfpack4: doesn't show hand=20
*** SUMMARY ***
Total pot 3125 | Rake 0=20
Seat 2: VinnieB118 (small blind) folded before Flop
Seat 3: rbonessss333 (big blind) folded before Flop
Seat 4: Bsgwolfpack4 collected (3125)
Seat 5: Ninja Stax folded before Flop (didn't bet)
Seat 6: JJin91 (button) folded before Flop (didn't bet)


*********** # 242 **************
PokerStars Hand #169476267372: Tournament #1597684053, $13.50+$1.50 USD=
 Hold'em No Limit - Level XV (500/1000) - 2017/05/06 16:13:53 ET
Table '1597684053 5' 6-max Seat #2 is the button
Seat 2: VinnieB118 (98940 in chips)=20
Seat 3: rbonessss333 (102041 in chips)=20
Seat 4: Bsgwolfpack4 (22567 in chips)=20
Seat 5: Ninja Stax (9763 in chips)=20
Seat 6: JJin91 (36736 in chips)=20
VinnieB118: posts the ante 125
rbonessss333: posts the ante 125
Bsgwolfpack4: posts the ante 125
Ninja Stax: posts the ante 125
JJin91: posts the ante 125
rbonessss333: posts small blind 500
Bsgwolfpack4: posts big blind 1000
*** HOLE CARDS ***
Dealt to JJin91 [Ac Jd]
Ninja Stax has timed out
Ninja Stax: folds=20
Ninja Stax is sitting out
Ninja Stax has returned
JJin91: raises 1190 to 2190
VinnieB118: folds=20
rbonessss333: folds=20
Bsgwolfpack4: folds=20
Uncalled bet (1190) returned to JJin91
JJin91 collected 3125 from pot
JJin91: doesn't show hand=20
*** SUMMARY ***
Total pot 3125 | Rake 0=20
Seat 2: VinnieB118 (button) folded before Flop (didn't bet)
Seat 3: rbonessss333 (small blind) folded before Flop
Seat 4: Bsgwolfpack4 (big blind) folded before Flop
Seat 5: Ninja Stax folded before Flop (didn't bet)
Seat 6: JJin91 collected (3125)


*********** # 243 **************
PokerStars Hand #169476267495: Tournament #1597684053, $13.50+$1.50 USD=
 Hold'em No Limit - Level XV (500/1000) - 2017/05/06 16:14:24 ET
Table '1597684053 5' 6-max Seat #3 is the button
Seat 2: VinnieB118 (98815 in chips)=20
Seat 3: rbonessss333 (101416 in chips)=20
Seat 4: Bsgwolfpack4 (21442 in chips)=20
Seat 5: Ninja Stax (9638 in chips)=20
Seat 6: JJin91 (38736 in chips)=20
VinnieB118: posts the ante 125
rbonessss333: posts the ante 125
Bsgwolfpack4: posts the ante 125
Ninja Stax: posts the ante 125
JJin91: posts the ante 125
Bsgwolfpack4: posts small blind 500
Ninja Stax: posts big blind 1000
*** HOLE CARDS ***
Dealt to JJin91 [6h 3s]
JJin91: folds=20
VinnieB118: folds=20
rbonessss333: folds=20
Bsgwolfpack4: raises 2000 to 3000
Ninja Stax: calls 2000
*** FLOP *** [Ah 9h 2d]
Bsgwolfpack4: bets 3975
Ninja Stax: folds=20
Uncalled bet (3975) returned to Bsgwolfpack4
Bsgwolfpack4 collected 6625 from pot
Bsgwolfpack4: doesn't show hand=20
*** SUMMARY ***
Total pot 6625 | Rake 0=20
Board [Ah 9h 2d]
Seat 2: VinnieB118 folded before Flop (didn't bet)
Seat 3: rbonessss333 (button) folded before Flop (didn't bet)
Seat 4: Bsgwolfpack4 (small blind) collected (6625)
Seat 5: Ninja Stax (big blind) folded on the Flop
Seat 6: JJin91 folded before Flop (didn't bet)


*********** # 244 **************
PokerStars Hand #169476267672: Tournament #1597684053, $13.50+$1.50 USD=
 Hold'em No Limit - Level XV (500/1000) - 2017/05/06 16:15:11 ET
Table '1597684053 5' 6-max Seat #4 is the button
Seat 2: VinnieB118 (98690 in chips)=20
Seat 3: rbonessss333 (101291 in chips)=20
Seat 4: Bsgwolfpack4 (24942 in chips)=20
Seat 5: Ninja Stax (6513 in chips)=20
Seat 6: JJin91 (38611 in chips)=20
VinnieB118: posts the ante 125
rbonessss333: posts the ante 125
Bsgwolfpack4: posts the ante 125
Ninja Stax: posts the ante 125
JJin91: posts the ante 125
Ninja Stax: posts small blind 500
JJin91: posts big blind 1000
*** HOLE CARDS ***
Dealt to JJin91 [2s 9d]
VinnieB118: raises 3000 to 4000
rbonessss333: calls 4000
Bsgwolfpack4: folds=20
Ninja Stax: raises 2388 to 6388 and is all-in
JJin91: folds=20
VinnieB118: calls 2388
rbonessss333: calls 2388
*** FLOP *** [3c Ac 8d]
VinnieB118: checks=20
rbonessss333: checks=20
*** TURN *** [3c Ac 8d] [Kh]
VinnieB118: checks=20
rbonessss333: checks=20
*** RIVER *** [3c Ac 8d Kh] [7h]
VinnieB118: checks=20
rbonessss333: checks=20
*** SHOW DOWN ***
Ninja Stax: shows [7s Ts] (a pair of Sevens)
VinnieB118: shows [Qs Qc] (a pair of Queens)
rbonessss333: mucks hand=20
VinnieB118 collected 20789 from pot
Ninja Stax finished the tournament in 20th place
*** SUMMARY ***
Total pot 20789 | Rake 0=20
Board [3c Ac 8d Kh 7h]
Seat 2: VinnieB118 showed [Qs Qc] and won (20789) with a pair of Queens
Seat 3: rbonessss333 mucked [6h 6d]
Seat 4: Bsgwolfpack4 (button) folded before Flop (didn't bet)
Seat 5: Ninja Stax (small blind) showed [7s Ts] and lost with a pair of=
 Sevens
Seat 6: JJin91 (big blind) folded before Flop


*********** # 245 **************
PokerStars Hand #169476267806: Tournament #1597684053, $13.50+$1.50 USD=
 Hold'em No Limit - Level XV (500/1000) - 2017/05/06 16:15:47 ET
Table '1597684053 5' 6-max Seat #6 is the button
Seat 2: VinnieB118 (112966 in chips)=20
Seat 3: rbonessss333 (94778 in chips)=20
Seat 4: Bsgwolfpack4 (24817 in chips)=20
Seat 6: JJin91 (37486 in chips)=20
VinnieB118: posts the ante 125
rbonessss333: posts the ante 125
Bsgwolfpack4: posts the ante 125
JJin91: posts the ante 125
VinnieB118: posts small blind 500
rbonessss333: posts big blind 1000
*** HOLE CARDS ***
Dealt to JJin91 [As 6c]
Bsgwolfpack4: folds=20
JJin91: raises 1190 to 2190
VinnieB118: folds=20
rbonessss333: folds=20
Uncalled bet (1190) returned to JJin91
JJin91 collected 3000 from pot
JJin91: doesn't show hand=20
*** SUMMARY ***
Total pot 3000 | Rake 0=20
Seat 2: VinnieB118 (small blind) folded before Flop
Seat 3: rbonessss333 (big blind) folded before Flop
Seat 4: Bsgwolfpack4 folded before Flop (didn't bet)
Seat 6: JJin91 (button) collected (3000)


*********** # 246 **************
PokerStars Hand #169476267941: Tournament #1597684053, $13.50+$1.50 USD=
 Hold'em No Limit - Level XV (500/1000) - 2017/05/06 16:16:21 ET
Table '1597684053 5' 6-max Seat #2 is the button
Seat 1: D_Rannn22 (65749 in chips)=20
Seat 2: VinnieB118 (112341 in chips)=20
Seat 3: rbonessss333 (93653 in chips)=20
Seat 4: Bsgwolfpack4 (24692 in chips)=20
Seat 5: CHIEFKILLER4 (86745 in chips)=20
Seat 6: JJin91 (39361 in chips)=20
D_Rannn22: posts the ante 125
VinnieB118: posts the ante 125
rbonessss333: posts the ante 125
Bsgwolfpack4: posts the ante 125
CHIEFKILLER4: posts the ante 125
JJin91: posts the ante 125
rbonessss333: posts small blind 500
Bsgwolfpack4: posts big blind 1000
*** HOLE CARDS ***
Dealt to JJin91 [6c Td]
CHIEFKILLER4: raises 1000 to 2000
JJin91: folds=20
D_Rannn22: folds=20
VinnieB118: raises 1000 to 3000
rbonessss333: folds=20
Bsgwolfpack4: folds=20
CHIEFKILLER4: calls 1000
*** FLOP *** [7d 4s 5s]
CHIEFKILLER4: checks=20
VinnieB118: bets 2000
CHIEFKILLER4: calls 2000
*** TURN *** [7d 4s 5s] [5h]
CHIEFKILLER4: checks=20
VinnieB118: bets 1000
CHIEFKILLER4: calls 1000
*** RIVER *** [7d 4s 5s 5h] [Kc]
CHIEFKILLER4: checks=20
VinnieB118: checks=20
*** SHOW DOWN ***
CHIEFKILLER4: shows [8d Ad] (a pair of Fives)
VinnieB118: shows [3s 3c] (two pair, Fives and Threes)
VinnieB118 collected 14250 from pot
*** SUMMARY ***
Total pot 14250 | Rake 0=20
Board [7d 4s 5s 5h Kc]
Seat 1: D_Rannn22 folded before Flop (didn't bet)
Seat 2: VinnieB118 (button) showed [3s 3c] and won (14250) with two pai=
r, Fives and Threes
Seat 3: rbonessss333 (small blind) folded before Flop
Seat 4: Bsgwolfpack4 (big blind) folded before Flop
Seat 5: CHIEFKILLER4 showed [8d Ad] and lost with a pair of Fives
Seat 6: JJin91 folded before Flop (didn't bet)


*********** # 247 **************
PokerStars Hand #169476268126: Tournament #1597684053, $13.50+$1.50 USD=
 Hold'em No Limit - Level XVI (600/1200) - 2017/05/06 16:17:17 ET
Table '1597684053 5' 6-max Seat #3 is the button
Seat 1: D_Rannn22 (65624 in chips)=20
Seat 2: VinnieB118 (120466 in chips)=20
Seat 3: rbonessss333 (93028 in chips)=20
Seat 4: Bsgwolfpack4 (23567 in chips)=20
Seat 5: CHIEFKILLER4 (80620 in chips)=20
Seat 6: JJin91 (39236 in chips)=20
D_Rannn22: posts the ante 150
VinnieB118: posts the ante 150
rbonessss333: posts the ante 150
Bsgwolfpack4: posts the ante 150
CHIEFKILLER4: posts the ante 150
JJin91: posts the ante 150
Bsgwolfpack4: posts small blind 600
CHIEFKILLER4: posts big blind 1200
*** HOLE CARDS ***
Dealt to JJin91 [8s 6c]
JJin91: folds=20
D_Rannn22: folds=20
VinnieB118: folds=20
rbonessss333: folds=20
Bsgwolfpack4: calls 600
CHIEFKILLER4: checks=20
*** FLOP *** [2s 9d Ks]
Bsgwolfpack4: bets 1980
CHIEFKILLER4: folds=20
Uncalled bet (1980) returned to Bsgwolfpack4
Bsgwolfpack4 collected 3300 from pot
Bsgwolfpack4: doesn't show hand=20
*** SUMMARY ***
Total pot 3300 | Rake 0=20
Board [2s 9d Ks]
Seat 1: D_Rannn22 folded before Flop (didn't bet)
Seat 2: VinnieB118 folded before Flop (didn't bet)
Seat 3: rbonessss333 (button) folded before Flop (didn't bet)
Seat 4: Bsgwolfpack4 (small blind) collected (3300)
Seat 5: CHIEFKILLER4 (big blind) folded on the Flop
Seat 6: JJin91 folded before Flop (didn't bet)


*********** # 248 **************
PokerStars Hand #169476268212: Tournament #1597684053, $13.50+$1.50 USD=
 Hold'em No Limit - Level XVI (600/1200) - 2017/05/06 16:17:44 ET
Table '1597684053 5' 6-max Seat #4 is the button
Seat 1: D_Rannn22 (65474 in chips)=20
Seat 2: VinnieB118 (120316 in chips)=20
Seat 3: rbonessss333 (92878 in chips)=20
Seat 4: Bsgwolfpack4 (25517 in chips)=20
Seat 5: CHIEFKILLER4 (79270 in chips)=20
Seat 6: JJin91 (39086 in chips)=20
D_Rannn22: posts the ante 150
VinnieB118: posts the ante 150
rbonessss333: posts the ante 150
Bsgwolfpack4: posts the ante 150
CHIEFKILLER4: posts the ante 150
JJin91: posts the ante 150
CHIEFKILLER4: posts small blind 600
JJin91: posts big blind 1200
*** HOLE CARDS ***
Dealt to JJin91 [4s 7h]
D_Rannn22: folds=20
VinnieB118: folds=20
rbonessss333: calls 1200
Bsgwolfpack4: folds=20
CHIEFKILLER4: raises 3600 to 4800
JJin91: folds=20
rbonessss333: folds=20
Uncalled bet (3600) returned to CHIEFKILLER4
CHIEFKILLER4 collected 4500 from pot
*** SUMMARY ***
Total pot 4500 | Rake 0=20
Seat 1: D_Rannn22 folded before Flop (didn't bet)
Seat 2: VinnieB118 folded before Flop (didn't bet)
Seat 3: rbonessss333 folded before Flop
Seat 4: Bsgwolfpack4 (button) folded before Flop (didn't bet)
Seat 5: CHIEFKILLER4 (small blind) collected (4500)
Seat 6: JJin91 (big blind) folded before Flop


*********** # 249 **************
PokerStars Hand #169476268316: Tournament #1597684053, $13.50+$1.50 USD=
 Hold'em No Limit - Level XVI (600/1200) - 2017/05/06 16:18:17 ET
Table '1597684053 5' 6-max Seat #5 is the button
Seat 1: D_Rannn22 (65324 in chips)=20
Seat 2: VinnieB118 (120166 in chips)=20
Seat 3: rbonessss333 (91528 in chips)=20
Seat 4: Bsgwolfpack4 (25367 in chips)=20
Seat 5: CHIEFKILLER4 (82420 in chips)=20
Seat 6: JJin91 (37736 in chips)=20
D_Rannn22: posts the ante 150
VinnieB118: posts the ante 150
rbonessss333: posts the ante 150
Bsgwolfpack4: posts the ante 150
CHIEFKILLER4: posts the ante 150
JJin91: posts the ante 150
JJin91: posts small blind 600
D_Rannn22: posts big blind 1200
*** HOLE CARDS ***
Dealt to JJin91 [8h 4c]
VinnieB118: folds=20
rbonessss333: folds=20
Bsgwolfpack4: folds=20
CHIEFKILLER4: raises 1200 to 2400
JJin91: folds=20
D_Rannn22: calls 1200
*** FLOP *** [Ks Jc 2c]
D_Rannn22: checks=20
CHIEFKILLER4: bets 4800
D_Rannn22: folds=20
Uncalled bet (4800) returned to CHIEFKILLER4
CHIEFKILLER4 collected 6300 from pot
*** SUMMARY ***
Total pot 6300 | Rake 0=20
Board [Ks Jc 2c]
Seat 1: D_Rannn22 (big blind) folded on the Flop
Seat 2: VinnieB118 folded before Flop (didn't bet)
Seat 3: rbonessss333 folded before Flop (didn't bet)
Seat 4: Bsgwolfpack4 folded before Flop (didn't bet)
Seat 5: CHIEFKILLER4 (button) collected (6300)
Seat 6: JJin91 (small blind) folded before Flop


*********** # 250 **************
PokerStars Hand #169476268428: Tournament #1597684053, $13.50+$1.50 USD=
 Hold'em No Limit - Level XVI (600/1200) - 2017/05/06 16:18:45 ET
Table '1597684053 5' 6-max Seat #6 is the button
Seat 1: D_Rannn22 (62774 in chips)=20
Seat 2: VinnieB118 (120016 in chips)=20
Seat 3: rbonessss333 (91378 in chips)=20
Seat 4: Bsgwolfpack4 (25217 in chips)=20
Seat 5: CHIEFKILLER4 (86170 in chips)=20
Seat 6: JJin91 (36986 in chips)=20
D_Rannn22: posts the ante 150
VinnieB118: posts the ante 150
rbonessss333: posts the ante 150
Bsgwolfpack4: posts the ante 150
CHIEFKILLER4: posts the ante 150
JJin91: posts the ante 150
D_Rannn22: posts small blind 600
VinnieB118: posts big blind 1200
*** HOLE CARDS ***
Dealt to JJin91 [Jd Qh]
rbonessss333: raises 1200 to 2400
Bsgwolfpack4: folds=20
CHIEFKILLER4: folds=20
JJin91: calls 2400
D_Rannn22: folds=20
VinnieB118: folds=20
*** FLOP *** [3d 6c As]
rbonessss333: checks=20
JJin91: bets 3975
rbonessss333: raises 84853 to 88828 and is all-in
JJin91: folds=20
Uncalled bet (84853) returned to rbonessss333
rbonessss333 collected 15450 from pot
*** SUMMARY ***
Total pot 15450 | Rake 0=20
Board [3d 6c As]
Seat 1: D_Rannn22 (small blind) folded before Flop
Seat 2: VinnieB118 (big blind) folded before Flop
Seat 3: rbonessss333 collected (15450)
Seat 4: Bsgwolfpack4 folded before Flop (didn't bet)
Seat 5: CHIEFKILLER4 folded before Flop (didn't bet)
Seat 6: JJin91 (button) folded on the Flop


*********** # 251 **************
PokerStars Hand #169476268546: Tournament #1597684053, $13.50+$1.50 USD=
 Hold'em No Limit - Level XVI (600/1200) - 2017/05/06 16:19:17 ET
Table '1597684053 5' 6-max Seat #1 is the button
Seat 1: D_Rannn22 (62024 in chips)=20
Seat 2: VinnieB118 (118666 in chips)=20
Seat 3: rbonessss333 (100303 in chips)=20
Seat 4: Bsgwolfpack4 (25067 in chips)=20
Seat 5: CHIEFKILLER4 (86020 in chips)=20
Seat 6: JJin91 (30461 in chips)=20
D_Rannn22: posts the ante 150
VinnieB118: posts the ante 150
rbonessss333: posts the ante 150
Bsgwolfpack4: posts the ante 150
CHIEFKILLER4: posts the ante 150
JJin91: posts the ante 150
VinnieB118: posts small blind 600
rbonessss333: posts big blind 1200
*** HOLE CARDS ***
Dealt to JJin91 [6h 4h]
Bsgwolfpack4: folds=20
CHIEFKILLER4: folds=20
JJin91: folds=20
D_Rannn22: raises 1200 to 2400
VinnieB118: folds=20
rbonessss333: calls 1200
*** FLOP *** [Kc Tc Qc]
rbonessss333: bets 1200
D_Rannn22: calls 1200
*** TURN *** [Kc Tc Qc] [4d]
rbonessss333: checks=20
D_Rannn22: checks=20
*** RIVER *** [Kc Tc Qc 4d] [Js]
rbonessss333: checks=20
D_Rannn22: bets 4350
rbonessss333: folds=20
Uncalled bet (4350) returned to D_Rannn22
D_Rannn22 collected 8700 from pot
D_Rannn22: doesn't show hand=20
*** SUMMARY ***
Total pot 8700 | Rake 0=20
Board [Kc Tc Qc 4d Js]
Seat 1: D_Rannn22 (button) collected (8700)
Seat 2: VinnieB118 (small blind) folded before Flop
Seat 3: rbonessss333 (big blind) folded on the River
Seat 4: Bsgwolfpack4 folded before Flop (didn't bet)
Seat 5: CHIEFKILLER4 folded before Flop (didn't bet)
Seat 6: JJin91 folded before Flop (didn't bet)


*********** # 252 **************
PokerStars Hand #169476268678: Tournament #1597684053, $13.50+$1.50 USD=
 Hold'em No Limit - Level XVI (600/1200) - 2017/05/06 16:19:52 ET
Table '1597684053 5' 6-max Seat #2 is the button
Seat 1: D_Rannn22 (66974 in chips)=20
Seat 2: VinnieB118 (117916 in chips)=20
Seat 3: rbonessss333 (96553 in chips)=20
Seat 4: Bsgwolfpack4 (24917 in chips)=20
Seat 5: CHIEFKILLER4 (85870 in chips)=20
Seat 6: JJin91 (30311 in chips)=20
D_Rannn22: posts the ante 150
VinnieB118: posts the ante 150
rbonessss333: posts the ante 150
Bsgwolfpack4: posts the ante 150
CHIEFKILLER4: posts the ante 150
JJin91: posts the ante 150
rbonessss333: posts small blind 600
Bsgwolfpack4: posts big blind 1200
*** HOLE CARDS ***
Dealt to JJin91 [Jd 7s]
CHIEFKILLER4: folds=20
JJin91: folds=20
D_Rannn22: calls 1200
VinnieB118: folds=20
rbonessss333: calls 600
Bsgwolfpack4: checks=20
*** FLOP *** [Tc 4c 8d]
rbonessss333: checks=20
Bsgwolfpack4: checks=20
D_Rannn22: checks=20
*** TURN *** [Tc 4c 8d] [3h]
rbonessss333: bets 1200
Bsgwolfpack4: calls 1200
D_Rannn22: calls 1200
*** RIVER *** [Tc 4c 8d 3h] [7c]
rbonessss333: checks=20
Bsgwolfpack4: checks=20
D_Rannn22: bets 4000
rbonessss333: folds=20
Bsgwolfpack4: calls 4000
*** SHOW DOWN ***
D_Rannn22: shows [9h Jh] (a straight, Seven to Jack)
Bsgwolfpack4: mucks hand=20
D_Rannn22 collected 16100 from pot
*** SUMMARY ***
Total pot 16100 | Rake 0=20
Board [Tc 4c 8d 3h 7c]
Seat 1: D_Rannn22 showed [9h Jh] and won (16100) with a straight, Seven=
 to Jack
Seat 2: VinnieB118 (button) folded before Flop (didn't bet)
Seat 3: rbonessss333 (small blind) folded on the River
Seat 4: Bsgwolfpack4 (big blind) mucked [5d 6c]
Seat 5: CHIEFKILLER4 folded before Flop (didn't bet)
Seat 6: JJin91 folded before Flop (didn't bet)


*********** # 253 **************
PokerStars Hand #169476268871: Tournament #1597684053, $13.50+$1.50 USD=
 Hold'em No Limit - Level XVI (600/1200) - 2017/05/06 16:20:44 ET
Table '1597684053 5' 6-max Seat #3 is the button
Seat 1: D_Rannn22 (76524 in chips)=20
Seat 2: VinnieB118 (117766 in chips)=20
Seat 3: rbonessss333 (94003 in chips)=20
Seat 4: Bsgwolfpack4 (18367 in chips)=20
Seat 5: CHIEFKILLER4 (85720 in chips)=20
Seat 6: JJin91 (30161 in chips)=20
D_Rannn22: posts the ante 150
VinnieB118: posts the ante 150
rbonessss333: posts the ante 150
Bsgwolfpack4: posts the ante 150
CHIEFKILLER4: posts the ante 150
JJin91: posts the ante 150
Bsgwolfpack4: posts small blind 600
CHIEFKILLER4: posts big blind 1200
*** HOLE CARDS ***
Dealt to JJin91 [8h 9d]
JJin91: folds=20
D_Rannn22: folds=20
VinnieB118: raises 1200 to 2400
rbonessss333: calls 2400
Bsgwolfpack4: raises 15817 to 18217 and is all-in
CHIEFKILLER4: folds=20
VinnieB118: folds=20
rbonessss333: folds=20
Uncalled bet (15817) returned to Bsgwolfpack4
Bsgwolfpack4 collected 9300 from pot
Bsgwolfpack4: doesn't show hand=20
*** SUMMARY ***
Total pot 9300 | Rake 0=20
Seat 1: D_Rannn22 folded before Flop (didn't bet)
Seat 2: VinnieB118 folded before Flop
Seat 3: rbonessss333 (button) folded before Flop
Seat 4: Bsgwolfpack4 (small blind) collected (9300)
Seat 5: CHIEFKILLER4 (big blind) folded before Flop
Seat 6: JJin91 folded before Flop (didn't bet)


*********** # 254 **************
PokerStars Hand #169476269005: Tournament #1597684053, $13.50+$1.50 USD=
 Hold'em No Limit - Level XVI (600/1200) - 2017/05/06 16:21:18 ET
Table '1597684053 5' 6-max Seat #4 is the button
Seat 1: D_Rannn22 (76374 in chips)=20
Seat 2: VinnieB118 (115216 in chips)=20
Seat 3: rbonessss333 (91453 in chips)=20
Seat 4: Bsgwolfpack4 (25117 in chips)=20
Seat 5: CHIEFKILLER4 (84370 in chips)=20
Seat 6: JJin91 (30011 in chips)=20
D_Rannn22: posts the ante 150
VinnieB118: posts the ante 150
rbonessss333: posts the ante 150
Bsgwolfpack4: posts the ante 150
CHIEFKILLER4: posts the ante 150
JJin91: posts the ante 150
CHIEFKILLER4: posts small blind 600
JJin91: posts big blind 1200
*** HOLE CARDS ***
Dealt to JJin91 [9c 4h]
D_Rannn22: folds=20
VinnieB118: folds=20
rbonessss333: raises 3900 to 5100
Bsgwolfpack4: folds=20
CHIEFKILLER4: folds=20
JJin91: folds=20
Uncalled bet (3900) returned to rbonessss333
rbonessss333 collected 3900 from pot
*** SUMMARY ***
Total pot 3900 | Rake 0=20
Seat 1: D_Rannn22 folded before Flop (didn't bet)
Seat 2: VinnieB118 folded before Flop (didn't bet)
Seat 3: rbonessss333 collected (3900)
Seat 4: Bsgwolfpack4 (button) folded before Flop (didn't bet)
Seat 5: CHIEFKILLER4 (small blind) folded before Flop
Seat 6: JJin91 (big blind) folded before Flop


*********** # 255 **************
PokerStars Hand #169476269051: Tournament #1597684053, $13.50+$1.50 USD=
 Hold'em No Limit - Level XVI (600/1200) - 2017/05/06 16:21:33 ET
Table '1597684053 5' 6-max Seat #5 is the button
Seat 1: D_Rannn22 (76224 in chips)=20
Seat 2: VinnieB118 (115066 in chips)=20
Seat 3: rbonessss333 (94003 in chips)=20
Seat 4: Bsgwolfpack4 (24967 in chips)=20
Seat 5: CHIEFKILLER4 (83620 in chips)=20
Seat 6: JJin91 (28661 in chips)=20
D_Rannn22: posts the ante 150
VinnieB118: posts the ante 150
rbonessss333: posts the ante 150
Bsgwolfpack4: posts the ante 150
CHIEFKILLER4: posts the ante 150
JJin91: posts the ante 150
JJin91: posts small blind 600
D_Rannn22: posts big blind 1200
*** HOLE CARDS ***
Dealt to JJin91 [Kc Th]
VinnieB118: folds=20
rbonessss333: folds=20
Bsgwolfpack4: folds=20
CHIEFKILLER4: folds=20
JJin91: raises 27311 to 28511 and is all-in
D_Rannn22: folds=20
Uncalled bet (27311) returned to JJin91
JJin91 collected 3300 from pot
JJin91: doesn't show hand=20
*** SUMMARY ***
Total pot 3300 | Rake 0=20
Seat 1: D_Rannn22 (big blind) folded before Flop
Seat 2: VinnieB118 folded before Flop (didn't bet)
Seat 3: rbonessss333 folded before Flop (didn't bet)
Seat 4: Bsgwolfpack4 folded before Flop (didn't bet)
Seat 5: CHIEFKILLER4 (button) folded before Flop (didn't bet)
Seat 6: JJin91 (small blind) collected (3300)


*********** # 256 **************
PokerStars Hand #169476269115: Tournament #1597684053, $13.50+$1.50 USD=
 Hold'em No Limit - Level XVI (600/1200) - 2017/05/06 16:21:50 ET
Table '1597684053 5' 6-max Seat #6 is the button
Seat 1: D_Rannn22 (74874 in chips)=20
Seat 2: VinnieB118 (114916 in chips)=20
Seat 3: rbonessss333 (93853 in chips)=20
Seat 4: Bsgwolfpack4 (24817 in chips)=20
Seat 5: CHIEFKILLER4 (83470 in chips)=20
Seat 6: JJin91 (30611 in chips)=20
D_Rannn22: posts the ante 150
VinnieB118: posts the ante 150
rbonessss333: posts the ante 150
Bsgwolfpack4: posts the ante 150
CHIEFKILLER4: posts the ante 150
JJin91: posts the ante 150
D_Rannn22: posts small blind 600
VinnieB118: posts big blind 1200
*** HOLE CARDS ***
Dealt to JJin91 [7h 2h]
rbonessss333: folds=20
Bsgwolfpack4: folds=20
CHIEFKILLER4: raises 1200 to 2400
JJin91: folds=20
D_Rannn22: folds=20
VinnieB118: folds=20
Uncalled bet (1200) returned to CHIEFKILLER4
CHIEFKILLER4 collected 3900 from pot
*** SUMMARY ***
Total pot 3900 | Rake 0=20
Seat 1: D_Rannn22 (small blind) folded before Flop
Seat 2: VinnieB118 (big blind) folded before Flop
Seat 3: rbonessss333 folded before Flop (didn't bet)
Seat 4: Bsgwolfpack4 folded before Flop (didn't bet)
Seat 5: CHIEFKILLER4 collected (3900)
Seat 6: JJin91 (button) folded before Flop (didn't bet)


*********** # 257 **************
PokerStars Hand #169476269165: Tournament #1597684053, $13.50+$1.50 USD=
 Hold'em No Limit - Level XVI (600/1200) - 2017/05/06 16:22:04 ET
Table '1597684053 5' 6-max Seat #1 is the button
Seat 1: D_Rannn22 (74124 in chips)=20
Seat 2: VinnieB118 (113566 in chips)=20
Seat 3: rbonessss333 (93703 in chips)=20
Seat 4: Bsgwolfpack4 (24667 in chips)=20
Seat 5: CHIEFKILLER4 (86020 in chips)=20
Seat 6: JJin91 (30461 in chips)=20
D_Rannn22: posts the ante 150
VinnieB118: posts the ante 150
rbonessss333: posts the ante 150
Bsgwolfpack4: posts the ante 150
CHIEFKILLER4: posts the ante 150
JJin91: posts the ante 150
VinnieB118: posts small blind 600
rbonessss333: posts big blind 1200
*** HOLE CARDS ***
Dealt to JJin91 [3h 4s]
Bsgwolfpack4: folds=20
CHIEFKILLER4: folds=20
JJin91: folds=20
D_Rannn22: raises 1200 to 2400
VinnieB118: folds=20
rbonessss333: folds=20
Uncalled bet (1200) returned to D_Rannn22
D_Rannn22 collected 3900 from pot
D_Rannn22: doesn't show hand=20
*** SUMMARY ***
Total pot 3900 | Rake 0=20
Seat 1: D_Rannn22 (button) collected (3900)
Seat 2: VinnieB118 (small blind) folded before Flop
Seat 3: rbonessss333 (big blind) folded before Flop
Seat 4: Bsgwolfpack4 folded before Flop (didn't bet)
Seat 5: CHIEFKILLER4 folded before Flop (didn't bet)
Seat 6: JJin91 folded before Flop (didn't bet)


*********** # 258 **************
PokerStars Hand #169476269235: Tournament #1597684053, $13.50+$1.50 USD=
 Hold'em No Limit - Level XVI (600/1200) - 2017/05/06 16:22:23 ET
Table '1597684053 5' 6-max Seat #2 is the button
Seat 1: D_Rannn22 (76674 in chips)=20
Seat 2: VinnieB118 (112816 in chips)=20
Seat 3: rbonessss333 (92353 in chips)=20
Seat 4: Bsgwolfpack4 (24517 in chips)=20
Seat 5: CHIEFKILLER4 (85870 in chips)=20
Seat 6: JJin91 (30311 in chips)=20
D_Rannn22: posts the ante 150
VinnieB118: posts the ante 150
rbonessss333: posts the ante 150
Bsgwolfpack4: posts the ante 150
CHIEFKILLER4: posts the ante 150
JJin91: posts the ante 150
rbonessss333: posts small blind 600
Bsgwolfpack4: posts big blind 1200
*** HOLE CARDS ***
Dealt to JJin91 [9s 6h]
CHIEFKILLER4: folds=20
JJin91: folds=20
D_Rannn22: calls 1200
VinnieB118: folds=20
rbonessss333: calls 600
Bsgwolfpack4: raises 23167 to 24367 and is all-in
D_Rannn22: folds=20
rbonessss333: folds=20
Uncalled bet (23167) returned to Bsgwolfpack4
Bsgwolfpack4 collected 4500 from pot
Bsgwolfpack4: doesn't show hand=20
*** SUMMARY ***
Total pot 4500 | Rake 0=20
Seat 1: D_Rannn22 folded before Flop
Seat 2: VinnieB118 (button) folded before Flop (didn't bet)
Seat 3: rbonessss333 (small blind) folded before Flop
Seat 4: Bsgwolfpack4 (big blind) collected (4500)
Seat 5: CHIEFKILLER4 folded before Flop (didn't bet)
Seat 6: JJin91 folded before Flop (didn't bet)


*********** # 259 **************
PokerStars Hand #169476269330: Tournament #1597684053, $13.50+$1.50 USD=
 Hold'em No Limit - Level XVI (600/1200) - 2017/05/06 16:22:46 ET
Table '1597684053 5' 6-max Seat #3 is the button
Seat 1: D_Rannn22 (75324 in chips)=20
Seat 2: VinnieB118 (112666 in chips)=20
Seat 3: rbonessss333 (91003 in chips)=20
Seat 4: Bsgwolfpack4 (27667 in chips)=20
Seat 5: CHIEFKILLER4 (85720 in chips)=20
Seat 6: JJin91 (30161 in chips)=20
D_Rannn22: posts the ante 150
VinnieB118: posts the ante 150
rbonessss333: posts the ante 150
Bsgwolfpack4: posts the ante 150
CHIEFKILLER4: posts the ante 150
JJin91: posts the ante 150
Bsgwolfpack4: posts small blind 600
CHIEFKILLER4: posts big blind 1200
*** HOLE CARDS ***
Dealt to JJin91 [2s 3h]
JJin91: folds=20
D_Rannn22: folds=20
VinnieB118: folds=20
rbonessss333: raises 2400 to 3600
Bsgwolfpack4: folds=20
CHIEFKILLER4: folds=20
Uncalled bet (2400) returned to rbonessss333
rbonessss333 collected 3900 from pot
*** SUMMARY ***
Total pot 3900 | Rake 0=20
Seat 1: D_Rannn22 folded before Flop (didn't bet)
Seat 2: VinnieB118 folded before Flop (didn't bet)
Seat 3: rbonessss333 (button) collected (3900)
Seat 4: Bsgwolfpack4 (small blind) folded before Flop
Seat 5: CHIEFKILLER4 (big blind) folded before Flop
Seat 6: JJin91 folded before Flop (didn't bet)


*********** # 260 **************
PokerStars Hand #169476269405: Tournament #1597684053, $13.50+$1.50 USD=
 Hold'em No Limit - Level XVI (600/1200) - 2017/05/06 16:23:02 ET
Table '1597684053 5' 6-max Seat #4 is the button
Seat 1: D_Rannn22 (75174 in chips)=20
Seat 2: VinnieB118 (112516 in chips)=20
Seat 3: rbonessss333 (93553 in chips)=20
Seat 4: Bsgwolfpack4 (26917 in chips)=20
Seat 5: CHIEFKILLER4 (84370 in chips)=20
Seat 6: JJin91 (30011 in chips)=20
D_Rannn22: posts the ante 150
VinnieB118: posts the ante 150
rbonessss333: posts the ante 150
Bsgwolfpack4: posts the ante 150
CHIEFKILLER4: posts the ante 150
JJin91: posts the ante 150
CHIEFKILLER4: posts small blind 600
JJin91: posts big blind 1200
*** HOLE CARDS ***
Dealt to JJin91 [6d Kc]
D_Rannn22: folds=20
VinnieB118: folds=20
rbonessss333: folds=20
Bsgwolfpack4: folds=20
CHIEFKILLER4: calls 600
JJin91: checks=20
*** FLOP *** [5c Ts 9c]
CHIEFKILLER4: checks=20
JJin91: checks=20
*** TURN *** [5c Ts 9c] [8d]
CHIEFKILLER4: checks=20
JJin91: checks=20
*** RIVER *** [5c Ts 9c 8d] [As]
CHIEFKILLER4: checks=20
JJin91: checks=20
*** SHOW DOWN ***
CHIEFKILLER4: shows [6h Kh] (high card Ace)
JJin91: shows [6d Kc] (high card Ace)
CHIEFKILLER4 collected 1650 from pot
JJin91 collected 1650 from pot
*** SUMMARY ***
Total pot 3300 | Rake 0=20
Board [5c Ts 9c 8d As]
Seat 1: D_Rannn22 folded before Flop (didn't bet)
Seat 2: VinnieB118 folded before Flop (didn't bet)
Seat 3: rbonessss333 folded before Flop (didn't bet)
Seat 4: Bsgwolfpack4 (button) folded before Flop (didn't bet)
Seat 5: CHIEFKILLER4 (small blind) showed [6h Kh] and won (1650) with h=
igh card Ace
Seat 6: JJin91 (big blind) showed [6d Kc] and won (1650) with high card=
 Ace


*********** # 261 **************
PokerStars Hand #169476269564: Tournament #1597684053, $13.50+$1.50 USD=
 Hold'em No Limit - Level XVI (600/1200) - 2017/05/06 16:23:40 ET
Table '1597684053 5' 6-max Seat #5 is the button
Seat 1: D_Rannn22 (75024 in chips)=20
Seat 2: VinnieB118 (112366 in chips)=20
Seat 3: rbonessss333 (93403 in chips)=20
Seat 4: Bsgwolfpack4 (26767 in chips)=20
Seat 5: CHIEFKILLER4 (84670 in chips)=20
Seat 6: JJin91 (30311 in chips)=20
D_Rannn22: posts the ante 150
VinnieB118: posts the ante 150
rbonessss333: posts the ante 150
Bsgwolfpack4: posts the ante 150
CHIEFKILLER4: posts the ante 150
JJin91: posts the ante 150
JJin91: posts small blind 600
D_Rannn22: posts big blind 1200
*** HOLE CARDS ***
Dealt to JJin91 [7c 6d]
VinnieB118: folds=20
rbonessss333: calls 1200
Bsgwolfpack4: raises 3000 to 4200
CHIEFKILLER4: folds=20
JJin91: folds=20
D_Rannn22: folds=20
rbonessss333: folds=20
Uncalled bet (3000) returned to Bsgwolfpack4
Bsgwolfpack4 collected 5100 from pot
Bsgwolfpack4: doesn't show hand=20
*** SUMMARY ***
Total pot 5100 | Rake 0=20
Seat 1: D_Rannn22 (big blind) folded before Flop
Seat 2: VinnieB118 folded before Flop (didn't bet)
Seat 3: rbonessss333 folded before Flop
Seat 4: Bsgwolfpack4 collected (5100)
Seat 5: CHIEFKILLER4 (button) folded before Flop (didn't bet)
Seat 6: JJin91 (small blind) folded before Flop


*********** # 262 **************
PokerStars Hand #169476269632: Tournament #1597684053, $13.50+$1.50 USD=
 Hold'em No Limit - Level XVI (600/1200) - 2017/05/06 16:23:59 ET
Table '1597684053 5' 6-max Seat #6 is the button
Seat 1: D_Rannn22 (73674 in chips)=20
Seat 2: VinnieB118 (112216 in chips)=20
Seat 3: rbonessss333 (92053 in chips)=20
Seat 4: Bsgwolfpack4 (30517 in chips)=20
Seat 5: CHIEFKILLER4 (84520 in chips)=20
Seat 6: JJin91 (29561 in chips)=20
D_Rannn22: posts the ante 150
VinnieB118: posts the ante 150
rbonessss333: posts the ante 150
Bsgwolfpack4: posts the ante 150
CHIEFKILLER4: posts the ante 150
JJin91: posts the ante 150
D_Rannn22: posts small blind 600
VinnieB118: posts big blind 1200
*** HOLE CARDS ***
Dealt to JJin91 [Js 9h]
rbonessss333: folds=20
Bsgwolfpack4: folds=20
CHIEFKILLER4: folds=20
JJin91: folds=20
D_Rannn22: calls 600
VinnieB118: checks=20
*** FLOP *** [Kh Ah Jc]
D_Rannn22: checks=20
VinnieB118: bets 1200
D_Rannn22: calls 1200
*** TURN *** [Kh Ah Jc] [8h]
D_Rannn22: checks=20
VinnieB118: checks=20
*** RIVER *** [Kh Ah Jc 8h] [5h]
D_Rannn22: bets 5700
VinnieB118: calls 5700
*** SHOW DOWN ***
D_Rannn22: shows [Qh Ac] (a flush, Ace high)
VinnieB118: mucks hand=20
D_Rannn22 collected 17100 from pot
*** SUMMARY ***
Total pot 17100 | Rake 0=20
Board [Kh Ah Jc 8h 5h]
Seat 1: D_Rannn22 (small blind) showed [Qh Ac] and won (17100) with a f=
lush, Ace high
Seat 2: VinnieB118 (big blind) mucked [3d Th]
Seat 3: rbonessss333 folded before Flop (didn't bet)
Seat 4: Bsgwolfpack4 folded before Flop (didn't bet)
Seat 5: CHIEFKILLER4 folded before Flop (didn't bet)
Seat 6: JJin91 (button) folded before Flop (didn't bet)


*********** # 263 **************
PokerStars Hand #169476269786: Tournament #1597684053, $13.50+$1.50 USD=
 Hold'em No Limit - Level XVI (600/1200) - 2017/05/06 16:24:38 ET
Table '1597684053 5' 6-max Seat #1 is the button
Seat 1: D_Rannn22 (82524 in chips)=20
Seat 2: VinnieB118 (103966 in chips)=20
Seat 3: rbonessss333 (91903 in chips)=20
Seat 4: Bsgwolfpack4 (30367 in chips)=20
Seat 5: CHIEFKILLER4 (84370 in chips)=20
Seat 6: JJin91 (29411 in chips)=20
D_Rannn22: posts the ante 150
VinnieB118: posts the ante 150
rbonessss333: posts the ante 150
Bsgwolfpack4: posts the ante 150
CHIEFKILLER4: posts the ante 150
JJin91: posts the ante 150
VinnieB118: posts small blind 600
rbonessss333: posts big blind 1200
*** HOLE CARDS ***
Dealt to JJin91 [Td 3c]
Bsgwolfpack4: folds=20
CHIEFKILLER4: folds=20
JJin91: folds=20
D_Rannn22: calls 1200
VinnieB118: raises 2400 to 3600
rbonessss333: folds=20
D_Rannn22: calls 2400
*** FLOP *** [Kd Jc Jd]
VinnieB118: checks=20
D_Rannn22: bets 3000
VinnieB118: calls 3000
*** TURN *** [Kd Jc Jd] [5d]
VinnieB118: checks=20
D_Rannn22: bets 6000
VinnieB118: raises 6000 to 12000
D_Rannn22: calls 6000
*** RIVER *** [Kd Jc Jd 5d] [As]
VinnieB118: bets 39600
D_Rannn22: folds [Qs Qc]
Uncalled bet (39600) returned to VinnieB118
VinnieB118 collected 39300 from pot
VinnieB118: doesn't show hand=20
*** SUMMARY ***
Total pot 39300 | Rake 0=20
Board [Kd Jc Jd 5d As]
Seat 1: D_Rannn22 (button) folded on the River
Seat 2: VinnieB118 (small blind) collected (39300)
Seat 3: rbonessss333 (big blind) folded before Flop
Seat 4: Bsgwolfpack4 folded before Flop (didn't bet)
Seat 5: CHIEFKILLER4 folded before Flop (didn't bet)
Seat 6: JJin91 folded before Flop (didn't bet)


*********** # 264 **************
PokerStars Hand #169476780968: Tournament #1597684053, $13.50+$1.50 USD=
 Hold'em No Limit - Level XVI (600/1200) - 2017/05/06 16:25:57 ET
Table '1597684053 5' 6-max Seat #2 is the button
Seat 1: D_Rannn22 (63774 in chips)=20
Seat 2: VinnieB118 (124516 in chips)=20
Seat 3: rbonessss333 (90553 in chips)=20
Seat 4: Bsgwolfpack4 (30217 in chips)=20
Seat 5: CHIEFKILLER4 (84220 in chips)=20
Seat 6: JJin91 (29261 in chips)=20
D_Rannn22: posts the ante 150
VinnieB118: posts the ante 150
rbonessss333: posts the ante 150
Bsgwolfpack4: posts the ante 150
CHIEFKILLER4: posts the ante 150
JJin91: posts the ante 150
rbonessss333: posts small blind 600
Bsgwolfpack4: posts big blind 1200
*** HOLE CARDS ***
Dealt to JJin91 [4s 6h]
CHIEFKILLER4: folds=20
JJin91: folds=20
D_Rannn22: folds=20
VinnieB118: folds=20
rbonessss333: folds=20
Uncalled bet (600) returned to Bsgwolfpack4
Bsgwolfpack4 collected 2100 from pot
Bsgwolfpack4: doesn't show hand=20
*** SUMMARY ***
Total pot 2100 | Rake 0=20
Seat 1: D_Rannn22 folded before Flop (didn't bet)
Seat 2: VinnieB118 (button) folded before Flop (didn't bet)
Seat 3: rbonessss333 (small blind) folded before Flop
Seat 4: Bsgwolfpack4 (big blind) collected (2100)
Seat 5: CHIEFKILLER4 folded before Flop (didn't bet)
Seat 6: JJin91 folded before Flop (didn't bet)


*********** # 265 **************
PokerStars Hand #169476781001: Tournament #1597684053, $13.50+$1.50 USD=
 Hold'em No Limit - Level XVI (600/1200) - 2017/05/06 16:26:08 ET
Table '1597684053 5' 6-max Seat #3 is the button
Seat 1: D_Rannn22 (63624 in chips)=20
Seat 2: VinnieB118 (124366 in chips)=20
Seat 3: rbonessss333 (89803 in chips)=20
Seat 4: Bsgwolfpack4 (31567 in chips)=20
Seat 5: CHIEFKILLER4 (84070 in chips)=20
Seat 6: JJin91 (29111 in chips)=20
D_Rannn22: posts the ante 150
VinnieB118: posts the ante 150
rbonessss333: posts the ante 150
Bsgwolfpack4: posts the ante 150
CHIEFKILLER4: posts the ante 150
JJin91: posts the ante 150
Bsgwolfpack4: posts small blind 600
CHIEFKILLER4: posts big blind 1200
*** HOLE CARDS ***
Dealt to JJin91 [Qd 8s]
JJin91: folds=20
D_Rannn22: folds=20
VinnieB118: raises 1200 to 2400
rbonessss333: calls 2400
Bsgwolfpack4: folds=20
CHIEFKILLER4: folds=20
*** FLOP *** [3d Jd 9h]
VinnieB118: checks=20
rbonessss333: checks=20
*** TURN *** [3d Jd 9h] [3c]
VinnieB118: checks=20
rbonessss333: bets 1200
VinnieB118: folds=20
Uncalled bet (1200) returned to rbonessss333
rbonessss333 collected 7500 from pot
*** SUMMARY ***
Total pot 7500 | Rake 0=20
Board [3d Jd 9h 3c]
Seat 1: D_Rannn22 folded before Flop (didn't bet)
Seat 2: VinnieB118 folded on the Turn
Seat 3: rbonessss333 (button) collected (7500)
Seat 4: Bsgwolfpack4 (small blind) folded before Flop
Seat 5: CHIEFKILLER4 (big blind) folded before Flop
Seat 6: JJin91 folded before Flop (didn't bet)


*********** # 266 **************
PokerStars Hand #169476781173: Tournament #1597684053, $13.50+$1.50 USD=
 Hold'em No Limit - Level XVI (600/1200) - 2017/05/06 16:26:53 ET
Table '1597684053 5' 6-max Seat #4 is the button
Seat 1: D_Rannn22 (63474 in chips)=20
Seat 2: VinnieB118 (121816 in chips)=20
Seat 3: rbonessss333 (94753 in chips)=20
Seat 4: Bsgwolfpack4 (30817 in chips)=20
Seat 5: CHIEFKILLER4 (82720 in chips)=20
Seat 6: JJin91 (28961 in chips)=20
D_Rannn22: posts the ante 150
VinnieB118: posts the ante 150
rbonessss333: posts the ante 150
Bsgwolfpack4: posts the ante 150
CHIEFKILLER4: posts the ante 150
JJin91: posts the ante 150
CHIEFKILLER4: posts small blind 600
JJin91: posts big blind 1200
*** HOLE CARDS ***
Dealt to JJin91 [9h 9s]
D_Rannn22: raises 1200 to 2400
VinnieB118: folds=20
rbonessss333: folds=20
Bsgwolfpack4: folds=20
CHIEFKILLER4: calls 1800
JJin91: raises 26411 to 28811 and is all-in
D_Rannn22: folds=20
CHIEFKILLER4: folds=20
Uncalled bet (26411) returned to JJin91
JJin91 collected 8100 from pot
JJin91: doesn't show hand=20
*** SUMMARY ***
Total pot 8100 | Rake 0=20
Seat 1: D_Rannn22 folded before Flop
Seat 2: VinnieB118 folded before Flop (didn't bet)
Seat 3: rbonessss333 folded before Flop (didn't bet)
Seat 4: Bsgwolfpack4 (button) folded before Flop (didn't bet)
Seat 5: CHIEFKILLER4 (small blind) folded before Flop
Seat 6: JJin91 (big blind) collected (8100)


*********** # 267 **************
PokerStars Hand #169476781283: Tournament #1597684053, $13.50+$1.50 USD=
 Hold'em No Limit - Level XVII (700/1400) - 2017/05/06 16:27:23 ET
Table '1597684053 5' 6-max Seat #5 is the button
Seat 1: D_Rannn22 (60924 in chips)=20
Seat 2: VinnieB118 (121666 in chips)=20
Seat 3: rbonessss333 (94603 in chips)=20
Seat 4: Bsgwolfpack4 (30667 in chips)=20
Seat 5: CHIEFKILLER4 (80170 in chips)=20
Seat 6: JJin91 (34511 in chips)=20
D_Rannn22: posts the ante 175
VinnieB118: posts the ante 175
rbonessss333: posts the ante 175
Bsgwolfpack4: posts the ante 175
CHIEFKILLER4: posts the ante 175
JJin91: posts the ante 175
JJin91: posts small blind 700
D_Rannn22: posts big blind 1400
*** HOLE CARDS ***
Dealt to JJin91 [Ac Qd]
VinnieB118: folds=20
rbonessss333: folds=20
Bsgwolfpack4: folds=20
CHIEFKILLER4: folds=20
JJin91: raises 32936 to 34336 and is all-in
D_Rannn22: folds=20
Uncalled bet (32936) returned to JJin91
JJin91 collected 3850 from pot
JJin91: doesn't show hand=20
*** SUMMARY ***
Total pot 3850 | Rake 0=20
Seat 1: D_Rannn22 (big blind) folded before Flop
Seat 2: VinnieB118 folded before Flop (didn't bet)
Seat 3: rbonessss333 folded before Flop (didn't bet)
Seat 4: Bsgwolfpack4 folded before Flop (didn't bet)
Seat 5: CHIEFKILLER4 (button) folded before Flop (didn't bet)
Seat 6: JJin91 (small blind) collected (3850)


*********** # 268 **************
PokerStars Hand #169476781338: Tournament #1597684053, $13.50+$1.50 USD=
 Hold'em No Limit - Level XVII (700/1400) - 2017/05/06 16:27:39 ET
Table '1597684053 5' 6-max Seat #6 is the button
Seat 1: D_Rannn22 (59349 in chips)=20
Seat 2: VinnieB118 (121491 in chips)=20
Seat 3: rbonessss333 (94428 in chips)=20
Seat 4: Bsgwolfpack4 (30492 in chips)=20
Seat 5: CHIEFKILLER4 (79995 in chips)=20
Seat 6: JJin91 (36786 in chips)=20
D_Rannn22: posts the ante 175
VinnieB118: posts the ante 175
rbonessss333: posts the ante 175
Bsgwolfpack4: posts the ante 175
CHIEFKILLER4: posts the ante 175
JJin91: posts the ante 175
D_Rannn22: posts small blind 700
VinnieB118: posts big blind 1400
*** HOLE CARDS ***
Dealt to JJin91 [As 7s]
rbonessss333: folds=20
Bsgwolfpack4: calls 1400
CHIEFKILLER4: calls 1400
JJin91: calls 1400
D_Rannn22: calls 700
VinnieB118: checks=20
*** FLOP *** [Ks Kc 5s]
D_Rannn22: bets 1400
VinnieB118: folds=20
Bsgwolfpack4: calls 1400
CHIEFKILLER4: folds=20
JJin91: calls 1400
*** TURN *** [Ks Kc 5s] [Td]
D_Rannn22: checks=20
Bsgwolfpack4: checks=20
JJin91: checks=20
*** RIVER *** [Ks Kc 5s Td] [9d]
D_Rannn22: checks=20
Bsgwolfpack4: bets 5225
JJin91: folds=20
D_Rannn22: calls 5225
*** SHOW DOWN ***
Bsgwolfpack4: shows [Kd 7d] (three of a kind, Kings)
D_Rannn22: mucks hand=20
Bsgwolfpack4 collected 22700 from pot
*** SUMMARY ***
Total pot 22700 | Rake 0=20
Board [Ks Kc 5s Td 9d]
Seat 1: D_Rannn22 (small blind) mucked [2s 5c]
Seat 2: VinnieB118 (big blind) folded on the Flop
Seat 3: rbonessss333 folded before Flop (didn't bet)
Seat 4: Bsgwolfpack4 showed [Kd 7d] and won (22700) with three of a kin=
d, Kings
Seat 5: CHIEFKILLER4 folded on the Flop
Seat 6: JJin91 (button) folded on the River


*********** # 269 **************
PokerStars Hand #169476781526: Tournament #1597684053, $13.50+$1.50 USD=
 Hold'em No Limit - Level XVII (700/1400) - 2017/05/06 16:28:35 ET
Table '1597684053 5' 6-max Seat #1 is the button
Seat 1: D_Rannn22 (51149 in chips)=20
Seat 2: VinnieB118 (119916 in chips)=20
Seat 3: rbonessss333 (94253 in chips)=20
Seat 4: Bsgwolfpack4 (44992 in chips)=20
Seat 5: CHIEFKILLER4 (78420 in chips)=20
Seat 6: JJin91 (33811 in chips)=20
D_Rannn22: posts the ante 175
VinnieB118: posts the ante 175
rbonessss333: posts the ante 175
Bsgwolfpack4: posts the ante 175
CHIEFKILLER4: posts the ante 175
JJin91: posts the ante 175
VinnieB118: posts small blind 700
rbonessss333: posts big blind 1400
*** HOLE CARDS ***
Dealt to JJin91 [Ts 4d]
Bsgwolfpack4: folds=20
CHIEFKILLER4: folds=20
JJin91: folds=20
D_Rannn22: raises 1400 to 2800
VinnieB118: folds=20
rbonessss333: raises 7350 to 10150
D_Rannn22: calls 7350
*** FLOP *** [7c Ah 2h]
rbonessss333: bets 22050
D_Rannn22: raises 18774 to 40824 and is all-in
rbonessss333: calls 18774
*** TURN *** [7c Ah 2h] [4h]
*** RIVER *** [7c Ah 2h 4h] [9c]
*** SHOW DOWN ***
rbonessss333: shows [Kh Ad] (a pair of Aces)
D_Rannn22: shows [Ac Kd] (a pair of Aces)
rbonessss333 collected 51849 from pot
D_Rannn22 collected 51849 from pot
*** SUMMARY ***
Total pot 103698 | Rake 0=20
Board [7c Ah 2h 4h 9c]
Seat 1: D_Rannn22 (button) showed [Ac Kd] and won (51849) with a pair o=
f Aces
Seat 2: VinnieB118 (small blind) folded before Flop
Seat 3: rbonessss333 (big blind) showed [Kh Ad] and won (51849) with a =
pair of Aces
Seat 4: Bsgwolfpack4 folded before Flop (didn't bet)
Seat 5: CHIEFKILLER4 folded before Flop (didn't bet)
Seat 6: JJin91 folded before Flop (didn't bet)


*********** # 270 **************
PokerStars Hand #169476781657: Tournament #1597684053, $13.50+$1.50 USD=
 Hold'em No Limit - Level XVII (700/1400) - 2017/05/06 16:29:06 ET
Table '1597684053 5' 6-max Seat #2 is the button
Seat 1: D_Rannn22 (51849 in chips)=20
Seat 2: VinnieB118 (119041 in chips)=20
Seat 3: rbonessss333 (94953 in chips)=20
Seat 4: Bsgwolfpack4 (44817 in chips)=20
Seat 5: CHIEFKILLER4 (78245 in chips)=20
Seat 6: JJin91 (33636 in chips)=20
D_Rannn22: posts the ante 175
VinnieB118: posts the ante 175
rbonessss333: posts the ante 175
Bsgwolfpack4: posts the ante 175
CHIEFKILLER4: posts the ante 175
JJin91: posts the ante 175
rbonessss333: posts small blind 700
Bsgwolfpack4: posts big blind 1400
*** HOLE CARDS ***
Dealt to JJin91 [8h 5s]
CHIEFKILLER4: folds=20
JJin91: folds=20
D_Rannn22: folds=20
VinnieB118: folds=20
rbonessss333: calls 700
Bsgwolfpack4: raises 3100 to 4500
rbonessss333: folds=20
Uncalled bet (3100) returned to Bsgwolfpack4
Bsgwolfpack4 collected 3850 from pot
Bsgwolfpack4: doesn't show hand=20
*** SUMMARY ***
Total pot 3850 | Rake 0=20
Seat 1: D_Rannn22 folded before Flop (didn't bet)
Seat 2: VinnieB118 (button) folded before Flop (didn't bet)
Seat 3: rbonessss333 (small blind) folded before Flop
Seat 4: Bsgwolfpack4 (big blind) collected (3850)
Seat 5: CHIEFKILLER4 folded before Flop (didn't bet)
Seat 6: JJin91 folded before Flop (didn't bet)


*********** # 271 **************
PokerStars Hand #169476781719: Tournament #1597684053, $13.50+$1.50 USD=
 Hold'em No Limit - Level XVII (700/1400) - 2017/05/06 16:29:23 ET
Table '1597684053 5' 6-max Seat #3 is the button
Seat 1: D_Rannn22 (51674 in chips)=20
Seat 2: VinnieB118 (118866 in chips)=20
Seat 3: rbonessss333 (93378 in chips)=20
Seat 4: Bsgwolfpack4 (47092 in chips)=20
Seat 5: CHIEFKILLER4 (78070 in chips)=20
Seat 6: JJin91 (33461 in chips)=20
D_Rannn22: posts the ante 175
VinnieB118: posts the ante 175
rbonessss333: posts the ante 175
Bsgwolfpack4: posts the ante 175
CHIEFKILLER4: posts the ante 175
JJin91: posts the ante 175
Bsgwolfpack4: posts small blind 700
CHIEFKILLER4: posts big blind 1400
*** HOLE CARDS ***
Dealt to JJin91 [5s 3s]
JJin91: folds=20
D_Rannn22: folds=20
VinnieB118: folds=20
rbonessss333: folds=20
Bsgwolfpack4: folds=20
Uncalled bet (700) returned to CHIEFKILLER4
CHIEFKILLER4 collected 2450 from pot
*** SUMMARY ***
Total pot 2450 | Rake 0=20
Seat 1: D_Rannn22 folded before Flop (didn't bet)
Seat 2: VinnieB118 folded before Flop (didn't bet)
Seat 3: rbonessss333 (button) folded before Flop (didn't bet)
Seat 4: Bsgwolfpack4 (small blind) folded before Flop
Seat 5: CHIEFKILLER4 (big blind) collected (2450)
Seat 6: JJin91 folded before Flop (didn't bet)


*********** # 272 **************
PokerStars Hand #169476781777: Tournament #1597684053, $13.50+$1.50 USD=
 Hold'em No Limit - Level XVII (700/1400) - 2017/05/06 16:29:35 ET
Table '1597684053 5' 6-max Seat #4 is the button
Seat 1: D_Rannn22 (51499 in chips)=20
Seat 2: VinnieB118 (118691 in chips)=20
Seat 3: rbonessss333 (93203 in chips)=20
Seat 4: Bsgwolfpack4 (46217 in chips)=20
Seat 5: CHIEFKILLER4 (79645 in chips)=20
Seat 6: JJin91 (33286 in chips)=20
D_Rannn22: posts the ante 175
VinnieB118: posts the ante 175
rbonessss333: posts the ante 175
Bsgwolfpack4: posts the ante 175
CHIEFKILLER4: posts the ante 175
JJin91: posts the ante 175
CHIEFKILLER4: posts small blind 700
JJin91: posts big blind 1400
*** HOLE CARDS ***
Dealt to JJin91 [4h 6c]
D_Rannn22: folds=20
VinnieB118: folds=20
rbonessss333: calls 1400
Bsgwolfpack4: folds=20
CHIEFKILLER4: calls 700
JJin91: checks=20
*** FLOP *** [As 9s 6d]
CHIEFKILLER4: checks=20
JJin91: bets 1628
rbonessss333: raises 1628 to 3256
CHIEFKILLER4: folds=20
JJin91: folds=20
Uncalled bet (1628) returned to rbonessss333
rbonessss333 collected 8506 from pot
*** SUMMARY ***
Total pot 8506 | Rake 0=20
Board [As 9s 6d]
Seat 1: D_Rannn22 folded before Flop (didn't bet)
Seat 2: VinnieB118 folded before Flop (didn't bet)
Seat 3: rbonessss333 collected (8506)
Seat 4: Bsgwolfpack4 (button) folded before Flop (didn't bet)
Seat 5: CHIEFKILLER4 (small blind) folded on the Flop
Seat 6: JJin91 (big blind) folded on the Flop


*********** # 273 **************
PokerStars Hand #169476781947: Tournament #1597684053, $13.50+$1.50 USD=
 Hold'em No Limit - Level XVII (700/1400) - 2017/05/06 16:30:14 ET
Table '1597684053 5' 6-max Seat #5 is the button
Seat 1: D_Rannn22 (51324 in chips)=20
Seat 2: VinnieB118 (118516 in chips)=20
Seat 3: rbonessss333 (98506 in chips)=20
Seat 4: Bsgwolfpack4 (46042 in chips)=20
Seat 5: CHIEFKILLER4 (78070 in chips)=20
Seat 6: JJin91 (30083 in chips)=20
D_Rannn22: posts the ante 175
VinnieB118: posts the ante 175
rbonessss333: posts the ante 175
Bsgwolfpack4: posts the ante 175
CHIEFKILLER4: posts the ante 175
JJin91: posts the ante 175
JJin91: posts small blind 700
D_Rannn22: posts big blind 1400
*** HOLE CARDS ***
Dealt to JJin91 [8d 7s]
VinnieB118: raises 1400 to 2800
rbonessss333: folds=20
Bsgwolfpack4: folds=20
CHIEFKILLER4: calls 2800
JJin91: folds=20
D_Rannn22: folds=20
*** FLOP *** [4d 5c Kc]
VinnieB118 is disconnected=20
VinnieB118 is connected=20
VinnieB118: checks=20
CHIEFKILLER4: checks=20
*** TURN *** [4d 5c Kc] [5s]
VinnieB118: bets 1400
CHIEFKILLER4: folds=20
Uncalled bet (1400) returned to VinnieB118
VinnieB118 collected 8750 from pot
VinnieB118: doesn't show hand=20
*** SUMMARY ***
Total pot 8750 | Rake 0=20
Board [4d 5c Kc 5s]
Seat 1: D_Rannn22 (big blind) folded before Flop
Seat 2: VinnieB118 collected (8750)
Seat 3: rbonessss333 folded before Flop (didn't bet)
Seat 4: Bsgwolfpack4 folded before Flop (didn't bet)
Seat 5: CHIEFKILLER4 (button) folded on the Turn
Seat 6: JJin91 (small blind) folded before Flop


*********** # 274 **************
PokerStars Hand #169476782216: Tournament #1597684053, $13.50+$1.50 USD=
 Hold'em No Limit - Level XVII (700/1400) - 2017/05/06 16:31:26 ET
Table '1597684053 5' 6-max Seat #6 is the button
Seat 1: D_Rannn22 (49749 in chips)=20
Seat 2: VinnieB118 (124291 in chips)=20
Seat 3: rbonessss333 (98331 in chips)=20
Seat 4: Bsgwolfpack4 (45867 in chips)=20
Seat 5: CHIEFKILLER4 (75095 in chips)=20
Seat 6: JJin91 (29208 in chips)=20
D_Rannn22: posts the ante 175
VinnieB118: posts the ante 175
rbonessss333: posts the ante 175
Bsgwolfpack4: posts the ante 175
CHIEFKILLER4: posts the ante 175
JJin91: posts the ante 175
D_Rannn22: posts small blind 700
VinnieB118: posts big blind 1400
*** HOLE CARDS ***
Dealt to JJin91 [Tc 4h]
rbonessss333: folds=20
Bsgwolfpack4: folds=20
CHIEFKILLER4: folds=20
JJin91: folds=20
D_Rannn22: calls 700
VinnieB118: checks=20
*** FLOP *** [Qs 3s 2d]
D_Rannn22: checks=20
VinnieB118: checks=20
*** TURN *** [Qs 3s 2d] [2s]
D_Rannn22: bets 1400
VinnieB118: folds=20
Uncalled bet (1400) returned to D_Rannn22
D_Rannn22 collected 3850 from pot
D_Rannn22: doesn't show hand=20
*** SUMMARY ***
Total pot 3850 | Rake 0=20
Board [Qs 3s 2d 2s]
Seat 1: D_Rannn22 (small blind) collected (3850)
Seat 2: VinnieB118 (big blind) folded on the Turn
Seat 3: rbonessss333 folded before Flop (didn't bet)
Seat 4: Bsgwolfpack4 folded before Flop (didn't bet)
Seat 5: CHIEFKILLER4 folded before Flop (didn't bet)
Seat 6: JJin91 (button) folded before Flop (didn't bet)


*********** # 275 **************
PokerStars Hand #169476782296: Tournament #1597684053, $13.50+$1.50 USD=
 Hold'em No Limit - Level XVII (700/1400) - 2017/05/06 16:31:50 ET
Table '1597684053 5' 6-max Seat #1 is the button
Seat 1: D_Rannn22 (52024 in chips)=20
Seat 2: VinnieB118 (122716 in chips)=20
Seat 3: rbonessss333 (98156 in chips)=20
Seat 4: Bsgwolfpack4 (45692 in chips)=20
Seat 5: CHIEFKILLER4 (74920 in chips)=20
Seat 6: JJin91 (29033 in chips)=20
D_Rannn22: posts the ante 175
VinnieB118: posts the ante 175
rbonessss333: posts the ante 175
Bsgwolfpack4: posts the ante 175
CHIEFKILLER4: posts the ante 175
JJin91: posts the ante 175
VinnieB118: posts small blind 700
rbonessss333: posts big blind 1400
*** HOLE CARDS ***
Dealt to JJin91 [Kc 5s]
Bsgwolfpack4: folds=20
CHIEFKILLER4: folds=20
JJin91: folds=20
D_Rannn22: calls 1400
VinnieB118: calls 700
rbonessss333: checks=20
*** FLOP *** [3c Qh 6c]
VinnieB118: bets 1400
rbonessss333: folds=20
D_Rannn22: folds=20
Uncalled bet (1400) returned to VinnieB118
VinnieB118 collected 5250 from pot
VinnieB118: doesn't show hand=20
*** SUMMARY ***
Total pot 5250 | Rake 0=20
Board [3c Qh 6c]
Seat 1: D_Rannn22 (button) folded on the Flop
Seat 2: VinnieB118 (small blind) collected (5250)
Seat 3: rbonessss333 (big blind) folded on the Flop
Seat 4: Bsgwolfpack4 folded before Flop (didn't bet)
Seat 5: CHIEFKILLER4 folded before Flop (didn't bet)
Seat 6: JJin91 folded before Flop (didn't bet)


*********** # 276 **************
PokerStars Hand #169476782367: Tournament #1597684053, $13.50+$1.50 USD=
 Hold'em No Limit - Level XVII (700/1400) - 2017/05/06 16:32:08 ET
Table '1597684053 5' 6-max Seat #2 is the button
Seat 1: D_Rannn22 (50449 in chips)=20
Seat 2: VinnieB118 (126391 in chips)=20
Seat 3: rbonessss333 (96581 in chips)=20
Seat 4: Bsgwolfpack4 (45517 in chips)=20
Seat 5: CHIEFKILLER4 (74745 in chips)=20
Seat 6: JJin91 (28858 in chips)=20
D_Rannn22: posts the ante 175
VinnieB118: posts the ante 175
rbonessss333: posts the ante 175
Bsgwolfpack4: posts the ante 175
CHIEFKILLER4: posts the ante 175
JJin91: posts the ante 175
rbonessss333: posts small blind 700
Bsgwolfpack4: posts big blind 1400
*** HOLE CARDS ***
Dealt to JJin91 [3h Jc]
CHIEFKILLER4: folds=20
JJin91: folds=20
D_Rannn22: folds=20
VinnieB118: raises 1400 to 2800
rbonessss333: folds=20
Bsgwolfpack4: calls 1400
*** FLOP *** [7d 2s 7s]
Bsgwolfpack4: checks=20
VinnieB118: bets 1400
Bsgwolfpack4: calls 1400
*** TURN *** [7d 2s 7s] [9c]
Bsgwolfpack4: checks=20
VinnieB118: checks=20
*** RIVER *** [7d 2s 7s 9c] [6d]
Bsgwolfpack4: bets 5075
VinnieB118: calls 5075
*** SHOW DOWN ***
Bsgwolfpack4: shows [Ac 6c] (two pair, Sevens and Sixes)
VinnieB118: shows [Ad 6s] (two pair, Sevens and Sixes)
Bsgwolfpack4 collected 10150 from pot
VinnieB118 collected 10150 from pot
*** SUMMARY ***
Total pot 20300 | Rake 0=20
Board [7d 2s 7s 9c 6d]
Seat 1: D_Rannn22 folded before Flop (didn't bet)
Seat 2: VinnieB118 (button) showed [Ad 6s] and won (10150) with two pai=
r, Sevens and Sixes
Seat 3: rbonessss333 (small blind) folded before Flop
Seat 4: Bsgwolfpack4 (big blind) showed [Ac 6c] and won (10150) with tw=
o pair, Sevens and Sixes
Seat 5: CHIEFKILLER4 folded before Flop (didn't bet)
Seat 6: JJin91 folded before Flop (didn't bet)


*********** # 277 **************
PokerStars Hand #169476782493: Tournament #1597684053, $13.50+$1.50 USD=
 Hold'em No Limit - Level XVII (700/1400) - 2017/05/06 16:32:42 ET
Table '1597684053 5' 6-max Seat #3 is the button
Seat 1: D_Rannn22 (50274 in chips)=20
Seat 2: VinnieB118 (127091 in chips)=20
Seat 3: rbonessss333 (95706 in chips)=20
Seat 4: Bsgwolfpack4 (46217 in chips)=20
Seat 5: CHIEFKILLER4 (74570 in chips)=20
Seat 6: JJin91 (28683 in chips)=20
D_Rannn22: posts the ante 175
VinnieB118: posts the ante 175
rbonessss333: posts the ante 175
Bsgwolfpack4: posts the ante 175
CHIEFKILLER4: posts the ante 175
JJin91: posts the ante 175
Bsgwolfpack4: posts small blind 700
CHIEFKILLER4: posts big blind 1400
*** HOLE CARDS ***
Dealt to JJin91 [9s 6d]
JJin91: folds=20
D_Rannn22: calls 1400
VinnieB118: raises 1400 to 2800
rbonessss333: folds=20
Bsgwolfpack4: folds=20
CHIEFKILLER4: folds=20
D_Rannn22: calls 1400
*** FLOP *** [Jh 6s 3c]
D_Rannn22: checks=20
VinnieB118: checks=20
*** TURN *** [Jh 6s 3c] [Tc]
D_Rannn22: bets 3000
VinnieB118: folds=20
Uncalled bet (3000) returned to D_Rannn22
D_Rannn22 collected 8750 from pot
D_Rannn22: doesn't show hand=20
*** SUMMARY ***
Total pot 8750 | Rake 0=20
Board [Jh 6s 3c Tc]
Seat 1: D_Rannn22 collected (8750)
Seat 2: VinnieB118 folded on the Turn
Seat 3: rbonessss333 (button) folded before Flop (didn't bet)
Seat 4: Bsgwolfpack4 (small blind) folded before Flop
Seat 5: CHIEFKILLER4 (big blind) folded before Flop
Seat 6: JJin91 folded before Flop (didn't bet)


*********** # 278 **************
PokerStars Hand #169476782655: Tournament #1597684053, $13.50+$1.50 USD=
 Hold'em No Limit - Level XVII (700/1400) - 2017/05/06 16:33:26 ET
Table '1597684053 4' 6-max Seat #2 is the button
Seat 2: asremb (85414 in chips)=20
Seat 3: FupaBoi47 (81279 in chips)=20
Seat 4: JJin91 (28508 in chips)=20
Seat 5: FootPerv (26599 in chips)=20
Seat 6: StephGod30 (120489 in chips)=20
asremb: posts the ante 175
FupaBoi47: posts the ante 175
JJin91: posts the ante 175
FootPerv: posts the ante 175
StephGod30: posts the ante 175
FupaBoi47: posts small blind 700
JJin91: posts big blind 1400
*** HOLE CARDS ***
Dealt to JJin91 [2d Qh]
FootPerv: folds=20
StephGod30: folds=20
asremb: folds=20
FupaBoi47: calls 700
JJin91: checks=20
*** FLOP *** [6c Qc Kd]
FupaBoi47: checks=20
JJin91: bets 26933 and is all-in
FupaBoi47: folds=20
Uncalled bet (26933) returned to JJin91
JJin91 collected 3675 from pot
JJin91: doesn't show hand=20
*** SUMMARY ***
Total pot 3675 | Rake 0=20
Board [6c Qc Kd]
Seat 2: asremb (button) folded before Flop (didn't bet)
Seat 3: FupaBoi47 (small blind) folded on the Flop
Seat 4: JJin91 (big blind) collected (3675)
Seat 5: FootPerv folded before Flop (didn't bet)
Seat 6: StephGod30 folded before Flop (didn't bet)


*********** # 279 **************
PokerStars Hand #169476782746: Tournament #1597684053, $13.50+$1.50 USD=
 Hold'em No Limit - Level XVII (700/1400) - 2017/05/06 16:33:52 ET
Table '1597684053 4' 6-max Seat #3 is the button
Seat 2: asremb (85239 in chips)=20
Seat 3: FupaBoi47 (79704 in chips)=20
Seat 4: JJin91 (30608 in chips)=20
Seat 5: FootPerv (26424 in chips)=20
Seat 6: StephGod30 (120314 in chips)=20
asremb: posts the ante 175
FupaBoi47: posts the ante 175
JJin91: posts the ante 175
FootPerv: posts the ante 175
StephGod30: posts the ante 175
JJin91: posts small blind 700
FootPerv: posts big blind 1400
*** HOLE CARDS ***
Dealt to JJin91 [2s Ac]
StephGod30: folds=20
asremb: folds=20
FupaBoi47: calls 1400
JJin91: calls 700
FootPerv: checks=20
*** FLOP *** [Qs 8s 7c]
JJin91: checks=20
FootPerv: bets 2639
FupaBoi47: folds=20
JJin91: folds=20
Uncalled bet (2639) returned to FootPerv
FootPerv collected 5075 from pot
FootPerv: doesn't show hand=20
*** SUMMARY ***
Total pot 5075 | Rake 0=20
Board [Qs 8s 7c]
Seat 2: asremb folded before Flop (didn't bet)
Seat 3: FupaBoi47 (button) folded on the Flop
Seat 4: JJin91 (small blind) folded on the Flop
Seat 5: FootPerv (big blind) collected (5075)
Seat 6: StephGod30 folded before Flop (didn't bet)


*********** # 280 **************
PokerStars Hand #169476782896: Tournament #1597684053, $13.50+$1.50 USD=
 Hold'em No Limit - Level XVII (700/1400) - 2017/05/06 16:34:34 ET
Table '1597684053 4' 6-max Seat #4 is the button
Seat 2: asremb (85064 in chips)=20
Seat 3: FupaBoi47 (78129 in chips)=20
Seat 4: JJin91 (29033 in chips)=20
Seat 5: FootPerv (29924 in chips)=20
Seat 6: StephGod30 (120139 in chips)=20
asremb: posts the ante 175
FupaBoi47: posts the ante 175
JJin91: posts the ante 175
FootPerv: posts the ante 175
StephGod30: posts the ante 175
FootPerv: posts small blind 700
StephGod30: posts big blind 1400
*** HOLE CARDS ***
Dealt to JJin91 [8d Jd]
asremb: folds=20
FupaBoi47: folds=20
JJin91: raises 26600 to 28000
FootPerv: folds=20
StephGod30: folds=20
Uncalled bet (26600) returned to JJin91
JJin91 collected 4375 from pot
JJin91: doesn't show hand=20
*** SUMMARY ***
Total pot 4375 | Rake 0=20
Seat 2: asremb folded before Flop (didn't bet)
Seat 3: FupaBoi47 folded before Flop (didn't bet)
Seat 4: JJin91 (button) collected (4375)
Seat 5: FootPerv (small blind) folded before Flop
Seat 6: StephGod30 (big blind) folded before Flop


*********** # 281 **************
PokerStars Hand #169476782955: Tournament #1597684053, $13.50+$1.50 USD=
 Hold'em No Limit - Level XVII (700/1400) - 2017/05/06 16:34:50 ET
Table '1597684053 4' 6-max Seat #5 is the button
Seat 2: asremb (84889 in chips)=20
Seat 3: FupaBoi47 (77954 in chips)=20
Seat 4: JJin91 (31833 in chips)=20
Seat 5: FootPerv (29049 in chips)=20
Seat 6: StephGod30 (118564 in chips)=20
asremb: posts the ante 175
FupaBoi47: posts the ante 175
JJin91: posts the ante 175
FootPerv: posts the ante 175
StephGod30: posts the ante 175
StephGod30: posts small blind 700
asremb: posts big blind 1400
*** HOLE CARDS ***
Dealt to JJin91 [5h 3h]
FupaBoi47: folds=20
JJin91: folds=20
FootPerv: folds=20
StephGod30: raises 2800 to 4200
asremb: folds=20
Uncalled bet (2800) returned to StephGod30
StephGod30 collected 3675 from pot
StephGod30: doesn't show hand=20
*** SUMMARY ***
Total pot 3675 | Rake 0=20
Seat 2: asremb (big blind) folded before Flop
Seat 3: FupaBoi47 folded before Flop (didn't bet)
Seat 4: JJin91 folded before Flop (didn't bet)
Seat 5: FootPerv (button) folded before Flop (didn't bet)
Seat 6: StephGod30 (small blind) collected (3675)


*********** # 282 **************
PokerStars Hand #169476783017: Tournament #1597684053, $13.50+$1.50 USD=
 Hold'em No Limit - Level XVII (700/1400) - 2017/05/06 16:35:07 ET
Table '1597684053 4' 6-max Seat #6 is the button
Seat 2: asremb (83314 in chips)=20
Seat 3: FupaBoi47 (77779 in chips)=20
Seat 4: JJin91 (31658 in chips)=20
Seat 5: FootPerv (28874 in chips)=20
Seat 6: StephGod30 (120664 in chips)=20
asremb: posts the ante 175
FupaBoi47: posts the ante 175
JJin91: posts the ante 175
FootPerv: posts the ante 175
StephGod30: posts the ante 175
asremb: posts small blind 700
FupaBoi47: posts big blind 1400
*** HOLE CARDS ***
Dealt to JJin91 [As Qd]
JJin91: raises 30083 to 31483 and is all-in
FootPerv: calls 28699 and is all-in
StephGod30: folds=20
asremb: folds=20
FupaBoi47: folds=20
Uncalled bet (2784) returned to JJin91
*** FLOP *** [Kd 2h Qs]
*** TURN *** [Kd 2h Qs] [Qc]
*** RIVER *** [Kd 2h Qs Qc] [Jh]
*** SHOW DOWN ***
JJin91: shows [As Qd] (three of a kind, Queens)
FootPerv: shows [Kc Kh] (a full house, Kings full of Queens)
FootPerv collected 60373 from pot
*** SUMMARY ***
Total pot 60373 | Rake 0=20
Board [Kd 2h Qs Qc Jh]
Seat 2: asremb (small blind) folded before Flop
Seat 3: FupaBoi47 (big blind) folded before Flop
Seat 4: JJin91 showed [As Qd] and lost with three of a kind, Queens
Seat 5: FootPerv showed [Kc Kh] and won (60373) with a full house, King=
s full of Queens
Seat 6: StephGod30 (button) folded before Flop (didn't bet)


*********** # 283 **************
PokerStars Hand #169476783101: Tournament #1597684053, $13.50+$1.50 USD=
 Hold'em No Limit - Level XVII (700/1400) - 2017/05/06 16:35:29 ET
Table '1597684053 4' 6-max Seat #2 is the button
Seat 2: asremb (82439 in chips)=20
Seat 3: FupaBoi47 (76204 in chips)=20
Seat 4: JJin91 (2784 in chips)=20
Seat 5: FootPerv (60373 in chips)=20
Seat 6: StephGod30 (120489 in chips)=20
asremb: posts the ante 175
FupaBoi47: posts the ante 175
JJin91: posts the ante 175
FootPerv: posts the ante 175
StephGod30: posts the ante 175
FupaBoi47: posts small blind 700
JJin91: posts big blind 1400
*** HOLE CARDS ***
Dealt to JJin91 [8c Tc]
FootPerv: folds=20
StephGod30: raises 1890 to 3290
asremb: folds=20
FupaBoi47: calls 2590
JJin91: calls 1209 and is all-in
*** FLOP *** [3d 7h As]
FupaBoi47: bets 5032
StephGod30: folds=20
Uncalled bet (5032) returned to FupaBoi47
*** TURN *** [3d 7h As] [7c]
*** RIVER *** [3d 7h As 7c] [Ah]
*** SHOW DOWN ***
FupaBoi47: shows [9c 9h] (two pair, Aces and Nines)
FupaBoi47 collected 1362 from side pot
JJin91: shows [8c Tc] (two pair, Aces and Sevens)
FupaBoi47 collected 8702 from main pot
JJin91 finished the tournament in 15th place and received $18.77.
*** SUMMARY ***
Total pot 10064 Main pot 8702. Side pot 1362. | Rake 0=20
Board [3d 7h As 7c Ah]
Seat 2: asremb (button) folded before Flop (didn't bet)
Seat 3: FupaBoi47 (small blind) showed [9c 9h] and won (10064) with two=
 pair, Aces and Nines
Seat 4: JJin91 (big blind) showed [8c Tc] and lost with two pair, Aces =
and Sevens
Seat 5: FootPerv folded before Flop (didn't bet)
Seat 6: StephGod30 folded on the Flop



If you have any questions, please contact us at "PokerStars Support" <s=
upport@pokerstarsnj.com>


