Transcript for tournament #1597684021 requested by JJin91 (jamiejin91@g=
mail.com)

*********** # 1 **************
PokerStars Hand #169432432387: Tournament #1597684021, $18.20+$1.80 USD=
 Hold'em No Limit - Level VI (75/150) - 2017/05/05 20:01:34 ET
Table '1597684021 4' 9-max Seat #6 is the button
Seat 1: jbodey52 (13460 in chips)=20
Seat 2: RealProK (4486 in chips)=20
Seat 3: panth26 (10253 in chips)=20
Seat 6: OceansO7 (10006 in chips)=20
Seat 7: Going2Ship (21823 in chips)=20
Seat 8: JJin91 (10000 in chips)=20
Seat 9: btd0729 (6930 in chips)=20
jbodey52: posts the ante 20
RealProK: posts the ante 20
panth26: posts the ante 20
OceansO7: posts the ante 20
Going2Ship: posts the ante 20
JJin91: posts the ante 20
btd0729: posts the ante 20
Going2Ship: posts small blind 75
JJin91: posts big blind 150
*** HOLE CARDS ***
Dealt to JJin91 [6s 2s]
btd0729: folds=20
jbodey52: folds=20
RealProK: folds=20
panth26: raises 210 to 360
OceansO7: folds=20
Going2Ship: folds=20
JJin91: folds=20
Uncalled bet (210) returned to panth26
panth26 collected 515 from pot
panth26: doesn't show hand=20
*** SUMMARY ***
Total pot 515 | Rake 0=20
Seat 1: jbodey52 folded before Flop (didn't bet)
Seat 2: RealProK folded before Flop (didn't bet)
Seat 3: panth26 collected (515)
Seat 6: OceansO7 (button) folded before Flop (didn't bet)
Seat 7: Going2Ship (small blind) folded before Flop
Seat 8: JJin91 (big blind) folded before Flop
Seat 9: btd0729 folded before Flop (didn't bet)


*********** # 2 **************
PokerStars Hand #169432432494: Tournament #1597684021, $18.20+$1.80 USD=
 Hold'em No Limit - Level VI (75/150) - 2017/05/05 20:02:03 ET
Table '1597684021 4' 9-max Seat #7 is the button
Seat 1: jbodey52 (13440 in chips)=20
Seat 2: RealProK (4466 in chips)=20
Seat 3: panth26 (10598 in chips)=20
Seat 6: OceansO7 (9986 in chips)=20
Seat 7: Going2Ship (21728 in chips)=20
Seat 8: JJin91 (9830 in chips)=20
Seat 9: btd0729 (6910 in chips)=20
jbodey52: posts the ante 20
RealProK: posts the ante 20
panth26: posts the ante 20
OceansO7: posts the ante 20
Going2Ship: posts the ante 20
JJin91: posts the ante 20
btd0729: posts the ante 20
JJin91: posts small blind 75
btd0729: posts big blind 150
*** HOLE CARDS ***
Dealt to JJin91 [Jh 5s]
jbodey52: raises 225 to 375
RealProK: folds=20
panth26: folds=20
OceansO7: folds=20
Going2Ship: folds=20
JJin91: folds=20
btd0729: raises 965 to 1340
jbodey52: calls 965
*** FLOP *** [Qc 7h 7s]
btd0729: bets 5550 and is all-in
jbodey52: calls 5550
*** TURN *** [Qc 7h 7s] [Jd]
*** RIVER *** [Qc 7h 7s Jd] [4s]
*** SHOW DOWN ***
btd0729: shows [Qs Ah] (two pair, Queens and Sevens)
jbodey52: shows [Ts Td] (two pair, Tens and Sevens)
btd0729 collected 13995 from pot
*** SUMMARY ***
Total pot 13995 | Rake 0=20
Board [Qc 7h 7s Jd 4s]
Seat 1: jbodey52 showed [Ts Td] and lost with two pair, Tens and Sevens
Seat 2: RealProK folded before Flop (didn't bet)
Seat 3: panth26 folded before Flop (didn't bet)
Seat 6: OceansO7 folded before Flop (didn't bet)
Seat 7: Going2Ship (button) folded before Flop (didn't bet)
Seat 8: JJin91 (small blind) folded before Flop
Seat 9: btd0729 (big blind) showed [Qs Ah] and won (13995) with two pai=
r, Queens and Sevens


*********** # 3 **************
PokerStars Hand #169432432779: Tournament #1597684021, $18.20+$1.80 USD=
 Hold'em No Limit - Level VI (75/150) - 2017/05/05 20:03:04 ET
Table '1597684021 4' 9-max Seat #8 is the button
Seat 1: jbodey52 (6530 in chips)=20
Seat 2: RealProK (4446 in chips)=20
Seat 3: panth26 (10578 in chips)=20
Seat 4: JSkelts (9980 in chips)=20
Seat 5: PhillyisGarb (10000 in chips)=20
Seat 6: OceansO7 (9966 in chips)=20
Seat 7: Going2Ship (21708 in chips)=20
Seat 8: JJin91 (9735 in chips)=20
Seat 9: btd0729 (13995 in chips)=20
jbodey52: posts the ante 20
RealProK: posts the ante 20
panth26: posts the ante 20
JSkelts: posts the ante 20
PhillyisGarb: posts the ante 20
OceansO7: posts the ante 20
Going2Ship: posts the ante 20
JJin91: posts the ante 20
btd0729: posts the ante 20
btd0729: posts small blind 75
jbodey52: posts big blind 150
*** HOLE CARDS ***
Dealt to JJin91 [Qc Kh]
RealProK: folds=20
panth26: raises 210 to 360
JSkelts: folds=20
PhillyisGarb: folds=20
OceansO7: folds=20
Going2Ship: folds=20
JJin91: calls 360
btd0729: folds=20
jbodey52: raises 5040 to 5400
panth26: folds=20
JJin91: folds=20
Uncalled bet (5040) returned to jbodey52
jbodey52 collected 1335 from pot
jbodey52: doesn't show hand=20
*** SUMMARY ***
Total pot 1335 | Rake 0=20
Seat 1: jbodey52 (big blind) collected (1335)
Seat 2: RealProK folded before Flop (didn't bet)
Seat 3: panth26 folded before Flop
Seat 4: JSkelts folded before Flop (didn't bet)
Seat 5: PhillyisGarb folded before Flop (didn't bet)
Seat 6: OceansO7 folded before Flop (didn't bet)
Seat 7: Going2Ship folded before Flop (didn't bet)
Seat 8: JJin91 (button) folded before Flop
Seat 9: btd0729 (small blind) folded before Flop


*********** # 4 **************
PokerStars Hand #169432433050: Tournament #1597684021, $18.20+$1.80 USD=
 Hold'em No Limit - Level VI (75/150) - 2017/05/05 20:04:09 ET
Table '1597684021 4' 9-max Seat #9 is the button
Seat 1: jbodey52 (7485 in chips)=20
Seat 2: RealProK (4426 in chips)=20
Seat 3: panth26 (10198 in chips)=20
Seat 4: JSkelts (9960 in chips)=20
Seat 5: PhillyisGarb (9980 in chips)=20
Seat 6: OceansO7 (9946 in chips)=20
Seat 7: Going2Ship (21688 in chips)=20
Seat 8: JJin91 (9355 in chips)=20
Seat 9: btd0729 (13900 in chips)=20
jbodey52: posts the ante 20
RealProK: posts the ante 20
panth26: posts the ante 20
JSkelts: posts the ante 20
PhillyisGarb: posts the ante 20
OceansO7: posts the ante 20
Going2Ship: posts the ante 20
JJin91: posts the ante 20
btd0729: posts the ante 20
jbodey52: posts small blind 75
RealProK: posts big blind 150
*** HOLE CARDS ***
Dealt to JJin91 [8d Js]
panth26: folds=20
JSkelts: folds=20
PhillyisGarb: folds=20
OceansO7: folds=20
Going2Ship: raises 270 to 420
JJin91: folds=20
btd0729: folds=20
jbodey52: calls 345
RealProK: calls 270
*** FLOP *** [9s Ac Qc]
jbodey52: checks=20
RealProK: checks=20
JJin91 is sitting out
Going2Ship: checks=20
*** TURN *** [9s Ac Qc] [2c]
jbodey52: bets 720
RealProK: folds=20
Going2Ship: folds=20
Uncalled bet (720) returned to jbodey52
jbodey52 collected 1440 from pot
jbodey52: doesn't show hand=20
*** SUMMARY ***
Total pot 1440 | Rake 0=20
Board [9s Ac Qc 2c]
Seat 1: jbodey52 (small blind) collected (1440)
Seat 2: RealProK (big blind) folded on the Turn
Seat 3: panth26 folded before Flop (didn't bet)
Seat 4: JSkelts folded before Flop (didn't bet)
Seat 5: PhillyisGarb folded before Flop (didn't bet)
Seat 6: OceansO7 folded before Flop (didn't bet)
Seat 7: Going2Ship folded on the Turn
Seat 8: JJin91 folded before Flop (didn't bet)
Seat 9: btd0729 (button) folded before Flop (didn't bet)


*********** # 5 **************
PokerStars Hand #169432433421: Tournament #1597684021, $18.20+$1.80 USD=
 Hold'em No Limit - Level VI (75/150) - 2017/05/05 20:05:40 ET
Table '1597684021 4' 9-max Seat #1 is the button
Seat 1: jbodey52 (8485 in chips)=20
Seat 2: RealProK (3986 in chips)=20
Seat 3: panth26 (10178 in chips)=20
Seat 4: JSkelts (9940 in chips)=20
Seat 5: PhillyisGarb (9960 in chips)=20
Seat 6: OceansO7 (9926 in chips)=20
Seat 7: Going2Ship (21248 in chips)=20
Seat 8: JJin91 (9335 in chips) is sitting out
Seat 9: btd0729 (13880 in chips)=20
jbodey52: posts the ante 20
RealProK: posts the ante 20
panth26: posts the ante 20
JSkelts: posts the ante 20
PhillyisGarb: posts the ante 20
OceansO7: posts the ante 20
Going2Ship: posts the ante 20
JJin91: posts the ante 20
btd0729: posts the ante 20
RealProK: posts small blind 75
panth26: posts big blind 150
*** HOLE CARDS ***
Dealt to JJin91 [Tc 8d]
JSkelts: folds=20
PhillyisGarb: folds=20
OceansO7: folds=20
JJin91 has returned
Going2Ship: folds=20
JJin91: folds=20
btd0729: folds=20
jbodey52: folds=20
RealProK: folds=20
Uncalled bet (75) returned to panth26
panth26 collected 330 from pot
panth26: doesn't show hand=20
*** SUMMARY ***
Total pot 330 | Rake 0=20
Seat 1: jbodey52 (button) folded before Flop (didn't bet)
Seat 2: RealProK (small blind) folded before Flop
Seat 3: panth26 (big blind) collected (330)
Seat 4: JSkelts folded before Flop (didn't bet)
Seat 5: PhillyisGarb folded before Flop (didn't bet)
Seat 6: OceansO7 folded before Flop (didn't bet)
Seat 7: Going2Ship folded before Flop (didn't bet)
Seat 8: JJin91 folded before Flop (didn't bet)
Seat 9: btd0729 folded before Flop (didn't bet)


*********** # 6 **************
PokerStars Hand #169432433569: Tournament #1597684021, $18.20+$1.80 USD=
 Hold'em No Limit - Level VI (75/150) - 2017/05/05 20:06:17 ET
Table '1597684021 4' 9-max Seat #2 is the button
Seat 1: jbodey52 (8465 in chips)=20
Seat 2: RealProK (3891 in chips)=20
Seat 3: panth26 (10413 in chips)=20
Seat 4: JSkelts (9920 in chips)=20
Seat 5: PhillyisGarb (9940 in chips)=20
Seat 6: OceansO7 (9906 in chips)=20
Seat 7: Going2Ship (21228 in chips)=20
Seat 8: JJin91 (9315 in chips)=20
Seat 9: btd0729 (13860 in chips)=20
jbodey52: posts the ante 20
RealProK: posts the ante 20
panth26: posts the ante 20
JSkelts: posts the ante 20
PhillyisGarb: posts the ante 20
OceansO7: posts the ante 20
Going2Ship: posts the ante 20
JJin91: posts the ante 20
btd0729: posts the ante 20
panth26: posts small blind 75
JSkelts: posts big blind 150
*** HOLE CARDS ***
Dealt to JJin91 [Kd 2h]
PhillyisGarb: folds=20
OceansO7: folds=20
Going2Ship is disconnected=20
Going2Ship is connected=20
Going2Ship: folds=20
JJin91: folds=20
JJin91 is sitting out
btd0729: folds=20
jbodey52: folds=20
RealProK: raises 555 to 705
panth26: folds=20
JSkelts: calls 555
*** FLOP *** [2s 7s Ac]
JSkelts: checks=20
RealProK: bets 3166 and is all-in
JSkelts: folds=20
Uncalled bet (3166) returned to RealProK
JJin91 has returned
RealProK collected 1665 from pot
RealProK: doesn't show hand=20
*** SUMMARY ***
Total pot 1665 | Rake 0=20
Board [2s 7s Ac]
Seat 1: jbodey52 folded before Flop (didn't bet)
Seat 2: RealProK (button) collected (1665)
Seat 3: panth26 (small blind) folded before Flop
Seat 4: JSkelts (big blind) folded on the Flop
Seat 5: PhillyisGarb folded before Flop (didn't bet)
Seat 6: OceansO7 folded before Flop (didn't bet)
Seat 7: Going2Ship folded before Flop (didn't bet)
Seat 8: JJin91 folded before Flop (didn't bet)
Seat 9: btd0729 folded before Flop (didn't bet)


*********** # 7 **************
PokerStars Hand #169432433797: Tournament #1597684021, $18.20+$1.80 USD=
 Hold'em No Limit - Level VII (100/200) - 2017/05/05 20:07:12 ET
Table '1597684021 4' 9-max Seat #3 is the button
Seat 1: jbodey52 (8445 in chips)=20
Seat 2: RealProK (4831 in chips)=20
Seat 3: panth26 (10318 in chips)=20
Seat 4: JSkelts (9195 in chips)=20
Seat 5: PhillyisGarb (9920 in chips)=20
Seat 6: OceansO7 (9886 in chips)=20
Seat 7: Going2Ship (21208 in chips)=20
Seat 8: JJin91 (9295 in chips)=20
Seat 9: btd0729 (13840 in chips)=20
jbodey52: posts the ante 25
RealProK: posts the ante 25
panth26: posts the ante 25
JSkelts: posts the ante 25
PhillyisGarb: posts the ante 25
OceansO7: posts the ante 25
Going2Ship: posts the ante 25
JJin91: posts the ante 25
btd0729: posts the ante 25
JSkelts: posts small blind 100
PhillyisGarb: posts big blind 200
*** HOLE CARDS ***
Dealt to JJin91 [6h 2c]
OceansO7: folds=20
Going2Ship: raises 200 to 400
JJin91: folds=20
btd0729: calls 400
jbodey52: calls 400
RealProK: folds=20
panth26: folds=20
JSkelts: folds=20
PhillyisGarb: calls 200
*** FLOP *** [4h 8c 2s]
PhillyisGarb: checks=20
Going2Ship: checks=20
btd0729: checks=20
jbodey52: bets 1000
PhillyisGarb: calls 1000
Going2Ship: calls 1000
btd0729: folds=20
*** TURN *** [4h 8c 2s] [7s]
PhillyisGarb: checks=20
Going2Ship: checks=20
jbodey52: bets 7020 and is all-in
PhillyisGarb: folds=20
Going2Ship: folds=20
Uncalled bet (7020) returned to jbodey52
jbodey52 collected 4925 from pot
jbodey52: doesn't show hand=20
*** SUMMARY ***
Total pot 4925 | Rake 0=20
Board [4h 8c 2s 7s]
Seat 1: jbodey52 collected (4925)
Seat 2: RealProK folded before Flop (didn't bet)
Seat 3: panth26 (button) folded before Flop (didn't bet)
Seat 4: JSkelts (small blind) folded before Flop
Seat 5: PhillyisGarb (big blind) folded on the Turn
Seat 6: OceansO7 folded before Flop (didn't bet)
Seat 7: Going2Ship folded on the Turn
Seat 8: JJin91 folded before Flop (didn't bet)
Seat 9: btd0729 folded on the Flop


*********** # 8 **************
PokerStars Hand #169432434232: Tournament #1597684021, $18.20+$1.80 USD=
 Hold'em No Limit - Level VII (100/200) - 2017/05/05 20:08:56 ET
Table '1597684021 4' 9-max Seat #4 is the button
Seat 1: jbodey52 (11945 in chips)=20
Seat 2: RealProK (4806 in chips)=20
Seat 3: panth26 (10293 in chips)=20
Seat 4: JSkelts (9070 in chips)=20
Seat 5: PhillyisGarb (8495 in chips)=20
Seat 7: Going2Ship (19783 in chips)=20
Seat 8: JJin91 (9270 in chips)=20
Seat 9: btd0729 (13415 in chips)=20
jbodey52: posts the ante 25
RealProK: posts the ante 25
panth26: posts the ante 25
JSkelts: posts the ante 25
PhillyisGarb: posts the ante 25
Going2Ship: posts the ante 25
JJin91: posts the ante 25
btd0729: posts the ante 25
PhillyisGarb: posts small blind 100
Going2Ship: posts big blind 200
*** HOLE CARDS ***
Dealt to JJin91 [9h 3s]
JJin91: folds=20
btd0729: folds=20
jbodey52: folds=20
RealProK: folds=20
panth26: folds=20
JSkelts: raises 240 to 440
PhillyisGarb: folds=20
Going2Ship: calls 240
*** FLOP *** [Td 7h 7d]
Going2Ship: checks=20
JSkelts: bets 400
Going2Ship: calls 400
*** TURN *** [Td 7h 7d] [4h]
Going2Ship: checks=20
JSkelts: checks=20
*** RIVER *** [Td 7h 7d 4h] [Ah]
Going2Ship: checks=20
JSkelts: bets 1500
Going2Ship: folds=20
Uncalled bet (1500) returned to JSkelts
JSkelts collected 1980 from pot
JSkelts: doesn't show hand=20
*** SUMMARY ***
Total pot 1980 | Rake 0=20
Board [Td 7h 7d 4h Ah]
Seat 1: jbodey52 folded before Flop (didn't bet)
Seat 2: RealProK folded before Flop (didn't bet)
Seat 3: panth26 folded before Flop (didn't bet)
Seat 4: JSkelts (button) collected (1980)
Seat 5: PhillyisGarb (small blind) folded before Flop
Seat 7: Going2Ship (big blind) folded on the River
Seat 8: JJin91 folded before Flop (didn't bet)
Seat 9: btd0729 folded before Flop (didn't bet)


*********** # 9 **************
PokerStars Hand #169432434487: Tournament #1597684021, $18.20+$1.80 USD=
 Hold'em No Limit - Level VII (100/200) - 2017/05/05 20:10:00 ET
Table '1597684021 4' 9-max Seat #5 is the button
Seat 1: jbodey52 (11920 in chips)=20
Seat 2: RealProK (4781 in chips)=20
Seat 3: panth26 (10268 in chips)=20
Seat 4: JSkelts (10185 in chips)=20
Seat 5: PhillyisGarb (8370 in chips)=20
Seat 7: Going2Ship (18918 in chips)=20
Seat 8: JJin91 (9245 in chips)=20
Seat 9: btd0729 (13390 in chips)=20
jbodey52: posts the ante 25
RealProK: posts the ante 25
panth26: posts the ante 25
JSkelts: posts the ante 25
PhillyisGarb: posts the ante 25
Going2Ship: posts the ante 25
JJin91: posts the ante 25
btd0729: posts the ante 25
Going2Ship: posts small blind 100
JJin91: posts big blind 200
*** HOLE CARDS ***
Dealt to JJin91 [Qh Jc]
btd0729: folds=20
jbodey52: folds=20
RealProK: folds=20
panth26: folds=20
JSkelts: folds=20
PhillyisGarb: folds=20
Going2Ship: raises 200 to 400
JJin91: calls 200
*** FLOP *** [8h 8s Kh]
Going2Ship: checks=20
JJin91: bets 530
Going2Ship: folds=20
Uncalled bet (530) returned to JJin91
JJin91 collected 1000 from pot
JJin91: doesn't show hand=20
*** SUMMARY ***
Total pot 1000 | Rake 0=20
Board [8h 8s Kh]
Seat 1: jbodey52 folded before Flop (didn't bet)
Seat 2: RealProK folded before Flop (didn't bet)
Seat 3: panth26 folded before Flop (didn't bet)
Seat 4: JSkelts folded before Flop (didn't bet)
Seat 5: PhillyisGarb (button) folded before Flop (didn't bet)
Seat 7: Going2Ship (small blind) folded on the Flop
Seat 8: JJin91 (big blind) collected (1000)
Seat 9: btd0729 folded before Flop (didn't bet)


*********** # 10 **************
PokerStars Hand #169432434603: Tournament #1597684021, $18.20+$1.80 USD=
 Hold'em No Limit - Level VII (100/200) - 2017/05/05 20:10:31 ET
Table '1597684021 4' 9-max Seat #7 is the button
Seat 1: jbodey52 (11895 in chips)=20
Seat 2: RealProK (4756 in chips)=20
Seat 3: panth26 (10243 in chips)=20
Seat 4: JSkelts (10160 in chips)=20
Seat 5: PhillyisGarb (8345 in chips)=20
Seat 7: Going2Ship (18493 in chips)=20
Seat 8: JJin91 (9820 in chips)=20
Seat 9: btd0729 (13365 in chips)=20
jbodey52: posts the ante 25
RealProK: posts the ante 25
panth26: posts the ante 25
JSkelts: posts the ante 25
PhillyisGarb: posts the ante 25
Going2Ship: posts the ante 25
JJin91: posts the ante 25
btd0729: posts the ante 25
JJin91: posts small blind 100
btd0729: posts big blind 200
*** HOLE CARDS ***
Dealt to JJin91 [Jc 4h]
jbodey52: raises 300 to 500
RealProK: folds=20
panth26: folds=20
JSkelts: folds=20
PhillyisGarb: folds=20
Going2Ship: calls 500
JJin91: folds=20
btd0729: folds=20
*** FLOP *** [5s 3c Qc]
jbodey52: checks=20
Going2Ship: checks=20
*** TURN *** [5s 3c Qc] [8d]
jbodey52: bets 1100
Going2Ship: calls 1100
*** RIVER *** [5s 3c Qc 8d] [Ah]
jbodey52: bets 1100
Going2Ship: folds=20
Uncalled bet (1100) returned to jbodey52
jbodey52 collected 3700 from pot
jbodey52: doesn't show hand=20
*** SUMMARY ***
Total pot 3700 | Rake 0=20
Board [5s 3c Qc 8d Ah]
Seat 1: jbodey52 collected (3700)
Seat 2: RealProK folded before Flop (didn't bet)
Seat 3: panth26 folded before Flop (didn't bet)
Seat 4: JSkelts folded before Flop (didn't bet)
Seat 5: PhillyisGarb folded before Flop (didn't bet)
Seat 7: Going2Ship (button) folded on the River
Seat 8: JJin91 (small blind) folded before Flop
Seat 9: btd0729 (big blind) folded before Flop


*********** # 11 **************
PokerStars Hand #169432434790: Tournament #1597684021, $18.20+$1.80 USD=
 Hold'em No Limit - Level VII (100/200) - 2017/05/05 20:11:12 ET
Table '1597684021 4' 9-max Seat #8 is the button
Seat 1: jbodey52 (13970 in chips)=20
Seat 2: RealProK (4731 in chips)=20
Seat 3: panth26 (10218 in chips)=20
Seat 4: JSkelts (10135 in chips)=20
Seat 5: PhillyisGarb (8320 in chips)=20
Seat 7: Going2Ship (16868 in chips)=20
Seat 8: JJin91 (9695 in chips)=20
Seat 9: btd0729 (13140 in chips)=20
jbodey52: posts the ante 25
RealProK: posts the ante 25
panth26: posts the ante 25
JSkelts: posts the ante 25
PhillyisGarb: posts the ante 25
Going2Ship: posts the ante 25
JJin91: posts the ante 25
btd0729: posts the ante 25
btd0729: posts small blind 100
jbodey52: posts big blind 200
*** HOLE CARDS ***
Dealt to JJin91 [9d 2d]
RealProK: folds=20
panth26: folds=20
JSkelts: folds=20
PhillyisGarb: raises 300 to 500
Going2Ship: folds=20
JJin91: folds=20
btd0729: calls 400
jbodey52: raises 13445 to 13945 and is all-in
PhillyisGarb: folds=20
btd0729: folds=20
Uncalled bet (13445) returned to jbodey52
jbodey52 collected 1700 from pot
jbodey52: doesn't show hand=20
*** SUMMARY ***
Total pot 1700 | Rake 0=20
Seat 1: jbodey52 (big blind) collected (1700)
Seat 2: RealProK folded before Flop (didn't bet)
Seat 3: panth26 folded before Flop (didn't bet)
Seat 4: JSkelts folded before Flop (didn't bet)
Seat 5: PhillyisGarb folded before Flop
Seat 7: Going2Ship folded before Flop (didn't bet)
Seat 8: JJin91 (button) folded before Flop (didn't bet)
Seat 9: btd0729 (small blind) folded before Flop


*********** # 12 **************
PokerStars Hand #169432435023: Tournament #1597684021, $18.20+$1.80 USD=
 Hold'em No Limit - Level VII (100/200) - 2017/05/05 20:12:04 ET
Table '1597684021 4' 9-max Seat #9 is the button
Seat 1: jbodey52 (15145 in chips)=20
Seat 2: RealProK (4706 in chips)=20
Seat 3: panth26 (10193 in chips)=20
Seat 4: JSkelts (10110 in chips)=20
Seat 5: PhillyisGarb (7795 in chips)=20
Seat 7: Going2Ship (16843 in chips)=20
Seat 8: JJin91 (9670 in chips)=20
Seat 9: btd0729 (12615 in chips)=20
jbodey52: posts the ante 25
RealProK: posts the ante 25
panth26: posts the ante 25
JSkelts: posts the ante 25
PhillyisGarb: posts the ante 25
Going2Ship: posts the ante 25
JJin91: posts the ante 25
btd0729: posts the ante 25
jbodey52: posts small blind 100
RealProK: posts big blind 200
*** HOLE CARDS ***
Dealt to JJin91 [Qc 7d]
panth26: folds=20
JSkelts: folds=20
PhillyisGarb: raises 300 to 500
Going2Ship: folds=20
JJin91: folds=20
btd0729: calls 500
jbodey52: folds=20
RealProK: raises 4181 to 4681 and is all-in
PhillyisGarb: raises 3089 to 7770 and is all-in
btd0729: calls 7270
*** FLOP *** [7s Kh 4c]
*** TURN *** [7s Kh 4c] [As]
*** RIVER *** [7s Kh 4c As] [Js]
*** SHOW DOWN ***
PhillyisGarb: shows [Qs Ad] (a pair of Aces)
btd0729: shows [9d 9s] (a pair of Nines)
PhillyisGarb collected 6178 from side pot
RealProK: shows [Ac 5c] (a pair of Aces - lower kicker)
PhillyisGarb collected 14343 from main pot
RealProK finished the tournament in 103rd place
*** SUMMARY ***
Total pot 20521 Main pot 14343. Side pot 6178. | Rake 0=20
Board [7s Kh 4c As Js]
Seat 1: jbodey52 (small blind) folded before Flop
Seat 2: RealProK (big blind) showed [Ac 5c] and lost with a pair of Aces
Seat 3: panth26 folded before Flop (didn't bet)
Seat 4: JSkelts folded before Flop (didn't bet)
Seat 5: PhillyisGarb showed [Qs Ad] and won (20521) with a pair of Aces
Seat 7: Going2Ship folded before Flop (didn't bet)
Seat 8: JJin91 folded before Flop (didn't bet)
Seat 9: btd0729 (button) showed [9d 9s] and lost with a pair of Nines


*********** # 13 **************
PokerStars Hand #169432435184: Tournament #1597684021, $18.20+$1.80 USD=
 Hold'em No Limit - Level VII (100/200) - 2017/05/05 20:12:45 ET
Table '1597684021 4' 9-max Seat #1 is the button
Seat 1: jbodey52 (15020 in chips)=20
Seat 3: panth26 (10168 in chips)=20
Seat 4: JSkelts (10085 in chips)=20
Seat 5: PhillyisGarb (20521 in chips)=20
Seat 7: Going2Ship (16818 in chips)=20
Seat 8: JJin91 (9645 in chips)=20
Seat 9: btd0729 (4820 in chips)=20
jbodey52: posts the ante 25
panth26: posts the ante 25
JSkelts: posts the ante 25
PhillyisGarb: posts the ante 25
Going2Ship: posts the ante 25
JJin91: posts the ante 25
btd0729: posts the ante 25
panth26: posts small blind 100
JSkelts: posts big blind 200
*** HOLE CARDS ***
Dealt to JJin91 [Jc 4s]
PhillyisGarb: raises 200 to 400
Going2Ship: folds=20
JJin91: folds=20
btd0729: folds=20
jbodey52: raises 925 to 1325
panth26: folds=20
JSkelts: folds=20
btd0729 said, "ridiculous"
PhillyisGarb: calls 925
*** FLOP *** [Ts 9c Jh]
PhillyisGarb: checks=20
jbodey52: bets 1600
PhillyisGarb: folds=20
Uncalled bet (1600) returned to jbodey52
jbodey52 collected 3125 from pot
jbodey52: doesn't show hand=20
*** SUMMARY ***
Total pot 3125 | Rake 0=20
Board [Ts 9c Jh]
Seat 1: jbodey52 (button) collected (3125)
Seat 3: panth26 (small blind) folded before Flop
Seat 4: JSkelts (big blind) folded before Flop
Seat 5: PhillyisGarb folded on the Flop
Seat 7: Going2Ship folded before Flop (didn't bet)
Seat 8: JJin91 folded before Flop (didn't bet)
Seat 9: btd0729 folded before Flop (didn't bet)


*********** # 14 **************
PokerStars Hand #169432435413: Tournament #1597684021, $18.20+$1.80 USD=
 Hold'em No Limit - Level VII (100/200) - 2017/05/05 20:13:44 ET
Table '1597684021 4' 9-max Seat #3 is the button
Seat 1: jbodey52 (16795 in chips)=20
Seat 2: sunsvet7580 (10000 in chips)=20
Seat 3: panth26 (10043 in chips)=20
Seat 4: JSkelts (9860 in chips)=20
Seat 5: PhillyisGarb (19171 in chips)=20
Seat 7: Going2Ship (16793 in chips)=20
Seat 8: JJin91 (9620 in chips)=20
Seat 9: btd0729 (4795 in chips)=20
jbodey52: posts the ante 25
sunsvet7580: posts the ante 25
panth26: posts the ante 25
JSkelts: posts the ante 25
PhillyisGarb: posts the ante 25
Going2Ship: posts the ante 25
JJin91: posts the ante 25
btd0729: posts the ante 25
JSkelts: posts small blind 100
PhillyisGarb: posts big blind 200
*** HOLE CARDS ***
Dealt to JJin91 [Qs 7d]
Going2Ship: folds=20
JJin91: folds=20
btd0729: folds=20
jbodey52: raises 300 to 500
sunsvet7580: folds=20
panth26: calls 500
JSkelts: folds=20
PhillyisGarb: raises 700 to 1200
jbodey52: calls 700
panth26: calls 700
*** FLOP *** [6c Qd Kc]
PhillyisGarb: checks=20
jbodey52: checks=20
panth26: bets 1950
PhillyisGarb: folds=20
jbodey52: raises 13620 to 15570 and is all-in
panth26: folds=20
Uncalled bet (13620) returned to jbodey52
jbodey52 collected 7800 from pot
jbodey52: doesn't show hand=20
*** SUMMARY ***
Total pot 7800 | Rake 0=20
Board [6c Qd Kc]
Seat 1: jbodey52 collected (7800)
Seat 2: sunsvet7580 folded before Flop (didn't bet)
Seat 3: panth26 (button) folded on the Flop
Seat 4: JSkelts (small blind) folded before Flop
Seat 5: PhillyisGarb (big blind) folded on the Flop
Seat 7: Going2Ship folded before Flop (didn't bet)
Seat 8: JJin91 folded before Flop (didn't bet)
Seat 9: btd0729 folded before Flop (didn't bet)


*********** # 15 **************
PokerStars Hand #169432435826: Tournament #1597684021, $18.20+$1.80 USD=
 Hold'em No Limit - Level VII (100/200) - 2017/05/05 20:15:18 ET
Table '1597684021 4' 9-max Seat #4 is the button
Seat 1: jbodey52 (21420 in chips)=20
Seat 2: sunsvet7580 (9975 in chips)=20
Seat 3: panth26 (6868 in chips)=20
Seat 4: JSkelts (9735 in chips)=20
Seat 5: PhillyisGarb (17946 in chips)=20
Seat 7: Going2Ship (16768 in chips)=20
Seat 8: JJin91 (9595 in chips)=20
Seat 9: btd0729 (4770 in chips)=20
jbodey52: posts the ante 25
sunsvet7580: posts the ante 25
panth26: posts the ante 25
JSkelts: posts the ante 25
PhillyisGarb: posts the ante 25
Going2Ship: posts the ante 25
JJin91: posts the ante 25
btd0729: posts the ante 25
PhillyisGarb: posts small blind 100
Going2Ship: posts big blind 200
*** HOLE CARDS ***
Dealt to JJin91 [4d Jh]
JJin91: folds=20
btd0729: folds=20
jbodey52: folds=20
sunsvet7580: folds=20
panth26: folds=20
JSkelts: folds=20
PhillyisGarb: calls 100
Going2Ship: raises 600 to 800
PhillyisGarb: folds=20
Uncalled bet (600) returned to Going2Ship
Going2Ship collected 600 from pot
*** SUMMARY ***
Total pot 600 | Rake 0=20
Seat 1: jbodey52 folded before Flop (didn't bet)
Seat 2: sunsvet7580 folded before Flop (didn't bet)
Seat 3: panth26 folded before Flop (didn't bet)
Seat 4: JSkelts (button) folded before Flop (didn't bet)
Seat 5: PhillyisGarb (small blind) folded before Flop
Seat 7: Going2Ship (big blind) collected (600)
Seat 8: JJin91 folded before Flop (didn't bet)
Seat 9: btd0729 folded before Flop (didn't bet)


*********** # 16 **************
PokerStars Hand #169432436018: Tournament #1597684021, $18.20+$1.80 USD=
 Hold'em No Limit - Level VII (100/200) - 2017/05/05 20:16:02 ET
Table '1597684021 4' 9-max Seat #5 is the button
Seat 1: jbodey52 (21395 in chips)=20
Seat 2: sunsvet7580 (9950 in chips)=20
Seat 3: panth26 (6843 in chips)=20
Seat 4: JSkelts (9710 in chips)=20
Seat 5: PhillyisGarb (17721 in chips)=20
Seat 6: Fishstyx1958 (10000 in chips) out of hand (moved from another t=
able into small blind)
Seat 7: Going2Ship (17143 in chips)=20
Seat 8: JJin91 (9570 in chips)=20
Seat 9: btd0729 (4745 in chips)=20
jbodey52: posts the ante 25
sunsvet7580: posts the ante 25
panth26: posts the ante 25
JSkelts: posts the ante 25
PhillyisGarb: posts the ante 25
Going2Ship: posts the ante 25
JJin91: posts the ante 25
btd0729: posts the ante 25
Going2Ship: posts small blind 100
JJin91: posts big blind 200
*** HOLE CARDS ***
Dealt to JJin91 [5h Kh]
btd0729: folds=20
jbodey52: folds=20
sunsvet7580: folds=20
panth26: folds=20
JSkelts: folds=20
PhillyisGarb: raises 200 to 400
Going2Ship: folds=20
JJin91: calls 200
*** FLOP *** [7h 3c 3d]
JJin91: checks=20
PhillyisGarb: bets 550
JJin91: calls 550
*** TURN *** [7h 3c 3d] [Qd]
JJin91: checks=20
PhillyisGarb: checks=20
*** RIVER *** [7h 3c 3d Qd] [2h]
JJin91: bets 1600
PhillyisGarb: folds=20
Uncalled bet (1600) returned to JJin91
JJin91 collected 2200 from pot
JJin91: doesn't show hand=20
*** SUMMARY ***
Total pot 2200 | Rake 0=20
Board [7h 3c 3d Qd 2h]
Seat 1: jbodey52 folded before Flop (didn't bet)
Seat 2: sunsvet7580 folded before Flop (didn't bet)
Seat 3: panth26 folded before Flop (didn't bet)
Seat 4: JSkelts folded before Flop (didn't bet)
Seat 5: PhillyisGarb (button) folded on the River
Seat 7: Going2Ship (small blind) folded before Flop
Seat 8: JJin91 (big blind) collected (2200)
Seat 9: btd0729 folded before Flop (didn't bet)


*********** # 17 **************
PokerStars Hand #169432436282: Tournament #1597684021, $18.20+$1.80 USD=
 Hold'em No Limit - Level VIII (125/250) - 2017/05/05 20:17:08 ET
Table '1597684021 4' 9-max Seat #7 is the button
Seat 1: jbodey52 (21370 in chips)=20
Seat 2: sunsvet7580 (9925 in chips)=20
Seat 3: panth26 (6818 in chips)=20
Seat 4: JSkelts (9685 in chips)=20
Seat 5: PhillyisGarb (16746 in chips)=20
Seat 6: Fishstyx1958 (10000 in chips)=20
Seat 7: Going2Ship (17018 in chips)=20
Seat 8: JJin91 (10795 in chips)=20
Seat 9: btd0729 (4720 in chips)=20
jbodey52: posts the ante 30
sunsvet7580: posts the ante 30
panth26: posts the ante 30
JSkelts: posts the ante 30
PhillyisGarb: posts the ante 30
Fishstyx1958: posts the ante 30
Going2Ship: posts the ante 30
JJin91: posts the ante 30
btd0729: posts the ante 30
JJin91: posts small blind 125
btd0729: posts big blind 250
*** HOLE CARDS ***
Dealt to JJin91 [7s 4h]
jbodey52: folds=20
sunsvet7580: folds=20
panth26: folds=20
JSkelts: folds=20
PhillyisGarb: raises 250 to 500
Fishstyx1958: folds=20
Going2Ship: folds=20
JJin91: folds=20
btd0729: calls 250
*** FLOP *** [Js 4d Ad]
btd0729: checks=20
PhillyisGarb: bets 698
btd0729: folds=20
Uncalled bet (698) returned to PhillyisGarb
PhillyisGarb collected 1395 from pot
PhillyisGarb: doesn't show hand=20
*** SUMMARY ***
Total pot 1395 | Rake 0=20
Board [Js 4d Ad]
Seat 1: jbodey52 folded before Flop (didn't bet)
Seat 2: sunsvet7580 folded before Flop (didn't bet)
Seat 3: panth26 folded before Flop (didn't bet)
Seat 4: JSkelts folded before Flop (didn't bet)
Seat 5: PhillyisGarb collected (1395)
Seat 6: Fishstyx1958 folded before Flop (didn't bet)
Seat 7: Going2Ship (button) folded before Flop (didn't bet)
Seat 8: JJin91 (small blind) folded before Flop
Seat 9: btd0729 (big blind) folded on the Flop


*********** # 18 **************
PokerStars Hand #169432436571: Tournament #1597684021, $18.20+$1.80 USD=
 Hold'em No Limit - Level VIII (125/250) - 2017/05/05 20:18:12 ET
Table '1597684021 4' 9-max Seat #8 is the button
Seat 1: jbodey52 (21340 in chips)=20
Seat 2: sunsvet7580 (9895 in chips)=20
Seat 3: panth26 (6788 in chips)=20
Seat 4: JSkelts (9655 in chips)=20
Seat 5: PhillyisGarb (17611 in chips)=20
Seat 6: Fishstyx1958 (9970 in chips)=20
Seat 7: Going2Ship (16988 in chips)=20
Seat 8: JJin91 (10640 in chips)=20
Seat 9: btd0729 (4190 in chips)=20
jbodey52: posts the ante 30
sunsvet7580: posts the ante 30
panth26: posts the ante 30
JSkelts: posts the ante 30
PhillyisGarb: posts the ante 30
Fishstyx1958: posts the ante 30
Going2Ship: posts the ante 30
JJin91: posts the ante 30
btd0729: posts the ante 30
btd0729: posts small blind 125
jbodey52: posts big blind 250
*** HOLE CARDS ***
Dealt to JJin91 [5h Qs]
sunsvet7580: folds=20
panth26: folds=20
JSkelts: raises 300 to 550
PhillyisGarb: calls 550
Fishstyx1958: folds=20
Going2Ship: folds=20
JJin91: folds=20
btd0729: folds=20
jbodey52: folds=20
*** FLOP *** [6c 7c Ts]
JSkelts: bets 600
PhillyisGarb: calls 600
*** TURN *** [6c 7c Ts] [7h]
JSkelts: checks=20
PhillyisGarb: checks=20
*** RIVER *** [6c 7c Ts 7h] [8c]
JSkelts: checks=20
PhillyisGarb: checks=20
*** SHOW DOWN ***
JSkelts: shows [Ad Kc] (a pair of Sevens)
PhillyisGarb: shows [5d 5c] (two pair, Sevens and Fives)
PhillyisGarb collected 2945 from pot
*** SUMMARY ***
Total pot 2945 | Rake 0=20
Board [6c 7c Ts 7h 8c]
Seat 1: jbodey52 (big blind) folded before Flop
Seat 2: sunsvet7580 folded before Flop (didn't bet)
Seat 3: panth26 folded before Flop (didn't bet)
Seat 4: JSkelts showed [Ad Kc] and lost with a pair of Sevens
Seat 5: PhillyisGarb showed [5d 5c] and won (2945) with two pair, Seven=
s and Fives
Seat 6: Fishstyx1958 folded before Flop (didn't bet)
Seat 7: Going2Ship folded before Flop (didn't bet)
Seat 8: JJin91 (button) folded before Flop (didn't bet)
Seat 9: btd0729 (small blind) folded before Flop


*********** # 19 **************
PokerStars Hand #169432436861: Tournament #1597684021, $18.20+$1.80 USD=
 Hold'em No Limit - Level VIII (125/250) - 2017/05/05 20:19:22 ET
Table '1597684021 4' 9-max Seat #9 is the button
Seat 1: jbodey52 (21060 in chips)=20
Seat 2: sunsvet7580 (9865 in chips)=20
Seat 3: panth26 (6758 in chips)=20
Seat 4: JSkelts (8475 in chips)=20
Seat 5: PhillyisGarb (19376 in chips)=20
Seat 6: Fishstyx1958 (9940 in chips)=20
Seat 7: Going2Ship (16958 in chips)=20
Seat 8: JJin91 (10610 in chips)=20
Seat 9: btd0729 (4035 in chips)=20
jbodey52: posts the ante 30
sunsvet7580: posts the ante 30
panth26: posts the ante 30
JSkelts: posts the ante 30
PhillyisGarb: posts the ante 30
Fishstyx1958: posts the ante 30
Going2Ship: posts the ante 30
JJin91: posts the ante 30
btd0729: posts the ante 30
jbodey52: posts small blind 125
sunsvet7580: posts big blind 250
*** HOLE CARDS ***
Dealt to JJin91 [2s 2h]
panth26: folds=20
JSkelts: folds=20
PhillyisGarb: folds=20
Fishstyx1958: folds=20
Going2Ship: folds=20
JJin91: calls 250
btd0729: calls 250
jbodey52: calls 125
sunsvet7580: checks=20
*** FLOP *** [6s 7c 6d]
jbodey52: checks=20
sunsvet7580: checks=20
JJin91: checks=20
btd0729: checks=20
*** TURN *** [6s 7c 6d] [7d]
jbodey52: checks=20
sunsvet7580: checks=20
JJin91: checks=20
btd0729: checks=20
*** RIVER *** [6s 7c 6d 7d] [6c]
jbodey52: checks=20
sunsvet7580: checks=20
JJin91: checks=20
btd0729: checks=20
*** SHOW DOWN ***
jbodey52: shows [4s Ts] (a full house, Sixes full of Sevens)
sunsvet7580: shows [3c Jd] (a full house, Sixes full of Sevens)
JJin91: shows [2s 2h] (a full house, Sixes full of Sevens)
btd0729: shows [Js 8s] (a full house, Sixes full of Sevens)
jbodey52 collected 318 from pot
sunsvet7580 collected 318 from pot
JJin91 collected 317 from pot
btd0729 collected 317 from pot
*** SUMMARY ***
Total pot 1270 | Rake 0=20
Board [6s 7c 6d 7d 6c]
Seat 1: jbodey52 (small blind) showed [4s Ts] and won (318) with a full=
 house, Sixes full of Sevens
Seat 2: sunsvet7580 (big blind) showed [3c Jd] and won (318) with a ful=
l house, Sixes full of Sevens
Seat 3: panth26 folded before Flop (didn't bet)
Seat 4: JSkelts folded before Flop (didn't bet)
Seat 5: PhillyisGarb folded before Flop (didn't bet)
Seat 6: Fishstyx1958 folded before Flop (didn't bet)
Seat 7: Going2Ship folded before Flop (didn't bet)
Seat 8: JJin91 showed [2s 2h] and won (317) with a full house, Sixes fu=
ll of Sevens
Seat 9: btd0729 (button) showed [Js 8s] and won (317) with a full house=
, Sixes full of Sevens


*********** # 20 **************
PokerStars Hand #169432437261: Tournament #1597684021, $18.20+$1.80 USD=
 Hold'em No Limit - Level VIII (125/250) - 2017/05/05 20:20:54 ET
Table '1597684021 4' 9-max Seat #1 is the button
Seat 1: jbodey52 (21098 in chips)=20
Seat 2: sunsvet7580 (9903 in chips)=20
Seat 3: panth26 (6728 in chips)=20
Seat 4: JSkelts (8445 in chips)=20
Seat 6: Fishstyx1958 (9910 in chips)=20
Seat 7: Going2Ship (16928 in chips)=20
Seat 8: JJin91 (10647 in chips)=20
Seat 9: btd0729 (4072 in chips)=20
jbodey52: posts the ante 30
sunsvet7580: posts the ante 30
panth26: posts the ante 30
JSkelts: posts the ante 30
Fishstyx1958: posts the ante 30
Going2Ship: posts the ante 30
JJin91: posts the ante 30
btd0729: posts the ante 30
sunsvet7580: posts small blind 125
panth26: posts big blind 250
*** HOLE CARDS ***
Dealt to JJin91 [2c Jd]
JSkelts: folds=20
Fishstyx1958 is connected=20
Fishstyx1958: folds=20
Going2Ship: folds=20
JJin91: folds=20
btd0729: folds=20
jbodey52: calls 250
sunsvet7580: calls 125
panth26: raises 625 to 875
jbodey52: folds=20
sunsvet7580: folds=20
Uncalled bet (625) returned to panth26
panth26 collected 990 from pot
panth26: doesn't show hand=20
*** SUMMARY ***
Total pot 990 | Rake 0=20
Seat 1: jbodey52 (button) folded before Flop
Seat 2: sunsvet7580 (small blind) folded before Flop
Seat 3: panth26 (big blind) collected (990)
Seat 4: JSkelts folded before Flop (didn't bet)
Seat 6: Fishstyx1958 folded before Flop (didn't bet)
Seat 7: Going2Ship folded before Flop (didn't bet)
Seat 8: JJin91 folded before Flop (didn't bet)
Seat 9: btd0729 folded before Flop (didn't bet)


*********** # 21 **************
PokerStars Hand #169432437474: Tournament #1597684021, $18.20+$1.80 USD=
 Hold'em No Limit - Level VIII (125/250) - 2017/05/05 20:21:42 ET
Table '1597684021 4' 9-max Seat #2 is the button
Seat 1: jbodey52 (20818 in chips)=20
Seat 2: sunsvet7580 (9623 in chips)=20
Seat 3: panth26 (7438 in chips)=20
Seat 4: JSkelts (8415 in chips)=20
Seat 6: Fishstyx1958 (9880 in chips)=20
Seat 7: Going2Ship (16898 in chips)=20
Seat 8: JJin91 (10617 in chips)=20
Seat 9: btd0729 (4042 in chips)=20
jbodey52: posts the ante 30
sunsvet7580: posts the ante 30
panth26: posts the ante 30
JSkelts: posts the ante 30
Fishstyx1958: posts the ante 30
Going2Ship: posts the ante 30
JJin91: posts the ante 30
btd0729: posts the ante 30
panth26: posts small blind 125
JSkelts: posts big blind 250
*** HOLE CARDS ***
Dealt to JJin91 [5d Jc]
Fishstyx1958: folds=20
Going2Ship: folds=20
JJin91: folds=20
btd0729: raises 3762 to 4012 and is all-in
jbodey52: folds=20
sunsvet7580: folds=20
panth26: folds=20
JSkelts: folds=20
Uncalled bet (3762) returned to btd0729
btd0729 collected 865 from pot
*** SUMMARY ***
Total pot 865 | Rake 0=20
Seat 1: jbodey52 folded before Flop (didn't bet)
Seat 2: sunsvet7580 (button) folded before Flop (didn't bet)
Seat 3: panth26 (small blind) folded before Flop
Seat 4: JSkelts (big blind) folded before Flop
Seat 6: Fishstyx1958 folded before Flop (didn't bet)
Seat 7: Going2Ship folded before Flop (didn't bet)
Seat 8: JJin91 folded before Flop (didn't bet)
Seat 9: btd0729 collected (865)


*********** # 22 **************
PokerStars Hand #169432437586: Tournament #1597684021, $18.20+$1.80 USD=
 Hold'em No Limit - Level VIII (125/250) - 2017/05/05 20:22:07 ET
Table '1597684021 4' 9-max Seat #3 is the button
Seat 1: jbodey52 (20788 in chips)=20
Seat 2: sunsvet7580 (9593 in chips)=20
Seat 3: panth26 (7283 in chips)=20
Seat 4: JSkelts (8135 in chips)=20
Seat 6: Fishstyx1958 (9850 in chips)=20
Seat 7: Going2Ship (16868 in chips)=20
Seat 8: JJin91 (10587 in chips)=20
Seat 9: btd0729 (4627 in chips)=20
jbodey52: posts the ante 30
sunsvet7580: posts the ante 30
panth26: posts the ante 30
JSkelts: posts the ante 30
Fishstyx1958: posts the ante 30
Going2Ship: posts the ante 30
JJin91: posts the ante 30
btd0729: posts the ante 30
JSkelts: posts small blind 125
Fishstyx1958: posts big blind 250
*** HOLE CARDS ***
Dealt to JJin91 [Jd 3h]
Going2Ship: folds=20
JJin91: folds=20
btd0729: folds=20
jbodey52: folds=20
sunsvet7580: raises 500 to 750
panth26: folds=20
JSkelts: folds=20
Fishstyx1958: calls 500
*** FLOP *** [Qs 2s Qd]
Fishstyx1958: checks=20
sunsvet7580: bets 933
Fishstyx1958: calls 933
*** TURN *** [Qs 2s Qd] [4d]
Fishstyx1958: checks=20
sunsvet7580: checks=20
*** RIVER *** [Qs 2s Qd 4d] [3c]
Fishstyx1958: bets 500
sunsvet7580: calls 500
*** SHOW DOWN ***
Fishstyx1958: shows [7s 4s] (two pair, Queens and Fours)
sunsvet7580: shows [Kd Kc] (two pair, Kings and Queens)
sunsvet7580 collected 4731 from pot
*** SUMMARY ***
Total pot 4731 | Rake 0=20
Board [Qs 2s Qd 4d 3c]
Seat 1: jbodey52 folded before Flop (didn't bet)
Seat 2: sunsvet7580 showed [Kd Kc] and won (4731) with two pair, Kings =
and Queens
Seat 3: panth26 (button) folded before Flop (didn't bet)
Seat 4: JSkelts (small blind) folded before Flop
Seat 6: Fishstyx1958 (big blind) showed [7s 4s] and lost with two pair,=
 Queens and Fours
Seat 7: Going2Ship folded before Flop (didn't bet)
Seat 8: JJin91 folded before Flop (didn't bet)
Seat 9: btd0729 folded before Flop (didn't bet)


*********** # 23 **************
PokerStars Hand #169432437810: Tournament #1597684021, $18.20+$1.80 USD=
 Hold'em No Limit - Level VIII (125/250) - 2017/05/05 20:23:00 ET
Table '1597684021 4' 9-max Seat #4 is the button
Seat 1: jbodey52 (20758 in chips)=20
Seat 2: sunsvet7580 (12111 in chips)=20
Seat 3: panth26 (7253 in chips)=20
Seat 4: JSkelts (7980 in chips)=20
Seat 6: Fishstyx1958 (7637 in chips)=20
Seat 7: Going2Ship (16838 in chips)=20
Seat 8: JJin91 (10557 in chips)=20
Seat 9: btd0729 (4597 in chips)=20
jbodey52: posts the ante 30
sunsvet7580: posts the ante 30
panth26: posts the ante 30
JSkelts: posts the ante 30
Fishstyx1958: posts the ante 30
Going2Ship: posts the ante 30
JJin91: posts the ante 30
btd0729: posts the ante 30
Fishstyx1958: posts small blind 125
Going2Ship: posts big blind 250
*** HOLE CARDS ***
Dealt to JJin91 [3d Th]
JJin91: folds=20
btd0729: folds=20
jbodey52: folds=20
sunsvet7580: folds=20
panth26: folds=20
JSkelts: raises 300 to 550
Fishstyx1958: calls 425
Going2Ship: folds=20
*** FLOP *** [6s Kd Qc]
Fishstyx1958: checks=20
JSkelts: checks=20
*** TURN *** [6s Kd Qc] [7s]
Fishstyx1958: bets 500
JSkelts: raises 1243 to 1743
Fishstyx1958: folds=20
Uncalled bet (1243) returned to JSkelts
JSkelts collected 2590 from pot
JSkelts: doesn't show hand=20
*** SUMMARY ***
Total pot 2590 | Rake 0=20
Board [6s Kd Qc 7s]
Seat 1: jbodey52 folded before Flop (didn't bet)
Seat 2: sunsvet7580 folded before Flop (didn't bet)
Seat 3: panth26 folded before Flop (didn't bet)
Seat 4: JSkelts (button) collected (2590)
Seat 6: Fishstyx1958 (small blind) folded on the Turn
Seat 7: Going2Ship (big blind) folded before Flop
Seat 8: JJin91 folded before Flop (didn't bet)
Seat 9: btd0729 folded before Flop (didn't bet)


*********** # 24 **************
PokerStars Hand #169432438023: Tournament #1597684021, $18.20+$1.80 USD=
 Hold'em No Limit - Level VIII (125/250) - 2017/05/05 20:23:51 ET
Table '1597684021 4' 9-max Seat #6 is the button
Seat 1: jbodey52 (20728 in chips)=20
Seat 2: sunsvet7580 (12081 in chips)=20
Seat 3: panth26 (7223 in chips)=20
Seat 4: JSkelts (9490 in chips)=20
Seat 6: Fishstyx1958 (6557 in chips)=20
Seat 7: Going2Ship (16558 in chips)=20
Seat 8: JJin91 (10527 in chips)=20
Seat 9: btd0729 (4567 in chips)=20
jbodey52: posts the ante 30
sunsvet7580: posts the ante 30
panth26: posts the ante 30
JSkelts: posts the ante 30
Fishstyx1958: posts the ante 30
Going2Ship: posts the ante 30
JJin91: posts the ante 30
btd0729: posts the ante 30
Going2Ship: posts small blind 125
JJin91: posts big blind 250
*** HOLE CARDS ***
Dealt to JJin91 [5h 7d]
btd0729: folds=20
jbodey52: raises 375 to 625
sunsvet7580: folds=20
panth26: folds=20
JSkelts: folds=20
Fishstyx1958: folds=20
Going2Ship: folds=20
JJin91: folds=20
Uncalled bet (375) returned to jbodey52
jbodey52 collected 865 from pot
jbodey52: doesn't show hand=20
*** SUMMARY ***
Total pot 865 | Rake 0=20
Seat 1: jbodey52 collected (865)
Seat 2: sunsvet7580 folded before Flop (didn't bet)
Seat 3: panth26 folded before Flop (didn't bet)
Seat 4: JSkelts folded before Flop (didn't bet)
Seat 6: Fishstyx1958 (button) folded before Flop (didn't bet)
Seat 7: Going2Ship (small blind) folded before Flop
Seat 8: JJin91 (big blind) folded before Flop
Seat 9: btd0729 folded before Flop (didn't bet)


*********** # 25 **************
PokerStars Hand #169432438252: Tournament #1597684021, $18.20+$1.80 USD=
 Hold'em No Limit - Level VIII (125/250) - 2017/05/05 20:24:41 ET
Table '1597684021 4' 9-max Seat #7 is the button
Seat 1: jbodey52 (21313 in chips)=20
Seat 2: sunsvet7580 (12051 in chips)=20
Seat 3: panth26 (7193 in chips)=20
Seat 4: JSkelts (9460 in chips)=20
Seat 6: Fishstyx1958 (6527 in chips)=20
Seat 7: Going2Ship (16403 in chips)=20
Seat 8: JJin91 (10247 in chips)=20
Seat 9: btd0729 (4537 in chips)=20
jbodey52: posts the ante 30
sunsvet7580: posts the ante 30
panth26: posts the ante 30
JSkelts: posts the ante 30
Fishstyx1958: posts the ante 30
Going2Ship: posts the ante 30
JJin91: posts the ante 30
btd0729: posts the ante 30
JJin91: posts small blind 125
btd0729: posts big blind 250
*** HOLE CARDS ***
Dealt to JJin91 [2s 8s]
jbodey52: folds=20
sunsvet7580: folds=20
panth26: folds=20
JSkelts: folds=20
Fishstyx1958: folds=20
Going2Ship: folds=20
JJin91: calls 125
btd0729: checks=20
*** FLOP *** [9c Qh 4h]
JJin91: bets 392
btd0729: folds=20
Uncalled bet (392) returned to JJin91
JJin91 collected 740 from pot
JJin91: doesn't show hand=20
*** SUMMARY ***
Total pot 740 | Rake 0=20
Board [9c Qh 4h]
Seat 1: jbodey52 folded before Flop (didn't bet)
Seat 2: sunsvet7580 folded before Flop (didn't bet)
Seat 3: panth26 folded before Flop (didn't bet)
Seat 4: JSkelts folded before Flop (didn't bet)
Seat 6: Fishstyx1958 folded before Flop (didn't bet)
Seat 7: Going2Ship (button) folded before Flop (didn't bet)
Seat 8: JJin91 (small blind) collected (740)
Seat 9: btd0729 (big blind) folded on the Flop


*********** # 26 **************
PokerStars Hand #169432438385: Tournament #1597684021, $18.20+$1.80 USD=
 Hold'em No Limit - Level VIII (125/250) - 2017/05/05 20:25:11 ET
Table '1597684021 4' 9-max Seat #8 is the button
Seat 1: jbodey52 (21283 in chips)=20
Seat 2: sunsvet7580 (12021 in chips)=20
Seat 3: panth26 (7163 in chips)=20
Seat 4: JSkelts (9430 in chips)=20
Seat 6: Fishstyx1958 (6497 in chips)=20
Seat 7: Going2Ship (16373 in chips)=20
Seat 8: JJin91 (10707 in chips)=20
Seat 9: btd0729 (4257 in chips)=20
jbodey52: posts the ante 30
sunsvet7580: posts the ante 30
panth26: posts the ante 30
JSkelts: posts the ante 30
Fishstyx1958: posts the ante 30
Going2Ship: posts the ante 30
JJin91: posts the ante 30
btd0729: posts the ante 30
btd0729: posts small blind 125
jbodey52: posts big blind 250
*** HOLE CARDS ***
Dealt to JJin91 [Ad 6d]
sunsvet7580: folds=20
panth26: folds=20
JSkelts: folds=20
Fishstyx1958: folds=20
Going2Ship: folds=20
JJin91: raises 277 to 527
btd0729: raises 3700 to 4227 and is all-in
jbodey52: folds=20
JJin91: calls 3700
*** FLOP *** [Qd 9d 8h]
*** TURN *** [Qd 9d 8h] [9h]
*** RIVER *** [Qd 9d 8h 9h] [Ts]
*** SHOW DOWN ***
btd0729: shows [Tc Td] (a full house, Tens full of Nines)
JJin91: shows [Ad 6d] (a pair of Nines)
btd0729 collected 8944 from pot
*** SUMMARY ***
Total pot 8944 | Rake 0=20
Board [Qd 9d 8h 9h Ts]
Seat 1: jbodey52 (big blind) folded before Flop
Seat 2: sunsvet7580 folded before Flop (didn't bet)
Seat 3: panth26 folded before Flop (didn't bet)
Seat 4: JSkelts folded before Flop (didn't bet)
Seat 6: Fishstyx1958 folded before Flop (didn't bet)
Seat 7: Going2Ship folded before Flop (didn't bet)
Seat 8: JJin91 (button) showed [Ad 6d] and lost with a pair of Nines
Seat 9: btd0729 (small blind) showed [Tc Td] and won (8944) with a full=
 house, Tens full of Nines


*********** # 27 **************
PokerStars Hand #169432438573: Tournament #1597684021, $18.20+$1.80 USD=
 Hold'em No Limit - Level VIII (125/250) - 2017/05/05 20:25:55 ET
Table '1597684021 4' 9-max Seat #9 is the button
Seat 1: jbodey52 (21003 in chips)=20
Seat 2: sunsvet7580 (11991 in chips)=20
Seat 3: panth26 (7133 in chips)=20
Seat 4: JSkelts (9400 in chips)=20
Seat 6: Fishstyx1958 (6467 in chips)=20
Seat 7: Going2Ship (16343 in chips)=20
Seat 8: JJin91 (6450 in chips)=20
Seat 9: btd0729 (8944 in chips)=20
jbodey52: posts the ante 30
sunsvet7580: posts the ante 30
panth26: posts the ante 30
JSkelts: posts the ante 30
Fishstyx1958: posts the ante 30
Going2Ship: posts the ante 30
JJin91: posts the ante 30
btd0729: posts the ante 30
jbodey52: posts small blind 125
sunsvet7580: posts big blind 250
*** HOLE CARDS ***
Dealt to JJin91 [6c 5c]
panth26: folds=20
JSkelts: folds=20
Fishstyx1958: folds=20
Going2Ship: raises 350 to 600
JJin91: calls 600
btd0729: folds=20
jbodey52: folds=20
sunsvet7580: calls 350
*** FLOP *** [9c Jh 3d]
sunsvet7580: bets 1083
Going2Ship: folds=20
JJin91: folds=20
Uncalled bet (1083) returned to sunsvet7580
sunsvet7580 collected 2165 from pot
sunsvet7580: doesn't show hand=20
*** SUMMARY ***
Total pot 2165 | Rake 0=20
Board [9c Jh 3d]
Seat 1: jbodey52 (small blind) folded before Flop
Seat 2: sunsvet7580 (big blind) collected (2165)
Seat 3: panth26 folded before Flop (didn't bet)
Seat 4: JSkelts folded before Flop (didn't bet)
Seat 6: Fishstyx1958 folded before Flop (didn't bet)
Seat 7: Going2Ship folded on the Flop
Seat 8: JJin91 folded on the Flop
Seat 9: btd0729 (button) folded before Flop (didn't bet)


*********** # 28 **************
PokerStars Hand #169432438820: Tournament #1597684021, $18.20+$1.80 USD=
 Hold'em No Limit - Level IX (150/300) - 2017/05/05 20:26:53 ET
Table '1597684021 4' 9-max Seat #1 is the button
Seat 1: jbodey52 (20848 in chips)=20
Seat 2: sunsvet7580 (13526 in chips)=20
Seat 3: panth26 (7103 in chips)=20
Seat 4: JSkelts (9370 in chips)=20
Seat 5: smitheea (10000 in chips)=20
Seat 6: Fishstyx1958 (6437 in chips)=20
Seat 7: Going2Ship (15713 in chips)=20
Seat 8: JJin91 (5820 in chips)=20
Seat 9: btd0729 (8914 in chips)=20
jbodey52: posts the ante 40
sunsvet7580: posts the ante 40
panth26: posts the ante 40
JSkelts: posts the ante 40
smitheea: posts the ante 40
Fishstyx1958: posts the ante 40
Going2Ship: posts the ante 40
JJin91: posts the ante 40
btd0729: posts the ante 40
sunsvet7580: posts small blind 150
panth26: posts big blind 300
*** HOLE CARDS ***
Dealt to JJin91 [4s 8c]
JSkelts: folds=20
smitheea: raises 600 to 900
Fishstyx1958: folds=20
Going2Ship: folds=20
JJin91: folds=20
btd0729: folds=20
jbodey52: folds=20
sunsvet7580: folds=20
panth26: folds=20
Uncalled bet (600) returned to smitheea
smitheea collected 1110 from pot
smitheea: doesn't show hand=20
*** SUMMARY ***
Total pot 1110 | Rake 0=20
Seat 1: jbodey52 (button) folded before Flop (didn't bet)
Seat 2: sunsvet7580 (small blind) folded before Flop
Seat 3: panth26 (big blind) folded before Flop
Seat 4: JSkelts folded before Flop (didn't bet)
Seat 5: smitheea collected (1110)
Seat 6: Fishstyx1958 folded before Flop (didn't bet)
Seat 7: Going2Ship folded before Flop (didn't bet)
Seat 8: JJin91 folded before Flop (didn't bet)
Seat 9: btd0729 folded before Flop (didn't bet)


*********** # 29 **************
PokerStars Hand #169432438962: Tournament #1597684021, $18.20+$1.80 USD=
 Hold'em No Limit - Level IX (150/300) - 2017/05/05 20:27:24 ET
Table '1597684021 4' 9-max Seat #2 is the button
Seat 1: jbodey52 (20808 in chips)=20
Seat 2: sunsvet7580 (13336 in chips)=20
Seat 3: panth26 (6763 in chips)=20
Seat 4: JSkelts (9330 in chips)=20
Seat 5: smitheea (10770 in chips)=20
Seat 6: Fishstyx1958 (6397 in chips)=20
Seat 7: Going2Ship (15673 in chips)=20
Seat 8: JJin91 (5780 in chips)=20
Seat 9: btd0729 (8874 in chips)=20
jbodey52: posts the ante 40
sunsvet7580: posts the ante 40
panth26: posts the ante 40
JSkelts: posts the ante 40
smitheea: posts the ante 40
Fishstyx1958: posts the ante 40
Going2Ship: posts the ante 40
JJin91: posts the ante 40
btd0729: posts the ante 40
panth26: posts small blind 150
JSkelts: posts big blind 300
*** HOLE CARDS ***
Dealt to JJin91 [9c Ks]
smitheea: folds=20
Fishstyx1958: folds=20
Going2Ship: folds=20
JJin91: folds=20
btd0729: folds=20
jbodey52: raises 450 to 750
sunsvet7580: calls 750
panth26: folds=20
JSkelts: calls 450
*** FLOP *** [5d 4c 7c]
JSkelts: checks=20
jbodey52: bets 999
sunsvet7580: calls 999
JSkelts: folds=20
*** TURN *** [5d 4c 7c] [6c]
jbodey52: bets 2379
sunsvet7580: folds=20
Uncalled bet (2379) returned to jbodey52
jbodey52 collected 4758 from pot
jbodey52: doesn't show hand=20
*** SUMMARY ***
Total pot 4758 | Rake 0=20
Board [5d 4c 7c 6c]
Seat 1: jbodey52 collected (4758)
Seat 2: sunsvet7580 (button) folded on the Turn
Seat 3: panth26 (small blind) folded before Flop
Seat 4: JSkelts (big blind) folded on the Flop
Seat 5: smitheea folded before Flop (didn't bet)
Seat 6: Fishstyx1958 folded before Flop (didn't bet)
Seat 7: Going2Ship folded before Flop (didn't bet)
Seat 8: JJin91 folded before Flop (didn't bet)
Seat 9: btd0729 folded before Flop (didn't bet)


*********** # 30 **************
PokerStars Hand #169432439299: Tournament #1597684021, $18.20+$1.80 USD=
 Hold'em No Limit - Level IX (150/300) - 2017/05/05 20:28:39 ET
Table '1597684021 4' 9-max Seat #3 is the button
Seat 1: jbodey52 (23777 in chips)=20
Seat 2: sunsvet7580 (11547 in chips)=20
Seat 3: panth26 (6573 in chips)=20
Seat 4: JSkelts (8540 in chips)=20
Seat 5: smitheea (10730 in chips)=20
Seat 6: Fishstyx1958 (6357 in chips)=20
Seat 7: Going2Ship (15633 in chips)=20
Seat 8: JJin91 (5740 in chips)=20
Seat 9: btd0729 (8834 in chips)=20
jbodey52: posts the ante 40
sunsvet7580: posts the ante 40
panth26: posts the ante 40
JSkelts: posts the ante 40
smitheea: posts the ante 40
Fishstyx1958: posts the ante 40
Going2Ship: posts the ante 40
JJin91: posts the ante 40
btd0729: posts the ante 40
JSkelts: posts small blind 150
smitheea: posts big blind 300
*** HOLE CARDS ***
Dealt to JJin91 [7s 2c]
Fishstyx1958: folds=20
Going2Ship: folds=20
JJin91: folds=20
btd0729: calls 300
jbodey52: folds=20
sunsvet7580: raises 300 to 600
panth26: folds=20
JSkelts: folds=20
smitheea: folds=20
btd0729: calls 300
*** FLOP *** [3c 9s Td]
btd0729: checks=20
sunsvet7580: bets 1005
btd0729: folds=20
Uncalled bet (1005) returned to sunsvet7580
sunsvet7580 collected 2010 from pot
sunsvet7580: doesn't show hand=20
*** SUMMARY ***
Total pot 2010 | Rake 0=20
Board [3c 9s Td]
Seat 1: jbodey52 folded before Flop (didn't bet)
Seat 2: sunsvet7580 collected (2010)
Seat 3: panth26 (button) folded before Flop (didn't bet)
Seat 4: JSkelts (small blind) folded before Flop
Seat 5: smitheea (big blind) folded before Flop
Seat 6: Fishstyx1958 folded before Flop (didn't bet)
Seat 7: Going2Ship folded before Flop (didn't bet)
Seat 8: JJin91 folded before Flop (didn't bet)
Seat 9: btd0729 folded on the Flop


*********** # 31 **************
PokerStars Hand #169432439521: Tournament #1597684021, $18.20+$1.80 USD=
 Hold'em No Limit - Level IX (150/300) - 2017/05/05 20:29:33 ET
Table '1597684021 4' 9-max Seat #4 is the button
Seat 1: jbodey52 (23737 in chips)=20
Seat 2: sunsvet7580 (12917 in chips)=20
Seat 3: panth26 (6533 in chips)=20
Seat 4: JSkelts (8350 in chips)=20
Seat 5: smitheea (10390 in chips)=20
Seat 6: Fishstyx1958 (6317 in chips)=20
Seat 7: Going2Ship (15593 in chips)=20
Seat 8: JJin91 (5700 in chips)=20
Seat 9: btd0729 (8194 in chips)=20
jbodey52: posts the ante 40
sunsvet7580: posts the ante 40
panth26: posts the ante 40
JSkelts: posts the ante 40
smitheea: posts the ante 40
Fishstyx1958: posts the ante 40
Going2Ship: posts the ante 40
JJin91: posts the ante 40
btd0729: posts the ante 40
smitheea: posts small blind 150
Fishstyx1958: posts big blind 300
*** HOLE CARDS ***
Dealt to JJin91 [Ah Qh]
Going2Ship: folds=20
JJin91: raises 423 to 723
btd0729: folds=20
jbodey52: folds=20
sunsvet7580: folds=20
panth26: calls 723
JSkelts: folds=20
smitheea: folds=20
Fishstyx1958: calls 423
*** FLOP *** [5h Jc Td]
Fishstyx1958: checks=20
JJin91: bets 1500
panth26: calls 1500
Fishstyx1958: folds=20
*** TURN *** [5h Jc Td] [Kc]
JJin91: checks=20
panth26: bets 4270 and is all-in
JJin91: calls 3437 and is all-in
Uncalled bet (833) returned to panth26
*** RIVER *** [5h Jc Td Kc] [8h]
*** SHOW DOWN ***
JJin91: shows [Ah Qh] (a straight, Ten to Ace)
panth26: shows [Ks Ad] (a pair of Kings)
JJin91 collected 12553 from pot
*** SUMMARY ***
Total pot 12553 | Rake 0=20
Board [5h Jc Td Kc 8h]
Seat 1: jbodey52 folded before Flop (didn't bet)
Seat 2: sunsvet7580 folded before Flop (didn't bet)
Seat 3: panth26 showed [Ks Ad] and lost with a pair of Kings
Seat 4: JSkelts (button) folded before Flop (didn't bet)
Seat 5: smitheea (small blind) folded before Flop
Seat 6: Fishstyx1958 (big blind) folded on the Flop
Seat 7: Going2Ship folded before Flop (didn't bet)
Seat 8: JJin91 showed [Ah Qh] and won (12553) with a straight, Ten to A=
ce
Seat 9: btd0729 folded before Flop (didn't bet)


*********** # 32 **************
PokerStars Hand #169432439749: Tournament #1597684021, $18.20+$1.80 USD=
 Hold'em No Limit - Level IX (150/300) - 2017/05/05 20:30:26 ET
Table '1597684021 4' 9-max Seat #5 is the button
Seat 1: jbodey52 (23697 in chips)=20
Seat 2: sunsvet7580 (12877 in chips)=20
Seat 3: panth26 (833 in chips)=20
Seat 4: JSkelts (8310 in chips)=20
Seat 5: smitheea (10200 in chips)=20
Seat 6: Fishstyx1958 (5554 in chips)=20
Seat 7: Going2Ship (15553 in chips)=20
Seat 8: JJin91 (12553 in chips)=20
Seat 9: btd0729 (8154 in chips)=20
jbodey52: posts the ante 40
sunsvet7580: posts the ante 40
panth26: posts the ante 40
JSkelts: posts the ante 40
smitheea: posts the ante 40
Fishstyx1958: posts the ante 40
Going2Ship: posts the ante 40
JJin91: posts the ante 40
btd0729: posts the ante 40
Fishstyx1958: posts small blind 150
Going2Ship: posts big blind 300
*** HOLE CARDS ***
Dealt to JJin91 [Js 4s]
JJin91: folds=20
btd0729: folds=20
jbodey52: folds=20
sunsvet7580: raises 300 to 600
panth26: folds=20
JSkelts: folds=20
smitheea: folds=20
Fishstyx1958: folds=20
Going2Ship: calls 300
*** FLOP *** [Ts Qc Kc]
Going2Ship: checks=20
sunsvet7580: bets 855
Going2Ship: calls 855
*** TURN *** [Ts Qc Kc] [Kh]
Going2Ship: checks=20
sunsvet7580: checks=20
*** RIVER *** [Ts Qc Kc Kh] [Th]
Going2Ship: bets 2400
sunsvet7580: raises 8220 to 10620
Going2Ship: calls 8220
*** SHOW DOWN ***
sunsvet7580: shows [Ks Qd] (a full house, Kings full of Queens)
Going2Ship: mucks hand=20
sunsvet7580 collected 24660 from pot
*** SUMMARY ***
Total pot 24660 | Rake 0=20
Board [Ts Qc Kc Kh Th]
Seat 1: jbodey52 folded before Flop (didn't bet)
Seat 2: sunsvet7580 showed [Ks Qd] and won (24660) with a full house, K=
ings full of Queens
Seat 3: panth26 folded before Flop (didn't bet)
Seat 4: JSkelts folded before Flop (didn't bet)
Seat 5: smitheea (button) folded before Flop (didn't bet)
Seat 6: Fishstyx1958 (small blind) folded before Flop
Seat 7: Going2Ship (big blind) mucked [Ad Tc]
Seat 8: JJin91 folded before Flop (didn't bet)
Seat 9: btd0729 folded before Flop (didn't bet)


*********** # 33 **************
PokerStars Hand #169437434199: Tournament #1597684021, $18.20+$1.80 USD=
 Hold'em No Limit - Level IX (150/300) - 2017/05/05 20:32:08 ET
Table '1597684021 4' 9-max Seat #6 is the button
Seat 1: jbodey52 (23657 in chips)=20
Seat 2: sunsvet7580 (25422 in chips)=20
Seat 3: panth26 (793 in chips)=20
Seat 4: JSkelts (8270 in chips)=20
Seat 5: smitheea (10160 in chips)=20
Seat 6: Fishstyx1958 (5364 in chips)=20
Seat 7: Going2Ship (3438 in chips)=20
Seat 8: JJin91 (12513 in chips)=20
jbodey52: posts the ante 40
sunsvet7580: posts the ante 40
panth26: posts the ante 40
JSkelts: posts the ante 40
smitheea: posts the ante 40
Fishstyx1958: posts the ante 40
Going2Ship: posts the ante 40
JJin91: posts the ante 40
Going2Ship: posts small blind 150
JJin91: posts big blind 300
*** HOLE CARDS ***
Dealt to JJin91 [6d Kd]
jbodey52: calls 300
sunsvet7580: folds=20
panth26: folds=20
JSkelts: folds=20
smitheea: folds=20
Fishstyx1958: folds=20
Going2Ship: raises 3098 to 3398 and is all-in
JJin91: folds=20
jbodey52: calls 3098
*** FLOP *** [2c 7s 7h]
*** TURN *** [2c 7s 7h] [As]
*** RIVER *** [2c 7s 7h As] [Ad]
*** SHOW DOWN ***
Going2Ship: shows [8d 8h] (two pair, Aces and Eights)
jbodey52: shows [Ks Js] (two pair, Aces and Sevens)
Going2Ship collected 7416 from pot
*** SUMMARY ***
Total pot 7416 | Rake 0=20
Board [2c 7s 7h As Ad]
Seat 1: jbodey52 showed [Ks Js] and lost with two pair, Aces and Sevens
Seat 2: sunsvet7580 folded before Flop (didn't bet)
Seat 3: panth26 folded before Flop (didn't bet)
Seat 4: JSkelts folded before Flop (didn't bet)
Seat 5: smitheea folded before Flop (didn't bet)
Seat 6: Fishstyx1958 (button) folded before Flop (didn't bet)
Seat 7: Going2Ship (small blind) showed [8d 8h] and won (7416) with two=
 pair, Aces and Eights
Seat 8: JJin91 (big blind) folded before Flop


*********** # 34 **************
PokerStars Hand #169437434418: Tournament #1597684021, $18.20+$1.80 USD=
 Hold'em No Limit - Level IX (150/300) - 2017/05/05 20:32:54 ET
Table '1597684021 4' 9-max Seat #7 is the button
Seat 1: jbodey52 (20219 in chips)=20
Seat 2: sunsvet7580 (25382 in chips)=20
Seat 3: panth26 (753 in chips)=20
Seat 4: JSkelts (8230 in chips)=20
Seat 5: smitheea (10120 in chips)=20
Seat 6: Fishstyx1958 (5324 in chips)=20
Seat 7: Going2Ship (7416 in chips)=20
Seat 8: JJin91 (12173 in chips)=20
jbodey52: posts the ante 40
sunsvet7580: posts the ante 40
panth26: posts the ante 40
JSkelts: posts the ante 40
smitheea: posts the ante 40
Fishstyx1958: posts the ante 40
Going2Ship: posts the ante 40
JJin91: posts the ante 40
JJin91: posts small blind 150
jbodey52: posts big blind 300
*** HOLE CARDS ***
Dealt to JJin91 [8c 3h]
sunsvet7580: folds=20
panth26: folds=20
JSkelts: folds=20
smitheea: folds=20
Fishstyx1958: calls 300
Going2Ship: folds=20
JJin91: folds=20
jbodey52: checks=20
*** FLOP *** [7d 2h 8s]
jbodey52: bets 450
Fishstyx1958: raises 4534 to 4984 and is all-in
jbodey52: calls 4534
*** TURN *** [7d 2h 8s] [Ad]
*** RIVER *** [7d 2h 8s Ad] [3s]
*** SHOW DOWN ***
jbodey52: shows [7s Qs] (a pair of Sevens)
Fishstyx1958: shows [8d Td] (a pair of Eights)
Fishstyx1958 collected 11038 from pot
*** SUMMARY ***
Total pot 11038 | Rake 0=20
Board [7d 2h 8s Ad 3s]
Seat 1: jbodey52 (big blind) showed [7s Qs] and lost with a pair of Sev=
ens
Seat 2: sunsvet7580 folded before Flop (didn't bet)
Seat 3: panth26 folded before Flop (didn't bet)
Seat 4: JSkelts folded before Flop (didn't bet)
Seat 5: smitheea folded before Flop (didn't bet)
Seat 6: Fishstyx1958 showed [8d Td] and won (11038) with a pair of Eigh=
ts
Seat 7: Going2Ship (button) folded before Flop (didn't bet)
Seat 8: JJin91 (small blind) folded before Flop


*********** # 35 **************
PokerStars Hand #169437434591: Tournament #1597684021, $18.20+$1.80 USD=
 Hold'em No Limit - Level IX (150/300) - 2017/05/05 20:33:30 ET
Table '1597684021 4' 9-max Seat #8 is the button
Seat 1: jbodey52 (14895 in chips)=20
Seat 2: sunsvet7580 (25342 in chips)=20
Seat 3: panth26 (713 in chips)=20
Seat 4: JSkelts (8190 in chips)=20
Seat 5: smitheea (10080 in chips)=20
Seat 6: Fishstyx1958 (11038 in chips)=20
Seat 7: Going2Ship (7376 in chips)=20
Seat 8: JJin91 (11983 in chips)=20
jbodey52: posts the ante 40
sunsvet7580: posts the ante 40
panth26: posts the ante 40
JSkelts: posts the ante 40
smitheea: posts the ante 40
Fishstyx1958: posts the ante 40
Going2Ship: posts the ante 40
JJin91: posts the ante 40
jbodey52: posts small blind 150
sunsvet7580: posts big blind 300
*** HOLE CARDS ***
Dealt to JJin91 [Ac As]
panth26: raises 373 to 673 and is all-in
JSkelts: folds=20
smitheea: folds=20
Fishstyx1958: folds=20
Going2Ship: folds=20
JJin91: calls 673
jbodey52: folds=20
sunsvet7580: folds=20
*** FLOP *** [Jh 6s 4d]
*** TURN *** [Jh 6s 4d] [3c]
*** RIVER *** [Jh 6s 4d 3c] [4c]
*** SHOW DOWN ***
panth26: shows [Ah 9h] (a pair of Fours)
JJin91: shows [Ac As] (two pair, Aces and Fours)
JJin91 collected 2116 from pot
panth26 finished the tournament in 85th place
*** SUMMARY ***
Total pot 2116 | Rake 0=20
Board [Jh 6s 4d 3c 4c]
Seat 1: jbodey52 (small blind) folded before Flop
Seat 2: sunsvet7580 (big blind) folded before Flop
Seat 3: panth26 showed [Ah 9h] and lost with a pair of Fours
Seat 4: JSkelts folded before Flop (didn't bet)
Seat 5: smitheea folded before Flop (didn't bet)
Seat 6: Fishstyx1958 folded before Flop (didn't bet)
Seat 7: Going2Ship folded before Flop (didn't bet)
Seat 8: JJin91 (button) showed [Ac As] and won (2116) with two pair, Ac=
es and Fours


*********** # 36 **************
PokerStars Hand #169437434752: Tournament #1597684021, $18.20+$1.80 USD=
 Hold'em No Limit - Level IX (150/300) - 2017/05/05 20:34:01 ET
Table '1597684021 4' 9-max Seat #1 is the button
Seat 1: jbodey52 (14705 in chips)=20
Seat 2: sunsvet7580 (25002 in chips)=20
Seat 4: JSkelts (8150 in chips)=20
Seat 5: smitheea (10040 in chips)=20
Seat 6: Fishstyx1958 (10998 in chips)=20
Seat 7: Going2Ship (7336 in chips)=20
Seat 8: JJin91 (13386 in chips)=20
jbodey52: posts the ante 40
sunsvet7580: posts the ante 40
JSkelts: posts the ante 40
smitheea: posts the ante 40
Fishstyx1958: posts the ante 40
Going2Ship: posts the ante 40
JJin91: posts the ante 40
sunsvet7580: posts small blind 150
JSkelts: posts big blind 300
*** HOLE CARDS ***
Dealt to JJin91 [6c Ah]
smitheea: folds=20
Fishstyx1958: folds=20
Going2Ship: folds=20
JJin91: raises 333 to 633
jbodey52: raises 1917 to 2550
sunsvet7580: folds=20
JSkelts: calls 2250
JJin91: folds=20
*** FLOP *** [Qd 4h Ts]
JSkelts: checks=20
jbodey52: bets 12115 and is all-in
JSkelts: calls 5560 and is all-in
Uncalled bet (6555) returned to jbodey52
*** TURN *** [Qd 4h Ts] [9c]
*** RIVER *** [Qd 4h Ts 9c] [2h]
*** SHOW DOWN ***
JSkelts: shows [Kc Kd] (a pair of Kings)
jbodey52: shows [6s 6h] (a pair of Sixes)
JSkelts collected 17283 from pot
*** SUMMARY ***
Total pot 17283 | Rake 0=20
Board [Qd 4h Ts 9c 2h]
Seat 1: jbodey52 (button) showed [6s 6h] and lost with a pair of Sixes
Seat 2: sunsvet7580 (small blind) folded before Flop
Seat 4: JSkelts (big blind) showed [Kc Kd] and won (17283) with a pair =
of Kings
Seat 5: smitheea folded before Flop (didn't bet)
Seat 6: Fishstyx1958 folded before Flop (didn't bet)
Seat 7: Going2Ship folded before Flop (didn't bet)
Seat 8: JJin91 folded before Flop


*********** # 37 **************
PokerStars Hand #169437434945: Tournament #1597684021, $18.20+$1.80 USD=
 Hold'em No Limit - Level IX (150/300) - 2017/05/05 20:34:44 ET
Table '1597684021 4' 9-max Seat #2 is the button
Seat 1: jbodey52 (6555 in chips)=20
Seat 2: sunsvet7580 (24812 in chips)=20
Seat 4: JSkelts (17283 in chips)=20
Seat 5: smitheea (10000 in chips)=20
Seat 6: Fishstyx1958 (10958 in chips)=20
Seat 7: Going2Ship (7296 in chips)=20
Seat 8: JJin91 (12713 in chips)=20
jbodey52: posts the ante 40
sunsvet7580: posts the ante 40
JSkelts: posts the ante 40
smitheea: posts the ante 40
Fishstyx1958: posts the ante 40
Going2Ship: posts the ante 40
JJin91: posts the ante 40
JSkelts: posts small blind 150
smitheea: posts big blind 300
*** HOLE CARDS ***
Dealt to JJin91 [2d As]
Fishstyx1958: raises 600 to 900
Going2Ship: folds=20
JJin91: folds=20
jbodey52: folds=20
sunsvet7580 is disconnected=20
sunsvet7580 is connected=20
sunsvet7580: folds=20
JSkelts: folds=20
smitheea: calls 600
*** FLOP *** [Qc Kd Js]
smitheea: checks=20
Fishstyx1958: bets 10018 and is all-in
smitheea: folds=20
Uncalled bet (10018) returned to Fishstyx1958
Fishstyx1958 collected 2230 from pot
Fishstyx1958: doesn't show hand=20
*** SUMMARY ***
Total pot 2230 | Rake 0=20
Board [Qc Kd Js]
Seat 1: jbodey52 folded before Flop (didn't bet)
Seat 2: sunsvet7580 (button) folded before Flop (didn't bet)
Seat 4: JSkelts (small blind) folded before Flop
Seat 5: smitheea (big blind) folded on the Flop
Seat 6: Fishstyx1958 collected (2230)
Seat 7: Going2Ship folded before Flop (didn't bet)
Seat 8: JJin91 folded before Flop (didn't bet)


*********** # 38 **************
PokerStars Hand #169437435149: Tournament #1597684021, $18.20+$1.80 USD=
 Hold'em No Limit - Level IX (150/300) - 2017/05/05 20:35:29 ET
Table '1597684021 4' 9-max Seat #4 is the button
Seat 1: jbodey52 (6515 in chips)=20
Seat 2: sunsvet7580 (24772 in chips)=20
Seat 4: JSkelts (17093 in chips)=20
Seat 5: smitheea (9060 in chips)=20
Seat 6: Fishstyx1958 (12248 in chips)=20
Seat 7: Going2Ship (7256 in chips)=20
Seat 8: JJin91 (12673 in chips)=20
jbodey52: posts the ante 40
sunsvet7580: posts the ante 40
JSkelts: posts the ante 40
smitheea: posts the ante 40
Fishstyx1958: posts the ante 40
Going2Ship: posts the ante 40
JJin91: posts the ante 40
smitheea: posts small blind 150
Fishstyx1958: posts big blind 300
*** HOLE CARDS ***
Dealt to JJin91 [Th 9c]
Going2Ship: folds=20
JJin91: folds=20
jbodey52: folds=20
sunsvet7580: folds=20
JSkelts: raises 360 to 660
smitheea: folds=20
Fishstyx1958: raises 11548 to 12208 and is all-in
JSkelts: folds=20
Uncalled bet (11548) returned to Fishstyx1958
Fishstyx1958 collected 1750 from pot
Fishstyx1958: doesn't show hand=20
*** SUMMARY ***
Total pot 1750 | Rake 0=20
Seat 1: jbodey52 folded before Flop (didn't bet)
Seat 2: sunsvet7580 folded before Flop (didn't bet)
Seat 4: JSkelts (button) folded before Flop
Seat 5: smitheea (small blind) folded before Flop
Seat 6: Fishstyx1958 (big blind) collected (1750)
Seat 7: Going2Ship folded before Flop (didn't bet)
Seat 8: JJin91 folded before Flop (didn't bet)


*********** # 39 **************
PokerStars Hand #169437435314: Tournament #1597684021, $18.20+$1.80 USD=
 Hold'em No Limit - Level IX (150/300) - 2017/05/05 20:36:06 ET
Table '1597684021 4' 9-max Seat #5 is the button
Seat 1: jbodey52 (6475 in chips)=20
Seat 2: sunsvet7580 (24732 in chips)=20
Seat 4: JSkelts (16393 in chips)=20
Seat 5: smitheea (8870 in chips)=20
Seat 6: Fishstyx1958 (13298 in chips)=20
Seat 7: Going2Ship (7216 in chips)=20
Seat 8: JJin91 (12633 in chips)=20
jbodey52: posts the ante 40
sunsvet7580: posts the ante 40
JSkelts: posts the ante 40
smitheea: posts the ante 40
Fishstyx1958: posts the ante 40
Going2Ship: posts the ante 40
JJin91: posts the ante 40
Fishstyx1958: posts small blind 150
Going2Ship: posts big blind 300
*** HOLE CARDS ***
Dealt to JJin91 [3d Tc]
JJin91: folds=20
jbodey52: folds=20
sunsvet7580: folds=20
JSkelts: folds=20
smitheea: folds=20
Fishstyx1958: folds=20
Uncalled bet (150) returned to Going2Ship
Going2Ship collected 580 from pot
*** SUMMARY ***
Total pot 580 | Rake 0=20
Seat 1: jbodey52 folded before Flop (didn't bet)
Seat 2: sunsvet7580 folded before Flop (didn't bet)
Seat 4: JSkelts folded before Flop (didn't bet)
Seat 5: smitheea (button) folded before Flop (didn't bet)
Seat 6: Fishstyx1958 (small blind) folded before Flop
Seat 7: Going2Ship (big blind) collected (580)
Seat 8: JJin91 folded before Flop (didn't bet)


*********** # 40 **************
PokerStars Hand #169437435493: Tournament #1597684021, $18.20+$1.80 USD=
 Hold'em No Limit - Level X (200/400) - 2017/05/05 20:36:46 ET
Table '1597684021 4' 9-max Seat #6 is the button
Seat 1: jbodey52 (6435 in chips)=20
Seat 2: sunsvet7580 (24692 in chips)=20
Seat 4: JSkelts (16353 in chips)=20
Seat 5: smitheea (8830 in chips)=20
Seat 6: Fishstyx1958 (13108 in chips)=20
Seat 7: Going2Ship (7606 in chips)=20
Seat 8: JJin91 (12593 in chips)=20
jbodey52: posts the ante 50
sunsvet7580: posts the ante 50
JSkelts: posts the ante 50
smitheea: posts the ante 50
Fishstyx1958: posts the ante 50
Going2Ship: posts the ante 50
JJin91: posts the ante 50
Going2Ship: posts small blind 200
JJin91: posts big blind 400
*** HOLE CARDS ***
Dealt to JJin91 [Qc 7h]
jbodey52: raises 600 to 1000
sunsvet7580: folds=20
JSkelts: folds=20
smitheea: folds=20
Fishstyx1958: folds=20
Going2Ship: folds=20
JJin91: folds=20
Uncalled bet (600) returned to jbodey52
jbodey52 collected 1350 from pot
jbodey52: doesn't show hand=20
*** SUMMARY ***
Total pot 1350 | Rake 0=20
Seat 1: jbodey52 collected (1350)
Seat 2: sunsvet7580 folded before Flop (didn't bet)
Seat 4: JSkelts folded before Flop (didn't bet)
Seat 5: smitheea folded before Flop (didn't bet)
Seat 6: Fishstyx1958 (button) folded before Flop (didn't bet)
Seat 7: Going2Ship (small blind) folded before Flop
Seat 8: JJin91 (big blind) folded before Flop


*********** # 41 **************
PokerStars Hand #169437435618: Tournament #1597684021, $18.20+$1.80 USD=
 Hold'em No Limit - Level X (200/400) - 2017/05/05 20:37:17 ET
Table '1597684021 4' 9-max Seat #7 is the button
Seat 1: jbodey52 (7335 in chips)=20
Seat 2: sunsvet7580 (24642 in chips)=20
Seat 3: CY832 (10000 in chips)=20
Seat 4: JSkelts (16303 in chips)=20
Seat 5: smitheea (8780 in chips)=20
Seat 6: Fishstyx1958 (13058 in chips)=20
Seat 7: Going2Ship (7356 in chips)=20
Seat 8: JJin91 (12143 in chips)=20
jbodey52: posts the ante 50
sunsvet7580: posts the ante 50
CY832: posts the ante 50
JSkelts: posts the ante 50
smitheea: posts the ante 50
Fishstyx1958: posts the ante 50
Going2Ship: posts the ante 50
JJin91: posts the ante 50
JJin91: posts small blind 200
jbodey52: posts big blind 400
*** HOLE CARDS ***
Dealt to JJin91 [9h 5h]
sunsvet7580: folds=20
CY832: folds=20
JSkelts: raises 480 to 880
smitheea: folds=20
Fishstyx1958: calls 880
Going2Ship: folds=20
JJin91: folds=20
jbodey52: raises 6405 to 7285 and is all-in
JSkelts: folds=20
Fishstyx1958: calls 6405
*** FLOP *** [7c 2d 4h]
*** TURN *** [7c 2d 4h] [6s]
*** RIVER *** [7c 2d 4h 6s] [Kd]
*** SHOW DOWN ***
jbodey52: shows [7h 2s] (two pair, Sevens and Deuces)
Fishstyx1958: shows [Jd Jh] (a pair of Jacks)
jbodey52 collected 16050 from pot
*** SUMMARY ***
Total pot 16050 | Rake 0=20
Board [7c 2d 4h 6s Kd]
Seat 1: jbodey52 (big blind) showed [7h 2s] and won (16050) with two pa=
ir, Sevens and Deuces
Seat 2: sunsvet7580 folded before Flop (didn't bet)
Seat 3: CY832 folded before Flop (didn't bet)
Seat 4: JSkelts folded before Flop
Seat 5: smitheea folded before Flop (didn't bet)
Seat 6: Fishstyx1958 showed [Jd Jh] and lost with a pair of Jacks
Seat 7: Going2Ship (button) folded before Flop (didn't bet)
Seat 8: JJin91 (small blind) folded before Flop


*********** # 42 **************
PokerStars Hand #169437435823: Tournament #1597684021, $18.20+$1.80 USD=
 Hold'em No Limit - Level X (200/400) - 2017/05/05 20:38:03 ET
Table '1597684021 4' 9-max Seat #8 is the button
Seat 1: jbodey52 (16050 in chips)=20
Seat 2: sunsvet7580 (24592 in chips)=20
Seat 3: CY832 (9950 in chips)=20
Seat 4: JSkelts (15373 in chips)=20
Seat 5: smitheea (8730 in chips)=20
Seat 6: Fishstyx1958 (5723 in chips)=20
Seat 7: Going2Ship (7306 in chips)=20
Seat 8: JJin91 (11893 in chips)=20
jbodey52: posts the ante 50
sunsvet7580: posts the ante 50
CY832: posts the ante 50
JSkelts: posts the ante 50
smitheea: posts the ante 50
Fishstyx1958: posts the ante 50
Going2Ship: posts the ante 50
JJin91: posts the ante 50
jbodey52: posts small blind 200
sunsvet7580: posts big blind 400
*** HOLE CARDS ***
Dealt to JJin91 [As Jc]
CY832: folds=20
JSkelts: folds=20
smitheea: folds=20
Fishstyx1958: folds=20
Going2Ship: folds=20
JJin91: raises 444 to 844
jbodey52: calls 644
sunsvet7580: folds=20
*** FLOP *** [Ah Kd 3d]
jbodey52: checks=20
JJin91: bets 1319
jbodey52: calls 1319
*** TURN *** [Ah Kd 3d] [Jh]
jbodey52: checks=20
JJin91: bets 3717
jbodey52: calls 3717
*** RIVER *** [Ah Kd 3d Jh] [2h]
jbodey52: bets 10120 and is all-in
JJin91: calls 5963 and is all-in
Uncalled bet (4157) returned to jbodey52
*** SHOW DOWN ***
jbodey52: shows [Kh Th] (a flush, Ace high)
JJin91: shows [As Jc] (two pair, Aces and Jacks)
jbodey52 collected 24486 from pot
JJin91 finished the tournament in 82nd place
*** SUMMARY ***
Total pot 24486 | Rake 0=20
Board [Ah Kd 3d Jh 2h]
Seat 1: jbodey52 (small blind) showed [Kh Th] and won (24486) with a fl=
ush, Ace high
Seat 2: sunsvet7580 (big blind) folded before Flop
Seat 3: CY832 folded before Flop (didn't bet)
Seat 4: JSkelts folded before Flop (didn't bet)
Seat 5: smitheea folded before Flop (didn't bet)
Seat 6: Fishstyx1958 folded before Flop (didn't bet)
Seat 7: Going2Ship folded before Flop (didn't bet)
Seat 8: JJin91 (button) showed [As Jc] and lost with two pair, Aces and=
 Jacks


*********** # 43 **************
PokerStars Hand #169437436313: Tournament #1597684021, $18.20+$1.80 USD=
 Hold'em No Limit - Level X (200/400) - 2017/05/05 20:39:58 ET
Table '1597684021 7' 9-max Seat #5 is the button
Seat 1: Genotype55 (36071 in chips) is sitting out
Seat 2: YogaGrandma (4416 in chips)=20
Seat 3: JJin91 (10000 in chips)=20
Seat 4: TrademarkTer (35444 in chips)=20
Seat 5: AASupplier24 (35928 in chips)=20
Seat 6: OceansO7 (20827 in chips)=20
Seat 7: SaxieGal (14840 in chips)=20
Seat 8: Road2daMoney (14199 in chips)=20
Genotype55: posts the ante 50
YogaGrandma: posts the ante 50
JJin91: posts the ante 50
TrademarkTer: posts the ante 50
AASupplier24: posts the ante 50
OceansO7: posts the ante 50
SaxieGal: posts the ante 50
Road2daMoney: posts the ante 50
OceansO7: posts small blind 200
SaxieGal: posts big blind 400
*** HOLE CARDS ***
Dealt to JJin91 [6h 4h]
Road2daMoney: folds=20
Genotype55: folds=20
YogaGrandma: raises 3966 to 4366 and is all-in
JJin91: folds=20
TrademarkTer: folds=20
AASupplier24: folds=20
OceansO7: folds=20
SaxieGal: folds=20
Uncalled bet (3966) returned to YogaGrandma
YogaGrandma collected 1400 from pot
*** SUMMARY ***
Total pot 1400 | Rake 0=20
Seat 1: Genotype55 folded before Flop (didn't bet)
Seat 2: YogaGrandma collected (1400)
Seat 3: JJin91 folded before Flop (didn't bet)
Seat 4: TrademarkTer folded before Flop (didn't bet)
Seat 5: AASupplier24 (button) folded before Flop (didn't bet)
Seat 6: OceansO7 (small blind) folded before Flop
Seat 7: SaxieGal (big blind) folded before Flop
Seat 8: Road2daMoney folded before Flop (didn't bet)


*********** # 44 **************
PokerStars Hand #169437436435: Tournament #1597684021, $18.20+$1.80 USD=
 Hold'em No Limit - Level X (200/400) - 2017/05/05 20:40:26 ET
Table '1597684021 7' 9-max Seat #6 is the button
Seat 1: Genotype55 (36021 in chips) is sitting out
Seat 2: YogaGrandma (5366 in chips)=20
Seat 3: JJin91 (9950 in chips)=20
Seat 4: TrademarkTer (35394 in chips)=20
Seat 5: AASupplier24 (35878 in chips)=20
Seat 6: OceansO7 (20577 in chips)=20
Seat 7: SaxieGal (14390 in chips)=20
Seat 8: Road2daMoney (14149 in chips)=20
Genotype55: posts the ante 50
YogaGrandma: posts the ante 50
JJin91: posts the ante 50
TrademarkTer: posts the ante 50
AASupplier24: posts the ante 50
OceansO7: posts the ante 50
SaxieGal: posts the ante 50
Road2daMoney: posts the ante 50
SaxieGal: posts small blind 200
Road2daMoney: posts big blind 400
*** HOLE CARDS ***
Dealt to JJin91 [5d 2c]
Genotype55: folds=20
YogaGrandma: folds=20
JJin91: folds=20
TrademarkTer: raises 600 to 1000
AASupplier24: folds=20
OceansO7: folds=20
SaxieGal: folds=20
Road2daMoney: folds=20
Uncalled bet (600) returned to TrademarkTer
TrademarkTer collected 1400 from pot
*** SUMMARY ***
Total pot 1400 | Rake 0=20
Seat 1: Genotype55 folded before Flop (didn't bet)
Seat 2: YogaGrandma folded before Flop (didn't bet)
Seat 3: JJin91 folded before Flop (didn't bet)
Seat 4: TrademarkTer collected (1400)
Seat 5: AASupplier24 folded before Flop (didn't bet)
Seat 6: OceansO7 (button) folded before Flop (didn't bet)
Seat 7: SaxieGal (small blind) folded before Flop
Seat 8: Road2daMoney (big blind) folded before Flop


*********** # 45 **************
PokerStars Hand #169437436578: Tournament #1597684021, $18.20+$1.80 USD=
 Hold'em No Limit - Level X (200/400) - 2017/05/05 20:40:53 ET
Table '1597684021 7' 9-max Seat #7 is the button
Seat 1: Genotype55 (35971 in chips) is sitting out
Seat 2: YogaGrandma (5316 in chips)=20
Seat 3: JJin91 (9900 in chips)=20
Seat 4: TrademarkTer (36344 in chips)=20
Seat 5: AASupplier24 (35828 in chips)=20
Seat 6: OceansO7 (20527 in chips)=20
Seat 7: SaxieGal (14140 in chips)=20
Seat 8: Road2daMoney (13699 in chips)=20
Genotype55: posts the ante 50
YogaGrandma: posts the ante 50
JJin91: posts the ante 50
TrademarkTer: posts the ante 50
AASupplier24: posts the ante 50
OceansO7: posts the ante 50
SaxieGal: posts the ante 50
Road2daMoney: posts the ante 50
Road2daMoney: posts small blind 200
Genotype55: posts big blind 400
*** HOLE CARDS ***
Dealt to JJin91 [6h Kd]
YogaGrandma: raises 4866 to 5266 and is all-in
JJin91: folds=20
TrademarkTer: folds=20
AASupplier24: folds=20
OceansO7: folds=20
SaxieGal: folds=20
Road2daMoney: folds=20
Genotype55: folds=20
Uncalled bet (4866) returned to YogaGrandma
YogaGrandma collected 1400 from pot
*** SUMMARY ***
Total pot 1400 | Rake 0=20
Seat 1: Genotype55 (big blind) folded before Flop
Seat 2: YogaGrandma collected (1400)
Seat 3: JJin91 folded before Flop (didn't bet)
Seat 4: TrademarkTer folded before Flop (didn't bet)
Seat 5: AASupplier24 folded before Flop (didn't bet)
Seat 6: OceansO7 folded before Flop (didn't bet)
Seat 7: SaxieGal (button) folded before Flop (didn't bet)
Seat 8: Road2daMoney (small blind) folded before Flop


*********** # 46 **************
PokerStars Hand #169437436704: Tournament #1597684021, $18.20+$1.80 USD=
 Hold'em No Limit - Level X (200/400) - 2017/05/05 20:41:19 ET
Table '1597684021 7' 9-max Seat #8 is the button
Seat 1: Genotype55 (35521 in chips) is sitting out
Seat 3: JJin91 (9850 in chips)=20
Seat 4: TrademarkTer (36294 in chips)=20
Seat 5: AASupplier24 (35778 in chips)=20
Seat 6: OceansO7 (20477 in chips)=20
Seat 7: SaxieGal (14090 in chips)=20
Seat 8: Road2daMoney (13449 in chips)=20
Genotype55: posts the ante 50
JJin91: posts the ante 50
TrademarkTer: posts the ante 50
AASupplier24: posts the ante 50
OceansO7: posts the ante 50
SaxieGal: posts the ante 50
Road2daMoney: posts the ante 50
Genotype55: posts small blind 200
JJin91: posts big blind 400
*** HOLE CARDS ***
Dealt to JJin91 [Qh 2h]
TrademarkTer: folds=20
AASupplier24: raises 520 to 920
OceansO7: folds=20
SaxieGal: calls 920
Road2daMoney: raises 1880 to 2800
Genotype55: folds=20
JJin91: folds=20
AASupplier24: folds=20
SaxieGal: calls 1880
*** FLOP *** [9d Th Ks]
SaxieGal: checks=20
Genotype55 is disconnected=20
Road2daMoney: bets 5378
SaxieGal: folds=20
Uncalled bet (5378) returned to Road2daMoney
Road2daMoney collected 7470 from pot
Road2daMoney: doesn't show hand=20
*** SUMMARY ***
Total pot 7470 | Rake 0=20
Board [9d Th Ks]
Seat 1: Genotype55 (small blind) folded before Flop
Seat 3: JJin91 (big blind) folded before Flop
Seat 4: TrademarkTer folded before Flop (didn't bet)
Seat 5: AASupplier24 folded before Flop
Seat 6: OceansO7 folded before Flop (didn't bet)
Seat 7: SaxieGal folded on the Flop
Seat 8: Road2daMoney (button) collected (7470)


*********** # 47 **************
PokerStars Hand #169437436948: Tournament #1597684021, $18.20+$1.80 USD=
 Hold'em No Limit - Level X (200/400) - 2017/05/05 20:42:10 ET
Table '1597684021 7' 9-max Seat #1 is the button
Seat 1: Genotype55 (35271 in chips) is sitting out
Seat 2: vincent329 (10000 in chips) out of hand (moved from another tab=
le into small blind)
Seat 3: JJin91 (9400 in chips)=20
Seat 4: TrademarkTer (36244 in chips)=20
Seat 5: AASupplier24 (34808 in chips)=20
Seat 6: OceansO7 (20427 in chips)=20
Seat 7: SaxieGal (11240 in chips)=20
Seat 8: Road2daMoney (18069 in chips)=20
Genotype55: posts the ante 50
JJin91: posts the ante 50
TrademarkTer: posts the ante 50
AASupplier24: posts the ante 50
OceansO7: posts the ante 50
SaxieGal: posts the ante 50
Road2daMoney: posts the ante 50
JJin91: posts small blind 200
TrademarkTer: posts big blind 400
*** HOLE CARDS ***
Dealt to JJin91 [Jh 9d]
AASupplier24: folds=20
OceansO7: folds=20
SaxieGal: folds=20
Road2daMoney: folds=20
Genotype55: folds=20
JJin91: raises 800 to 1200
TrademarkTer: calls 800
*** FLOP *** [Qc Jd 3d]
JJin91: bets 1458
TrademarkTer: calls 1458
*** TURN *** [Qc Jd 3d] [4s]
JJin91: checks=20
TrademarkTer: checks=20
*** RIVER *** [Qc Jd 3d 4s] [8s]
JJin91: checks=20
TrademarkTer: checks=20
*** SHOW DOWN ***
JJin91: shows [Jh 9d] (a pair of Jacks)
TrademarkTer: mucks hand=20
JJin91 collected 5666 from pot
*** SUMMARY ***
Total pot 5666 | Rake 0=20
Board [Qc Jd 3d 4s 8s]
Seat 1: Genotype55 (button) folded before Flop (didn't bet)
Seat 3: JJin91 (small blind) showed [Jh 9d] and won (5666) with a pair =
of Jacks
Seat 4: TrademarkTer (big blind) mucked [Ac 2c]
Seat 5: AASupplier24 folded before Flop (didn't bet)
Seat 6: OceansO7 folded before Flop (didn't bet)
Seat 7: SaxieGal folded before Flop (didn't bet)
Seat 8: Road2daMoney folded before Flop (didn't bet)


*********** # 48 **************
PokerStars Hand #169437437195: Tournament #1597684021, $18.20+$1.80 USD=
 Hold'em No Limit - Level X (200/400) - 2017/05/05 20:43:06 ET
Table '1597684021 7' 9-max Seat #3 is the button
Seat 1: Genotype55 (35221 in chips) is sitting out
Seat 2: vincent329 (10000 in chips)=20
Seat 3: JJin91 (12358 in chips)=20
Seat 4: TrademarkTer (33536 in chips)=20
Seat 5: AASupplier24 (34758 in chips)=20
Seat 6: OceansO7 (20377 in chips)=20
Seat 7: SaxieGal (11190 in chips)=20
Seat 8: Road2daMoney (18019 in chips)=20
Genotype55: posts the ante 50
vincent329: posts the ante 50
JJin91: posts the ante 50
TrademarkTer: posts the ante 50
AASupplier24: posts the ante 50
OceansO7: posts the ante 50
SaxieGal: posts the ante 50
Road2daMoney: posts the ante 50
TrademarkTer: posts small blind 200
AASupplier24: posts big blind 400
*** HOLE CARDS ***
Dealt to JJin91 [6d 5c]
OceansO7: folds=20
SaxieGal: folds=20
Road2daMoney: folds=20
Genotype55: folds=20
vincent329: folds=20
JJin91: folds=20
TrademarkTer: calls 200
AASupplier24: raises 400 to 800
TrademarkTer: calls 400
*** FLOP *** [Jd Qh 8s]
TrademarkTer: checks=20
AASupplier24: bets 1200
Genotype55 has returned
TrademarkTer: raises 1200 to 2400
AASupplier24: calls 1200
*** TURN *** [Jd Qh 8s] [Ac]
TrademarkTer: bets 3400
AASupplier24: raises 3800 to 7200
TrademarkTer: calls 3800
*** RIVER *** [Jd Qh 8s Ac] [Kc]
TrademarkTer: checks=20
AASupplier24: bets 8300
TrademarkTer: raises 14786 to 23086 and is all-in
AASupplier24: calls 14786
*** SHOW DOWN ***
TrademarkTer: shows [Th 9s] (a straight, Ten to Ace)
AASupplier24: shows [As Ad] (three of a kind, Aces)
TrademarkTer collected 67372 from pot
*** SUMMARY ***
Total pot 67372 | Rake 0=20
Board [Jd Qh 8s Ac Kc]
Seat 1: Genotype55 folded before Flop (didn't bet)
Seat 2: vincent329 folded before Flop (didn't bet)
Seat 3: JJin91 (button) folded before Flop (didn't bet)
Seat 4: TrademarkTer (small blind) showed [Th 9s] and won (67372) with =
a straight, Ten to Ace
Seat 5: AASupplier24 (big blind) showed [As Ad] and lost with three of =
a kind, Aces
Seat 6: OceansO7 folded before Flop (didn't bet)
Seat 7: SaxieGal folded before Flop (didn't bet)
Seat 8: Road2daMoney folded before Flop (didn't bet)


*********** # 49 **************
PokerStars Hand #169437437549: Tournament #1597684021, $18.20+$1.80 USD=
 Hold'em No Limit - Level X (200/400) - 2017/05/05 20:44:25 ET
Table '1597684021 7' 9-max Seat #4 is the button
Seat 1: Genotype55 (35171 in chips)=20
Seat 2: vincent329 (9950 in chips)=20
Seat 3: JJin91 (12308 in chips)=20
Seat 4: TrademarkTer (67372 in chips)=20
Seat 5: AASupplier24 (1222 in chips)=20
Seat 6: OceansO7 (20327 in chips)=20
Seat 7: SaxieGal (11140 in chips)=20
Seat 8: Road2daMoney (17969 in chips)=20
Genotype55: posts the ante 50
vincent329: posts the ante 50
JJin91: posts the ante 50
TrademarkTer: posts the ante 50
AASupplier24: posts the ante 50
OceansO7: posts the ante 50
SaxieGal: posts the ante 50
Road2daMoney: posts the ante 50
AASupplier24: posts small blind 200
OceansO7: posts big blind 400
*** HOLE CARDS ***
Dealt to JJin91 [Kc Qd]
SaxieGal: calls 400
Road2daMoney: raises 1600 to 2000
Genotype55: folds=20
vincent329: folds=20
JJin91: folds=20
TrademarkTer: folds=20
AASupplier24: calls 972 and is all-in
OceansO7: folds=20
SaxieGal: calls 1600
*** FLOP *** [Ts Ks 4h]
SaxieGal: checks=20
Road2daMoney: checks=20
*** TURN *** [Ts Ks 4h] [6s]
SaxieGal: checks=20
Road2daMoney: checks=20
*** RIVER *** [Ts Ks 4h 6s] [2d]
SaxieGal: checks=20
Road2daMoney: checks=20
*** SHOW DOWN ***
SaxieGal: shows [Jc As] (high card Ace)
Road2daMoney: shows [9c 9d] (a pair of Nines)
Road2daMoney collected 1656 from side pot
AASupplier24: shows [Qc Th] (a pair of Tens)
AASupplier24 collected 4316 from main pot
*** SUMMARY ***
Total pot 5972 Main pot 4316. Side pot 1656. | Rake 0=20
Board [Ts Ks 4h 6s 2d]
Seat 1: Genotype55 folded before Flop (didn't bet)
Seat 2: vincent329 folded before Flop (didn't bet)
Seat 3: JJin91 folded before Flop (didn't bet)
Seat 4: TrademarkTer (button) folded before Flop (didn't bet)
Seat 5: AASupplier24 (small blind) showed [Qc Th] and won (4316) with a=
 pair of Tens
Seat 6: OceansO7 (big blind) folded before Flop
Seat 7: SaxieGal showed [Jc As] and lost with high card Ace
Seat 8: Road2daMoney showed [9c 9d] and won (1656) with a pair of Nines


*********** # 50 **************
PokerStars Hand #169437437730: Tournament #1597684021, $18.20+$1.80 USD=
 Hold'em No Limit - Level X (200/400) - 2017/05/05 20:45:03 ET
Table '1597684021 7' 9-max Seat #5 is the button
Seat 1: Genotype55 (35121 in chips)=20
Seat 2: vincent329 (9900 in chips)=20
Seat 3: JJin91 (12258 in chips)=20
Seat 4: TrademarkTer (67322 in chips)=20
Seat 5: AASupplier24 (4316 in chips)=20
Seat 6: OceansO7 (19877 in chips)=20
Seat 7: SaxieGal (9090 in chips)=20
Seat 8: Road2daMoney (17575 in chips)=20
Genotype55: posts the ante 50
vincent329: posts the ante 50
JJin91: posts the ante 50
TrademarkTer: posts the ante 50
AASupplier24: posts the ante 50
OceansO7: posts the ante 50
SaxieGal: posts the ante 50
Road2daMoney: posts the ante 50
OceansO7: posts small blind 200
SaxieGal: posts big blind 400
*** HOLE CARDS ***
Dealt to JJin91 [Tc 2s]
Road2daMoney: folds=20
Genotype55: folds=20
vincent329: calls 400
JJin91: folds=20
TrademarkTer: folds=20
AASupplier24: folds=20
OceansO7: calls 200
SaxieGal: checks=20
*** FLOP *** [Qd Ks 6s]
OceansO7: checks=20
SaxieGal: bets 800
vincent329: calls 800
OceansO7: folds=20
*** TURN *** [Qd Ks 6s] [8d]
SaxieGal: checks=20
vincent329: bets 1600
SaxieGal: folds=20
Uncalled bet (1600) returned to vincent329
vincent329 collected 3200 from pot
*** SUMMARY ***
Total pot 3200 | Rake 0=20
Board [Qd Ks 6s 8d]
Seat 1: Genotype55 folded before Flop (didn't bet)
Seat 2: vincent329 collected (3200)
Seat 3: JJin91 folded before Flop (didn't bet)
Seat 4: TrademarkTer folded before Flop (didn't bet)
Seat 5: AASupplier24 (button) folded before Flop (didn't bet)
Seat 6: OceansO7 (small blind) folded on the Flop
Seat 7: SaxieGal (big blind) folded on the Turn
Seat 8: Road2daMoney folded before Flop (didn't bet)


*********** # 51 **************
PokerStars Hand #169437437878: Tournament #1597684021, $18.20+$1.80 USD=
 Hold'em No Limit - Level X (200/400) - 2017/05/05 20:45:37 ET
Table '1597684021 7' 9-max Seat #6 is the button
Seat 1: Genotype55 (35071 in chips)=20
Seat 2: vincent329 (11850 in chips)=20
Seat 3: JJin91 (12208 in chips)=20
Seat 4: TrademarkTer (67272 in chips)=20
Seat 5: AASupplier24 (4266 in chips)=20
Seat 6: OceansO7 (19427 in chips)=20
Seat 7: SaxieGal (7840 in chips)=20
Seat 8: Road2daMoney (17525 in chips)=20
Genotype55: posts the ante 50
vincent329: posts the ante 50
JJin91: posts the ante 50
TrademarkTer: posts the ante 50
AASupplier24: posts the ante 50
OceansO7: posts the ante 50
SaxieGal: posts the ante 50
Road2daMoney: posts the ante 50
SaxieGal: posts small blind 200
Road2daMoney: posts big blind 400
*** HOLE CARDS ***
Dealt to JJin91 [Qd As]
Genotype55: folds=20
vincent329: calls 400
JJin91: raises 1332 to 1732
TrademarkTer: folds=20
AASupplier24: folds=20
OceansO7: folds=20
SaxieGal: folds=20
Road2daMoney: folds=20
vincent329: folds=20
Uncalled bet (1332) returned to JJin91
JJin91 collected 1800 from pot
JJin91: doesn't show hand=20
*** SUMMARY ***
Total pot 1800 | Rake 0=20
Seat 1: Genotype55 folded before Flop (didn't bet)
Seat 2: vincent329 folded before Flop
Seat 3: JJin91 collected (1800)
Seat 4: TrademarkTer folded before Flop (didn't bet)
Seat 5: AASupplier24 folded before Flop (didn't bet)
Seat 6: OceansO7 (button) folded before Flop (didn't bet)
Seat 7: SaxieGal (small blind) folded before Flop
Seat 8: Road2daMoney (big blind) folded before Flop


*********** # 52 **************
PokerStars Hand #169437438009: Tournament #1597684021, $18.20+$1.80 USD=
 Hold'em No Limit - Level X (200/400) - 2017/05/05 20:46:03 ET
Table '1597684021 7' 9-max Seat #7 is the button
Seat 1: Genotype55 (35021 in chips)=20
Seat 2: vincent329 (11400 in chips)=20
Seat 3: JJin91 (13558 in chips)=20
Seat 4: TrademarkTer (67222 in chips)=20
Seat 5: AASupplier24 (4216 in chips)=20
Seat 6: OceansO7 (19377 in chips)=20
Seat 7: SaxieGal (7590 in chips)=20
Seat 8: Road2daMoney (17075 in chips)=20
Genotype55: posts the ante 50
vincent329: posts the ante 50
JJin91: posts the ante 50
TrademarkTer: posts the ante 50
AASupplier24: posts the ante 50
OceansO7: posts the ante 50
SaxieGal: posts the ante 50
Road2daMoney: posts the ante 50
Road2daMoney: posts small blind 200
Genotype55: posts big blind 400
*** HOLE CARDS ***
Dealt to JJin91 [Qh Js]
vincent329: folds=20
JJin91: folds=20
TrademarkTer: raises 600 to 1000
AASupplier24: folds=20
OceansO7: folds=20
SaxieGal: calls 1000
Road2daMoney: folds=20
Genotype55: raises 3800 to 4800
TrademarkTer said, "Not nice Geno!!!"
TrademarkTer said, "Not nice!"
TrademarkTer: folds=20
SaxieGal: calls 3800
*** FLOP *** [Th Jd Qd]
Genotype55: bets 30171 and is all-in
SaxieGal: calls 2740 and is all-in
Uncalled bet (27431) returned to Genotype55
*** TURN *** [Th Jd Qd] [4c]
*** RIVER *** [Th Jd Qd 4c] [8d]
*** SHOW DOWN ***
Genotype55: shows [Kh Kd] (a pair of Kings)
SaxieGal: shows [Tc Ah] (a pair of Tens)
Genotype55 collected 16680 from pot
SaxieGal finished the tournament in 71st place
*** SUMMARY ***
Total pot 16680 | Rake 0=20
Board [Th Jd Qd 4c 8d]
Seat 1: Genotype55 (big blind) showed [Kh Kd] and won (16680) with a pa=
ir of Kings
Seat 2: vincent329 folded before Flop (didn't bet)
Seat 3: JJin91 folded before Flop (didn't bet)
Seat 4: TrademarkTer folded before Flop
Seat 5: AASupplier24 folded before Flop (didn't bet)
Seat 6: OceansO7 folded before Flop (didn't bet)
Seat 7: SaxieGal (button) showed [Tc Ah] and lost with a pair of Tens
Seat 8: Road2daMoney (small blind) folded before Flop


*********** # 53 **************
PokerStars Hand #169437438307: Tournament #1597684021, $18.20+$1.80 USD=
 Hold'em No Limit - Level XI (250/500) - 2017/05/05 20:47:05 ET
Table '1597684021 7' 9-max Seat #8 is the button
Seat 1: Genotype55 (44111 in chips)=20
Seat 2: vincent329 (11350 in chips)=20
Seat 3: JJin91 (13508 in chips)=20
Seat 4: TrademarkTer (66172 in chips)=20
Seat 5: AASupplier24 (4166 in chips)=20
Seat 6: OceansO7 (19327 in chips)=20
Seat 8: Road2daMoney (16825 in chips)=20
Genotype55: posts the ante 60
vincent329: posts the ante 60
JJin91: posts the ante 60
TrademarkTer: posts the ante 60
AASupplier24: posts the ante 60
OceansO7: posts the ante 60
Road2daMoney: posts the ante 60
Genotype55: posts small blind 250
vincent329: posts big blind 500
*** HOLE CARDS ***
Dealt to JJin91 [8s 3h]
JJin91: folds=20
TrademarkTer: folds=20
AASupplier24: folds=20
OceansO7: folds=20
Road2daMoney: raises 500 to 1000
Genotype55: calls 750
vincent329: calls 500
*** FLOP *** [6d 6c Js]
Genotype55: checks=20
vincent329: checks=20
Road2daMoney: checks=20
*** TURN *** [6d 6c Js] [8d]
Genotype55: checks=20
vincent329: bets 1710
Road2daMoney: calls 1710
Genotype55: folds=20
*** RIVER *** [6d 6c Js 8d] [8h]
vincent329: bets 1500
Road2daMoney: calls 1500
*** SHOW DOWN ***
vincent329: shows [Ks 3c] (two pair, Eights and Sixes)
Road2daMoney: shows [Jc 7h] (two pair, Jacks and Eights)
Road2daMoney collected 9840 from pot
*** SUMMARY ***
Total pot 9840 | Rake 0=20
Board [6d 6c Js 8d 8h]
Seat 1: Genotype55 (small blind) folded on the Turn
Seat 2: vincent329 (big blind) showed [Ks 3c] and lost with two pair, E=
ights and Sixes
Seat 3: JJin91 folded before Flop (didn't bet)
Seat 4: TrademarkTer folded before Flop (didn't bet)
Seat 5: AASupplier24 folded before Flop (didn't bet)
Seat 6: OceansO7 folded before Flop (didn't bet)
Seat 8: Road2daMoney (button) showed [Jc 7h] and won (9840) with two pa=
ir, Jacks and Eights


*********** # 54 **************
PokerStars Hand #169437438565: Tournament #1597684021, $18.20+$1.80 USD=
 Hold'em No Limit - Level XI (250/500) - 2017/05/05 20:47:56 ET
Table '1597684021 7' 9-max Seat #1 is the button
Seat 1: Genotype55 (43051 in chips)=20
Seat 2: vincent329 (7080 in chips)=20
Seat 3: JJin91 (13448 in chips)=20
Seat 4: TrademarkTer (66112 in chips)=20
Seat 5: AASupplier24 (4106 in chips)=20
Seat 6: OceansO7 (19267 in chips)=20
Seat 8: Road2daMoney (22395 in chips)=20
Genotype55: posts the ante 60
vincent329: posts the ante 60
JJin91: posts the ante 60
TrademarkTer: posts the ante 60
AASupplier24: posts the ante 60
OceansO7: posts the ante 60
Road2daMoney: posts the ante 60
vincent329: posts small blind 250
JJin91: posts big blind 500
*** HOLE CARDS ***
Dealt to JJin91 [5h Ts]
TrademarkTer: folds=20
AASupplier24: folds=20
OceansO7: raises 700 to 1200
Road2daMoney: folds=20
Genotype55: folds=20
vincent329: folds=20
JJin91: folds=20
Uncalled bet (700) returned to OceansO7
OceansO7 collected 1670 from pot
OceansO7: doesn't show hand=20
*** SUMMARY ***
Total pot 1670 | Rake 0=20
Seat 1: Genotype55 (button) folded before Flop (didn't bet)
Seat 2: vincent329 (small blind) folded before Flop
Seat 3: JJin91 (big blind) folded before Flop
Seat 4: TrademarkTer folded before Flop (didn't bet)
Seat 5: AASupplier24 folded before Flop (didn't bet)
Seat 6: OceansO7 collected (1670)
Seat 8: Road2daMoney folded before Flop (didn't bet)


*********** # 55 **************
PokerStars Hand #169437438643: Tournament #1597684021, $18.20+$1.80 USD=
 Hold'em No Limit - Level XI (250/500) - 2017/05/05 20:48:11 ET
Table '1597684021 7' 9-max Seat #2 is the button
Seat 1: Genotype55 (42991 in chips)=20
Seat 2: vincent329 (6770 in chips)=20
Seat 3: JJin91 (12888 in chips)=20
Seat 4: TrademarkTer (66052 in chips)=20
Seat 5: AASupplier24 (4046 in chips)=20
Seat 6: OceansO7 (20377 in chips)=20
Seat 8: Road2daMoney (22335 in chips)=20
Genotype55: posts the ante 60
vincent329: posts the ante 60
JJin91: posts the ante 60
TrademarkTer: posts the ante 60
AASupplier24: posts the ante 60
OceansO7: posts the ante 60
Road2daMoney: posts the ante 60
JJin91: posts small blind 250
TrademarkTer: posts big blind 500
*** HOLE CARDS ***
Dealt to JJin91 [6d 5h]
AASupplier24: folds=20
OceansO7: folds=20
Road2daMoney: folds=20
Genotype55: folds=20
vincent329: raises 1000 to 1500
JJin91: folds=20
TrademarkTer: calls 1000
*** FLOP *** [9d 3s Kh]
TrademarkTer: checks=20
vincent329: checks=20
*** TURN *** [9d 3s Kh] [6c]
TrademarkTer: checks=20
vincent329: bets 3670
TrademarkTer: folds=20
Uncalled bet (3670) returned to vincent329
vincent329 collected 3670 from pot
*** SUMMARY ***
Total pot 3670 | Rake 0=20
Board [9d 3s Kh 6c]
Seat 1: Genotype55 folded before Flop (didn't bet)
Seat 2: vincent329 (button) collected (3670)
Seat 3: JJin91 (small blind) folded before Flop
Seat 4: TrademarkTer (big blind) folded on the Turn
Seat 5: AASupplier24 folded before Flop (didn't bet)
Seat 6: OceansO7 folded before Flop (didn't bet)
Seat 8: Road2daMoney folded before Flop (didn't bet)


*********** # 56 **************
PokerStars Hand #169437438783: Tournament #1597684021, $18.20+$1.80 USD=
 Hold'em No Limit - Level XI (250/500) - 2017/05/05 20:48:43 ET
Table '1597684021 7' 9-max Seat #3 is the button
Seat 1: Genotype55 (42931 in chips)=20
Seat 2: vincent329 (8880 in chips)=20
Seat 3: JJin91 (12578 in chips)=20
Seat 4: TrademarkTer (64492 in chips)=20
Seat 5: AASupplier24 (3986 in chips)=20
Seat 6: OceansO7 (20317 in chips)=20
Seat 8: Road2daMoney (22275 in chips)=20
Genotype55: posts the ante 60
vincent329: posts the ante 60
JJin91: posts the ante 60
TrademarkTer: posts the ante 60
AASupplier24: posts the ante 60
OceansO7: posts the ante 60
Road2daMoney: posts the ante 60
TrademarkTer: posts small blind 250
AASupplier24: posts big blind 500
*** HOLE CARDS ***
Dealt to JJin91 [2h Ks]
OceansO7: folds=20
Road2daMoney: folds=20
Genotype55: calls 500
vincent329: calls 500
JJin91: folds=20
TrademarkTer: calls 250
AASupplier24: checks=20
*** FLOP *** [Kc Jh 2c]
TrademarkTer: checks=20
AASupplier24: checks=20
Genotype55: bets 2420
vincent329: calls 2420
TrademarkTer: folds=20
AASupplier24: folds=20
*** TURN *** [Kc Jh 2c] [7s]
Genotype55: bets 5900
vincent329: calls 5900 and is all-in
*** RIVER *** [Kc Jh 2c 7s] [Tc]
*** SHOW DOWN ***
Genotype55: shows [7c 8h] (a pair of Sevens)
vincent329: shows [Kd 9h] (a pair of Kings)
vincent329 collected 19060 from pot
*** SUMMARY ***
Total pot 19060 | Rake 0=20
Board [Kc Jh 2c 7s Tc]
Seat 1: Genotype55 showed [7c 8h] and lost with a pair of Sevens
Seat 2: vincent329 showed [Kd 9h] and won (19060) with a pair of Kings
Seat 3: JJin91 (button) folded before Flop (didn't bet)
Seat 4: TrademarkTer (small blind) folded on the Flop
Seat 5: AASupplier24 (big blind) folded on the Flop
Seat 6: OceansO7 folded before Flop (didn't bet)
Seat 8: Road2daMoney folded before Flop (didn't bet)


*********** # 57 **************
PokerStars Hand #169437439014: Tournament #1597684021, $18.20+$1.80 USD=
 Hold'em No Limit - Level XI (250/500) - 2017/05/05 20:49:31 ET
Table '1597684021 7' 9-max Seat #4 is the button
Seat 1: Genotype55 (34051 in chips)=20
Seat 2: vincent329 (19060 in chips)=20
Seat 3: JJin91 (12518 in chips)=20
Seat 4: TrademarkTer (63932 in chips)=20
Seat 5: AASupplier24 (3426 in chips)=20
Seat 6: OceansO7 (20257 in chips)=20
Seat 7: jnumberone (10000 in chips)=20
Seat 8: Road2daMoney (22215 in chips)=20
Genotype55: posts the ante 60
vincent329: posts the ante 60
JJin91: posts the ante 60
TrademarkTer: posts the ante 60
AASupplier24: posts the ante 60
OceansO7: posts the ante 60
jnumberone: posts the ante 60
Road2daMoney: posts the ante 60
AASupplier24: posts small blind 250
OceansO7: posts big blind 500
*** HOLE CARDS ***
Dealt to JJin91 [6h 7d]
jnumberone: folds=20
Road2daMoney: raises 750 to 1250
Genotype55: folds=20
vincent329: folds=20
JJin91: folds=20
TrademarkTer: folds=20
AASupplier24: raises 2116 to 3366 and is all-in
OceansO7: folds=20
Road2daMoney: calls 2116
*** FLOP *** [Jd Jh 8d]
*** TURN *** [Jd Jh 8d] [9h]
*** RIVER *** [Jd Jh 8d 9h] [4h]
*** SHOW DOWN ***
AASupplier24: shows [Kc Jc] (three of a kind, Jacks)
Road2daMoney: shows [Ad Ks] (a pair of Jacks)
AASupplier24 collected 7712 from pot
*** SUMMARY ***
Total pot 7712 | Rake 0=20
Board [Jd Jh 8d 9h 4h]
Seat 1: Genotype55 folded before Flop (didn't bet)
Seat 2: vincent329 folded before Flop (didn't bet)
Seat 3: JJin91 folded before Flop (didn't bet)
Seat 4: TrademarkTer (button) folded before Flop (didn't bet)
Seat 5: AASupplier24 (small blind) showed [Kc Jc] and won (7712) with t=
hree of a kind, Jacks
Seat 6: OceansO7 (big blind) folded before Flop
Seat 7: jnumberone folded before Flop (didn't bet)
Seat 8: Road2daMoney showed [Ad Ks] and lost with a pair of Jacks


*********** # 58 **************
PokerStars Hand #169437439239: Tournament #1597684021, $18.20+$1.80 USD=
 Hold'em No Limit - Level XI (250/500) - 2017/05/05 20:50:13 ET
Table '1597684021 7' 9-max Seat #5 is the button
Seat 1: Genotype55 (33991 in chips)=20
Seat 2: vincent329 (19000 in chips)=20
Seat 3: JJin91 (12458 in chips)=20
Seat 4: TrademarkTer (63872 in chips)=20
Seat 5: AASupplier24 (7712 in chips)=20
Seat 6: OceansO7 (19697 in chips)=20
Seat 7: jnumberone (9940 in chips)=20
Seat 8: Road2daMoney (18789 in chips)=20
Genotype55: posts the ante 60
vincent329: posts the ante 60
JJin91: posts the ante 60
TrademarkTer: posts the ante 60
AASupplier24: posts the ante 60
OceansO7: posts the ante 60
jnumberone: posts the ante 60
Road2daMoney: posts the ante 60
OceansO7: posts small blind 250
jnumberone: posts big blind 500
*** HOLE CARDS ***
Dealt to JJin91 [7d Kh]
Road2daMoney: folds=20
Genotype55: raises 1000 to 1500
vincent329: folds=20
JJin91: folds=20
TrademarkTer: folds=20
AASupplier24: folds=20
OceansO7: folds=20
jnumberone: folds=20
Uncalled bet (1000) returned to Genotype55
Genotype55 collected 1730 from pot
*** SUMMARY ***
Total pot 1730 | Rake 0=20
Seat 1: Genotype55 collected (1730)
Seat 2: vincent329 folded before Flop (didn't bet)
Seat 3: JJin91 folded before Flop (didn't bet)
Seat 4: TrademarkTer folded before Flop (didn't bet)
Seat 5: AASupplier24 (button) folded before Flop (didn't bet)
Seat 6: OceansO7 (small blind) folded before Flop
Seat 7: jnumberone (big blind) folded before Flop
Seat 8: Road2daMoney folded before Flop (didn't bet)


*********** # 59 **************
PokerStars Hand #169437439314: Tournament #1597684021, $18.20+$1.80 USD=
 Hold'em No Limit - Level XI (250/500) - 2017/05/05 20:50:29 ET
Table '1597684021 7' 9-max Seat #6 is the button
Seat 1: Genotype55 (35161 in chips)=20
Seat 2: vincent329 (18940 in chips)=20
Seat 3: JJin91 (12398 in chips)=20
Seat 4: TrademarkTer (63812 in chips)=20
Seat 5: AASupplier24 (7652 in chips)=20
Seat 6: OceansO7 (19387 in chips)=20
Seat 7: jnumberone (9380 in chips)=20
Seat 8: Road2daMoney (18729 in chips)=20
Genotype55: posts the ante 60
vincent329: posts the ante 60
JJin91: posts the ante 60
TrademarkTer: posts the ante 60
AASupplier24: posts the ante 60
OceansO7: posts the ante 60
jnumberone: posts the ante 60
Road2daMoney: posts the ante 60
jnumberone: posts small blind 250
Road2daMoney: posts big blind 500
*** HOLE CARDS ***
Dealt to JJin91 [Kh Qh]
Genotype55: folds=20
vincent329: folds=20
JJin91: raises 555 to 1055
TrademarkTer: folds=20
AASupplier24: folds=20
OceansO7: folds=20
jnumberone: folds=20
Road2daMoney: calls 555
*** FLOP *** [7c 4d Qd]
Road2daMoney: checks=20
JJin91: bets 1505
Road2daMoney: folds=20
Uncalled bet (1505) returned to JJin91
JJin91 collected 2840 from pot
JJin91: doesn't show hand=20
*** SUMMARY ***
Total pot 2840 | Rake 0=20
Board [7c 4d Qd]
Seat 1: Genotype55 folded before Flop (didn't bet)
Seat 2: vincent329 folded before Flop (didn't bet)
Seat 3: JJin91 collected (2840)
Seat 4: TrademarkTer folded before Flop (didn't bet)
Seat 5: AASupplier24 folded before Flop (didn't bet)
Seat 6: OceansO7 (button) folded before Flop (didn't bet)
Seat 7: jnumberone (small blind) folded before Flop
Seat 8: Road2daMoney (big blind) folded on the Flop


*********** # 60 **************
PokerStars Hand #169437439436: Tournament #1597684021, $18.20+$1.80 USD=
 Hold'em No Limit - Level XI (250/500) - 2017/05/05 20:51:00 ET
Table '1597684021 7' 9-max Seat #7 is the button
Seat 1: Genotype55 (35101 in chips)=20
Seat 2: vincent329 (18880 in chips)=20
Seat 3: JJin91 (14123 in chips)=20
Seat 4: TrademarkTer (63752 in chips)=20
Seat 5: AASupplier24 (7592 in chips)=20
Seat 6: OceansO7 (19327 in chips)=20
Seat 7: jnumberone (9070 in chips)=20
Seat 8: Road2daMoney (17614 in chips)=20
Genotype55: posts the ante 60
vincent329: posts the ante 60
JJin91: posts the ante 60
TrademarkTer: posts the ante 60
AASupplier24: posts the ante 60
OceansO7: posts the ante 60
jnumberone: posts the ante 60
Road2daMoney: posts the ante 60
Road2daMoney: posts small blind 250
Genotype55: posts big blind 500
*** HOLE CARDS ***
Dealt to JJin91 [2s 3d]
vincent329: calls 500
JJin91: folds=20
TrademarkTer: folds=20
AASupplier24: folds=20
OceansO7: raises 800 to 1300
jnumberone: folds=20
Road2daMoney: folds=20
Genotype55: calls 800
vincent329: calls 800
*** FLOP *** [Ac Ah 6c]
Genotype55: checks=20
vincent329: checks=20
OceansO7: checks=20
*** TURN *** [Ac Ah 6c] [8s]
Genotype55: bets 4630
vincent329: folds=20
OceansO7: calls 4630
*** RIVER *** [Ac Ah 6c 8s] [Ts]
Genotype55: bets 4500
OceansO7: calls 4500
*** SHOW DOWN ***
Genotype55: shows [9c 8c] (two pair, Aces and Eights)
OceansO7: shows [Kc Ks] (two pair, Aces and Kings)
OceansO7 collected 22890 from pot
*** SUMMARY ***
Total pot 22890 | Rake 0=20
Board [Ac Ah 6c 8s Ts]
Seat 1: Genotype55 (big blind) showed [9c 8c] and lost with two pair, A=
ces and Eights
Seat 2: vincent329 folded on the Turn
Seat 3: JJin91 folded before Flop (didn't bet)
Seat 4: TrademarkTer folded before Flop (didn't bet)
Seat 5: AASupplier24 folded before Flop (didn't bet)
Seat 6: OceansO7 showed [Kc Ks] and won (22890) with two pair, Aces and=
 Kings
Seat 7: jnumberone (button) folded before Flop (didn't bet)
Seat 8: Road2daMoney (small blind) folded before Flop


*********** # 61 **************
PokerStars Hand #169441877427: Tournament #1597684021, $18.20+$1.80 USD=
 Hold'em No Limit - Level XI (250/500) - 2017/05/05 20:52:58 ET
Table '1597684021 2' 9-max Seat #7 is the button
Seat 1: JJin91 (14063 in chips)=20
Seat 2: nwmdnj (24056 in chips)=20
Seat 3: A A 5454 (30318 in chips)=20
Seat 5: MM9955 (37129 in chips)=20
Seat 7: MelzWay (13610 in chips)=20
Seat 8: akbongu1977 (14740 in chips)=20
Seat 9: RynerNJ (10656 in chips)=20
JJin91: posts the ante 60
nwmdnj: posts the ante 60
A A 5454: posts the ante 60
MM9955: posts the ante 60
MelzWay: posts the ante 60
akbongu1977: posts the ante 60
RynerNJ: posts the ante 60
akbongu1977: posts small blind 250
RynerNJ: posts big blind 500
*** HOLE CARDS ***
Dealt to JJin91 [7s 6d]
JJin91: folds=20
nwmdnj: folds=20
A A 5454: folds=20
MM9955: calls 500
MelzWay: calls 500
akbongu1977: raises 14180 to 14680 and is all-in
RynerNJ: folds=20
MM9955: folds=20
MelzWay: folds=20
Uncalled bet (14180) returned to akbongu1977
akbongu1977 collected 2420 from pot
akbongu1977: doesn't show hand=20
*** SUMMARY ***
Total pot 2420 | Rake 0=20
Seat 1: JJin91 folded before Flop (didn't bet)
Seat 2: nwmdnj folded before Flop (didn't bet)
Seat 3: A A 5454 folded before Flop (didn't bet)
Seat 5: MM9955 folded before Flop
Seat 7: MelzWay (button) folded before Flop
Seat 8: akbongu1977 (small blind) collected (2420)
Seat 9: RynerNJ (big blind) folded before Flop


*********** # 62 **************
PokerStars Hand #169441877553: Tournament #1597684021, $18.20+$1.80 USD=
 Hold'em No Limit - Level XI (250/500) - 2017/05/05 20:53:22 ET
Table '1597684021 2' 9-max Seat #8 is the button
Seat 1: JJin91 (14003 in chips)=20
Seat 2: nwmdnj (23996 in chips)=20
Seat 3: A A 5454 (30258 in chips)=20
Seat 5: MM9955 (36569 in chips)=20
Seat 7: MelzWay (13050 in chips)=20
Seat 8: akbongu1977 (16600 in chips)=20
Seat 9: RynerNJ (10096 in chips)=20
JJin91: posts the ante 60
nwmdnj: posts the ante 60
A A 5454: posts the ante 60
MM9955: posts the ante 60
MelzWay: posts the ante 60
akbongu1977: posts the ante 60
RynerNJ: posts the ante 60
RynerNJ: posts small blind 250
JJin91: posts big blind 500
*** HOLE CARDS ***
Dealt to JJin91 [2h Qs]
nwmdnj: folds=20
A A 5454: folds=20
MM9955: folds=20
MelzWay: folds=20
akbongu1977: folds=20
RynerNJ: calls 250
JJin91: checks=20
*** FLOP *** [2d 9d 8h]
RynerNJ: bets 500
JJin91: calls 500
*** TURN *** [2d 9d 8h] [7s]
RynerNJ: bets 1575
JJin91: folds=20
Uncalled bet (1575) returned to RynerNJ
RynerNJ collected 2420 from pot
RynerNJ: doesn't show hand=20
*** SUMMARY ***
Total pot 2420 | Rake 0=20
Board [2d 9d 8h 7s]
Seat 1: JJin91 (big blind) folded on the Turn
Seat 2: nwmdnj folded before Flop (didn't bet)
Seat 3: A A 5454 folded before Flop (didn't bet)
Seat 5: MM9955 folded before Flop (didn't bet)
Seat 7: MelzWay folded before Flop (didn't bet)
Seat 8: akbongu1977 (button) folded before Flop (didn't bet)
Seat 9: RynerNJ (small blind) collected (2420)


*********** # 63 **************
PokerStars Hand #169441877730: Tournament #1597684021, $18.20+$1.80 USD=
 Hold'em No Limit - Level XI (250/500) - 2017/05/05 20:53:56 ET
Table '1597684021 2' 9-max Seat #9 is the button
Seat 1: JJin91 (12943 in chips)=20
Seat 2: nwmdnj (23936 in chips)=20
Seat 3: A A 5454 (30198 in chips)=20
Seat 5: MM9955 (36509 in chips)=20
Seat 7: MelzWay (12990 in chips)=20
Seat 8: akbongu1977 (16540 in chips)=20
Seat 9: RynerNJ (11456 in chips)=20
JJin91: posts the ante 60
nwmdnj: posts the ante 60
A A 5454: posts the ante 60
MM9955: posts the ante 60
MelzWay: posts the ante 60
akbongu1977: posts the ante 60
RynerNJ: posts the ante 60
JJin91: posts small blind 250
nwmdnj: posts big blind 500
*** HOLE CARDS ***
Dealt to JJin91 [Kd 5h]
A A 5454: calls 500
MM9955: folds=20
MelzWay: folds=20
akbongu1977: raises 15980 to 16480 and is all-in
RynerNJ: folds=20
JJin91: folds=20
nwmdnj: folds=20
A A 5454: folds=20
Uncalled bet (15980) returned to akbongu1977
akbongu1977 collected 2170 from pot
akbongu1977: doesn't show hand=20
*** SUMMARY ***
Total pot 2170 | Rake 0=20
Seat 1: JJin91 (small blind) folded before Flop
Seat 2: nwmdnj (big blind) folded before Flop
Seat 3: A A 5454 folded before Flop
Seat 5: MM9955 folded before Flop (didn't bet)
Seat 7: MelzWay folded before Flop (didn't bet)
Seat 8: akbongu1977 collected (2170)
Seat 9: RynerNJ (button) folded before Flop (didn't bet)


*********** # 64 **************
PokerStars Hand #169441877842: Tournament #1597684021, $18.20+$1.80 USD=
 Hold'em No Limit - Level XI (250/500) - 2017/05/05 20:54:17 ET
Table '1597684021 2' 9-max Seat #1 is the button
Seat 1: JJin91 (12633 in chips)=20
Seat 2: nwmdnj (23376 in chips)=20
Seat 3: A A 5454 (29638 in chips)=20
Seat 5: MM9955 (36449 in chips)=20
Seat 7: MelzWay (12930 in chips)=20
Seat 8: akbongu1977 (18150 in chips)=20
Seat 9: RynerNJ (11396 in chips)=20
JJin91: posts the ante 60
nwmdnj: posts the ante 60
A A 5454: posts the ante 60
MM9955: posts the ante 60
MelzWay: posts the ante 60
akbongu1977: posts the ante 60
RynerNJ: posts the ante 60
nwmdnj: posts small blind 250
A A 5454: posts big blind 500
*** HOLE CARDS ***
Dealt to JJin91 [Qd 4c]
MM9955: folds=20
MelzWay: folds=20
akbongu1977: folds=20
RynerNJ: folds=20
JJin91: folds=20
nwmdnj: folds=20
Uncalled bet (250) returned to A A 5454
A A 5454 collected 920 from pot
A A 5454: doesn't show hand=20
*** SUMMARY ***
Total pot 920 | Rake 0=20
Seat 1: JJin91 (button) folded before Flop (didn't bet)
Seat 2: nwmdnj (small blind) folded before Flop
Seat 3: A A 5454 (big blind) collected (920)
Seat 5: MM9955 folded before Flop (didn't bet)
Seat 7: MelzWay folded before Flop (didn't bet)
Seat 8: akbongu1977 folded before Flop (didn't bet)
Seat 9: RynerNJ folded before Flop (didn't bet)


*********** # 65 **************
PokerStars Hand #169441877912: Tournament #1597684021, $18.20+$1.80 USD=
 Hold'em No Limit - Level XI (250/500) - 2017/05/05 20:54:32 ET
Table '1597684021 2' 9-max Seat #2 is the button
Seat 1: JJin91 (12573 in chips)=20
Seat 2: nwmdnj (23066 in chips)=20
Seat 3: A A 5454 (30248 in chips)=20
Seat 5: MM9955 (36389 in chips)=20
Seat 7: MelzWay (12870 in chips)=20
Seat 8: akbongu1977 (18090 in chips)=20
Seat 9: RynerNJ (11336 in chips)=20
JJin91: posts the ante 60
nwmdnj: posts the ante 60
A A 5454: posts the ante 60
MM9955: posts the ante 60
MelzWay: posts the ante 60
akbongu1977: posts the ante 60
RynerNJ: posts the ante 60
A A 5454: posts small blind 250
MM9955: posts big blind 500
*** HOLE CARDS ***
Dealt to JJin91 [6h 6d]
MelzWay: calls 500
akbongu1977: folds=20
RynerNJ: folds=20
JJin91: raises 1751 to 2251
nwmdnj: folds=20
A A 5454: folds=20
MM9955: folds=20
MelzWay: folds=20
Uncalled bet (1751) returned to JJin91
JJin91 collected 2170 from pot
JJin91: doesn't show hand=20
*** SUMMARY ***
Total pot 2170 | Rake 0=20
Seat 1: JJin91 collected (2170)
Seat 2: nwmdnj (button) folded before Flop (didn't bet)
Seat 3: A A 5454 (small blind) folded before Flop
Seat 5: MM9955 (big blind) folded before Flop
Seat 7: MelzWay folded before Flop
Seat 8: akbongu1977 folded before Flop (didn't bet)
Seat 9: RynerNJ folded before Flop (didn't bet)


*********** # 66 **************
PokerStars Hand #169441879498: Tournament #1597684021, $18.20+$1.80 USD=
 Hold'em No Limit - Level XI (250/500) - 2017/05/05 21:01:02 ET
Table '1597684021 2' 9-max Seat #3 is the button
Seat 1: JJin91 (14183 in chips)=20
Seat 2: nwmdnj (23006 in chips)=20
Seat 3: A A 5454 (29938 in chips)=20
Seat 4: Maximus5828 (10000 in chips) out of hand (moved from another ta=
ble into small blind)
Seat 5: MM9955 (35829 in chips)=20
Seat 6: jaysu (10000 in chips)=20
Seat 7: MelzWay (12310 in chips)=20
Seat 8: akbongu1977 (18030 in chips)=20
Seat 9: RynerNJ (11276 in chips)=20
JJin91: posts the ante 60
nwmdnj: posts the ante 60
A A 5454: posts the ante 60
MM9955: posts the ante 60
jaysu: posts the ante 60
MelzWay: posts the ante 60
akbongu1977: posts the ante 60
RynerNJ: posts the ante 60
MM9955: posts small blind 250
jaysu: posts big blind 500
*** HOLE CARDS ***
Dealt to JJin91 [Ad 2s]
MelzWay: calls 500
akbongu1977: folds=20
RynerNJ: folds=20
JJin91: folds=20
nwmdnj: folds=20
A A 5454: folds=20
MM9955: calls 250
jaysu: checks=20
*** FLOP *** [6c Jh Ks]
MM9955: checks=20
jaysu: checks=20
MelzWay: checks=20
*** TURN *** [6c Jh Ks] [Js]
MM9955: checks=20
jaysu: checks=20
MelzWay: checks=20
*** RIVER *** [6c Jh Ks Js] [6d]
MM9955: bets 500
jaysu: folds=20
MelzWay: folds=20
Uncalled bet (500) returned to MM9955
MM9955 collected 1980 from pot
MM9955: doesn't show hand=20
*** SUMMARY ***
Total pot 1980 | Rake 0=20
Board [6c Jh Ks Js 6d]
Seat 1: JJin91 folded before Flop (didn't bet)
Seat 2: nwmdnj folded before Flop (didn't bet)
Seat 3: A A 5454 (button) folded before Flop (didn't bet)
Seat 5: MM9955 (small blind) collected (1980)
Seat 6: jaysu (big blind) folded on the River
Seat 7: MelzWay folded on the River
Seat 8: akbongu1977 folded before Flop (didn't bet)
Seat 9: RynerNJ folded before Flop (didn't bet)


*********** # 67 **************
PokerStars Hand #169441879961: Tournament #1597684021, $18.20+$1.80 USD=
 Hold'em No Limit - Level XII (300/600) - 2017/05/05 21:02:44 ET
Table '1597684021 2' 9-max Seat #5 is the button
Seat 1: JJin91 (14123 in chips)=20
Seat 2: nwmdnj (22946 in chips)=20
Seat 3: A A 5454 (29878 in chips)=20
Seat 4: Maximus5828 (10000 in chips)=20
Seat 5: MM9955 (37249 in chips)=20
Seat 6: jaysu (9440 in chips)=20
Seat 8: akbongu1977 (17970 in chips)=20
Seat 9: RynerNJ (11216 in chips)=20
JJin91: posts the ante 70
nwmdnj: posts the ante 70
A A 5454: posts the ante 70
Maximus5828: posts the ante 70
MM9955: posts the ante 70
jaysu: posts the ante 70
akbongu1977: posts the ante 70
RynerNJ: posts the ante 70
jaysu: posts small blind 300
akbongu1977: posts big blind 600
*** HOLE CARDS ***
Dealt to JJin91 [8s 5c]
RynerNJ: folds=20
JJin91: folds=20
nwmdnj: folds=20
A A 5454: folds=20
Maximus5828: folds=20
MM9955: raises 1200 to 1800
jaysu: folds=20
akbongu1977: folds=20
Uncalled bet (1200) returned to MM9955
MM9955 collected 2060 from pot
MM9955: doesn't show hand=20
*** SUMMARY ***
Total pot 2060 | Rake 0=20
Seat 1: JJin91 folded before Flop (didn't bet)
Seat 2: nwmdnj folded before Flop (didn't bet)
Seat 3: A A 5454 folded before Flop (didn't bet)
Seat 4: Maximus5828 folded before Flop (didn't bet)
Seat 5: MM9955 (button) collected (2060)
Seat 6: jaysu (small blind) folded before Flop
Seat 8: akbongu1977 (big blind) folded before Flop
Seat 9: RynerNJ folded before Flop (didn't bet)


*********** # 68 **************
PokerStars Hand #169443326105: Tournament #1597684021, $18.20+$1.80 USD=
 Hold'em No Limit - Level XII (300/600) - 2017/05/05 21:03:13 ET
Table '1597684021 2' 9-max Seat #6 is the button
Seat 1: JJin91 (14053 in chips)=20
Seat 2: nwmdnj (22876 in chips)=20
Seat 3: A A 5454 (29808 in chips)=20
Seat 4: Maximus5828 (9930 in chips)=20
Seat 5: MM9955 (38639 in chips)=20
Seat 6: jaysu (9070 in chips)=20
Seat 8: akbongu1977 (17300 in chips)=20
Seat 9: RynerNJ (11146 in chips)=20
JJin91: posts the ante 70
nwmdnj: posts the ante 70
A A 5454: posts the ante 70
Maximus5828: posts the ante 70
MM9955: posts the ante 70
jaysu: posts the ante 70
akbongu1977: posts the ante 70
RynerNJ: posts the ante 70
akbongu1977: posts small blind 300
RynerNJ: posts big blind 600
*** HOLE CARDS ***
Dealt to JJin91 [Ac Jc]
JJin91: raises 846 to 1446
nwmdnj: folds=20
A A 5454: folds=20
Maximus5828: calls 1446
MM9955: folds=20
jaysu: folds=20
akbongu1977: folds=20
RynerNJ: calls 846
*** FLOP *** [3d 7h 2d]
RynerNJ: checks=20
JJin91: bets 1611
Maximus5828: folds=20
RynerNJ: raises 8019 to 9630 and is all-in
JJin91: folds=20
Uncalled bet (8019) returned to RynerNJ
RynerNJ collected 8420 from pot
RynerNJ: doesn't show hand=20
*** SUMMARY ***
Total pot 8420 | Rake 0=20
Board [3d 7h 2d]
Seat 1: JJin91 folded on the Flop
Seat 2: nwmdnj folded before Flop (didn't bet)
Seat 3: A A 5454 folded before Flop (didn't bet)
Seat 4: Maximus5828 folded on the Flop
Seat 5: MM9955 folded before Flop (didn't bet)
Seat 6: jaysu (button) folded before Flop (didn't bet)
Seat 8: akbongu1977 (small blind) folded before Flop
Seat 9: RynerNJ (big blind) collected (8420)


*********** # 69 **************
PokerStars Hand #169443326336: Tournament #1597684021, $18.20+$1.80 USD=
 Hold'em No Limit - Level XII (300/600) - 2017/05/05 21:04:01 ET
Table '1597684021 2' 9-max Seat #8 is the button
Seat 1: JJin91 (10926 in chips)=20
Seat 2: nwmdnj (22806 in chips)=20
Seat 3: A A 5454 (29738 in chips)=20
Seat 4: Maximus5828 (8414 in chips)=20
Seat 5: MM9955 (38569 in chips)=20
Seat 6: jaysu (9000 in chips)=20
Seat 8: akbongu1977 (16930 in chips)=20
Seat 9: RynerNJ (16439 in chips)=20
JJin91: posts the ante 70
nwmdnj: posts the ante 70
A A 5454: posts the ante 70
Maximus5828: posts the ante 70
MM9955: posts the ante 70
jaysu: posts the ante 70
akbongu1977: posts the ante 70
RynerNJ: posts the ante 70
RynerNJ: posts small blind 300
JJin91: posts big blind 600
*** HOLE CARDS ***
Dealt to JJin91 [9d Qh]
nwmdnj: folds=20
A A 5454: folds=20
Maximus5828: folds=20
MM9955: calls 600
jaysu: folds=20
akbongu1977: folds=20
RynerNJ: calls 300
JJin91: checks=20
*** FLOP *** [9s Td 3c]
RynerNJ: checks=20
JJin91: checks=20
MM9955: bets 600
RynerNJ: folds=20
JJin91: calls 600
*** TURN *** [9s Td 3c] [8s]
JJin91: checks=20
MM9955: checks=20
*** RIVER *** [9s Td 3c 8s] [5d]
JJin91: bets 1887
MM9955: folds=20
Uncalled bet (1887) returned to JJin91
JJin91 collected 3560 from pot
JJin91: doesn't show hand=20
*** SUMMARY ***
Total pot 3560 | Rake 0=20
Board [9s Td 3c 8s 5d]
Seat 1: JJin91 (big blind) collected (3560)
Seat 2: nwmdnj folded before Flop (didn't bet)
Seat 3: A A 5454 folded before Flop (didn't bet)
Seat 4: Maximus5828 folded before Flop (didn't bet)
Seat 5: MM9955 folded on the River
Seat 6: jaysu folded before Flop (didn't bet)
Seat 8: akbongu1977 (button) folded before Flop (didn't bet)
Seat 9: RynerNJ (small blind) folded on the Flop


*********** # 70 **************
PokerStars Hand #169443326626: Tournament #1597684021, $18.20+$1.80 USD=
 Hold'em No Limit - Level XII (300/600) - 2017/05/05 21:05:05 ET
Table '1597684021 2' 9-max Seat #9 is the button
Seat 1: JJin91 (13216 in chips)=20
Seat 2: nwmdnj (22736 in chips)=20
Seat 3: A A 5454 (29668 in chips)=20
Seat 4: Maximus5828 (8344 in chips)=20
Seat 5: MM9955 (37299 in chips)=20
Seat 6: jaysu (8930 in chips)=20
Seat 8: akbongu1977 (16860 in chips)=20
Seat 9: RynerNJ (15769 in chips)=20
JJin91: posts the ante 70
nwmdnj: posts the ante 70
A A 5454: posts the ante 70
Maximus5828: posts the ante 70
MM9955: posts the ante 70
jaysu: posts the ante 70
akbongu1977: posts the ante 70
RynerNJ: posts the ante 70
JJin91: posts small blind 300
nwmdnj: posts big blind 600
*** HOLE CARDS ***
Dealt to JJin91 [7d 2d]
A A 5454: calls 600
Maximus5828: folds=20
MM9955: folds=20
jaysu: folds=20
akbongu1977: folds=20
RynerNJ: folds=20
JJin91: folds=20
nwmdnj: checks=20
*** FLOP *** [6s Qs Jc]
nwmdnj: checks=20
A A 5454: bets 2060
nwmdnj: folds=20
Uncalled bet (2060) returned to A A 5454
A A 5454 collected 2060 from pot
A A 5454: doesn't show hand=20
*** SUMMARY ***
Total pot 2060 | Rake 0=20
Board [6s Qs Jc]
Seat 1: JJin91 (small blind) folded before Flop
Seat 2: nwmdnj (big blind) folded on the Flop
Seat 3: A A 5454 collected (2060)
Seat 4: Maximus5828 folded before Flop (didn't bet)
Seat 5: MM9955 folded before Flop (didn't bet)
Seat 6: jaysu folded before Flop (didn't bet)
Seat 8: akbongu1977 folded before Flop (didn't bet)
Seat 9: RynerNJ (button) folded before Flop (didn't bet)


*********** # 71 **************
PokerStars Hand #169443326779: Tournament #1597684021, $18.20+$1.80 USD=
 Hold'em No Limit - Level XII (300/600) - 2017/05/05 21:05:38 ET
Table '1597684021 2' 9-max Seat #1 is the button
Seat 1: JJin91 (12846 in chips)=20
Seat 2: nwmdnj (22066 in chips)=20
Seat 3: A A 5454 (31058 in chips)=20
Seat 4: Maximus5828 (8274 in chips)=20
Seat 5: MM9955 (37229 in chips)=20
Seat 6: jaysu (8860 in chips)=20
Seat 8: akbongu1977 (16790 in chips)=20
Seat 9: RynerNJ (15699 in chips)=20
JJin91: posts the ante 70
nwmdnj: posts the ante 70
A A 5454: posts the ante 70
Maximus5828: posts the ante 70
MM9955: posts the ante 70
jaysu: posts the ante 70
akbongu1977: posts the ante 70
RynerNJ: posts the ante 70
nwmdnj: posts small blind 300
A A 5454: posts big blind 600
*** HOLE CARDS ***
Dealt to JJin91 [8c Ac]
Maximus5828: raises 600 to 1200
MM9955: folds=20
jaysu: raises 7590 to 8790 and is all-in
akbongu1977: folds=20
RynerNJ: folds=20
JJin91: folds=20
nwmdnj: folds=20
A A 5454: folds=20
Maximus5828: folds=20
Uncalled bet (7590) returned to jaysu
jaysu collected 3860 from pot
jaysu: doesn't show hand=20
*** SUMMARY ***
Total pot 3860 | Rake 0=20
Seat 1: JJin91 (button) folded before Flop (didn't bet)
Seat 2: nwmdnj (small blind) folded before Flop
Seat 3: A A 5454 (big blind) folded before Flop
Seat 4: Maximus5828 folded before Flop
Seat 5: MM9955 folded before Flop (didn't bet)
Seat 6: jaysu collected (3860)
Seat 8: akbongu1977 folded before Flop (didn't bet)
Seat 9: RynerNJ folded before Flop (didn't bet)


*********** # 72 **************
PokerStars Hand #169443326960: Tournament #1597684021, $18.20+$1.80 USD=
 Hold'em No Limit - Level XII (300/600) - 2017/05/05 21:06:19 ET
Table '1597684021 2' 9-max Seat #2 is the button
Seat 1: JJin91 (12776 in chips)=20
Seat 2: nwmdnj (21696 in chips)=20
Seat 3: A A 5454 (30388 in chips)=20
Seat 4: Maximus5828 (7004 in chips)=20
Seat 5: MM9955 (37159 in chips)=20
Seat 6: jaysu (11450 in chips)=20
Seat 8: akbongu1977 (16720 in chips)=20
Seat 9: RynerNJ (15629 in chips)=20
JJin91: posts the ante 70
nwmdnj: posts the ante 70
A A 5454: posts the ante 70
Maximus5828: posts the ante 70
MM9955: posts the ante 70
jaysu: posts the ante 70
akbongu1977: posts the ante 70
RynerNJ: posts the ante 70
A A 5454: posts small blind 300
Maximus5828: posts big blind 600
*** HOLE CARDS ***
Dealt to JJin91 [Js Qd]
MM9955: folds=20
jaysu: folds=20
akbongu1977: calls 600
RynerNJ: folds=20
JJin91: raises 1200 to 1800
nwmdnj: folds=20
A A 5454: folds=20
Maximus5828: calls 1200
akbongu1977: calls 1200
*** FLOP *** [8s 4c Ks]
Maximus5828: checks=20
akbongu1977: bets 14850 and is all-in
JJin91: folds=20
Maximus5828: folds=20
Uncalled bet (14850) returned to akbongu1977
akbongu1977 collected 6260 from pot
akbongu1977: doesn't show hand=20
*** SUMMARY ***
Total pot 6260 | Rake 0=20
Board [8s 4c Ks]
Seat 1: JJin91 folded on the Flop
Seat 2: nwmdnj (button) folded before Flop (didn't bet)
Seat 3: A A 5454 (small blind) folded before Flop
Seat 4: Maximus5828 (big blind) folded on the Flop
Seat 5: MM9955 folded before Flop (didn't bet)
Seat 6: jaysu folded before Flop (didn't bet)
Seat 8: akbongu1977 collected (6260)
Seat 9: RynerNJ folded before Flop (didn't bet)


*********** # 73 **************
PokerStars Hand #169443327176: Tournament #1597684021, $18.20+$1.80 USD=
 Hold'em No Limit - Level XII (300/600) - 2017/05/05 21:07:10 ET
Table '1597684021 2' 9-max Seat #3 is the button
Seat 1: JJin91 (10906 in chips)=20
Seat 2: nwmdnj (21626 in chips)=20
Seat 3: A A 5454 (30018 in chips)=20
Seat 4: Maximus5828 (5134 in chips)=20
Seat 5: MM9955 (37089 in chips)=20
Seat 6: jaysu (11380 in chips)=20
Seat 7: ThulsaDoom69 (9888 in chips)=20
Seat 8: akbongu1977 (21110 in chips)=20
Seat 9: RynerNJ (15559 in chips)=20
JJin91: posts the ante 70
nwmdnj: posts the ante 70
A A 5454: posts the ante 70
Maximus5828: posts the ante 70
MM9955: posts the ante 70
jaysu: posts the ante 70
ThulsaDoom69: posts the ante 70
akbongu1977: posts the ante 70
RynerNJ: posts the ante 70
Maximus5828: posts small blind 300
MM9955: posts big blind 600
*** HOLE CARDS ***
Dealt to JJin91 [3s 8h]
jaysu: raises 688 to 1288
ThulsaDoom69: calls 1288
akbongu1977: folds=20
RynerNJ: folds=20
JJin91: folds=20
nwmdnj: folds=20
A A 5454: folds=20
Maximus5828: folds=20
MM9955: calls 688
*** FLOP *** [2c 8s 9h]
MM9955: bets 2397
jaysu: folds=20
ThulsaDoom69: folds=20
Uncalled bet (2397) returned to MM9955
MM9955 collected 4794 from pot
MM9955: doesn't show hand=20
*** SUMMARY ***
Total pot 4794 | Rake 0=20
Board [2c 8s 9h]
Seat 1: JJin91 folded before Flop (didn't bet)
Seat 2: nwmdnj folded before Flop (didn't bet)
Seat 3: A A 5454 (button) folded before Flop (didn't bet)
Seat 4: Maximus5828 (small blind) folded before Flop
Seat 5: MM9955 (big blind) collected (4794)
Seat 6: jaysu folded on the Flop
Seat 7: ThulsaDoom69 folded on the Flop
Seat 8: akbongu1977 folded before Flop (didn't bet)
Seat 9: RynerNJ folded before Flop (didn't bet)


*********** # 74 **************
PokerStars Hand #169443327414: Tournament #1597684021, $18.20+$1.80 USD=
 Hold'em No Limit - Level XII (300/600) - 2017/05/05 21:08:02 ET
Table '1597684021 2' 9-max Seat #4 is the button
Seat 1: JJin91 (10836 in chips)=20
Seat 2: nwmdnj (21556 in chips)=20
Seat 3: A A 5454 (29948 in chips)=20
Seat 4: Maximus5828 (4764 in chips)=20
Seat 5: MM9955 (40525 in chips)=20
Seat 6: jaysu (10022 in chips)=20
Seat 7: ThulsaDoom69 (8530 in chips)=20
Seat 8: akbongu1977 (21040 in chips)=20
Seat 9: RynerNJ (15489 in chips)=20
JJin91: posts the ante 70
nwmdnj: posts the ante 70
A A 5454: posts the ante 70
Maximus5828: posts the ante 70
MM9955: posts the ante 70
jaysu: posts the ante 70
ThulsaDoom69: posts the ante 70
akbongu1977: posts the ante 70
RynerNJ: posts the ante 70
MM9955: posts small blind 300
jaysu: posts big blind 600
*** HOLE CARDS ***
Dealt to JJin91 [7d As]
ThulsaDoom69: folds=20
akbongu1977: folds=20
RynerNJ: folds=20
JJin91: folds=20
nwmdnj: folds=20
A A 5454: folds=20
Maximus5828: folds=20
MM9955: calls 300
jaysu: raises 9352 to 9952 and is all-in
MM9955: folds=20
Uncalled bet (9352) returned to jaysu
jaysu collected 1830 from pot
jaysu: doesn't show hand=20
*** SUMMARY ***
Total pot 1830 | Rake 0=20
Seat 1: JJin91 folded before Flop (didn't bet)
Seat 2: nwmdnj folded before Flop (didn't bet)
Seat 3: A A 5454 folded before Flop (didn't bet)
Seat 4: Maximus5828 (button) folded before Flop (didn't bet)
Seat 5: MM9955 (small blind) folded before Flop
Seat 6: jaysu (big blind) collected (1830)
Seat 7: ThulsaDoom69 folded before Flop (didn't bet)
Seat 8: akbongu1977 folded before Flop (didn't bet)
Seat 9: RynerNJ folded before Flop (didn't bet)


*********** # 75 **************
PokerStars Hand #169443327571: Tournament #1597684021, $18.20+$1.80 USD=
 Hold'em No Limit - Level XII (300/600) - 2017/05/05 21:08:37 ET
Table '1597684021 2' 9-max Seat #5 is the button
Seat 1: JJin91 (10766 in chips)=20
Seat 2: nwmdnj (21486 in chips)=20
Seat 3: A A 5454 (29878 in chips)=20
Seat 4: Maximus5828 (4694 in chips)=20
Seat 5: MM9955 (39855 in chips)=20
Seat 6: jaysu (11182 in chips)=20
Seat 7: ThulsaDoom69 (8460 in chips)=20
Seat 8: akbongu1977 (20970 in chips)=20
Seat 9: RynerNJ (15419 in chips)=20
JJin91: posts the ante 70
nwmdnj: posts the ante 70
A A 5454: posts the ante 70
Maximus5828: posts the ante 70
MM9955: posts the ante 70
jaysu: posts the ante 70
ThulsaDoom69: posts the ante 70
akbongu1977: posts the ante 70
RynerNJ: posts the ante 70
jaysu: posts small blind 300
ThulsaDoom69: posts big blind 600
*** HOLE CARDS ***
Dealt to JJin91 [Qh 4d]
akbongu1977: folds=20
RynerNJ: folds=20
JJin91: folds=20
nwmdnj: folds=20
A A 5454: folds=20
Maximus5828: raises 4024 to 4624 and is all-in
MM9955: folds=20
jaysu: folds=20
ThulsaDoom69: folds=20
Uncalled bet (4024) returned to Maximus5828
Maximus5828 collected 2130 from pot
Maximus5828: doesn't show hand=20
*** SUMMARY ***
Total pot 2130 | Rake 0=20
Seat 1: JJin91 folded before Flop (didn't bet)
Seat 2: nwmdnj folded before Flop (didn't bet)
Seat 3: A A 5454 folded before Flop (didn't bet)
Seat 4: Maximus5828 collected (2130)
Seat 5: MM9955 (button) folded before Flop (didn't bet)
Seat 6: jaysu (small blind) folded before Flop
Seat 7: ThulsaDoom69 (big blind) folded before Flop
Seat 8: akbongu1977 folded before Flop (didn't bet)
Seat 9: RynerNJ folded before Flop (didn't bet)


*********** # 76 **************
PokerStars Hand #169443327672: Tournament #1597684021, $18.20+$1.80 USD=
 Hold'em No Limit - Level XII (300/600) - 2017/05/05 21:08:59 ET
Table '1597684021 2' 9-max Seat #6 is the button
Seat 1: JJin91 (10696 in chips)=20
Seat 2: nwmdnj (21416 in chips)=20
Seat 3: A A 5454 (29808 in chips)=20
Seat 4: Maximus5828 (6154 in chips)=20
Seat 5: MM9955 (39785 in chips)=20
Seat 6: jaysu (10812 in chips)=20
Seat 7: ThulsaDoom69 (7790 in chips)=20
Seat 8: akbongu1977 (20900 in chips)=20
Seat 9: RynerNJ (15349 in chips)=20
JJin91: posts the ante 70
nwmdnj: posts the ante 70
A A 5454: posts the ante 70
Maximus5828: posts the ante 70
MM9955: posts the ante 70
jaysu: posts the ante 70
ThulsaDoom69: posts the ante 70
akbongu1977: posts the ante 70
RynerNJ: posts the ante 70
ThulsaDoom69: posts small blind 300
akbongu1977: posts big blind 600
*** HOLE CARDS ***
Dealt to JJin91 [Jd Tc]
RynerNJ: folds=20
JJin91: folds=20
nwmdnj: folds=20
A A 5454: calls 600
Maximus5828: folds=20
MM9955: folds=20
jaysu: folds=20
ThulsaDoom69: calls 300
akbongu1977: checks=20
*** FLOP *** [2c 7h Kd]
ThulsaDoom69: checks=20
akbongu1977: checks=20
A A 5454: bets 1215
ThulsaDoom69: folds=20
akbongu1977: folds=20
Uncalled bet (1215) returned to A A 5454
A A 5454 collected 2430 from pot
A A 5454: doesn't show hand=20
*** SUMMARY ***
Total pot 2430 | Rake 0=20
Board [2c 7h Kd]
Seat 1: JJin91 folded before Flop (didn't bet)
Seat 2: nwmdnj folded before Flop (didn't bet)
Seat 3: A A 5454 collected (2430)
Seat 4: Maximus5828 folded before Flop (didn't bet)
Seat 5: MM9955 folded before Flop (didn't bet)
Seat 6: jaysu (button) folded before Flop (didn't bet)
Seat 7: ThulsaDoom69 (small blind) folded on the Flop
Seat 8: akbongu1977 (big blind) folded on the Flop
Seat 9: RynerNJ folded before Flop (didn't bet)


*********** # 77 **************
PokerStars Hand #169443327872: Tournament #1597684021, $18.20+$1.80 USD=
 Hold'em No Limit - Level XII (300/600) - 2017/05/05 21:09:42 ET
Table '1597684021 2' 9-max Seat #7 is the button
Seat 1: JJin91 (10626 in chips)=20
Seat 2: nwmdnj (21346 in chips)=20
Seat 3: A A 5454 (31568 in chips)=20
Seat 4: Maximus5828 (6084 in chips)=20
Seat 5: MM9955 (39715 in chips)=20
Seat 6: jaysu (10742 in chips)=20
Seat 7: ThulsaDoom69 (7120 in chips)=20
Seat 8: akbongu1977 (20230 in chips)=20
Seat 9: RynerNJ (15279 in chips)=20
JJin91: posts the ante 70
nwmdnj: posts the ante 70
A A 5454: posts the ante 70
Maximus5828: posts the ante 70
MM9955: posts the ante 70
jaysu: posts the ante 70
ThulsaDoom69: posts the ante 70
akbongu1977: posts the ante 70
RynerNJ: posts the ante 70
akbongu1977: posts small blind 300
RynerNJ: posts big blind 600
*** HOLE CARDS ***
Dealt to JJin91 [Ks 9s]
JJin91: raises 666 to 1266
nwmdnj: folds=20
A A 5454: folds=20
Maximus5828: folds=20
MM9955: folds=20
jaysu: folds=20
ThulsaDoom69: folds=20
akbongu1977: folds=20
RynerNJ: calls 666
*** FLOP *** [2h 5s Th]
RynerNJ: checks=20
JJin91: checks=20
*** TURN *** [2h 5s Th] [5h]
RynerNJ: checks=20
JJin91: checks=20
*** RIVER *** [2h 5s Th 5h] [9c]
RynerNJ: checks=20
JJin91: checks=20
*** SHOW DOWN ***
RynerNJ: shows [Qh Kc] (a pair of Fives)
JJin91: shows [Ks 9s] (two pair, Nines and Fives)
JJin91 collected 3462 from pot
*** SUMMARY ***
Total pot 3462 | Rake 0=20
Board [2h 5s Th 5h 9c]
Seat 1: JJin91 showed [Ks 9s] and won (3462) with two pair, Nines and F=
ives
Seat 2: nwmdnj folded before Flop (didn't bet)
Seat 3: A A 5454 folded before Flop (didn't bet)
Seat 4: Maximus5828 folded before Flop (didn't bet)
Seat 5: MM9955 folded before Flop (didn't bet)
Seat 6: jaysu folded before Flop (didn't bet)
Seat 7: ThulsaDoom69 (button) folded before Flop (didn't bet)
Seat 8: akbongu1977 (small blind) folded before Flop
Seat 9: RynerNJ (big blind) showed [Qh Kc] and lost with a pair of Fives


*********** # 78 **************
PokerStars Hand #169443328169: Tournament #1597684021, $18.20+$1.80 USD=
 Hold'em No Limit - Level XII (300/600) - 2017/05/05 21:10:49 ET
Table '1597684021 2' 9-max Seat #8 is the button
Seat 1: JJin91 (12752 in chips)=20
Seat 2: nwmdnj (21276 in chips)=20
Seat 3: A A 5454 (31498 in chips)=20
Seat 4: Maximus5828 (6014 in chips)=20
Seat 5: MM9955 (39645 in chips)=20
Seat 6: jaysu (10672 in chips)=20
Seat 7: ThulsaDoom69 (7050 in chips)=20
Seat 8: akbongu1977 (19860 in chips)=20
Seat 9: RynerNJ (13943 in chips)=20
JJin91: posts the ante 70
nwmdnj: posts the ante 70
A A 5454: posts the ante 70
Maximus5828: posts the ante 70
MM9955: posts the ante 70
jaysu: posts the ante 70
ThulsaDoom69: posts the ante 70
akbongu1977: posts the ante 70
RynerNJ: posts the ante 70
RynerNJ: posts small blind 300
JJin91: posts big blind 600
*** HOLE CARDS ***
Dealt to JJin91 [5h 5d]
nwmdnj: folds=20
A A 5454: folds=20
Maximus5828: folds=20
MM9955: folds=20
jaysu: folds=20
ThulsaDoom69: folds=20
akbongu1977: folds=20
RynerNJ: calls 300
JJin91: checks=20
*** FLOP *** [Ah 2s Ac]
RynerNJ: checks=20
JJin91: bets 970
RynerNJ: folds=20
Uncalled bet (970) returned to JJin91
JJin91 collected 1830 from pot
JJin91: doesn't show hand=20
*** SUMMARY ***
Total pot 1830 | Rake 0=20
Board [Ah 2s Ac]
Seat 1: JJin91 (big blind) collected (1830)
Seat 2: nwmdnj folded before Flop (didn't bet)
Seat 3: A A 5454 folded before Flop (didn't bet)
Seat 4: Maximus5828 folded before Flop (didn't bet)
Seat 5: MM9955 folded before Flop (didn't bet)
Seat 6: jaysu folded before Flop (didn't bet)
Seat 7: ThulsaDoom69 folded before Flop (didn't bet)
Seat 8: akbongu1977 (button) folded before Flop (didn't bet)
Seat 9: RynerNJ (small blind) folded on the Flop


*********** # 79 **************
PokerStars Hand #169443328392: Tournament #1597684021, $18.20+$1.80 USD=
 Hold'em No Limit - Level XII (300/600) - 2017/05/05 21:11:36 ET
Table '1597684021 2' 9-max Seat #9 is the button
Seat 1: JJin91 (13912 in chips)=20
Seat 2: nwmdnj (21206 in chips)=20
Seat 3: A A 5454 (31428 in chips)=20
Seat 4: Maximus5828 (5944 in chips)=20
Seat 5: MM9955 (39575 in chips)=20
Seat 6: jaysu (10602 in chips)=20
Seat 7: ThulsaDoom69 (6980 in chips)=20
Seat 8: akbongu1977 (19790 in chips)=20
Seat 9: RynerNJ (13273 in chips)=20
JJin91: posts the ante 70
nwmdnj: posts the ante 70
A A 5454: posts the ante 70
Maximus5828: posts the ante 70
MM9955: posts the ante 70
jaysu: posts the ante 70
ThulsaDoom69: posts the ante 70
akbongu1977: posts the ante 70
RynerNJ: posts the ante 70
JJin91: posts small blind 300
nwmdnj: posts big blind 600
*** HOLE CARDS ***
Dealt to JJin91 [4c Qc]
A A 5454: folds=20
Maximus5828: calls 600
MM9955: folds=20
jaysu: folds=20
ThulsaDoom69: raises 6310 to 6910 and is all-in
akbongu1977: folds=20
RynerNJ: folds=20
JJin91: folds=20
nwmdnj: folds=20
Maximus5828: folds=20
Uncalled bet (6310) returned to ThulsaDoom69
ThulsaDoom69 collected 2730 from pot
ThulsaDoom69: doesn't show hand=20
*** SUMMARY ***
Total pot 2730 | Rake 0=20
Seat 1: JJin91 (small blind) folded before Flop
Seat 2: nwmdnj (big blind) folded before Flop
Seat 3: A A 5454 folded before Flop (didn't bet)
Seat 4: Maximus5828 folded before Flop
Seat 5: MM9955 folded before Flop (didn't bet)
Seat 6: jaysu folded before Flop (didn't bet)
Seat 7: ThulsaDoom69 collected (2730)
Seat 8: akbongu1977 folded before Flop (didn't bet)
Seat 9: RynerNJ (button) folded before Flop (didn't bet)


*********** # 80 **************
PokerStars Hand #169443328599: Tournament #1597684021, $18.20+$1.80 USD=
 Hold'em No Limit - Level XII (300/600) - 2017/05/05 21:12:21 ET
Table '1597684021 2' 9-max Seat #1 is the button
Seat 1: JJin91 (13542 in chips)=20
Seat 2: nwmdnj (20536 in chips)=20
Seat 3: A A 5454 (31358 in chips)=20
Seat 4: Maximus5828 (5274 in chips)=20
Seat 5: MM9955 (39505 in chips)=20
Seat 6: jaysu (10532 in chips)=20
Seat 7: ThulsaDoom69 (9040 in chips)=20
Seat 8: akbongu1977 (19720 in chips)=20
Seat 9: RynerNJ (13203 in chips)=20
JJin91: posts the ante 70
nwmdnj: posts the ante 70
A A 5454: posts the ante 70
Maximus5828: posts the ante 70
MM9955: posts the ante 70
jaysu: posts the ante 70
ThulsaDoom69: posts the ante 70
akbongu1977: posts the ante 70
RynerNJ: posts the ante 70
nwmdnj: posts small blind 300
A A 5454: posts big blind 600
*** HOLE CARDS ***
Dealt to JJin91 [3s 3h]
Maximus5828: folds=20
MM9955: folds=20
jaysu: raises 688 to 1288
ThulsaDoom69: folds=20
akbongu1977: folds=20
RynerNJ: folds=20
JJin91: calls 1288
nwmdnj: folds=20
A A 5454: calls 688
*** FLOP *** [6h 5c 8h]
A A 5454: checks=20
jaysu: checks=20
JJin91: bets 2541
A A 5454: folds=20
jaysu: folds=20
Uncalled bet (2541) returned to JJin91
JJin91 collected 4794 from pot
JJin91: doesn't show hand=20
*** SUMMARY ***
Total pot 4794 | Rake 0=20
Board [6h 5c 8h]
Seat 1: JJin91 (button) collected (4794)
Seat 2: nwmdnj (small blind) folded before Flop
Seat 3: A A 5454 (big blind) folded on the Flop
Seat 4: Maximus5828 folded before Flop (didn't bet)
Seat 5: MM9955 folded before Flop (didn't bet)
Seat 6: jaysu folded on the Flop
Seat 7: ThulsaDoom69 folded before Flop (didn't bet)
Seat 8: akbongu1977 folded before Flop (didn't bet)
Seat 9: RynerNJ folded before Flop (didn't bet)


*********** # 81 **************
PokerStars Hand #169443329005: Tournament #1597684021, $18.20+$1.80 USD=
 Hold'em No Limit - Level XIII (350/700) - 2017/05/05 21:13:47 ET
Table '1597684021 2' 9-max Seat #2 is the button
Seat 1: JJin91 (16978 in chips)=20
Seat 2: nwmdnj (20166 in chips)=20
Seat 3: A A 5454 (30000 in chips)=20
Seat 5: MM9955 (39435 in chips)=20
Seat 6: jaysu (9174 in chips)=20
Seat 7: ThulsaDoom69 (8970 in chips)=20
Seat 8: akbongu1977 (19650 in chips)=20
Seat 9: RynerNJ (13133 in chips)=20
JJin91: posts the ante 85
nwmdnj: posts the ante 85
A A 5454: posts the ante 85
MM9955: posts the ante 85
jaysu: posts the ante 85
ThulsaDoom69: posts the ante 85
akbongu1977: posts the ante 85
RynerNJ: posts the ante 85
A A 5454: posts small blind 350
MM9955: posts big blind 700
*** HOLE CARDS ***
Dealt to JJin91 [4h Kc]
jaysu: folds=20
ThulsaDoom69: folds=20
akbongu1977: calls 700
RynerNJ: folds=20
JJin91: folds=20
nwmdnj: calls 700
A A 5454: folds=20
MM9955: checks=20
*** FLOP *** [Qd 5s Jd]
MM9955: checks=20
akbongu1977: checks=20
nwmdnj: bets 2316
MM9955: calls 2316
akbongu1977: folds=20
*** TURN *** [Qd 5s Jd] [8c]
MM9955: checks=20
nwmdnj: checks=20
*** RIVER *** [Qd 5s Jd 8c] [9h]
MM9955: bets 700
nwmdnj: calls 700
*** SHOW DOWN ***
MM9955: shows [Js 2h] (a pair of Jacks)
nwmdnj: shows [Qc Kd] (a pair of Queens)
nwmdnj collected 9162 from pot
*** SUMMARY ***
Total pot 9162 | Rake 0=20
Board [Qd 5s Jd 8c 9h]
Seat 1: JJin91 folded before Flop (didn't bet)
Seat 2: nwmdnj (button) showed [Qc Kd] and won (9162) with a pair of Qu=
eens
Seat 3: A A 5454 (small blind) folded before Flop
Seat 5: MM9955 (big blind) showed [Js 2h] and lost with a pair of Jacks
Seat 6: jaysu folded before Flop (didn't bet)
Seat 7: ThulsaDoom69 folded before Flop (didn't bet)
Seat 8: akbongu1977 folded on the Flop
Seat 9: RynerNJ folded before Flop (didn't bet)


*********** # 82 **************
PokerStars Hand #169443329305: Tournament #1597684021, $18.20+$1.80 USD=
 Hold'em No Limit - Level XIII (350/700) - 2017/05/05 21:14:48 ET
Table '1597684021 2' 9-max Seat #3 is the button
Seat 1: JJin91 (16893 in chips)=20
Seat 2: nwmdnj (25527 in chips)=20
Seat 3: A A 5454 (29565 in chips)=20
Seat 5: MM9955 (35634 in chips)=20
Seat 6: jaysu (9089 in chips)=20
Seat 7: ThulsaDoom69 (8885 in chips)=20
Seat 8: akbongu1977 (18865 in chips)=20
Seat 9: RynerNJ (13048 in chips)=20
JJin91: posts the ante 85
nwmdnj: posts the ante 85
A A 5454: posts the ante 85
MM9955: posts the ante 85
jaysu: posts the ante 85
ThulsaDoom69: posts the ante 85
akbongu1977: posts the ante 85
RynerNJ: posts the ante 85
MM9955: posts small blind 350
jaysu: posts big blind 700
*** HOLE CARDS ***
Dealt to JJin91 [Th Ad]
ThulsaDoom69: raises 8100 to 8800 and is all-in
akbongu1977: folds=20
RynerNJ: folds=20
JJin91: folds=20
nwmdnj: folds=20
A A 5454: folds=20
MM9955: folds=20
jaysu: folds=20
Uncalled bet (8100) returned to ThulsaDoom69
ThulsaDoom69 collected 2430 from pot
ThulsaDoom69: doesn't show hand=20
*** SUMMARY ***
Total pot 2430 | Rake 0=20
Seat 1: JJin91 folded before Flop (didn't bet)
Seat 2: nwmdnj folded before Flop (didn't bet)
Seat 3: A A 5454 (button) folded before Flop (didn't bet)
Seat 5: MM9955 (small blind) folded before Flop
Seat 6: jaysu (big blind) folded before Flop
Seat 7: ThulsaDoom69 collected (2430)
Seat 8: akbongu1977 folded before Flop (didn't bet)
Seat 9: RynerNJ folded before Flop (didn't bet)


*********** # 83 **************
PokerStars Hand #169443329437: Tournament #1597684021, $18.20+$1.80 USD=
 Hold'em No Limit - Level XIII (350/700) - 2017/05/05 21:15:15 ET
Table '1597684021 2' 9-max Seat #5 is the button
Seat 1: JJin91 (16808 in chips)=20
Seat 2: nwmdnj (25442 in chips)=20
Seat 3: A A 5454 (29480 in chips)=20
Seat 5: MM9955 (35199 in chips)=20
Seat 6: jaysu (8304 in chips)=20
Seat 7: ThulsaDoom69 (10530 in chips)=20
Seat 8: akbongu1977 (18780 in chips)=20
Seat 9: RynerNJ (12963 in chips)=20
JJin91: posts the ante 85
nwmdnj: posts the ante 85
A A 5454: posts the ante 85
MM9955: posts the ante 85
jaysu: posts the ante 85
ThulsaDoom69: posts the ante 85
akbongu1977: posts the ante 85
RynerNJ: posts the ante 85
jaysu: posts small blind 350
ThulsaDoom69: posts big blind 700
*** HOLE CARDS ***
Dealt to JJin91 [3s Kd]
akbongu1977: folds=20
RynerNJ: folds=20
JJin91: folds=20
nwmdnj: folds=20
A A 5454: calls 700
MM9955: folds=20
jaysu: folds=20
ThulsaDoom69: checks=20
*** FLOP *** [6h Ah 2d]
ThulsaDoom69: checks=20
A A 5454: checks=20
*** TURN *** [6h Ah 2d] [8d]
ThulsaDoom69: checks=20
A A 5454: checks=20
*** RIVER *** [6h Ah 2d 8d] [8h]
ThulsaDoom69: checks=20
A A 5454: checks=20
*** SHOW DOWN ***
ThulsaDoom69: shows [7s Jh] (a pair of Eights)
A A 5454: shows [9c Jc] (a pair of Eights - Ace+Jack+Nine kicker)
A A 5454 collected 2430 from pot
*** SUMMARY ***
Total pot 2430 | Rake 0=20
Board [6h Ah 2d 8d 8h]
Seat 1: JJin91 folded before Flop (didn't bet)
Seat 2: nwmdnj folded before Flop (didn't bet)
Seat 3: A A 5454 showed [9c Jc] and won (2430) with a pair of Eights
Seat 5: MM9955 (button) folded before Flop (didn't bet)
Seat 6: jaysu (small blind) folded before Flop
Seat 7: ThulsaDoom69 (big blind) showed [7s Jh] and lost with a pair of=
 Eights
Seat 8: akbongu1977 folded before Flop (didn't bet)
Seat 9: RynerNJ folded before Flop (didn't bet)


*********** # 84 **************
PokerStars Hand #169443329590: Tournament #1597684021, $18.20+$1.80 USD=
 Hold'em No Limit - Level XIII (350/700) - 2017/05/05 21:15:47 ET
Table '1597684021 2' 9-max Seat #6 is the button
Seat 1: JJin91 (16723 in chips)=20
Seat 2: nwmdnj (25357 in chips)=20
Seat 3: A A 5454 (31125 in chips)=20
Seat 5: MM9955 (35114 in chips)=20
Seat 6: jaysu (7869 in chips)=20
Seat 7: ThulsaDoom69 (9745 in chips)=20
Seat 8: akbongu1977 (18695 in chips)=20
Seat 9: RynerNJ (12878 in chips)=20
JJin91: posts the ante 85
nwmdnj: posts the ante 85
A A 5454: posts the ante 85
MM9955: posts the ante 85
jaysu: posts the ante 85
ThulsaDoom69: posts the ante 85
akbongu1977: posts the ante 85
RynerNJ: posts the ante 85
ThulsaDoom69: posts small blind 350
akbongu1977: posts big blind 700
*** HOLE CARDS ***
Dealt to JJin91 [9h 8d]
RynerNJ: folds=20
JJin91: folds=20
nwmdnj: folds=20
A A 5454: calls 700
MM9955: calls 700
jaysu: folds=20
ThulsaDoom69: folds=20
akbongu1977: checks=20
*** FLOP *** [4c As 4d]
akbongu1977: checks=20
A A 5454: checks=20
MM9955: checks=20
*** TURN *** [4c As 4d] [3c]
akbongu1977: checks=20
A A 5454: checks=20
MM9955: bets 1565
akbongu1977: folds=20
A A 5454: calls 1565
*** RIVER *** [4c As 4d 3c] [Ks]
A A 5454: checks=20
MM9955: bets 1400
A A 5454: calls 1400
*** SHOW DOWN ***
MM9955: shows [Ah 6d] (two pair, Aces and Fours)
A A 5454: mucks hand=20
MM9955 collected 9060 from pot
*** SUMMARY ***
Total pot 9060 | Rake 0=20
Board [4c As 4d 3c Ks]
Seat 1: JJin91 folded before Flop (didn't bet)
Seat 2: nwmdnj folded before Flop (didn't bet)
Seat 3: A A 5454 mucked [8h 8s]
Seat 5: MM9955 showed [Ah 6d] and won (9060) with two pair, Aces and Fo=
urs
Seat 6: jaysu (button) folded before Flop (didn't bet)
Seat 7: ThulsaDoom69 (small blind) folded before Flop
Seat 8: akbongu1977 (big blind) folded on the Turn
Seat 9: RynerNJ folded before Flop (didn't bet)


*********** # 85 **************
PokerStars Hand #169443329795: Tournament #1597684021, $18.20+$1.80 USD=
 Hold'em No Limit - Level XIII (350/700) - 2017/05/05 21:16:37 ET
Table '1597684021 2' 9-max Seat #7 is the button
Seat 1: JJin91 (16638 in chips)=20
Seat 2: nwmdnj (25272 in chips)=20
Seat 3: A A 5454 (27375 in chips)=20
Seat 5: MM9955 (40424 in chips)=20
Seat 6: jaysu (7784 in chips)=20
Seat 7: ThulsaDoom69 (9310 in chips)=20
Seat 8: akbongu1977 (17910 in chips)=20
Seat 9: RynerNJ (12793 in chips)=20
JJin91: posts the ante 85
nwmdnj: posts the ante 85
A A 5454: posts the ante 85
MM9955: posts the ante 85
jaysu: posts the ante 85
ThulsaDoom69: posts the ante 85
akbongu1977: posts the ante 85
RynerNJ: posts the ante 85
akbongu1977: posts small blind 350
RynerNJ: posts big blind 700
*** HOLE CARDS ***
Dealt to JJin91 [3h 6h]
JJin91: folds=20
nwmdnj: folds=20
A A 5454: folds=20
MM9955: raises 700 to 1400
jaysu: folds=20
ThulsaDoom69: folds=20
akbongu1977: folds=20
RynerNJ: raises 11308 to 12708 and is all-in
MM9955: calls 11308
*** FLOP *** [2c Ks 9h]
*** TURN *** [2c Ks 9h] [Qs]
*** RIVER *** [2c Ks 9h Qs] [3d]
*** SHOW DOWN ***
RynerNJ: shows [Tc Ad] (high card Ace)
MM9955: shows [Kc Qc] (two pair, Kings and Queens)
MM9955 collected 26446 from pot
RynerNJ finished the tournament in 45th place
*** SUMMARY ***
Total pot 26446 | Rake 0=20
Board [2c Ks 9h Qs 3d]
Seat 1: JJin91 folded before Flop (didn't bet)
Seat 2: nwmdnj folded before Flop (didn't bet)
Seat 3: A A 5454 folded before Flop (didn't bet)
Seat 5: MM9955 showed [Kc Qc] and won (26446) with two pair, Kings and =
Queens
Seat 6: jaysu folded before Flop (didn't bet)
Seat 7: ThulsaDoom69 (button) folded before Flop (didn't bet)
Seat 8: akbongu1977 (small blind) folded before Flop
Seat 9: RynerNJ (big blind) showed [Tc Ad] and lost with high card Ace


*********** # 86 **************
PokerStars Hand #169445088428: Tournament #1597684021, $18.20+$1.80 USD=
 Hold'em No Limit - Level XIII (350/700) - 2017/05/05 21:17:30 ET
Table '1597684021 2' 9-max Seat #8 is the button
Seat 1: JJin91 (16553 in chips)=20
Seat 2: nwmdnj (25187 in chips)=20
Seat 3: A A 5454 (27290 in chips)=20
Seat 4: PhillyisGarb (10766 in chips)=20
Seat 5: MM9955 (54077 in chips)=20
Seat 6: jaysu (7699 in chips)=20
Seat 7: ThulsaDoom69 (9225 in chips)=20
Seat 8: akbongu1977 (17475 in chips)=20
JJin91: posts the ante 85
nwmdnj: posts the ante 85
A A 5454: posts the ante 85
PhillyisGarb: posts the ante 85
MM9955: posts the ante 85
jaysu: posts the ante 85
ThulsaDoom69: posts the ante 85
akbongu1977: posts the ante 85
JJin91: posts small blind 350
nwmdnj: posts big blind 700
*** HOLE CARDS ***
Dealt to JJin91 [5h 7s]
A A 5454: folds=20
PhillyisGarb: folds=20
MM9955: folds=20
jaysu: folds=20
ThulsaDoom69: folds=20
akbongu1977: calls 700
JJin91: folds=20
nwmdnj: checks=20
*** FLOP *** [6h Ad Kd]
nwmdnj: checks=20
akbongu1977: bets 1400
nwmdnj: folds=20
Uncalled bet (1400) returned to akbongu1977
akbongu1977 collected 2430 from pot
akbongu1977: doesn't show hand=20
*** SUMMARY ***
Total pot 2430 | Rake 0=20
Board [6h Ad Kd]
Seat 1: JJin91 (small blind) folded before Flop
Seat 2: nwmdnj (big blind) folded on the Flop
Seat 3: A A 5454 folded before Flop (didn't bet)
Seat 4: PhillyisGarb folded before Flop (didn't bet)
Seat 5: MM9955 folded before Flop (didn't bet)
Seat 6: jaysu folded before Flop (didn't bet)
Seat 7: ThulsaDoom69 folded before Flop (didn't bet)
Seat 8: akbongu1977 (button) collected (2430)


*********** # 87 **************
PokerStars Hand #169445088665: Tournament #1597684021, $18.20+$1.80 USD=
 Hold'em No Limit - Level XIII (350/700) - 2017/05/05 21:18:22 ET
Table '1597684021 2' 9-max Seat #1 is the button
Seat 1: JJin91 (16118 in chips)=20
Seat 2: nwmdnj (24402 in chips)=20
Seat 3: A A 5454 (27205 in chips)=20
Seat 4: PhillyisGarb (10681 in chips)=20
Seat 5: MM9955 (53992 in chips)=20
Seat 6: jaysu (7614 in chips)=20
Seat 7: ThulsaDoom69 (9140 in chips)=20
Seat 8: akbongu1977 (19120 in chips)=20
JJin91: posts the ante 85
nwmdnj: posts the ante 85
A A 5454: posts the ante 85
PhillyisGarb: posts the ante 85
MM9955: posts the ante 85
jaysu: posts the ante 85
ThulsaDoom69: posts the ante 85
akbongu1977: posts the ante 85
nwmdnj: posts small blind 350
A A 5454: posts big blind 700
*** HOLE CARDS ***
Dealt to JJin91 [Jh Ah]
PhillyisGarb: folds=20
MM9955: folds=20
jaysu: folds=20
ThulsaDoom69: folds=20
akbongu1977: folds=20
JJin91: raises 1127 to 1827
nwmdnj: folds=20
A A 5454: folds=20
Uncalled bet (1127) returned to JJin91
JJin91 collected 2430 from pot
JJin91: doesn't show hand=20
*** SUMMARY ***
Total pot 2430 | Rake 0=20
Seat 1: JJin91 (button) collected (2430)
Seat 2: nwmdnj (small blind) folded before Flop
Seat 3: A A 5454 (big blind) folded before Flop
Seat 4: PhillyisGarb folded before Flop (didn't bet)
Seat 5: MM9955 folded before Flop (didn't bet)
Seat 6: jaysu folded before Flop (didn't bet)
Seat 7: ThulsaDoom69 folded before Flop (didn't bet)
Seat 8: akbongu1977 folded before Flop (didn't bet)


*********** # 88 **************
PokerStars Hand #169445088780: Tournament #1597684021, $18.20+$1.80 USD=
 Hold'em No Limit - Level XIII (350/700) - 2017/05/05 21:18:43 ET
Table '1597684021 2' 9-max Seat #2 is the button
Seat 1: JJin91 (17763 in chips)=20
Seat 2: nwmdnj (23967 in chips)=20
Seat 3: A A 5454 (26420 in chips)=20
Seat 4: PhillyisGarb (10596 in chips)=20
Seat 5: MM9955 (53907 in chips)=20
Seat 6: jaysu (7529 in chips)=20
Seat 7: ThulsaDoom69 (9055 in chips)=20
Seat 8: akbongu1977 (19035 in chips)=20
JJin91: posts the ante 85
nwmdnj: posts the ante 85
A A 5454: posts the ante 85
PhillyisGarb: posts the ante 85
MM9955: posts the ante 85
jaysu: posts the ante 85
ThulsaDoom69: posts the ante 85
akbongu1977: posts the ante 85
A A 5454: posts small blind 350
PhillyisGarb: posts big blind 700
*** HOLE CARDS ***
Dealt to JJin91 [4c 2s]
MM9955: raises 700 to 1400
jaysu: folds=20
ThulsaDoom69: raises 7570 to 8970 and is all-in
akbongu1977: folds=20
JJin91: folds=20
nwmdnj: folds=20
A A 5454: folds=20
PhillyisGarb: folds=20
MM9955: calls 7570
*** FLOP *** [Ah Ks 2d]
*** TURN *** [Ah Ks 2d] [7s]
*** RIVER *** [Ah Ks 2d 7s] [9h]
*** SHOW DOWN ***
MM9955: shows [Kc Ac] (two pair, Aces and Kings)
ThulsaDoom69: shows [9d 9s] (three of a kind, Nines)
ThulsaDoom69 collected 19670 from pot
*** SUMMARY ***
Total pot 19670 | Rake 0=20
Board [Ah Ks 2d 7s 9h]
Seat 1: JJin91 folded before Flop (didn't bet)
Seat 2: nwmdnj (button) folded before Flop (didn't bet)
Seat 3: A A 5454 (small blind) folded before Flop
Seat 4: PhillyisGarb (big blind) folded before Flop
Seat 5: MM9955 showed [Kc Ac] and lost with two pair, Aces and Kings
Seat 6: jaysu folded before Flop (didn't bet)
Seat 7: ThulsaDoom69 showed [9d 9s] and won (19670) with three of a kin=
d, Nines
Seat 8: akbongu1977 folded before Flop (didn't bet)


*********** # 89 **************
PokerStars Hand #169445088920: Tournament #1597684021, $18.20+$1.80 USD=
 Hold'em No Limit - Level XIII (350/700) - 2017/05/05 21:19:16 ET
Table '1597684021 2' 9-max Seat #3 is the button
Seat 1: JJin91 (17678 in chips)=20
Seat 2: nwmdnj (23882 in chips)=20
Seat 3: A A 5454 (25985 in chips)=20
Seat 4: PhillyisGarb (9811 in chips)=20
Seat 5: MM9955 (44852 in chips)=20
Seat 6: jaysu (7444 in chips)=20
Seat 7: ThulsaDoom69 (19670 in chips)=20
Seat 8: akbongu1977 (18950 in chips)=20
JJin91: posts the ante 85
nwmdnj: posts the ante 85
A A 5454: posts the ante 85
PhillyisGarb: posts the ante 85
MM9955: posts the ante 85
jaysu: posts the ante 85
ThulsaDoom69: posts the ante 85
akbongu1977: posts the ante 85
PhillyisGarb: posts small blind 350
MM9955: posts big blind 700
*** HOLE CARDS ***
Dealt to JJin91 [3h Ks]
jaysu: folds=20
ThulsaDoom69: folds=20
akbongu1977: folds=20
JJin91: folds=20
nwmdnj: folds=20
A A 5454: folds=20
PhillyisGarb: folds=20
Uncalled bet (350) returned to MM9955
MM9955 collected 1380 from pot
MM9955: doesn't show hand=20
*** SUMMARY ***
Total pot 1380 | Rake 0=20
Seat 1: JJin91 folded before Flop (didn't bet)
Seat 2: nwmdnj folded before Flop (didn't bet)
Seat 3: A A 5454 (button) folded before Flop (didn't bet)
Seat 4: PhillyisGarb (small blind) folded before Flop
Seat 5: MM9955 (big blind) collected (1380)
Seat 6: jaysu folded before Flop (didn't bet)
Seat 7: ThulsaDoom69 folded before Flop (didn't bet)
Seat 8: akbongu1977 folded before Flop (didn't bet)


*********** # 90 **************
PokerStars Hand #169445089180: Tournament #1597684021, $18.20+$1.80 USD=
 Hold'em No Limit - Level XIII (350/700) - 2017/05/05 21:20:11 ET
Table '1597684021 2' 9-max Seat #4 is the button
Seat 1: JJin91 (17593 in chips)=20
Seat 2: nwmdnj (23797 in chips)=20
Seat 3: A A 5454 (25900 in chips)=20
Seat 4: PhillyisGarb (9376 in chips)=20
Seat 5: MM9955 (45797 in chips)=20
Seat 6: jaysu (7359 in chips)=20
Seat 7: ThulsaDoom69 (19585 in chips)=20
Seat 8: akbongu1977 (18865 in chips)=20
JJin91: posts the ante 85
nwmdnj: posts the ante 85
A A 5454: posts the ante 85
PhillyisGarb: posts the ante 85
MM9955: posts the ante 85
jaysu: posts the ante 85
ThulsaDoom69: posts the ante 85
akbongu1977: posts the ante 85
MM9955: posts small blind 350
jaysu: posts big blind 700
*** HOLE CARDS ***
Dealt to JJin91 [Qs Kc]
ThulsaDoom69: folds=20
akbongu1977: folds=20
JJin91: raises 1127 to 1827
nwmdnj: folds=20
A A 5454: folds=20
PhillyisGarb: raises 7464 to 9291 and is all-in
MM9955: folds=20
jaysu: folds=20
JJin91: calls 7464
*** FLOP *** [Jd 2h 8d]
*** TURN *** [Jd 2h 8d] [Ks]
*** RIVER *** [Jd 2h 8d Ks] [Qc]
*** SHOW DOWN ***
JJin91: shows [Qs Kc] (two pair, Kings and Queens)
PhillyisGarb: shows [7s 7h] (a pair of Sevens)
JJin91 collected 20312 from pot
PhillyisGarb finished the tournament in 42nd place
*** SUMMARY ***
Total pot 20312 | Rake 0=20
Board [Jd 2h 8d Ks Qc]
Seat 1: JJin91 showed [Qs Kc] and won (20312) with two pair, Kings and =
Queens
Seat 2: nwmdnj folded before Flop (didn't bet)
Seat 3: A A 5454 folded before Flop (didn't bet)
Seat 4: PhillyisGarb (button) showed [7s 7h] and lost with a pair of Se=
vens
Seat 5: MM9955 (small blind) folded before Flop
Seat 6: jaysu (big blind) folded before Flop
Seat 7: ThulsaDoom69 folded before Flop (didn't bet)
Seat 8: akbongu1977 folded before Flop (didn't bet)


*********** # 91 **************
PokerStars Hand #169445089354: Tournament #1597684021, $18.20+$1.80 USD=
 Hold'em No Limit - Level XIII (350/700) - 2017/05/05 21:20:51 ET
Table '1597684021 2' 9-max Seat #5 is the button
Seat 1: JJin91 (28529 in chips)=20
Seat 2: nwmdnj (23712 in chips)=20
Seat 3: A A 5454 (25815 in chips)=20
Seat 5: MM9955 (45362 in chips)=20
Seat 6: jaysu (6574 in chips)=20
Seat 7: ThulsaDoom69 (19500 in chips)=20
Seat 8: akbongu1977 (18780 in chips)=20
JJin91: posts the ante 85
nwmdnj: posts the ante 85
A A 5454: posts the ante 85
MM9955: posts the ante 85
jaysu: posts the ante 85
ThulsaDoom69: posts the ante 85
akbongu1977: posts the ante 85
jaysu: posts small blind 350
ThulsaDoom69: posts big blind 700
*** HOLE CARDS ***
Dealt to JJin91 [5h Tc]
akbongu1977: folds=20
JJin91: folds=20
PhillyisGarb [observer] said, "gc degen"
nwmdnj: raises 1050 to 1750
A A 5454: folds=20
MM9955: folds=20
jaysu: folds=20
ThulsaDoom69: folds=20
Uncalled bet (1050) returned to nwmdnj
nwmdnj collected 2345 from pot
nwmdnj: doesn't show hand=20
*** SUMMARY ***
Total pot 2345 | Rake 0=20
Seat 1: JJin91 folded before Flop (didn't bet)
Seat 2: nwmdnj collected (2345)
Seat 3: A A 5454 folded before Flop (didn't bet)
Seat 5: MM9955 (button) folded before Flop (didn't bet)
Seat 6: jaysu (small blind) folded before Flop
Seat 7: ThulsaDoom69 (big blind) folded before Flop
Seat 8: akbongu1977 folded before Flop (didn't bet)


*********** # 92 **************
PokerStars Hand #169445089539: Tournament #1597684021, $18.20+$1.80 USD=
 Hold'em No Limit - Level XIII (350/700) - 2017/05/05 21:21:29 ET
Table '1597684021 2' 9-max Seat #6 is the button
Seat 1: JJin91 (28444 in chips)=20
Seat 2: nwmdnj (25272 in chips)=20
Seat 3: A A 5454 (25730 in chips)=20
Seat 4: Twon excelz (14991 in chips)=20
Seat 5: MM9955 (45277 in chips)=20
Seat 6: jaysu (6139 in chips)=20
Seat 7: ThulsaDoom69 (18715 in chips)=20
Seat 8: akbongu1977 (18695 in chips)=20
JJin91: posts the ante 85
nwmdnj: posts the ante 85
A A 5454: posts the ante 85
Twon excelz: posts the ante 85
MM9955: posts the ante 85
jaysu: posts the ante 85
ThulsaDoom69: posts the ante 85
akbongu1977: posts the ante 85
ThulsaDoom69: posts small blind 350
akbongu1977: posts big blind 700
*** HOLE CARDS ***
Dealt to JJin91 [2h 7d]
JJin91: folds=20
nwmdnj: raises 700 to 1400
A A 5454: folds=20
Twon excelz: raises 13506 to 14906 and is all-in
MM9955: folds=20
jaysu: folds=20
ThulsaDoom69: folds=20
akbongu1977: folds=20
nwmdnj: folds=20
Uncalled bet (13506) returned to Twon excelz
Twon excelz collected 4530 from pot
Twon excelz: doesn't show hand=20
*** SUMMARY ***
Total pot 4530 | Rake 0=20
Seat 1: JJin91 folded before Flop (didn't bet)
Seat 2: nwmdnj folded before Flop
Seat 3: A A 5454 folded before Flop (didn't bet)
Seat 4: Twon excelz collected (4530)
Seat 5: MM9955 folded before Flop (didn't bet)
Seat 6: jaysu (button) folded before Flop (didn't bet)
Seat 7: ThulsaDoom69 (small blind) folded before Flop
Seat 8: akbongu1977 (big blind) folded before Flop


*********** # 93 **************
PokerStars Hand #169445089797: Tournament #1597684021, $18.20+$1.80 USD=
 Hold'em No Limit - Level XIII (350/700) - 2017/05/05 21:22:24 ET
Table '1597684021 2' 9-max Seat #7 is the button
Seat 1: JJin91 (28359 in chips)=20
Seat 2: nwmdnj (23787 in chips)=20
Seat 3: A A 5454 (25645 in chips)=20
Seat 4: Twon excelz (18036 in chips)=20
Seat 5: MM9955 (45192 in chips)=20
Seat 6: jaysu (6054 in chips)=20
Seat 7: ThulsaDoom69 (18280 in chips)=20
Seat 8: akbongu1977 (17910 in chips)=20
JJin91: posts the ante 85
nwmdnj: posts the ante 85
A A 5454: posts the ante 85
Twon excelz: posts the ante 85
MM9955: posts the ante 85
jaysu: posts the ante 85
ThulsaDoom69: posts the ante 85
akbongu1977: posts the ante 85
akbongu1977: posts small blind 350
JJin91: posts big blind 700
*** HOLE CARDS ***
Dealt to JJin91 [Qs Kh]
nwmdnj: folds=20
A A 5454: folds=20
Twon excelz: raises 2430 to 3130
MM9955: folds=20
jaysu: folds=20
ThulsaDoom69: folds=20
akbongu1977: folds=20
JJin91: folds=20
Uncalled bet (2430) returned to Twon excelz
Twon excelz collected 2430 from pot
Twon excelz: doesn't show hand=20
*** SUMMARY ***
Total pot 2430 | Rake 0=20
Seat 1: JJin91 (big blind) folded before Flop
Seat 2: nwmdnj folded before Flop (didn't bet)
Seat 3: A A 5454 folded before Flop (didn't bet)
Seat 4: Twon excelz collected (2430)
Seat 5: MM9955 folded before Flop (didn't bet)
Seat 6: jaysu folded before Flop (didn't bet)
Seat 7: ThulsaDoom69 (button) folded before Flop (didn't bet)
Seat 8: akbongu1977 (small blind) folded before Flop


*********** # 94 **************
PokerStars Hand #169445089933: Tournament #1597684021, $18.20+$1.80 USD=
 Hold'em No Limit - Level XIV (400/800) - 2017/05/05 21:22:55 ET
Table '1597684021 2' 9-max Seat #8 is the button
Seat 1: JJin91 (27574 in chips)=20
Seat 2: nwmdnj (23702 in chips)=20
Seat 3: A A 5454 (25560 in chips)=20
Seat 4: Twon excelz (19681 in chips)=20
Seat 5: MM9955 (45107 in chips)=20
Seat 6: jaysu (5969 in chips)=20
Seat 7: ThulsaDoom69 (18195 in chips)=20
Seat 8: akbongu1977 (17475 in chips)=20
JJin91: posts the ante 100
nwmdnj: posts the ante 100
A A 5454: posts the ante 100
Twon excelz: posts the ante 100
MM9955: posts the ante 100
jaysu: posts the ante 100
ThulsaDoom69: posts the ante 100
akbongu1977: posts the ante 100
JJin91: posts small blind 400
nwmdnj: posts big blind 800
*** HOLE CARDS ***
Dealt to JJin91 [Ts Qd]
A A 5454: folds=20
Twon excelz: folds=20
MM9955: folds=20
jaysu: raises 5069 to 5869 and is all-in
ThulsaDoom69: folds=20
akbongu1977: folds=20
JJin91: folds=20
nwmdnj: folds=20
Uncalled bet (5069) returned to jaysu
jaysu collected 2800 from pot
jaysu: doesn't show hand=20
*** SUMMARY ***
Total pot 2800 | Rake 0=20
Seat 1: JJin91 (small blind) folded before Flop
Seat 2: nwmdnj (big blind) folded before Flop
Seat 3: A A 5454 folded before Flop (didn't bet)
Seat 4: Twon excelz folded before Flop (didn't bet)
Seat 5: MM9955 folded before Flop (didn't bet)
Seat 6: jaysu collected (2800)
Seat 7: ThulsaDoom69 folded before Flop (didn't bet)
Seat 8: akbongu1977 (button) folded before Flop (didn't bet)


*********** # 95 **************
PokerStars Hand #169445708361: Tournament #1597684021, $18.20+$1.80 USD=
 Hold'em No Limit - Level XIV (400/800) - 2017/05/05 21:23:19 ET
Table '1597684021 2' 9-max Seat #1 is the button
Seat 1: JJin91 (27074 in chips)=20
Seat 2: nwmdnj (22802 in chips)=20
Seat 3: A A 5454 (25460 in chips)=20
Seat 4: Twon excelz (19581 in chips)=20
Seat 5: MM9955 (45007 in chips)=20
Seat 6: jaysu (7869 in chips)=20
Seat 7: ThulsaDoom69 (18095 in chips)=20
Seat 8: akbongu1977 (17375 in chips)=20
JJin91: posts the ante 100
nwmdnj: posts the ante 100
A A 5454: posts the ante 100
Twon excelz: posts the ante 100
MM9955: posts the ante 100
jaysu: posts the ante 100
ThulsaDoom69: posts the ante 100
akbongu1977: posts the ante 100
nwmdnj: posts small blind 400
A A 5454: posts big blind 800
*** HOLE CARDS ***
Dealt to JJin91 [2c Ts]
Twon excelz: folds=20
MM9955: calls 800
jaysu: folds=20
ThulsaDoom69: folds=20
akbongu1977: folds=20
JJin91: folds=20
nwmdnj: folds=20
A A 5454: checks=20
*** FLOP *** [Ks Kd Jd]
A A 5454: checks=20
MM9955: bets 1400
A A 5454: folds=20
Uncalled bet (1400) returned to MM9955
MM9955 collected 2800 from pot
MM9955: doesn't show hand=20
*** SUMMARY ***
Total pot 2800 | Rake 0=20
Board [Ks Kd Jd]
Seat 1: JJin91 (button) folded before Flop (didn't bet)
Seat 2: nwmdnj (small blind) folded before Flop
Seat 3: A A 5454 (big blind) folded on the Flop
Seat 4: Twon excelz folded before Flop (didn't bet)
Seat 5: MM9955 collected (2800)
Seat 6: jaysu folded before Flop (didn't bet)
Seat 7: ThulsaDoom69 folded before Flop (didn't bet)
Seat 8: akbongu1977 folded before Flop (didn't bet)


*********** # 96 **************
PokerStars Hand #169445708509: Tournament #1597684021, $18.20+$1.80 USD=
 Hold'em No Limit - Level XIV (400/800) - 2017/05/05 21:23:51 ET
Table '1597684021 2' 9-max Seat #2 is the button
Seat 1: JJin91 (26974 in chips)=20
Seat 2: nwmdnj (22302 in chips)=20
Seat 3: A A 5454 (24560 in chips)=20
Seat 4: Twon excelz (19481 in chips)=20
Seat 5: MM9955 (46907 in chips)=20
Seat 6: jaysu (7769 in chips)=20
Seat 7: ThulsaDoom69 (17995 in chips)=20
Seat 8: akbongu1977 (17275 in chips)=20
JJin91: posts the ante 100
nwmdnj: posts the ante 100
A A 5454: posts the ante 100
Twon excelz: posts the ante 100
MM9955: posts the ante 100
jaysu: posts the ante 100
ThulsaDoom69: posts the ante 100
akbongu1977: posts the ante 100
A A 5454: posts small blind 400
Twon excelz: posts big blind 800
*** HOLE CARDS ***
Dealt to JJin91 [5d 7d]
MM9955: folds=20
jaysu: folds=20
ThulsaDoom69: folds=20
akbongu1977: folds=20
JJin91: folds=20
nwmdnj: folds=20
A A 5454: folds=20
Uncalled bet (400) returned to Twon excelz
Twon excelz collected 1600 from pot
Twon excelz: doesn't show hand=20
*** SUMMARY ***
Total pot 1600 | Rake 0=20
Seat 1: JJin91 folded before Flop (didn't bet)
Seat 2: nwmdnj (button) folded before Flop (didn't bet)
Seat 3: A A 5454 (small blind) folded before Flop
Seat 4: Twon excelz (big blind) collected (1600)
Seat 5: MM9955 folded before Flop (didn't bet)
Seat 6: jaysu folded before Flop (didn't bet)
Seat 7: ThulsaDoom69 folded before Flop (didn't bet)
Seat 8: akbongu1977 folded before Flop (didn't bet)


*********** # 97 **************
PokerStars Hand #169445708622: Tournament #1597684021, $18.20+$1.80 USD=
 Hold'em No Limit - Level XIV (400/800) - 2017/05/05 21:24:14 ET
Table '1597684021 2' 9-max Seat #3 is the button
Seat 1: JJin91 (26874 in chips)=20
Seat 2: nwmdnj (22202 in chips)=20
Seat 3: A A 5454 (24060 in chips)=20
Seat 4: Twon excelz (20581 in chips)=20
Seat 5: MM9955 (46807 in chips)=20
Seat 6: jaysu (7669 in chips)=20
Seat 7: ThulsaDoom69 (17895 in chips)=20
Seat 8: akbongu1977 (17175 in chips)=20
JJin91: posts the ante 100
nwmdnj: posts the ante 100
A A 5454: posts the ante 100
Twon excelz: posts the ante 100
MM9955: posts the ante 100
jaysu: posts the ante 100
ThulsaDoom69: posts the ante 100
akbongu1977: posts the ante 100
Twon excelz: posts small blind 400
MM9955: posts big blind 800
*** HOLE CARDS ***
Dealt to JJin91 [Jc 2s]
jaysu: folds=20
ThulsaDoom69: folds=20
akbongu1977: folds=20
JJin91: folds=20
nwmdnj: folds=20
A A 5454: folds=20
Twon excelz: folds=20
Uncalled bet (400) returned to MM9955
MM9955 collected 1600 from pot
MM9955: doesn't show hand=20
*** SUMMARY ***
Total pot 1600 | Rake 0=20
Seat 1: JJin91 folded before Flop (didn't bet)
Seat 2: nwmdnj folded before Flop (didn't bet)
Seat 3: A A 5454 (button) folded before Flop (didn't bet)
Seat 4: Twon excelz (small blind) folded before Flop
Seat 5: MM9955 (big blind) collected (1600)
Seat 6: jaysu folded before Flop (didn't bet)
Seat 7: ThulsaDoom69 folded before Flop (didn't bet)
Seat 8: akbongu1977 folded before Flop (didn't bet)


*********** # 98 **************
PokerStars Hand #169445708828: Tournament #1597684021, $18.20+$1.80 USD=
 Hold'em No Limit - Level XIV (400/800) - 2017/05/05 21:24:57 ET
Table '1597684021 2' 9-max Seat #4 is the button
Seat 1: JJin91 (26774 in chips)=20
Seat 2: nwmdnj (22102 in chips)=20
Seat 3: A A 5454 (23960 in chips)=20
Seat 4: Twon excelz (20081 in chips)=20
Seat 5: MM9955 (47907 in chips)=20
Seat 6: jaysu (7569 in chips)=20
Seat 7: ThulsaDoom69 (17795 in chips)=20
Seat 8: akbongu1977 (17075 in chips)=20
JJin91: posts the ante 100
nwmdnj: posts the ante 100
A A 5454: posts the ante 100
Twon excelz: posts the ante 100
MM9955: posts the ante 100
jaysu: posts the ante 100
ThulsaDoom69: posts the ante 100
akbongu1977: posts the ante 100
MM9955: posts small blind 400
jaysu: posts big blind 800
*** HOLE CARDS ***
Dealt to JJin91 [7c 9c]
ThulsaDoom69: folds=20
akbongu1977: folds=20
JJin91: folds=20
nwmdnj: raises 800 to 1600
A A 5454: folds=20
Twon excelz: folds=20
MM9955: folds=20
jaysu: calls 800
*** FLOP *** [3d 9s Tc]
jaysu: checks=20
nwmdnj: bets 1452
jaysu: raises 4417 to 5869 and is all-in
nwmdnj: folds=20
Uncalled bet (4417) returned to jaysu
jaysu collected 7304 from pot
jaysu: doesn't show hand=20
*** SUMMARY ***
Total pot 7304 | Rake 0=20
Board [3d 9s Tc]
Seat 1: JJin91 folded before Flop (didn't bet)
Seat 2: nwmdnj folded on the Flop
Seat 3: A A 5454 folded before Flop (didn't bet)
Seat 4: Twon excelz (button) folded before Flop (didn't bet)
Seat 5: MM9955 (small blind) folded before Flop
Seat 6: jaysu (big blind) collected (7304)
Seat 7: ThulsaDoom69 folded before Flop (didn't bet)
Seat 8: akbongu1977 folded before Flop (didn't bet)


*********** # 99 **************
PokerStars Hand #169445709132: Tournament #1597684021, $18.20+$1.80 USD=
 Hold'em No Limit - Level XIV (400/800) - 2017/05/05 21:26:04 ET
Table '1597684021 2' 9-max Seat #5 is the button
Seat 1: JJin91 (26674 in chips)=20
Seat 2: nwmdnj (18950 in chips)=20
Seat 3: A A 5454 (23860 in chips)=20
Seat 4: Twon excelz (19981 in chips)=20
Seat 5: MM9955 (47407 in chips)=20
Seat 6: jaysu (11721 in chips)=20
Seat 7: ThulsaDoom69 (17695 in chips)=20
Seat 8: akbongu1977 (16975 in chips)=20
JJin91: posts the ante 100
nwmdnj: posts the ante 100
A A 5454: posts the ante 100
Twon excelz: posts the ante 100
MM9955: posts the ante 100
jaysu: posts the ante 100
ThulsaDoom69: posts the ante 100
akbongu1977: posts the ante 100
jaysu: posts small blind 400
ThulsaDoom69: posts big blind 800
*** HOLE CARDS ***
Dealt to JJin91 [Kd 2d]
akbongu1977: folds=20
JJin91: raises 952 to 1752
nwmdnj: folds=20
A A 5454: folds=20
Twon excelz: folds=20
MM9955: calls 1752
jaysu: folds=20
ThulsaDoom69: raises 15843 to 17595 and is all-in
JJin91: folds=20
MM9955: calls 15843
*** FLOP *** [5h 6d 8c]
*** TURN *** [5h 6d 8c] [4c]
*** RIVER *** [5h 6d 8c 4c] [6s]
*** SHOW DOWN ***
ThulsaDoom69: shows [Jc Jd] (two pair, Jacks and Sixes)
MM9955: shows [8h 8d] (a full house, Eights full of Sixes)
MM9955 collected 38142 from pot
ThulsaDoom69 finished the tournament in 40th place
*** SUMMARY ***
Total pot 38142 | Rake 0=20
Board [5h 6d 8c 4c 6s]
Seat 1: JJin91 folded before Flop
Seat 2: nwmdnj folded before Flop (didn't bet)
Seat 3: A A 5454 folded before Flop (didn't bet)
Seat 4: Twon excelz folded before Flop (didn't bet)
Seat 5: MM9955 (button) showed [8h 8d] and won (38142) with a full hous=
e, Eights full of Sixes
Seat 6: jaysu (small blind) folded before Flop
Seat 7: ThulsaDoom69 (big blind) showed [Jc Jd] and lost with two pair,=
 Jacks and Sixes
Seat 8: akbongu1977 folded before Flop (didn't bet)


*********** # 100 **************
PokerStars Hand #169445709310: Tournament #1597684021, $18.20+$1.80 USD=
 Hold'em No Limit - Level XIV (400/800) - 2017/05/05 21:26:40 ET
Table '1597684021 2' 9-max Seat #6 is the button
Seat 1: JJin91 (24822 in chips)=20
Seat 2: nwmdnj (18850 in chips)=20
Seat 3: A A 5454 (23760 in chips)=20
Seat 4: Twon excelz (19881 in chips)=20
Seat 5: MM9955 (67854 in chips)=20
Seat 6: jaysu (11221 in chips)=20
Seat 8: akbongu1977 (16875 in chips)=20
JJin91: posts the ante 100
nwmdnj: posts the ante 100
A A 5454: posts the ante 100
Twon excelz: posts the ante 100
MM9955: posts the ante 100
jaysu: posts the ante 100
akbongu1977: posts the ante 100
akbongu1977: posts small blind 400
JJin91: posts big blind 800
*** HOLE CARDS ***
Dealt to JJin91 [8s Qd]
nwmdnj: folds=20
A A 5454: folds=20
Twon excelz: folds=20
MM9955: folds=20
jaysu: raises 950 to 1750
akbongu1977: folds=20
JJin91: folds=20
Uncalled bet (950) returned to jaysu
jaysu collected 2700 from pot
jaysu: doesn't show hand=20
*** SUMMARY ***
Total pot 2700 | Rake 0=20
Seat 1: JJin91 (big blind) folded before Flop
Seat 2: nwmdnj folded before Flop (didn't bet)
Seat 3: A A 5454 folded before Flop (didn't bet)
Seat 4: Twon excelz folded before Flop (didn't bet)
Seat 5: MM9955 folded before Flop (didn't bet)
Seat 6: jaysu (button) collected (2700)
Seat 8: akbongu1977 (small blind) folded before Flop


*********** # 101 **************
PokerStars Hand #169445709411: Tournament #1597684021, $18.20+$1.80 USD=
 Hold'em No Limit - Level XIV (400/800) - 2017/05/05 21:27:04 ET
Table '1597684021 2' 9-max Seat #8 is the button
Seat 1: JJin91 (23922 in chips)=20
Seat 2: nwmdnj (18750 in chips)=20
Seat 3: A A 5454 (23660 in chips)=20
Seat 4: Twon excelz (19781 in chips)=20
Seat 5: MM9955 (67754 in chips)=20
Seat 6: jaysu (13021 in chips)=20
Seat 8: akbongu1977 (16375 in chips)=20
JJin91: posts the ante 100
nwmdnj: posts the ante 100
A A 5454: posts the ante 100
Twon excelz: posts the ante 100
MM9955: posts the ante 100
jaysu: posts the ante 100
akbongu1977: posts the ante 100
JJin91: posts small blind 400
nwmdnj: posts big blind 800
*** HOLE CARDS ***
Dealt to JJin91 [5s Th]
A A 5454: folds=20
Twon excelz: folds=20
MM9955: folds=20
jaysu: folds=20
akbongu1977: folds=20
JJin91: folds=20
Uncalled bet (400) returned to nwmdnj
nwmdnj collected 1500 from pot
nwmdnj: doesn't show hand=20
*** SUMMARY ***
Total pot 1500 | Rake 0=20
Seat 1: JJin91 (small blind) folded before Flop
Seat 2: nwmdnj (big blind) collected (1500)
Seat 3: A A 5454 folded before Flop (didn't bet)
Seat 4: Twon excelz folded before Flop (didn't bet)
Seat 5: MM9955 folded before Flop (didn't bet)
Seat 6: jaysu folded before Flop (didn't bet)
Seat 8: akbongu1977 (button) folded before Flop (didn't bet)


*********** # 102 **************
PokerStars Hand #169445709501: Tournament #1597684021, $18.20+$1.80 USD=
 Hold'em No Limit - Level XIV (400/800) - 2017/05/05 21:27:22 ET
Table '1597684021 2' 9-max Seat #1 is the button
Seat 1: JJin91 (23422 in chips)=20
Seat 2: nwmdnj (19750 in chips)=20
Seat 3: A A 5454 (23560 in chips)=20
Seat 4: Twon excelz (19681 in chips)=20
Seat 5: MM9955 (67654 in chips)=20
Seat 6: jaysu (12921 in chips)=20
Seat 8: akbongu1977 (16275 in chips)=20
JJin91: posts the ante 100
nwmdnj: posts the ante 100
A A 5454: posts the ante 100
Twon excelz: posts the ante 100
MM9955: posts the ante 100
jaysu: posts the ante 100
akbongu1977: posts the ante 100
nwmdnj: posts small blind 400
A A 5454: posts big blind 800
*** HOLE CARDS ***
Dealt to JJin91 [3c Tc]
Twon excelz: folds=20
MM9955: raises 800 to 1600
jaysu: folds=20
akbongu1977: calls 1600
JJin91: folds=20
nwmdnj: folds=20
A A 5454: calls 800
*** FLOP *** [3h Kc 2d]
A A 5454: checks=20
MM9955: bets 800
akbongu1977: raises 13775 to 14575 and is all-in
A A 5454: folds=20
MM9955: folds=20
Uncalled bet (13775) returned to akbongu1977
akbongu1977 collected 7500 from pot
akbongu1977: doesn't show hand=20
*** SUMMARY ***
Total pot 7500 | Rake 0=20
Board [3h Kc 2d]
Seat 1: JJin91 (button) folded before Flop (didn't bet)
Seat 2: nwmdnj (small blind) folded before Flop
Seat 3: A A 5454 (big blind) folded on the Flop
Seat 4: Twon excelz folded before Flop (didn't bet)
Seat 5: MM9955 folded on the Flop
Seat 6: jaysu folded before Flop (didn't bet)
Seat 8: akbongu1977 collected (7500)


*********** # 103 **************
PokerStars Hand #169445709703: Tournament #1597684021, $18.20+$1.80 USD=
 Hold'em No Limit - Level XIV (400/800) - 2017/05/05 21:28:05 ET
Table '1597684021 2' 9-max Seat #2 is the button
Seat 1: JJin91 (23322 in chips)=20
Seat 2: nwmdnj (19250 in chips)=20
Seat 3: A A 5454 (21860 in chips)=20
Seat 4: Twon excelz (19581 in chips)=20
Seat 5: MM9955 (65154 in chips)=20
Seat 6: jaysu (12821 in chips)=20
Seat 8: akbongu1977 (21275 in chips)=20
JJin91: posts the ante 100
nwmdnj: posts the ante 100
A A 5454: posts the ante 100
Twon excelz: posts the ante 100
MM9955: posts the ante 100
jaysu: posts the ante 100
akbongu1977: posts the ante 100
A A 5454: posts small blind 400
Twon excelz: posts big blind 800
*** HOLE CARDS ***
Dealt to JJin91 [9c Qh]
MM9955: folds=20
jaysu: raises 11921 to 12721 and is all-in
akbongu1977: folds=20
JJin91: folds=20
nwmdnj: folds=20
A A 5454: folds=20
Twon excelz: folds=20
Uncalled bet (11921) returned to jaysu
jaysu collected 2700 from pot
jaysu: doesn't show hand=20
*** SUMMARY ***
Total pot 2700 | Rake 0=20
Seat 1: JJin91 folded before Flop (didn't bet)
Seat 2: nwmdnj (button) folded before Flop (didn't bet)
Seat 3: A A 5454 (small blind) folded before Flop
Seat 4: Twon excelz (big blind) folded before Flop
Seat 5: MM9955 folded before Flop (didn't bet)
Seat 6: jaysu collected (2700)
Seat 8: akbongu1977 folded before Flop (didn't bet)


*********** # 104 **************
PokerStars Hand #169445709915: Tournament #1597684021, $18.20+$1.80 USD=
 Hold'em No Limit - Level XIV (400/800) - 2017/05/05 21:28:49 ET
Table '1597684021 2' 9-max Seat #3 is the button
Seat 1: JJin91 (23222 in chips)=20
Seat 2: nwmdnj (19150 in chips)=20
Seat 3: A A 5454 (21360 in chips)=20
Seat 4: Twon excelz (18681 in chips)=20
Seat 5: MM9955 (65054 in chips)=20
Seat 6: jaysu (14621 in chips)=20
Seat 8: akbongu1977 (21175 in chips)=20
JJin91: posts the ante 100
nwmdnj: posts the ante 100
A A 5454: posts the ante 100
Twon excelz: posts the ante 100
MM9955: posts the ante 100
jaysu: posts the ante 100
akbongu1977: posts the ante 100
Twon excelz: posts small blind 400
MM9955: posts big blind 800
*** HOLE CARDS ***
Dealt to JJin91 [Th Qs]
jaysu: folds=20
akbongu1977: folds=20
JJin91: folds=20
nwmdnj: raises 800 to 1600
A A 5454: folds=20
Twon excelz: folds=20
MM9955: calls 800
*** FLOP *** [2d 3s Qc]
MM9955: checks=20
nwmdnj: checks=20
*** TURN *** [2d 3s Qc] [8d]
MM9955: bets 2400
nwmdnj: folds=20
Uncalled bet (2400) returned to MM9955
MM9955 collected 4300 from pot
MM9955: doesn't show hand=20
*** SUMMARY ***
Total pot 4300 | Rake 0=20
Board [2d 3s Qc 8d]
Seat 1: JJin91 folded before Flop (didn't bet)
Seat 2: nwmdnj folded on the Turn
Seat 3: A A 5454 (button) folded before Flop (didn't bet)
Seat 4: Twon excelz (small blind) folded before Flop
Seat 5: MM9955 (big blind) collected (4300)
Seat 6: jaysu folded before Flop (didn't bet)
Seat 8: akbongu1977 folded before Flop (didn't bet)


*********** # 105 **************
PokerStars Hand #169446474709: Tournament #1597684021, $18.20+$1.80 USD=
 Hold'em No Limit - Level XIV (400/800) - 2017/05/05 21:29:32 ET
Table '1597684021 2' 9-max Seat #4 is the button
Seat 1: JJin91 (23122 in chips)=20
Seat 2: nwmdnj (17450 in chips)=20
Seat 3: A A 5454 (21260 in chips)=20
Seat 4: Twon excelz (18181 in chips)=20
Seat 5: MM9955 (67654 in chips)=20
Seat 6: jaysu (14521 in chips)=20
Seat 8: akbongu1977 (21075 in chips)=20
JJin91: posts the ante 100
nwmdnj: posts the ante 100
A A 5454: posts the ante 100
Twon excelz: posts the ante 100
MM9955: posts the ante 100
jaysu: posts the ante 100
akbongu1977: posts the ante 100
MM9955: posts small blind 400
jaysu: posts big blind 800
*** HOLE CARDS ***
Dealt to JJin91 [5s Qs]
akbongu1977: folds=20
JJin91: folds=20
nwmdnj: folds=20
A A 5454: folds=20
Twon excelz: raises 2700 to 3500
MM9955: folds=20
jaysu: folds=20
Uncalled bet (2700) returned to Twon excelz
Twon excelz collected 2700 from pot
Twon excelz: doesn't show hand=20
*** SUMMARY ***
Total pot 2700 | Rake 0=20
Seat 1: JJin91 folded before Flop (didn't bet)
Seat 2: nwmdnj folded before Flop (didn't bet)
Seat 3: A A 5454 folded before Flop (didn't bet)
Seat 4: Twon excelz (button) collected (2700)
Seat 5: MM9955 (small blind) folded before Flop
Seat 6: jaysu (big blind) folded before Flop
Seat 8: akbongu1977 folded before Flop (didn't bet)


*********** # 106 **************
PokerStars Hand #169446474819: Tournament #1597684021, $18.20+$1.80 USD=
 Hold'em No Limit - Level XIV (400/800) - 2017/05/05 21:29:55 ET
Table '1597684021 2' 9-max Seat #5 is the button
Seat 1: JJin91 (23022 in chips)=20
Seat 2: nwmdnj (17350 in chips)=20
Seat 3: A A 5454 (21160 in chips)=20
Seat 4: Twon excelz (19981 in chips)=20
Seat 5: MM9955 (67154 in chips)=20
Seat 6: jaysu (13621 in chips)=20
Seat 8: akbongu1977 (20975 in chips)=20
JJin91: posts the ante 100
nwmdnj: posts the ante 100
A A 5454: posts the ante 100
Twon excelz: posts the ante 100
MM9955: posts the ante 100
jaysu: posts the ante 100
akbongu1977: posts the ante 100
jaysu: posts small blind 400
akbongu1977: posts big blind 800
*** HOLE CARDS ***
Dealt to JJin91 [8h 7d]
JJin91: folds=20
nwmdnj: folds=20
A A 5454: folds=20
Twon excelz: folds=20
MM9955: raises 1600 to 2400
jaysu: folds=20
akbongu1977: folds=20
Uncalled bet (1600) returned to MM9955
MM9955 collected 2700 from pot
MM9955: doesn't show hand=20
*** SUMMARY ***
Total pot 2700 | Rake 0=20
Seat 1: JJin91 folded before Flop (didn't bet)
Seat 2: nwmdnj folded before Flop (didn't bet)
Seat 3: A A 5454 folded before Flop (didn't bet)
Seat 4: Twon excelz folded before Flop (didn't bet)
Seat 5: MM9955 (button) collected (2700)
Seat 6: jaysu (small blind) folded before Flop
Seat 8: akbongu1977 (big blind) folded before Flop


*********** # 107 **************
PokerStars Hand #169446474961: Tournament #1597684021, $18.20+$1.80 USD=
 Hold'em No Limit - Level XIV (400/800) - 2017/05/05 21:30:25 ET
Table '1597684021 2' 9-max Seat #6 is the button
Seat 1: JJin91 (22922 in chips)=20
Seat 2: nwmdnj (17250 in chips)=20
Seat 3: A A 5454 (21060 in chips)=20
Seat 4: Twon excelz (19881 in chips)=20
Seat 5: MM9955 (68954 in chips)=20
Seat 6: jaysu (13121 in chips)=20
Seat 8: akbongu1977 (20075 in chips)=20
JJin91: posts the ante 100
nwmdnj: posts the ante 100
A A 5454: posts the ante 100
Twon excelz: posts the ante 100
MM9955: posts the ante 100
jaysu: posts the ante 100
akbongu1977: posts the ante 100
akbongu1977: posts small blind 400
JJin91: posts big blind 800
*** HOLE CARDS ***
Dealt to JJin91 [Qd 8h]
nwmdnj: raises 1200 to 2000
A A 5454: folds=20
Twon excelz: folds=20
MM9955: folds=20
jaysu: folds=20
akbongu1977: folds=20
JJin91: folds=20
Uncalled bet (1200) returned to nwmdnj
nwmdnj collected 2700 from pot
nwmdnj: doesn't show hand=20
*** SUMMARY ***
Total pot 2700 | Rake 0=20
Seat 1: JJin91 (big blind) folded before Flop
Seat 2: nwmdnj collected (2700)
Seat 3: A A 5454 folded before Flop (didn't bet)
Seat 4: Twon excelz folded before Flop (didn't bet)
Seat 5: MM9955 folded before Flop (didn't bet)
Seat 6: jaysu (button) folded before Flop (didn't bet)
Seat 8: akbongu1977 (small blind) folded before Flop


*********** # 108 **************
PokerStars Hand #169446475076: Tournament #1597684021, $18.20+$1.80 USD=
 Hold'em No Limit - Level XIV (400/800) - 2017/05/05 21:30:50 ET
Table '1597684021 2' 9-max Seat #8 is the button
Seat 1: JJin91 (22022 in chips)=20
Seat 2: nwmdnj (19050 in chips)=20
Seat 3: A A 5454 (20960 in chips)=20
Seat 4: Twon excelz (19781 in chips)=20
Seat 5: MM9955 (68854 in chips)=20
Seat 6: jaysu (13021 in chips)=20
Seat 8: akbongu1977 (19575 in chips)=20
JJin91: posts the ante 100
nwmdnj: posts the ante 100
A A 5454: posts the ante 100
Twon excelz: posts the ante 100
MM9955: posts the ante 100
jaysu: posts the ante 100
akbongu1977: posts the ante 100
JJin91: posts small blind 400
nwmdnj: posts big blind 800
*** HOLE CARDS ***
Dealt to JJin91 [Ad 5c]
A A 5454: folds=20
Twon excelz: folds=20
MM9955: folds=20
jaysu: raises 888 to 1688
akbongu1977: folds=20
JJin91: folds=20
nwmdnj: folds=20
Uncalled bet (888) returned to jaysu
jaysu collected 2700 from pot
jaysu: doesn't show hand=20
*** SUMMARY ***
Total pot 2700 | Rake 0=20
Seat 1: JJin91 (small blind) folded before Flop
Seat 2: nwmdnj (big blind) folded before Flop
Seat 3: A A 5454 folded before Flop (didn't bet)
Seat 4: Twon excelz folded before Flop (didn't bet)
Seat 5: MM9955 folded before Flop (didn't bet)
Seat 6: jaysu collected (2700)
Seat 8: akbongu1977 (button) folded before Flop (didn't bet)


*********** # 109 **************
PokerStars Hand #169446475248: Tournament #1597684021, $18.20+$1.80 USD=
 Hold'em No Limit - Level XIV (400/800) - 2017/05/05 21:31:26 ET
Table '1597684021 2' 9-max Seat #1 is the button
Seat 1: JJin91 (21522 in chips)=20
Seat 2: nwmdnj (18150 in chips)=20
Seat 3: A A 5454 (20860 in chips)=20
Seat 4: Twon excelz (19681 in chips)=20
Seat 5: MM9955 (68754 in chips)=20
Seat 6: jaysu (14821 in chips)=20
Seat 8: akbongu1977 (19475 in chips)=20
JJin91: posts the ante 100
nwmdnj: posts the ante 100
A A 5454: posts the ante 100
Twon excelz: posts the ante 100
MM9955: posts the ante 100
jaysu: posts the ante 100
akbongu1977: posts the ante 100
nwmdnj: posts small blind 400
A A 5454: posts big blind 800
*** HOLE CARDS ***
Dealt to JJin91 [5d Ad]
Twon excelz: folds=20
MM9955: folds=20
jaysu: folds=20
akbongu1977: folds=20
JJin91: raises 1288 to 2088
nwmdnj: folds=20
A A 5454: folds=20
Uncalled bet (1288) returned to JJin91
JJin91 collected 2700 from pot
JJin91: doesn't show hand=20
*** SUMMARY ***
Total pot 2700 | Rake 0=20
Seat 1: JJin91 (button) collected (2700)
Seat 2: nwmdnj (small blind) folded before Flop
Seat 3: A A 5454 (big blind) folded before Flop
Seat 4: Twon excelz folded before Flop (didn't bet)
Seat 5: MM9955 folded before Flop (didn't bet)
Seat 6: jaysu folded before Flop (didn't bet)
Seat 8: akbongu1977 folded before Flop (didn't bet)


*********** # 110 **************
PokerStars Hand #169446475405: Tournament #1597684021, $18.20+$1.80 USD=
 Hold'em No Limit - Level XIV (400/800) - 2017/05/05 21:31:57 ET
Table '1597684021 2' 9-max Seat #2 is the button
Seat 1: JJin91 (23322 in chips)=20
Seat 2: nwmdnj (17650 in chips)=20
Seat 3: A A 5454 (19960 in chips)=20
Seat 4: Twon excelz (19581 in chips)=20
Seat 5: MM9955 (68654 in chips)=20
Seat 6: jaysu (14721 in chips)=20
Seat 8: akbongu1977 (19375 in chips)=20
JJin91: posts the ante 100
nwmdnj: posts the ante 100
A A 5454: posts the ante 100
Twon excelz: posts the ante 100
MM9955: posts the ante 100
jaysu: posts the ante 100
akbongu1977: posts the ante 100
A A 5454: posts small blind 400
Twon excelz: posts big blind 800
*** HOLE CARDS ***
Dealt to JJin91 [6h 9h]
MM9955: raises 800 to 1600
jaysu: folds=20
akbongu1977: folds=20
JJin91: folds=20
nwmdnj: folds=20
A A 5454: folds=20
Twon excelz: calls 800
*** FLOP *** [Ts Jh Jd]
Twon excelz: bets 4300
MM9955: folds=20
Uncalled bet (4300) returned to Twon excelz
Twon excelz collected 4300 from pot
Twon excelz: doesn't show hand=20
*** SUMMARY ***
Total pot 4300 | Rake 0=20
Board [Ts Jh Jd]
Seat 1: JJin91 folded before Flop (didn't bet)
Seat 2: nwmdnj (button) folded before Flop (didn't bet)
Seat 3: A A 5454 (small blind) folded before Flop
Seat 4: Twon excelz (big blind) collected (4300)
Seat 5: MM9955 folded on the Flop
Seat 6: jaysu folded before Flop (didn't bet)
Seat 8: akbongu1977 folded before Flop (didn't bet)


*********** # 111 **************
PokerStars Hand #169446475600: Tournament #1597684021, $18.20+$1.80 USD=
 Hold'em No Limit - Level XIV (400/800) - 2017/05/05 21:32:35 ET
Table '1597684021 2' 9-max Seat #3 is the button
Seat 1: JJin91 (23222 in chips)=20
Seat 2: nwmdnj (17550 in chips)=20
Seat 3: A A 5454 (19460 in chips)=20
Seat 4: Twon excelz (22181 in chips)=20
Seat 5: MM9955 (66954 in chips)=20
Seat 6: jaysu (14621 in chips)=20
Seat 8: akbongu1977 (19275 in chips)=20
JJin91: posts the ante 100
nwmdnj: posts the ante 100
A A 5454: posts the ante 100
Twon excelz: posts the ante 100
MM9955: posts the ante 100
jaysu: posts the ante 100
akbongu1977: posts the ante 100
Twon excelz: posts small blind 400
MM9955: posts big blind 800
*** HOLE CARDS ***
Dealt to JJin91 [9s Qc]
jaysu: raises 888 to 1688
akbongu1977: folds=20
JJin91: folds=20
nwmdnj: folds=20
A A 5454: calls 1688
Twon excelz: folds=20
MM9955: folds=20
*** FLOP *** [3s 8d 4c]
jaysu: bets 1640
A A 5454: calls 1640
*** TURN *** [3s 8d 4c] [5c]
jaysu: checks=20
A A 5454: bets 4278
jaysu: folds=20
Uncalled bet (4278) returned to A A 5454
A A 5454 collected 8556 from pot
A A 5454: doesn't show hand=20
*** SUMMARY ***
Total pot 8556 | Rake 0=20
Board [3s 8d 4c 5c]
Seat 1: JJin91 folded before Flop (didn't bet)
Seat 2: nwmdnj folded before Flop (didn't bet)
Seat 3: A A 5454 (button) collected (8556)
Seat 4: Twon excelz (small blind) folded before Flop
Seat 5: MM9955 (big blind) folded before Flop
Seat 6: jaysu folded on the Turn
Seat 8: akbongu1977 folded before Flop (didn't bet)


*********** # 112 **************
PokerStars Hand #169446475967: Tournament #1597684021, $18.20+$1.80 USD=
 Hold'em No Limit - Level XV (500/1000) - 2017/05/05 21:33:51 ET
Table '1597684021 2' 9-max Seat #4 is the button
Seat 1: JJin91 (23122 in chips)=20
Seat 2: nwmdnj (17450 in chips)=20
Seat 3: A A 5454 (24588 in chips)=20
Seat 4: Twon excelz (21681 in chips)=20
Seat 5: MM9955 (66054 in chips)=20
Seat 6: jaysu (11193 in chips)=20
Seat 8: akbongu1977 (19175 in chips)=20
JJin91: posts the ante 125
nwmdnj: posts the ante 125
A A 5454: posts the ante 125
Twon excelz: posts the ante 125
MM9955: posts the ante 125
jaysu: posts the ante 125
akbongu1977: posts the ante 125
MM9955: posts small blind 500
jaysu: posts big blind 1000
*** HOLE CARDS ***
Dealt to JJin91 [5c 6s]
akbongu1977: folds=20
JJin91: folds=20
nwmdnj: folds=20
A A 5454: folds=20
Twon excelz: raises 3375 to 4375
MM9955: folds=20
jaysu: folds=20
Uncalled bet (3375) returned to Twon excelz
Twon excelz collected 3375 from pot
Twon excelz: doesn't show hand=20
*** SUMMARY ***
Total pot 3375 | Rake 0=20
Seat 1: JJin91 folded before Flop (didn't bet)
Seat 2: nwmdnj folded before Flop (didn't bet)
Seat 3: A A 5454 folded before Flop (didn't bet)
Seat 4: Twon excelz (button) collected (3375)
Seat 5: MM9955 (small blind) folded before Flop
Seat 6: jaysu (big blind) folded before Flop
Seat 8: akbongu1977 folded before Flop (didn't bet)


*********** # 113 **************
PokerStars Hand #169446476150: Tournament #1597684021, $18.20+$1.80 USD=
 Hold'em No Limit - Level XV (500/1000) - 2017/05/05 21:34:30 ET
Table '1597684021 2' 9-max Seat #5 is the button
Seat 1: JJin91 (22997 in chips)=20
Seat 2: nwmdnj (17325 in chips)=20
Seat 3: A A 5454 (24463 in chips)=20
Seat 4: Twon excelz (23931 in chips)=20
Seat 5: MM9955 (65429 in chips)=20
Seat 6: jaysu (10068 in chips)=20
Seat 8: akbongu1977 (19050 in chips)=20
JJin91: posts the ante 125
nwmdnj: posts the ante 125
A A 5454: posts the ante 125
Twon excelz: posts the ante 125
MM9955: posts the ante 125
jaysu: posts the ante 125
akbongu1977: posts the ante 125
jaysu: posts small blind 500
akbongu1977: posts big blind 1000
*** HOLE CARDS ***
Dealt to JJin91 [8s Qs]
JJin91: folds=20
nwmdnj: raises 1000 to 2000
A A 5454: folds=20
Twon excelz: raises 21806 to 23806 and is all-in
MM9955: folds=20
jaysu: folds=20
akbongu1977: folds=20
nwmdnj: calls 15200 and is all-in
Uncalled bet (6606) returned to Twon excelz
*** FLOP *** [8d 4s 6s]
*** TURN *** [8d 4s 6s] [5s]
*** RIVER *** [8d 4s 6s 5s] [7s]
*** SHOW DOWN ***
nwmdnj: shows [Kc As] (a flush, Ace high)
Twon excelz: shows [Qc Qd] (a straight, Four to Eight)
nwmdnj collected 36775 from pot
*** SUMMARY ***
Total pot 36775 | Rake 0=20
Board [8d 4s 6s 5s 7s]
Seat 1: JJin91 folded before Flop (didn't bet)
Seat 2: nwmdnj showed [Kc As] and won (36775) with a flush, Ace high
Seat 3: A A 5454 folded before Flop (didn't bet)
Seat 4: Twon excelz showed [Qc Qd] and lost with a straight, Four to Ei=
ght
Seat 5: MM9955 (button) folded before Flop (didn't bet)
Seat 6: jaysu (small blind) folded before Flop
Seat 8: akbongu1977 (big blind) folded before Flop


*********** # 114 **************
PokerStars Hand #169446476378: Tournament #1597684021, $18.20+$1.80 USD=
 Hold'em No Limit - Level XV (500/1000) - 2017/05/05 21:35:14 ET
Table '1597684021 2' 9-max Seat #6 is the button
Seat 1: JJin91 (22872 in chips)=20
Seat 2: nwmdnj (36775 in chips)=20
Seat 3: A A 5454 (24338 in chips)=20
Seat 4: Twon excelz (6606 in chips)=20
Seat 5: MM9955 (65304 in chips)=20
Seat 6: jaysu (9443 in chips)=20
Seat 8: akbongu1977 (17925 in chips)=20
JJin91: posts the ante 125
nwmdnj: posts the ante 125
A A 5454: posts the ante 125
Twon excelz: posts the ante 125
MM9955: posts the ante 125
jaysu: posts the ante 125
akbongu1977: posts the ante 125
akbongu1977: posts small blind 500
JJin91: posts big blind 1000
*** HOLE CARDS ***
Dealt to JJin91 [4d 9c]
nwmdnj: folds=20
A A 5454: folds=20
Twon excelz: folds=20
MM9955: folds=20
jaysu: folds=20
akbongu1977: folds=20
Uncalled bet (500) returned to JJin91
JJin91 collected 1875 from pot
JJin91: doesn't show hand=20
*** SUMMARY ***
Total pot 1875 | Rake 0=20
Seat 1: JJin91 (big blind) collected (1875)
Seat 2: nwmdnj folded before Flop (didn't bet)
Seat 3: A A 5454 folded before Flop (didn't bet)
Seat 4: Twon excelz folded before Flop (didn't bet)
Seat 5: MM9955 folded before Flop (didn't bet)
Seat 6: jaysu (button) folded before Flop (didn't bet)
Seat 8: akbongu1977 (small blind) folded before Flop


*********** # 115 **************
PokerStars Hand #169446476443: Tournament #1597684021, $18.20+$1.80 USD=
 Hold'em No Limit - Level XV (500/1000) - 2017/05/05 21:35:26 ET
Table '1597684021 2' 9-max Seat #8 is the button
Seat 1: JJin91 (24122 in chips)=20
Seat 2: nwmdnj (36650 in chips)=20
Seat 3: A A 5454 (24213 in chips)=20
Seat 4: Twon excelz (6481 in chips)=20
Seat 5: MM9955 (65179 in chips)=20
Seat 6: jaysu (9318 in chips)=20
Seat 8: akbongu1977 (17300 in chips)=20
JJin91: posts the ante 125
nwmdnj: posts the ante 125
A A 5454: posts the ante 125
Twon excelz: posts the ante 125
MM9955: posts the ante 125
jaysu: posts the ante 125
akbongu1977: posts the ante 125
JJin91: posts small blind 500
nwmdnj: posts big blind 1000
*** HOLE CARDS ***
Dealt to JJin91 [Th 3h]
A A 5454: folds=20
Twon excelz: folds=20
MM9955: folds=20
jaysu: folds=20
akbongu1977 is connected=20
akbongu1977: calls 1000
JJin91: raises 3000 to 4000
nwmdnj: folds=20
akbongu1977: folds=20
Uncalled bet (3000) returned to JJin91
JJin91 collected 3875 from pot
JJin91: doesn't show hand=20
*** SUMMARY ***
Total pot 3875 | Rake 0=20
Seat 1: JJin91 (small blind) collected (3875)
Seat 2: nwmdnj (big blind) folded before Flop
Seat 3: A A 5454 folded before Flop (didn't bet)
Seat 4: Twon excelz folded before Flop (didn't bet)
Seat 5: MM9955 folded before Flop (didn't bet)
Seat 6: jaysu folded before Flop (didn't bet)
Seat 8: akbongu1977 (button) folded before Flop


*********** # 116 **************
PokerStars Hand #169446476639: Tournament #1597684021, $18.20+$1.80 USD=
 Hold'em No Limit - Level XV (500/1000) - 2017/05/05 21:36:05 ET
Table '1597684021 2' 9-max Seat #1 is the button
Seat 1: JJin91 (26872 in chips)=20
Seat 2: nwmdnj (35525 in chips)=20
Seat 3: A A 5454 (24088 in chips)=20
Seat 4: Twon excelz (6356 in chips)=20
Seat 5: MM9955 (65054 in chips)=20
Seat 6: jaysu (9193 in chips)=20
Seat 8: akbongu1977 (16175 in chips)=20
JJin91: posts the ante 125
nwmdnj: posts the ante 125
A A 5454: posts the ante 125
Twon excelz: posts the ante 125
MM9955: posts the ante 125
jaysu: posts the ante 125
akbongu1977: posts the ante 125
nwmdnj: posts small blind 500
A A 5454: posts big blind 1000
*** HOLE CARDS ***
Dealt to JJin91 [Ac Kh]
Twon excelz: raises 5231 to 6231 and is all-in
MM9955: folds=20
jaysu: raises 2837 to 9068 and is all-in
akbongu1977: folds=20
JJin91: raises 17679 to 26747 and is all-in
nwmdnj: folds=20
A A 5454: folds=20
Uncalled bet (17679) returned to JJin91
*** FLOP *** [Jh Ts Qs]
*** TURN *** [Jh Ts Qs] [3h]
*** RIVER *** [Jh Ts Qs 3h] [5c]
*** SHOW DOWN ***
jaysu: shows [Ad Jc] (a pair of Jacks)
JJin91: shows [Ac Kh] (a straight, Ten to Ace)
JJin91 collected 5674 from side pot
Twon excelz: shows [Tc 8d] (a pair of Tens)
JJin91 collected 21068 from main pot
jaysu finished the tournament in 35th place
Twon excelz finished the tournament in 36th place
*** SUMMARY ***
Total pot 26742 Main pot 21068. Side pot 5674. | Rake 0=20
Board [Jh Ts Qs 3h 5c]
Seat 1: JJin91 (button) showed [Ac Kh] and won (26742) with a straight,=
 Ten to Ace
Seat 2: nwmdnj (small blind) folded before Flop
Seat 3: A A 5454 (big blind) folded before Flop
Seat 4: Twon excelz showed [Tc 8d] and lost with a pair of Tens
Seat 5: MM9955 folded before Flop (didn't bet)
Seat 6: jaysu showed [Ad Jc] and lost with a pair of Jacks
Seat 8: akbongu1977 folded before Flop (didn't bet)


*********** # 117 **************
PokerStars Hand #169446476820: Tournament #1597684021, $18.20+$1.80 USD=
 Hold'em No Limit - Level XV (500/1000) - 2017/05/05 21:36:44 ET
Table '1597684021 2' 9-max Seat #2 is the button
Seat 1: JJin91 (44421 in chips)=20
Seat 2: nwmdnj (34900 in chips)=20
Seat 3: A A 5454 (22963 in chips)=20
Seat 5: MM9955 (64929 in chips)=20
Seat 7: MelzWay (23626 in chips)=20
Seat 8: akbongu1977 (16050 in chips)=20
Seat 9: hotcard08873 (25425 in chips)=20
JJin91: posts the ante 125
nwmdnj: posts the ante 125
A A 5454: posts the ante 125
MM9955: posts the ante 125
MelzWay: posts the ante 125
akbongu1977: posts the ante 125
hotcard08873: posts the ante 125
A A 5454: posts small blind 500
MM9955: posts big blind 1000
*** HOLE CARDS ***
Dealt to JJin91 [Th 3h]
MelzWay: folds=20
akbongu1977: raises 2000 to 3000
hotcard08873: folds=20
JJin91: folds=20
nwmdnj: folds=20
A A 5454: folds=20
MM9955: calls 2000
*** FLOP *** [5h Qh 9c]
MM9955: checks=20
akbongu1977: bets 12925 and is all-in
MM9955: folds=20
Uncalled bet (12925) returned to akbongu1977
akbongu1977 collected 7375 from pot
akbongu1977: doesn't show hand=20
*** SUMMARY ***
Total pot 7375 | Rake 0=20
Board [5h Qh 9c]
Seat 1: JJin91 folded before Flop (didn't bet)
Seat 2: nwmdnj (button) folded before Flop (didn't bet)
Seat 3: A A 5454 (small blind) folded before Flop
Seat 5: MM9955 (big blind) folded on the Flop
Seat 7: MelzWay folded before Flop (didn't bet)
Seat 8: akbongu1977 collected (7375)
Seat 9: hotcard08873 folded before Flop (didn't bet)


*********** # 118 **************
PokerStars Hand #169446477026: Tournament #1597684021, $18.20+$1.80 USD=
 Hold'em No Limit - Level XV (500/1000) - 2017/05/05 21:37:24 ET
Table '1597684021 2' 9-max Seat #3 is the button
Seat 1: JJin91 (44296 in chips)=20
Seat 2: nwmdnj (34775 in chips)=20
Seat 3: A A 5454 (22338 in chips)=20
Seat 5: MM9955 (61804 in chips)=20
Seat 6: Mr Hero76 (32198 in chips)=20
Seat 7: MelzWay (23501 in chips)=20
Seat 8: akbongu1977 (20300 in chips)=20
Seat 9: hotcard08873 (25300 in chips)=20
JJin91: posts the ante 125
nwmdnj: posts the ante 125
A A 5454: posts the ante 125
MM9955: posts the ante 125
Mr Hero76: posts the ante 125
MelzWay: posts the ante 125
akbongu1977: posts the ante 125
hotcard08873: posts the ante 125
MM9955: posts small blind 500
Mr Hero76: posts big blind 1000
*** HOLE CARDS ***
Dealt to JJin91 [Tc Jc]
MelzWay: folds=20
akbongu1977: calls 1000
hotcard08873: folds=20
JJin91: calls 1000
nwmdnj: folds=20
A A 5454: folds=20
MM9955: calls 500
Mr Hero76: raises 5000 to 6000
akbongu1977: folds=20
JJin91: folds=20
MM9955: folds=20
Uncalled bet (5000) returned to Mr Hero76
Mr Hero76 collected 5000 from pot
Mr Hero76: doesn't show hand=20
*** SUMMARY ***
Total pot 5000 | Rake 0=20
Seat 1: JJin91 folded before Flop
Seat 2: nwmdnj folded before Flop (didn't bet)
Seat 3: A A 5454 (button) folded before Flop (didn't bet)
Seat 5: MM9955 (small blind) folded before Flop
Seat 6: Mr Hero76 (big blind) collected (5000)
Seat 7: MelzWay folded before Flop (didn't bet)
Seat 8: akbongu1977 folded before Flop
Seat 9: hotcard08873 folded before Flop (didn't bet)


*********** # 119 **************
PokerStars Hand #169446477244: Tournament #1597684021, $18.20+$1.80 USD=
 Hold'em No Limit - Level XV (500/1000) - 2017/05/05 21:38:07 ET
Table '1597684021 2' 9-max Seat #5 is the button
Seat 1: JJin91 (43171 in chips)=20
Seat 2: nwmdnj (34650 in chips)=20
Seat 3: A A 5454 (22213 in chips)=20
Seat 5: MM9955 (60679 in chips)=20
Seat 6: Mr Hero76 (36073 in chips)=20
Seat 7: MelzWay (23376 in chips)=20
Seat 8: akbongu1977 (19175 in chips)=20
Seat 9: hotcard08873 (25175 in chips)=20
JJin91: posts the ante 125
nwmdnj: posts the ante 125
A A 5454: posts the ante 125
MM9955: posts the ante 125
Mr Hero76: posts the ante 125
MelzWay: posts the ante 125
akbongu1977: posts the ante 125
hotcard08873: posts the ante 125
Mr Hero76: posts small blind 500
MelzWay: posts big blind 1000
*** HOLE CARDS ***
Dealt to JJin91 [2h Tc]
akbongu1977: folds=20
hotcard08873: folds=20
JJin91: folds=20
nwmdnj: folds=20
A A 5454: folds=20
MM9955: raises 4000 to 5000
Mr Hero76: folds=20
MelzWay: folds=20
Uncalled bet (4000) returned to MM9955
MM9955 collected 3500 from pot
MM9955: doesn't show hand=20
*** SUMMARY ***
Total pot 3500 | Rake 0=20
Seat 1: JJin91 folded before Flop (didn't bet)
Seat 2: nwmdnj folded before Flop (didn't bet)
Seat 3: A A 5454 folded before Flop (didn't bet)
Seat 5: MM9955 (button) collected (3500)
Seat 6: Mr Hero76 (small blind) folded before Flop
Seat 7: MelzWay (big blind) folded before Flop
Seat 8: akbongu1977 folded before Flop (didn't bet)
Seat 9: hotcard08873 folded before Flop (didn't bet)


*********** # 120 **************
PokerStars Hand #169446477406: Tournament #1597684021, $18.20+$1.80 USD=
 Hold'em No Limit - Level XV (500/1000) - 2017/05/05 21:38:40 ET
Table '1597684021 2' 9-max Seat #6 is the button
Seat 1: JJin91 (43046 in chips)=20
Seat 2: nwmdnj (34525 in chips)=20
Seat 3: A A 5454 (22088 in chips)=20
Seat 5: MM9955 (63054 in chips)=20
Seat 6: Mr Hero76 (35448 in chips)=20
Seat 7: MelzWay (22251 in chips)=20
Seat 8: akbongu1977 (19050 in chips)=20
Seat 9: hotcard08873 (25050 in chips)=20
JJin91: posts the ante 125
nwmdnj: posts the ante 125
A A 5454: posts the ante 125
MM9955: posts the ante 125
Mr Hero76: posts the ante 125
MelzWay: posts the ante 125
akbongu1977: posts the ante 125
hotcard08873: posts the ante 125
MelzWay: posts small blind 500
akbongu1977: posts big blind 1000
*** HOLE CARDS ***
Dealt to JJin91 [5d Jc]
hotcard08873: folds=20
JJin91: folds=20
nwmdnj: folds=20
A A 5454: calls 1000
MM9955: folds=20
Mr Hero76: folds=20
MelzWay: calls 500
akbongu1977: checks=20
*** FLOP *** [8c Th 9s]
MelzWay: checks=20
akbongu1977: checks=20
A A 5454: bets 2000
MelzWay: calls 2000
akbongu1977: folds=20
*** TURN *** [8c Th 9s] [3s]
MelzWay: checks=20
A A 5454: checks=20
*** RIVER *** [8c Th 9s 3s] [6s]
MelzWay: checks=20
A A 5454: bets 4000
MelzWay: folds=20
Uncalled bet (4000) returned to A A 5454
A A 5454 collected 8000 from pot
A A 5454: doesn't show hand=20
*** SUMMARY ***
Total pot 8000 | Rake 0=20
Board [8c Th 9s 3s 6s]
Seat 1: JJin91 folded before Flop (didn't bet)
Seat 2: nwmdnj folded before Flop (didn't bet)
Seat 3: A A 5454 collected (8000)
Seat 5: MM9955 folded before Flop (didn't bet)
Seat 6: Mr Hero76 (button) folded before Flop (didn't bet)
Seat 7: MelzWay (small blind) folded on the River
Seat 8: akbongu1977 (big blind) folded on the Flop
Seat 9: hotcard08873 folded before Flop (didn't bet)


*********** # 121 **************
PokerStars Hand #169446477869: Tournament #1597684021, $18.20+$1.80 USD=
 Hold'em No Limit - Level XV (500/1000) - 2017/05/05 21:40:10 ET
Table '1597684021 2' 9-max Seat #7 is the button
Seat 1: JJin91 (42921 in chips)=20
Seat 2: nwmdnj (34400 in chips)=20
Seat 3: A A 5454 (26963 in chips)=20
Seat 5: MM9955 (62929 in chips)=20
Seat 6: Mr Hero76 (35323 in chips)=20
Seat 7: MelzWay (19126 in chips)=20
Seat 8: akbongu1977 (17925 in chips)=20
Seat 9: hotcard08873 (24925 in chips)=20
JJin91: posts the ante 125
nwmdnj: posts the ante 125
A A 5454: posts the ante 125
MM9955: posts the ante 125
Mr Hero76: posts the ante 125
MelzWay: posts the ante 125
akbongu1977: posts the ante 125
hotcard08873: posts the ante 125
akbongu1977: posts small blind 500
hotcard08873: posts big blind 1000
*** HOLE CARDS ***
Dealt to JJin91 [As Jc]
JJin91: raises 1190 to 2190
nwmdnj: folds=20
A A 5454: folds=20
MM9955: calls 2190
Mr Hero76: folds=20
MelzWay: folds=20
akbongu1977: calls 1690
hotcard08873: raises 22610 to 24800 and is all-in
JJin91: folds=20
MM9955: folds=20
akbongu1977: folds=20
Uncalled bet (22610) returned to hotcard08873
hotcard08873 collected 9760 from pot
hotcard08873: doesn't show hand=20
*** SUMMARY ***
Total pot 9760 | Rake 0=20
Seat 1: JJin91 folded before Flop
Seat 2: nwmdnj folded before Flop (didn't bet)
Seat 3: A A 5454 folded before Flop (didn't bet)
Seat 5: MM9955 folded before Flop
Seat 6: Mr Hero76 folded before Flop (didn't bet)
Seat 7: MelzWay (button) folded before Flop (didn't bet)
Seat 8: akbongu1977 (small blind) folded before Flop
Seat 9: hotcard08873 (big blind) collected (9760)


*********** # 122 **************
PokerStars Hand #169446477983: Tournament #1597684021, $18.20+$1.80 USD=
 Hold'em No Limit - Level XV (500/1000) - 2017/05/05 21:40:34 ET
Table '1597684021 2' 9-max Seat #8 is the button
Seat 1: JJin91 (40606 in chips)=20
Seat 2: nwmdnj (34275 in chips)=20
Seat 3: A A 5454 (26838 in chips)=20
Seat 5: MM9955 (60614 in chips)=20
Seat 6: Mr Hero76 (35198 in chips)=20
Seat 7: MelzWay (19001 in chips)=20
Seat 8: akbongu1977 (15610 in chips)=20
Seat 9: hotcard08873 (32370 in chips)=20
JJin91: posts the ante 125
nwmdnj: posts the ante 125
A A 5454: posts the ante 125
MM9955: posts the ante 125
Mr Hero76: posts the ante 125
MelzWay: posts the ante 125
akbongu1977: posts the ante 125
hotcard08873: posts the ante 125
hotcard08873: posts small blind 500
JJin91: posts big blind 1000
*** HOLE CARDS ***
Dealt to JJin91 [Jh Ts]
nwmdnj: folds=20
A A 5454: folds=20
MM9955: calls 1000
Mr Hero76: folds=20
MelzWay: calls 1000
akbongu1977: calls 1000
hotcard08873: folds=20
JJin91: checks=20
*** FLOP *** [2c Kc 5d]
JJin91: checks=20
MM9955: bets 2000
MelzWay: folds=20
akbongu1977: folds=20
JJin91: folds=20
Uncalled bet (2000) returned to MM9955
MM9955 collected 5500 from pot
MM9955: doesn't show hand=20
*** SUMMARY ***
Total pot 5500 | Rake 0=20
Board [2c Kc 5d]
Seat 1: JJin91 (big blind) folded on the Flop
Seat 2: nwmdnj folded before Flop (didn't bet)
Seat 3: A A 5454 folded before Flop (didn't bet)
Seat 5: MM9955 collected (5500)
Seat 6: Mr Hero76 folded before Flop (didn't bet)
Seat 7: MelzWay folded on the Flop
Seat 8: akbongu1977 (button) folded on the Flop
Seat 9: hotcard08873 (small blind) folded before Flop


*********** # 123 **************
PokerStars Hand #169446478171: Tournament #1597684021, $18.20+$1.80 USD=
 Hold'em No Limit - Level XV (500/1000) - 2017/05/05 21:41:17 ET
Table '1597684021 2' 9-max Seat #9 is the button
Seat 1: JJin91 (39481 in chips)=20
Seat 2: nwmdnj (34150 in chips)=20
Seat 3: A A 5454 (26713 in chips)=20
Seat 5: MM9955 (64989 in chips)=20
Seat 6: Mr Hero76 (35073 in chips)=20
Seat 7: MelzWay (17876 in chips)=20
Seat 8: akbongu1977 (14485 in chips)=20
Seat 9: hotcard08873 (31745 in chips)=20
JJin91: posts the ante 125
nwmdnj: posts the ante 125
A A 5454: posts the ante 125
MM9955: posts the ante 125
Mr Hero76: posts the ante 125
MelzWay: posts the ante 125
akbongu1977: posts the ante 125
hotcard08873: posts the ante 125
JJin91: posts small blind 500
nwmdnj: posts big blind 1000
*** HOLE CARDS ***
Dealt to JJin91 [3d 8c]
A A 5454: folds=20
MM9955: folds=20
Mr Hero76 has timed out
Mr Hero76: folds=20
Mr Hero76 is sitting out
MelzWay: calls 1000
akbongu1977: folds=20
hotcard08873: folds=20
JJin91: folds=20
Mr Hero76 has returned
nwmdnj: checks=20
*** FLOP *** [Jh 2d Tc]
nwmdnj: checks=20
MelzWay: bets 1000
nwmdnj: folds=20
Uncalled bet (1000) returned to MelzWay
MelzWay collected 3500 from pot
MelzWay: doesn't show hand=20
*** SUMMARY ***
Total pot 3500 | Rake 0=20
Board [Jh 2d Tc]
Seat 1: JJin91 (small blind) folded before Flop
Seat 2: nwmdnj (big blind) folded on the Flop
Seat 3: A A 5454 folded before Flop (didn't bet)
Seat 5: MM9955 folded before Flop (didn't bet)
Seat 6: Mr Hero76 folded before Flop (didn't bet)
Seat 7: MelzWay collected (3500)
Seat 8: akbongu1977 folded before Flop (didn't bet)
Seat 9: hotcard08873 (button) folded before Flop (didn't bet)


*********** # 124 **************
PokerStars Hand #169446478602: Tournament #1597684021, $18.20+$1.80 USD=
 Hold'em No Limit - Level XVI (600/1200) - 2017/05/05 21:42:45 ET
Table '1597684021 2' 9-max Seat #1 is the button
Seat 1: JJin91 (38856 in chips)=20
Seat 2: nwmdnj (33025 in chips)=20
Seat 3: A A 5454 (26588 in chips)=20
Seat 5: MM9955 (64864 in chips)=20
Seat 6: Mr Hero76 (34948 in chips)=20
Seat 7: MelzWay (20251 in chips)=20
Seat 8: akbongu1977 (14360 in chips)=20
Seat 9: hotcard08873 (31620 in chips)=20
JJin91: posts the ante 150
nwmdnj: posts the ante 150
A A 5454: posts the ante 150
MM9955: posts the ante 150
Mr Hero76: posts the ante 150
MelzWay: posts the ante 150
akbongu1977: posts the ante 150
hotcard08873: posts the ante 150
nwmdnj: posts small blind 600
A A 5454: posts big blind 1200
*** HOLE CARDS ***
Dealt to JJin91 [7h 4c]
MM9955: folds=20
Mr Hero76: folds=20
MelzWay: folds=20
akbongu1977: calls 1200
hotcard08873: folds=20
JJin91: folds=20
nwmdnj: folds=20
A A 5454: checks=20
*** FLOP *** [2d Ks 3c]
A A 5454: checks=20
akbongu1977: bets 4200
A A 5454: folds=20
Uncalled bet (4200) returned to akbongu1977
akbongu1977 collected 4200 from pot
akbongu1977: doesn't show hand=20
*** SUMMARY ***
Total pot 4200 | Rake 0=20
Board [2d Ks 3c]
Seat 1: JJin91 (button) folded before Flop (didn't bet)
Seat 2: nwmdnj (small blind) folded before Flop
Seat 3: A A 5454 (big blind) folded on the Flop
Seat 5: MM9955 folded before Flop (didn't bet)
Seat 6: Mr Hero76 folded before Flop (didn't bet)
Seat 7: MelzWay folded before Flop (didn't bet)
Seat 8: akbongu1977 collected (4200)
Seat 9: hotcard08873 folded before Flop (didn't bet)


*********** # 125 **************
PokerStars Hand #169446478806: Tournament #1597684021, $18.20+$1.80 USD=
 Hold'em No Limit - Level XVI (600/1200) - 2017/05/05 21:43:23 ET
Table '1597684021 2' 9-max Seat #2 is the button
Seat 1: JJin91 (38706 in chips)=20
Seat 2: nwmdnj (32275 in chips)=20
Seat 3: A A 5454 (25238 in chips)=20
Seat 5: MM9955 (64714 in chips)=20
Seat 6: Mr Hero76 (34798 in chips)=20
Seat 7: MelzWay (20101 in chips)=20
Seat 8: akbongu1977 (17210 in chips)=20
Seat 9: hotcard08873 (31470 in chips)=20
JJin91: posts the ante 150
nwmdnj: posts the ante 150
A A 5454: posts the ante 150
MM9955: posts the ante 150
Mr Hero76: posts the ante 150
MelzWay: posts the ante 150
akbongu1977: posts the ante 150
hotcard08873: posts the ante 150
A A 5454: posts small blind 600
MM9955: posts big blind 1200
*** HOLE CARDS ***
Dealt to JJin91 [Ah 3d]
Mr Hero76: folds=20
MelzWay: calls 1200
akbongu1977: calls 1200
hotcard08873: folds=20
JJin91: folds=20
nwmdnj: folds=20
A A 5454: folds=20
MM9955: checks=20
*** FLOP *** [Jd 4s Js]
MM9955: checks=20
MelzWay: bets 1200
akbongu1977: calls 1200
MM9955: raises 1200 to 2400
MelzWay: folds=20
akbongu1977: calls 1200
*** TURN *** [Jd 4s Js] [9h]
MM9955: bets 5700
akbongu1977: folds=20
Uncalled bet (5700) returned to MM9955
MM9955 collected 11400 from pot
MM9955: doesn't show hand=20
*** SUMMARY ***
Total pot 11400 | Rake 0=20
Board [Jd 4s Js 9h]
Seat 1: JJin91 folded before Flop (didn't bet)
Seat 2: nwmdnj (button) folded before Flop (didn't bet)
Seat 3: A A 5454 (small blind) folded before Flop
Seat 5: MM9955 (big blind) collected (11400)
Seat 6: Mr Hero76 folded before Flop (didn't bet)
Seat 7: MelzWay folded on the Flop
Seat 8: akbongu1977 folded on the Turn
Seat 9: hotcard08873 folded before Flop (didn't bet)


*********** # 126 **************
PokerStars Hand #169446479114: Tournament #1597684021, $18.20+$1.80 USD=
 Hold'em No Limit - Level XVI (600/1200) - 2017/05/05 21:44:25 ET
Table '1597684021 2' 9-max Seat #3 is the button
Seat 1: JJin91 (38556 in chips)=20
Seat 3: A A 5454 (24488 in chips)=20
Seat 5: MM9955 (72364 in chips)=20
Seat 6: Mr Hero76 (34648 in chips)=20
Seat 7: MelzWay (17551 in chips)=20
Seat 8: akbongu1977 (13460 in chips)=20
Seat 9: hotcard08873 (31320 in chips)=20
JJin91: posts the ante 150
A A 5454: posts the ante 150
MM9955: posts the ante 150
Mr Hero76: posts the ante 150
MelzWay: posts the ante 150
akbongu1977: posts the ante 150
hotcard08873: posts the ante 150
MM9955: posts small blind 600
Mr Hero76: posts big blind 1200
*** HOLE CARDS ***
Dealt to JJin91 [7h Ad]
MelzWay: folds=20
akbongu1977: raises 12110 to 13310 and is all-in
hotcard08873: folds=20
JJin91: folds=20
A A 5454: folds=20
MM9955: folds=20
Mr Hero76: folds=20
Uncalled bet (12110) returned to akbongu1977
akbongu1977 collected 4050 from pot
akbongu1977: doesn't show hand=20
*** SUMMARY ***
Total pot 4050 | Rake 0=20
Seat 1: JJin91 folded before Flop (didn't bet)
Seat 3: A A 5454 (button) folded before Flop (didn't bet)
Seat 5: MM9955 (small blind) folded before Flop
Seat 6: Mr Hero76 (big blind) folded before Flop
Seat 7: MelzWay folded before Flop (didn't bet)
Seat 8: akbongu1977 collected (4050)
Seat 9: hotcard08873 folded before Flop (didn't bet)


*********** # 127 **************
PokerStars Hand #169446479239: Tournament #1597684021, $18.20+$1.80 USD=
 Hold'em No Limit - Level XVI (600/1200) - 2017/05/05 21:44:53 ET
Table '1597684021 2' 9-max Seat #5 is the button
Seat 1: JJin91 (38406 in chips)=20
Seat 3: A A 5454 (24338 in chips)=20
Seat 5: MM9955 (71614 in chips)=20
Seat 6: Mr Hero76 (33298 in chips)=20
Seat 7: MelzWay (17401 in chips)=20
Seat 8: akbongu1977 (16160 in chips)=20
Seat 9: hotcard08873 (31170 in chips)=20
JJin91: posts the ante 150
A A 5454: posts the ante 150
MM9955: posts the ante 150
Mr Hero76: posts the ante 150
MelzWay: posts the ante 150
akbongu1977: posts the ante 150
hotcard08873: posts the ante 150
Mr Hero76: posts small blind 600
MelzWay: posts big blind 1200
*** HOLE CARDS ***
Dealt to JJin91 [3h Ks]
akbongu1977: calls 1200
hotcard08873: folds=20
JJin91: folds=20
A A 5454: folds=20
MM9955: folds=20
Mr Hero76: folds=20
MelzWay: raises 2400 to 3600
akbongu1977: raises 12410 to 16010 and is all-in
MelzWay: calls 12410
*** FLOP *** [4s Td Kd]
*** TURN *** [4s Td Kd] [Ah]
*** RIVER *** [4s Td Kd Ah] [8s]
*** SHOW DOWN ***
MelzWay: shows [Ts 9s] (a pair of Tens)
akbongu1977: shows [4h 4d] (three of a kind, Fours)
akbongu1977 collected 33670 from pot
*** SUMMARY ***
Total pot 33670 | Rake 0=20
Board [4s Td Kd Ah 8s]
Seat 1: JJin91 folded before Flop (didn't bet)
Seat 3: A A 5454 folded before Flop (didn't bet)
Seat 5: MM9955 (button) folded before Flop (didn't bet)
Seat 6: Mr Hero76 (small blind) folded before Flop
Seat 7: MelzWay (big blind) showed [Ts 9s] and lost with a pair of Tens
Seat 8: akbongu1977 showed [4h 4d] and won (33670) with three of a kind=
, Fours
Seat 9: hotcard08873 folded before Flop (didn't bet)


*********** # 128 **************
PokerStars Hand #169446479489: Tournament #1597684021, $18.20+$1.80 USD=
 Hold'em No Limit - Level XVI (600/1200) - 2017/05/05 21:45:44 ET
Table '1597684021 2' 9-max Seat #6 is the button
Seat 1: JJin91 (38256 in chips)=20
Seat 3: A A 5454 (24188 in chips)=20
Seat 5: MM9955 (71464 in chips)=20
Seat 6: Mr Hero76 (32548 in chips)=20
Seat 7: MelzWay (1241 in chips)=20
Seat 8: akbongu1977 (33670 in chips)=20
Seat 9: hotcard08873 (31020 in chips)=20
JJin91: posts the ante 150
A A 5454: posts the ante 150
MM9955: posts the ante 150
Mr Hero76: posts the ante 150
MelzWay: posts the ante 150
akbongu1977: posts the ante 150
hotcard08873: posts the ante 150
MelzWay: posts small blind 600
akbongu1977: posts big blind 1200
*** HOLE CARDS ***
Dealt to JJin91 [7h 6s]
hotcard08873: folds=20
JJin91: folds=20
A A 5454: folds=20
MM9955: folds=20
Mr Hero76: raises 1200 to 2400
MelzWay: calls 491 and is all-in
akbongu1977: folds=20
Uncalled bet (1200) returned to Mr Hero76
*** FLOP *** [4s 8c 6c]
*** TURN *** [4s 8c 6c] [7s]
*** RIVER *** [4s 8c 6c 7s] [Jd]
*** SHOW DOWN ***
Mr Hero76: shows [5h 9s] (a straight, Five to Nine)
Mr Hero76 collected 218 from side pot
MelzWay: shows [6h Th] (a pair of Sixes)
Mr Hero76 collected 4323 from main pot
MelzWay finished the tournament in 27th place
*** SUMMARY ***
Total pot 4541 Main pot 4323. Side pot 218. | Rake 0=20
Board [4s 8c 6c 7s Jd]
Seat 1: JJin91 folded before Flop (didn't bet)
Seat 3: A A 5454 folded before Flop (didn't bet)
Seat 5: MM9955 folded before Flop (didn't bet)
Seat 6: Mr Hero76 (button) showed [5h 9s] and won (4541) with a straigh=
t, Five to Nine
Seat 7: MelzWay (small blind) showed [6h Th] and lost with a pair of Si=
xes
Seat 8: akbongu1977 (big blind) folded before Flop
Seat 9: hotcard08873 folded before Flop (didn't bet)


*********** # 129 **************
PokerStars Hand #169446479675: Tournament #1597684021, $18.20+$1.80 USD=
 Hold'em No Limit - Level XVI (600/1200) - 2017/05/05 21:46:22 ET
Table '1597684021 2' 9-max Seat #8 is the button
Seat 1: JJin91 (38106 in chips)=20
Seat 2: apoch19 (61311 in chips)=20
Seat 3: A A 5454 (24038 in chips)=20
Seat 4: jvurn (170952 in chips)=20
Seat 5: MM9955 (71314 in chips)=20
Seat 6: Mr Hero76 (35739 in chips)=20
Seat 8: akbongu1977 (32320 in chips)=20
Seat 9: hotcard08873 (30870 in chips)=20
JJin91: posts the ante 150
apoch19: posts the ante 150
A A 5454: posts the ante 150
jvurn: posts the ante 150
MM9955: posts the ante 150
Mr Hero76: posts the ante 150
akbongu1977: posts the ante 150
hotcard08873: posts the ante 150
hotcard08873: posts small blind 600
JJin91: posts big blind 1200
*** HOLE CARDS ***
Dealt to JJin91 [Qc 9h]
apoch19: folds=20
A A 5454: folds=20
jvurn: raises 1200 to 2400
MM9955: folds=20
Mr Hero76: calls 2400
akbongu1977: folds=20
hotcard08873: folds=20
JJin91: calls 1200
*** FLOP *** [5c Tc 4s]
JJin91: checks=20
jvurn: bets 8400
Mr Hero76: calls 8400
JJin91: folds=20
*** TURN *** [5c Tc 4s] [7h]
jvurn: checks=20
Mr Hero76: checks=20
*** RIVER *** [5c Tc 4s 7h] [Jd]
jvurn: bets 160002 and is all-in
Mr Hero76: folds=20
Uncalled bet (160002) returned to jvurn
jvurn collected 25800 from pot
jvurn: doesn't show hand=20
*** SUMMARY ***
Total pot 25800 | Rake 0=20
Board [5c Tc 4s 7h Jd]
Seat 1: JJin91 (big blind) folded on the Flop
Seat 2: apoch19 folded before Flop (didn't bet)
Seat 3: A A 5454 folded before Flop (didn't bet)
Seat 4: jvurn collected (25800)
Seat 5: MM9955 folded before Flop (didn't bet)
Seat 6: Mr Hero76 folded on the River
Seat 8: akbongu1977 (button) folded before Flop (didn't bet)
Seat 9: hotcard08873 (small blind) folded before Flop


*********** # 130 **************
PokerStars Hand #169446479954: Tournament #1597684021, $18.20+$1.80 USD=
 Hold'em No Limit - Level XVI (600/1200) - 2017/05/05 21:47:20 ET
Table '1597684021 2' 9-max Seat #9 is the button
Seat 1: JJin91 (35556 in chips)=20
Seat 2: apoch19 (61161 in chips)=20
Seat 3: A A 5454 (23888 in chips)=20
Seat 4: jvurn (185802 in chips)=20
Seat 5: MM9955 (71164 in chips)=20
Seat 6: Mr Hero76 (24789 in chips)=20
Seat 8: akbongu1977 (32170 in chips)=20
Seat 9: hotcard08873 (30120 in chips)=20
JJin91: posts the ante 150
apoch19: posts the ante 150
A A 5454: posts the ante 150
jvurn: posts the ante 150
MM9955: posts the ante 150
Mr Hero76: posts the ante 150
akbongu1977: posts the ante 150
hotcard08873: posts the ante 150
JJin91: posts small blind 600
apoch19: posts big blind 1200
*** HOLE CARDS ***
Dealt to JJin91 [7c 2h]
A A 5454: folds=20
jvurn: raises 1200 to 2400
MM9955: folds=20
Mr Hero76: folds=20
akbongu1977: folds=20
hotcard08873: folds=20
JJin91: folds=20
apoch19: folds=20
Uncalled bet (1200) returned to jvurn
jvurn collected 4200 from pot
jvurn: doesn't show hand=20
*** SUMMARY ***
Total pot 4200 | Rake 0=20
Seat 1: JJin91 (small blind) folded before Flop
Seat 2: apoch19 (big blind) folded before Flop
Seat 3: A A 5454 folded before Flop (didn't bet)
Seat 4: jvurn collected (4200)
Seat 5: MM9955 folded before Flop (didn't bet)
Seat 6: Mr Hero76 folded before Flop (didn't bet)
Seat 8: akbongu1977 folded before Flop (didn't bet)
Seat 9: hotcard08873 (button) folded before Flop (didn't bet)


*********** # 131 **************
PokerStars Hand #169448687489: Tournament #1597684021, $18.20+$1.80 USD=
 Hold'em No Limit - Level XVI (600/1200) - 2017/05/05 21:47:49 ET
Table '1597684021 2' 9-max Seat #1 is the button
Seat 1: JJin91 (34806 in chips)=20
Seat 2: apoch19 (59811 in chips)=20
Seat 3: A A 5454 (23738 in chips)=20
Seat 4: jvurn (188652 in chips)=20
Seat 5: MM9955 (71014 in chips)=20
Seat 6: Mr Hero76 (24639 in chips)=20
Seat 8: akbongu1977 (32020 in chips)=20
Seat 9: hotcard08873 (29970 in chips)=20
JJin91: posts the ante 150
apoch19: posts the ante 150
A A 5454: posts the ante 150
jvurn: posts the ante 150
MM9955: posts the ante 150
Mr Hero76: posts the ante 150
akbongu1977: posts the ante 150
hotcard08873: posts the ante 150
apoch19: posts small blind 600
A A 5454: posts big blind 1200
*** HOLE CARDS ***
Dealt to JJin91 [Qs Tc]
jvurn: folds=20
MM9955: raises 1200 to 2400
Mr Hero76: folds=20
akbongu1977: folds=20
hotcard08873: calls 2400
JJin91: folds=20
apoch19: folds=20
A A 5454: calls 1200
*** FLOP *** [4c 8c 6c]
A A 5454: checks=20
MM9955: checks=20
hotcard08873: bets 4500
A A 5454: calls 4500
MM9955: folds=20
*** TURN *** [4c 8c 6c] [Ac]
A A 5454: checks=20
hotcard08873: checks=20
*** RIVER *** [4c 8c 6c Ac] [Td]
A A 5454: checks=20
hotcard08873: checks=20
*** SHOW DOWN ***
A A 5454: shows [6d 6h] (three of a kind, Sixes)
hotcard08873: shows [Qc 9c] (a flush, Ace high)
hotcard08873 collected 18000 from pot
*** SUMMARY ***
Total pot 18000 | Rake 0=20
Board [4c 8c 6c Ac Td]
Seat 1: JJin91 (button) folded before Flop (didn't bet)
Seat 2: apoch19 (small blind) folded before Flop
Seat 3: A A 5454 (big blind) showed [6d 6h] and lost with three of a ki=
nd, Sixes
Seat 4: jvurn folded before Flop (didn't bet)
Seat 5: MM9955 folded on the Flop
Seat 6: Mr Hero76 folded before Flop (didn't bet)
Seat 8: akbongu1977 folded before Flop (didn't bet)
Seat 9: hotcard08873 showed [Qc 9c] and won (18000) with a flush, Ace h=
igh


*********** # 132 **************
PokerStars Hand #169448687757: Tournament #1597684021, $18.20+$1.80 USD=
 Hold'em No Limit - Level XVI (600/1200) - 2017/05/05 21:48:47 ET
Table '1597684021 2' 9-max Seat #2 is the button
Seat 1: JJin91 (34656 in chips)=20
Seat 2: apoch19 (59061 in chips)=20
Seat 3: A A 5454 (16688 in chips)=20
Seat 4: jvurn (188502 in chips)=20
Seat 5: MM9955 (68464 in chips)=20
Seat 6: Mr Hero76 (24489 in chips)=20
Seat 8: akbongu1977 (31870 in chips)=20
Seat 9: hotcard08873 (40920 in chips)=20
JJin91: posts the ante 150
apoch19: posts the ante 150
A A 5454: posts the ante 150
jvurn: posts the ante 150
MM9955: posts the ante 150
Mr Hero76: posts the ante 150
akbongu1977: posts the ante 150
hotcard08873: posts the ante 150
A A 5454: posts small blind 600
jvurn: posts big blind 1200
*** HOLE CARDS ***
Dealt to JJin91 [Kd Jh]
MM9955: calls 1200
Mr Hero76: raises 23139 to 24339 and is all-in
akbongu1977: folds=20
hotcard08873: folds=20
JJin91: folds=20
apoch19: folds=20
A A 5454: folds=20
jvurn: folds=20
MM9955: folds=20
Uncalled bet (23139) returned to Mr Hero76
Mr Hero76 collected 5400 from pot
Mr Hero76: doesn't show hand=20
*** SUMMARY ***
Total pot 5400 | Rake 0=20
Seat 1: JJin91 folded before Flop (didn't bet)
Seat 2: apoch19 (button) folded before Flop (didn't bet)
Seat 3: A A 5454 (small blind) folded before Flop
Seat 4: jvurn (big blind) folded before Flop
Seat 5: MM9955 folded before Flop
Seat 6: Mr Hero76 collected (5400)
Seat 8: akbongu1977 folded before Flop (didn't bet)
Seat 9: hotcard08873 folded before Flop (didn't bet)


*********** # 133 **************
PokerStars Hand #169448687925: Tournament #1597684021, $18.20+$1.80 USD=
 Hold'em No Limit - Level XVI (600/1200) - 2017/05/05 21:49:27 ET
Table '1597684021 2' 9-max Seat #3 is the button
Seat 1: JJin91 (34506 in chips)=20
Seat 2: apoch19 (58911 in chips)=20
Seat 3: A A 5454 (15938 in chips)=20
Seat 4: jvurn (187152 in chips)=20
Seat 5: MM9955 (67114 in chips)=20
Seat 6: Mr Hero76 (28539 in chips)=20
Seat 8: akbongu1977 (31720 in chips)=20
Seat 9: hotcard08873 (40770 in chips)=20
JJin91: posts the ante 150
apoch19: posts the ante 150
A A 5454: posts the ante 150
jvurn: posts the ante 150
MM9955: posts the ante 150
Mr Hero76: posts the ante 150
akbongu1977: posts the ante 150
hotcard08873: posts the ante 150
jvurn: posts small blind 600
MM9955: posts big blind 1200
*** HOLE CARDS ***
Dealt to JJin91 [2s 6d]
Mr Hero76: raises 1200 to 2400
akbongu1977: raises 29170 to 31570 and is all-in
hotcard08873: folds=20
JJin91: folds=20
apoch19: folds=20
A A 5454: folds=20
jvurn: folds=20
MM9955: calls 30370
Mr Hero76: folds=20
*** FLOP *** [Ks 4s 5s]
*** TURN *** [Ks 4s 5s] [7s]
*** RIVER *** [Ks 4s 5s 7s] [9h]
*** SHOW DOWN ***
MM9955: shows [Jh Js] (a flush, King high)
akbongu1977: shows [Kc Kd] (three of a kind, Kings)
MM9955 collected 67340 from pot
akbongu1977 finished the tournament in 24th place
*** SUMMARY ***
Total pot 67340 | Rake 0=20
Board [Ks 4s 5s 7s 9h]
Seat 1: JJin91 folded before Flop (didn't bet)
Seat 2: apoch19 folded before Flop (didn't bet)
Seat 3: A A 5454 (button) folded before Flop (didn't bet)
Seat 4: jvurn (small blind) folded before Flop
Seat 5: MM9955 (big blind) showed [Jh Js] and won (67340) with a flush,=
 King high
Seat 6: Mr Hero76 folded before Flop
Seat 8: akbongu1977 showed [Kc Kd] and lost with three of a kind, Kings
Seat 9: hotcard08873 folded before Flop (didn't bet)


*********** # 134 **************
PokerStars Hand #169448688170: Tournament #1597684021, $18.20+$1.80 USD=
 Hold'em No Limit - Level XVI (600/1200) - 2017/05/05 21:50:25 ET
Table '1597684021 2' 9-max Seat #4 is the button
Seat 1: JJin91 (34356 in chips)=20
Seat 2: apoch19 (58761 in chips)=20
Seat 3: A A 5454 (15788 in chips)=20
Seat 4: jvurn (186402 in chips)=20
Seat 5: MM9955 (102734 in chips)=20
Seat 6: Mr Hero76 (25989 in chips)=20
Seat 9: hotcard08873 (40620 in chips)=20
JJin91: posts the ante 150
apoch19: posts the ante 150
A A 5454: posts the ante 150
jvurn: posts the ante 150
MM9955: posts the ante 150
Mr Hero76: posts the ante 150
hotcard08873: posts the ante 150
MM9955: posts small blind 600
Mr Hero76: posts big blind 1200
*** HOLE CARDS ***
Dealt to JJin91 [9c Ks]
hotcard08873: folds=20
JJin91: folds=20
apoch19: raises 1640 to 2840
A A 5454: folds=20
jvurn: folds=20
MM9955: folds=20
Mr Hero76: calls 1640
*** FLOP *** [3d 5s Tc]
Mr Hero76: checks=20
apoch19: bets 2842
Mr Hero76: raises 2842 to 5684
apoch19: calls 2842
*** TURN *** [3d 5s Tc] [2c]
Mr Hero76: bets 17315 and is all-in
apoch19: calls 17315
*** RIVER *** [3d 5s Tc 2c] [9s]
*** SHOW DOWN ***
Mr Hero76: shows [Jh Ts] (a pair of Tens)
apoch19: shows [Ac Jc] (high card Ace)
Mr Hero76 collected 53328 from pot
*** SUMMARY ***
Total pot 53328 | Rake 0=20
Board [3d 5s Tc 2c 9s]
Seat 1: JJin91 folded before Flop (didn't bet)
Seat 2: apoch19 showed [Ac Jc] and lost with high card Ace
Seat 3: A A 5454 folded before Flop (didn't bet)
Seat 4: jvurn (button) folded before Flop (didn't bet)
Seat 5: MM9955 (small blind) folded before Flop
Seat 6: Mr Hero76 (big blind) showed [Jh Ts] and won (53328) with a pai=
r of Tens
Seat 9: hotcard08873 folded before Flop (didn't bet)


*********** # 135 **************
PokerStars Hand #169448688564: Tournament #1597684021, $18.20+$1.80 USD=
 Hold'em No Limit - Level XVI (600/1200) - 2017/05/05 21:52:01 ET
Table '1597684021 2' 9-max Seat #5 is the button
Seat 1: JJin91 (34206 in chips)=20
Seat 2: apoch19 (32772 in chips)=20
Seat 3: A A 5454 (15638 in chips)=20
Seat 4: jvurn (186252 in chips)=20
Seat 5: MM9955 (101984 in chips)=20
Seat 6: Mr Hero76 (53328 in chips)=20
Seat 9: hotcard08873 (40470 in chips)=20
JJin91: posts the ante 150
apoch19: posts the ante 150
A A 5454: posts the ante 150
jvurn: posts the ante 150
MM9955: posts the ante 150
Mr Hero76: posts the ante 150
hotcard08873: posts the ante 150
Mr Hero76: posts small blind 600
hotcard08873: posts big blind 1200
*** HOLE CARDS ***
Dealt to JJin91 [5h 8s]
JJin91: folds=20
apoch19: folds=20
A A 5454: folds=20
jvurn: folds=20
MM9955: raises 2400 to 3600
Mr Hero76: folds=20
hotcard08873: folds=20
Uncalled bet (2400) returned to MM9955
MM9955 collected 4050 from pot
MM9955: doesn't show hand=20
*** SUMMARY ***
Total pot 4050 | Rake 0=20
Seat 1: JJin91 folded before Flop (didn't bet)
Seat 2: apoch19 folded before Flop (didn't bet)
Seat 3: A A 5454 folded before Flop (didn't bet)
Seat 4: jvurn folded before Flop (didn't bet)
Seat 5: MM9955 (button) collected (4050)
Seat 6: Mr Hero76 (small blind) folded before Flop
Seat 9: hotcard08873 (big blind) folded before Flop


*********** # 136 **************
PokerStars Hand #169448688722: Tournament #1597684021, $18.20+$1.80 USD=
 Hold'em No Limit - Level XVI (600/1200) - 2017/05/05 21:52:38 ET
Table '1597684021 2' 9-max Seat #6 is the button
Seat 1: JJin91 (34056 in chips)=20
Seat 2: apoch19 (32622 in chips)=20
Seat 3: A A 5454 (15488 in chips)=20
Seat 4: jvurn (186102 in chips)=20
Seat 5: MM9955 (104684 in chips)=20
Seat 6: Mr Hero76 (52578 in chips)=20
Seat 9: hotcard08873 (39120 in chips)=20
JJin91: posts the ante 150
apoch19: posts the ante 150
A A 5454: posts the ante 150
jvurn: posts the ante 150
MM9955: posts the ante 150
Mr Hero76: posts the ante 150
hotcard08873: posts the ante 150
hotcard08873: posts small blind 600
JJin91: posts big blind 1200
*** HOLE CARDS ***
Dealt to JJin91 [4h 9c]
apoch19: folds=20
A A 5454: folds=20
jvurn: raises 1799 to 2999
MM9955: folds=20
Mr Hero76: folds=20
hotcard08873: folds=20
JJin91: folds=20
Uncalled bet (1799) returned to jvurn
jvurn collected 4050 from pot
jvurn: doesn't show hand=20
*** SUMMARY ***
Total pot 4050 | Rake 0=20
Seat 1: JJin91 (big blind) folded before Flop
Seat 2: apoch19 folded before Flop (didn't bet)
Seat 3: A A 5454 folded before Flop (didn't bet)
Seat 4: jvurn collected (4050)
Seat 5: MM9955 folded before Flop (didn't bet)
Seat 6: Mr Hero76 (button) folded before Flop (didn't bet)
Seat 9: hotcard08873 (small blind) folded before Flop


*********** # 137 **************
PokerStars Hand #169448688921: Tournament #1597684021, $18.20+$1.80 USD=
 Hold'em No Limit - Level XVII (700/1400) - 2017/05/05 21:53:25 ET
Table '1597684021 2' 9-max Seat #9 is the button
Seat 1: JJin91 (32706 in chips)=20
Seat 2: apoch19 (32472 in chips)=20
Seat 3: A A 5454 (15338 in chips)=20
Seat 4: jvurn (188802 in chips)=20
Seat 5: MM9955 (104534 in chips)=20
Seat 6: Mr Hero76 (52428 in chips)=20
Seat 9: hotcard08873 (38370 in chips)=20
JJin91: posts the ante 175
apoch19: posts the ante 175
A A 5454: posts the ante 175
jvurn: posts the ante 175
MM9955: posts the ante 175
Mr Hero76: posts the ante 175
hotcard08873: posts the ante 175
JJin91: posts small blind 700
apoch19: posts big blind 1400
*** HOLE CARDS ***
Dealt to JJin91 [2h 9c]
A A 5454: folds=20
jvurn: folds=20
MM9955: raises 2800 to 4200
Mr Hero76: folds=20
hotcard08873: folds=20
JJin91: folds=20
apoch19: folds=20
Uncalled bet (2800) returned to MM9955
MM9955 collected 4725 from pot
MM9955: doesn't show hand=20
*** SUMMARY ***
Total pot 4725 | Rake 0=20
Seat 1: JJin91 (small blind) folded before Flop
Seat 2: apoch19 (big blind) folded before Flop
Seat 3: A A 5454 folded before Flop (didn't bet)
Seat 4: jvurn folded before Flop (didn't bet)
Seat 5: MM9955 collected (4725)
Seat 6: Mr Hero76 folded before Flop (didn't bet)
Seat 9: hotcard08873 (button) folded before Flop (didn't bet)


*********** # 138 **************
PokerStars Hand #169448689084: Tournament #1597684021, $18.20+$1.80 USD=
 Hold'em No Limit - Level XVII (700/1400) - 2017/05/05 21:53:59 ET
Table '1597684021 2' 9-max Seat #1 is the button
Seat 1: JJin91 (31831 in chips)=20
Seat 2: apoch19 (30897 in chips)=20
Seat 3: A A 5454 (15163 in chips)=20
Seat 4: jvurn (188627 in chips)=20
Seat 5: MM9955 (107684 in chips)=20
Seat 6: Mr Hero76 (52253 in chips)=20
Seat 9: hotcard08873 (38195 in chips)=20
JJin91: posts the ante 175
apoch19: posts the ante 175
A A 5454: posts the ante 175
jvurn: posts the ante 175
MM9955: posts the ante 175
Mr Hero76: posts the ante 175
hotcard08873: posts the ante 175
apoch19: posts small blind 700
A A 5454: posts big blind 1400
*** HOLE CARDS ***
Dealt to JJin91 [6h Td]
jvurn: folds=20
MM9955: folds=20
Mr Hero76: folds=20
hotcard08873: folds=20
JJin91: folds=20
apoch19: raises 29322 to 30722 and is all-in
A A 5454: folds=20
Uncalled bet (29322) returned to apoch19
apoch19 collected 4025 from pot
apoch19: doesn't show hand=20
*** SUMMARY ***
Total pot 4025 | Rake 0=20
Seat 1: JJin91 (button) folded before Flop (didn't bet)
Seat 2: apoch19 (small blind) collected (4025)
Seat 3: A A 5454 (big blind) folded before Flop
Seat 4: jvurn folded before Flop (didn't bet)
Seat 5: MM9955 folded before Flop (didn't bet)
Seat 6: Mr Hero76 folded before Flop (didn't bet)
Seat 9: hotcard08873 folded before Flop (didn't bet)


*********** # 139 **************
PokerStars Hand #169448689267: Tournament #1597684021, $18.20+$1.80 USD=
 Hold'em No Limit - Level XVII (700/1400) - 2017/05/05 21:54:41 ET
Table '1597684021 2' 9-max Seat #2 is the button
Seat 1: JJin91 (31656 in chips)=20
Seat 2: apoch19 (33347 in chips)=20
Seat 3: A A 5454 (13588 in chips)=20
Seat 4: jvurn (188452 in chips)=20
Seat 5: MM9955 (107509 in chips)=20
Seat 6: Mr Hero76 (52078 in chips)=20
Seat 9: hotcard08873 (38020 in chips)=20
JJin91: posts the ante 175
apoch19: posts the ante 175
A A 5454: posts the ante 175
jvurn: posts the ante 175
MM9955: posts the ante 175
Mr Hero76: posts the ante 175
hotcard08873: posts the ante 175
A A 5454: posts small blind 700
jvurn: posts big blind 1400
*** HOLE CARDS ***
Dealt to JJin91 [5d 2h]
MM9955: folds=20
Mr Hero76: folds=20
hotcard08873: folds=20
JJin91: folds=20
apoch19: folds=20
A A 5454: folds=20
Uncalled bet (700) returned to jvurn
jvurn collected 2625 from pot
jvurn: doesn't show hand=20
*** SUMMARY ***
Total pot 2625 | Rake 0=20
Seat 1: JJin91 folded before Flop (didn't bet)
Seat 2: apoch19 (button) folded before Flop (didn't bet)
Seat 3: A A 5454 (small blind) folded before Flop
Seat 4: jvurn (big blind) collected (2625)
Seat 5: MM9955 folded before Flop (didn't bet)
Seat 6: Mr Hero76 folded before Flop (didn't bet)
Seat 9: hotcard08873 folded before Flop (didn't bet)


*********** # 140 **************
PokerStars Hand #169449658889: Tournament #1597684021, $18.20+$1.80 USD=
 Hold'em No Limit - Level XVII (700/1400) - 2017/05/05 22:00:25 ET
Table '1597684021 2' 9-max Seat #3 is the button
Seat 1: JJin91 (31481 in chips)=20
Seat 2: apoch19 (33172 in chips)=20
Seat 3: A A 5454 (12713 in chips)=20
Seat 4: jvurn (190202 in chips)=20
Seat 5: MM9955 (107334 in chips)=20
Seat 6: Mr Hero76 (51903 in chips)=20
Seat 9: hotcard08873 (37845 in chips)=20
JJin91: posts the ante 175
apoch19: posts the ante 175
A A 5454: posts the ante 175
jvurn: posts the ante 175
MM9955: posts the ante 175
Mr Hero76: posts the ante 175
hotcard08873: posts the ante 175
jvurn: posts small blind 700
MM9955: posts big blind 1400
*** HOLE CARDS ***
Dealt to JJin91 [3c 7d]
Mr Hero76: folds=20
hotcard08873: folds=20
JJin91: folds=20
apoch19: raises 2142 to 3542
A A 5454: folds=20
jvurn has timed out while disconnected
jvurn: folds=20
jvurn is sitting out
MM9955: calls 2142
*** FLOP *** [9c 8s 6c]
MM9955: bets 4505
apoch19: calls 4505
*** TURN *** [9c 8s 6c] [As]
jvurn has returned
MM9955: checks=20
apoch19: bets 24950 and is all-in
MM9955: folds=20
Uncalled bet (24950) returned to apoch19
apoch19 collected 18019 from pot
apoch19: doesn't show hand=20
*** SUMMARY ***
Total pot 18019 | Rake 0=20
Board [9c 8s 6c As]
Seat 1: JJin91 folded before Flop (didn't bet)
Seat 2: apoch19 collected (18019)
Seat 3: A A 5454 (button) folded before Flop (didn't bet)
Seat 4: jvurn (small blind) folded before Flop
Seat 5: MM9955 (big blind) folded on the Turn
Seat 6: Mr Hero76 folded before Flop (didn't bet)
Seat 9: hotcard08873 folded before Flop (didn't bet)


*********** # 141 **************
PokerStars Hand #169449659261: Tournament #1597684021, $18.20+$1.80 USD=
 Hold'em No Limit - Level XVII (700/1400) - 2017/05/05 22:01:58 ET
Table '1597684021 2' 9-max Seat #4 is the button
Seat 1: JJin91 (31306 in chips)=20
Seat 2: apoch19 (42969 in chips)=20
Seat 3: A A 5454 (12538 in chips)=20
Seat 4: jvurn (189327 in chips)=20
Seat 5: MM9955 (99112 in chips)=20
Seat 6: Mr Hero76 (51728 in chips)=20
Seat 9: hotcard08873 (37670 in chips)=20
JJin91: posts the ante 175
apoch19: posts the ante 175
A A 5454: posts the ante 175
jvurn: posts the ante 175
MM9955: posts the ante 175
Mr Hero76: posts the ante 175
hotcard08873: posts the ante 175
MM9955: posts small blind 700
Mr Hero76: posts big blind 1400
*** HOLE CARDS ***
Dealt to JJin91 [Td Ad]
hotcard08873: folds=20
JJin91: raises 1666 to 3066
apoch19: raises 6756 to 9822
A A 5454: folds=20
jvurn: folds=20
MM9955: folds=20
Mr Hero76: folds=20
JJin91: calls 6756
*** FLOP *** [6s 6d 2c]
JJin91: checks=20
apoch19: bets 32972 and is all-in
JJin91: folds=20
Uncalled bet (32972) returned to apoch19
apoch19 collected 22969 from pot
apoch19: doesn't show hand=20
*** SUMMARY ***
Total pot 22969 | Rake 0=20
Board [6s 6d 2c]
Seat 1: JJin91 folded on the Flop
Seat 2: apoch19 collected (22969)
Seat 3: A A 5454 folded before Flop (didn't bet)
Seat 4: jvurn (button) folded before Flop (didn't bet)
Seat 5: MM9955 (small blind) folded before Flop
Seat 6: Mr Hero76 (big blind) folded before Flop
Seat 9: hotcard08873 folded before Flop (didn't bet)


*********** # 142 **************
PokerStars Hand #169449659596: Tournament #1597684021, $18.20+$1.80 USD=
 Hold'em No Limit - Level XVII (700/1400) - 2017/05/05 22:03:15 ET
Table '1597684021 2' 9-max Seat #5 is the button
Seat 1: JJin91 (21309 in chips)=20
Seat 2: apoch19 (55941 in chips)=20
Seat 3: A A 5454 (12363 in chips)=20
Seat 4: jvurn (189152 in chips)=20
Seat 5: MM9955 (98237 in chips)=20
Seat 6: Mr Hero76 (50153 in chips)=20
Seat 9: hotcard08873 (37495 in chips)=20
JJin91: posts the ante 175
apoch19: posts the ante 175
A A 5454: posts the ante 175
jvurn: posts the ante 175
MM9955: posts the ante 175
Mr Hero76: posts the ante 175
hotcard08873: posts the ante 175
Mr Hero76: posts small blind 700
hotcard08873: posts big blind 1400
*** HOLE CARDS ***
Dealt to JJin91 [7h 5d]
JJin91: folds=20
apoch19: folds=20
A A 5454: folds=20
jvurn: calls 1400
MM9955 is disconnected=20
MM9955 has timed out while disconnected
MM9955: folds=20
MM9955 is sitting out
Mr Hero76: folds=20
MM9955 has returned
hotcard08873: checks=20
*** FLOP *** [7s 4d Kd]
hotcard08873: checks=20
jvurn: checks=20
*** TURN *** [7s 4d Kd] [Ac]
hotcard08873: checks=20
jvurn: bets 2800
hotcard08873: folds=20
Uncalled bet (2800) returned to jvurn
jvurn collected 4725 from pot
jvurn: doesn't show hand=20
*** SUMMARY ***
Total pot 4725 | Rake 0=20
Board [7s 4d Kd Ac]
Seat 1: JJin91 folded before Flop (didn't bet)
Seat 2: apoch19 folded before Flop (didn't bet)
Seat 3: A A 5454 folded before Flop (didn't bet)
Seat 4: jvurn collected (4725)
Seat 5: MM9955 (button) folded before Flop (didn't bet)
Seat 6: Mr Hero76 (small blind) folded before Flop
Seat 9: hotcard08873 (big blind) folded on the Turn


*********** # 143 **************
PokerStars Hand #169450258520: Tournament #1597684021, $18.20+$1.80 USD=
 Hold'em No Limit - Level XVII (700/1400) - 2017/05/05 22:04:51 ET
Table '1597684021 2' 9-max Seat #6 is the button
Seat 1: JJin91 (21134 in chips)=20
Seat 2: apoch19 (55766 in chips)=20
Seat 3: A A 5454 (12188 in chips)=20
Seat 4: jvurn (192302 in chips)=20
Seat 5: MM9955 (98062 in chips)=20
Seat 6: Mr Hero76 (49278 in chips)=20
Seat 9: hotcard08873 (35920 in chips)=20
JJin91: posts the ante 175
apoch19: posts the ante 175
A A 5454: posts the ante 175
jvurn: posts the ante 175
MM9955: posts the ante 175
Mr Hero76: posts the ante 175
hotcard08873: posts the ante 175
hotcard08873: posts small blind 700
JJin91: posts big blind 1400
*** HOLE CARDS ***
Dealt to JJin91 [As Jc]
apoch19: folds=20
A A 5454: folds=20
jvurn has timed out
jvurn: folds=20
jvurn is sitting out
MM9955: folds=20
Mr Hero76: raises 2800 to 4200
hotcard08873: folds=20
JJin91: raises 16759 to 20959 and is all-in
Mr Hero76: folds=20
Uncalled bet (16759) returned to JJin91
JJin91 collected 10325 from pot
JJin91: doesn't show hand=20
*** SUMMARY ***
Total pot 10325 | Rake 0=20
Seat 1: JJin91 (big blind) collected (10325)
Seat 2: apoch19 folded before Flop (didn't bet)
Seat 3: A A 5454 folded before Flop (didn't bet)
Seat 4: jvurn folded before Flop (didn't bet)
Seat 5: MM9955 folded before Flop (didn't bet)
Seat 6: Mr Hero76 (button) folded before Flop
Seat 9: hotcard08873 (small blind) folded before Flop


*********** # 144 **************
PokerStars Hand #169450258916: Tournament #1597684021, $18.20+$1.80 USD=
 Hold'em No Limit - Level XVII (700/1400) - 2017/05/05 22:06:19 ET
Table '1597684021 2' 9-max Seat #9 is the button
Seat 1: JJin91 (27084 in chips)=20
Seat 2: apoch19 (55591 in chips)=20
Seat 3: A A 5454 (12013 in chips)=20
Seat 4: jvurn (192127 in chips) is sitting out
Seat 5: MM9955 (97887 in chips)=20
Seat 6: Mr Hero76 (44903 in chips)=20
Seat 9: hotcard08873 (35045 in chips)=20
JJin91: posts the ante 175
apoch19: posts the ante 175
A A 5454: posts the ante 175
jvurn: posts the ante 175
MM9955: posts the ante 175
Mr Hero76: posts the ante 175
hotcard08873: posts the ante 175
JJin91: posts small blind 700
apoch19: posts big blind 1400
*** HOLE CARDS ***
Dealt to JJin91 [Jd 8s]
A A 5454: folds=20
jvurn: folds=20
MM9955: folds=20
Mr Hero76: folds=20
hotcard08873: folds=20
JJin91: raises 1400 to 2800
apoch19: folds=20
Uncalled bet (1400) returned to JJin91
JJin91 collected 4025 from pot
JJin91: doesn't show hand=20
*** SUMMARY ***
Total pot 4025 | Rake 0=20
Seat 1: JJin91 (small blind) collected (4025)
Seat 2: apoch19 (big blind) folded before Flop
Seat 3: A A 5454 folded before Flop (didn't bet)
Seat 4: jvurn folded before Flop (didn't bet)
Seat 5: MM9955 folded before Flop (didn't bet)
Seat 6: Mr Hero76 folded before Flop (didn't bet)
Seat 9: hotcard08873 (button) folded before Flop (didn't bet)


*********** # 145 **************
PokerStars Hand #169450259122: Tournament #1597684021, $18.20+$1.80 USD=
 Hold'em No Limit - Level XVII (700/1400) - 2017/05/05 22:07:12 ET
Table '1597684021 2' 9-max Seat #1 is the button
Seat 1: JJin91 (29534 in chips)=20
Seat 2: apoch19 (54016 in chips)=20
Seat 3: A A 5454 (11838 in chips)=20
Seat 4: jvurn (191952 in chips) is sitting out
Seat 5: MM9955 (97712 in chips)=20
Seat 6: Mr Hero76 (44728 in chips)=20
Seat 9: hotcard08873 (34870 in chips)=20
JJin91: posts the ante 175
apoch19: posts the ante 175
A A 5454: posts the ante 175
jvurn: posts the ante 175
MM9955: posts the ante 175
Mr Hero76: posts the ante 175
hotcard08873: posts the ante 175
apoch19: posts small blind 700
A A 5454: posts big blind 1400
*** HOLE CARDS ***
Dealt to JJin91 [Ad 6s]
jvurn: folds=20
MM9955: folds=20
Mr Hero76: folds=20
hotcard08873: folds=20
JJin91: raises 2254 to 3654
apoch19: raises 50187 to 53841 and is all-in
A A 5454: folds=20
JJin91: folds=20
Uncalled bet (50187) returned to apoch19
apoch19 collected 9933 from pot
apoch19: doesn't show hand=20
*** SUMMARY ***
Total pot 9933 | Rake 0=20
Seat 1: JJin91 (button) folded before Flop
Seat 2: apoch19 (small blind) collected (9933)
Seat 3: A A 5454 (big blind) folded before Flop
Seat 4: jvurn folded before Flop (didn't bet)
Seat 5: MM9955 folded before Flop (didn't bet)
Seat 6: Mr Hero76 folded before Flop (didn't bet)
Seat 9: hotcard08873 folded before Flop (didn't bet)


*********** # 146 **************
PokerStars Hand #169450259385: Tournament #1597684021, $18.20+$1.80 USD=
 Hold'em No Limit - Level XVIII (800/1600) - 2017/05/05 22:08:14 ET
Table '1597684021 2' 9-max Seat #2 is the button
Seat 1: JJin91 (25705 in chips)=20
Seat 2: apoch19 (60120 in chips)=20
Seat 3: A A 5454 (10263 in chips)=20
Seat 4: jvurn (191777 in chips) is sitting out
Seat 5: MM9955 (97537 in chips)=20
Seat 6: Mr Hero76 (44553 in chips)=20
Seat 9: hotcard08873 (34695 in chips)=20
JJin91: posts the ante 200
apoch19: posts the ante 200
A A 5454: posts the ante 200
jvurn: posts the ante 200
MM9955: posts the ante 200
Mr Hero76: posts the ante 200
hotcard08873: posts the ante 200
A A 5454: posts small blind 800
jvurn: posts big blind 1600
*** HOLE CARDS ***
Dealt to JJin91 [7h 4d]
MM9955: folds=20
Mr Hero76: folds=20
hotcard08873: raises 2400 to 4000
JJin91: folds=20
apoch19: folds=20
A A 5454: folds=20
jvurn: folds=20
Uncalled bet (2400) returned to hotcard08873
hotcard08873 collected 5400 from pot
hotcard08873: doesn't show hand=20
*** SUMMARY ***
Total pot 5400 | Rake 0=20
Seat 1: JJin91 folded before Flop (didn't bet)
Seat 2: apoch19 (button) folded before Flop (didn't bet)
Seat 3: A A 5454 (small blind) folded before Flop
Seat 4: jvurn (big blind) folded before Flop
Seat 5: MM9955 folded before Flop (didn't bet)
Seat 6: Mr Hero76 folded before Flop (didn't bet)
Seat 9: hotcard08873 collected (5400)


*********** # 147 **************
PokerStars Hand #169450259481: Tournament #1597684021, $18.20+$1.80 USD=
 Hold'em No Limit - Level XVIII (800/1600) - 2017/05/05 22:08:40 ET
Table '1597684021 2' 9-max Seat #3 is the button
Seat 1: JJin91 (25505 in chips)=20
Seat 2: apoch19 (59920 in chips)=20
Seat 3: A A 5454 (9263 in chips)=20
Seat 4: jvurn (189977 in chips) is sitting out
Seat 5: MM9955 (97337 in chips)=20
Seat 6: Mr Hero76 (44353 in chips)=20
Seat 9: hotcard08873 (38295 in chips)=20
JJin91: posts the ante 200
apoch19: posts the ante 200
A A 5454: posts the ante 200
jvurn: posts the ante 200
MM9955: posts the ante 200
Mr Hero76: posts the ante 200
hotcard08873: posts the ante 200
jvurn: posts small blind 800
MM9955: posts big blind 1600
*** HOLE CARDS ***
Dealt to JJin91 [6d 7s]
Mr Hero76: folds=20
jvurn has returned
hotcard08873: folds=20
JJin91: folds=20
apoch19: folds=20
A A 5454: folds=20
jvurn: raises 1600 to 3200
MM9955: calls 1600
*** FLOP *** [As 5d Js]
jvurn: checks=20
MM9955: checks=20
*** TURN *** [As 5d Js] [Qh]
jvurn: checks=20
MM9955: checks=20
*** RIVER *** [As 5d Js Qh] [Jc]
jvurn: bets 8000
MM9955: folds=20
Uncalled bet (8000) returned to jvurn
jvurn collected 7800 from pot
jvurn: doesn't show hand=20
*** SUMMARY ***
Total pot 7800 | Rake 0=20
Board [As 5d Js Qh Jc]
Seat 1: JJin91 folded before Flop (didn't bet)
Seat 2: apoch19 folded before Flop (didn't bet)
Seat 3: A A 5454 (button) folded before Flop (didn't bet)
Seat 4: jvurn (small blind) collected (7800)
Seat 5: MM9955 (big blind) folded on the River
Seat 6: Mr Hero76 folded before Flop (didn't bet)
Seat 9: hotcard08873 folded before Flop (didn't bet)


*********** # 148 **************
PokerStars Hand #169450259805: Tournament #1597684021, $18.20+$1.80 USD=
 Hold'em No Limit - Level XVIII (800/1600) - 2017/05/05 22:09:51 ET
Table '1597684021 2' 9-max Seat #4 is the button
Seat 1: JJin91 (25305 in chips)=20
Seat 2: apoch19 (59720 in chips)=20
Seat 3: A A 5454 (9063 in chips)=20
Seat 4: jvurn (194377 in chips)=20
Seat 5: MM9955 (93937 in chips)=20
Seat 6: Mr Hero76 (44153 in chips)=20
Seat 9: hotcard08873 (38095 in chips)=20
JJin91: posts the ante 200
apoch19: posts the ante 200
A A 5454: posts the ante 200
jvurn: posts the ante 200
MM9955: posts the ante 200
Mr Hero76: posts the ante 200
hotcard08873: posts the ante 200
MM9955: posts small blind 800
Mr Hero76: posts big blind 1600
*** HOLE CARDS ***
Dealt to JJin91 [8d 2h]
hotcard08873: folds=20
JJin91: folds=20
apoch19: folds=20
A A 5454: folds=20
jvurn: folds=20
MM9955: raises 1600 to 3200
Mr Hero76: folds=20
Uncalled bet (1600) returned to MM9955
MM9955 collected 4600 from pot
MM9955: doesn't show hand=20
*** SUMMARY ***
Total pot 4600 | Rake 0=20
Seat 1: JJin91 folded before Flop (didn't bet)
Seat 2: apoch19 folded before Flop (didn't bet)
Seat 3: A A 5454 folded before Flop (didn't bet)
Seat 4: jvurn (button) folded before Flop (didn't bet)
Seat 5: MM9955 (small blind) collected (4600)
Seat 6: Mr Hero76 (big blind) folded before Flop
Seat 9: hotcard08873 folded before Flop (didn't bet)


*********** # 149 **************
PokerStars Hand #169450805617: Tournament #1597684021, $18.20+$1.80 USD=
 Hold'em No Limit - Level XVIII (800/1600) - 2017/05/05 22:10:38 ET
Table '1597684021 2' 9-max Seat #5 is the button
Seat 1: JJin91 (25105 in chips)=20
Seat 2: apoch19 (59520 in chips)=20
Seat 3: A A 5454 (8863 in chips)=20
Seat 4: jvurn (194177 in chips)=20
Seat 5: MM9955 (96737 in chips)=20
Seat 6: Mr Hero76 (42353 in chips)=20
Seat 9: hotcard08873 (37895 in chips)=20
JJin91: posts the ante 200
apoch19: posts the ante 200
A A 5454: posts the ante 200
jvurn: posts the ante 200
MM9955: posts the ante 200
Mr Hero76: posts the ante 200
hotcard08873: posts the ante 200
Mr Hero76: posts small blind 800
hotcard08873: posts big blind 1600
*** HOLE CARDS ***
Dealt to JJin91 [Jc Kh]
JJin91: folds=20
apoch19: folds=20
A A 5454: folds=20
jvurn: folds=20
MM9955: raises 1600 to 3200
Mr Hero76: calls 2400
hotcard08873: folds=20
*** FLOP *** [9c Ac Ks]
Mr Hero76: checks=20
MM9955: checks=20
*** TURN *** [9c Ac Ks] [Qs]
Mr Hero76: bets 4700
MM9955: calls 4700
*** RIVER *** [9c Ac Ks Qs] [6h]
Mr Hero76: checks=20
MM9955: checks=20
*** SHOW DOWN ***
Mr Hero76: shows [Td Kd] (a pair of Kings)
MM9955: mucks hand=20
Mr Hero76 collected 18800 from pot
*** SUMMARY ***
Total pot 18800 | Rake 0=20
Board [9c Ac Ks Qs 6h]
Seat 1: JJin91 folded before Flop (didn't bet)
Seat 2: apoch19 folded before Flop (didn't bet)
Seat 3: A A 5454 folded before Flop (didn't bet)
Seat 4: jvurn folded before Flop (didn't bet)
Seat 5: MM9955 (button) mucked [Js 8s]
Seat 6: Mr Hero76 (small blind) showed [Td Kd] and won (18800) with a p=
air of Kings
Seat 9: hotcard08873 (big blind) folded before Flop


*********** # 150 **************
PokerStars Hand #169450805925: Tournament #1597684021, $18.20+$1.80 USD=
 Hold'em No Limit - Level XVIII (800/1600) - 2017/05/05 22:11:50 ET
Table '1597684021 2' 9-max Seat #6 is the button
Seat 1: JJin91 (24905 in chips)=20
Seat 2: apoch19 (59320 in chips)=20
Seat 3: A A 5454 (8663 in chips)=20
Seat 4: jvurn (193977 in chips)=20
Seat 5: MM9955 (88637 in chips)=20
Seat 6: Mr Hero76 (53053 in chips)=20
Seat 9: hotcard08873 (36095 in chips)=20
JJin91: posts the ante 200
apoch19: posts the ante 200
A A 5454: posts the ante 200
jvurn: posts the ante 200
MM9955: posts the ante 200
Mr Hero76: posts the ante 200
hotcard08873: posts the ante 200
hotcard08873: posts small blind 800
JJin91: posts big blind 1600
*** HOLE CARDS ***
Dealt to JJin91 [Jh 4h]
apoch19: folds=20
A A 5454: folds=20
jvurn: folds=20
MM9955: folds=20
Mr Hero76: folds=20
hotcard08873: raises 3200 to 4800
JJin91: folds=20
Uncalled bet (3200) returned to hotcard08873
hotcard08873 collected 4600 from pot
hotcard08873: doesn't show hand=20
*** SUMMARY ***
Total pot 4600 | Rake 0=20
Seat 1: JJin91 (big blind) folded before Flop
Seat 2: apoch19 folded before Flop (didn't bet)
Seat 3: A A 5454 folded before Flop (didn't bet)
Seat 4: jvurn folded before Flop (didn't bet)
Seat 5: MM9955 folded before Flop (didn't bet)
Seat 6: Mr Hero76 (button) folded before Flop (didn't bet)
Seat 9: hotcard08873 (small blind) collected (4600)


*********** # 151 **************
PokerStars Hand #169450806088: Tournament #1597684021, $18.20+$1.80 USD=
 Hold'em No Limit - Level XVIII (800/1600) - 2017/05/05 22:12:26 ET
Table '1597684021 2' 9-max Seat #9 is the button
Seat 1: JJin91 (23105 in chips)=20
Seat 2: apoch19 (59120 in chips)=20
Seat 3: A A 5454 (8463 in chips)=20
Seat 4: jvurn (193777 in chips)=20
Seat 5: MM9955 (88437 in chips)=20
Seat 6: Mr Hero76 (52853 in chips)=20
Seat 9: hotcard08873 (38895 in chips)=20
JJin91: posts the ante 200
apoch19: posts the ante 200
A A 5454: posts the ante 200
jvurn: posts the ante 200
MM9955: posts the ante 200
Mr Hero76: posts the ante 200
hotcard08873: posts the ante 200
JJin91: posts small blind 800
apoch19: posts big blind 1600
*** HOLE CARDS ***
Dealt to JJin91 [Kc Kd]
A A 5454: folds=20
jvurn: folds=20
MM9955: folds=20
Mr Hero76: folds=20
hotcard08873: folds=20
JJin91: raises 1904 to 3504
apoch19: calls 1904
*** FLOP *** [Qc 8s 7h]
JJin91: checks=20
apoch19: bets 3642
JJin91: calls 3642
*** TURN *** [Qc 8s 7h] [Kh]
JJin91: checks=20
apoch19: checks=20
*** RIVER *** [Qc 8s 7h Kh] [8h]
JJin91: checks=20
apoch19: bets 12422
JJin91: raises 3337 to 15759 and is all-in
apoch19: folds=20
Uncalled bet (3337) returned to JJin91
JJin91 collected 40536 from pot
JJin91: doesn't show hand=20
*** SUMMARY ***
Total pot 40536 | Rake 0=20
Board [Qc 8s 7h Kh 8h]
Seat 1: JJin91 (small blind) collected (40536)
Seat 2: apoch19 (big blind) folded on the River
Seat 3: A A 5454 folded before Flop (didn't bet)
Seat 4: jvurn folded before Flop (didn't bet)
Seat 5: MM9955 folded before Flop (didn't bet)
Seat 6: Mr Hero76 folded before Flop (didn't bet)
Seat 9: hotcard08873 (button) folded before Flop (didn't bet)


*********** # 152 **************
PokerStars Hand #169450806574: Tournament #1597684021, $18.20+$1.80 USD=
 Hold'em No Limit - Level XVIII (800/1600) - 2017/05/05 22:14:12 ET
Table '1597684021 2' 9-max Seat #1 is the button
Seat 1: JJin91 (43873 in chips)=20
Seat 2: apoch19 (39352 in chips)=20
Seat 3: A A 5454 (8263 in chips)=20
Seat 4: jvurn (193577 in chips)=20
Seat 5: MM9955 (88237 in chips)=20
Seat 6: Mr Hero76 (52653 in chips)=20
Seat 9: hotcard08873 (38695 in chips)=20
JJin91: posts the ante 200
apoch19: posts the ante 200
A A 5454: posts the ante 200
jvurn: posts the ante 200
MM9955: posts the ante 200
Mr Hero76: posts the ante 200
hotcard08873: posts the ante 200
apoch19: posts small blind 800
A A 5454: posts big blind 1600
*** HOLE CARDS ***
Dealt to JJin91 [5c 3c]
jvurn: folds=20
MM9955: calls 1600
Mr Hero76: raises 3200 to 4800
hotcard08873: folds=20
JJin91: folds=20
apoch19: folds=20
A A 5454: folds=20
MM9955: calls 3200
*** FLOP *** [2d Kh Td]
MM9955: checks=20
Mr Hero76: bets 6700
MM9955: folds=20
Uncalled bet (6700) returned to Mr Hero76
Mr Hero76 collected 13400 from pot
Mr Hero76: doesn't show hand=20
*** SUMMARY ***
Total pot 13400 | Rake 0=20
Board [2d Kh Td]
Seat 1: JJin91 (button) folded before Flop (didn't bet)
Seat 2: apoch19 (small blind) folded before Flop
Seat 3: A A 5454 (big blind) folded before Flop
Seat 4: jvurn folded before Flop (didn't bet)
Seat 5: MM9955 folded on the Flop
Seat 6: Mr Hero76 collected (13400)
Seat 9: hotcard08873 folded before Flop (didn't bet)


*********** # 153 **************
PokerStars Hand #169450806955: Tournament #1597684021, $18.20+$1.80 USD=
 Hold'em No Limit - Level XVIII (800/1600) - 2017/05/05 22:15:32 ET
Table '1597684021 2' 9-max Seat #2 is the button
Seat 1: JJin91 (43673 in chips)=20
Seat 2: apoch19 (38352 in chips)=20
Seat 3: A A 5454 (6463 in chips)=20
Seat 4: jvurn (193377 in chips)=20
Seat 5: MM9955 (83237 in chips)=20
Seat 6: Mr Hero76 (61053 in chips)=20
Seat 9: hotcard08873 (38495 in chips)=20
JJin91: posts the ante 200
apoch19: posts the ante 200
A A 5454: posts the ante 200
jvurn: posts the ante 200
MM9955: posts the ante 200
Mr Hero76: posts the ante 200
hotcard08873: posts the ante 200
A A 5454: posts small blind 800
jvurn: posts big blind 1600
*** HOLE CARDS ***
Dealt to JJin91 [8h 4d]
MM9955: folds=20
Mr Hero76: folds=20
hotcard08873: raises 2000 to 3600
JJin91: folds=20
apoch19: folds=20
A A 5454: raises 2663 to 6263 and is all-in
jvurn has timed out
jvurn: folds=20
jvurn is sitting out
hotcard08873: calls 2663
*** FLOP *** [7h Qh Td]
*** TURN *** [7h Qh Td] [7s]
*** RIVER *** [7h Qh Td 7s] [Jd]
*** SHOW DOWN ***
A A 5454: shows [Kd As] (a straight, Ten to Ace)
hotcard08873: shows [Ac 7c] (three of a kind, Sevens)
A A 5454 collected 15526 from pot
*** SUMMARY ***
Total pot 15526 | Rake 0=20
Board [7h Qh Td 7s Jd]
Seat 1: JJin91 folded before Flop (didn't bet)
Seat 2: apoch19 (button) folded before Flop (didn't bet)
Seat 3: A A 5454 (small blind) showed [Kd As] and won (15526) with a st=
raight, Ten to Ace
Seat 4: jvurn (big blind) folded before Flop
Seat 5: MM9955 folded before Flop (didn't bet)
Seat 6: Mr Hero76 folded before Flop (didn't bet)
Seat 9: hotcard08873 showed [Ac 7c] and lost with three of a kind, Seve=
ns


*********** # 154 **************
PokerStars Hand #169450807304: Tournament #1597684021, $18.20+$1.80 USD=
 Hold'em No Limit - Level XVIII (800/1600) - 2017/05/05 22:16:45 ET
Table '1597684021 2' 9-max Seat #3 is the button
Seat 1: JJin91 (43473 in chips)=20
Seat 2: apoch19 (38152 in chips)=20
Seat 3: A A 5454 (15526 in chips)=20
Seat 4: jvurn (191577 in chips) is sitting out
Seat 5: MM9955 (83037 in chips)=20
Seat 6: Mr Hero76 (60853 in chips)=20
Seat 9: hotcard08873 (32032 in chips)=20
JJin91: posts the ante 200
apoch19: posts the ante 200
A A 5454: posts the ante 200
jvurn: posts the ante 200
MM9955: posts the ante 200
Mr Hero76: posts the ante 200
hotcard08873: posts the ante 200
jvurn: posts small blind 800
MM9955: posts big blind 1600
*** HOLE CARDS ***
Dealt to JJin91 [6d 2h]
Mr Hero76: folds=20
hotcard08873: folds=20
JJin91: folds=20
apoch19: folds=20
A A 5454: folds=20
jvurn: folds=20
Uncalled bet (800) returned to MM9955
MM9955 collected 3000 from pot
MM9955: doesn't show hand=20
*** SUMMARY ***
Total pot 3000 | Rake 0=20
Seat 1: JJin91 folded before Flop (didn't bet)
Seat 2: apoch19 folded before Flop (didn't bet)
Seat 3: A A 5454 (button) folded before Flop (didn't bet)
Seat 4: jvurn (small blind) folded before Flop
Seat 5: MM9955 (big blind) collected (3000)
Seat 6: Mr Hero76 folded before Flop (didn't bet)
Seat 9: hotcard08873 folded before Flop (didn't bet)


*********** # 155 **************
PokerStars Hand #169450807644: Tournament #1597684021, $18.20+$1.80 USD=
 Hold'em No Limit - Level XVIII (800/1600) - 2017/05/05 22:17:58 ET
Table '1597684021 2' 9-max Seat #4 is the button
Seat 1: JJin91 (43273 in chips)=20
Seat 2: apoch19 (37952 in chips)=20
Seat 3: A A 5454 (15326 in chips)=20
Seat 4: jvurn (190577 in chips) is sitting out
Seat 5: MM9955 (85037 in chips)=20
Seat 6: Mr Hero76 (60653 in chips)=20
Seat 9: hotcard08873 (31832 in chips)=20
JJin91: posts the ante 200
apoch19: posts the ante 200
A A 5454: posts the ante 200
jvurn: posts the ante 200
MM9955: posts the ante 200
Mr Hero76: posts the ante 200
hotcard08873: posts the ante 200
MM9955: posts small blind 800
Mr Hero76: posts big blind 1600
*** HOLE CARDS ***
Dealt to JJin91 [5d 3s]
hotcard08873: folds=20
JJin91: folds=20
apoch19: folds=20
A A 5454: folds=20
jvurn: folds=20
MM9955: calls 800
Mr Hero76: checks=20
*** FLOP *** [Ts 7c 4c]
MM9955: bets 2300
Mr Hero76: folds=20
Uncalled bet (2300) returned to MM9955
MM9955 collected 4600 from pot
MM9955: doesn't show hand=20
*** SUMMARY ***
Total pot 4600 | Rake 0=20
Board [Ts 7c 4c]
Seat 1: JJin91 folded before Flop (didn't bet)
Seat 2: apoch19 folded before Flop (didn't bet)
Seat 3: A A 5454 folded before Flop (didn't bet)
Seat 4: jvurn (button) folded before Flop (didn't bet)
Seat 5: MM9955 (small blind) collected (4600)
Seat 6: Mr Hero76 (big blind) folded on the Flop
Seat 9: hotcard08873 folded before Flop (didn't bet)


*********** # 156 **************
PokerStars Hand #169450807930: Tournament #1597684021, $18.20+$1.80 USD=
 Hold'em No Limit - Level XIX (1000/2000) - 2017/05/05 22:18:59 ET
Table '1597684021 2' 9-max Seat #5 is the button
Seat 1: JJin91 (43073 in chips)=20
Seat 2: apoch19 (37752 in chips)=20
Seat 3: A A 5454 (15126 in chips)=20
Seat 4: jvurn (190377 in chips) is sitting out
Seat 5: MM9955 (87837 in chips)=20
Seat 6: Mr Hero76 (58853 in chips)=20
Seat 9: hotcard08873 (31632 in chips)=20
JJin91: posts the ante 250
apoch19: posts the ante 250
A A 5454: posts the ante 250
jvurn: posts the ante 250
MM9955: posts the ante 250
Mr Hero76: posts the ante 250
hotcard08873: posts the ante 250
Mr Hero76: posts small blind 1000
hotcard08873: posts big blind 2000
*** HOLE CARDS ***
Dealt to JJin91 [9h 5c]
JJin91: folds=20
apoch19: folds=20
A A 5454: folds=20
jvurn: folds=20
MM9955: raises 2000 to 4000
Mr Hero76: folds=20
hotcard08873: folds=20
Uncalled bet (2000) returned to MM9955
MM9955 collected 6750 from pot
MM9955: doesn't show hand=20
*** SUMMARY ***
Total pot 6750 | Rake 0=20
Seat 1: JJin91 folded before Flop (didn't bet)
Seat 2: apoch19 folded before Flop (didn't bet)
Seat 3: A A 5454 folded before Flop (didn't bet)
Seat 4: jvurn folded before Flop (didn't bet)
Seat 5: MM9955 (button) collected (6750)
Seat 6: Mr Hero76 (small blind) folded before Flop
Seat 9: hotcard08873 (big blind) folded before Flop


*********** # 157 **************
PokerStars Hand #169450808164: Tournament #1597684021, $18.20+$1.80 USD=
 Hold'em No Limit - Level XIX (1000/2000) - 2017/05/05 22:19:50 ET
Table '1597684021 2' 9-max Seat #6 is the button
Seat 1: JJin91 (42823 in chips)=20
Seat 2: apoch19 (37502 in chips)=20
Seat 3: A A 5454 (14876 in chips)=20
Seat 4: jvurn (190127 in chips) is sitting out
Seat 5: MM9955 (92337 in chips)=20
Seat 6: Mr Hero76 (57603 in chips)=20
Seat 9: hotcard08873 (29382 in chips)=20
JJin91: posts the ante 250
apoch19: posts the ante 250
A A 5454: posts the ante 250
jvurn: posts the ante 250
MM9955: posts the ante 250
Mr Hero76: posts the ante 250
hotcard08873: posts the ante 250
hotcard08873: posts small blind 1000
JJin91: posts big blind 2000
*** HOLE CARDS ***
Dealt to JJin91 [Kd 7c]
apoch19: raises 2520 to 4520
A A 5454: folds=20
jvurn: folds=20
MM9955: folds=20
Mr Hero76: folds=20
hotcard08873: folds=20
JJin91: folds=20
Uncalled bet (2520) returned to apoch19
apoch19 collected 6750 from pot
apoch19: doesn't show hand=20
*** SUMMARY ***
Total pot 6750 | Rake 0=20
Seat 1: JJin91 (big blind) folded before Flop
Seat 2: apoch19 collected (6750)
Seat 3: A A 5454 folded before Flop (didn't bet)
Seat 4: jvurn folded before Flop (didn't bet)
Seat 5: MM9955 folded before Flop (didn't bet)
Seat 6: Mr Hero76 (button) folded before Flop (didn't bet)
Seat 9: hotcard08873 (small blind) folded before Flop


*********** # 158 **************
PokerStars Hand #169450808418: Tournament #1597684021, $18.20+$1.80 USD=
 Hold'em No Limit - Level XIX (1000/2000) - 2017/05/05 22:20:51 ET
Table '1597684021 2' 9-max Seat #9 is the button
Seat 1: JJin91 (40573 in chips)=20
Seat 2: apoch19 (42002 in chips)=20
Seat 3: A A 5454 (14626 in chips)=20
Seat 4: jvurn (189877 in chips) is sitting out
Seat 5: MM9955 (92087 in chips)=20
Seat 6: Mr Hero76 (57353 in chips)=20
Seat 9: hotcard08873 (28132 in chips)=20
JJin91: posts the ante 250
apoch19: posts the ante 250
A A 5454: posts the ante 250
jvurn: posts the ante 250
MM9955: posts the ante 250
Mr Hero76: posts the ante 250
hotcard08873: posts the ante 250
JJin91: posts small blind 1000
apoch19: posts big blind 2000
*** HOLE CARDS ***
Dealt to JJin91 [2d Jh]
A A 5454: folds=20
jvurn: folds=20
MM9955: folds=20
Mr Hero76: folds=20
hotcard08873: folds=20
JJin91: folds=20
Uncalled bet (1000) returned to apoch19
apoch19 collected 3750 from pot
apoch19: doesn't show hand=20
*** SUMMARY ***
Total pot 3750 | Rake 0=20
Seat 1: JJin91 (small blind) folded before Flop
Seat 2: apoch19 (big blind) collected (3750)
Seat 3: A A 5454 folded before Flop (didn't bet)
Seat 4: jvurn folded before Flop (didn't bet)
Seat 5: MM9955 folded before Flop (didn't bet)
Seat 6: Mr Hero76 folded before Flop (didn't bet)
Seat 9: hotcard08873 (button) folded before Flop (didn't bet)


*********** # 159 **************
PokerStars Hand #169450808654: Tournament #1597684021, $18.20+$1.80 USD=
 Hold'em No Limit - Level XIX (1000/2000) - 2017/05/05 22:21:47 ET
Table '1597684021 2' 9-max Seat #1 is the button
Seat 1: JJin91 (39323 in chips)=20
Seat 2: apoch19 (44502 in chips)=20
Seat 3: A A 5454 (14376 in chips)=20
Seat 4: jvurn (189627 in chips) is sitting out
Seat 5: MM9955 (91837 in chips)=20
Seat 6: Mr Hero76 (57103 in chips)=20
Seat 9: hotcard08873 (27882 in chips)=20
JJin91: posts the ante 250
apoch19: posts the ante 250
A A 5454: posts the ante 250
jvurn: posts the ante 250
MM9955: posts the ante 250
Mr Hero76: posts the ante 250
hotcard08873: posts the ante 250
apoch19: posts small blind 1000
A A 5454: posts big blind 2000
*** HOLE CARDS ***
Dealt to JJin91 [7d 8s]
jvurn: folds=20
MM9955: folds=20
Mr Hero76: folds=20
hotcard08873: folds=20
JJin91: raises 2380 to 4380
apoch19: folds=20
A A 5454: folds=20
Uncalled bet (2380) returned to JJin91
JJin91 collected 6750 from pot
JJin91: doesn't show hand=20
*** SUMMARY ***
Total pot 6750 | Rake 0=20
Seat 1: JJin91 (button) collected (6750)
Seat 2: apoch19 (small blind) folded before Flop
Seat 3: A A 5454 (big blind) folded before Flop
Seat 4: jvurn folded before Flop (didn't bet)
Seat 5: MM9955 folded before Flop (didn't bet)
Seat 6: Mr Hero76 folded before Flop (didn't bet)
Seat 9: hotcard08873 folded before Flop (didn't bet)


*********** # 160 **************
PokerStars Hand #169450808842: Tournament #1597684021, $18.20+$1.80 USD=
 Hold'em No Limit - Level XIX (1000/2000) - 2017/05/05 22:22:29 ET
Table '1597684021 2' 9-max Seat #2 is the button
Seat 1: JJin91 (43823 in chips)=20
Seat 2: apoch19 (43252 in chips)=20
Seat 3: A A 5454 (12126 in chips)=20
Seat 4: jvurn (189377 in chips) is sitting out
Seat 5: MM9955 (91587 in chips)=20
Seat 6: Mr Hero76 (56853 in chips)=20
Seat 9: hotcard08873 (27632 in chips)=20
JJin91: posts the ante 250
apoch19: posts the ante 250
A A 5454: posts the ante 250
jvurn: posts the ante 250
MM9955: posts the ante 250
Mr Hero76: posts the ante 250
hotcard08873: posts the ante 250
A A 5454: posts small blind 1000
jvurn: posts big blind 2000
*** HOLE CARDS ***
Dealt to JJin91 [5c 3h]
MM9955: raises 2000 to 4000
Mr Hero76: folds=20
hotcard08873: folds=20
JJin91: folds=20
apoch19: calls 4000
A A 5454: folds=20
jvurn: folds=20
*** FLOP *** [8d Td Ts]
MM9955: checks=20
apoch19: checks=20
*** TURN *** [8d Td Ts] [9d]
MM9955: checks=20
apoch19: checks=20
*** RIVER *** [8d Td Ts 9d] [5h]
MM9955: bets 2000
apoch19: calls 2000
*** SHOW DOWN ***
MM9955: shows [7c 7s] (two pair, Tens and Sevens)
apoch19: mucks hand=20
MM9955 collected 16750 from pot
*** SUMMARY ***
Total pot 16750 | Rake 0=20
Board [8d Td Ts 9d 5h]
Seat 1: JJin91 folded before Flop (didn't bet)
Seat 2: apoch19 (button) mucked [As Qc]
Seat 3: A A 5454 (small blind) folded before Flop
Seat 4: jvurn (big blind) folded before Flop
Seat 5: MM9955 showed [7c 7s] and won (16750) with two pair, Tens and S=
evens
Seat 6: Mr Hero76 folded before Flop (didn't bet)
Seat 9: hotcard08873 folded before Flop (didn't bet)


*********** # 161 **************
PokerStars Hand #169450809100: Tournament #1597684021, $18.20+$1.80 USD=
 Hold'em No Limit - Level XIX (1000/2000) - 2017/05/05 22:23:28 ET
Table '1597684021 2' 9-max Seat #3 is the button
Seat 1: JJin91 (43573 in chips)=20
Seat 2: apoch19 (37002 in chips)=20
Seat 3: A A 5454 (10876 in chips)=20
Seat 4: jvurn (187127 in chips) is sitting out
Seat 5: MM9955 (102087 in chips)=20
Seat 6: Mr Hero76 (56603 in chips)=20
Seat 9: hotcard08873 (27382 in chips)=20
JJin91: posts the ante 250
apoch19: posts the ante 250
A A 5454: posts the ante 250
jvurn: posts the ante 250
MM9955: posts the ante 250
Mr Hero76: posts the ante 250
hotcard08873: posts the ante 250
jvurn: posts small blind 1000
MM9955: posts big blind 2000
*** HOLE CARDS ***
Dealt to JJin91 [Kd 3s]
Mr Hero76: raises 2000 to 4000
hotcard08873: calls 4000
JJin91: folds=20
apoch19: folds=20
A A 5454: folds=20
jvurn: folds=20
MM9955: calls 2000
*** FLOP *** [Kc 9c Jh]
MM9955: checks=20
Mr Hero76: checks=20
hotcard08873: checks=20
*** TURN *** [Kc 9c Jh] [5h]
MM9955: bets 7375
Mr Hero76: folds=20
hotcard08873: folds=20
Uncalled bet (7375) returned to MM9955
MM9955 collected 14750 from pot
MM9955: doesn't show hand=20
*** SUMMARY ***
Total pot 14750 | Rake 0=20
Board [Kc 9c Jh 5h]
Seat 1: JJin91 folded before Flop (didn't bet)
Seat 2: apoch19 folded before Flop (didn't bet)
Seat 3: A A 5454 (button) folded before Flop (didn't bet)
Seat 4: jvurn (small blind) folded before Flop
Seat 5: MM9955 (big blind) collected (14750)
Seat 6: Mr Hero76 folded on the Turn
Seat 9: hotcard08873 folded on the Turn


*********** # 162 **************
PokerStars Hand #169450809363: Tournament #1597684021, $18.20+$1.80 USD=
 Hold'em No Limit - Level XIX (1000/2000) - 2017/05/05 22:24:25 ET
Table '1597684021 2' 9-max Seat #4 is the button
Seat 1: JJin91 (43323 in chips)=20
Seat 2: apoch19 (36752 in chips)=20
Seat 3: A A 5454 (10626 in chips)=20
Seat 4: jvurn (185877 in chips) is sitting out
Seat 5: MM9955 (112587 in chips)=20
Seat 6: Mr Hero76 (52353 in chips)=20
Seat 9: hotcard08873 (23132 in chips)=20
JJin91: posts the ante 250
apoch19: posts the ante 250
A A 5454: posts the ante 250
jvurn: posts the ante 250
MM9955: posts the ante 250
Mr Hero76: posts the ante 250
hotcard08873: posts the ante 250
MM9955: posts small blind 1000
Mr Hero76: posts big blind 2000
*** HOLE CARDS ***
Dealt to JJin91 [8d 7d]
hotcard08873: folds=20
JJin91: raises 2380 to 4380
apoch19: folds=20
A A 5454: folds=20
jvurn: folds=20
MM9955: folds=20
Mr Hero76: calls 2380
*** FLOP *** [9h 6s 9c]
Mr Hero76: checks=20
JJin91: bets 6100
Mr Hero76: folds=20
Uncalled bet (6100) returned to JJin91
JJin91 collected 11510 from pot
JJin91: doesn't show hand=20
*** SUMMARY ***
Total pot 11510 | Rake 0=20
Board [9h 6s 9c]
Seat 1: JJin91 collected (11510)
Seat 2: apoch19 folded before Flop (didn't bet)
Seat 3: A A 5454 folded before Flop (didn't bet)
Seat 4: jvurn (button) folded before Flop (didn't bet)
Seat 5: MM9955 (small blind) folded before Flop
Seat 6: Mr Hero76 (big blind) folded on the Flop
Seat 9: hotcard08873 folded before Flop (didn't bet)


*********** # 163 **************
PokerStars Hand #169450809618: Tournament #1597684021, $18.20+$1.80 USD=
 Hold'em No Limit - Level XIX (1000/2000) - 2017/05/05 22:25:25 ET
Table '1597684021 2' 9-max Seat #5 is the button
Seat 1: JJin91 (50203 in chips)=20
Seat 2: apoch19 (36502 in chips)=20
Seat 3: A A 5454 (10376 in chips)=20
Seat 4: jvurn (185627 in chips) is sitting out
Seat 5: MM9955 (111337 in chips)=20
Seat 6: Mr Hero76 (47723 in chips)=20
Seat 9: hotcard08873 (22882 in chips)=20
JJin91: posts the ante 250
apoch19: posts the ante 250
A A 5454: posts the ante 250
jvurn: posts the ante 250
MM9955: posts the ante 250
Mr Hero76: posts the ante 250
hotcard08873: posts the ante 250
Mr Hero76: posts small blind 1000
hotcard08873: posts big blind 2000
*** HOLE CARDS ***
Dealt to JJin91 [Ac As]
JJin91: raises 2380 to 4380
apoch19: folds=20
A A 5454: folds=20
jvurn: folds=20
MM9955: calls 4380
Mr Hero76: folds=20
hotcard08873: folds=20
*** FLOP *** [8s 9h Qs]
JJin91: bets 7160
MM9955: folds=20
Uncalled bet (7160) returned to JJin91
JJin91 collected 13510 from pot
JJin91: doesn't show hand=20
*** SUMMARY ***
Total pot 13510 | Rake 0=20
Board [8s 9h Qs]
Seat 1: JJin91 collected (13510)
Seat 2: apoch19 folded before Flop (didn't bet)
Seat 3: A A 5454 folded before Flop (didn't bet)
Seat 4: jvurn folded before Flop (didn't bet)
Seat 5: MM9955 (button) folded on the Flop
Seat 6: Mr Hero76 (small blind) folded before Flop
Seat 9: hotcard08873 (big blind) folded before Flop


*********** # 164 **************
PokerStars Hand #169450809878: Tournament #1597684021, $18.20+$1.80 USD=
 Hold'em No Limit - Level XIX (1000/2000) - 2017/05/05 22:26:29 ET
Table '1597684021 2' 9-max Seat #6 is the button
Seat 1: JJin91 (59083 in chips)=20
Seat 2: apoch19 (36252 in chips)=20
Seat 3: A A 5454 (10126 in chips)=20
Seat 4: jvurn (185377 in chips) is sitting out
Seat 5: MM9955 (106707 in chips)=20
Seat 6: Mr Hero76 (46473 in chips)=20
Seat 9: hotcard08873 (20632 in chips)=20
JJin91: posts the ante 250
apoch19: posts the ante 250
A A 5454: posts the ante 250
jvurn: posts the ante 250
MM9955: posts the ante 250
Mr Hero76: posts the ante 250
hotcard08873: posts the ante 250
hotcard08873: posts small blind 1000
JJin91: posts big blind 2000
*** HOLE CARDS ***
Dealt to JJin91 [7h Ac]
apoch19: folds=20
A A 5454: folds=20
jvurn: folds=20
MM9955: folds=20
Mr Hero76: folds=20
hotcard08873: folds=20
Uncalled bet (1000) returned to JJin91
JJin91 collected 3750 from pot
JJin91: doesn't show hand=20
*** SUMMARY ***
Total pot 3750 | Rake 0=20
Seat 1: JJin91 (big blind) collected (3750)
Seat 2: apoch19 folded before Flop (didn't bet)
Seat 3: A A 5454 folded before Flop (didn't bet)
Seat 4: jvurn folded before Flop (didn't bet)
Seat 5: MM9955 folded before Flop (didn't bet)
Seat 6: Mr Hero76 (button) folded before Flop (didn't bet)
Seat 9: hotcard08873 (small blind) folded before Flop


*********** # 165 **************
PokerStars Hand #169452249137: Tournament #1597684021, $18.20+$1.80 USD=
 Hold'em No Limit - Level XIX (1000/2000) - 2017/05/05 22:27:06 ET
Table '1597684021 2' 9-max Seat #9 is the button
Seat 1: JJin91 (61583 in chips)=20
Seat 2: apoch19 (36002 in chips)=20
Seat 3: A A 5454 (9876 in chips)=20
Seat 4: jvurn (185127 in chips) is sitting out
Seat 5: MM9955 (106457 in chips)=20
Seat 6: Mr Hero76 (46223 in chips)=20
Seat 9: hotcard08873 (19382 in chips)=20
JJin91: posts the ante 250
apoch19: posts the ante 250
A A 5454: posts the ante 250
jvurn: posts the ante 250
MM9955: posts the ante 250
Mr Hero76: posts the ante 250
hotcard08873: posts the ante 250
JJin91: posts small blind 1000
apoch19: posts big blind 2000
*** HOLE CARDS ***
Dealt to JJin91 [3c Qs]
A A 5454: folds=20
jvurn: folds=20
MM9955: folds=20
Mr Hero76: folds=20
hotcard08873: folds=20
JJin91: folds=20
Uncalled bet (1000) returned to apoch19
apoch19 collected 3750 from pot
apoch19: doesn't show hand=20
*** SUMMARY ***
Total pot 3750 | Rake 0=20
Seat 1: JJin91 (small blind) folded before Flop
Seat 2: apoch19 (big blind) collected (3750)
Seat 3: A A 5454 folded before Flop (didn't bet)
Seat 4: jvurn folded before Flop (didn't bet)
Seat 5: MM9955 folded before Flop (didn't bet)
Seat 6: Mr Hero76 folded before Flop (didn't bet)
Seat 9: hotcard08873 (button) folded before Flop (didn't bet)


*********** # 166 **************
PokerStars Hand #169452249396: Tournament #1597684021, $18.20+$1.80 USD=
 Hold'em No Limit - Level XX (1250/2500) - 2017/05/05 22:28:06 ET
Table '1597684021 2' 9-max Seat #1 is the button
Seat 1: JJin91 (60333 in chips)=20
Seat 2: apoch19 (38502 in chips)=20
Seat 3: A A 5454 (9626 in chips)=20
Seat 4: jvurn (184877 in chips) is sitting out
Seat 5: MM9955 (106207 in chips)=20
Seat 6: Mr Hero76 (45973 in chips)=20
Seat 9: hotcard08873 (19132 in chips)=20
JJin91: posts the ante 325
apoch19: posts the ante 325
A A 5454: posts the ante 325
jvurn: posts the ante 325
MM9955: posts the ante 325
Mr Hero76: posts the ante 325
hotcard08873: posts the ante 325
apoch19: posts small blind 1250
A A 5454: posts big blind 2500
*** HOLE CARDS ***
Dealt to JJin91 [3h Js]
jvurn: folds=20
MM9955: folds=20
Mr Hero76: raises 5000 to 7500
hotcard08873: folds=20
JJin91: folds=20
apoch19: folds=20
A A 5454: folds=20
Uncalled bet (5000) returned to Mr Hero76
Mr Hero76 collected 8525 from pot
Mr Hero76: doesn't show hand=20
*** SUMMARY ***
Total pot 8525 | Rake 0=20
Seat 1: JJin91 (button) folded before Flop (didn't bet)
Seat 2: apoch19 (small blind) folded before Flop
Seat 3: A A 5454 (big blind) folded before Flop
Seat 4: jvurn folded before Flop (didn't bet)
Seat 5: MM9955 folded before Flop (didn't bet)
Seat 6: Mr Hero76 collected (8525)
Seat 9: hotcard08873 folded before Flop (didn't bet)


*********** # 167 **************
PokerStars Hand #169452249599: Tournament #1597684021, $18.20+$1.80 USD=
 Hold'em No Limit - Level XX (1250/2500) - 2017/05/05 22:28:49 ET
Table '1597684021 2' 9-max Seat #2 is the button
Seat 1: JJin91 (60008 in chips)=20
Seat 2: apoch19 (36927 in chips)=20
Seat 3: A A 5454 (6801 in chips)=20
Seat 4: jvurn (184552 in chips) is sitting out
Seat 5: MM9955 (105882 in chips)=20
Seat 6: Mr Hero76 (51673 in chips)=20
Seat 9: hotcard08873 (18807 in chips)=20
JJin91: posts the ante 325
apoch19: posts the ante 325
A A 5454: posts the ante 325
jvurn: posts the ante 325
MM9955: posts the ante 325
Mr Hero76: posts the ante 325
hotcard08873: posts the ante 325
A A 5454: posts small blind 1250
jvurn: posts big blind 2500
*** HOLE CARDS ***
Dealt to JJin91 [8h 7h]
MM9955: raises 2500 to 5000
Mr Hero76: folds=20
hotcard08873: folds=20
JJin91: calls 5000
apoch19: folds=20
A A 5454: folds=20
jvurn: folds=20
*** FLOP *** [Jh Qs 4s]
MM9955: bets 5000
JJin91: folds=20
Uncalled bet (5000) returned to MM9955
MM9955 collected 16025 from pot
MM9955: doesn't show hand=20
*** SUMMARY ***
Total pot 16025 | Rake 0=20
Board [Jh Qs 4s]
Seat 1: JJin91 folded on the Flop
Seat 2: apoch19 (button) folded before Flop (didn't bet)
Seat 3: A A 5454 (small blind) folded before Flop
Seat 4: jvurn (big blind) folded before Flop
Seat 5: MM9955 collected (16025)
Seat 6: Mr Hero76 folded before Flop (didn't bet)
Seat 9: hotcard08873 folded before Flop (didn't bet)


*********** # 168 **************
PokerStars Hand #169452249865: Tournament #1597684021, $18.20+$1.80 USD=
 Hold'em No Limit - Level XX (1250/2500) - 2017/05/05 22:29:53 ET
Table '1597684021 2' 9-max Seat #3 is the button
Seat 1: JJin91 (54683 in chips)=20
Seat 2: apoch19 (36602 in chips)=20
Seat 3: A A 5454 (5226 in chips)=20
Seat 4: jvurn (181727 in chips) is sitting out
Seat 5: MM9955 (116582 in chips)=20
Seat 6: Mr Hero76 (51348 in chips)=20
Seat 9: hotcard08873 (18482 in chips)=20
JJin91: posts the ante 325
apoch19: posts the ante 325
A A 5454: posts the ante 325
jvurn: posts the ante 325
MM9955: posts the ante 325
Mr Hero76: posts the ante 325
hotcard08873: posts the ante 325
jvurn: posts small blind 1250
MM9955: posts big blind 2500
*** HOLE CARDS ***
Dealt to JJin91 [7s 4s]
Mr Hero76: folds=20
hotcard08873: raises 15657 to 18157 and is all-in
JJin91: folds=20
apoch19: raises 18120 to 36277 and is all-in
A A 5454: folds=20
jvurn: folds=20
MM9955: folds=20
Uncalled bet (18120) returned to apoch19
*** FLOP *** [3h As Ts]
*** TURN *** [3h As Ts] [Qc]
*** RIVER *** [3h As Ts Qc] [Jd]
*** SHOW DOWN ***
hotcard08873: shows [Ac Jc] (two pair, Aces and Jacks)
apoch19: shows [Kd Ks] (a straight, Ten to Ace)
apoch19 collected 42339 from pot
hotcard08873 finished the tournament in 19th place
*** SUMMARY ***
Total pot 42339 | Rake 0=20
Board [3h As Ts Qc Jd]
Seat 1: JJin91 folded before Flop (didn't bet)
Seat 2: apoch19 showed [Kd Ks] and won (42339) with a straight, Ten to =
Ace
Seat 3: A A 5454 (button) folded before Flop (didn't bet)
Seat 4: jvurn (small blind) folded before Flop
Seat 5: MM9955 (big blind) folded before Flop
Seat 6: Mr Hero76 folded before Flop (didn't bet)
Seat 9: hotcard08873 showed [Ac Jc] and lost with two pair, Aces and Ja=
cks


*********** # 169 **************
PokerStars Hand #169452560353: Tournament #1597684021, $18.20+$1.80 USD=
 Hold'em No Limit - Level XX (1250/2500) - 2017/05/05 22:30:36 ET
Table '1597684021 1' 9-max Seat #7 is the button
Seat 1: smitheea (124345 in chips)=20
Seat 2: JJin91 (54358 in chips)=20
Seat 3: GetLoose17 (11787 in chips)=20
Seat 4: apoch19 (60459 in chips)=20
Seat 5: DomBagz (43718 in chips)=20
Seat 6: gator856500 (9522 in chips)=20
Seat 7: SourDforMe (47545 in chips)=20
Seat 8: MM9955 (113757 in chips) out of hand (moved from another table =
into small blind)
Seat 9: asremb (117405 in chips)=20
smitheea: posts the ante 325
JJin91: posts the ante 325
GetLoose17: posts the ante 325
apoch19: posts the ante 325
DomBagz: posts the ante 325
gator856500: posts the ante 325
SourDforMe: posts the ante 325
asremb: posts the ante 325
asremb: posts small blind 1250
smitheea: posts big blind 2500
*** HOLE CARDS ***
Dealt to JJin91 [Js Th]
JJin91: folds=20
GetLoose17: folds=20
apoch19: folds=20
DomBagz: folds=20
gator856500: folds=20
SourDforMe: raises 5000 to 7500
asremb: folds=20
smitheea: folds=20
Uncalled bet (5000) returned to SourDforMe
SourDforMe collected 8850 from pot
SourDforMe: doesn't show hand=20
*** SUMMARY ***
Total pot 8850 | Rake 0=20
Seat 1: smitheea (big blind) folded before Flop
Seat 2: JJin91 folded before Flop (didn't bet)
Seat 3: GetLoose17 folded before Flop (didn't bet)
Seat 4: apoch19 folded before Flop (didn't bet)
Seat 5: DomBagz folded before Flop (didn't bet)
Seat 6: gator856500 folded before Flop (didn't bet)
Seat 7: SourDforMe (button) collected (8850)
Seat 9: asremb (small blind) folded before Flop


*********** # 170 **************
PokerStars Hand #169452560483: Tournament #1597684021, $18.20+$1.80 USD=
 Hold'em No Limit - Level XX (1250/2500) - 2017/05/05 22:31:08 ET
Table '1597684021 1' 9-max Seat #9 is the button
Seat 1: smitheea (121520 in chips)=20
Seat 2: JJin91 (54033 in chips)=20
Seat 3: GetLoose17 (11462 in chips)=20
Seat 4: apoch19 (60134 in chips)=20
Seat 5: DomBagz (43393 in chips)=20
Seat 6: gator856500 (9197 in chips)=20
Seat 7: SourDforMe (53570 in chips)=20
Seat 8: MM9955 (113757 in chips)=20
Seat 9: asremb (115830 in chips)=20
smitheea: posts the ante 325
JJin91: posts the ante 325
GetLoose17: posts the ante 325
apoch19: posts the ante 325
DomBagz: posts the ante 325
gator856500: posts the ante 325
SourDforMe: posts the ante 325
MM9955: posts the ante 325
asremb: posts the ante 325
smitheea: posts small blind 1250
JJin91: posts big blind 2500
*** HOLE CARDS ***
Dealt to JJin91 [6d Jh]
GetLoose17: folds=20
apoch19: folds=20
DomBagz: folds=20
gator856500: folds=20
SourDforMe: folds=20
MM9955: folds=20
asremb: raises 5000 to 7500
smitheea: folds=20
JJin91: folds=20
Uncalled bet (5000) returned to asremb
asremb collected 9175 from pot
asremb: doesn't show hand=20
*** SUMMARY ***
Total pot 9175 | Rake 0=20
Seat 1: smitheea (small blind) folded before Flop
Seat 2: JJin91 (big blind) folded before Flop
Seat 3: GetLoose17 folded before Flop (didn't bet)
Seat 4: apoch19 folded before Flop (didn't bet)
Seat 5: DomBagz folded before Flop (didn't bet)
Seat 6: gator856500 folded before Flop (didn't bet)
Seat 7: SourDforMe folded before Flop (didn't bet)
Seat 8: MM9955 folded before Flop (didn't bet)
Seat 9: asremb (button) collected (9175)


*********** # 171 **************
PokerStars Hand #169452560570: Tournament #1597684021, $18.20+$1.80 USD=
 Hold'em No Limit - Level XX (1250/2500) - 2017/05/05 22:31:29 ET
Table '1597684021 1' 9-max Seat #1 is the button
Seat 1: smitheea (119945 in chips)=20
Seat 2: JJin91 (51208 in chips)=20
Seat 3: GetLoose17 (11137 in chips)=20
Seat 4: apoch19 (59809 in chips)=20
Seat 5: DomBagz (43068 in chips)=20
Seat 6: gator856500 (8872 in chips)=20
Seat 7: SourDforMe (53245 in chips)=20
Seat 8: MM9955 (113432 in chips)=20
Seat 9: asremb (122180 in chips)=20
smitheea: posts the ante 325
JJin91: posts the ante 325
GetLoose17: posts the ante 325
apoch19: posts the ante 325
DomBagz: posts the ante 325
gator856500: posts the ante 325
SourDforMe: posts the ante 325
MM9955: posts the ante 325
asremb: posts the ante 325
JJin91: posts small blind 1250
GetLoose17: posts big blind 2500
*** HOLE CARDS ***
Dealt to JJin91 [7d 8c]
apoch19: folds=20
DomBagz: raises 2500 to 5000
gator856500: folds=20
SourDforMe: folds=20
MM9955: folds=20
asremb: folds=20
smitheea: folds=20
JJin91: folds=20
GetLoose17: raises 5812 to 10812 and is all-in
DomBagz: calls 5812
*** FLOP *** [Js Qd Kd]
*** TURN *** [Js Qd Kd] [Tc]
*** RIVER *** [Js Qd Kd Tc] [4d]
*** SHOW DOWN ***
GetLoose17: shows [Ts Ad] (a straight, Ten to Ace)
DomBagz: shows [Jh Ah] (a straight, Ten to Ace)
GetLoose17 collected 12900 from pot
DomBagz collected 12899 from pot
*** SUMMARY ***
Total pot 25799 | Rake 0=20
Board [Js Qd Kd Tc 4d]
Seat 1: smitheea (button) folded before Flop (didn't bet)
Seat 2: JJin91 (small blind) folded before Flop
Seat 3: GetLoose17 (big blind) showed [Ts Ad] and won (12900) with a st=
raight, Ten to Ace
Seat 4: apoch19 folded before Flop (didn't bet)
Seat 5: DomBagz showed [Jh Ah] and won (12899) with a straight, Ten to =
Ace
Seat 6: gator856500 folded before Flop (didn't bet)
Seat 7: SourDforMe folded before Flop (didn't bet)
Seat 8: MM9955 folded before Flop (didn't bet)
Seat 9: asremb folded before Flop (didn't bet)


*********** # 172 **************
PokerStars Hand #169452560690: Tournament #1597684021, $18.20+$1.80 USD=
 Hold'em No Limit - Level XX (1250/2500) - 2017/05/05 22:32:03 ET
Table '1597684021 1' 9-max Seat #2 is the button
Seat 1: smitheea (119620 in chips)=20
Seat 2: JJin91 (49633 in chips)=20
Seat 3: GetLoose17 (12900 in chips)=20
Seat 4: apoch19 (59484 in chips)=20
Seat 5: DomBagz (44830 in chips)=20
Seat 6: gator856500 (8547 in chips)=20
Seat 7: SourDforMe (52920 in chips)=20
Seat 8: MM9955 (113107 in chips)=20
Seat 9: asremb (121855 in chips)=20
smitheea: posts the ante 325
JJin91: posts the ante 325
GetLoose17: posts the ante 325
apoch19: posts the ante 325
DomBagz: posts the ante 325
gator856500: posts the ante 325
SourDforMe: posts the ante 325
MM9955: posts the ante 325
asremb: posts the ante 325
GetLoose17: posts small blind 1250
apoch19: posts big blind 2500
*** HOLE CARDS ***
Dealt to JJin91 [8c 3c]
DomBagz: folds=20
gator856500: folds=20
SourDforMe: folds=20
SourDforMe said, "lol"
MM9955: folds=20
asremb: folds=20
smitheea: raises 5000 to 7500
JJin91: folds=20
GetLoose17: folds=20
apoch19: folds=20
Uncalled bet (5000) returned to smitheea
smitheea collected 9175 from pot
smitheea: doesn't show hand=20
*** SUMMARY ***
Total pot 9175 | Rake 0=20
Seat 1: smitheea collected (9175)
Seat 2: JJin91 (button) folded before Flop (didn't bet)
Seat 3: GetLoose17 (small blind) folded before Flop
Seat 4: apoch19 (big blind) folded before Flop
Seat 5: DomBagz folded before Flop (didn't bet)
Seat 6: gator856500 folded before Flop (didn't bet)
Seat 7: SourDforMe folded before Flop (didn't bet)
Seat 8: MM9955 folded before Flop (didn't bet)
Seat 9: asremb folded before Flop (didn't bet)


*********** # 173 **************
PokerStars Hand #169452560760: Tournament #1597684021, $18.20+$1.80 USD=
 Hold'em No Limit - Level XX (1250/2500) - 2017/05/05 22:32:20 ET
Table '1597684021 1' 9-max Seat #3 is the button
Seat 1: smitheea (125970 in chips)=20
Seat 2: JJin91 (49308 in chips)=20
Seat 3: GetLoose17 (11325 in chips)=20
Seat 4: apoch19 (56659 in chips)=20
Seat 5: DomBagz (44505 in chips)=20
Seat 6: gator856500 (8222 in chips)=20
Seat 7: SourDforMe (52595 in chips)=20
Seat 8: MM9955 (112782 in chips)=20
Seat 9: asremb (121530 in chips)=20
smitheea: posts the ante 325
JJin91: posts the ante 325
GetLoose17: posts the ante 325
apoch19: posts the ante 325
DomBagz: posts the ante 325
gator856500: posts the ante 325
SourDforMe: posts the ante 325
MM9955: posts the ante 325
asremb: posts the ante 325
apoch19: posts small blind 1250
DomBagz: posts big blind 2500
*** HOLE CARDS ***
Dealt to JJin91 [3d Tc]
gator856500: folds=20
SourDforMe: folds=20
MM9955: folds=20
asremb: calls 2500
smitheea: folds=20
JJin91: folds=20
GetLoose17: raises 8500 to 11000 and is all-in
apoch19: folds=20
DomBagz: folds=20
asremb: calls 8500
*** FLOP *** [Jd 4s 9d]
*** TURN *** [Jd 4s 9d] [7h]
*** RIVER *** [Jd 4s 9d 7h] [5h]
*** SHOW DOWN ***
asremb: shows [5d Ac] (a pair of Fives)
GetLoose17: shows [Kh Kd] (a pair of Kings)
GetLoose17 collected 28675 from pot
*** SUMMARY ***
Total pot 28675 | Rake 0=20
Board [Jd 4s 9d 7h 5h]
Seat 1: smitheea folded before Flop (didn't bet)
Seat 2: JJin91 folded before Flop (didn't bet)
Seat 3: GetLoose17 (button) showed [Kh Kd] and won (28675) with a pair =
of Kings
Seat 4: apoch19 (small blind) folded before Flop
Seat 5: DomBagz (big blind) folded before Flop
Seat 6: gator856500 folded before Flop (didn't bet)
Seat 7: SourDforMe folded before Flop (didn't bet)
Seat 8: MM9955 folded before Flop (didn't bet)
Seat 9: asremb showed [5d Ac] and lost with a pair of Fives


*********** # 174 **************
PokerStars Hand #169452560951: Tournament #1597684021, $18.20+$1.80 USD=
 Hold'em No Limit - Level XX (1250/2500) - 2017/05/05 22:33:08 ET
Table '1597684021 1' 9-max Seat #4 is the button
Seat 1: smitheea (125645 in chips)=20
Seat 2: JJin91 (48983 in chips)=20
Seat 3: GetLoose17 (28675 in chips)=20
Seat 4: apoch19 (55084 in chips)=20
Seat 5: DomBagz (41680 in chips)=20
Seat 6: gator856500 (7897 in chips)=20
Seat 7: SourDforMe (52270 in chips)=20
Seat 8: MM9955 (112457 in chips)=20
Seat 9: asremb (110205 in chips)=20
smitheea: posts the ante 325
JJin91: posts the ante 325
GetLoose17: posts the ante 325
apoch19: posts the ante 325
DomBagz: posts the ante 325
gator856500: posts the ante 325
SourDforMe: posts the ante 325
MM9955: posts the ante 325
asremb: posts the ante 325
DomBagz: posts small blind 1250
gator856500: posts big blind 2500
*** HOLE CARDS ***
Dealt to JJin91 [Jd Kh]
SourDforMe: folds=20
MM9955: raises 2500 to 5000
asremb: calls 5000
smitheea: folds=20
JJin91: folds=20
GetLoose17: raises 23350 to 28350 and is all-in
apoch19: folds=20
DomBagz: folds=20
gator856500: folds=20
MM9955: calls 23350
asremb: folds=20
*** FLOP *** [4d Qs 7c]
*** TURN *** [4d Qs 7c] [2d]
*** RIVER *** [4d Qs 7c 2d] [Ah]
*** SHOW DOWN ***
MM9955: shows [Qd Ad] (two pair, Aces and Queens)
GetLoose17: shows [Ks Kc] (a pair of Kings)
MM9955 collected 68375 from pot
GetLoose17 finished the tournament in 17th place and received $42.90.
*** SUMMARY ***
Total pot 68375 | Rake 0=20
Board [4d Qs 7c 2d Ah]
Seat 1: smitheea folded before Flop (didn't bet)
Seat 2: JJin91 folded before Flop (didn't bet)
Seat 3: GetLoose17 showed [Ks Kc] and lost with a pair of Kings
Seat 4: apoch19 (button) folded before Flop (didn't bet)
Seat 5: DomBagz (small blind) folded before Flop
Seat 6: gator856500 (big blind) folded before Flop
Seat 7: SourDforMe folded before Flop (didn't bet)
Seat 8: MM9955 showed [Qd Ad] and won (68375) with two pair, Aces and Q=
ueens
Seat 9: asremb folded before Flop


*********** # 175 **************
PokerStars Hand #169452561144: Tournament #1597684021, $18.20+$1.80 USD=
 Hold'em No Limit - Level XX (1250/2500) - 2017/05/05 22:33:58 ET
Table '1597684021 1' 9-max Seat #5 is the button
Seat 1: smitheea (125320 in chips)=20
Seat 2: JJin91 (48658 in chips)=20
Seat 4: apoch19 (54759 in chips)=20
Seat 5: DomBagz (40105 in chips)=20
Seat 6: gator856500 (5072 in chips)=20
Seat 7: SourDforMe (51945 in chips)=20
Seat 8: MM9955 (152157 in chips)=20
Seat 9: asremb (104880 in chips)=20
smitheea: posts the ante 325
JJin91: posts the ante 325
apoch19: posts the ante 325
DomBagz: posts the ante 325
gator856500: posts the ante 325
SourDforMe: posts the ante 325
MM9955: posts the ante 325
asremb: posts the ante 325
gator856500: posts small blind 1250
SourDforMe: posts big blind 2500
*** HOLE CARDS ***
Dealt to JJin91 [Jd 5d]
MM9955: raises 2500 to 5000
asremb: calls 5000
smitheea: folds=20
JJin91: folds=20
SourDforMe said, "loll"
apoch19: folds=20
smitheea said, "sicker beats on pokerstars than iTunes"
DomBagz: raises 12500 to 17500
gator856500: folds=20
SourDforMe: folds=20
MM9955: folds=20
asremb: calls 12500
*** FLOP *** [5c 4h 2h]
asremb: checks=20
DomBagz: bets 22280 and is all-in
asremb: folds=20
Uncalled bet (22280) returned to DomBagz
DomBagz collected 46350 from pot
DomBagz: doesn't show hand=20
*** SUMMARY ***
Total pot 46350 | Rake 0=20
Board [5c 4h 2h]
Seat 1: smitheea folded before Flop (didn't bet)
Seat 2: JJin91 folded before Flop (didn't bet)
Seat 4: apoch19 folded before Flop (didn't bet)
Seat 5: DomBagz (button) collected (46350)
Seat 6: gator856500 (small blind) folded before Flop
Seat 7: SourDforMe (big blind) folded before Flop
Seat 8: MM9955 folded before Flop
Seat 9: asremb folded on the Flop


*********** # 176 **************
PokerStars Hand #169452561376: Tournament #1597684021, $18.20+$1.80 USD=
 Hold'em No Limit - Level XX (1250/2500) - 2017/05/05 22:34:56 ET
Table '1597684021 1' 9-max Seat #6 is the button
Seat 1: smitheea (124995 in chips)=20
Seat 2: JJin91 (48333 in chips)=20
Seat 4: apoch19 (54434 in chips)=20
Seat 5: DomBagz (68630 in chips)=20
Seat 6: gator856500 (3497 in chips)=20
Seat 7: SourDforMe (49120 in chips)=20
Seat 8: MM9955 (146832 in chips)=20
Seat 9: asremb (87055 in chips)=20
smitheea: posts the ante 325
JJin91: posts the ante 325
apoch19: posts the ante 325
DomBagz: posts the ante 325
gator856500: posts the ante 325
SourDforMe: posts the ante 325
MM9955: posts the ante 325
asremb: posts the ante 325
SourDforMe: posts small blind 1250
MM9955: posts big blind 2500
*** HOLE CARDS ***
Dealt to JJin91 [9s Jc]
asremb: raises 2500 to 5000
smitheea: folds=20
JJin91: folds=20
apoch19: folds=20
DomBagz: folds=20
gator856500: folds=20
SourDforMe: folds=20
MM9955: calls 2500
*** FLOP *** [Qc Qd 4d]
MM9955: checks=20
asremb: bets 5000
MM9955: calls 5000
*** TURN *** [Qc Qd 4d] [6s]
MM9955: checks=20
asremb: bets 11925
MM9955: calls 11925
*** RIVER *** [Qc Qd 4d 6s] [5h]
MM9955: bets 2500
asremb: calls 2500
*** SHOW DOWN ***
MM9955: shows [Qs 9c] (three of a kind, Queens)
asremb: mucks hand=20
MM9955 collected 52700 from pot
*** SUMMARY ***
Total pot 52700 | Rake 0=20
Board [Qc Qd 4d 6s 5h]
Seat 1: smitheea folded before Flop (didn't bet)
Seat 2: JJin91 folded before Flop (didn't bet)
Seat 4: apoch19 folded before Flop (didn't bet)
Seat 5: DomBagz folded before Flop (didn't bet)
Seat 6: gator856500 (button) folded before Flop (didn't bet)
Seat 7: SourDforMe (small blind) folded before Flop
Seat 8: MM9955 (big blind) showed [Qs 9c] and won (52700) with three of=
 a kind, Queens
Seat 9: asremb mucked [2c 2h]


*********** # 177 **************
PokerStars Hand #169452561590: Tournament #1597684021, $18.20+$1.80 USD=
 Hold'em No Limit - Level XX (1250/2500) - 2017/05/05 22:35:47 ET
Table '1597684021 1' 9-max Seat #7 is the button
Seat 1: smitheea (124670 in chips)=20
Seat 2: JJin91 (48008 in chips)=20
Seat 4: apoch19 (54109 in chips)=20
Seat 5: DomBagz (68305 in chips)=20
Seat 6: gator856500 (3172 in chips)=20
Seat 7: SourDforMe (47545 in chips)=20
Seat 8: MM9955 (174782 in chips)=20
Seat 9: asremb (62305 in chips)=20
smitheea: posts the ante 325
JJin91: posts the ante 325
apoch19: posts the ante 325
DomBagz: posts the ante 325
gator856500: posts the ante 325
SourDforMe: posts the ante 325
MM9955: posts the ante 325
asremb: posts the ante 325
MM9955: posts small blind 1250
asremb: posts big blind 2500
*** HOLE CARDS ***
Dealt to JJin91 [3s Ah]
smitheea: folds=20
JJin91: folds=20
apoch19: folds=20
DomBagz: folds=20
gator856500: folds=20
SourDforMe: folds=20
MM9955: calls 1250
asremb: checks=20
*** FLOP *** [7h 8h 6h]
MM9955: bets 2500
asremb: calls 2500
*** TURN *** [7h 8h 6h] [As]
MM9955: bets 2500
asremb: calls 2500
*** RIVER *** [7h 8h 6h As] [3c]
MM9955: bets 2500
asremb: folds [9h]
Uncalled bet (2500) returned to MM9955
MM9955 collected 17600 from pot
MM9955: doesn't show hand=20
*** SUMMARY ***
Total pot 17600 | Rake 0=20
Board [7h 8h 6h As 3c]
Seat 1: smitheea folded before Flop (didn't bet)
Seat 2: JJin91 folded before Flop (didn't bet)
Seat 4: apoch19 folded before Flop (didn't bet)
Seat 5: DomBagz folded before Flop (didn't bet)
Seat 6: gator856500 folded before Flop (didn't bet)
Seat 7: SourDforMe (button) folded before Flop (didn't bet)
Seat 8: MM9955 (small blind) collected (17600)
Seat 9: asremb (big blind) folded on the River


*********** # 178 **************
PokerStars Hand #169452561797: Tournament #1597684021, $18.20+$1.80 USD=
 Hold'em No Limit - Level XX (1250/2500) - 2017/05/05 22:36:36 ET
Table '1597684021 1' 9-max Seat #8 is the button
Seat 1: smitheea (124345 in chips)=20
Seat 2: JJin91 (47683 in chips)=20
Seat 4: apoch19 (53784 in chips)=20
Seat 5: DomBagz (67980 in chips)=20
Seat 6: gator856500 (2847 in chips)=20
Seat 7: SourDforMe (47220 in chips)=20
Seat 8: MM9955 (184557 in chips)=20
Seat 9: asremb (54480 in chips)=20
smitheea: posts the ante 325
JJin91: posts the ante 325
apoch19: posts the ante 325
DomBagz: posts the ante 325
gator856500: posts the ante 325
SourDforMe: posts the ante 325
MM9955: posts the ante 325
asremb: posts the ante 325
asremb: posts small blind 1250
smitheea: posts big blind 2500
*** HOLE CARDS ***
Dealt to JJin91 [9d Th]
JJin91: folds=20
apoch19: folds=20
DomBagz: folds=20
gator856500: folds=20
SourDforMe: folds=20
MM9955: raises 2500 to 5000
asremb: calls 3750
smitheea: calls 2500
*** FLOP *** [Jh Ac Jd]
asremb: checks=20
smitheea: checks=20
MM9955: bets 5000
asremb: calls 5000
smitheea: folds=20
*** TURN *** [Jh Ac Jd] [3d]
asremb: checks=20
MM9955: bets 5000
asremb: calls 5000
*** RIVER *** [Jh Ac Jd 3d] [7h]
asremb: checks=20
MM9955: bets 5000
asremb: calls 5000
*** SHOW DOWN ***
MM9955: shows [Js Qc] (three of a kind, Jacks)
asremb: mucks hand=20
MM9955 collected 47600 from pot
*** SUMMARY ***
Total pot 47600 | Rake 0=20
Board [Jh Ac Jd 3d 7h]
Seat 1: smitheea (big blind) folded on the Flop
Seat 2: JJin91 folded before Flop (didn't bet)
Seat 4: apoch19 folded before Flop (didn't bet)
Seat 5: DomBagz folded before Flop (didn't bet)
Seat 6: gator856500 folded before Flop (didn't bet)
Seat 7: SourDforMe folded before Flop (didn't bet)
Seat 8: MM9955 (button) showed [Js Qc] and won (47600) with three of a =
kind, Jacks
Seat 9: asremb (small blind) mucked [6c Ad]


*********** # 179 **************
PokerStars Hand #169452562049: Tournament #1597684021, $18.20+$1.80 USD=
 Hold'em No Limit - Level XX (1250/2500) - 2017/05/05 22:37:31 ET
Table '1597684021 1' 9-max Seat #9 is the button
Seat 1: smitheea (119020 in chips)=20
Seat 2: JJin91 (47358 in chips)=20
Seat 4: apoch19 (53459 in chips)=20
Seat 5: DomBagz (67655 in chips)=20
Seat 6: gator856500 (2522 in chips)=20
Seat 7: SourDforMe (46895 in chips)=20
Seat 8: MM9955 (211832 in chips)=20
Seat 9: asremb (34155 in chips)=20
smitheea: posts the ante 325
JJin91: posts the ante 325
apoch19: posts the ante 325
DomBagz: posts the ante 325
gator856500: posts the ante 325
SourDforMe: posts the ante 325
MM9955: posts the ante 325
asremb: posts the ante 325
smitheea: posts small blind 1250
JJin91: posts big blind 2500
*** HOLE CARDS ***
Dealt to JJin91 [8c As]
apoch19: folds=20
DomBagz: folds=20
gator856500: folds=20
SourDforMe: folds=20
MM9955: raises 2500 to 5000
asremb: folds=20
smitheea: folds=20
JJin91: calls 2500
*** FLOP *** [3c 2c Ts]
JJin91: bets 5000
MM9955: calls 5000
*** TURN *** [3c 2c Ts] [Qc]
JJin91: bets 12641
MM9955: folds=20
Uncalled bet (12641) returned to JJin91
JJin91 collected 23850 from pot
JJin91: doesn't show hand=20
*** SUMMARY ***
Total pot 23850 | Rake 0=20
Board [3c 2c Ts Qc]
Seat 1: smitheea (small blind) folded before Flop
Seat 2: JJin91 (big blind) collected (23850)
Seat 4: apoch19 folded before Flop (didn't bet)
Seat 5: DomBagz folded before Flop (didn't bet)
Seat 6: gator856500 folded before Flop (didn't bet)
Seat 7: SourDforMe folded before Flop (didn't bet)
Seat 8: MM9955 folded on the Turn
Seat 9: asremb (button) folded before Flop (didn't bet)


*********** # 180 **************
PokerStars Hand #169452562260: Tournament #1597684021, $18.20+$1.80 USD=
 Hold'em No Limit - Level XXI (1500/3000) - 2017/05/05 22:38:21 ET
Table '1597684021 1' 9-max Seat #1 is the button
Seat 1: smitheea (117445 in chips)=20
Seat 2: JJin91 (60883 in chips)=20
Seat 4: apoch19 (53134 in chips)=20
Seat 5: DomBagz (67330 in chips)=20
Seat 6: gator856500 (2197 in chips)=20
Seat 7: SourDforMe (46570 in chips)=20
Seat 8: MM9955 (201507 in chips)=20
Seat 9: asremb (33830 in chips)=20
smitheea: posts the ante 375
JJin91: posts the ante 375
apoch19: posts the ante 375
DomBagz: posts the ante 375
gator856500: posts the ante 375
SourDforMe: posts the ante 375
MM9955: posts the ante 375
asremb: posts the ante 375
JJin91: posts small blind 1500
apoch19: posts big blind 3000
*** HOLE CARDS ***
Dealt to JJin91 [5h 6d]
DomBagz: folds=20
gator856500: folds=20
SourDforMe: folds=20
MM9955: raises 3000 to 6000
asremb: folds=20
smitheea: calls 6000
JJin91: folds=20
apoch19: calls 3000
*** FLOP *** [5d Ad Jc]
apoch19: checks=20
MM9955: bets 6000
smitheea: folds=20
apoch19: calls 6000
*** TURN *** [5d Ad Jc] [Js]
apoch19: checks=20
MM9955: checks=20
*** RIVER *** [5d Ad Jc Js] [Kc]
apoch19: checks=20
MM9955: checks=20
*** SHOW DOWN ***
apoch19: shows [3s As] (two pair, Aces and Jacks)
MM9955: shows [6s Ah] (two pair, Aces and Jacks)
apoch19 collected 17250 from pot
MM9955 collected 17250 from pot
*** SUMMARY ***
Total pot 34500 | Rake 0=20
Board [5d Ad Jc Js Kc]
Seat 1: smitheea (button) folded on the Flop
Seat 2: JJin91 (small blind) folded before Flop
Seat 4: apoch19 (big blind) showed [3s As] and won (17250) with two pai=
r, Aces and Jacks
Seat 5: DomBagz folded before Flop (didn't bet)
Seat 6: gator856500 folded before Flop (didn't bet)
Seat 7: SourDforMe folded before Flop (didn't bet)
Seat 8: MM9955 showed [6s Ah] and won (17250) with two pair, Aces and J=
acks
Seat 9: asremb folded before Flop (didn't bet)


*********** # 181 **************
PokerStars Hand #169452562506: Tournament #1597684021, $18.20+$1.80 USD=
 Hold'em No Limit - Level XXI (1500/3000) - 2017/05/05 22:39:19 ET
Table '1597684021 1' 9-max Seat #2 is the button
Seat 1: smitheea (111070 in chips)=20
Seat 2: JJin91 (59008 in chips)=20
Seat 4: apoch19 (58009 in chips)=20
Seat 5: DomBagz (66955 in chips)=20
Seat 6: gator856500 (1822 in chips)=20
Seat 7: SourDforMe (46195 in chips)=20
Seat 8: MM9955 (206382 in chips)=20
Seat 9: asremb (33455 in chips)=20
smitheea: posts the ante 375
JJin91: posts the ante 375
apoch19: posts the ante 375
DomBagz: posts the ante 375
gator856500: posts the ante 375
SourDforMe: posts the ante 375
MM9955: posts the ante 375
asremb: posts the ante 375
apoch19: posts small blind 1500
DomBagz: posts big blind 3000
*** HOLE CARDS ***
Dealt to JJin91 [Th 8h]
gator856500: folds=20
SourDforMe: folds=20
MM9955: raises 3000 to 6000
asremb: folds=20
smitheea: folds=20
JJin91: folds=20
apoch19: folds=20
DomBagz: folds=20
Uncalled bet (3000) returned to MM9955
MM9955 collected 10500 from pot
MM9955: doesn't show hand=20
*** SUMMARY ***
Total pot 10500 | Rake 0=20
Seat 1: smitheea folded before Flop (didn't bet)
Seat 2: JJin91 (button) folded before Flop (didn't bet)
Seat 4: apoch19 (small blind) folded before Flop
Seat 5: DomBagz (big blind) folded before Flop
Seat 6: gator856500 folded before Flop (didn't bet)
Seat 7: SourDforMe folded before Flop (didn't bet)
Seat 8: MM9955 collected (10500)
Seat 9: asremb folded before Flop (didn't bet)


*********** # 182 **************
PokerStars Hand #169452562651: Tournament #1597684021, $18.20+$1.80 USD=
 Hold'em No Limit - Level XXI (1500/3000) - 2017/05/05 22:39:52 ET
Table '1597684021 1' 9-max Seat #4 is the button
Seat 1: smitheea (110695 in chips)=20
Seat 2: JJin91 (58633 in chips)=20
Seat 4: apoch19 (56134 in chips)=20
Seat 5: DomBagz (63580 in chips)=20
Seat 6: gator856500 (1447 in chips)=20
Seat 7: SourDforMe (45820 in chips)=20
Seat 8: MM9955 (213507 in chips)=20
Seat 9: asremb (33080 in chips)=20
smitheea: posts the ante 375
JJin91: posts the ante 375
apoch19: posts the ante 375
DomBagz: posts the ante 375
gator856500: posts the ante 375
SourDforMe: posts the ante 375
MM9955: posts the ante 375
asremb: posts the ante 375
DomBagz: posts small blind 1500
gator856500: posts big blind 1072 and is all-in
*** HOLE CARDS ***
Dealt to JJin91 [Ac 5h]
SourDforMe: folds=20
MM9955: folds=20
asremb: folds=20
smitheea: folds=20
JJin91: raises 5070 to 6570
apoch19: folds=20
DomBagz: calls 5070
*** FLOP *** [9s 6d 8c]
DomBagz: checks=20
JJin91: bets 5336
DomBagz: calls 5336
*** TURN *** [9s 6d 8c] [Jc]
DomBagz: checks=20
JJin91: checks=20
*** RIVER *** [9s 6d 8c Jc] [4s]
DomBagz: checks=20
JJin91: checks=20
*** SHOW DOWN ***
DomBagz: shows [8h Th] (a pair of Eights)
JJin91: mucks hand=20
DomBagz collected 21668 from side pot
gator856500: mucks hand=20
DomBagz collected 6216 from main pot
gator856500 finished the tournament in 16th place and received $42.90.
*** SUMMARY ***
Total pot 27884 Main pot 6216. Side pot 21668. | Rake 0=20
Board [9s 6d 8c Jc 4s]
Seat 1: smitheea folded before Flop (didn't bet)
Seat 2: JJin91 mucked [Ac 5h]
Seat 4: apoch19 (button) folded before Flop (didn't bet)
Seat 5: DomBagz (small blind) showed [8h Th] and won (27884) with a pai=
r of Eights
Seat 6: gator856500 (big blind) mucked [Kc As]
Seat 7: SourDforMe folded before Flop (didn't bet)
Seat 8: MM9955 folded before Flop (didn't bet)
Seat 9: asremb folded before Flop (didn't bet)


*********** # 183 **************
PokerStars Hand #169452562920: Tournament #1597684021, $18.20+$1.80 USD=
 Hold'em No Limit - Level XXI (1500/3000) - 2017/05/05 22:40:54 ET
Table '1597684021 1' 9-max Seat #5 is the button
Seat 1: smitheea (110320 in chips)=20
Seat 2: JJin91 (46352 in chips)=20
Seat 4: apoch19 (55759 in chips)=20
Seat 5: DomBagz (79183 in chips)=20
Seat 7: SourDforMe (45445 in chips)=20
Seat 8: MM9955 (213132 in chips)=20
Seat 9: asremb (32705 in chips)=20
smitheea: posts the ante 375
JJin91: posts the ante 375
apoch19: posts the ante 375
DomBagz: posts the ante 375
SourDforMe: posts the ante 375
MM9955: posts the ante 375
asremb: posts the ante 375
SourDforMe: posts small blind 1500
MM9955: posts big blind 3000
*** HOLE CARDS ***
Dealt to JJin91 [Ad 5h]
asremb: folds=20
smitheea: folds=20
JJin91: folds=20
apoch19: raises 4540 to 7540
DomBagz: folds=20
SourDforMe: folds=20
MM9955: calls 4540
*** FLOP *** [Ts 8h 3s]
MM9955: checks=20
apoch19: checks=20
*** TURN *** [Ts 8h 3s] [3d]
MM9955: bets 9603
apoch19: folds=20
Uncalled bet (9603) returned to MM9955
MM9955 collected 19205 from pot
MM9955: doesn't show hand=20
*** SUMMARY ***
Total pot 19205 | Rake 0=20
Board [Ts 8h 3s 3d]
Seat 1: smitheea folded before Flop (didn't bet)
Seat 2: JJin91 folded before Flop (didn't bet)
Seat 4: apoch19 folded on the Turn
Seat 5: DomBagz (button) folded before Flop (didn't bet)
Seat 7: SourDforMe (small blind) folded before Flop
Seat 8: MM9955 (big blind) collected (19205)
Seat 9: asremb folded before Flop (didn't bet)


*********** # 184 **************
PokerStars Hand #169452563091: Tournament #1597684021, $18.20+$1.80 USD=
 Hold'em No Limit - Level XXI (1500/3000) - 2017/05/05 22:41:38 ET
Table '1597684021 1' 9-max Seat #7 is the button
Seat 1: smitheea (109945 in chips)=20
Seat 2: JJin91 (45977 in chips)=20
Seat 4: apoch19 (47844 in chips)=20
Seat 5: DomBagz (78808 in chips)=20
Seat 7: SourDforMe (43570 in chips)=20
Seat 8: MM9955 (224422 in chips)=20
Seat 9: asremb (32330 in chips)=20
smitheea: posts the ante 375
JJin91: posts the ante 375
apoch19: posts the ante 375
DomBagz: posts the ante 375
SourDforMe: posts the ante 375
MM9955: posts the ante 375
asremb: posts the ante 375
MM9955: posts small blind 1500
asremb: posts big blind 3000
*** HOLE CARDS ***
Dealt to JJin91 [9s Ac]
smitheea: folds=20
JJin91: raises 3570 to 6570
apoch19: folds=20
DomBagz: folds=20
SourDforMe: folds=20
MM9955: folds=20
asremb: folds=20
Uncalled bet (3570) returned to JJin91
JJin91 collected 10125 from pot
JJin91: doesn't show hand=20
*** SUMMARY ***
Total pot 10125 | Rake 0=20
Seat 1: smitheea folded before Flop (didn't bet)
Seat 2: JJin91 collected (10125)
Seat 4: apoch19 folded before Flop (didn't bet)
Seat 5: DomBagz folded before Flop (didn't bet)
Seat 7: SourDforMe (button) folded before Flop (didn't bet)
Seat 8: MM9955 (small blind) folded before Flop
Seat 9: asremb (big blind) folded before Flop


*********** # 185 **************
PokerStars Hand #169452563280: Tournament #1597684021, $18.20+$1.80 USD=
 Hold'em No Limit - Level XXI (1500/3000) - 2017/05/05 22:42:26 ET
Table '1597684021 1' 9-max Seat #8 is the button
Seat 1: smitheea (109570 in chips)=20
Seat 2: JJin91 (52727 in chips)=20
Seat 4: apoch19 (47469 in chips)=20
Seat 5: DomBagz (78433 in chips)=20
Seat 7: SourDforMe (43195 in chips)=20
Seat 8: MM9955 (222547 in chips)=20
Seat 9: asremb (28955 in chips)=20
smitheea: posts the ante 375
JJin91: posts the ante 375
apoch19: posts the ante 375
DomBagz: posts the ante 375
SourDforMe: posts the ante 375
MM9955: posts the ante 375
asremb: posts the ante 375
asremb: posts small blind 1500
smitheea: posts big blind 3000
*** HOLE CARDS ***
Dealt to JJin91 [3d 5s]
JJin91: folds=20
apoch19: folds=20
DomBagz: folds=20
SourDforMe: folds=20
MM9955: folds=20
asremb: raises 25580 to 28580 and is all-in
smitheea: folds=20
Uncalled bet (25580) returned to asremb
asremb collected 8625 from pot
asremb: doesn't show hand=20
*** SUMMARY ***
Total pot 8625 | Rake 0=20
Seat 1: smitheea (big blind) folded before Flop
Seat 2: JJin91 folded before Flop (didn't bet)
Seat 4: apoch19 folded before Flop (didn't bet)
Seat 5: DomBagz folded before Flop (didn't bet)
Seat 7: SourDforMe folded before Flop (didn't bet)
Seat 8: MM9955 (button) folded before Flop (didn't bet)
Seat 9: asremb (small blind) collected (8625)


*********** # 186 **************
PokerStars Hand #169452563339: Tournament #1597684021, $18.20+$1.80 USD=
 Hold'em No Limit - Level XXI (1500/3000) - 2017/05/05 22:42:44 ET
Table '1597684021 1' 9-max Seat #9 is the button
Seat 1: smitheea (106195 in chips)=20
Seat 2: JJin91 (52352 in chips)=20
Seat 4: apoch19 (47094 in chips)=20
Seat 5: DomBagz (78058 in chips)=20
Seat 7: SourDforMe (42820 in chips)=20
Seat 8: MM9955 (222172 in chips)=20
Seat 9: asremb (34205 in chips)=20
smitheea: posts the ante 375
JJin91: posts the ante 375
apoch19: posts the ante 375
DomBagz: posts the ante 375
SourDforMe: posts the ante 375
MM9955: posts the ante 375
asremb: posts the ante 375
smitheea: posts small blind 1500
JJin91: posts big blind 3000
*** HOLE CARDS ***
Dealt to JJin91 [Ks Kh]
apoch19: folds=20
DomBagz: folds=20
SourDforMe: folds=20
MM9955: folds=20
asremb: folds=20
smitheea: folds=20
Uncalled bet (1500) returned to JJin91
JJin91 collected 5625 from pot
JJin91: doesn't show hand=20
*** SUMMARY ***
Total pot 5625 | Rake 0=20
Seat 1: smitheea (small blind) folded before Flop
Seat 2: JJin91 (big blind) collected (5625)
Seat 4: apoch19 folded before Flop (didn't bet)
Seat 5: DomBagz folded before Flop (didn't bet)
Seat 7: SourDforMe folded before Flop (didn't bet)
Seat 8: MM9955 folded before Flop (didn't bet)
Seat 9: asremb (button) folded before Flop (didn't bet)


*********** # 187 **************
PokerStars Hand #169452563450: Tournament #1597684021, $18.20+$1.80 USD=
 Hold'em No Limit - Level XXI (1500/3000) - 2017/05/05 22:43:08 ET
Table '1597684021 1' 9-max Seat #1 is the button
Seat 1: smitheea (104320 in chips)=20
Seat 2: JJin91 (56102 in chips)=20
Seat 4: apoch19 (46719 in chips)=20
Seat 5: DomBagz (77683 in chips)=20
Seat 7: SourDforMe (42445 in chips)=20
Seat 8: MM9955 (221797 in chips)=20
Seat 9: asremb (33830 in chips)=20
smitheea: posts the ante 375
JJin91: posts the ante 375
apoch19: posts the ante 375
DomBagz: posts the ante 375
SourDforMe: posts the ante 375
MM9955: posts the ante 375
asremb: posts the ante 375
JJin91: posts small blind 1500
apoch19: posts big blind 3000
*** HOLE CARDS ***
Dealt to JJin91 [9s Qd]
DomBagz: raises 3000 to 6000
SourDforMe: folds=20
MM9955: folds=20
asremb: folds=20
smitheea: folds=20
JJin91: folds=20
apoch19: folds=20
Uncalled bet (3000) returned to DomBagz
DomBagz collected 10125 from pot
DomBagz: doesn't show hand=20
*** SUMMARY ***
Total pot 10125 | Rake 0=20
Seat 1: smitheea (button) folded before Flop (didn't bet)
Seat 2: JJin91 (small blind) folded before Flop
Seat 4: apoch19 (big blind) folded before Flop
Seat 5: DomBagz collected (10125)
Seat 7: SourDforMe folded before Flop (didn't bet)
Seat 8: MM9955 folded before Flop (didn't bet)
Seat 9: asremb folded before Flop (didn't bet)


*********** # 188 **************
PokerStars Hand #169452563570: Tournament #1597684021, $18.20+$1.80 USD=
 Hold'em No Limit - Level XXI (1500/3000) - 2017/05/05 22:43:37 ET
Table '1597684021 1' 9-max Seat #2 is the button
Seat 1: smitheea (103945 in chips)=20
Seat 2: JJin91 (54227 in chips)=20
Seat 4: apoch19 (43344 in chips)=20
Seat 5: DomBagz (84433 in chips)=20
Seat 7: SourDforMe (42070 in chips)=20
Seat 8: MM9955 (221422 in chips)=20
Seat 9: asremb (33455 in chips)=20
smitheea: posts the ante 375
JJin91: posts the ante 375
apoch19: posts the ante 375
DomBagz: posts the ante 375
SourDforMe: posts the ante 375
MM9955: posts the ante 375
asremb: posts the ante 375
apoch19: posts small blind 1500
DomBagz: posts big blind 3000
*** HOLE CARDS ***
Dealt to JJin91 [8d 6c]
SourDforMe: folds=20
MM9955: folds=20
asremb: folds=20
smitheea: folds=20
JJin91: folds=20
apoch19: folds=20
Uncalled bet (1500) returned to DomBagz
DomBagz collected 5625 from pot
DomBagz: doesn't show hand=20
*** SUMMARY ***
Total pot 5625 | Rake 0=20
Seat 1: smitheea folded before Flop (didn't bet)
Seat 2: JJin91 (button) folded before Flop (didn't bet)
Seat 4: apoch19 (small blind) folded before Flop
Seat 5: DomBagz (big blind) collected (5625)
Seat 7: SourDforMe folded before Flop (didn't bet)
Seat 8: MM9955 folded before Flop (didn't bet)
Seat 9: asremb folded before Flop (didn't bet)


*********** # 189 **************
PokerStars Hand #169452563735: Tournament #1597684021, $18.20+$1.80 USD=
 Hold'em No Limit - Level XXI (1500/3000) - 2017/05/05 22:44:14 ET
Table '1597684021 1' 9-max Seat #4 is the button
Seat 1: smitheea (103570 in chips)=20
Seat 2: JJin91 (53852 in chips)=20
Seat 4: apoch19 (41469 in chips)=20
Seat 5: DomBagz (88183 in chips)=20
Seat 7: SourDforMe (41695 in chips)=20
Seat 8: MM9955 (221047 in chips)=20
Seat 9: asremb (33080 in chips)=20
smitheea: posts the ante 375
JJin91: posts the ante 375
apoch19: posts the ante 375
DomBagz: posts the ante 375
SourDforMe: posts the ante 375
MM9955: posts the ante 375
asremb: posts the ante 375
DomBagz: posts small blind 1500
SourDforMe: posts big blind 3000
*** HOLE CARDS ***
Dealt to JJin91 [9h Th]
MM9955: folds=20
asremb: folds=20
smitheea: folds=20
JJin91: folds=20
apoch19: raises 38094 to 41094 and is all-in
DomBagz: folds=20
SourDforMe: folds=20
Uncalled bet (38094) returned to apoch19
apoch19 collected 10125 from pot
apoch19: doesn't show hand=20
*** SUMMARY ***
Total pot 10125 | Rake 0=20
Seat 1: smitheea folded before Flop (didn't bet)
Seat 2: JJin91 folded before Flop (didn't bet)
Seat 4: apoch19 (button) collected (10125)
Seat 5: DomBagz (small blind) folded before Flop
Seat 7: SourDforMe (big blind) folded before Flop
Seat 8: MM9955 folded before Flop (didn't bet)
Seat 9: asremb folded before Flop (didn't bet)


*********** # 190 **************
PokerStars Hand #169452563903: Tournament #1597684021, $18.20+$1.80 USD=
 Hold'em No Limit - Level XXI (1500/3000) - 2017/05/05 22:44:52 ET
Table '1597684021 1' 9-max Seat #5 is the button
Seat 1: smitheea (103195 in chips)=20
Seat 2: JJin91 (53477 in chips)=20
Seat 4: apoch19 (48219 in chips)=20
Seat 5: DomBagz (86308 in chips)=20
Seat 7: SourDforMe (38320 in chips)=20
Seat 8: MM9955 (220672 in chips)=20
Seat 9: asremb (32705 in chips)=20
smitheea: posts the ante 375
JJin91: posts the ante 375
apoch19: posts the ante 375
DomBagz: posts the ante 375
SourDforMe: posts the ante 375
MM9955: posts the ante 375
asremb: posts the ante 375
SourDforMe: posts small blind 1500
MM9955: posts big blind 3000
*** HOLE CARDS ***
Dealt to JJin91 [8h Jh]
asremb: folds=20
smitheea: folds=20
JJin91: folds=20
apoch19: folds=20
DomBagz: raises 3000 to 6000
SourDforMe: folds=20
MM9955: calls 3000
*** FLOP *** [Kd 5c 8c]
MM9955: checks=20
DomBagz: bets 8063
MM9955: folds=20
Uncalled bet (8063) returned to DomBagz
DomBagz collected 16125 from pot
DomBagz: doesn't show hand=20
*** SUMMARY ***
Total pot 16125 | Rake 0=20
Board [Kd 5c 8c]
Seat 1: smitheea folded before Flop (didn't bet)
Seat 2: JJin91 folded before Flop (didn't bet)
Seat 4: apoch19 folded before Flop (didn't bet)
Seat 5: DomBagz (button) collected (16125)
Seat 7: SourDforMe (small blind) folded before Flop
Seat 8: MM9955 (big blind) folded on the Flop
Seat 9: asremb folded before Flop (didn't bet)


*********** # 191 **************
PokerStars Hand #169452564116: Tournament #1597684021, $18.20+$1.80 USD=
 Hold'em No Limit - Level XXI (1500/3000) - 2017/05/05 22:45:39 ET
Table '1597684021 1' 9-max Seat #7 is the button
Seat 1: smitheea (102820 in chips)=20
Seat 2: JJin91 (53102 in chips)=20
Seat 4: apoch19 (47844 in chips)=20
Seat 5: DomBagz (96058 in chips)=20
Seat 7: SourDforMe (36445 in chips)=20
Seat 8: MM9955 (214297 in chips)=20
Seat 9: asremb (32330 in chips)=20
smitheea: posts the ante 375
JJin91: posts the ante 375
apoch19: posts the ante 375
DomBagz: posts the ante 375
SourDforMe: posts the ante 375
MM9955: posts the ante 375
asremb: posts the ante 375
MM9955: posts small blind 1500
asremb: posts big blind 3000
*** HOLE CARDS ***
Dealt to JJin91 [Kh 5h]
smitheea: folds=20
JJin91: folds=20
apoch19: folds=20
DomBagz: folds=20
SourDforMe: folds=20
MM9955: calls 1500
asremb: raises 28955 to 31955 and is all-in
MM9955: folds=20
Uncalled bet (28955) returned to asremb
asremb collected 8625 from pot
asremb: doesn't show hand=20
*** SUMMARY ***
Total pot 8625 | Rake 0=20
Seat 1: smitheea folded before Flop (didn't bet)
Seat 2: JJin91 folded before Flop (didn't bet)
Seat 4: apoch19 folded before Flop (didn't bet)
Seat 5: DomBagz folded before Flop (didn't bet)
Seat 7: SourDforMe (button) folded before Flop (didn't bet)
Seat 8: MM9955 (small blind) folded before Flop
Seat 9: asremb (big blind) collected (8625)


*********** # 192 **************
PokerStars Hand #169452564202: Tournament #1597684021, $18.20+$1.80 USD=
 Hold'em No Limit - Level XXI (1500/3000) - 2017/05/05 22:45:57 ET
Table '1597684021 1' 9-max Seat #8 is the button
Seat 1: smitheea (102445 in chips)=20
Seat 2: JJin91 (52727 in chips)=20
Seat 4: apoch19 (47469 in chips)=20
Seat 5: DomBagz (95683 in chips)=20
Seat 7: SourDforMe (36070 in chips)=20
Seat 8: MM9955 (210922 in chips)=20
Seat 9: asremb (37580 in chips)=20
smitheea: posts the ante 375
JJin91: posts the ante 375
apoch19: posts the ante 375
DomBagz: posts the ante 375
SourDforMe: posts the ante 375
MM9955: posts the ante 375
asremb: posts the ante 375
asremb: posts small blind 1500
smitheea: posts big blind 3000
*** HOLE CARDS ***
Dealt to JJin91 [As 5c]
JJin91: folds=20
apoch19: folds=20
DomBagz: folds=20
SourDforMe: folds=20
MM9955: folds=20
asremb: raises 6000 to 9000
smitheea: raises 93070 to 102070 and is all-in
asremb: calls 28205 and is all-in
Uncalled bet (64865) returned to smitheea
*** FLOP *** [2c 4h Td]
*** TURN *** [2c 4h Td] [Ac]
*** RIVER *** [2c 4h Td Ac] [6c]
*** SHOW DOWN ***
asremb: shows [Jd Js] (a pair of Jacks)
smitheea: shows [2d 2s] (three of a kind, Deuces)
smitheea collected 77035 from pot
asremb finished the tournament in 15th place and received $44.99.
*** SUMMARY ***
Total pot 77035 | Rake 0=20
Board [2c 4h Td Ac 6c]
Seat 1: smitheea (big blind) showed [2d 2s] and won (77035) with three =
of a kind, Deuces
Seat 2: JJin91 folded before Flop (didn't bet)
Seat 4: apoch19 folded before Flop (didn't bet)
Seat 5: DomBagz folded before Flop (didn't bet)
Seat 7: SourDforMe folded before Flop (didn't bet)
Seat 8: MM9955 (button) folded before Flop (didn't bet)
Seat 9: asremb (small blind) showed [Jd Js] and lost with a pair of Jac=
ks


*********** # 193 **************
PokerStars Hand #169452564324: Tournament #1597684021, $18.20+$1.80 USD=
 Hold'em No Limit - Level XXI (1500/3000) - 2017/05/05 22:46:26 ET
Table '1597684021 1' 9-max Seat #1 is the button
Seat 1: smitheea (141900 in chips)=20
Seat 2: JJin91 (52352 in chips)=20
Seat 4: apoch19 (47094 in chips)=20
Seat 5: DomBagz (95308 in chips)=20
Seat 7: SourDforMe (35695 in chips)=20
Seat 8: MM9955 (210547 in chips)=20
smitheea: posts the ante 375
JJin91: posts the ante 375
apoch19: posts the ante 375
DomBagz: posts the ante 375
SourDforMe: posts the ante 375
MM9955: posts the ante 375
JJin91: posts small blind 1500
apoch19: posts big blind 3000
*** HOLE CARDS ***
Dealt to JJin91 [4d 3h]
DomBagz: folds=20
SourDforMe: folds=20
MM9955: raises 6000 to 9000
smitheea: folds=20
JJin91: folds=20
apoch19: folds=20
Uncalled bet (6000) returned to MM9955
MM9955 collected 9750 from pot
MM9955: doesn't show hand=20
*** SUMMARY ***
Total pot 9750 | Rake 0=20
Seat 1: smitheea (button) folded before Flop (didn't bet)
Seat 2: JJin91 (small blind) folded before Flop
Seat 4: apoch19 (big blind) folded before Flop
Seat 5: DomBagz folded before Flop (didn't bet)
Seat 7: SourDforMe folded before Flop (didn't bet)
Seat 8: MM9955 collected (9750)


*********** # 194 **************
PokerStars Hand #169452564383: Tournament #1597684021, $18.20+$1.80 USD=
 Hold'em No Limit - Level XXI (1500/3000) - 2017/05/05 22:46:42 ET
Table '1597684021 1' 9-max Seat #2 is the button
Seat 1: smitheea (141525 in chips)=20
Seat 2: JJin91 (50477 in chips)=20
Seat 4: apoch19 (43719 in chips)=20
Seat 5: DomBagz (94933 in chips)=20
Seat 7: SourDforMe (35320 in chips)=20
Seat 8: MM9955 (216922 in chips)=20
smitheea: posts the ante 375
JJin91: posts the ante 375
apoch19: posts the ante 375
DomBagz: posts the ante 375
SourDforMe: posts the ante 375
MM9955: posts the ante 375
apoch19: posts small blind 1500
DomBagz: posts big blind 3000
*** HOLE CARDS ***
Dealt to JJin91 [7c 4d]
SourDforMe: folds=20
MM9955: folds=20
smitheea: raises 6000 to 9000
JJin91: folds=20
apoch19: folds=20
DomBagz: folds=20
Uncalled bet (6000) returned to smitheea
smitheea collected 9750 from pot
smitheea: doesn't show hand=20
*** SUMMARY ***
Total pot 9750 | Rake 0=20
Seat 1: smitheea collected (9750)
Seat 2: JJin91 (button) folded before Flop (didn't bet)
Seat 4: apoch19 (small blind) folded before Flop
Seat 5: DomBagz (big blind) folded before Flop
Seat 7: SourDforMe folded before Flop (didn't bet)
Seat 8: MM9955 folded before Flop (didn't bet)


*********** # 195 **************
PokerStars Hand #169452564460: Tournament #1597684021, $18.20+$1.80 USD=
 Hold'em No Limit - Level XXI (1500/3000) - 2017/05/05 22:46:58 ET
Table '1597684021 1' 9-max Seat #4 is the button
Seat 1: smitheea (147900 in chips)=20
Seat 2: JJin91 (50102 in chips)=20
Seat 4: apoch19 (41844 in chips)=20
Seat 5: DomBagz (91558 in chips)=20
Seat 6: TrademarkTer (84075 in chips)=20
Seat 7: SourDforMe (34945 in chips)=20
Seat 8: MM9955 (216547 in chips)=20
smitheea: posts the ante 375
JJin91: posts the ante 375
apoch19: posts the ante 375
DomBagz: posts the ante 375
TrademarkTer: posts the ante 375
SourDforMe: posts the ante 375
MM9955: posts the ante 375
DomBagz: posts small blind 1500
TrademarkTer: posts big blind 3000
*** HOLE CARDS ***
Dealt to JJin91 [6h 4h]
SourDforMe: folds=20
MM9955: folds=20
smitheea: folds=20
JJin91: folds=20
apoch19: raises 38469 to 41469 and is all-in
DomBagz: folds=20
TrademarkTer: folds=20
Uncalled bet (38469) returned to apoch19
apoch19 collected 10125 from pot
apoch19: doesn't show hand=20
*** SUMMARY ***
Total pot 10125 | Rake 0=20
Seat 1: smitheea folded before Flop (didn't bet)
Seat 2: JJin91 folded before Flop (didn't bet)
Seat 4: apoch19 (button) collected (10125)
Seat 5: DomBagz (small blind) folded before Flop
Seat 6: TrademarkTer (big blind) folded before Flop
Seat 7: SourDforMe folded before Flop (didn't bet)
Seat 8: MM9955 folded before Flop (didn't bet)


*********** # 196 **************
PokerStars Hand #169452564571: Tournament #1597684021, $18.20+$1.80 USD=
 Hold'em No Limit - Level XXI (1500/3000) - 2017/05/05 22:47:24 ET
Table '1597684021 1' 9-max Seat #5 is the button
Seat 1: smitheea (147525 in chips)=20
Seat 2: JJin91 (49727 in chips)=20
Seat 4: apoch19 (48594 in chips)=20
Seat 5: DomBagz (89683 in chips)=20
Seat 6: TrademarkTer (80700 in chips)=20
Seat 7: SourDforMe (34570 in chips)=20
Seat 8: MM9955 (216172 in chips)=20
smitheea: posts the ante 375
JJin91: posts the ante 375
apoch19: posts the ante 375
DomBagz: posts the ante 375
TrademarkTer: posts the ante 375
SourDforMe: posts the ante 375
MM9955: posts the ante 375
TrademarkTer: posts small blind 1500
SourDforMe: posts big blind 3000
*** HOLE CARDS ***
Dealt to JJin91 [9c 4s]
MM9955: folds=20
smitheea: raises 6000 to 9000
JJin91: folds=20
apoch19: folds=20
DomBagz: folds=20
TrademarkTer: folds=20
SourDforMe: raises 25195 to 34195 and is all-in
smitheea: folds=20
Uncalled bet (25195) returned to SourDforMe
SourDforMe collected 22125 from pot
SourDforMe: shows [Ah Qd] (high card Ace)
*** SUMMARY ***
Total pot 22125 | Rake 0=20
Seat 1: smitheea folded before Flop
Seat 2: JJin91 folded before Flop (didn't bet)
Seat 4: apoch19 folded before Flop (didn't bet)
Seat 5: DomBagz (button) folded before Flop (didn't bet)
Seat 6: TrademarkTer (small blind) folded before Flop
Seat 7: SourDforMe (big blind) collected (22125)
Seat 8: MM9955 folded before Flop (didn't bet)


*********** # 197 **************
PokerStars Hand #169452564665: Tournament #1597684021, $18.20+$1.80 USD=
 Hold'em No Limit - Level XXI (1500/3000) - 2017/05/05 22:47:44 ET
Table '1597684021 1' 9-max Seat #6 is the button
Seat 1: smitheea (138150 in chips)=20
Seat 2: JJin91 (49352 in chips)=20
Seat 4: apoch19 (48219 in chips)=20
Seat 5: DomBagz (89308 in chips)=20
Seat 6: TrademarkTer (78825 in chips)=20
Seat 7: SourDforMe (47320 in chips)=20
Seat 8: MM9955 (215797 in chips)=20
smitheea: posts the ante 375
JJin91: posts the ante 375
apoch19: posts the ante 375
DomBagz: posts the ante 375
TrademarkTer: posts the ante 375
SourDforMe: posts the ante 375
MM9955: posts the ante 375
SourDforMe: posts small blind 1500
MM9955: posts big blind 3000
*** HOLE CARDS ***
Dealt to JJin91 [9s Qs]
smitheea: folds=20
JJin91: folds=20
apoch19: raises 4520 to 7520
DomBagz: folds=20
TrademarkTer: folds=20
SourDforMe: folds=20
MM9955: folds=20
Uncalled bet (4520) returned to apoch19
apoch19 collected 10125 from pot
apoch19: doesn't show hand=20
*** SUMMARY ***
Total pot 10125 | Rake 0=20
Seat 1: smitheea folded before Flop (didn't bet)
Seat 2: JJin91 folded before Flop (didn't bet)
Seat 4: apoch19 collected (10125)
Seat 5: DomBagz folded before Flop (didn't bet)
Seat 6: TrademarkTer (button) folded before Flop (didn't bet)
Seat 7: SourDforMe (small blind) folded before Flop
Seat 8: MM9955 (big blind) folded before Flop


*********** # 198 **************
PokerStars Hand #169452564780: Tournament #1597684021, $18.20+$1.80 USD=
 Hold'em No Limit - Level XXII (2000/4000) - 2017/05/05 22:48:12 ET
Table '1597684021 1' 9-max Seat #7 is the button
Seat 1: smitheea (137775 in chips)=20
Seat 2: JJin91 (48977 in chips)=20
Seat 4: apoch19 (54969 in chips)=20
Seat 5: DomBagz (88933 in chips)=20
Seat 6: TrademarkTer (78450 in chips)=20
Seat 7: SourDforMe (45445 in chips)=20
Seat 8: MM9955 (212422 in chips)=20
smitheea: posts the ante 500
JJin91: posts the ante 500
apoch19: posts the ante 500
DomBagz: posts the ante 500
TrademarkTer: posts the ante 500
SourDforMe: posts the ante 500
MM9955: posts the ante 500
MM9955: posts small blind 2000
smitheea: posts big blind 4000
*** HOLE CARDS ***
Dealt to JJin91 [9d 8c]
JJin91: folds=20
apoch19: raises 50469 to 54469 and is all-in
DomBagz: folds=20
TrademarkTer: folds=20
SourDforMe: calls 44945 and is all-in
MM9955: folds=20
smitheea: folds=20
Uncalled bet (9524) returned to apoch19
*** FLOP *** [8d 9s 3h]
*** TURN *** [8d 9s 3h] [8h]
*** RIVER *** [8d 9s 3h 8h] [2d]
*** SHOW DOWN ***
apoch19: shows [7h 7d] (two pair, Eights and Sevens)
SourDforMe: shows [Qs Ad] (a pair of Eights)
apoch19 collected 99390 from pot
SourDforMe finished the tournament in 14th place and received $44.99.
*** SUMMARY ***
Total pot 99390 | Rake 0=20
Board [8d 9s 3h 8h 2d]
Seat 1: smitheea (big blind) folded before Flop
Seat 2: JJin91 folded before Flop (didn't bet)
Seat 4: apoch19 showed [7h 7d] and won (99390) with two pair, Eights an=
d Sevens
Seat 5: DomBagz folded before Flop (didn't bet)
Seat 6: TrademarkTer folded before Flop (didn't bet)
Seat 7: SourDforMe (button) showed [Qs Ad] and lost with a pair of Eigh=
ts
Seat 8: MM9955 (small blind) folded before Flop


*********** # 199 **************
PokerStars Hand #169452564887: Tournament #1597684021, $18.20+$1.80 USD=
 Hold'em No Limit - Level XXII (2000/4000) - 2017/05/05 22:48:39 ET
Table '1597684021 1' 9-max Seat #8 is the button
Seat 1: smitheea (133275 in chips)=20
Seat 2: JJin91 (48477 in chips)=20
Seat 4: apoch19 (108914 in chips)=20
Seat 5: DomBagz (88433 in chips)=20
Seat 6: TrademarkTer (77950 in chips)=20
Seat 8: MM9955 (209922 in chips)=20
smitheea: posts the ante 500
JJin91: posts the ante 500
apoch19: posts the ante 500
DomBagz: posts the ante 500
TrademarkTer: posts the ante 500
MM9955: posts the ante 500
smitheea: posts small blind 2000
JJin91: posts big blind 4000
*** HOLE CARDS ***
Dealt to JJin91 [Ac 8h]
apoch19: folds=20
DomBagz: folds=20
TrademarkTer: folds=20
MM9955: folds=20
smitheea: raises 8000 to 12000
JJin91: raises 35977 to 47977 and is all-in
smitheea: folds=20
Uncalled bet (35977) returned to JJin91
JJin91 collected 27000 from pot
JJin91: doesn't show hand=20
*** SUMMARY ***
Total pot 27000 | Rake 0=20
Seat 1: smitheea (small blind) folded before Flop
Seat 2: JJin91 (big blind) collected (27000)
Seat 4: apoch19 folded before Flop (didn't bet)
Seat 5: DomBagz folded before Flop (didn't bet)
Seat 6: TrademarkTer folded before Flop (didn't bet)
Seat 8: MM9955 (button) folded before Flop (didn't bet)


*********** # 200 **************
PokerStars Hand #169452565026: Tournament #1597684021, $18.20+$1.80 USD=
 Hold'em No Limit - Level XXII (2000/4000) - 2017/05/05 22:49:06 ET
Table '1597684021 1' 9-max Seat #1 is the button
Seat 1: smitheea (120775 in chips)=20
Seat 2: JJin91 (62977 in chips)=20
Seat 4: apoch19 (108414 in chips)=20
Seat 5: DomBagz (87933 in chips)=20
Seat 6: TrademarkTer (77450 in chips)=20
Seat 8: MM9955 (209422 in chips)=20
smitheea: posts the ante 500
JJin91: posts the ante 500
apoch19: posts the ante 500
DomBagz: posts the ante 500
TrademarkTer: posts the ante 500
MM9955: posts the ante 500
JJin91: posts small blind 2000
apoch19: posts big blind 4000
*** HOLE CARDS ***
Dealt to JJin91 [5h Qh]
DomBagz: folds=20
TrademarkTer: folds=20
MM9955: folds=20
smitheea: folds=20
JJin91: raises 58477 to 62477 and is all-in
apoch19: folds=20
Uncalled bet (58477) returned to JJin91
JJin91 collected 11000 from pot
JJin91: doesn't show hand=20
*** SUMMARY ***
Total pot 11000 | Rake 0=20
Seat 1: smitheea (button) folded before Flop (didn't bet)
Seat 2: JJin91 (small blind) collected (11000)
Seat 4: apoch19 (big blind) folded before Flop
Seat 5: DomBagz folded before Flop (didn't bet)
Seat 6: TrademarkTer folded before Flop (didn't bet)
Seat 8: MM9955 folded before Flop (didn't bet)


*********** # 201 **************
PokerStars Hand #169452565076: Tournament #1597684021, $18.20+$1.80 USD=
 Hold'em No Limit - Level XXII (2000/4000) - 2017/05/05 22:49:19 ET
Table '1597684021 1' 9-max Seat #2 is the button
Seat 1: smitheea (120275 in chips)=20
Seat 2: JJin91 (69477 in chips)=20
Seat 4: apoch19 (103914 in chips)=20
Seat 5: DomBagz (87433 in chips)=20
Seat 6: TrademarkTer (76950 in chips)=20
Seat 8: MM9955 (208922 in chips)=20
smitheea: posts the ante 500
JJin91: posts the ante 500
apoch19: posts the ante 500
DomBagz: posts the ante 500
TrademarkTer: posts the ante 500
MM9955: posts the ante 500
apoch19: posts small blind 2000
DomBagz: posts big blind 4000
*** HOLE CARDS ***
Dealt to JJin91 [7s 4d]
TrademarkTer: folds=20
MM9955: folds=20
smitheea: raises 8000 to 12000
JJin91: folds=20
apoch19: folds=20
DomBagz: raises 20000 to 32000
smitheea: calls 20000
*** FLOP *** [7h 6s 4h]
DomBagz: bets 54933 and is all-in
smitheea: folds=20
Uncalled bet (54933) returned to DomBagz
DomBagz collected 69000 from pot
DomBagz: doesn't show hand=20
*** SUMMARY ***
Total pot 69000 | Rake 0=20
Board [7h 6s 4h]
Seat 1: smitheea folded on the Flop
Seat 2: JJin91 (button) folded before Flop (didn't bet)
Seat 4: apoch19 (small blind) folded before Flop
Seat 5: DomBagz (big blind) collected (69000)
Seat 6: TrademarkTer folded before Flop (didn't bet)
Seat 8: MM9955 folded before Flop (didn't bet)


*********** # 202 **************
PokerStars Hand #169452565255: Tournament #1597684021, $18.20+$1.80 USD=
 Hold'em No Limit - Level XXII (2000/4000) - 2017/05/05 22:49:58 ET
Table '1597684021 1' 9-max Seat #4 is the button
Seat 1: smitheea (87775 in chips)=20
Seat 2: JJin91 (68977 in chips)=20
Seat 4: apoch19 (101414 in chips)=20
Seat 5: DomBagz (123933 in chips)=20
Seat 6: TrademarkTer (76450 in chips)=20
Seat 8: MM9955 (208422 in chips)=20
smitheea: posts the ante 500
JJin91: posts the ante 500
apoch19: posts the ante 500
DomBagz: posts the ante 500
TrademarkTer: posts the ante 500
MM9955: posts the ante 500
DomBagz: posts small blind 2000
TrademarkTer: posts big blind 4000
*** HOLE CARDS ***
Dealt to JJin91 [4s Ks]
MM9955: raises 8000 to 12000
smitheea: folds=20
JJin91: folds=20
apoch19: folds=20
DomBagz: folds=20
TrademarkTer: folds=20
Uncalled bet (8000) returned to MM9955
MM9955 collected 13000 from pot
MM9955: doesn't show hand=20
*** SUMMARY ***
Total pot 13000 | Rake 0=20
Seat 1: smitheea folded before Flop (didn't bet)
Seat 2: JJin91 folded before Flop (didn't bet)
Seat 4: apoch19 (button) folded before Flop (didn't bet)
Seat 5: DomBagz (small blind) folded before Flop
Seat 6: TrademarkTer (big blind) folded before Flop
Seat 8: MM9955 collected (13000)


*********** # 203 **************
PokerStars Hand #169452565366: Tournament #1597684021, $18.20+$1.80 USD=
 Hold'em No Limit - Level XXII (2000/4000) - 2017/05/05 22:50:23 ET
Table '1597684021 1' 9-max Seat #5 is the button
Seat 1: smitheea (87275 in chips)=20
Seat 2: JJin91 (68477 in chips)=20
Seat 4: apoch19 (100914 in chips)=20
Seat 5: DomBagz (121433 in chips)=20
Seat 6: TrademarkTer (71950 in chips)=20
Seat 8: MM9955 (216922 in chips)=20
smitheea: posts the ante 500
JJin91: posts the ante 500
apoch19: posts the ante 500
DomBagz: posts the ante 500
TrademarkTer: posts the ante 500
MM9955: posts the ante 500
TrademarkTer: posts small blind 2000
MM9955: posts big blind 4000
*** HOLE CARDS ***
Dealt to JJin91 [Td Tc]
smitheea: folds=20
JJin91: raises 4760 to 8760
apoch19: folds=20
DomBagz: calls 8760
TrademarkTer: folds=20
MM9955: calls 4760
*** FLOP *** [8h 9h 4s]
MM9955: bets 12000
JJin91: raises 47217 to 59217 and is all-in
DomBagz: folds=20
MM9955: calls 47217
*** TURN *** [8h 9h 4s] [4c]
*** RIVER *** [8h 9h 4s 4c] [Ks]
*** SHOW DOWN ***
MM9955: shows [Ah 9s] (two pair, Nines and Fours)
JJin91: shows [Td Tc] (two pair, Tens and Fours)
JJin91 collected 149714 from pot
*** SUMMARY ***
Total pot 149714 | Rake 0=20
Board [8h 9h 4s 4c Ks]
Seat 1: smitheea folded before Flop (didn't bet)
Seat 2: JJin91 showed [Td Tc] and won (149714) with two pair, Tens and =
Fours
Seat 4: apoch19 folded before Flop (didn't bet)
Seat 5: DomBagz (button) folded on the Flop
Seat 6: TrademarkTer (small blind) folded before Flop
Seat 8: MM9955 (big blind) showed [Ah 9s] and lost with two pair, Nines=
 and Fours


*********** # 204 **************
PokerStars Hand #169452565614: Tournament #1597684021, $18.20+$1.80 USD=
 Hold'em No Limit - Level XXII (2000/4000) - 2017/05/05 22:51:17 ET
Table '1597684021 1' 9-max Seat #6 is the button
Seat 1: smitheea (86775 in chips)=20
Seat 2: JJin91 (149714 in chips)=20
Seat 4: apoch19 (100414 in chips)=20
Seat 5: DomBagz (112173 in chips)=20
Seat 6: TrademarkTer (69450 in chips)=20
Seat 8: MM9955 (148445 in chips)=20
smitheea: posts the ante 500
JJin91: posts the ante 500
apoch19: posts the ante 500
DomBagz: posts the ante 500
TrademarkTer: posts the ante 500
MM9955: posts the ante 500
MM9955: posts small blind 2000
smitheea: posts big blind 4000
*** HOLE CARDS ***
Dealt to JJin91 [Qs Th]
JJin91: folds=20
apoch19: folds=20
DomBagz: folds=20
TrademarkTer: folds=20
MM9955: raises 8000 to 12000
smitheea: folds=20
Uncalled bet (8000) returned to MM9955
MM9955 collected 11000 from pot
MM9955: doesn't show hand=20
*** SUMMARY ***
Total pot 11000 | Rake 0=20
Seat 1: smitheea (big blind) folded before Flop
Seat 2: JJin91 folded before Flop (didn't bet)
Seat 4: apoch19 folded before Flop (didn't bet)
Seat 5: DomBagz folded before Flop (didn't bet)
Seat 6: TrademarkTer (button) folded before Flop (didn't bet)
Seat 8: MM9955 (small blind) collected (11000)


*********** # 205 **************
PokerStars Hand #169452565692: Tournament #1597684021, $18.20+$1.80 USD=
 Hold'em No Limit - Level XXII (2000/4000) - 2017/05/05 22:51:36 ET
Table '1597684021 1' 9-max Seat #8 is the button
Seat 1: smitheea (82275 in chips)=20
Seat 2: JJin91 (149214 in chips)=20
Seat 4: apoch19 (99914 in chips)=20
Seat 5: DomBagz (111673 in chips)=20
Seat 6: TrademarkTer (68950 in chips)=20
Seat 8: MM9955 (154945 in chips)=20
smitheea: posts the ante 500
JJin91: posts the ante 500
apoch19: posts the ante 500
DomBagz: posts the ante 500
TrademarkTer: posts the ante 500
MM9955: posts the ante 500
smitheea: posts small blind 2000
JJin91: posts big blind 4000
*** HOLE CARDS ***
Dealt to JJin91 [5s 7d]
apoch19: folds=20
DomBagz: folds=20
TrademarkTer: raises 4000 to 8000
MM9955: calls 8000
smitheea: folds=20
JJin91: calls 4000
*** FLOP *** [3h Js 8c]
JJin91: checks=20
TrademarkTer: checks=20
MM9955: bets 14500
JJin91: folds=20
TrademarkTer: folds=20
Uncalled bet (14500) returned to MM9955
MM9955 collected 29000 from pot
MM9955: doesn't show hand=20
*** SUMMARY ***
Total pot 29000 | Rake 0=20
Board [3h Js 8c]
Seat 1: smitheea (small blind) folded before Flop
Seat 2: JJin91 (big blind) folded on the Flop
Seat 4: apoch19 folded before Flop (didn't bet)
Seat 5: DomBagz folded before Flop (didn't bet)
Seat 6: TrademarkTer folded on the Flop
Seat 8: MM9955 (button) collected (29000)


*********** # 206 **************
PokerStars Hand #169452565798: Tournament #1597684021, $18.20+$1.80 USD=
 Hold'em No Limit - Level XXII (2000/4000) - 2017/05/05 22:52:00 ET
Table '1597684021 1' 9-max Seat #1 is the button
Seat 1: smitheea (79775 in chips)=20
Seat 2: JJin91 (140714 in chips)=20
Seat 4: apoch19 (99414 in chips)=20
Seat 5: DomBagz (111173 in chips)=20
Seat 6: TrademarkTer (60450 in chips)=20
Seat 8: MM9955 (175445 in chips)=20
smitheea: posts the ante 500
JJin91: posts the ante 500
apoch19: posts the ante 500
DomBagz: posts the ante 500
TrademarkTer: posts the ante 500
MM9955: posts the ante 500
JJin91: posts small blind 2000
apoch19: posts big blind 4000
*** HOLE CARDS ***
Dealt to JJin91 [Ac 5h]
DomBagz: folds=20
TrademarkTer: calls 4000
MM9955: folds=20
smitheea: folds=20
JJin91: raises 8000 to 12000
apoch19: folds=20
TrademarkTer: calls 8000
*** FLOP *** [4d Td 2c]
JJin91: checks=20
TrademarkTer: checks=20
*** TURN *** [4d Td 2c] [Jh]
JJin91: bets 16430
TrademarkTer: folds=20
Uncalled bet (16430) returned to JJin91
JJin91 collected 31000 from pot
JJin91: doesn't show hand=20
*** SUMMARY ***
Total pot 31000 | Rake 0=20
Board [4d Td 2c Jh]
Seat 1: smitheea (button) folded before Flop (didn't bet)
Seat 2: JJin91 (small blind) collected (31000)
Seat 4: apoch19 (big blind) folded before Flop
Seat 5: DomBagz folded before Flop (didn't bet)
Seat 6: TrademarkTer folded on the Turn
Seat 8: MM9955 folded before Flop (didn't bet)


*********** # 207 **************
PokerStars Hand #169452566034: Tournament #1597684021, $18.20+$1.80 USD=
 Hold'em No Limit - Level XXII (2000/4000) - 2017/05/05 22:52:48 ET
Table '1597684021 1' 9-max Seat #2 is the button
Seat 1: smitheea (79275 in chips)=20
Seat 2: JJin91 (159214 in chips)=20
Seat 4: apoch19 (94914 in chips)=20
Seat 5: DomBagz (110673 in chips)=20
Seat 6: TrademarkTer (47950 in chips)=20
Seat 8: MM9955 (174945 in chips)=20
smitheea: posts the ante 500
JJin91: posts the ante 500
apoch19: posts the ante 500
DomBagz: posts the ante 500
TrademarkTer: posts the ante 500
MM9955: posts the ante 500
apoch19: posts small blind 2000
DomBagz: posts big blind 4000
*** HOLE CARDS ***
Dealt to JJin91 [Kh Ac]
TrademarkTer: folds=20
MM9955: folds=20
smitheea: folds=20
JJin91: raises 4760 to 8760
apoch19: folds=20
DomBagz: folds=20
Uncalled bet (4760) returned to JJin91
JJin91 collected 13000 from pot
JJin91: doesn't show hand=20
*** SUMMARY ***
Total pot 13000 | Rake 0=20
Seat 1: smitheea folded before Flop (didn't bet)
Seat 2: JJin91 (button) collected (13000)
Seat 4: apoch19 (small blind) folded before Flop
Seat 5: DomBagz (big blind) folded before Flop
Seat 6: TrademarkTer folded before Flop (didn't bet)
Seat 8: MM9955 folded before Flop (didn't bet)


*********** # 208 **************
PokerStars Hand #169452566120: Tournament #1597684021, $18.20+$1.80 USD=
 Hold'em No Limit - Level XXII (2000/4000) - 2017/05/05 22:53:07 ET
Table '1597684021 1' 9-max Seat #4 is the button
Seat 1: smitheea (78775 in chips)=20
Seat 2: JJin91 (167714 in chips)=20
Seat 4: apoch19 (92414 in chips)=20
Seat 5: DomBagz (106173 in chips)=20
Seat 6: TrademarkTer (47450 in chips)=20
Seat 8: MM9955 (174445 in chips)=20
smitheea: posts the ante 500
JJin91: posts the ante 500
apoch19: posts the ante 500
DomBagz: posts the ante 500
TrademarkTer: posts the ante 500
MM9955: posts the ante 500
DomBagz: posts small blind 2000
TrademarkTer: posts big blind 4000
*** HOLE CARDS ***
Dealt to JJin91 [Jd 9c]
MM9955: folds=20
smitheea: folds=20
JJin91: folds=20
apoch19: folds=20
DomBagz: raises 101673 to 105673 and is all-in
TrademarkTer: folds=20
Uncalled bet (101673) returned to DomBagz
DomBagz collected 11000 from pot
DomBagz: doesn't show hand=20
*** SUMMARY ***
Total pot 11000 | Rake 0=20
Seat 1: smitheea folded before Flop (didn't bet)
Seat 2: JJin91 folded before Flop (didn't bet)
Seat 4: apoch19 (button) folded before Flop (didn't bet)
Seat 5: DomBagz (small blind) collected (11000)
Seat 6: TrademarkTer (big blind) folded before Flop
Seat 8: MM9955 folded before Flop (didn't bet)


*********** # 209 **************
PokerStars Hand #169452566248: Tournament #1597684021, $18.20+$1.80 USD=
 Hold'em No Limit - Level XXII (2000/4000) - 2017/05/05 22:53:33 ET
Table '1597684021 1' 9-max Seat #5 is the button
Seat 1: smitheea (78275 in chips)=20
Seat 2: JJin91 (167214 in chips)=20
Seat 4: apoch19 (91914 in chips)=20
Seat 5: DomBagz (112673 in chips)=20
Seat 6: TrademarkTer (42950 in chips)=20
Seat 8: MM9955 (173945 in chips)=20
smitheea: posts the ante 500
JJin91: posts the ante 500
apoch19: posts the ante 500
DomBagz: posts the ante 500
TrademarkTer: posts the ante 500
MM9955: posts the ante 500
TrademarkTer: posts small blind 2000
MM9955: posts big blind 4000
*** HOLE CARDS ***
Dealt to JJin91 [6c Td]
smitheea: raises 8000 to 12000
JJin91: folds=20
apoch19: folds=20
DomBagz: calls 12000
TrademarkTer: folds=20
MM9955: folds=20
*** FLOP *** [2c 8h 4h]
smitheea: checks=20
DomBagz: checks=20
*** TURN *** [2c 8h 4h] [9d]
smitheea: bets 33000
DomBagz: folds=20
Uncalled bet (33000) returned to smitheea
smitheea collected 33000 from pot
smitheea: doesn't show hand=20
*** SUMMARY ***
Total pot 33000 | Rake 0=20
Board [2c 8h 4h 9d]
Seat 1: smitheea collected (33000)
Seat 2: JJin91 folded before Flop (didn't bet)
Seat 4: apoch19 folded before Flop (didn't bet)
Seat 5: DomBagz (button) folded on the Turn
Seat 6: TrademarkTer (small blind) folded before Flop
Seat 8: MM9955 (big blind) folded before Flop


*********** # 210 **************
PokerStars Hand #169452566439: Tournament #1597684021, $18.20+$1.80 USD=
 Hold'em No Limit - Level XXII (2000/4000) - 2017/05/05 22:54:15 ET
Table '1597684021 1' 9-max Seat #6 is the button
Seat 1: smitheea (98775 in chips)=20
Seat 2: JJin91 (166714 in chips)=20
Seat 4: apoch19 (91414 in chips)=20
Seat 5: DomBagz (100173 in chips)=20
Seat 6: TrademarkTer (40450 in chips)=20
Seat 8: MM9955 (169445 in chips)=20
smitheea: posts the ante 500
JJin91: posts the ante 500
apoch19: posts the ante 500
DomBagz: posts the ante 500
TrademarkTer: posts the ante 500
MM9955: posts the ante 500
MM9955: posts small blind 2000
smitheea: posts big blind 4000
*** HOLE CARDS ***
Dealt to JJin91 [4s Td]
JJin91: folds=20
apoch19: folds=20
DomBagz: folds=20
TrademarkTer: folds=20
MM9955: calls 2000
smitheea: checks=20
*** FLOP *** [Js 6c 3c]
MM9955: bets 4000
smitheea: folds=20
Uncalled bet (4000) returned to MM9955
MM9955 collected 11000 from pot
MM9955: doesn't show hand=20
*** SUMMARY ***
Total pot 11000 | Rake 0=20
Board [Js 6c 3c]
Seat 1: smitheea (big blind) folded on the Flop
Seat 2: JJin91 folded before Flop (didn't bet)
Seat 4: apoch19 folded before Flop (didn't bet)
Seat 5: DomBagz folded before Flop (didn't bet)
Seat 6: TrademarkTer (button) folded before Flop (didn't bet)
Seat 8: MM9955 (small blind) collected (11000)


*********** # 211 **************
PokerStars Hand #169452566548: Tournament #1597684021, $18.20+$1.80 USD=
 Hold'em No Limit - Level XXII (2000/4000) - 2017/05/05 22:54:38 ET
Table '1597684021 1' 9-max Seat #8 is the button
Seat 1: smitheea (94275 in chips)=20
Seat 2: JJin91 (166214 in chips)=20
Seat 4: apoch19 (90914 in chips)=20
Seat 5: DomBagz (99673 in chips)=20
Seat 6: TrademarkTer (39950 in chips)=20
Seat 8: MM9955 (175945 in chips)=20
smitheea: posts the ante 500
JJin91: posts the ante 500
apoch19: posts the ante 500
DomBagz: posts the ante 500
TrademarkTer: posts the ante 500
MM9955: posts the ante 500
smitheea: posts small blind 2000
JJin91: posts big blind 4000
*** HOLE CARDS ***
Dealt to JJin91 [Ac 2d]
apoch19: folds=20
DomBagz: raises 4000 to 8000
TrademarkTer: folds=20
MM9955: folds=20
smitheea: folds=20
JJin91: calls 4000
*** FLOP *** [Kh 3h Ah]
JJin91: bets 11130
DomBagz: folds=20
Uncalled bet (11130) returned to JJin91
JJin91 collected 21000 from pot
JJin91: doesn't show hand=20
*** SUMMARY ***
Total pot 21000 | Rake 0=20
Board [Kh 3h Ah]
Seat 1: smitheea (small blind) folded before Flop
Seat 2: JJin91 (big blind) collected (21000)
Seat 4: apoch19 folded before Flop (didn't bet)
Seat 5: DomBagz folded on the Flop
Seat 6: TrademarkTer folded before Flop (didn't bet)
Seat 8: MM9955 (button) folded before Flop (didn't bet)


*********** # 212 **************
PokerStars Hand #169452566642: Tournament #1597684021, $18.20+$1.80 USD=
 Hold'em No Limit - Level XXII (2000/4000) - 2017/05/05 22:55:04 ET
Table '1597684021 1' 9-max Seat #1 is the button
Seat 1: smitheea (91775 in chips)=20
Seat 2: JJin91 (178714 in chips)=20
Seat 4: apoch19 (90414 in chips)=20
Seat 5: DomBagz (91173 in chips)=20
Seat 6: TrademarkTer (39450 in chips)=20
Seat 8: MM9955 (175445 in chips)=20
smitheea: posts the ante 500
JJin91: posts the ante 500
apoch19: posts the ante 500
DomBagz: posts the ante 500
TrademarkTer: posts the ante 500
MM9955: posts the ante 500
JJin91: posts small blind 2000
apoch19: posts big blind 4000
*** HOLE CARDS ***
Dealt to JJin91 [Ad 5d]
DomBagz: raises 4000 to 8000
TrademarkTer: folds=20
MM9955: folds=20
smitheea: folds=20
JJin91: calls 6000
apoch19: calls 4000
*** FLOP *** [3d 5h 8c]
JJin91: checks=20
apoch19: checks=20
DomBagz: bets 20000
JJin91: folds=20
apoch19: folds=20
Uncalled bet (20000) returned to DomBagz
DomBagz collected 27000 from pot
DomBagz: doesn't show hand=20
*** SUMMARY ***
Total pot 27000 | Rake 0=20
Board [3d 5h 8c]
Seat 1: smitheea (button) folded before Flop (didn't bet)
Seat 2: JJin91 (small blind) folded on the Flop
Seat 4: apoch19 (big blind) folded on the Flop
Seat 5: DomBagz collected (27000)
Seat 6: TrademarkTer folded before Flop (didn't bet)
Seat 8: MM9955 folded before Flop (didn't bet)


*********** # 213 **************
PokerStars Hand #169452567783: Tournament #1597684021, $18.20+$1.80 USD=
 Hold'em No Limit - Level XXII (2000/4000) - 2017/05/05 23:00:35 ET
Table '1597684021 1' 9-max Seat #2 is the button
Seat 1: smitheea (91275 in chips)=20
Seat 2: JJin91 (170214 in chips)=20
Seat 4: apoch19 (81914 in chips)=20
Seat 5: DomBagz (109673 in chips) is sitting out
Seat 6: TrademarkTer (38950 in chips)=20
Seat 8: MM9955 (174945 in chips)=20
smitheea: posts the ante 500
JJin91: posts the ante 500
apoch19: posts the ante 500
DomBagz: posts the ante 500
TrademarkTer: posts the ante 500
MM9955: posts the ante 500
apoch19: posts small blind 2000
DomBagz: posts big blind 4000
*** HOLE CARDS ***
Dealt to JJin91 [Ac Jd]
TrademarkTer: folds=20
MM9955: folds=20
smitheea: raises 8000 to 12000
JJin91: calls 12000
apoch19: folds=20
DomBagz: folds=20
*** FLOP *** [2h Ts Kc]
smitheea: bets 19800
JJin91: calls 19800
*** TURN *** [2h Ts Kc] [5c]
smitheea: checks=20
JJin91: bets 22506
smitheea: raises 36469 to 58975 and is all-in
JJin91: folds=20
Uncalled bet (36469) returned to smitheea
smitheea collected 117612 from pot
smitheea: doesn't show hand=20
*** SUMMARY ***
Total pot 117612 | Rake 0=20
Board [2h Ts Kc 5c]
Seat 1: smitheea collected (117612)
Seat 2: JJin91 (button) folded on the Turn
Seat 4: apoch19 (small blind) folded before Flop
Seat 5: DomBagz (big blind) folded before Flop
Seat 6: TrademarkTer folded before Flop (didn't bet)
Seat 8: MM9955 folded before Flop (didn't bet)


*********** # 214 **************
PokerStars Hand #169452567981: Tournament #1597684021, $18.20+$1.80 USD=
 Hold'em No Limit - Level XXII (2000/4000) - 2017/05/05 23:01:19 ET
Table '1597684021 1' 9-max Seat #4 is the button
Seat 1: smitheea (154081 in chips)=20
Seat 2: JJin91 (115408 in chips)=20
Seat 4: apoch19 (79414 in chips)=20
Seat 5: DomBagz (105173 in chips) is sitting out
Seat 6: TrademarkTer (38450 in chips)=20
Seat 8: MM9955 (174445 in chips)=20
smitheea: posts the ante 500
JJin91: posts the ante 500
apoch19: posts the ante 500
DomBagz: posts the ante 500
TrademarkTer: posts the ante 500
MM9955: posts the ante 500
DomBagz: posts small blind 2000
TrademarkTer: posts big blind 4000
*** HOLE CARDS ***
Dealt to JJin91 [4c 9d]
MM9955: raises 4000 to 8000
smitheea: folds=20
JJin91: folds=20
apoch19: folds=20
DomBagz: folds=20
TrademarkTer: folds=20
Uncalled bet (4000) returned to MM9955
MM9955 collected 13000 from pot
MM9955: doesn't show hand=20
*** SUMMARY ***
Total pot 13000 | Rake 0=20
Seat 1: smitheea folded before Flop (didn't bet)
Seat 2: JJin91 folded before Flop (didn't bet)
Seat 4: apoch19 (button) folded before Flop (didn't bet)
Seat 5: DomBagz (small blind) folded before Flop
Seat 6: TrademarkTer (big blind) folded before Flop
Seat 8: MM9955 collected (13000)


*********** # 215 **************
PokerStars Hand #169452568019: Tournament #1597684021, $18.20+$1.80 USD=
 Hold'em No Limit - Level XXII (2000/4000) - 2017/05/05 23:01:31 ET
Table '1597684021 1' 9-max Seat #5 is the button
Seat 1: smitheea (153581 in chips)=20
Seat 2: JJin91 (114908 in chips)=20
Seat 4: apoch19 (78914 in chips)=20
Seat 5: DomBagz (102673 in chips) is sitting out
Seat 6: TrademarkTer (33950 in chips)=20
Seat 8: MM9955 (182945 in chips)=20
smitheea: posts the ante 500
JJin91: posts the ante 500
apoch19: posts the ante 500
DomBagz: posts the ante 500
TrademarkTer: posts the ante 500
MM9955: posts the ante 500
TrademarkTer: posts small blind 2000
MM9955: posts big blind 4000
*** HOLE CARDS ***
Dealt to JJin91 [3d Ts]
smitheea: folds=20
JJin91: folds=20
apoch19: raises 5822 to 9822
DomBagz: folds=20
TrademarkTer: folds=20
MM9955: folds=20
Uncalled bet (5822) returned to apoch19
apoch19 collected 13000 from pot
apoch19: doesn't show hand=20
*** SUMMARY ***
Total pot 13000 | Rake 0=20
Seat 1: smitheea folded before Flop (didn't bet)
Seat 2: JJin91 folded before Flop (didn't bet)
Seat 4: apoch19 collected (13000)
Seat 5: DomBagz (button) folded before Flop (didn't bet)
Seat 6: TrademarkTer (small blind) folded before Flop
Seat 8: MM9955 (big blind) folded before Flop


*********** # 216 **************
PokerStars Hand #169452568083: Tournament #1597684021, $18.20+$1.80 USD=
 Hold'em No Limit - Level XXII (2000/4000) - 2017/05/05 23:01:44 ET
Table '1597684021 1' 9-max Seat #6 is the button
Seat 1: smitheea (153081 in chips)=20
Seat 2: JJin91 (114408 in chips)=20
Seat 4: apoch19 (87414 in chips)=20
Seat 5: DomBagz (102173 in chips) is sitting out
Seat 6: TrademarkTer (31450 in chips)=20
Seat 8: MM9955 (178445 in chips)=20
smitheea: posts the ante 500
JJin91: posts the ante 500
apoch19: posts the ante 500
DomBagz: posts the ante 500
TrademarkTer: posts the ante 500
MM9955: posts the ante 500
MM9955: posts small blind 2000
smitheea: posts big blind 4000
*** HOLE CARDS ***
Dealt to JJin91 [4h Qs]
DomBagz has returned
JJin91: folds=20
apoch19: raises 5822 to 9822
DomBagz: folds=20
TrademarkTer: folds=20
MM9955: folds=20
smitheea: folds=20
Uncalled bet (5822) returned to apoch19
apoch19 collected 13000 from pot
apoch19: doesn't show hand=20
*** SUMMARY ***
Total pot 13000 | Rake 0=20
Seat 1: smitheea (big blind) folded before Flop
Seat 2: JJin91 folded before Flop (didn't bet)
Seat 4: apoch19 collected (13000)
Seat 5: DomBagz folded before Flop (didn't bet)
Seat 6: TrademarkTer (button) folded before Flop (didn't bet)
Seat 8: MM9955 (small blind) folded before Flop


*********** # 217 **************
PokerStars Hand #169452568157: Tournament #1597684021, $18.20+$1.80 USD=
 Hold'em No Limit - Level XXII (2000/4000) - 2017/05/05 23:02:02 ET
Table '1597684021 1' 9-max Seat #8 is the button
Seat 1: smitheea (148581 in chips)=20
Seat 2: JJin91 (113908 in chips)=20
Seat 4: apoch19 (95914 in chips)=20
Seat 5: DomBagz (101673 in chips)=20
Seat 6: TrademarkTer (30950 in chips)=20
Seat 8: MM9955 (175945 in chips)=20
smitheea: posts the ante 500
JJin91: posts the ante 500
apoch19: posts the ante 500
DomBagz: posts the ante 500
TrademarkTer: posts the ante 500
MM9955: posts the ante 500
smitheea: posts small blind 2000
JJin91: posts big blind 4000
*** HOLE CARDS ***
Dealt to JJin91 [Ts Ah]
apoch19: folds=20
DomBagz: folds=20
TrademarkTer: folds=20
MM9955: raises 4000 to 8000
smitheea: folds=20
JJin91: calls 4000
*** FLOP *** [Js Kd 3s]
JJin91: checks=20
MM9955: bets 8000
JJin91: calls 8000
*** TURN *** [Js Kd 3s] [8s]
JJin91: checks=20
MM9955: checks=20
*** RIVER *** [Js Kd 3s 8s] [6d]
JJin91: checks=20
MM9955: checks=20
*** SHOW DOWN ***
JJin91: shows [Ts Ah] (high card Ace)
MM9955: shows [3h 5h] (a pair of Threes)
MM9955 collected 37000 from pot
*** SUMMARY ***
Total pot 37000 | Rake 0=20
Board [Js Kd 3s 8s 6d]
Seat 1: smitheea (small blind) folded before Flop
Seat 2: JJin91 (big blind) showed [Ts Ah] and lost with high card Ace
Seat 4: apoch19 folded before Flop (didn't bet)
Seat 5: DomBagz folded before Flop (didn't bet)
Seat 6: TrademarkTer folded before Flop (didn't bet)
Seat 8: MM9955 (button) showed [3h 5h] and won (37000) with a pair of T=
hrees


*********** # 218 **************
PokerStars Hand #169452568455: Tournament #1597684021, $18.20+$1.80 USD=
 Hold'em No Limit - Level XXII (2000/4000) - 2017/05/05 23:03:04 ET
Table '1597684021 1' 9-max Seat #1 is the button
Seat 1: smitheea (146081 in chips)=20
Seat 2: JJin91 (97408 in chips)=20
Seat 4: apoch19 (95414 in chips)=20
Seat 5: DomBagz (101173 in chips)=20
Seat 6: TrademarkTer (30450 in chips)=20
Seat 8: MM9955 (196445 in chips)=20
smitheea: posts the ante 500
JJin91: posts the ante 500
apoch19: posts the ante 500
DomBagz: posts the ante 500
TrademarkTer: posts the ante 500
MM9955: posts the ante 500
JJin91: posts small blind 2000
apoch19: posts big blind 4000
*** HOLE CARDS ***
Dealt to JJin91 [4c Kd]
DomBagz: folds=20
TrademarkTer: raises 25950 to 29950 and is all-in
MM9955: folds=20
smitheea: folds=20
JJin91: folds=20
apoch19: folds=20
Uncalled bet (25950) returned to TrademarkTer
TrademarkTer collected 13000 from pot
*** SUMMARY ***
Total pot 13000 | Rake 0=20
Seat 1: smitheea (button) folded before Flop (didn't bet)
Seat 2: JJin91 (small blind) folded before Flop
Seat 4: apoch19 (big blind) folded before Flop
Seat 5: DomBagz folded before Flop (didn't bet)
Seat 6: TrademarkTer collected (13000)
Seat 8: MM9955 folded before Flop (didn't bet)


*********** # 219 **************
PokerStars Hand #169452568518: Tournament #1597684021, $18.20+$1.80 USD=
 Hold'em No Limit - Level XXII (2000/4000) - 2017/05/05 23:03:18 ET
Table '1597684021 1' 9-max Seat #2 is the button
Seat 1: smitheea (145581 in chips)=20
Seat 2: JJin91 (94908 in chips)=20
Seat 4: apoch19 (90914 in chips)=20
Seat 5: DomBagz (100673 in chips)=20
Seat 6: TrademarkTer (38950 in chips)=20
Seat 8: MM9955 (195945 in chips)=20
smitheea: posts the ante 500
JJin91: posts the ante 500
apoch19: posts the ante 500
DomBagz: posts the ante 500
TrademarkTer: posts the ante 500
MM9955: posts the ante 500
apoch19: posts small blind 2000
DomBagz: posts big blind 4000
*** HOLE CARDS ***
Dealt to JJin91 [4d Qd]
TrademarkTer: raises 34450 to 38450 and is all-in
MM9955: folds=20
smitheea: folds=20
JJin91: folds=20
apoch19: folds=20
DomBagz: folds=20
Uncalled bet (34450) returned to TrademarkTer
TrademarkTer collected 13000 from pot
*** SUMMARY ***
Total pot 13000 | Rake 0=20
Seat 1: smitheea folded before Flop (didn't bet)
Seat 2: JJin91 (button) folded before Flop (didn't bet)
Seat 4: apoch19 (small blind) folded before Flop
Seat 5: DomBagz (big blind) folded before Flop
Seat 6: TrademarkTer collected (13000)
Seat 8: MM9955 folded before Flop (didn't bet)


*********** # 220 **************
PokerStars Hand #169452568625: Tournament #1597684021, $18.20+$1.80 USD=
 Hold'em No Limit - Level XXIII (2500/5000) - 2017/05/05 23:03:41 ET
Table '1597684021 1' 9-max Seat #4 is the button
Seat 1: smitheea (145081 in chips)=20
Seat 2: JJin91 (94408 in chips)=20
Seat 4: apoch19 (88414 in chips)=20
Seat 5: DomBagz (96173 in chips)=20
Seat 6: TrademarkTer (47450 in chips)=20
Seat 8: MM9955 (195445 in chips)=20
smitheea: posts the ante 625
JJin91: posts the ante 625
apoch19: posts the ante 625
DomBagz: posts the ante 625
TrademarkTer: posts the ante 625
MM9955: posts the ante 625
DomBagz: posts small blind 2500
TrademarkTer: posts big blind 5000
*** HOLE CARDS ***
Dealt to JJin91 [6s 6c]
MM9955: raises 5000 to 10000
smitheea: folds=20
JJin91: raises 83783 to 93783 and is all-in
apoch19: folds=20
DomBagz: folds=20
TrademarkTer: folds=20
MM9955: folds=20
Uncalled bet (83783) returned to JJin91
JJin91 collected 31250 from pot
JJin91: doesn't show hand=20
*** SUMMARY ***
Total pot 31250 | Rake 0=20
Seat 1: smitheea folded before Flop (didn't bet)
Seat 2: JJin91 collected (31250)
Seat 4: apoch19 (button) folded before Flop (didn't bet)
Seat 5: DomBagz (small blind) folded before Flop
Seat 6: TrademarkTer (big blind) folded before Flop
Seat 8: MM9955 folded before Flop


*********** # 221 **************
PokerStars Hand #169452568717: Tournament #1597684021, $18.20+$1.80 USD=
 Hold'em No Limit - Level XXIII (2500/5000) - 2017/05/05 23:04:02 ET
Table '1597684021 1' 9-max Seat #5 is the button
Seat 1: smitheea (144456 in chips)=20
Seat 2: JJin91 (115033 in chips)=20
Seat 4: apoch19 (87789 in chips)=20
Seat 5: DomBagz (93048 in chips)=20
Seat 6: TrademarkTer (41825 in chips)=20
Seat 8: MM9955 (184820 in chips)=20
smitheea: posts the ante 625
JJin91: posts the ante 625
apoch19: posts the ante 625
DomBagz: posts the ante 625
TrademarkTer: posts the ante 625
MM9955: posts the ante 625
TrademarkTer: posts small blind 2500
MM9955: posts big blind 5000
*** HOLE CARDS ***
Dealt to JJin91 [9d 9c]
smitheea: folds=20
JJin91: raises 5950 to 10950
apoch19: folds=20
DomBagz: folds=20
TrademarkTer: folds=20
MM9955: calls 5950
*** FLOP *** [Tc Qd 3d]
MM9955: bets 5000
JJin91: raises 10000 to 15000
MM9955: folds=20
Uncalled bet (10000) returned to JJin91
JJin91 collected 38150 from pot
JJin91: doesn't show hand=20
*** SUMMARY ***
Total pot 38150 | Rake 0=20
Board [Tc Qd 3d]
Seat 1: smitheea folded before Flop (didn't bet)
Seat 2: JJin91 collected (38150)
Seat 4: apoch19 folded before Flop (didn't bet)
Seat 5: DomBagz (button) folded before Flop (didn't bet)
Seat 6: TrademarkTer (small blind) folded before Flop
Seat 8: MM9955 (big blind) folded on the Flop


*********** # 222 **************
PokerStars Hand #169452568819: Tournament #1597684021, $18.20+$1.80 USD=
 Hold'em No Limit - Level XXIII (2500/5000) - 2017/05/05 23:04:27 ET
Table '1597684021 1' 9-max Seat #6 is the button
Seat 1: smitheea (143831 in chips)=20
Seat 2: JJin91 (136608 in chips)=20
Seat 4: apoch19 (87164 in chips)=20
Seat 5: DomBagz (92423 in chips)=20
Seat 6: TrademarkTer (38700 in chips)=20
Seat 8: MM9955 (168245 in chips)=20
smitheea: posts the ante 625
JJin91: posts the ante 625
apoch19: posts the ante 625
DomBagz: posts the ante 625
TrademarkTer: posts the ante 625
MM9955: posts the ante 625
MM9955: posts small blind 2500
smitheea: posts big blind 5000
*** HOLE CARDS ***
Dealt to JJin91 [Tc 6s]
JJin91: folds=20
apoch19: folds=20
DomBagz: folds=20
TrademarkTer: folds=20
MM9955: calls 2500
smitheea: checks=20
*** FLOP *** [Qc Jh Js]
MM9955: bets 5000
smitheea: folds=20
Uncalled bet (5000) returned to MM9955
MM9955 collected 13750 from pot
MM9955: doesn't show hand=20
*** SUMMARY ***
Total pot 13750 | Rake 0=20
Board [Qc Jh Js]
Seat 1: smitheea (big blind) folded on the Flop
Seat 2: JJin91 folded before Flop (didn't bet)
Seat 4: apoch19 folded before Flop (didn't bet)
Seat 5: DomBagz folded before Flop (didn't bet)
Seat 6: TrademarkTer (button) folded before Flop (didn't bet)
Seat 8: MM9955 (small blind) collected (13750)


*********** # 223 **************
PokerStars Hand #169452568919: Tournament #1597684021, $18.20+$1.80 USD=
 Hold'em No Limit - Level XXIII (2500/5000) - 2017/05/05 23:04:47 ET
Table '1597684021 1' 9-max Seat #8 is the button
Seat 1: smitheea (138206 in chips)=20
Seat 2: JJin91 (135983 in chips)=20
Seat 4: apoch19 (86539 in chips)=20
Seat 5: DomBagz (91798 in chips)=20
Seat 6: TrademarkTer (38075 in chips)=20
Seat 8: MM9955 (176370 in chips)=20
smitheea: posts the ante 625
JJin91: posts the ante 625
apoch19: posts the ante 625
DomBagz: posts the ante 625
TrademarkTer: posts the ante 625
MM9955: posts the ante 625
smitheea: posts small blind 2500
JJin91: posts big blind 5000
*** HOLE CARDS ***
Dealt to JJin91 [Jd 6h]
apoch19: folds=20
DomBagz: folds=20
TrademarkTer: folds=20
MM9955: raises 5000 to 10000
smitheea: folds=20
JJin91: calls 5000
*** FLOP *** [Kh 4s Td]
JJin91: bets 8138
MM9955: calls 8138
*** TURN *** [Kh 4s Td] [9s]
JJin91: bets 22539
MM9955: calls 22539
*** RIVER *** [Kh 4s Td 9s] [6c]
JJin91: checks=20
MM9955: checks=20
*** SHOW DOWN ***
JJin91: shows [Jd 6h] (a pair of Sixes)
MM9955: mucks hand=20
JJin91 collected 87604 from pot
*** SUMMARY ***
Total pot 87604 | Rake 0=20
Board [Kh 4s Td 9s 6c]
Seat 1: smitheea (small blind) folded before Flop
Seat 2: JJin91 (big blind) showed [Jd 6h] and won (87604) with a pair o=
f Sixes
Seat 4: apoch19 folded before Flop (didn't bet)
Seat 5: DomBagz folded before Flop (didn't bet)
Seat 6: TrademarkTer folded before Flop (didn't bet)
Seat 8: MM9955 (button) mucked [7s Js]


*********** # 224 **************
PokerStars Hand #169452569078: Tournament #1597684021, $18.20+$1.80 USD=
 Hold'em No Limit - Level XXIII (2500/5000) - 2017/05/05 23:05:24 ET
Table '1597684021 1' 9-max Seat #1 is the button
Seat 1: smitheea (135081 in chips)=20
Seat 2: JJin91 (182285 in chips)=20
Seat 4: apoch19 (85914 in chips)=20
Seat 5: DomBagz (91173 in chips)=20
Seat 6: TrademarkTer (37450 in chips)=20
Seat 8: MM9955 (135068 in chips)=20
smitheea: posts the ante 625
JJin91: posts the ante 625
apoch19: posts the ante 625
DomBagz: posts the ante 625
TrademarkTer: posts the ante 625
MM9955: posts the ante 625
JJin91: posts small blind 2500
apoch19: posts big blind 5000
*** HOLE CARDS ***
Dealt to JJin91 [2d 2c]
DomBagz: folds=20
TrademarkTer: folds=20
MM9955: folds=20
smitheea: folds=20
JJin91: raises 5000 to 10000
apoch19: calls 5000
*** FLOP *** [Ah Qs 7h]
JJin91: checks=20
apoch19: checks=20
*** TURN *** [Ah Qs 7h] [7c]
JJin91: bets 7363
apoch19: calls 7363
*** RIVER *** [Ah Qs 7h 7c] [8h]
JJin91: checks=20
apoch19: bets 28440
JJin91: folds=20
Uncalled bet (28440) returned to apoch19
apoch19 collected 38476 from pot
apoch19: doesn't show hand=20
*** SUMMARY ***
Total pot 38476 | Rake 0=20
Board [Ah Qs 7h 7c 8h]
Seat 1: smitheea (button) folded before Flop (didn't bet)
Seat 2: JJin91 (small blind) folded on the River
Seat 4: apoch19 (big blind) collected (38476)
Seat 5: DomBagz folded before Flop (didn't bet)
Seat 6: TrademarkTer folded before Flop (didn't bet)
Seat 8: MM9955 folded before Flop (didn't bet)


*********** # 225 **************
PokerStars Hand #169452569342: Tournament #1597684021, $18.20+$1.80 USD=
 Hold'em No Limit - Level XXIII (2500/5000) - 2017/05/05 23:06:22 ET
Table '1597684021 1' 9-max Seat #2 is the button
Seat 1: smitheea (134456 in chips)=20
Seat 2: JJin91 (164297 in chips)=20
Seat 4: apoch19 (106402 in chips)=20
Seat 5: DomBagz (90548 in chips)=20
Seat 6: TrademarkTer (36825 in chips)=20
Seat 8: MM9955 (134443 in chips)=20
smitheea: posts the ante 625
JJin91: posts the ante 625
apoch19: posts the ante 625
DomBagz: posts the ante 625
TrademarkTer: posts the ante 625
MM9955: posts the ante 625
apoch19: posts small blind 2500
DomBagz: posts big blind 5000
*** HOLE CARDS ***
Dealt to JJin91 [Jc Ks]
TrademarkTer: folds=20
MM9955: raises 10000 to 15000
smitheea: folds=20
JJin91: calls 15000
apoch19: folds=20
DomBagz: folds=20
*** FLOP *** [Td Ad 4c]
MM9955: bets 20625
JJin91: folds=20
Uncalled bet (20625) returned to MM9955
MM9955 collected 41250 from pot
MM9955: doesn't show hand=20
*** SUMMARY ***
Total pot 41250 | Rake 0=20
Board [Td Ad 4c]
Seat 1: smitheea folded before Flop (didn't bet)
Seat 2: JJin91 (button) folded on the Flop
Seat 4: apoch19 (small blind) folded before Flop
Seat 5: DomBagz (big blind) folded before Flop
Seat 6: TrademarkTer folded before Flop (didn't bet)
Seat 8: MM9955 collected (41250)


*********** # 226 **************
PokerStars Hand #169452569435: Tournament #1597684021, $18.20+$1.80 USD=
 Hold'em No Limit - Level XXIII (2500/5000) - 2017/05/05 23:06:43 ET
Table '1597684021 1' 9-max Seat #4 is the button
Seat 1: smitheea (133831 in chips)=20
Seat 2: JJin91 (148672 in chips)=20
Seat 4: apoch19 (103277 in chips)=20
Seat 5: DomBagz (84923 in chips)=20
Seat 6: TrademarkTer (36200 in chips)=20
Seat 8: MM9955 (160068 in chips)=20
smitheea: posts the ante 625
JJin91: posts the ante 625
apoch19: posts the ante 625
DomBagz: posts the ante 625
TrademarkTer: posts the ante 625
MM9955: posts the ante 625
DomBagz: posts small blind 2500
TrademarkTer: posts big blind 5000
*** HOLE CARDS ***
Dealt to JJin91 [9c Th]
MM9955: raises 5000 to 10000
smitheea: folds=20
JJin91: folds=20
apoch19: folds=20
DomBagz: folds=20
TrademarkTer: folds=20
Uncalled bet (5000) returned to MM9955
MM9955 collected 16250 from pot
MM9955: doesn't show hand=20
*** SUMMARY ***
Total pot 16250 | Rake 0=20
Seat 1: smitheea folded before Flop (didn't bet)
Seat 2: JJin91 folded before Flop (didn't bet)
Seat 4: apoch19 (button) folded before Flop (didn't bet)
Seat 5: DomBagz (small blind) folded before Flop
Seat 6: TrademarkTer (big blind) folded before Flop
Seat 8: MM9955 collected (16250)


*********** # 227 **************
PokerStars Hand #169452569517: Tournament #1597684021, $18.20+$1.80 USD=
 Hold'em No Limit - Level XXIII (2500/5000) - 2017/05/05 23:07:01 ET
Table '1597684021 1' 9-max Seat #5 is the button
Seat 1: smitheea (133206 in chips)=20
Seat 2: JJin91 (148047 in chips)=20
Seat 4: apoch19 (102652 in chips)=20
Seat 5: DomBagz (81798 in chips)=20
Seat 6: TrademarkTer (30575 in chips)=20
Seat 8: MM9955 (170693 in chips)=20
smitheea: posts the ante 625
JJin91: posts the ante 625
apoch19: posts the ante 625
DomBagz: posts the ante 625
TrademarkTer: posts the ante 625
MM9955: posts the ante 625
TrademarkTer: posts small blind 2500
MM9955: posts big blind 5000
*** HOLE CARDS ***
Dealt to JJin91 [Ah Kd]
smitheea: raises 5000 to 10000
JJin91: raises 15000 to 25000
apoch19: folds=20
DomBagz: folds=20
TrademarkTer: folds=20
MM9955: folds=20
smitheea: calls 15000
*** FLOP *** [Kc Ks 2s]
smitheea: checks=20
JJin91: bets 18988
smitheea: calls 18988
*** TURN *** [Kc Ks 2s] [9s]
smitheea: checks=20
JJin91: bets 30760
smitheea: raises 57833 to 88593 and is all-in
JJin91: calls 57833
*** RIVER *** [Kc Ks 2s 9s] [9d]
*** SHOW DOWN ***
smitheea: shows [Js Qs] (a flush, King high)
JJin91: shows [Ah Kd] (a full house, Kings full of Nines)
JJin91 collected 276412 from pot
smitheea finished the tournament in 11th place and received $47.09.
*** SUMMARY ***
Total pot 276412 | Rake 0=20
Board [Kc Ks 2s 9s 9d]
Seat 1: smitheea showed [Js Qs] and lost with a flush, King high
Seat 2: JJin91 showed [Ah Kd] and won (276412) with a full house, Kings=
 full of Nines
Seat 4: apoch19 folded before Flop (didn't bet)
Seat 5: DomBagz (button) folded before Flop (didn't bet)
Seat 6: TrademarkTer (small blind) folded before Flop
Seat 8: MM9955 (big blind) folded before Flop


*********** # 228 **************
PokerStars Hand #169452569705: Tournament #1597684021, $18.20+$1.80 USD=
 Hold'em No Limit - Level XXIII (2500/5000) - 2017/05/05 23:07:46 ET
Table '1597684021 1' 9-max Seat #6 is the button
Seat 2: JJin91 (291253 in chips)=20
Seat 4: apoch19 (102027 in chips)=20
Seat 5: DomBagz (81173 in chips)=20
Seat 6: TrademarkTer (27450 in chips)=20
Seat 8: MM9955 (165068 in chips)=20
JJin91: posts the ante 625
apoch19: posts the ante 625
DomBagz: posts the ante 625
TrademarkTer: posts the ante 625
MM9955: posts the ante 625
MM9955: posts small blind 2500
JJin91: posts big blind 5000
*** HOLE CARDS ***
Dealt to JJin91 [4d 8h]
JJin91 said, "whew"
apoch19: raises 6840 to 11840
DomBagz: folds=20
TrademarkTer: folds=20
MM9955: folds=20
JJin91: folds=20
Uncalled bet (6840) returned to apoch19
apoch19 collected 15625 from pot
apoch19: doesn't show hand=20
*** SUMMARY ***
Total pot 15625 | Rake 0=20
Seat 2: JJin91 (big blind) folded before Flop
Seat 4: apoch19 collected (15625)
Seat 5: DomBagz folded before Flop (didn't bet)
Seat 6: TrademarkTer (button) folded before Flop (didn't bet)
Seat 8: MM9955 (small blind) folded before Flop


*********** # 229 **************
PokerStars Hand #169452569771: Tournament #1597684021, $18.20+$1.80 USD=
 Hold'em No Limit - Level XXIII (2500/5000) - 2017/05/05 23:08:02 ET
Table '1597684021 1' 9-max Seat #8 is the button
Seat 2: JJin91 (285628 in chips)=20
Seat 4: apoch19 (112027 in chips)=20
Seat 5: DomBagz (80548 in chips)=20
Seat 6: TrademarkTer (26825 in chips)=20
Seat 8: MM9955 (161943 in chips)=20
JJin91: posts the ante 625
apoch19: posts the ante 625
DomBagz: posts the ante 625
TrademarkTer: posts the ante 625
MM9955: posts the ante 625
JJin91: posts small blind 2500
apoch19: posts big blind 5000
*** HOLE CARDS ***
Dealt to JJin91 [5d 7c]
DomBagz: folds=20
TrademarkTer: raises 21200 to 26200 and is all-in
MM9955: folds=20
JJin91: folds=20
apoch19: folds=20
Uncalled bet (21200) returned to TrademarkTer
TrademarkTer collected 15625 from pot
*** SUMMARY ***
Total pot 15625 | Rake 0=20
Seat 2: JJin91 (small blind) folded before Flop
Seat 4: apoch19 (big blind) folded before Flop
Seat 5: DomBagz folded before Flop (didn't bet)
Seat 6: TrademarkTer collected (15625)
Seat 8: MM9955 (button) folded before Flop (didn't bet)


*********** # 230 **************
PokerStars Hand #169452569856: Tournament #1597684021, $18.20+$1.80 USD=
 Hold'em No Limit - Level XXIII (2500/5000) - 2017/05/05 23:08:23 ET
Table '1597684021 1' 9-max Seat #2 is the button
Seat 2: JJin91 (282503 in chips)=20
Seat 4: apoch19 (106402 in chips)=20
Seat 5: DomBagz (79923 in chips)=20
Seat 6: TrademarkTer (36825 in chips)=20
Seat 8: MM9955 (161318 in chips)=20
JJin91: posts the ante 625
apoch19: posts the ante 625
DomBagz: posts the ante 625
TrademarkTer: posts the ante 625
MM9955: posts the ante 625
apoch19: posts small blind 2500
DomBagz: posts big blind 5000
*** HOLE CARDS ***
Dealt to JJin91 [9c 7h]
TrademarkTer: folds=20
MM9955: raises 5000 to 10000
JJin91: folds=20
apoch19: folds=20
DomBagz: raises 69298 to 79298 and is all-in
MM9955: folds=20
Uncalled bet (69298) returned to DomBagz
DomBagz collected 25625 from pot
DomBagz: doesn't show hand=20
*** SUMMARY ***
Total pot 25625 | Rake 0=20
Seat 2: JJin91 (button) folded before Flop (didn't bet)
Seat 4: apoch19 (small blind) folded before Flop
Seat 5: DomBagz (big blind) collected (25625)
Seat 6: TrademarkTer folded before Flop (didn't bet)
Seat 8: MM9955 folded before Flop


*********** # 231 **************
PokerStars Hand #169456157605: Tournament #1597684021, $18.20+$1.80 USD=
 Hold'em No Limit - Level XXIII (2500/5000) - 2017/05/05 23:08:56 ET
Table '1597684021 1' 9-max Seat #4 is the button
Seat 1: vincent329 (97230 in chips)=20
Seat 2: JJin91 (281878 in chips)=20
Seat 3: btd0729 (67876 in chips)=20
Seat 4: apoch19 (103277 in chips)=20
Seat 5: DomBagz (94923 in chips)=20
Seat 6: TrademarkTer (36200 in chips)=20
Seat 7: Mr Hero76 (203277 in chips)=20
Seat 8: MM9955 (150693 in chips)=20
Seat 9: jvurn (114646 in chips)=20
vincent329: posts the ante 625
JJin91: posts the ante 625
btd0729: posts the ante 625
apoch19: posts the ante 625
DomBagz: posts the ante 625
TrademarkTer: posts the ante 625
Mr Hero76: posts the ante 625
MM9955: posts the ante 625
jvurn: posts the ante 625
DomBagz: posts small blind 2500
TrademarkTer: posts big blind 5000
*** HOLE CARDS ***
Dealt to JJin91 [4h Ks]
Mr Hero76: folds=20
MM9955: raises 5000 to 10000
jvurn: folds=20
vincent329: folds=20
JJin91: folds=20
btd0729: folds=20
apoch19: folds=20
DomBagz: folds=20
TrademarkTer: folds=20
Uncalled bet (5000) returned to MM9955
MM9955 collected 18125 from pot
MM9955: doesn't show hand=20
*** SUMMARY ***
Total pot 18125 | Rake 0=20
Seat 1: vincent329 folded before Flop (didn't bet)
Seat 2: JJin91 folded before Flop (didn't bet)
Seat 3: btd0729 folded before Flop (didn't bet)
Seat 4: apoch19 (button) folded before Flop (didn't bet)
Seat 5: DomBagz (small blind) folded before Flop
Seat 6: TrademarkTer (big blind) folded before Flop
Seat 7: Mr Hero76 folded before Flop (didn't bet)
Seat 8: MM9955 collected (18125)
Seat 9: jvurn folded before Flop (didn't bet)


*********** # 232 **************
PokerStars Hand #169456157708: Tournament #1597684021, $18.20+$1.80 USD=
 Hold'em No Limit - Level XXIII (2500/5000) - 2017/05/05 23:09:22 ET
Table '1597684021 1' 9-max Seat #5 is the button
Seat 1: vincent329 (96605 in chips)=20
Seat 2: JJin91 (281253 in chips)=20
Seat 3: btd0729 (67251 in chips)=20
Seat 4: apoch19 (102652 in chips)=20
Seat 5: DomBagz (91798 in chips)=20
Seat 6: TrademarkTer (30575 in chips)=20
Seat 7: Mr Hero76 (202652 in chips)=20
Seat 8: MM9955 (163193 in chips)=20
Seat 9: jvurn (114021 in chips)=20
vincent329: posts the ante 625
JJin91: posts the ante 625
btd0729: posts the ante 625
apoch19: posts the ante 625
DomBagz: posts the ante 625
TrademarkTer: posts the ante 625
Mr Hero76: posts the ante 625
MM9955: posts the ante 625
jvurn: posts the ante 625
TrademarkTer: posts small blind 2500
Mr Hero76: posts big blind 5000
*** HOLE CARDS ***
Dealt to JJin91 [7d Ks]
MM9955: raises 5000 to 10000
jvurn: calls 10000
vincent329: folds=20
JJin91: folds=20
btd0729: folds=20
apoch19: folds=20
DomBagz: calls 10000
TrademarkTer: folds=20
Mr Hero76: folds=20
*** FLOP *** [9s Kd Th]
MM9955: bets 15000
jvurn: raises 88396 to 103396 and is all-in
DomBagz: folds=20
MM9955: folds=20
Uncalled bet (88396) returned to jvurn
jvurn collected 73125 from pot
jvurn: doesn't show hand=20
*** SUMMARY ***
Total pot 73125 | Rake 0=20
Board [9s Kd Th]
Seat 1: vincent329 folded before Flop (didn't bet)
Seat 2: JJin91 folded before Flop (didn't bet)
Seat 3: btd0729 folded before Flop (didn't bet)
Seat 4: apoch19 folded before Flop (didn't bet)
Seat 5: DomBagz (button) folded on the Flop
Seat 6: TrademarkTer (small blind) folded before Flop
Seat 7: Mr Hero76 (big blind) folded before Flop
Seat 8: MM9955 folded on the Flop
Seat 9: jvurn collected (73125)


*********** # 233 **************
PokerStars Hand #169456157899: Tournament #1597684021, $18.20+$1.80 USD=
 Hold'em No Limit - Level XXIII (2500/5000) - 2017/05/05 23:10:09 ET
Table '1597684021 1' 9-max Seat #6 is the button
Seat 1: vincent329 (95980 in chips)=20
Seat 2: JJin91 (280628 in chips)=20
Seat 3: btd0729 (66626 in chips)=20
Seat 4: apoch19 (102027 in chips)=20
Seat 5: DomBagz (81173 in chips)=20
Seat 6: TrademarkTer (27450 in chips)=20
Seat 7: Mr Hero76 (197027 in chips)=20
Seat 8: MM9955 (137568 in chips)=20
Seat 9: jvurn (161521 in chips)=20
vincent329: posts the ante 625
JJin91: posts the ante 625
btd0729: posts the ante 625
apoch19: posts the ante 625
DomBagz: posts the ante 625
TrademarkTer: posts the ante 625
Mr Hero76: posts the ante 625
MM9955: posts the ante 625
jvurn: posts the ante 625
Mr Hero76: posts small blind 2500
MM9955: posts big blind 5000
*** HOLE CARDS ***
Dealt to JJin91 [9d 2s]
jvurn: folds=20
vincent329: folds=20
JJin91: folds=20
btd0729: raises 10000 to 15000
apoch19: folds=20
DomBagz: folds=20
TrademarkTer: folds=20
Mr Hero76: folds=20
MM9955: calls 10000
*** FLOP *** [3d Qh 7d]
MM9955: checks=20
btd0729: bets 20000
MM9955: folds=20
Uncalled bet (20000) returned to btd0729
btd0729 collected 38125 from pot
btd0729: doesn't show hand=20
*** SUMMARY ***
Total pot 38125 | Rake 0=20
Board [3d Qh 7d]
Seat 1: vincent329 folded before Flop (didn't bet)
Seat 2: JJin91 folded before Flop (didn't bet)
Seat 3: btd0729 collected (38125)
Seat 4: apoch19 folded before Flop (didn't bet)
Seat 5: DomBagz folded before Flop (didn't bet)
Seat 6: TrademarkTer (button) folded before Flop (didn't bet)
Seat 7: Mr Hero76 (small blind) folded before Flop
Seat 8: MM9955 (big blind) folded on the Flop
Seat 9: jvurn folded before Flop (didn't bet)


*********** # 234 **************
PokerStars Hand #169456158034: Tournament #1597684021, $18.20+$1.80 USD=
 Hold'em No Limit - Level XXIII (2500/5000) - 2017/05/05 23:10:39 ET
Table '1597684021 1' 9-max Seat #7 is the button
Seat 1: vincent329 (95355 in chips)=20
Seat 2: JJin91 (280003 in chips)=20
Seat 3: btd0729 (89126 in chips)=20
Seat 4: apoch19 (101402 in chips)=20
Seat 5: DomBagz (80548 in chips)=20
Seat 6: TrademarkTer (26825 in chips)=20
Seat 7: Mr Hero76 (193902 in chips)=20
Seat 8: MM9955 (121943 in chips)=20
Seat 9: jvurn (160896 in chips)=20
vincent329: posts the ante 625
JJin91: posts the ante 625
btd0729: posts the ante 625
apoch19: posts the ante 625
DomBagz: posts the ante 625
TrademarkTer: posts the ante 625
Mr Hero76: posts the ante 625
MM9955: posts the ante 625
jvurn: posts the ante 625
MM9955: posts small blind 2500
jvurn: posts big blind 5000
*** HOLE CARDS ***
Dealt to JJin91 [8s 9h]
vincent329: raises 5000 to 10000
JJin91: folds=20
btd0729: calls 10000
apoch19: folds=20
DomBagz: folds=20
TrademarkTer: folds=20
Mr Hero76: folds=20
MM9955: folds=20
jvurn: folds=20
*** FLOP *** [3d Jc Qd]
vincent329: bets 5000
btd0729: raises 20000 to 25000
vincent329: calls 20000
*** TURN *** [3d Jc Qd] [Ad]
vincent329: bets 15000
btd0729: raises 38501 to 53501 and is all-in
vincent329: folds=20
Uncalled bet (38501) returned to btd0729
btd0729 collected 113125 from pot
btd0729: doesn't show hand=20
*** SUMMARY ***
Total pot 113125 | Rake 0=20
Board [3d Jc Qd Ad]
Seat 1: vincent329 folded on the Turn
Seat 2: JJin91 folded before Flop (didn't bet)
Seat 3: btd0729 collected (113125)
Seat 4: apoch19 folded before Flop (didn't bet)
Seat 5: DomBagz folded before Flop (didn't bet)
Seat 6: TrademarkTer folded before Flop (didn't bet)
Seat 7: Mr Hero76 (button) folded before Flop (didn't bet)
Seat 8: MM9955 (small blind) folded before Flop
Seat 9: jvurn (big blind) folded before Flop


*********** # 235 **************
PokerStars Hand #169456158251: Tournament #1597684021, $18.20+$1.80 USD=
 Hold'em No Limit - Level XXIII (2500/5000) - 2017/05/05 23:11:29 ET
Table '1597684021 1' 9-max Seat #8 is the button
Seat 1: vincent329 (44730 in chips)=20
Seat 2: JJin91 (279378 in chips)=20
Seat 3: btd0729 (151626 in chips)=20
Seat 4: apoch19 (100777 in chips)=20
Seat 5: DomBagz (79923 in chips)=20
Seat 6: TrademarkTer (26200 in chips)=20
Seat 7: Mr Hero76 (193277 in chips)=20
Seat 8: MM9955 (118818 in chips)=20
Seat 9: jvurn (155271 in chips)=20
vincent329: posts the ante 625
JJin91: posts the ante 625
btd0729: posts the ante 625
apoch19: posts the ante 625
DomBagz: posts the ante 625
TrademarkTer: posts the ante 625
Mr Hero76: posts the ante 625
MM9955: posts the ante 625
jvurn: posts the ante 625
jvurn: posts small blind 2500
vincent329: posts big blind 5000
*** HOLE CARDS ***
Dealt to JJin91 [Ks Jh]
JJin91: folds=20
btd0729: calls 5000
apoch19: raises 13000 to 18000
DomBagz: folds=20
TrademarkTer: folds=20
Mr Hero76: folds=20
MM9955: folds=20
jvurn: folds=20
vincent329: calls 13000
btd0729: calls 13000
*** FLOP *** [Qh 4h 9d]
vincent329: bets 26105 and is all-in
btd0729: folds=20
apoch19: calls 26105
*** TURN *** [Qh 4h 9d] [5c]
*** RIVER *** [Qh 4h 9d 5c] [9s]
*** SHOW DOWN ***
vincent329: shows [6d Qc] (two pair, Queens and Nines)
apoch19: shows [Ah Jc] (a pair of Nines)
vincent329 collected 114335 from pot
*** SUMMARY ***
Total pot 114335 | Rake 0=20
Board [Qh 4h 9d 5c 9s]
Seat 1: vincent329 (big blind) showed [6d Qc] and won (114335) with two=
 pair, Queens and Nines
Seat 2: JJin91 folded before Flop (didn't bet)
Seat 3: btd0729 folded on the Flop
Seat 4: apoch19 showed [Ah Jc] and lost with a pair of Nines
Seat 5: DomBagz folded before Flop (didn't bet)
Seat 6: TrademarkTer folded before Flop (didn't bet)
Seat 7: Mr Hero76 folded before Flop (didn't bet)
Seat 8: MM9955 (button) folded before Flop (didn't bet)
Seat 9: jvurn (small blind) folded before Flop


*********** # 236 **************
PokerStars Hand #169456158539: Tournament #1597684021, $18.20+$1.80 USD=
 Hold'em No Limit - Level XXIII (2500/5000) - 2017/05/05 23:12:39 ET
Table '1597684021 1' 9-max Seat #9 is the button
Seat 1: vincent329 (114335 in chips)=20
Seat 2: JJin91 (278753 in chips)=20
Seat 3: btd0729 (133001 in chips)=20
Seat 4: apoch19 (56047 in chips)=20
Seat 5: DomBagz (79298 in chips)=20
Seat 6: TrademarkTer (25575 in chips)=20
Seat 7: Mr Hero76 (192652 in chips)=20
Seat 8: MM9955 (118193 in chips)=20
Seat 9: jvurn (152146 in chips)=20
vincent329: posts the ante 625
JJin91: posts the ante 625
btd0729: posts the ante 625
apoch19: posts the ante 625
DomBagz: posts the ante 625
TrademarkTer: posts the ante 625
Mr Hero76: posts the ante 625
MM9955: posts the ante 625
jvurn: posts the ante 625
vincent329: posts small blind 2500
JJin91: posts big blind 5000
*** HOLE CARDS ***
Dealt to JJin91 [8d 2s]
btd0729: folds=20
apoch19: raises 50422 to 55422 and is all-in
DomBagz: folds=20
TrademarkTer: folds=20
Mr Hero76: folds=20
MM9955: folds=20
jvurn: folds=20
vincent329: folds=20
JJin91: folds=20
Uncalled bet (50422) returned to apoch19
apoch19 collected 18125 from pot
apoch19: doesn't show hand=20
*** SUMMARY ***
Total pot 18125 | Rake 0=20
Seat 1: vincent329 (small blind) folded before Flop
Seat 2: JJin91 (big blind) folded before Flop
Seat 3: btd0729 folded before Flop (didn't bet)
Seat 4: apoch19 collected (18125)
Seat 5: DomBagz folded before Flop (didn't bet)
Seat 6: TrademarkTer folded before Flop (didn't bet)
Seat 7: Mr Hero76 folded before Flop (didn't bet)
Seat 8: MM9955 folded before Flop (didn't bet)
Seat 9: jvurn (button) folded before Flop (didn't bet)


*********** # 237 **************
PokerStars Hand #169456158638: Tournament #1597684021, $18.20+$1.80 USD=
 Hold'em No Limit - Level XXIII (2500/5000) - 2017/05/05 23:12:59 ET
Table '1597684021 1' 9-max Seat #1 is the button
Seat 1: vincent329 (111210 in chips)=20
Seat 2: JJin91 (273128 in chips)=20
Seat 3: btd0729 (132376 in chips)=20
Seat 4: apoch19 (68547 in chips)=20
Seat 5: DomBagz (78673 in chips)=20
Seat 6: TrademarkTer (24950 in chips)=20
Seat 7: Mr Hero76 (192027 in chips)=20
Seat 8: MM9955 (117568 in chips)=20
Seat 9: jvurn (151521 in chips)=20
vincent329: posts the ante 625
JJin91: posts the ante 625
btd0729: posts the ante 625
apoch19: posts the ante 625
DomBagz: posts the ante 625
TrademarkTer: posts the ante 625
Mr Hero76: posts the ante 625
MM9955: posts the ante 625
jvurn: posts the ante 625
JJin91: posts small blind 2500
btd0729: posts big blind 5000
*** HOLE CARDS ***
Dealt to JJin91 [Td 3h]
apoch19: folds=20
DomBagz: folds=20
TrademarkTer: folds=20
Mr Hero76: folds=20
MM9955: folds=20
jvurn: folds=20
vincent329: calls 5000
JJin91: folds=20
btd0729: checks=20
*** FLOP *** [5d 2h 6s]
btd0729: checks=20
vincent329: checks=20
*** TURN *** [5d 2h 6s] [Jc]
btd0729: checks=20
vincent329: bets 18125
btd0729: folds=20
Uncalled bet (18125) returned to vincent329
vincent329 collected 18125 from pot
*** SUMMARY ***
Total pot 18125 | Rake 0=20
Board [5d 2h 6s Jc]
Seat 1: vincent329 (button) collected (18125)
Seat 2: JJin91 (small blind) folded before Flop
Seat 3: btd0729 (big blind) folded on the Turn
Seat 4: apoch19 folded before Flop (didn't bet)
Seat 5: DomBagz folded before Flop (didn't bet)
Seat 6: TrademarkTer folded before Flop (didn't bet)
Seat 7: Mr Hero76 folded before Flop (didn't bet)
Seat 8: MM9955 folded before Flop (didn't bet)
Seat 9: jvurn folded before Flop (didn't bet)


*********** # 238 **************
PokerStars Hand #169456158811: Tournament #1597684021, $18.20+$1.80 USD=
 Hold'em No Limit - Level XXIV (3000/6000) - 2017/05/05 23:13:41 ET
Table '1597684021 1' 9-max Seat #2 is the button
Seat 1: vincent329 (123710 in chips)=20
Seat 2: JJin91 (270003 in chips)=20
Seat 3: btd0729 (126751 in chips)=20
Seat 4: apoch19 (67922 in chips)=20
Seat 5: DomBagz (78048 in chips)=20
Seat 6: TrademarkTer (24325 in chips)=20
Seat 7: Mr Hero76 (191402 in chips)=20
Seat 8: MM9955 (116943 in chips)=20
Seat 9: jvurn (150896 in chips)=20
vincent329: posts the ante 750
JJin91: posts the ante 750
btd0729: posts the ante 750
apoch19: posts the ante 750
DomBagz: posts the ante 750
TrademarkTer: posts the ante 750
Mr Hero76: posts the ante 750
MM9955: posts the ante 750
jvurn: posts the ante 750
btd0729: posts small blind 3000
apoch19: posts big blind 6000
*** HOLE CARDS ***
Dealt to JJin91 [3h 7d]
DomBagz: folds=20
TrademarkTer: raises 17575 to 23575 and is all-in
Mr Hero76: folds=20
MM9955: folds=20
jvurn: folds=20
vincent329: folds=20
JJin91: folds=20
btd0729: folds=20
apoch19: folds=20
Uncalled bet (17575) returned to TrademarkTer
TrademarkTer collected 21750 from pot
*** SUMMARY ***
Total pot 21750 | Rake 0=20
Seat 1: vincent329 folded before Flop (didn't bet)
Seat 2: JJin91 (button) folded before Flop (didn't bet)
Seat 3: btd0729 (small blind) folded before Flop
Seat 4: apoch19 (big blind) folded before Flop
Seat 5: DomBagz folded before Flop (didn't bet)
Seat 6: TrademarkTer collected (21750)
Seat 7: Mr Hero76 folded before Flop (didn't bet)
Seat 8: MM9955 folded before Flop (didn't bet)
Seat 9: jvurn folded before Flop (didn't bet)


*********** # 239 **************
PokerStars Hand #169456158919: Tournament #1597684021, $18.20+$1.80 USD=
 Hold'em No Limit - Level XXIV (3000/6000) - 2017/05/05 23:14:05 ET
Table '1597684021 1' 9-max Seat #3 is the button
Seat 1: vincent329 (122960 in chips)=20
Seat 2: JJin91 (269253 in chips)=20
Seat 3: btd0729 (123001 in chips)=20
Seat 4: apoch19 (61172 in chips)=20
Seat 5: DomBagz (77298 in chips)=20
Seat 6: TrademarkTer (39325 in chips)=20
Seat 7: Mr Hero76 (190652 in chips)=20
Seat 8: MM9955 (116193 in chips)=20
Seat 9: jvurn (150146 in chips)=20
vincent329: posts the ante 750
JJin91: posts the ante 750
btd0729: posts the ante 750
apoch19: posts the ante 750
DomBagz: posts the ante 750
TrademarkTer: posts the ante 750
Mr Hero76: posts the ante 750
MM9955: posts the ante 750
jvurn: posts the ante 750
apoch19: posts small blind 3000
DomBagz: posts big blind 6000
*** HOLE CARDS ***
Dealt to JJin91 [Jh 4s]
TrademarkTer: folds=20
Mr Hero76: folds=20
MM9955: folds=20
jvurn: raises 6000 to 12000
vincent329: folds=20
JJin91: folds=20
btd0729: folds=20
apoch19: folds=20
DomBagz: raises 64548 to 76548 and is all-in
jvurn: calls 64548
*** FLOP *** [7h Qc Qd]
*** TURN *** [7h Qc Qd] [2d]
*** RIVER *** [7h Qc Qd 2d] [5h]
*** SHOW DOWN ***
DomBagz: shows [3c 3d] (two pair, Queens and Threes)
jvurn: shows [As Ah] (two pair, Aces and Queens)
jvurn collected 162846 from pot
DomBagz finished the tournament in 9th place and received $52.32.
*** SUMMARY ***
Total pot 162846 | Rake 0=20
Board [7h Qc Qd 2d 5h]
Seat 1: vincent329 folded before Flop (didn't bet)
Seat 2: JJin91 folded before Flop (didn't bet)
Seat 3: btd0729 (button) folded before Flop (didn't bet)
Seat 4: apoch19 (small blind) folded before Flop
Seat 5: DomBagz (big blind) showed [3c 3d] and lost with two pair, Quee=
ns and Threes
Seat 6: TrademarkTer folded before Flop (didn't bet)
Seat 7: Mr Hero76 folded before Flop (didn't bet)
Seat 8: MM9955 folded before Flop (didn't bet)
Seat 9: jvurn showed [As Ah] and won (162846) with two pair, Aces and Q=
ueens


*********** # 240 **************
PokerStars Hand #169456159056: Tournament #1597684021, $18.20+$1.80 USD=
 Hold'em No Limit - Level XXIV (3000/6000) - 2017/05/05 23:14:36 ET
Table '1597684021 1' 9-max Seat #4 is the button
Seat 1: vincent329 (122210 in chips)=20
Seat 2: JJin91 (268503 in chips)=20
Seat 3: btd0729 (122251 in chips)=20
Seat 4: apoch19 (57422 in chips)=20
Seat 6: TrademarkTer (38575 in chips)=20
Seat 7: Mr Hero76 (189902 in chips)=20
Seat 8: MM9955 (115443 in chips)=20
Seat 9: jvurn (235694 in chips)=20
vincent329: posts the ante 750
JJin91: posts the ante 750
btd0729: posts the ante 750
apoch19: posts the ante 750
TrademarkTer: posts the ante 750
Mr Hero76: posts the ante 750
MM9955: posts the ante 750
jvurn: posts the ante 750
TrademarkTer: posts small blind 3000
Mr Hero76: posts big blind 6000
*** HOLE CARDS ***
Dealt to JJin91 [Jc 3h]
MM9955: folds=20
jvurn: raises 6000 to 12000
vincent329: folds=20
JJin91: folds=20
btd0729: raises 24000 to 36000
apoch19: folds=20
TrademarkTer: folds=20
Mr Hero76: folds=20
jvurn: calls 24000
*** FLOP *** [4h 2c 7d]
jvurn: checks=20
btd0729: bets 42000
jvurn: folds=20
Uncalled bet (42000) returned to btd0729
btd0729 collected 87000 from pot
btd0729: doesn't show hand=20
*** SUMMARY ***
Total pot 87000 | Rake 0=20
Board [4h 2c 7d]
Seat 1: vincent329 folded before Flop (didn't bet)
Seat 2: JJin91 folded before Flop (didn't bet)
Seat 3: btd0729 collected (87000)
Seat 4: apoch19 (button) folded before Flop (didn't bet)
Seat 6: TrademarkTer (small blind) folded before Flop
Seat 7: Mr Hero76 (big blind) folded before Flop
Seat 8: MM9955 folded before Flop (didn't bet)
Seat 9: jvurn folded on the Flop


*********** # 241 **************
PokerStars Hand #169456159205: Tournament #1597684021, $18.20+$1.80 USD=
 Hold'em No Limit - Level XXIV (3000/6000) - 2017/05/05 23:15:13 ET
Table '1597684021 1' 9-max Seat #6 is the button
Seat 1: vincent329 (121460 in chips)=20
Seat 2: JJin91 (267753 in chips)=20
Seat 3: btd0729 (172501 in chips)=20
Seat 4: apoch19 (56672 in chips)=20
Seat 6: TrademarkTer (34825 in chips)=20
Seat 7: Mr Hero76 (183152 in chips)=20
Seat 8: MM9955 (114693 in chips)=20
Seat 9: jvurn (198944 in chips)=20
vincent329: posts the ante 750
JJin91: posts the ante 750
btd0729: posts the ante 750
apoch19: posts the ante 750
TrademarkTer: posts the ante 750
Mr Hero76: posts the ante 750
MM9955: posts the ante 750
jvurn: posts the ante 750
Mr Hero76: posts small blind 3000
MM9955: posts big blind 6000
*** HOLE CARDS ***
Dealt to JJin91 [8h 6c]
jvurn: folds=20
vincent329: raises 12000 to 18000
JJin91: folds=20
btd0729: calls 18000
apoch19: folds=20
TrademarkTer: folds=20
Mr Hero76: folds=20
MM9955: calls 12000
*** FLOP *** [Qd Kd 5h]
MM9955: checks=20
vincent329: bets 12000
btd0729: raises 30000 to 42000
MM9955: folds=20
vincent329: folds=20
Uncalled bet (30000) returned to btd0729
btd0729 collected 87000 from pot
btd0729: doesn't show hand=20
*** SUMMARY ***
Total pot 87000 | Rake 0=20
Board [Qd Kd 5h]
Seat 1: vincent329 folded on the Flop
Seat 2: JJin91 folded before Flop (didn't bet)
Seat 3: btd0729 collected (87000)
Seat 4: apoch19 folded before Flop (didn't bet)
Seat 6: TrademarkTer (button) folded before Flop (didn't bet)
Seat 7: Mr Hero76 (small blind) folded before Flop
Seat 8: MM9955 (big blind) folded on the Flop
Seat 9: jvurn folded before Flop (didn't bet)


*********** # 242 **************
PokerStars Hand #169456159410: Tournament #1597684021, $18.20+$1.80 USD=
 Hold'em No Limit - Level XXIV (3000/6000) - 2017/05/05 23:15:58 ET
Table '1597684021 1' 9-max Seat #7 is the button
Seat 1: vincent329 (90710 in chips)=20
Seat 2: JJin91 (267003 in chips)=20
Seat 3: btd0729 (228751 in chips)=20
Seat 4: apoch19 (55922 in chips)=20
Seat 6: TrademarkTer (34075 in chips)=20
Seat 7: Mr Hero76 (179402 in chips)=20
Seat 8: MM9955 (95943 in chips)=20
Seat 9: jvurn (198194 in chips)=20
vincent329: posts the ante 750
JJin91: posts the ante 750
btd0729: posts the ante 750
apoch19: posts the ante 750
TrademarkTer: posts the ante 750
Mr Hero76: posts the ante 750
MM9955: posts the ante 750
jvurn: posts the ante 750
MM9955: posts small blind 3000
jvurn: posts big blind 6000
*** HOLE CARDS ***
Dealt to JJin91 [Ad 6c]
vincent329: folds=20
JJin91: folds=20
btd0729: folds=20
apoch19: folds=20
TrademarkTer: folds=20
Mr Hero76: folds=20
MM9955: calls 3000
jvurn: checks=20
*** FLOP *** [2h 7d 7c]
MM9955: bets 6000
jvurn: folds=20
Uncalled bet (6000) returned to MM9955
MM9955 collected 18000 from pot
MM9955: doesn't show hand=20
*** SUMMARY ***
Total pot 18000 | Rake 0=20
Board [2h 7d 7c]
Seat 1: vincent329 folded before Flop (didn't bet)
Seat 2: JJin91 folded before Flop (didn't bet)
Seat 3: btd0729 folded before Flop (didn't bet)
Seat 4: apoch19 folded before Flop (didn't bet)
Seat 6: TrademarkTer folded before Flop (didn't bet)
Seat 7: Mr Hero76 (button) folded before Flop (didn't bet)
Seat 8: MM9955 (small blind) collected (18000)
Seat 9: jvurn (big blind) folded on the Flop


*********** # 243 **************
PokerStars Hand #169456159462: Tournament #1597684021, $18.20+$1.80 USD=
 Hold'em No Limit - Level XXIV (3000/6000) - 2017/05/05 23:16:10 ET
Table '1597684021 1' 9-max Seat #8 is the button
Seat 1: vincent329 (89960 in chips)=20
Seat 2: JJin91 (266253 in chips)=20
Seat 3: btd0729 (228001 in chips)=20
Seat 4: apoch19 (55172 in chips)=20
Seat 6: TrademarkTer (33325 in chips)=20
Seat 7: Mr Hero76 (178652 in chips)=20
Seat 8: MM9955 (107193 in chips)=20
Seat 9: jvurn (191444 in chips)=20
vincent329: posts the ante 750
JJin91: posts the ante 750
btd0729: posts the ante 750
apoch19: posts the ante 750
TrademarkTer: posts the ante 750
Mr Hero76: posts the ante 750
MM9955: posts the ante 750
jvurn: posts the ante 750
jvurn: posts small blind 3000
vincent329: posts big blind 6000
*** HOLE CARDS ***
Dealt to JJin91 [7d 8d]
JJin91: folds=20
btd0729: folds=20
apoch19: folds=20
TrademarkTer: raises 26575 to 32575 and is all-in
Mr Hero76: folds=20
MM9955: folds=20
jvurn: raises 158119 to 190694 and is all-in
vincent329: folds=20
Uncalled bet (158119) returned to jvurn
TrademarkTer said, "oh no!!!!!!!!!!!!!! no!!!!! no!!!!!!!!!!!!!!!!!!!!!=
!!!!!!"
*** FLOP *** [5c Ks 8s]
*** TURN *** [5c Ks 8s] [6s]
*** RIVER *** [5c Ks 8s 6s] [3c]
*** SHOW DOWN ***
jvurn: shows [4s 4c] (a pair of Fours)
TrademarkTer: shows [Ts Ad] (high card Ace)
jvurn collected 77150 from pot
TrademarkTer finished the tournament in 8th place and received $62.79.
*** SUMMARY ***
Total pot 77150 | Rake 0=20
Board [5c Ks 8s 6s 3c]
Seat 1: vincent329 (big blind) folded before Flop
Seat 2: JJin91 folded before Flop (didn't bet)
Seat 3: btd0729 folded before Flop (didn't bet)
Seat 4: apoch19 folded before Flop (didn't bet)
Seat 6: TrademarkTer showed [Ts Ad] and lost with high card Ace
Seat 7: Mr Hero76 folded before Flop (didn't bet)
Seat 8: MM9955 (button) folded before Flop (didn't bet)
Seat 9: jvurn (small blind) showed [4s 4c] and won (77150) with a pair =
of Fours


*********** # 244 **************
PokerStars Hand #169456159621: Tournament #1597684021, $18.20+$1.80 USD=
 Hold'em No Limit - Level XXIV (3000/6000) - 2017/05/05 23:16:46 ET
Table '1597684021 1' 9-max Seat #9 is the button
Seat 1: vincent329 (83210 in chips)=20
Seat 2: JJin91 (265503 in chips)=20
Seat 3: btd0729 (227251 in chips)=20
Seat 4: apoch19 (54422 in chips)=20
Seat 7: Mr Hero76 (177902 in chips)=20
Seat 8: MM9955 (106443 in chips)=20
Seat 9: jvurn (235269 in chips)=20
vincent329: posts the ante 750
JJin91: posts the ante 750
btd0729: posts the ante 750
apoch19: posts the ante 750
Mr Hero76: posts the ante 750
MM9955: posts the ante 750
jvurn: posts the ante 750
vincent329: posts small blind 3000
JJin91: posts big blind 6000
*** HOLE CARDS ***
Dealt to JJin91 [7h 3c]
btd0729: folds=20
apoch19: raises 47672 to 53672 and is all-in
Mr Hero76: folds=20
MM9955: folds=20
jvurn: folds=20
vincent329: folds=20
JJin91: folds=20
Uncalled bet (47672) returned to apoch19
apoch19 collected 20250 from pot
apoch19: doesn't show hand=20
*** SUMMARY ***
Total pot 20250 | Rake 0=20
Seat 1: vincent329 (small blind) folded before Flop
Seat 2: JJin91 (big blind) folded before Flop
Seat 3: btd0729 folded before Flop (didn't bet)
Seat 4: apoch19 collected (20250)
Seat 7: Mr Hero76 folded before Flop (didn't bet)
Seat 8: MM9955 folded before Flop (didn't bet)
Seat 9: jvurn (button) folded before Flop (didn't bet)


*********** # 245 **************
PokerStars Hand #169456159680: Tournament #1597684021, $18.20+$1.80 USD=
 Hold'em No Limit - Level XXIV (3000/6000) - 2017/05/05 23:17:01 ET
Table '1597684021 1' 9-max Seat #1 is the button
Seat 1: vincent329 (79460 in chips)=20
Seat 2: JJin91 (258753 in chips)=20
Seat 3: btd0729 (226501 in chips)=20
Seat 4: apoch19 (67922 in chips)=20
Seat 7: Mr Hero76 (177152 in chips)=20
Seat 8: MM9955 (105693 in chips)=20
Seat 9: jvurn (234519 in chips)=20
vincent329: posts the ante 750
JJin91: posts the ante 750
btd0729: posts the ante 750
apoch19: posts the ante 750
Mr Hero76: posts the ante 750
MM9955: posts the ante 750
jvurn: posts the ante 750
JJin91: posts small blind 3000
btd0729: posts big blind 6000
*** HOLE CARDS ***
Dealt to JJin91 [Qd 7c]
apoch19: folds=20
Mr Hero76: folds=20
MM9955: folds=20
jvurn: folds=20
vincent329: folds=20
JJin91: raises 6000 to 12000
btd0729: folds=20
Uncalled bet (6000) returned to JJin91
JJin91 collected 17250 from pot
JJin91: doesn't show hand=20
*** SUMMARY ***
Total pot 17250 | Rake 0=20
Seat 1: vincent329 (button) folded before Flop (didn't bet)
Seat 2: JJin91 (small blind) collected (17250)
Seat 3: btd0729 (big blind) folded before Flop
Seat 4: apoch19 folded before Flop (didn't bet)
Seat 7: Mr Hero76 folded before Flop (didn't bet)
Seat 8: MM9955 folded before Flop (didn't bet)
Seat 9: jvurn folded before Flop (didn't bet)


*********** # 246 **************
PokerStars Hand #169456159768: Tournament #1597684021, $18.20+$1.80 USD=
 Hold'em No Limit - Level XXIV (3000/6000) - 2017/05/05 23:17:19 ET
Table '1597684021 1' 9-max Seat #2 is the button
Seat 1: vincent329 (78710 in chips)=20
Seat 2: JJin91 (269253 in chips)=20
Seat 3: btd0729 (219751 in chips)=20
Seat 4: apoch19 (67172 in chips)=20
Seat 7: Mr Hero76 (176402 in chips)=20
Seat 8: MM9955 (104943 in chips)=20
Seat 9: jvurn (233769 in chips)=20
vincent329: posts the ante 750
JJin91: posts the ante 750
btd0729: posts the ante 750
apoch19: posts the ante 750
Mr Hero76: posts the ante 750
MM9955: posts the ante 750
jvurn: posts the ante 750
btd0729: posts small blind 3000
apoch19: posts big blind 6000
*** HOLE CARDS ***
Dealt to JJin91 [7s 6s]
Mr Hero76: folds=20
MM9955: raises 12000 to 18000
jvurn: folds=20
vincent329: folds=20
JJin91: folds=20
btd0729: folds=20
apoch19: folds=20
Uncalled bet (12000) returned to MM9955
MM9955 collected 20250 from pot
MM9955: doesn't show hand=20
*** SUMMARY ***
Total pot 20250 | Rake 0=20
Seat 1: vincent329 folded before Flop (didn't bet)
Seat 2: JJin91 (button) folded before Flop (didn't bet)
Seat 3: btd0729 (small blind) folded before Flop
Seat 4: apoch19 (big blind) folded before Flop
Seat 7: Mr Hero76 folded before Flop (didn't bet)
Seat 8: MM9955 collected (20250)
Seat 9: jvurn folded before Flop (didn't bet)


*********** # 247 **************
PokerStars Hand #169456159839: Tournament #1597684021, $18.20+$1.80 USD=
 Hold'em No Limit - Level XXIV (3000/6000) - 2017/05/05 23:17:36 ET
Table '1597684021 1' 9-max Seat #3 is the button
Seat 1: vincent329 (77960 in chips)=20
Seat 2: JJin91 (268503 in chips)=20
Seat 3: btd0729 (216001 in chips)=20
Seat 4: apoch19 (60422 in chips)=20
Seat 7: Mr Hero76 (175652 in chips)=20
Seat 8: MM9955 (118443 in chips)=20
Seat 9: jvurn (233019 in chips)=20
vincent329: posts the ante 750
JJin91: posts the ante 750
btd0729: posts the ante 750
apoch19: posts the ante 750
Mr Hero76: posts the ante 750
MM9955: posts the ante 750
jvurn: posts the ante 750
apoch19: posts small blind 3000
Mr Hero76: posts big blind 6000
*** HOLE CARDS ***
Dealt to JJin91 [6c 9c]
MM9955: folds=20
jvurn: folds=20
vincent329: folds=20
JJin91: folds=20
btd0729: folds=20
apoch19: raises 53672 to 59672 and is all-in
Mr Hero76: folds=20
Uncalled bet (53672) returned to apoch19
apoch19 collected 17250 from pot
apoch19: doesn't show hand=20
*** SUMMARY ***
Total pot 17250 | Rake 0=20
Seat 1: vincent329 folded before Flop (didn't bet)
Seat 2: JJin91 folded before Flop (didn't bet)
Seat 3: btd0729 (button) folded before Flop (didn't bet)
Seat 4: apoch19 (small blind) collected (17250)
Seat 7: Mr Hero76 (big blind) folded before Flop
Seat 8: MM9955 folded before Flop (didn't bet)
Seat 9: jvurn folded before Flop (didn't bet)


*********** # 248 **************
PokerStars Hand #169456159926: Tournament #1597684021, $18.20+$1.80 USD=
 Hold'em No Limit - Level XXIV (3000/6000) - 2017/05/05 23:17:55 ET
Table '1597684021 1' 9-max Seat #4 is the button
Seat 1: vincent329 (77210 in chips)=20
Seat 2: JJin91 (267753 in chips)=20
Seat 3: btd0729 (215251 in chips)=20
Seat 4: apoch19 (70922 in chips)=20
Seat 7: Mr Hero76 (168902 in chips)=20
Seat 8: MM9955 (117693 in chips)=20
Seat 9: jvurn (232269 in chips)=20
vincent329: posts the ante 750
JJin91: posts the ante 750
btd0729: posts the ante 750
apoch19: posts the ante 750
Mr Hero76: posts the ante 750
MM9955: posts the ante 750
jvurn: posts the ante 750
Mr Hero76: posts small blind 3000
MM9955: posts big blind 6000
*** HOLE CARDS ***
Dealt to JJin91 [Ac Qs]
jvurn: folds=20
vincent329: raises 70460 to 76460 and is all-in
JJin91: calls 76460
btd0729: folds=20
apoch19: folds=20
Mr Hero76: folds=20
MM9955: folds=20
*** FLOP *** [7h 4s 8s]
*** TURN *** [7h 4s 8s] [Jh]
*** RIVER *** [7h 4s 8s Jh] [5s]
*** SHOW DOWN ***
vincent329: shows [As 9h] (high card Ace)
JJin91: shows [Ac Qs] (high card Ace - Queen kicker)
JJin91 collected 167170 from pot
vincent329 finished the tournament in 7th place and received $83.72.
*** SUMMARY ***
Total pot 167170 | Rake 0=20
Board [7h 4s 8s Jh 5s]
Seat 1: vincent329 showed [As 9h] and lost with high card Ace
Seat 2: JJin91 showed [Ac Qs] and won (167170) with high card Ace
Seat 3: btd0729 folded before Flop (didn't bet)
Seat 4: apoch19 (button) folded before Flop (didn't bet)
Seat 7: Mr Hero76 (small blind) folded before Flop
Seat 8: MM9955 (big blind) folded before Flop
Seat 9: jvurn folded before Flop (didn't bet)


*********** # 249 **************
PokerStars Hand #169456942534: Tournament #1597684021, $18.20+$1.80 USD=
 Hold'em No Limit - Level XXIV (3000/6000) - 2017/05/05 23:18:20 ET
Table '1597684021 1' 9-max Seat #7 is the button
Seat 2: JJin91 (357713 in chips)=20
Seat 3: btd0729 (214501 in chips)=20
Seat 4: apoch19 (70172 in chips)=20
Seat 7: Mr Hero76 (165152 in chips)=20
Seat 8: MM9955 (110943 in chips)=20
Seat 9: jvurn (231519 in chips)=20
JJin91: posts the ante 750
btd0729: posts the ante 750
apoch19: posts the ante 750
Mr Hero76: posts the ante 750
MM9955: posts the ante 750
jvurn: posts the ante 750
MM9955: posts small blind 3000
jvurn: posts big blind 6000
*** HOLE CARDS ***
Dealt to JJin91 [4d 7h]
JJin91: folds=20
btd0729: folds=20
apoch19: folds=20
Mr Hero76: folds=20
MM9955: folds=20
Uncalled bet (3000) returned to jvurn
jvurn collected 10500 from pot
jvurn: doesn't show hand=20
*** SUMMARY ***
Total pot 10500 | Rake 0=20
Seat 2: JJin91 folded before Flop (didn't bet)
Seat 3: btd0729 folded before Flop (didn't bet)
Seat 4: apoch19 folded before Flop (didn't bet)
Seat 7: Mr Hero76 (button) folded before Flop (didn't bet)
Seat 8: MM9955 (small blind) folded before Flop
Seat 9: jvurn (big blind) collected (10500)


*********** # 250 **************
PokerStars Hand #169456942577: Tournament #1597684021, $18.20+$1.80 USD=
 Hold'em No Limit - Level XXIV (3000/6000) - 2017/05/05 23:18:31 ET
Table '1597684021 1' 9-max Seat #8 is the button
Seat 2: JJin91 (356963 in chips)=20
Seat 3: btd0729 (213751 in chips)=20
Seat 4: apoch19 (69422 in chips)=20
Seat 7: Mr Hero76 (164402 in chips)=20
Seat 8: MM9955 (107193 in chips)=20
Seat 9: jvurn (238269 in chips)=20
JJin91: posts the ante 750
btd0729: posts the ante 750
apoch19: posts the ante 750
Mr Hero76: posts the ante 750
MM9955: posts the ante 750
jvurn: posts the ante 750
jvurn: posts small blind 3000
JJin91: posts big blind 6000
*** HOLE CARDS ***
Dealt to JJin91 [Kc 7c]
btd0729: folds=20
apoch19: folds=20
Mr Hero76: folds=20
MM9955: folds=20
jvurn: raises 16500 to 22500
JJin91: folds=20
Uncalled bet (16500) returned to jvurn
jvurn collected 16500 from pot
jvurn: doesn't show hand=20
*** SUMMARY ***
Total pot 16500 | Rake 0=20
Seat 2: JJin91 (big blind) folded before Flop
Seat 3: btd0729 folded before Flop (didn't bet)
Seat 4: apoch19 folded before Flop (didn't bet)
Seat 7: Mr Hero76 folded before Flop (didn't bet)
Seat 8: MM9955 (button) folded before Flop (didn't bet)
Seat 9: jvurn (small blind) collected (16500)


*********** # 251 **************
PokerStars Hand #169456942644: Tournament #1597684021, $18.20+$1.80 USD=
 Hold'em No Limit - Level XXIV (3000/6000) - 2017/05/05 23:18:46 ET
Table '1597684021 1' 9-max Seat #9 is the button
Seat 2: JJin91 (350213 in chips)=20
Seat 3: btd0729 (213001 in chips)=20
Seat 4: apoch19 (68672 in chips)=20
Seat 7: Mr Hero76 (163652 in chips)=20
Seat 8: MM9955 (106443 in chips)=20
Seat 9: jvurn (248019 in chips)=20
JJin91: posts the ante 750
btd0729: posts the ante 750
apoch19: posts the ante 750
Mr Hero76: posts the ante 750
MM9955: posts the ante 750
jvurn: posts the ante 750
JJin91: posts small blind 3000
btd0729: posts big blind 6000
*** HOLE CARDS ***
Dealt to JJin91 [Kd Kh]
apoch19: folds=20
Mr Hero76: folds=20
MM9955: folds=20
jvurn: folds=20
JJin91: raises 9660 to 15660
btd0729: calls 9660
*** FLOP *** [6d Qd 5d]
JJin91: bets 18985
btd0729: folds=20
Uncalled bet (18985) returned to JJin91
JJin91 collected 35820 from pot
JJin91: doesn't show hand=20
*** SUMMARY ***
Total pot 35820 | Rake 0=20
Board [6d Qd 5d]
Seat 2: JJin91 (small blind) collected (35820)
Seat 3: btd0729 (big blind) folded on the Flop
Seat 4: apoch19 folded before Flop (didn't bet)
Seat 7: Mr Hero76 folded before Flop (didn't bet)
Seat 8: MM9955 folded before Flop (didn't bet)
Seat 9: jvurn (button) folded before Flop (didn't bet)


*********** # 252 **************
PokerStars Hand #169456942817: Tournament #1597684021, $18.20+$1.80 USD=
 Hold'em No Limit - Level XXIV (3000/6000) - 2017/05/05 23:19:24 ET
Table '1597684021 1' 9-max Seat #2 is the button
Seat 2: JJin91 (369623 in chips)=20
Seat 3: btd0729 (196591 in chips)=20
Seat 4: apoch19 (67922 in chips)=20
Seat 7: Mr Hero76 (162902 in chips)=20
Seat 8: MM9955 (105693 in chips)=20
Seat 9: jvurn (247269 in chips)=20
JJin91: posts the ante 750
btd0729: posts the ante 750
apoch19: posts the ante 750
Mr Hero76: posts the ante 750
MM9955: posts the ante 750
jvurn: posts the ante 750
btd0729: posts small blind 3000
apoch19: posts big blind 6000
*** HOLE CARDS ***
Dealt to JJin91 [4s 8h]
Mr Hero76: folds=20
MM9955: folds=20
jvurn: folds=20
JJin91: folds=20
btd0729: folds=20
Uncalled bet (3000) returned to apoch19
apoch19 collected 10500 from pot
apoch19: doesn't show hand=20
*** SUMMARY ***
Total pot 10500 | Rake 0=20
Seat 2: JJin91 (button) folded before Flop (didn't bet)
Seat 3: btd0729 (small blind) folded before Flop
Seat 4: apoch19 (big blind) collected (10500)
Seat 7: Mr Hero76 folded before Flop (didn't bet)
Seat 8: MM9955 folded before Flop (didn't bet)
Seat 9: jvurn folded before Flop (didn't bet)


*********** # 253 **************
PokerStars Hand #169456942864: Tournament #1597684021, $18.20+$1.80 USD=
 Hold'em No Limit - Level XXIV (3000/6000) - 2017/05/05 23:19:35 ET
Table '1597684021 1' 9-max Seat #3 is the button
Seat 2: JJin91 (368873 in chips)=20
Seat 3: btd0729 (192841 in chips)=20
Seat 4: apoch19 (74672 in chips)=20
Seat 7: Mr Hero76 (162152 in chips)=20
Seat 8: MM9955 (104943 in chips)=20
Seat 9: jvurn (246519 in chips)=20
JJin91: posts the ante 750
btd0729: posts the ante 750
apoch19: posts the ante 750
Mr Hero76: posts the ante 750
MM9955: posts the ante 750
jvurn: posts the ante 750
apoch19: posts small blind 3000
Mr Hero76: posts big blind 6000
*** HOLE CARDS ***
Dealt to JJin91 [Jh Tc]
MM9955: folds=20
jvurn: raises 6000 to 12000
JJin91: folds=20
btd0729: folds=20
apoch19: folds=20
Mr Hero76: folds=20
Uncalled bet (6000) returned to jvurn
jvurn collected 19500 from pot
jvurn: doesn't show hand=20
*** SUMMARY ***
Total pot 19500 | Rake 0=20
Seat 2: JJin91 folded before Flop (didn't bet)
Seat 3: btd0729 (button) folded before Flop (didn't bet)
Seat 4: apoch19 (small blind) folded before Flop
Seat 7: Mr Hero76 (big blind) folded before Flop
Seat 8: MM9955 folded before Flop (didn't bet)
Seat 9: jvurn collected (19500)


*********** # 254 **************
PokerStars Hand #169456942935: Tournament #1597684021, $18.20+$1.80 USD=
 Hold'em No Limit - Level XXIV (3000/6000) - 2017/05/05 23:19:53 ET
Table '1597684021 1' 9-max Seat #4 is the button
Seat 2: JJin91 (368123 in chips)=20
Seat 3: btd0729 (192091 in chips)=20
Seat 4: apoch19 (70922 in chips)=20
Seat 7: Mr Hero76 (155402 in chips)=20
Seat 8: MM9955 (104193 in chips)=20
Seat 9: jvurn (259269 in chips)=20
JJin91: posts the ante 750
btd0729: posts the ante 750
apoch19: posts the ante 750
Mr Hero76: posts the ante 750
MM9955: posts the ante 750
jvurn: posts the ante 750
Mr Hero76: posts small blind 3000
MM9955: posts big blind 6000
*** HOLE CARDS ***
Dealt to JJin91 [3s Jd]
jvurn: folds=20
JJin91: folds=20
btd0729: calls 6000
apoch19: folds=20
Mr Hero76: calls 3000
MM9955: checks=20
*** FLOP *** [Th 4c 8h]
Mr Hero76: checks=20
MM9955: bets 6000
btd0729: calls 6000
Mr Hero76: folds=20
*** TURN *** [Th 4c 8h] [Jh]
MM9955: bets 17250
btd0729: calls 17250
*** RIVER *** [Th 4c 8h Jh] [7c]
MM9955: checks=20
btd0729: checks=20
*** SHOW DOWN ***
MM9955: shows [Ah 7d] (a pair of Sevens)
btd0729: shows [Tc Kh] (a pair of Tens)
btd0729 collected 69000 from pot
*** SUMMARY ***
Total pot 69000 | Rake 0=20
Board [Th 4c 8h Jh 7c]
Seat 2: JJin91 folded before Flop (didn't bet)
Seat 3: btd0729 showed [Tc Kh] and won (69000) with a pair of Tens
Seat 4: apoch19 (button) folded before Flop (didn't bet)
Seat 7: Mr Hero76 (small blind) folded on the Flop
Seat 8: MM9955 (big blind) showed [Ah 7d] and lost with a pair of Sevens
Seat 9: jvurn folded before Flop (didn't bet)


*********** # 255 **************
PokerStars Hand #169456943183: Tournament #1597684021, $18.20+$1.80 USD=
 Hold'em No Limit - Level XXIV (3000/6000) - 2017/05/05 23:20:47 ET
Table '1597684021 1' 9-max Seat #7 is the button
Seat 2: JJin91 (367373 in chips)=20
Seat 3: btd0729 (231091 in chips)=20
Seat 4: apoch19 (70172 in chips)=20
Seat 7: Mr Hero76 (148652 in chips)=20
Seat 8: MM9955 (74193 in chips)=20
Seat 9: jvurn (258519 in chips)=20
JJin91: posts the ante 750
btd0729: posts the ante 750
apoch19: posts the ante 750
Mr Hero76: posts the ante 750
MM9955: posts the ante 750
jvurn: posts the ante 750
MM9955: posts small blind 3000
jvurn: posts big blind 6000
*** HOLE CARDS ***
Dealt to JJin91 [9s 5s]
JJin91: folds=20
btd0729: folds=20
apoch19: folds=20
Mr Hero76: folds=20
MM9955: folds=20
Uncalled bet (3000) returned to jvurn
jvurn collected 10500 from pot
jvurn: doesn't show hand=20
*** SUMMARY ***
Total pot 10500 | Rake 0=20
Seat 2: JJin91 folded before Flop (didn't bet)
Seat 3: btd0729 folded before Flop (didn't bet)
Seat 4: apoch19 folded before Flop (didn't bet)
Seat 7: Mr Hero76 (button) folded before Flop (didn't bet)
Seat 8: MM9955 (small blind) folded before Flop
Seat 9: jvurn (big blind) collected (10500)


*********** # 256 **************
PokerStars Hand #169456943231: Tournament #1597684021, $18.20+$1.80 USD=
 Hold'em No Limit - Level XXIV (3000/6000) - 2017/05/05 23:20:59 ET
Table '1597684021 1' 9-max Seat #8 is the button
Seat 2: JJin91 (366623 in chips)=20
Seat 3: btd0729 (230341 in chips)=20
Seat 4: apoch19 (69422 in chips)=20
Seat 7: Mr Hero76 (147902 in chips)=20
Seat 8: MM9955 (70443 in chips)=20
Seat 9: jvurn (265269 in chips)=20
JJin91: posts the ante 750
btd0729: posts the ante 750
apoch19: posts the ante 750
Mr Hero76: posts the ante 750
MM9955: posts the ante 750
jvurn: posts the ante 750
jvurn: posts small blind 3000
JJin91: posts big blind 6000
*** HOLE CARDS ***
Dealt to JJin91 [Ac 8d]
btd0729: raises 18000 to 24000
apoch19: folds=20
Mr Hero76: folds=20
MM9955: folds=20
jvurn: folds=20
JJin91: folds=20
Uncalled bet (18000) returned to btd0729
btd0729 collected 19500 from pot
btd0729: doesn't show hand=20
*** SUMMARY ***
Total pot 19500 | Rake 0=20
Seat 2: JJin91 (big blind) folded before Flop
Seat 3: btd0729 collected (19500)
Seat 4: apoch19 folded before Flop (didn't bet)
Seat 7: Mr Hero76 folded before Flop (didn't bet)
Seat 8: MM9955 (button) folded before Flop (didn't bet)
Seat 9: jvurn (small blind) folded before Flop


*********** # 257 **************
PokerStars Hand #169456943361: Tournament #1597684021, $18.20+$1.80 USD=
 Hold'em No Limit - Level XXIV (3000/6000) - 2017/05/05 23:21:25 ET
Table '1597684021 1' 9-max Seat #9 is the button
Seat 2: JJin91 (359873 in chips)=20
Seat 3: btd0729 (243091 in chips)=20
Seat 4: apoch19 (68672 in chips)=20
Seat 7: Mr Hero76 (147152 in chips)=20
Seat 8: MM9955 (69693 in chips)=20
Seat 9: jvurn (261519 in chips)=20
JJin91: posts the ante 750
btd0729: posts the ante 750
apoch19: posts the ante 750
Mr Hero76: posts the ante 750
MM9955: posts the ante 750
jvurn: posts the ante 750
JJin91: posts small blind 3000
btd0729: posts big blind 6000
*** HOLE CARDS ***
Dealt to JJin91 [Jh 8s]
apoch19: folds=20
Mr Hero76: folds=20
MM9955: folds=20
jvurn: raises 12000 to 18000
JJin91: folds=20
btd0729: folds=20
Uncalled bet (12000) returned to jvurn
jvurn collected 19500 from pot
jvurn: doesn't show hand=20
*** SUMMARY ***
Total pot 19500 | Rake 0=20
Seat 2: JJin91 (small blind) folded before Flop
Seat 3: btd0729 (big blind) folded before Flop
Seat 4: apoch19 folded before Flop (didn't bet)
Seat 7: Mr Hero76 folded before Flop (didn't bet)
Seat 8: MM9955 folded before Flop (didn't bet)
Seat 9: jvurn (button) collected (19500)


*********** # 258 **************
PokerStars Hand #169456943438: Tournament #1597684021, $18.20+$1.80 USD=
 Hold'em No Limit - Level XXIV (3000/6000) - 2017/05/05 23:21:42 ET
Table '1597684021 1' 9-max Seat #2 is the button
Seat 2: JJin91 (356123 in chips)=20
Seat 3: btd0729 (236341 in chips)=20
Seat 4: apoch19 (67922 in chips)=20
Seat 7: Mr Hero76 (146402 in chips)=20
Seat 8: MM9955 (68943 in chips)=20
Seat 9: jvurn (274269 in chips)=20
JJin91: posts the ante 750
btd0729: posts the ante 750
apoch19: posts the ante 750
Mr Hero76: posts the ante 750
MM9955: posts the ante 750
jvurn: posts the ante 750
btd0729: posts small blind 3000
apoch19: posts big blind 6000
*** HOLE CARDS ***
Dealt to JJin91 [6c Tc]
Mr Hero76: folds=20
MM9955: folds=20
jvurn: folds=20
JJin91: raises 7140 to 13140
btd0729: folds=20
apoch19: raises 54032 to 67172 and is all-in
JJin91: folds=20
Uncalled bet (54032) returned to apoch19
apoch19 collected 33780 from pot
apoch19: doesn't show hand=20
*** SUMMARY ***
Total pot 33780 | Rake 0=20
Seat 2: JJin91 (button) folded before Flop
Seat 3: btd0729 (small blind) folded before Flop
Seat 4: apoch19 (big blind) collected (33780)
Seat 7: Mr Hero76 folded before Flop (didn't bet)
Seat 8: MM9955 folded before Flop (didn't bet)
Seat 9: jvurn folded before Flop (didn't bet)


*********** # 259 **************
PokerStars Hand #169456943550: Tournament #1597684021, $18.20+$1.80 USD=
 Hold'em No Limit - Level XXIV (3000/6000) - 2017/05/05 23:22:05 ET
Table '1597684021 1' 9-max Seat #3 is the button
Seat 2: JJin91 (342233 in chips)=20
Seat 3: btd0729 (232591 in chips)=20
Seat 4: apoch19 (87812 in chips)=20
Seat 7: Mr Hero76 (145652 in chips)=20
Seat 8: MM9955 (68193 in chips)=20
Seat 9: jvurn (273519 in chips)=20
JJin91: posts the ante 750
btd0729: posts the ante 750
apoch19: posts the ante 750
Mr Hero76: posts the ante 750
MM9955: posts the ante 750
jvurn: posts the ante 750
apoch19: posts small blind 3000
Mr Hero76: posts big blind 6000
*** HOLE CARDS ***
Dealt to JJin91 [Ad Qh]
MM9955: folds=20
jvurn: folds=20
JJin91: raises 7140 to 13140
btd0729: folds=20
apoch19: folds=20
Mr Hero76: calls 7140
*** FLOP *** [8d Qc Jd]
Mr Hero76: bets 16890
JJin91: raises 31110 to 48000
Mr Hero76: raises 83762 to 131762 and is all-in
JJin91: calls 83762
*** TURN *** [8d Qc Jd] [7s]
*** RIVER *** [8d Qc Jd 7s] [6h]
*** SHOW DOWN ***
Mr Hero76: shows [Qd Ks] (a pair of Queens)
JJin91: shows [Ad Qh] (a pair of Queens - Ace kicker)
JJin91 collected 297304 from pot
Mr Hero76 finished the tournament in 6th place and received $104.65.
*** SUMMARY ***
Total pot 297304 | Rake 0=20
Board [8d Qc Jd 7s 6h]
Seat 2: JJin91 showed [Ad Qh] and won (297304) with a pair of Queens
Seat 3: btd0729 (button) folded before Flop (didn't bet)
Seat 4: apoch19 (small blind) folded before Flop
Seat 7: Mr Hero76 (big blind) showed [Qd Ks] and lost with a pair of Qu=
eens
Seat 8: MM9955 folded before Flop (didn't bet)
Seat 9: jvurn folded before Flop (didn't bet)


*********** # 260 **************
PokerStars Hand #169456943800: Tournament #1597684021, $18.20+$1.80 USD=
 Hold'em No Limit - Level XXIV (3000/6000) - 2017/05/05 23:22:58 ET
Table '1597684021 1' 9-max Seat #4 is the button
Seat 2: JJin91 (493885 in chips)=20
Seat 3: btd0729 (231841 in chips)=20
Seat 4: apoch19 (84062 in chips)=20
Seat 8: MM9955 (67443 in chips)=20
Seat 9: jvurn (272769 in chips)=20
JJin91: posts the ante 750
btd0729: posts the ante 750
apoch19: posts the ante 750
MM9955: posts the ante 750
jvurn: posts the ante 750
MM9955: posts small blind 3000
jvurn: posts big blind 6000
*** HOLE CARDS ***
Dealt to JJin91 [2d Qs]
JJin91: folds=20
btd0729: folds=20
apoch19: folds=20
MM9955: folds=20
Uncalled bet (3000) returned to jvurn
jvurn collected 9750 from pot
jvurn: doesn't show hand=20
*** SUMMARY ***
Total pot 9750 | Rake 0=20
Seat 2: JJin91 folded before Flop (didn't bet)
Seat 3: btd0729 folded before Flop (didn't bet)
Seat 4: apoch19 (button) folded before Flop (didn't bet)
Seat 8: MM9955 (small blind) folded before Flop
Seat 9: jvurn (big blind) collected (9750)


*********** # 261 **************
PokerStars Hand #169456943851: Tournament #1597684021, $18.20+$1.80 USD=
 Hold'em No Limit - Level XXIV (3000/6000) - 2017/05/05 23:23:10 ET
Table '1597684021 1' 9-max Seat #8 is the button
Seat 2: JJin91 (493135 in chips)=20
Seat 3: btd0729 (231091 in chips)=20
Seat 4: apoch19 (83312 in chips)=20
Seat 8: MM9955 (63693 in chips)=20
Seat 9: jvurn (278769 in chips)=20
JJin91: posts the ante 750
btd0729: posts the ante 750
apoch19: posts the ante 750
MM9955: posts the ante 750
jvurn: posts the ante 750
jvurn: posts small blind 3000
JJin91: posts big blind 6000
*** HOLE CARDS ***
Dealt to JJin91 [4c 7s]
btd0729: calls 6000
apoch19: folds=20
MM9955: folds=20
jvurn: calls 3000
JJin91: checks=20
*** FLOP *** [4d 9d 9c]
jvurn: checks=20
JJin91: bets 6743
btd0729: folds=20
jvurn: folds=20
Uncalled bet (6743) returned to JJin91
JJin91 collected 21750 from pot
JJin91: doesn't show hand=20
*** SUMMARY ***
Total pot 21750 | Rake 0=20
Board [4d 9d 9c]
Seat 2: JJin91 (big blind) collected (21750)
Seat 3: btd0729 folded on the Flop
Seat 4: apoch19 folded before Flop (didn't bet)
Seat 8: MM9955 (button) folded before Flop (didn't bet)
Seat 9: jvurn (small blind) folded on the Flop


*********** # 262 **************
PokerStars Hand #169456943990: Tournament #1597684021, $18.20+$1.80 USD=
 Hold'em No Limit - Level XXV (3500/7000) - 2017/05/05 23:23:38 ET
Table '1597684021 1' 9-max Seat #9 is the button
Seat 2: JJin91 (508135 in chips)=20
Seat 3: btd0729 (224341 in chips)=20
Seat 4: apoch19 (82562 in chips)=20
Seat 8: MM9955 (62943 in chips)=20
Seat 9: jvurn (272019 in chips)=20
JJin91: posts the ante 875
btd0729: posts the ante 875
apoch19: posts the ante 875
MM9955: posts the ante 875
jvurn: posts the ante 875
JJin91: posts small blind 3500
btd0729: posts big blind 7000
*** HOLE CARDS ***
Dealt to JJin91 [Kd 6c]
apoch19: folds=20
MM9955: raises 55068 to 62068 and is all-in
jvurn: calls 62068
JJin91: folds=20
btd0729: folds=20
*** FLOP *** [9h Ah Jd]
*** TURN *** [9h Ah Jd] [Ks]
*** RIVER *** [9h Ah Jd Ks] [3s]
*** SHOW DOWN ***
MM9955: shows [As 2c] (a pair of Aces)
jvurn: shows [4c 4s] (a pair of Fours)
MM9955 collected 139011 from pot
*** SUMMARY ***
Total pot 139011 | Rake 0=20
Board [9h Ah Jd Ks 3s]
Seat 2: JJin91 (small blind) folded before Flop
Seat 3: btd0729 (big blind) folded before Flop
Seat 4: apoch19 folded before Flop (didn't bet)
Seat 8: MM9955 showed [As 2c] and won (139011) with a pair of Aces
Seat 9: jvurn (button) showed [4c 4s] and lost with a pair of Fours


*********** # 263 **************
PokerStars Hand #169456944107: Tournament #1597684021, $18.20+$1.80 USD=
 Hold'em No Limit - Level XXV (3500/7000) - 2017/05/05 23:24:01 ET
Table '1597684021 1' 9-max Seat #2 is the button
Seat 2: JJin91 (503760 in chips)=20
Seat 3: btd0729 (216466 in chips)=20
Seat 4: apoch19 (81687 in chips)=20
Seat 8: MM9955 (139011 in chips)=20
Seat 9: jvurn (209076 in chips)=20
JJin91: posts the ante 875
btd0729: posts the ante 875
apoch19: posts the ante 875
MM9955: posts the ante 875
jvurn: posts the ante 875
btd0729: posts small blind 3500
apoch19: posts big blind 7000
*** HOLE CARDS ***
Dealt to JJin91 [Ah Kc]
MM9955: folds=20
jvurn: raises 7000 to 14000
JJin91: raises 21000 to 35000
btd0729: folds=20
apoch19: folds=20
jvurn: calls 21000
*** FLOP *** [Qc 7c Kh]
jvurn: checks=20
JJin91: bets 44984
jvurn: folds=20
Uncalled bet (44984) returned to JJin91
JJin91 collected 84875 from pot
JJin91: doesn't show hand=20
*** SUMMARY ***
Total pot 84875 | Rake 0=20
Board [Qc 7c Kh]
Seat 2: JJin91 (button) collected (84875)
Seat 3: btd0729 (small blind) folded before Flop
Seat 4: apoch19 (big blind) folded before Flop
Seat 8: MM9955 folded before Flop (didn't bet)
Seat 9: jvurn folded on the Flop


*********** # 264 **************
PokerStars Hand #169456944210: Tournament #1597684021, $18.20+$1.80 USD=
 Hold'em No Limit - Level XXV (3500/7000) - 2017/05/05 23:24:22 ET
Table '1597684021 1' 9-max Seat #3 is the button
Seat 2: JJin91 (552760 in chips)=20
Seat 3: btd0729 (212091 in chips)=20
Seat 4: apoch19 (73812 in chips)=20
Seat 8: MM9955 (138136 in chips)=20
Seat 9: jvurn (173201 in chips)=20
JJin91: posts the ante 875
btd0729: posts the ante 875
apoch19: posts the ante 875
MM9955: posts the ante 875
jvurn: posts the ante 875
apoch19: posts small blind 3500
MM9955: posts big blind 7000
*** HOLE CARDS ***
Dealt to JJin91 [Kc Th]
jvurn: folds=20
JJin91: folds=20
btd0729: folds=20
apoch19: raises 65937 to 72937 and is all-in
MM9955: calls 65937
*** FLOP *** [6c Kh 2c]
*** TURN *** [6c Kh 2c] [2s]
*** RIVER *** [6c Kh 2c 2s] [6s]
*** SHOW DOWN ***
apoch19: shows [4d Ad] (two pair, Sixes and Deuces)
MM9955: shows [As Jh] (two pair, Sixes and Deuces)
apoch19 collected 75125 from pot
MM9955 collected 75124 from pot
*** SUMMARY ***
Total pot 150249 | Rake 0=20
Board [6c Kh 2c 2s 6s]
Seat 2: JJin91 folded before Flop (didn't bet)
Seat 3: btd0729 (button) folded before Flop (didn't bet)
Seat 4: apoch19 (small blind) showed [4d Ad] and won (75125) with two p=
air, Sixes and Deuces
Seat 8: MM9955 (big blind) showed [As Jh] and won (75124) with two pair=
, Sixes and Deuces
Seat 9: jvurn folded before Flop (didn't bet)


*********** # 265 **************
PokerStars Hand #169456944304: Tournament #1597684021, $18.20+$1.80 USD=
 Hold'em No Limit - Level XXV (3500/7000) - 2017/05/05 23:24:43 ET
Table '1597684021 1' 9-max Seat #4 is the button
Seat 2: JJin91 (551885 in chips)=20
Seat 3: btd0729 (211216 in chips)=20
Seat 4: apoch19 (75125 in chips)=20
Seat 8: MM9955 (139448 in chips)=20
Seat 9: jvurn (172326 in chips)=20
JJin91: posts the ante 875
btd0729: posts the ante 875
apoch19: posts the ante 875
MM9955: posts the ante 875
jvurn: posts the ante 875
MM9955: posts small blind 3500
jvurn: posts big blind 7000
*** HOLE CARDS ***
Dealt to JJin91 [4s Jd]
JJin91: folds=20
btd0729: calls 7000
apoch19: folds=20
MM9955: calls 3500
jvurn: checks=20
*** FLOP *** [7d 6h 7c]
MM9955: checks=20
jvurn: checks=20
btd0729: checks=20
*** TURN *** [7d 6h 7c] [8s]
MM9955: checks=20
jvurn: bets 14000
btd0729: folds=20
MM9955: folds=20
Uncalled bet (14000) returned to jvurn
jvurn collected 25375 from pot
jvurn: doesn't show hand=20
*** SUMMARY ***
Total pot 25375 | Rake 0=20
Board [7d 6h 7c 8s]
Seat 2: JJin91 folded before Flop (didn't bet)
Seat 3: btd0729 folded on the Turn
Seat 4: apoch19 (button) folded before Flop (didn't bet)
Seat 8: MM9955 (small blind) folded on the Turn
Seat 9: jvurn (big blind) collected (25375)


*********** # 266 **************
PokerStars Hand #169456944448: Tournament #1597684021, $18.20+$1.80 USD=
 Hold'em No Limit - Level XXV (3500/7000) - 2017/05/05 23:25:14 ET
Table '1597684021 1' 9-max Seat #8 is the button
Seat 2: JJin91 (551010 in chips)=20
Seat 3: btd0729 (203341 in chips)=20
Seat 4: apoch19 (74250 in chips)=20
Seat 8: MM9955 (131573 in chips)=20
Seat 9: jvurn (189826 in chips)=20
JJin91: posts the ante 875
btd0729: posts the ante 875
apoch19: posts the ante 875
MM9955: posts the ante 875
jvurn: posts the ante 875
jvurn: posts small blind 3500
JJin91: posts big blind 7000
*** HOLE CARDS ***
Dealt to JJin91 [8s Jc]
btd0729: folds=20
apoch19: raises 66375 to 73375 and is all-in
MM9955: folds=20
jvurn: folds=20
JJin91: folds=20
Uncalled bet (66375) returned to apoch19
apoch19 collected 21875 from pot
apoch19: doesn't show hand=20
*** SUMMARY ***
Total pot 21875 | Rake 0=20
Seat 2: JJin91 (big blind) folded before Flop
Seat 3: btd0729 folded before Flop (didn't bet)
Seat 4: apoch19 collected (21875)
Seat 8: MM9955 (button) folded before Flop (didn't bet)
Seat 9: jvurn (small blind) folded before Flop


*********** # 267 **************
PokerStars Hand #169456944557: Tournament #1597684021, $18.20+$1.80 USD=
 Hold'em No Limit - Level XXV (3500/7000) - 2017/05/05 23:25:36 ET
Table '1597684021 1' 9-max Seat #9 is the button
Seat 2: JJin91 (543135 in chips)=20
Seat 3: btd0729 (202466 in chips)=20
Seat 4: apoch19 (88250 in chips)=20
Seat 8: MM9955 (130698 in chips)=20
Seat 9: jvurn (185451 in chips)=20
JJin91: posts the ante 875
btd0729: posts the ante 875
apoch19: posts the ante 875
MM9955: posts the ante 875
jvurn: posts the ante 875
JJin91: posts small blind 3500
btd0729: posts big blind 7000
*** HOLE CARDS ***
Dealt to JJin91 [3s Js]
apoch19: folds=20
MM9955: folds=20
jvurn: folds=20
JJin91: raises 7000 to 14000
btd0729: calls 7000
*** FLOP *** [Tc Kc 7h]
JJin91: checks=20
btd0729: checks=20
*** TURN *** [Tc Kc 7h] [2h]
JJin91: checks=20
btd0729: checks=20
*** RIVER *** [Tc Kc 7h 2h] [2d]
JJin91: checks=20
btd0729: checks=20
*** SHOW DOWN ***
JJin91: shows [3s Js] (a pair of Deuces)
btd0729: mucks hand=20
JJin91 collected 32375 from pot
*** SUMMARY ***
Total pot 32375 | Rake 0=20
Board [Tc Kc 7h 2h 2d]
Seat 2: JJin91 (small blind) showed [3s Js] and won (32375) with a pair=
 of Deuces
Seat 3: btd0729 (big blind) mucked [4h 5h]
Seat 4: apoch19 folded before Flop (didn't bet)
Seat 8: MM9955 folded before Flop (didn't bet)
Seat 9: jvurn (button) folded before Flop (didn't bet)


*********** # 268 **************
PokerStars Hand #169456944700: Tournament #1597684021, $18.20+$1.80 USD=
 Hold'em No Limit - Level XXV (3500/7000) - 2017/05/05 23:26:10 ET
Table '1597684021 1' 9-max Seat #2 is the button
Seat 2: JJin91 (560635 in chips)=20
Seat 3: btd0729 (187591 in chips)=20
Seat 4: apoch19 (87375 in chips)=20
Seat 8: MM9955 (129823 in chips)=20
Seat 9: jvurn (184576 in chips)=20
JJin91: posts the ante 875
btd0729: posts the ante 875
apoch19: posts the ante 875
MM9955: posts the ante 875
jvurn: posts the ante 875
btd0729: posts small blind 3500
apoch19: posts big blind 7000
*** HOLE CARDS ***
Dealt to JJin91 [Jc 2h]
MM9955: folds=20
jvurn: raises 7000 to 14000
JJin91: folds=20
btd0729: calls 10500
apoch19: folds=20
*** FLOP *** [Kc 3s 6s]
btd0729: checks=20
jvurn: checks=20
*** TURN *** [Kc 3s 6s] [2d]
btd0729: checks=20
jvurn: bets 21000
btd0729: folds=20
Uncalled bet (21000) returned to jvurn
jvurn collected 39375 from pot
jvurn: doesn't show hand=20
*** SUMMARY ***
Total pot 39375 | Rake 0=20
Board [Kc 3s 6s 2d]
Seat 2: JJin91 (button) folded before Flop (didn't bet)
Seat 3: btd0729 (small blind) folded on the Turn
Seat 4: apoch19 (big blind) folded before Flop
Seat 8: MM9955 folded before Flop (didn't bet)
Seat 9: jvurn collected (39375)


*********** # 269 **************
PokerStars Hand #169456944846: Tournament #1597684021, $18.20+$1.80 USD=
 Hold'em No Limit - Level XXV (3500/7000) - 2017/05/05 23:26:43 ET
Table '1597684021 1' 9-max Seat #3 is the button
Seat 2: JJin91 (559760 in chips)=20
Seat 3: btd0729 (172716 in chips)=20
Seat 4: apoch19 (79500 in chips)=20
Seat 8: MM9955 (128948 in chips)=20
Seat 9: jvurn (209076 in chips)=20
JJin91: posts the ante 875
btd0729: posts the ante 875
apoch19: posts the ante 875
MM9955: posts the ante 875
jvurn: posts the ante 875
apoch19: posts small blind 3500
MM9955: posts big blind 7000
*** HOLE CARDS ***
Dealt to JJin91 [9s Jc]
jvurn: folds=20
JJin91: folds=20
btd0729: folds=20
apoch19: folds=20
Uncalled bet (3500) returned to MM9955
MM9955 collected 11375 from pot
MM9955: doesn't show hand=20
*** SUMMARY ***
Total pot 11375 | Rake 0=20
Seat 2: JJin91 folded before Flop (didn't bet)
Seat 3: btd0729 (button) folded before Flop (didn't bet)
Seat 4: apoch19 (small blind) folded before Flop
Seat 8: MM9955 (big blind) collected (11375)
Seat 9: jvurn folded before Flop (didn't bet)


*********** # 270 **************
PokerStars Hand #169456944926: Tournament #1597684021, $18.20+$1.80 USD=
 Hold'em No Limit - Level XXV (3500/7000) - 2017/05/05 23:27:01 ET
Table '1597684021 1' 9-max Seat #4 is the button
Seat 2: JJin91 (558885 in chips)=20
Seat 3: btd0729 (171841 in chips)=20
Seat 4: apoch19 (75125 in chips)=20
Seat 8: MM9955 (135948 in chips)=20
Seat 9: jvurn (208201 in chips)=20
JJin91: posts the ante 875
btd0729: posts the ante 875
apoch19: posts the ante 875
MM9955: posts the ante 875
jvurn: posts the ante 875
MM9955: posts small blind 3500
jvurn: posts big blind 7000
*** HOLE CARDS ***
Dealt to JJin91 [Qd Td]
JJin91: raises 8330 to 15330
btd0729: folds=20
apoch19: folds=20
MM9955: folds=20
jvurn: calls 8330
*** FLOP *** [2s 5s 7d]
jvurn: checks=20
JJin91: checks=20
*** TURN *** [2s 5s 7d] [4s]
jvurn: bets 42000
JJin91: folds=20
Uncalled bet (42000) returned to jvurn
jvurn collected 38535 from pot
jvurn: doesn't show hand=20
*** SUMMARY ***
Total pot 38535 | Rake 0=20
Board [2s 5s 7d 4s]
Seat 2: JJin91 folded on the Turn
Seat 3: btd0729 folded before Flop (didn't bet)
Seat 4: apoch19 (button) folded before Flop (didn't bet)
Seat 8: MM9955 (small blind) folded before Flop
Seat 9: jvurn (big blind) collected (38535)


*********** # 271 **************
PokerStars Hand #169456945032: Tournament #1597684021, $18.20+$1.80 USD=
 Hold'em No Limit - Level XXV (3500/7000) - 2017/05/05 23:27:27 ET
Table '1597684021 1' 9-max Seat #8 is the button
Seat 2: JJin91 (542680 in chips)=20
Seat 3: btd0729 (170966 in chips)=20
Seat 4: apoch19 (74250 in chips)=20
Seat 8: MM9955 (131573 in chips)=20
Seat 9: jvurn (230531 in chips)=20
JJin91: posts the ante 875
btd0729: posts the ante 875
apoch19: posts the ante 875
MM9955: posts the ante 875
jvurn: posts the ante 875
jvurn: posts small blind 3500
JJin91: posts big blind 7000
*** HOLE CARDS ***
Dealt to JJin91 [5d Ks]
btd0729: folds=20
apoch19: folds=20
MM9955: folds=20
jvurn: raises 7000 to 14000
JJin91: calls 7000
*** FLOP *** [Th 8h Ad]
jvurn: checks=20
JJin91: bets 10036
jvurn: folds=20
Uncalled bet (10036) returned to JJin91
JJin91 collected 32375 from pot
JJin91: doesn't show hand=20
*** SUMMARY ***
Total pot 32375 | Rake 0=20
Board [Th 8h Ad]
Seat 2: JJin91 (big blind) collected (32375)
Seat 3: btd0729 folded before Flop (didn't bet)
Seat 4: apoch19 folded before Flop (didn't bet)
Seat 8: MM9955 (button) folded before Flop (didn't bet)
Seat 9: jvurn (small blind) folded on the Flop


*********** # 272 **************
PokerStars Hand #169456945119: Tournament #1597684021, $18.20+$1.80 USD=
 Hold'em No Limit - Level XXV (3500/7000) - 2017/05/05 23:27:49 ET
Table '1597684021 1' 9-max Seat #9 is the button
Seat 2: JJin91 (560180 in chips)=20
Seat 3: btd0729 (170091 in chips)=20
Seat 4: apoch19 (73375 in chips)=20
Seat 8: MM9955 (130698 in chips)=20
Seat 9: jvurn (215656 in chips)=20
JJin91: posts the ante 875
btd0729: posts the ante 875
apoch19: posts the ante 875
MM9955: posts the ante 875
jvurn: posts the ante 875
JJin91: posts small blind 3500
btd0729: posts big blind 7000
*** HOLE CARDS ***
Dealt to JJin91 [Jc 9h]
apoch19: folds=20
MM9955: folds=20
jvurn: raises 7000 to 14000
JJin91: folds=20
btd0729: folds=20
Uncalled bet (7000) returned to jvurn
jvurn collected 21875 from pot
jvurn: doesn't show hand=20
*** SUMMARY ***
Total pot 21875 | Rake 0=20
Seat 2: JJin91 (small blind) folded before Flop
Seat 3: btd0729 (big blind) folded before Flop
Seat 4: apoch19 folded before Flop (didn't bet)
Seat 8: MM9955 folded before Flop (didn't bet)
Seat 9: jvurn (button) collected (21875)


*********** # 273 **************
PokerStars Hand #169456945175: Tournament #1597684021, $18.20+$1.80 USD=
 Hold'em No Limit - Level XXV (3500/7000) - 2017/05/05 23:28:03 ET
Table '1597684021 1' 9-max Seat #2 is the button
Seat 2: JJin91 (555805 in chips)=20
Seat 3: btd0729 (162216 in chips)=20
Seat 4: apoch19 (72500 in chips)=20
Seat 8: MM9955 (129823 in chips)=20
Seat 9: jvurn (229656 in chips)=20
JJin91: posts the ante 875
btd0729: posts the ante 875
apoch19: posts the ante 875
MM9955: posts the ante 875
jvurn: posts the ante 875
btd0729: posts small blind 3500
apoch19: posts big blind 7000
*** HOLE CARDS ***
Dealt to JJin91 [Kc 3h]
MM9955: folds=20
jvurn: raises 7000 to 14000
JJin91: folds=20
btd0729: raises 28000 to 42000
apoch19: folds=20
jvurn: raises 186781 to 228781 and is all-in
btd0729: calls 119341 and is all-in
Uncalled bet (67440) returned to jvurn
*** FLOP *** [4s 2d Tc]
*** TURN *** [4s 2d Tc] [Ah]
*** RIVER *** [4s 2d Tc Ah] [Ac]
*** SHOW DOWN ***
btd0729: shows [As Jh] (three of a kind, Aces)
jvurn: shows [Js Ad] (three of a kind, Aces)
btd0729 collected 167029 from pot
jvurn collected 167028 from pot
*** SUMMARY ***
Total pot 334057 | Rake 0=20
Board [4s 2d Tc Ah Ac]
Seat 2: JJin91 (button) folded before Flop (didn't bet)
Seat 3: btd0729 (small blind) showed [As Jh] and won (167029) with thre=
e of a kind, Aces
Seat 4: apoch19 (big blind) folded before Flop
Seat 8: MM9955 folded before Flop (didn't bet)
Seat 9: jvurn showed [Js Ad] and won (167028) with three of a kind, Aces


*********** # 274 **************
PokerStars Hand #169456945289: Tournament #1597684021, $18.20+$1.80 USD=
 Hold'em No Limit - Level XXV (3500/7000) - 2017/05/05 23:28:28 ET
Table '1597684021 1' 9-max Seat #3 is the button
Seat 2: JJin91 (554930 in chips)=20
Seat 3: btd0729 (167029 in chips)=20
Seat 4: apoch19 (64625 in chips)=20
Seat 8: MM9955 (128948 in chips)=20
Seat 9: jvurn (234468 in chips)=20
JJin91: posts the ante 875
btd0729: posts the ante 875
apoch19: posts the ante 875
MM9955: posts the ante 875
jvurn: posts the ante 875
apoch19: posts small blind 3500
MM9955: posts big blind 7000
*** HOLE CARDS ***
Dealt to JJin91 [Qs 6s]
jvurn: folds=20
JJin91: folds=20
btd0729: folds=20
apoch19: raises 56750 to 63750 and is all-in
MM9955: folds=20
Uncalled bet (56750) returned to apoch19
apoch19 collected 18375 from pot
apoch19: doesn't show hand=20
*** SUMMARY ***
Total pot 18375 | Rake 0=20
Seat 2: JJin91 folded before Flop (didn't bet)
Seat 3: btd0729 (button) folded before Flop (didn't bet)
Seat 4: apoch19 (small blind) collected (18375)
Seat 8: MM9955 (big blind) folded before Flop
Seat 9: jvurn folded before Flop (didn't bet)


*********** # 275 **************
PokerStars Hand #169456945391: Tournament #1597684021, $18.20+$1.80 USD=
 Hold'em No Limit - Level XXV (3500/7000) - 2017/05/05 23:28:51 ET
Table '1597684021 1' 9-max Seat #4 is the button
Seat 2: JJin91 (554055 in chips)=20
Seat 3: btd0729 (166154 in chips)=20
Seat 4: apoch19 (75125 in chips)=20
Seat 8: MM9955 (121073 in chips)=20
Seat 9: jvurn (233593 in chips)=20
JJin91: posts the ante 875
btd0729: posts the ante 875
apoch19: posts the ante 875
MM9955: posts the ante 875
jvurn: posts the ante 875
MM9955: posts small blind 3500
jvurn: posts big blind 7000
*** HOLE CARDS ***
Dealt to JJin91 [2s 9h]
JJin91: folds=20
btd0729: folds=20
apoch19: raises 67250 to 74250 and is all-in
MM9955: folds=20
jvurn: calls 67250
*** FLOP *** [9c Ts Th]
*** TURN *** [9c Ts Th] [Ac]
*** RIVER *** [9c Ts Th Ac] [6c]
*** SHOW DOWN ***
jvurn: shows [3d 3c] (two pair, Tens and Threes)
apoch19: shows [Jc Kh] (a pair of Tens)
jvurn collected 156375 from pot
apoch19 finished the tournament in 5th place and received $125.58.
*** SUMMARY ***
Total pot 156375 | Rake 0=20
Board [9c Ts Th Ac 6c]
Seat 2: JJin91 folded before Flop (didn't bet)
Seat 3: btd0729 folded before Flop (didn't bet)
Seat 4: apoch19 (button) showed [Jc Kh] and lost with a pair of Tens
Seat 8: MM9955 (small blind) folded before Flop
Seat 9: jvurn (big blind) showed [3d 3c] and won (156375) with two pair=
, Tens and Threes


*********** # 276 **************
PokerStars Hand #169456945522: Tournament #1597684021, $18.20+$1.80 USD=
 Hold'em No Limit - Level XXV (3500/7000) - 2017/05/05 23:29:18 ET
Table '1597684021 1' 9-max Seat #8 is the button
Seat 2: JJin91 (553180 in chips)=20
Seat 3: btd0729 (165279 in chips)=20
Seat 8: MM9955 (116698 in chips)=20
Seat 9: jvurn (314843 in chips)=20
JJin91: posts the ante 875
btd0729: posts the ante 875
MM9955: posts the ante 875
jvurn: posts the ante 875
jvurn: posts small blind 3500
JJin91: posts big blind 7000
*** HOLE CARDS ***
Dealt to JJin91 [Ah Jd]
btd0729: folds=20
MM9955: folds=20
jvurn: raises 14000 to 21000
JJin91: calls 14000
*** FLOP *** [5s 2c Kh]
jvurn: bets 21000
JJin91: calls 21000
*** TURN *** [5s 2c Kh] [7h]
jvurn: checks=20
JJin91: bets 46375
jvurn: folds=20
Uncalled bet (46375) returned to JJin91
JJin91 collected 87500 from pot
JJin91: doesn't show hand=20
*** SUMMARY ***
Total pot 87500 | Rake 0=20
Board [5s 2c Kh 7h]
Seat 2: JJin91 (big blind) collected (87500)
Seat 3: btd0729 folded before Flop (didn't bet)
Seat 8: MM9955 (button) folded before Flop (didn't bet)
Seat 9: jvurn (small blind) folded on the Turn


*********** # 277 **************
PokerStars Hand #169456945632: Tournament #1597684021, $18.20+$1.80 USD=
 Hold'em No Limit - Level XXV (3500/7000) - 2017/05/05 23:29:44 ET
Table '1597684021 1' 9-max Seat #9 is the button
Seat 2: JJin91 (597805 in chips)=20
Seat 3: btd0729 (164404 in chips)=20
Seat 8: MM9955 (115823 in chips)=20
Seat 9: jvurn (271968 in chips)=20
JJin91: posts the ante 875
btd0729: posts the ante 875
MM9955: posts the ante 875
jvurn: posts the ante 875
JJin91: posts small blind 3500
btd0729: posts big blind 7000
*** HOLE CARDS ***
Dealt to JJin91 [9c 5h]
MM9955: folds=20
jvurn: folds=20
JJin91: folds=20
Uncalled bet (3500) returned to btd0729
btd0729 collected 10500 from pot
btd0729: doesn't show hand=20
*** SUMMARY ***
Total pot 10500 | Rake 0=20
Seat 2: JJin91 (small blind) folded before Flop
Seat 3: btd0729 (big blind) collected (10500)
Seat 8: MM9955 folded before Flop (didn't bet)
Seat 9: jvurn (button) folded before Flop (didn't bet)


*********** # 278 **************
PokerStars Hand #169456945673: Tournament #1597684021, $18.20+$1.80 USD=
 Hold'em No Limit - Level XXV (3500/7000) - 2017/05/05 23:29:54 ET
Table '1597684021 1' 9-max Seat #2 is the button
Seat 2: JJin91 (593430 in chips)=20
Seat 3: btd0729 (170529 in chips)=20
Seat 8: MM9955 (114948 in chips)=20
Seat 9: jvurn (271093 in chips)=20
JJin91: posts the ante 875
btd0729: posts the ante 875
MM9955: posts the ante 875
jvurn: posts the ante 875
btd0729: posts small blind 3500
MM9955: posts big blind 7000
*** HOLE CARDS ***
Dealt to JJin91 [Ac 8d]
jvurn: folds=20
JJin91: raises 8330 to 15330
btd0729: folds=20
MM9955: calls 8330
*** FLOP *** [5c Tc Td]
MM9955: checks=20
JJin91: checks=20
*** TURN *** [5c Tc Td] [Qd]
MM9955: checks=20
JJin91: checks=20
*** RIVER *** [5c Tc Td Qd] [Kh]
MM9955: checks=20
JJin91: checks=20
*** SHOW DOWN ***
MM9955: shows [8s Js] (a pair of Tens)
JJin91: shows [Ac 8d] (a pair of Tens - Ace kicker)
JJin91 collected 37660 from pot
*** SUMMARY ***
Total pot 37660 | Rake 0=20
Board [5c Tc Td Qd Kh]
Seat 2: JJin91 (button) showed [Ac 8d] and won (37660) with a pair of T=
ens
Seat 3: btd0729 (small blind) folded before Flop
Seat 8: MM9955 (big blind) showed [8s Js] and lost with a pair of Tens
Seat 9: jvurn folded before Flop (didn't bet)


*********** # 279 **************
PokerStars Hand #169456945796: Tournament #1597684021, $18.20+$1.80 USD=
 Hold'em No Limit - Level XXV (3500/7000) - 2017/05/05 23:30:21 ET
Table '1597684021 1' 9-max Seat #3 is the button
Seat 2: JJin91 (614885 in chips)=20
Seat 3: btd0729 (166154 in chips)=20
Seat 8: MM9955 (98743 in chips)=20
Seat 9: jvurn (270218 in chips)=20
JJin91: posts the ante 875
btd0729: posts the ante 875
MM9955: posts the ante 875
jvurn: posts the ante 875
MM9955: posts small blind 3500
jvurn: posts big blind 7000
*** HOLE CARDS ***
Dealt to JJin91 [Jh 8h]
JJin91: folds=20
btd0729: folds=20
MM9955: calls 3500
jvurn: raises 17500 to 24500
MM9955: folds=20
Uncalled bet (17500) returned to jvurn
jvurn collected 17500 from pot
jvurn: doesn't show hand=20
*** SUMMARY ***
Total pot 17500 | Rake 0=20
Seat 2: JJin91 folded before Flop (didn't bet)
Seat 3: btd0729 (button) folded before Flop (didn't bet)
Seat 8: MM9955 (small blind) folded before Flop
Seat 9: jvurn (big blind) collected (17500)


*********** # 280 **************
PokerStars Hand #169456945886: Tournament #1597684021, $18.20+$1.80 USD=
 Hold'em No Limit - Level XXV (3500/7000) - 2017/05/05 23:30:42 ET
Table '1597684021 1' 9-max Seat #8 is the button
Seat 2: JJin91 (614010 in chips)=20
Seat 3: btd0729 (165279 in chips)=20
Seat 8: MM9955 (90868 in chips)=20
Seat 9: jvurn (279843 in chips)=20
JJin91: posts the ante 875
btd0729: posts the ante 875
MM9955: posts the ante 875
jvurn: posts the ante 875
jvurn: posts small blind 3500
JJin91: posts big blind 7000
*** HOLE CARDS ***
Dealt to JJin91 [2h 4s]
btd0729: folds=20
MM9955: raises 14000 to 21000
jvurn: folds=20
JJin91: folds=20
Uncalled bet (14000) returned to MM9955
MM9955 collected 21000 from pot
MM9955: doesn't show hand=20
*** SUMMARY ***
Total pot 21000 | Rake 0=20
Seat 2: JJin91 (big blind) folded before Flop
Seat 3: btd0729 folded before Flop (didn't bet)
Seat 8: MM9955 (button) collected (21000)
Seat 9: jvurn (small blind) folded before Flop


*********** # 281 **************
PokerStars Hand #169456945969: Tournament #1597684021, $18.20+$1.80 USD=
 Hold'em No Limit - Level XXV (3500/7000) - 2017/05/05 23:30:59 ET
Table '1597684021 1' 9-max Seat #9 is the button
Seat 2: JJin91 (606135 in chips)=20
Seat 3: btd0729 (164404 in chips)=20
Seat 8: MM9955 (103993 in chips)=20
Seat 9: jvurn (275468 in chips)=20
JJin91: posts the ante 875
btd0729: posts the ante 875
MM9955: posts the ante 875
jvurn: posts the ante 875
JJin91: posts small blind 3500
btd0729: posts big blind 7000
*** HOLE CARDS ***
Dealt to JJin91 [2s Ad]
MM9955: raises 14000 to 21000
jvurn: calls 21000
JJin91: folds=20
btd0729: folds=20
*** FLOP *** [4h Qc 3d]
MM9955: bets 82118 and is all-in
jvurn: calls 82118
*** TURN *** [4h Qc 3d] [Js]
*** RIVER *** [4h Qc 3d Js] [Kc]
*** SHOW DOWN ***
MM9955: shows [5h Ac] (high card Ace)
jvurn: shows [8c Ah] (high card Ace - King+Queen+Jack+Eight kicker)
jvurn collected 220236 from pot
MM9955 finished the tournament in 4th place and received $188.37.
*** SUMMARY ***
Total pot 220236 | Rake 0=20
Board [4h Qc 3d Js Kc]
Seat 2: JJin91 (small blind) folded before Flop
Seat 3: btd0729 (big blind) folded before Flop
Seat 8: MM9955 showed [5h Ac] and lost with high card Ace
Seat 9: jvurn (button) showed [8c Ah] and won (220236) with high card A=
ce


*********** # 282 **************
PokerStars Hand #169456946071: Tournament #1597684021, $18.20+$1.80 USD=
 Hold'em No Limit - Level XXV (3500/7000) - 2017/05/05 23:31:22 ET
Table '1597684021 1' 9-max Seat #2 is the button
Seat 2: JJin91 (601760 in chips)=20
Seat 3: btd0729 (156529 in chips)=20
Seat 9: jvurn (391711 in chips)=20
JJin91: posts the ante 875
btd0729: posts the ante 875
jvurn: posts the ante 875
btd0729: posts small blind 3500
jvurn: posts big blind 7000
*** HOLE CARDS ***
Dealt to JJin91 [3c 8c]
JJin91: raises 8330 to 15330
btd0729: folds=20
jvurn: folds=20
Uncalled bet (8330) returned to JJin91
JJin91 collected 20125 from pot
JJin91: doesn't show hand=20
*** SUMMARY ***
Total pot 20125 | Rake 0=20
Seat 2: JJin91 (button) collected (20125)
Seat 3: btd0729 (small blind) folded before Flop
Seat 9: jvurn (big blind) folded before Flop


*********** # 283 **************
PokerStars Hand #169456946125: Tournament #1597684021, $18.20+$1.80 USD=
 Hold'em No Limit - Level XXV (3500/7000) - 2017/05/05 23:31:35 ET
Table '1597684021 1' 9-max Seat #3 is the button
Seat 2: JJin91 (614010 in chips)=20
Seat 3: btd0729 (152154 in chips)=20
Seat 9: jvurn (383836 in chips)=20
JJin91: posts the ante 875
btd0729: posts the ante 875
jvurn: posts the ante 875
jvurn: posts small blind 3500
JJin91: posts big blind 7000
*** HOLE CARDS ***
Dealt to JJin91 [8d Kh]
btd0729: folds=20
jvurn: calls 3500
JJin91: checks=20
*** FLOP *** [7c 3h 7h]
jvurn: checks=20
JJin91: bets 8811
jvurn: calls 8811
*** TURN *** [7c 3h 7h] [3s]
jvurn: checks=20
JJin91: bets 10617
jvurn: calls 10617
*** RIVER *** [7c 3h 7h 3s] [Ac]
jvurn: bets 56000
JJin91: folds=20
Uncalled bet (56000) returned to jvurn
jvurn collected 55481 from pot
jvurn: doesn't show hand=20
*** SUMMARY ***
Total pot 55481 | Rake 0=20
Board [7c 3h 7h 3s Ac]
Seat 2: JJin91 (big blind) folded on the River
Seat 3: btd0729 (button) folded before Flop (didn't bet)
Seat 9: jvurn (small blind) collected (55481)


*********** # 284 **************
PokerStars Hand #169456946281: Tournament #1597684021, $18.20+$1.80 USD=
 Hold'em No Limit - Level XXV (3500/7000) - 2017/05/05 23:32:15 ET
Table '1597684021 1' 9-max Seat #9 is the button
Seat 2: JJin91 (586707 in chips)=20
Seat 3: btd0729 (151279 in chips)=20
Seat 9: jvurn (412014 in chips)=20
JJin91: posts the ante 875
btd0729: posts the ante 875
jvurn: posts the ante 875
JJin91: posts small blind 3500
btd0729: posts big blind 7000
*** HOLE CARDS ***
Dealt to JJin91 [2d 2s]
jvurn: raises 14000 to 21000
JJin91: calls 17500
btd0729: folds=20
*** FLOP *** [8c Jh Kd]
JJin91: checks=20
jvurn: bets 28000
JJin91: folds=20
Uncalled bet (28000) returned to jvurn
jvurn collected 51625 from pot
jvurn: doesn't show hand=20
*** SUMMARY ***
Total pot 51625 | Rake 0=20
Board [8c Jh Kd]
Seat 2: JJin91 (small blind) folded on the Flop
Seat 3: btd0729 (big blind) folded before Flop
Seat 9: jvurn (button) collected (51625)


*********** # 285 **************
PokerStars Hand #169456946368: Tournament #1597684021, $18.20+$1.80 USD=
 Hold'em No Limit - Level XXV (3500/7000) - 2017/05/05 23:32:35 ET
Table '1597684021 1' 9-max Seat #2 is the button
Seat 2: JJin91 (564832 in chips)=20
Seat 3: btd0729 (143404 in chips)=20
Seat 9: jvurn (441764 in chips)=20
JJin91: posts the ante 875
btd0729: posts the ante 875
jvurn: posts the ante 875
btd0729: posts small blind 3500
jvurn: posts big blind 7000
*** HOLE CARDS ***
Dealt to JJin91 [Td Jd]
JJin91: raises 8330 to 15330
btd0729: raises 127199 to 142529 and is all-in
jvurn: folds=20
JJin91: folds=20
Uncalled bet (127199) returned to btd0729
btd0729 collected 40285 from pot
*** SUMMARY ***
Total pot 40285 | Rake 0=20
Seat 2: JJin91 (button) folded before Flop
Seat 3: btd0729 (small blind) collected (40285)
Seat 9: jvurn (big blind) folded before Flop


*********** # 286 **************
PokerStars Hand #169456946423: Tournament #1597684021, $18.20+$1.80 USD=
 Hold'em No Limit - Level XXV (3500/7000) - 2017/05/05 23:32:51 ET
Table '1597684021 1' 9-max Seat #3 is the button
Seat 2: JJin91 (548627 in chips)=20
Seat 3: btd0729 (167484 in chips)=20
Seat 9: jvurn (433889 in chips)=20
JJin91: posts the ante 875
btd0729: posts the ante 875
jvurn: posts the ante 875
jvurn: posts small blind 3500
JJin91: posts big blind 7000
*** HOLE CARDS ***
Dealt to JJin91 [8c 3c]
btd0729: folds=20
jvurn: raises 16625 to 23625
JJin91: folds=20
Uncalled bet (16625) returned to jvurn
jvurn collected 16625 from pot
jvurn: doesn't show hand=20
*** SUMMARY ***
Total pot 16625 | Rake 0=20
Seat 2: JJin91 (big blind) folded before Flop
Seat 3: btd0729 (button) folded before Flop (didn't bet)
Seat 9: jvurn (small blind) collected (16625)


*********** # 287 **************
PokerStars Hand #169456946478: Tournament #1597684021, $18.20+$1.80 USD=
 Hold'em No Limit - Level XXV (3500/7000) - 2017/05/05 23:33:02 ET
Table '1597684021 1' 9-max Seat #9 is the button
Seat 2: JJin91 (540752 in chips)=20
Seat 3: btd0729 (166609 in chips)=20
Seat 9: jvurn (442639 in chips)=20
JJin91: posts the ante 875
btd0729: posts the ante 875
jvurn: posts the ante 875
JJin91: posts small blind 3500
btd0729: posts big blind 7000
*** HOLE CARDS ***
Dealt to JJin91 [Js 8h]
jvurn: raises 20125 to 27125
JJin91: folds=20
btd0729: folds=20
Uncalled bet (20125) returned to jvurn
jvurn collected 20125 from pot
jvurn: doesn't show hand=20
*** SUMMARY ***
Total pot 20125 | Rake 0=20
Seat 2: JJin91 (small blind) folded before Flop
Seat 3: btd0729 (big blind) folded before Flop
Seat 9: jvurn (button) collected (20125)


*********** # 288 **************
PokerStars Hand #169456946523: Tournament #1597684021, $18.20+$1.80 USD=
 Hold'em No Limit - Level XXV (3500/7000) - 2017/05/05 23:33:13 ET
Table '1597684021 1' 9-max Seat #2 is the button
Seat 2: JJin91 (536377 in chips)=20
Seat 3: btd0729 (158734 in chips)=20
Seat 9: jvurn (454889 in chips)=20
JJin91: posts the ante 875
btd0729: posts the ante 875
jvurn: posts the ante 875
btd0729: posts small blind 3500
jvurn: posts big blind 7000
*** HOLE CARDS ***
Dealt to JJin91 [Kh 3d]
JJin91: folds=20
btd0729: raises 150859 to 157859 and is all-in
jvurn: folds=20
Uncalled bet (150859) returned to btd0729
btd0729 collected 16625 from pot
btd0729: doesn't show hand=20
*** SUMMARY ***
Total pot 16625 | Rake 0=20
Seat 2: JJin91 (button) folded before Flop (didn't bet)
Seat 3: btd0729 (small blind) collected (16625)
Seat 9: jvurn (big blind) folded before Flop


*********** # 289 **************
PokerStars Hand #169456946568: Tournament #1597684021, $18.20+$1.80 USD=
 Hold'em No Limit - Level XXV (3500/7000) - 2017/05/05 23:33:25 ET
Table '1597684021 1' 9-max Seat #3 is the button
Seat 2: JJin91 (535502 in chips)=20
Seat 3: btd0729 (167484 in chips)=20
Seat 9: jvurn (447014 in chips)=20
JJin91: posts the ante 875
btd0729: posts the ante 875
jvurn: posts the ante 875
jvurn: posts small blind 3500
JJin91: posts big blind 7000
*** HOLE CARDS ***
Dealt to JJin91 [8d Kh]
btd0729: folds=20
jvurn: calls 3500
JJin91: raises 14000 to 21000
jvurn: calls 14000
*** FLOP *** [4d 7d 9s]
jvurn: checks=20
JJin91: checks=20
*** TURN *** [4d 7d 9s] [Qs]
jvurn: bets 7000
JJin91: calls 7000
*** RIVER *** [4d 7d 9s Qs] [Ah]
jvurn: checks=20
JJin91: bets 58625
jvurn: calls 58625
*** SHOW DOWN ***
JJin91: shows [8d Kh] (high card Ace)
jvurn: shows [Qd 6c] (a pair of Queens)
jvurn collected 175875 from pot
*** SUMMARY ***
Total pot 175875 | Rake 0=20
Board [4d 7d 9s Qs Ah]
Seat 2: JJin91 (big blind) showed [8d Kh] and lost with high card Ace
Seat 3: btd0729 (button) folded before Flop (didn't bet)
Seat 9: jvurn (small blind) showed [Qd 6c] and won (175875) with a pair=
 of Queens


*********** # 290 **************
PokerStars Hand #169456946724: Tournament #1597684021, $18.20+$1.80 USD=
 Hold'em No Limit - Level XXVI (4000/8000) - 2017/05/05 23:34:01 ET
Table '1597684021 1' 9-max Seat #9 is the button
Seat 2: JJin91 (448002 in chips)=20
Seat 3: btd0729 (166609 in chips)=20
Seat 9: jvurn (535389 in chips)=20
JJin91: posts the ante 1000
btd0729: posts the ante 1000
jvurn: posts the ante 1000
JJin91: posts small blind 4000
btd0729: posts big blind 8000
*** HOLE CARDS ***
Dealt to JJin91 [5s 2c]
jvurn: raises 526389 to 534389 and is all-in
JJin91: folds=20
btd0729: folds=20
Uncalled bet (526389) returned to jvurn
jvurn collected 23000 from pot
jvurn: doesn't show hand=20
*** SUMMARY ***
Total pot 23000 | Rake 0=20
Seat 2: JJin91 (small blind) folded before Flop
Seat 3: btd0729 (big blind) folded before Flop
Seat 9: jvurn (button) collected (23000)


*********** # 291 **************
PokerStars Hand #169456946768: Tournament #1597684021, $18.20+$1.80 USD=
 Hold'em No Limit - Level XXVI (4000/8000) - 2017/05/05 23:34:12 ET
Table '1597684021 1' 9-max Seat #2 is the button
Seat 2: JJin91 (443002 in chips)=20
Seat 3: btd0729 (157609 in chips)=20
Seat 9: jvurn (549389 in chips)=20
JJin91: posts the ante 1000
btd0729: posts the ante 1000
jvurn: posts the ante 1000
btd0729: posts small blind 4000
jvurn: posts big blind 8000
*** HOLE CARDS ***
Dealt to JJin91 [4d Qs]
JJin91: folds=20
btd0729: calls 4000
jvurn: checks=20
*** FLOP *** [Ad 6d 2h]
btd0729: checks=20
jvurn: checks=20
*** TURN *** [Ad 6d 2h] [Jc]
btd0729: checks=20
jvurn: checks=20
*** RIVER *** [Ad 6d 2h Jc] [Tc]
btd0729: bets 8000
jvurn: folds=20
Uncalled bet (8000) returned to btd0729
btd0729 collected 19000 from pot
*** SUMMARY ***
Total pot 19000 | Rake 0=20
Board [Ad 6d 2h Jc Tc]
Seat 2: JJin91 (button) folded before Flop (didn't bet)
Seat 3: btd0729 (small blind) collected (19000)
Seat 9: jvurn (big blind) folded on the River


*********** # 292 **************
PokerStars Hand #169456946872: Tournament #1597684021, $18.20+$1.80 USD=
 Hold'em No Limit - Level XXVI (4000/8000) - 2017/05/05 23:34:37 ET
Table '1597684021 1' 9-max Seat #3 is the button
Seat 2: JJin91 (442002 in chips)=20
Seat 3: btd0729 (167609 in chips)=20
Seat 9: jvurn (540389 in chips)=20
JJin91: posts the ante 1000
btd0729: posts the ante 1000
jvurn: posts the ante 1000
jvurn: posts small blind 4000
JJin91: posts big blind 8000
*** HOLE CARDS ***
Dealt to JJin91 [2c Jh]
btd0729: calls 8000
jvurn: calls 4000
JJin91: checks=20
*** FLOP *** [Td Qs 5s]
jvurn: checks=20
JJin91: checks=20
btd0729: bets 16000
jvurn: folds=20
JJin91: folds=20
Uncalled bet (16000) returned to btd0729
btd0729 collected 27000 from pot
btd0729: doesn't show hand=20
*** SUMMARY ***
Total pot 27000 | Rake 0=20
Board [Td Qs 5s]
Seat 2: JJin91 (big blind) folded on the Flop
Seat 3: btd0729 (button) collected (27000)
Seat 9: jvurn (small blind) folded on the Flop


*********** # 293 **************
PokerStars Hand #169456946970: Tournament #1597684021, $18.20+$1.80 USD=
 Hold'em No Limit - Level XXVI (4000/8000) - 2017/05/05 23:35:02 ET
Table '1597684021 1' 9-max Seat #9 is the button
Seat 2: JJin91 (433002 in chips)=20
Seat 3: btd0729 (185609 in chips)=20
Seat 9: jvurn (531389 in chips)=20
JJin91: posts the ante 1000
btd0729: posts the ante 1000
jvurn: posts the ante 1000
JJin91: posts small blind 4000
btd0729: posts big blind 8000
*** HOLE CARDS ***
Dealt to JJin91 [8s 7h]
jvurn: folds=20
JJin91: calls 4000
btd0729: checks=20
*** FLOP *** [Tc Qs 3s]
JJin91: checks=20
btd0729: checks=20
*** TURN *** [Tc Qs 3s] [Jh]
JJin91: bets 10070
btd0729: calls 10070
*** RIVER *** [Tc Qs 3s Jh] [Td]
JJin91: checks=20
btd0729: checks=20
*** SHOW DOWN ***
JJin91: shows [8s 7h] (a pair of Tens)
btd0729: shows [5c Ks] (a pair of Tens - King kicker)
btd0729 collected 39140 from pot
*** SUMMARY ***
Total pot 39140 | Rake 0=20
Board [Tc Qs 3s Jh Td]
Seat 2: JJin91 (small blind) showed [8s 7h] and lost with a pair of Tens
Seat 3: btd0729 (big blind) showed [5c Ks] and won (39140) with a pair =
of Tens
Seat 9: jvurn (button) folded before Flop (didn't bet)


*********** # 294 **************
PokerStars Hand #169456947170: Tournament #1597684021, $18.20+$1.80 USD=
 Hold'em No Limit - Level XXVI (4000/8000) - 2017/05/05 23:35:49 ET
Table '1597684021 1' 9-max Seat #2 is the button
Seat 2: JJin91 (413932 in chips)=20
Seat 3: btd0729 (205679 in chips)=20
Seat 9: jvurn (530389 in chips)=20
JJin91: posts the ante 1000
btd0729: posts the ante 1000
jvurn: posts the ante 1000
btd0729: posts small blind 4000
jvurn: posts big blind 8000
*** HOLE CARDS ***
Dealt to JJin91 [Jc 2d]
JJin91: folds=20
btd0729: folds=20
Uncalled bet (4000) returned to jvurn
jvurn collected 11000 from pot
jvurn: doesn't show hand=20
*** SUMMARY ***
Total pot 11000 | Rake 0=20
Seat 2: JJin91 (button) folded before Flop (didn't bet)
Seat 3: btd0729 (small blind) folded before Flop
Seat 9: jvurn (big blind) collected (11000)


*********** # 295 **************
PokerStars Hand #169456947216: Tournament #1597684021, $18.20+$1.80 USD=
 Hold'em No Limit - Level XXVI (4000/8000) - 2017/05/05 23:36:00 ET
Table '1597684021 1' 9-max Seat #3 is the button
Seat 2: JJin91 (412932 in chips)=20
Seat 3: btd0729 (200679 in chips)=20
Seat 9: jvurn (536389 in chips)=20
JJin91: posts the ante 1000
btd0729: posts the ante 1000
jvurn: posts the ante 1000
jvurn: posts small blind 4000
JJin91: posts big blind 8000
*** HOLE CARDS ***
Dealt to JJin91 [Qh 4h]
btd0729: folds=20
jvurn: raises 16000 to 24000
JJin91: folds=20
Uncalled bet (16000) returned to jvurn
jvurn collected 19000 from pot
jvurn: doesn't show hand=20
*** SUMMARY ***
Total pot 19000 | Rake 0=20
Seat 2: JJin91 (big blind) folded before Flop
Seat 3: btd0729 (button) folded before Flop (didn't bet)
Seat 9: jvurn (small blind) collected (19000)


*********** # 296 **************
PokerStars Hand #169456947273: Tournament #1597684021, $18.20+$1.80 USD=
 Hold'em No Limit - Level XXVI (4000/8000) - 2017/05/05 23:36:13 ET
Table '1597684021 1' 9-max Seat #9 is the button
Seat 2: JJin91 (403932 in chips)=20
Seat 3: btd0729 (199679 in chips)=20
Seat 9: jvurn (546389 in chips)=20
JJin91: posts the ante 1000
btd0729: posts the ante 1000
jvurn: posts the ante 1000
JJin91: posts small blind 4000
btd0729: posts big blind 8000
*** HOLE CARDS ***
Dealt to JJin91 [5c Th]
jvurn: raises 8000 to 16000
JJin91: folds=20
btd0729: folds=20
Uncalled bet (8000) returned to jvurn
jvurn collected 23000 from pot
jvurn: doesn't show hand=20
*** SUMMARY ***
Total pot 23000 | Rake 0=20
Seat 2: JJin91 (small blind) folded before Flop
Seat 3: btd0729 (big blind) folded before Flop
Seat 9: jvurn (button) collected (23000)


*********** # 297 **************
PokerStars Hand #169456947323: Tournament #1597684021, $18.20+$1.80 USD=
 Hold'em No Limit - Level XXVI (4000/8000) - 2017/05/05 23:36:27 ET
Table '1597684021 1' 9-max Seat #2 is the button
Seat 2: JJin91 (398932 in chips)=20
Seat 3: btd0729 (190679 in chips)=20
Seat 9: jvurn (560389 in chips)=20
JJin91: posts the ante 1000
btd0729: posts the ante 1000
jvurn: posts the ante 1000
btd0729: posts small blind 4000
jvurn: posts big blind 8000
*** HOLE CARDS ***
Dealt to JJin91 [4s Jh]
JJin91: raises 9520 to 17520
btd0729: folds=20
jvurn: folds=20
Uncalled bet (9520) returned to JJin91
JJin91 collected 23000 from pot
JJin91: doesn't show hand=20
*** SUMMARY ***
Total pot 23000 | Rake 0=20
Seat 2: JJin91 (button) collected (23000)
Seat 3: btd0729 (small blind) folded before Flop
Seat 9: jvurn (big blind) folded before Flop


*********** # 298 **************
PokerStars Hand #169456947371: Tournament #1597684021, $18.20+$1.80 USD=
 Hold'em No Limit - Level XXVI (4000/8000) - 2017/05/05 23:36:38 ET
Table '1597684021 1' 9-max Seat #3 is the button
Seat 2: JJin91 (412932 in chips)=20
Seat 3: btd0729 (185679 in chips)=20
Seat 9: jvurn (551389 in chips)=20
JJin91: posts the ante 1000
btd0729: posts the ante 1000
jvurn: posts the ante 1000
jvurn: posts small blind 4000
JJin91: posts big blind 8000
*** HOLE CARDS ***
Dealt to JJin91 [Jd 4h]
btd0729: folds=20
jvurn: raises 8000 to 16000
JJin91: calls 8000
*** FLOP *** [9s 7d 5s]
jvurn: checks=20
JJin91: checks=20
*** TURN *** [9s 7d 5s] [3c]
jvurn: bets 32000
JJin91: folds=20
Uncalled bet (32000) returned to jvurn
jvurn collected 35000 from pot
jvurn: doesn't show hand=20
*** SUMMARY ***
Total pot 35000 | Rake 0=20
Board [9s 7d 5s 3c]
Seat 2: JJin91 (big blind) folded on the Turn
Seat 3: btd0729 (button) folded before Flop (didn't bet)
Seat 9: jvurn (small blind) collected (35000)


*********** # 299 **************
PokerStars Hand #169456947453: Tournament #1597684021, $18.20+$1.80 USD=
 Hold'em No Limit - Level XXVI (4000/8000) - 2017/05/05 23:36:57 ET
Table '1597684021 1' 9-max Seat #9 is the button
Seat 2: JJin91 (395932 in chips)=20
Seat 3: btd0729 (184679 in chips)=20
Seat 9: jvurn (569389 in chips)=20
JJin91: posts the ante 1000
btd0729: posts the ante 1000
jvurn: posts the ante 1000
JJin91: posts small blind 4000
btd0729: posts big blind 8000
*** HOLE CARDS ***
Dealt to JJin91 [8c Th]
jvurn: raises 8000 to 16000
JJin91: folds=20
btd0729: folds=20
Uncalled bet (8000) returned to jvurn
jvurn collected 23000 from pot
jvurn: doesn't show hand=20
*** SUMMARY ***
Total pot 23000 | Rake 0=20
Seat 2: JJin91 (small blind) folded before Flop
Seat 3: btd0729 (big blind) folded before Flop
Seat 9: jvurn (button) collected (23000)


*********** # 300 **************
PokerStars Hand #169456947500: Tournament #1597684021, $18.20+$1.80 USD=
 Hold'em No Limit - Level XXVI (4000/8000) - 2017/05/05 23:37:08 ET
Table '1597684021 1' 9-max Seat #2 is the button
Seat 2: JJin91 (390932 in chips)=20
Seat 3: btd0729 (175679 in chips)=20
Seat 9: jvurn (583389 in chips)=20
JJin91: posts the ante 1000
btd0729: posts the ante 1000
jvurn: posts the ante 1000
btd0729: posts small blind 4000
jvurn: posts big blind 8000
*** HOLE CARDS ***
Dealt to JJin91 [Td Ts]
JJin91: raises 9520 to 17520
btd0729: folds=20
jvurn: calls 9520
*** FLOP *** [Qc 3c 3d]
jvurn: checks=20
JJin91: checks=20
*** TURN *** [Qc 3c 3d] [7d]
jvurn: bets 40000
JJin91: calls 40000
*** RIVER *** [Qc 3c 3d 7d] [2c]
jvurn: bets 64000
JJin91: calls 64000
*** SHOW DOWN ***
jvurn: shows [7c 9c] (a flush, Queen high)
JJin91: mucks hand=20
jvurn collected 250040 from pot
*** SUMMARY ***
Total pot 250040 | Rake 0=20
Board [Qc 3c 3d 7d 2c]
Seat 2: JJin91 (button) mucked [Td Ts]
Seat 3: btd0729 (small blind) folded before Flop
Seat 9: jvurn (big blind) showed [7c 9c] and won (250040) with a flush,=
 Queen high


*********** # 301 **************
PokerStars Hand #169456947616: Tournament #1597684021, $18.20+$1.80 USD=
 Hold'em No Limit - Level XXVI (4000/8000) - 2017/05/05 23:37:36 ET
Table '1597684021 1' 9-max Seat #3 is the button
Seat 2: JJin91 (268412 in chips)=20
Seat 3: btd0729 (170679 in chips)=20
Seat 9: jvurn (710909 in chips)=20
JJin91: posts the ante 1000
btd0729: posts the ante 1000
jvurn: posts the ante 1000
jvurn: posts small blind 4000
JJin91: posts big blind 8000
*** HOLE CARDS ***
Dealt to JJin91 [Kd 8h]
btd0729: folds=20
jvurn: raises 8000 to 16000
JJin91: calls 8000
*** FLOP *** [9s 7s 4c]
jvurn: bets 32000
JJin91: folds=20
Uncalled bet (32000) returned to jvurn
jvurn collected 35000 from pot
jvurn: doesn't show hand=20
*** SUMMARY ***
Total pot 35000 | Rake 0=20
Board [9s 7s 4c]
Seat 2: JJin91 (big blind) folded on the Flop
Seat 3: btd0729 (button) folded before Flop (didn't bet)
Seat 9: jvurn (small blind) collected (35000)


*********** # 302 **************
PokerStars Hand #169456947713: Tournament #1597684021, $18.20+$1.80 USD=
 Hold'em No Limit - Level XXVI (4000/8000) - 2017/05/05 23:37:56 ET
Table '1597684021 1' 9-max Seat #9 is the button
Seat 2: JJin91 (251412 in chips)=20
Seat 3: btd0729 (169679 in chips)=20
Seat 9: jvurn (728909 in chips)=20
JJin91: posts the ante 1000
btd0729: posts the ante 1000
jvurn: posts the ante 1000
JJin91: posts small blind 4000
btd0729: posts big blind 8000
*** HOLE CARDS ***
Dealt to JJin91 [3d 9s]
jvurn: raises 16000 to 24000
JJin91: folds=20
btd0729: folds=20
Uncalled bet (16000) returned to jvurn
jvurn collected 23000 from pot
jvurn: doesn't show hand=20
*** SUMMARY ***
Total pot 23000 | Rake 0=20
Seat 2: JJin91 (small blind) folded before Flop
Seat 3: btd0729 (big blind) folded before Flop
Seat 9: jvurn (button) collected (23000)


*********** # 303 **************
PokerStars Hand #169456947750: Tournament #1597684021, $18.20+$1.80 USD=
 Hold'em No Limit - Level XXVI (4000/8000) - 2017/05/05 23:38:07 ET
Table '1597684021 1' 9-max Seat #2 is the button
Seat 2: JJin91 (246412 in chips)=20
Seat 3: btd0729 (160679 in chips)=20
Seat 9: jvurn (742909 in chips)=20
JJin91: posts the ante 1000
btd0729: posts the ante 1000
jvurn: posts the ante 1000
btd0729: posts small blind 4000
jvurn: posts big blind 8000
*** HOLE CARDS ***
Dealt to JJin91 [9d 2c]
JJin91: folds=20
btd0729: folds=20
Uncalled bet (4000) returned to jvurn
jvurn collected 11000 from pot
jvurn: doesn't show hand=20
*** SUMMARY ***
Total pot 11000 | Rake 0=20
Seat 2: JJin91 (button) folded before Flop (didn't bet)
Seat 3: btd0729 (small blind) folded before Flop
Seat 9: jvurn (big blind) collected (11000)


*********** # 304 **************
PokerStars Hand #169456947799: Tournament #1597684021, $18.20+$1.80 USD=
 Hold'em No Limit - Level XXVI (4000/8000) - 2017/05/05 23:38:17 ET
Table '1597684021 1' 9-max Seat #3 is the button
Seat 2: JJin91 (245412 in chips)=20
Seat 3: btd0729 (155679 in chips)=20
Seat 9: jvurn (748909 in chips)=20
JJin91: posts the ante 1000
btd0729: posts the ante 1000
jvurn: posts the ante 1000
jvurn: posts small blind 4000
JJin91: posts big blind 8000
*** HOLE CARDS ***
Dealt to JJin91 [9s Ac]
btd0729: folds=20
jvurn: raises 739909 to 747909 and is all-in
JJin91: folds=20
Uncalled bet (739909) returned to jvurn
jvurn collected 19000 from pot
jvurn: doesn't show hand=20
*** SUMMARY ***
Total pot 19000 | Rake 0=20
Seat 2: JJin91 (big blind) folded before Flop
Seat 3: btd0729 (button) folded before Flop (didn't bet)
Seat 9: jvurn (small blind) collected (19000)


*********** # 305 **************
PokerStars Hand #169456947866: Tournament #1597684021, $18.20+$1.80 USD=
 Hold'em No Limit - Level XXVI (4000/8000) - 2017/05/05 23:38:30 ET
Table '1597684021 1' 9-max Seat #9 is the button
Seat 2: JJin91 (236412 in chips)=20
Seat 3: btd0729 (154679 in chips)=20
Seat 9: jvurn (758909 in chips)=20
JJin91: posts the ante 1000
btd0729: posts the ante 1000
jvurn: posts the ante 1000
JJin91: posts small blind 4000
btd0729: posts big blind 8000
*** HOLE CARDS ***
Dealt to JJin91 [4s Jc]
jvurn: raises 16000 to 24000
JJin91: folds=20
btd0729: calls 16000
*** FLOP *** [2h 6d 4h]
btd0729: bets 129679 and is all-in
jvurn: calls 129679
*** TURN *** [2h 6d 4h] [Qc]
*** RIVER *** [2h 6d 4h Qc] [Qh]
*** SHOW DOWN ***
btd0729: shows [Th 7h] (a flush, Queen high)
jvurn: shows [2d 2s] (a full house, Deuces full of Queens)
jvurn collected 314358 from pot
btd0729 finished the tournament in 3rd place and received $254.29.
*** SUMMARY ***
Total pot 314358 | Rake 0=20
Board [2h 6d 4h Qc Qh]
Seat 2: JJin91 (small blind) folded before Flop
Seat 3: btd0729 (big blind) showed [Th 7h] and lost with a flush, Queen=
 high
Seat 9: jvurn (button) showed [2d 2s] and won (314358) with a full hous=
e, Deuces full of Queens


*********** # 306 **************
PokerStars Hand #169456948004: Tournament #1597684021, $18.20+$1.80 USD=
 Hold'em No Limit - Level XXVI (4000/8000) - 2017/05/05 23:39:04 ET
Table '1597684021 1' 9-max Seat #2 is the button
Seat 2: JJin91 (231412 in chips)=20
Seat 9: jvurn (918588 in chips)=20
JJin91: posts the ante 1000
jvurn: posts the ante 1000
JJin91: posts small blind 4000
jvurn: posts big blind 8000
*** HOLE CARDS ***
Dealt to JJin91 [2s Kd]
JJin91: calls 4000
jvurn: checks=20
*** FLOP *** [Td 7d Qd]
jvurn: checks=20
JJin91: bets 9540
jvurn: raises 900048 to 909588 and is all-in
JJin91: calls 212872 and is all-in
Uncalled bet (687176) returned to jvurn
*** TURN *** [Td 7d Qd] [Ad]
*** RIVER *** [Td 7d Qd Ad] [Jc]
*** SHOW DOWN ***
jvurn: shows [4d 6h] (a flush, Ace high)
JJin91: shows [2s Kd] (a flush, Ace high - King higher)
JJin91 collected 462824 from pot
*** SUMMARY ***
Total pot 462824 | Rake 0=20
Board [Td 7d Qd Ad Jc]
Seat 2: JJin91 (button) (small blind) showed [2s Kd] and won (462824) w=
ith a flush, Ace high
Seat 9: jvurn (big blind) showed [4d 6h] and lost with a flush, Ace high


*********** # 307 **************
PokerStars Hand #169456948115: Tournament #1597684021, $18.20+$1.80 USD=
 Hold'em No Limit - Level XXVI (4000/8000) - 2017/05/05 23:39:27 ET
Table '1597684021 1' 9-max Seat #9 is the button
Seat 2: JJin91 (462824 in chips)=20
Seat 9: jvurn (687176 in chips)=20
JJin91: posts the ante 1000
jvurn: posts the ante 1000
jvurn: posts small blind 4000
JJin91: posts big blind 8000
*** HOLE CARDS ***
Dealt to JJin91 [2d 7c]
jvurn: folds=20
Uncalled bet (4000) returned to JJin91
JJin91 collected 10000 from pot
JJin91: doesn't show hand=20
*** SUMMARY ***
Total pot 10000 | Rake 0=20
Seat 2: JJin91 (big blind) collected (10000)
Seat 9: jvurn (button) (small blind) folded before Flop


*********** # 308 **************
PokerStars Hand #169456948143: Tournament #1597684021, $18.20+$1.80 USD=
 Hold'em No Limit - Level XXVI (4000/8000) - 2017/05/05 23:39:33 ET
Table '1597684021 1' 9-max Seat #2 is the button
Seat 2: JJin91 (467824 in chips)=20
Seat 9: jvurn (682176 in chips)=20
JJin91: posts the ante 1000
jvurn: posts the ante 1000
JJin91: posts small blind 4000
jvurn: posts big blind 8000
*** HOLE CARDS ***
Dealt to JJin91 [7s 9c]
JJin91: raises 8000 to 16000
jvurn: calls 8000
*** FLOP *** [6c 6s 9d]
jvurn: checks=20
JJin91: bets 18020
jvurn: calls 18020
*** TURN *** [6c 6s 9d] [Td]
jvurn: checks=20
JJin91: checks=20
*** RIVER *** [6c 6s 9d Td] [2h]
jvurn: bets 32000
JJin91: raises 72000 to 104000
jvurn: folds=20
Uncalled bet (72000) returned to JJin91
JJin91 collected 134040 from pot
JJin91: doesn't show hand=20
*** SUMMARY ***
Total pot 134040 | Rake 0=20
Board [6c 6s 9d Td 2h]
Seat 2: JJin91 (button) (small blind) collected (134040)
Seat 9: jvurn (big blind) folded on the River


*********** # 309 **************
PokerStars Hand #169456948252: Tournament #1597684021, $18.20+$1.80 USD=
 Hold'em No Limit - Level XXVI (4000/8000) - 2017/05/05 23:39:59 ET
Table '1597684021 1' 9-max Seat #9 is the button
Seat 2: JJin91 (534844 in chips)=20
Seat 9: jvurn (615156 in chips)=20
JJin91: posts the ante 1000
jvurn: posts the ante 1000
jvurn: posts small blind 4000
JJin91: posts big blind 8000
*** HOLE CARDS ***
Dealt to JJin91 [6h Kc]
jvurn: folds=20
Uncalled bet (4000) returned to JJin91
JJin91 collected 10000 from pot
JJin91: doesn't show hand=20
*** SUMMARY ***
Total pot 10000 | Rake 0=20
Seat 2: JJin91 (big blind) collected (10000)
Seat 9: jvurn (button) (small blind) folded before Flop


*********** # 310 **************
PokerStars Hand #169456948313: Tournament #1597684021, $18.20+$1.80 USD=
 Hold'em No Limit - Level XXVI (4000/8000) - 2017/05/05 23:40:14 ET
Table '1597684021 1' 9-max Seat #2 is the button
Seat 2: JJin91 (539844 in chips)=20
Seat 9: jvurn (610156 in chips)=20
JJin91: posts the ante 1000
jvurn: posts the ante 1000
JJin91: posts small blind 4000
jvurn: posts big blind 8000
*** HOLE CARDS ***
Dealt to JJin91 [5c 9h]
JJin91: folds=20
Uncalled bet (4000) returned to jvurn
jvurn collected 10000 from pot
jvurn: doesn't show hand=20
*** SUMMARY ***
Total pot 10000 | Rake 0=20
Seat 2: JJin91 (button) (small blind) folded before Flop
Seat 9: jvurn (big blind) collected (10000)


*********** # 311 **************
PokerStars Hand #169456948341: Tournament #1597684021, $18.20+$1.80 USD=
 Hold'em No Limit - Level XXVI (4000/8000) - 2017/05/05 23:40:21 ET
Table '1597684021 1' 9-max Seat #9 is the button
Seat 2: JJin91 (534844 in chips)=20
Seat 9: jvurn (615156 in chips)=20
JJin91: posts the ante 1000
jvurn: posts the ante 1000
jvurn: posts small blind 4000
JJin91: posts big blind 8000
*** HOLE CARDS ***
Dealt to JJin91 [7d 7h]
jvurn: raises 18000 to 26000
JJin91: raises 38000 to 64000
jvurn: raises 550156 to 614156 and is all-in
JJin91: calls 469844 and is all-in
Uncalled bet (80312) returned to jvurn
*** FLOP *** [8c 4d Td]
*** TURN *** [8c 4d Td] [2s]
*** RIVER *** [8c 4d Td 2s] [8d]
*** SHOW DOWN ***
JJin91: shows [7d 7h] (two pair, Eights and Sevens)
jvurn: shows [As Qd] (a pair of Eights)
JJin91 collected 1069688 from pot
*** SUMMARY ***
Total pot 1069688 | Rake 0=20
Board [8c 4d Td 2s 8d]
Seat 2: JJin91 (big blind) showed [7d 7h] and won (1069688) with two pa=
ir, Eights and Sevens
Seat 9: jvurn (button) (small blind) showed [As Qd] and lost with a pai=
r of Eights


*********** # 312 **************
PokerStars Hand #169456948445: Tournament #1597684021, $18.20+$1.80 USD=
 Hold'em No Limit - Level XXVI (4000/8000) - 2017/05/05 23:40:42 ET
Table '1597684021 1' 9-max Seat #2 is the button
Seat 2: JJin91 (1069688 in chips)=20
Seat 9: jvurn (80312 in chips)=20
JJin91: posts the ante 1000
jvurn: posts the ante 1000
JJin91: posts small blind 4000
jvurn: posts big blind 8000
*** HOLE CARDS ***
Dealt to JJin91 [Td Qs]
JJin91: raises 1060688 to 1068688 and is all-in
jvurn: calls 71312 and is all-in
Uncalled bet (989376) returned to JJin91
*** FLOP *** [4h Jc 3h]
*** TURN *** [4h Jc 3h] [Js]
*** RIVER *** [4h Jc 3h Js] [6s]
*** SHOW DOWN ***
jvurn: shows [Jd Th] (three of a kind, Jacks)
JJin91: shows [Td Qs] (a pair of Jacks)
jvurn collected 160624 from pot
*** SUMMARY ***
Total pot 160624 | Rake 0=20
Board [4h Jc 3h Js 6s]
Seat 2: JJin91 (button) (small blind) showed [Td Qs] and lost with a pa=
ir of Jacks
Seat 9: jvurn (big blind) showed [Jd Th] and won (160624) with three of=
 a kind, Jacks


*********** # 313 **************
PokerStars Hand #169456948524: Tournament #1597684021, $18.20+$1.80 USD=
 Hold'em No Limit - Level XXVI (4000/8000) - 2017/05/05 23:41:02 ET
Table '1597684021 1' 9-max Seat #9 is the button
Seat 2: JJin91 (989376 in chips)=20
Seat 9: jvurn (160624 in chips)=20
JJin91: posts the ante 1000
jvurn: posts the ante 1000
jvurn: posts small blind 4000
JJin91: posts big blind 8000
*** HOLE CARDS ***
Dealt to JJin91 [2d 7s]
jvurn: folds=20
Uncalled bet (4000) returned to JJin91
JJin91 collected 10000 from pot
JJin91: doesn't show hand=20
*** SUMMARY ***
Total pot 10000 | Rake 0=20
Seat 2: JJin91 (big blind) collected (10000)
Seat 9: jvurn (button) (small blind) folded before Flop


*********** # 314 **************
PokerStars Hand #169456948555: Tournament #1597684021, $18.20+$1.80 USD=
 Hold'em No Limit - Level XXVI (4000/8000) - 2017/05/05 23:41:10 ET
Table '1597684021 1' 9-max Seat #2 is the button
Seat 2: JJin91 (994376 in chips)=20
Seat 9: jvurn (155624 in chips)=20
JJin91: posts the ante 1000
jvurn: posts the ante 1000
JJin91: posts small blind 4000
jvurn: posts big blind 8000
*** HOLE CARDS ***
Dealt to JJin91 [5s Tc]
JJin91: raises 8000 to 16000
jvurn: folds=20
Uncalled bet (8000) returned to JJin91
JJin91 collected 18000 from pot
JJin91: doesn't show hand=20
*** SUMMARY ***
Total pot 18000 | Rake 0=20
Seat 2: JJin91 (button) (small blind) collected (18000)
Seat 9: jvurn (big blind) folded before Flop


*********** # 315 **************
PokerStars Hand #169456948597: Tournament #1597684021, $18.20+$1.80 USD=
 Hold'em No Limit - Level XXVI (4000/8000) - 2017/05/05 23:41:21 ET
Table '1597684021 1' 9-max Seat #9 is the button
Seat 2: JJin91 (1003376 in chips)=20
Seat 9: jvurn (146624 in chips)=20
JJin91: posts the ante 1000
jvurn: posts the ante 1000
jvurn: posts small blind 4000
JJin91: posts big blind 8000
*** HOLE CARDS ***
Dealt to JJin91 [Ah Qc]
jvurn: raises 137624 to 145624 and is all-in
JJin91: calls 137624
*** FLOP *** [8s Kc 5h]
*** TURN *** [8s Kc 5h] [7s]
*** RIVER *** [8s Kc 5h 7s] [7d]
*** SHOW DOWN ***
JJin91: shows [Ah Qc] (a pair of Sevens)
jvurn: shows [Jh 4s] (a pair of Sevens - lower kicker)
JJin91 collected 293248 from pot
jvurn finished the tournament in 2nd place and received $334.88.
JJin91 wins the tournament and receives $481.46 - congratulations!
*** SUMMARY ***
Total pot 293248 | Rake 0=20
Board [8s Kc 5h 7s 7d]
Seat 2: JJin91 (big blind) showed [Ah Qc] and won (293248) with a pair =
of Sevens
Seat 9: jvurn (button) (small blind) showed [Jh 4s] and lost with a pai=
r of Sevens



If you have any questions, please contact us at "PokerStars Support" <s=
upport@pokerstarsnj.com>


