Transcript for tournament #1622537113 requested by JJin91 (jamiejin91@g=
mail.com)

*********** # 1 **************
PokerStars Hand #169640959545: Tournament #1622537113, $9.10+$0.90 USD =
Hold'em No Limit - Level VIII (125/250) - 2017/05/09 19:24:31 ET
Table '1622537113 4' 9-max Seat #3 is the button
Seat 1: AmTheCaptain (8911 in chips)=20
Seat 2: frankx99x (5905 in chips)=20
Seat 3: Dezrok17 (5475 in chips)=20
Seat 4: Hai1ToPitt (13828 in chips)=20
Seat 5: apoch19 (11684 in chips)=20
Seat 6: zBeanHeaDz (7709 in chips)=20
Seat 7: SquadooshBag (48313 in chips)=20
Seat 9: JJin91 (10000 in chips)=20
AmTheCaptain: posts the ante 30
frankx99x: posts the ante 30
Dezrok17: posts the ante 30
Hai1ToPitt: posts the ante 30
apoch19: posts the ante 30
zBeanHeaDz: posts the ante 30
SquadooshBag: posts the ante 30
JJin91: posts the ante 30
Hai1ToPitt: posts small blind 125
apoch19: posts big blind 250
*** HOLE CARDS ***
Dealt to JJin91 [9s 3s]
zBeanHeaDz: folds=20
SquadooshBag: calls 250
JJin91: folds=20
AmTheCaptain: folds=20
frankx99x: raises 300 to 550
Dezrok17: folds=20
JJin91 is sitting out
Hai1ToPitt: folds=20
apoch19: folds=20
SquadooshBag: calls 300
*** FLOP *** [5h Td 4d]
SquadooshBag: checks=20
frankx99x: checks=20
*** TURN *** [5h Td 4d] [Jh]
SquadooshBag: bets 250
frankx99x: calls 250
*** RIVER *** [5h Td 4d Jh] [Jc]
SquadooshBag: bets 250
frankx99x: calls 250
*** SHOW DOWN ***
SquadooshBag: shows [8c Qc] (a pair of Jacks)
frankx99x: shows [As Qd] (a pair of Jacks - Ace kicker)
frankx99x collected 2715 from pot
*** SUMMARY ***
Total pot 2715 | Rake 0=20
Board [5h Td 4d Jh Jc]
Seat 1: AmTheCaptain folded before Flop (didn't bet)
Seat 2: frankx99x showed [As Qd] and won (2715) with a pair of Jacks
Seat 3: Dezrok17 (button) folded before Flop (didn't bet)
Seat 4: Hai1ToPitt (small blind) folded before Flop
Seat 5: apoch19 (big blind) folded before Flop
Seat 6: zBeanHeaDz folded before Flop (didn't bet)
Seat 7: SquadooshBag showed [8c Qc] and lost with a pair of Jacks
Seat 9: JJin91 folded before Flop (didn't bet)


*********** # 2 **************
PokerStars Hand #169642130915: Tournament #1622537113, $9.10+$0.90 USD =
Hold'em No Limit - Level IX (150/300) - 2017/05/09 19:25:56 ET
Table '1622537113 4' 9-max Seat #4 is the button
Seat 1: AmTheCaptain (8881 in chips)=20
Seat 2: frankx99x (7540 in chips)=20
Seat 3: Dezrok17 (5445 in chips)=20
Seat 4: Hai1ToPitt (13673 in chips)=20
Seat 5: apoch19 (11404 in chips)=20
Seat 6: zBeanHeaDz (7679 in chips)=20
Seat 7: SquadooshBag (47233 in chips)=20
Seat 9: JJin91 (9970 in chips) is sitting out
AmTheCaptain: posts the ante 40
frankx99x: posts the ante 40
Dezrok17: posts the ante 40
Hai1ToPitt: posts the ante 40
apoch19: posts the ante 40
zBeanHeaDz: posts the ante 40
SquadooshBag: posts the ante 40
JJin91: posts the ante 40
apoch19: posts small blind 150
zBeanHeaDz: posts big blind 300
*** HOLE CARDS ***
Dealt to JJin91 [6s 8c]
SquadooshBag: folds=20
JJin91: folds=20
AmTheCaptain: calls 300
frankx99x: raises 600 to 900
Dezrok17: folds=20
Hai1ToPitt: raises 2000 to 2900
apoch19: folds=20
zBeanHeaDz: folds=20
AmTheCaptain: folds=20
frankx99x: folds=20
Uncalled bet (2000) returned to Hai1ToPitt
Hai1ToPitt collected 2870 from pot
Hai1ToPitt: doesn't show hand=20
*** SUMMARY ***
Total pot 2870 | Rake 0=20
Seat 1: AmTheCaptain folded before Flop
Seat 2: frankx99x folded before Flop
Seat 3: Dezrok17 folded before Flop (didn't bet)
Seat 4: Hai1ToPitt (button) collected (2870)
Seat 5: apoch19 (small blind) folded before Flop
Seat 6: zBeanHeaDz (big blind) folded before Flop
Seat 7: SquadooshBag folded before Flop (didn't bet)
Seat 9: JJin91 folded before Flop (didn't bet)


*********** # 3 **************
PokerStars Hand #169642131189: Tournament #1622537113, $9.10+$0.90 USD =
Hold'em No Limit - Level IX (150/300) - 2017/05/09 19:26:47 ET
Table '1622537113 4' 9-max Seat #5 is the button
Seat 1: AmTheCaptain (8541 in chips)=20
Seat 2: frankx99x (6600 in chips)=20
Seat 3: Dezrok17 (5405 in chips)=20
Seat 4: Hai1ToPitt (15603 in chips)=20
Seat 5: apoch19 (11214 in chips)=20
Seat 6: zBeanHeaDz (7339 in chips)=20
Seat 7: SquadooshBag (47193 in chips)=20
Seat 9: JJin91 (9930 in chips) is sitting out
AmTheCaptain: posts the ante 40
frankx99x: posts the ante 40
Dezrok17: posts the ante 40
Hai1ToPitt: posts the ante 40
apoch19: posts the ante 40
zBeanHeaDz: posts the ante 40
SquadooshBag: posts the ante 40
JJin91: posts the ante 40
zBeanHeaDz: posts small blind 150
SquadooshBag: posts big blind 300
*** HOLE CARDS ***
Dealt to JJin91 [Ad 9d]
JJin91: folds=20
AmTheCaptain: calls 300
frankx99x: folds=20
Dezrok17: raises 5065 to 5365 and is all-in
JJin91 has returned
Hai1ToPitt: folds=20
apoch19: folds=20
zBeanHeaDz: folds=20
SquadooshBag: folds=20
AmTheCaptain: calls 5065
*** FLOP *** [Qs Ts Qd]
*** TURN *** [Qs Ts Qd] [8c]
*** RIVER *** [Qs Ts Qd 8c] [5c]
*** SHOW DOWN ***
AmTheCaptain: shows [Ah 9h] (a pair of Queens)
Dezrok17: shows [6s 6c] (two pair, Queens and Sixes)
Dezrok17 collected 11500 from pot
*** SUMMARY ***
Total pot 11500 | Rake 0=20
Board [Qs Ts Qd 8c 5c]
Seat 1: AmTheCaptain showed [Ah 9h] and lost with a pair of Queens
Seat 2: frankx99x folded before Flop (didn't bet)
Seat 3: Dezrok17 showed [6s 6c] and won (11500) with two pair, Queens a=
nd Sixes
Seat 4: Hai1ToPitt folded before Flop (didn't bet)
Seat 5: apoch19 (button) folded before Flop (didn't bet)
Seat 6: zBeanHeaDz (small blind) folded before Flop
Seat 7: SquadooshBag (big blind) folded before Flop
Seat 9: JJin91 folded before Flop (didn't bet)


*********** # 4 **************
PokerStars Hand #169642131462: Tournament #1622537113, $9.10+$0.90 USD =
Hold'em No Limit - Level IX (150/300) - 2017/05/09 19:27:38 ET
Table '1622537113 4' 9-max Seat #6 is the button
Seat 1: AmTheCaptain (3136 in chips)=20
Seat 2: frankx99x (6560 in chips)=20
Seat 3: Dezrok17 (11500 in chips)=20
Seat 4: Hai1ToPitt (15563 in chips)=20
Seat 5: apoch19 (11174 in chips)=20
Seat 6: zBeanHeaDz (7149 in chips)=20
Seat 7: SquadooshBag (46853 in chips)=20
Seat 9: JJin91 (9890 in chips)=20
AmTheCaptain: posts the ante 40
frankx99x: posts the ante 40
Dezrok17: posts the ante 40
Hai1ToPitt: posts the ante 40
apoch19: posts the ante 40
zBeanHeaDz: posts the ante 40
SquadooshBag: posts the ante 40
JJin91: posts the ante 40
SquadooshBag: posts small blind 150
JJin91: posts big blind 300
*** HOLE CARDS ***
Dealt to JJin91 [5d Qh]
AmTheCaptain: folds=20
frankx99x: folds=20
Dezrok17: folds=20
Hai1ToPitt: raises 366 to 666
apoch19: folds=20
zBeanHeaDz: folds=20
SquadooshBag: calls 516
JJin91: folds=20
*** FLOP *** [Jh 8c 6s]
SquadooshBag: bets 300
JJin91 is sitting out
Hai1ToPitt: raises 1097 to 1397
SquadooshBag: folds=20
Uncalled bet (1097) returned to Hai1ToPitt
Hai1ToPitt collected 2552 from pot
Hai1ToPitt: doesn't show hand=20
*** SUMMARY ***
Total pot 2552 | Rake 0=20
Board [Jh 8c 6s]
Seat 1: AmTheCaptain folded before Flop (didn't bet)
Seat 2: frankx99x folded before Flop (didn't bet)
Seat 3: Dezrok17 folded before Flop (didn't bet)
Seat 4: Hai1ToPitt collected (2552)
Seat 5: apoch19 folded before Flop (didn't bet)
Seat 6: zBeanHeaDz (button) folded before Flop (didn't bet)
Seat 7: SquadooshBag (small blind) folded on the Flop
Seat 9: JJin91 (big blind) folded before Flop


*********** # 5 **************
PokerStars Hand #169642131741: Tournament #1622537113, $9.10+$0.90 USD =
Hold'em No Limit - Level IX (150/300) - 2017/05/09 19:28:32 ET
Table '1622537113 4' 9-max Seat #7 is the button
Seat 1: AmTheCaptain (3096 in chips)=20
Seat 2: frankx99x (6520 in chips)=20
Seat 3: Dezrok17 (11460 in chips)=20
Seat 4: Hai1ToPitt (17109 in chips)=20
Seat 5: apoch19 (11134 in chips)=20
Seat 6: zBeanHeaDz (7109 in chips)=20
Seat 7: SquadooshBag (45847 in chips)=20
Seat 9: JJin91 (9550 in chips) is sitting out
AmTheCaptain: posts the ante 40
frankx99x: posts the ante 40
Dezrok17: posts the ante 40
Hai1ToPitt: posts the ante 40
apoch19: posts the ante 40
zBeanHeaDz: posts the ante 40
SquadooshBag: posts the ante 40
JJin91: posts the ante 40
JJin91: posts small blind 150
AmTheCaptain: posts big blind 300
*** HOLE CARDS ***
Dealt to JJin91 [Kd Ks]
JJin91 has returned
frankx99x: folds=20
Dezrok17: folds=20
Hai1ToPitt: folds=20
apoch19: folds=20
zBeanHeaDz: folds=20
SquadooshBag: calls 300
JJin91: raises 9210 to 9510 and is all-in
AmTheCaptain: folds=20
SquadooshBag: folds=20
Uncalled bet (9210) returned to JJin91
JJin91 collected 1220 from pot
JJin91: doesn't show hand=20
*** SUMMARY ***
Total pot 1220 | Rake 0=20
Seat 1: AmTheCaptain (big blind) folded before Flop
Seat 2: frankx99x folded before Flop (didn't bet)
Seat 3: Dezrok17 folded before Flop (didn't bet)
Seat 4: Hai1ToPitt folded before Flop (didn't bet)
Seat 5: apoch19 folded before Flop (didn't bet)
Seat 6: zBeanHeaDz folded before Flop (didn't bet)
Seat 7: SquadooshBag (button) folded before Flop
Seat 9: JJin91 (small blind) collected (1220)


*********** # 6 **************
PokerStars Hand #169642131988: Tournament #1622537113, $9.10+$0.90 USD =
Hold'em No Limit - Level IX (150/300) - 2017/05/09 19:29:21 ET
Table '1622537113 4' 9-max Seat #9 is the button
Seat 1: AmTheCaptain (2756 in chips)=20
Seat 2: frankx99x (6480 in chips)=20
Seat 3: Dezrok17 (11420 in chips)=20
Seat 4: Hai1ToPitt (17069 in chips)=20
Seat 5: apoch19 (11094 in chips)=20
Seat 6: zBeanHeaDz (7069 in chips)=20
Seat 7: SquadooshBag (45507 in chips)=20
Seat 9: JJin91 (10430 in chips)=20
AmTheCaptain: posts the ante 40
frankx99x: posts the ante 40
Dezrok17: posts the ante 40
Hai1ToPitt: posts the ante 40
apoch19: posts the ante 40
zBeanHeaDz: posts the ante 40
SquadooshBag: posts the ante 40
JJin91: posts the ante 40
AmTheCaptain: posts small blind 150
frankx99x: posts big blind 300
*** HOLE CARDS ***
Dealt to JJin91 [Kh Ks]
Dezrok17: folds=20
Hai1ToPitt: raises 366 to 666
apoch19: folds=20
zBeanHeaDz: folds=20
SquadooshBag: calls 666
JJin91: raises 1617 to 2283
AmTheCaptain: folds=20
frankx99x: folds=20
Hai1ToPitt: folds=20
SquadooshBag: calls 1617
*** FLOP *** [2h Jd 7c]
SquadooshBag: bets 300
JJin91: raises 3000 to 3300
SquadooshBag: folds=20
Uncalled bet (3000) returned to JJin91
JJin91 collected 6602 from pot
JJin91: doesn't show hand=20
*** SUMMARY ***
Total pot 6602 | Rake 0=20
Board [2h Jd 7c]
Seat 1: AmTheCaptain (small blind) folded before Flop
Seat 2: frankx99x (big blind) folded before Flop
Seat 3: Dezrok17 folded before Flop (didn't bet)
Seat 4: Hai1ToPitt folded before Flop
Seat 5: apoch19 folded before Flop (didn't bet)
Seat 6: zBeanHeaDz folded before Flop (didn't bet)
Seat 7: SquadooshBag folded on the Flop
Seat 9: JJin91 (button) collected (6602)


*********** # 7 **************
PokerStars Hand #169642132446: Tournament #1622537113, $9.10+$0.90 USD =
Hold'em No Limit - Level IX (150/300) - 2017/05/09 19:30:46 ET
Table '1622537113 4' 9-max Seat #1 is the button
Seat 1: AmTheCaptain (2566 in chips)=20
Seat 2: frankx99x (6140 in chips)=20
Seat 3: Dezrok17 (11380 in chips)=20
Seat 4: Hai1ToPitt (16363 in chips)=20
Seat 5: apoch19 (11054 in chips)=20
Seat 6: zBeanHeaDz (7029 in chips)=20
Seat 7: SquadooshBag (42884 in chips)=20
Seat 9: JJin91 (14409 in chips)=20
AmTheCaptain: posts the ante 40
frankx99x: posts the ante 40
Dezrok17: posts the ante 40
Hai1ToPitt: posts the ante 40
apoch19: posts the ante 40
zBeanHeaDz: posts the ante 40
SquadooshBag: posts the ante 40
JJin91: posts the ante 40
frankx99x: posts small blind 150
Dezrok17: posts big blind 300
*** HOLE CARDS ***
Dealt to JJin91 [8d 6h]
Hai1ToPitt: folds=20
apoch19: folds=20
zBeanHeaDz: folds=20
SquadooshBag: calls 300
JJin91: folds=20
AmTheCaptain: raises 2226 to 2526 and is all-in
frankx99x: folds=20
Dezrok17: folds=20
SquadooshBag: folds=20
Uncalled bet (2226) returned to AmTheCaptain
AmTheCaptain collected 1370 from pot
*** SUMMARY ***
Total pot 1370 | Rake 0=20
Seat 1: AmTheCaptain (button) collected (1370)
Seat 2: frankx99x (small blind) folded before Flop
Seat 3: Dezrok17 (big blind) folded before Flop
Seat 4: Hai1ToPitt folded before Flop (didn't bet)
Seat 5: apoch19 folded before Flop (didn't bet)
Seat 6: zBeanHeaDz folded before Flop (didn't bet)
Seat 7: SquadooshBag folded before Flop
Seat 9: JJin91 folded before Flop (didn't bet)


*********** # 8 **************
PokerStars Hand #169642132692: Tournament #1622537113, $9.10+$0.90 USD =
Hold'em No Limit - Level IX (150/300) - 2017/05/09 19:31:29 ET
Table '1622537113 4' 9-max Seat #2 is the button
Seat 1: AmTheCaptain (3596 in chips)=20
Seat 2: frankx99x (5950 in chips)=20
Seat 3: Dezrok17 (11040 in chips)=20
Seat 4: Hai1ToPitt (16323 in chips)=20
Seat 5: apoch19 (11014 in chips)=20
Seat 6: zBeanHeaDz (6989 in chips)=20
Seat 7: SquadooshBag (42544 in chips)=20
Seat 9: JJin91 (14369 in chips)=20
AmTheCaptain: posts the ante 40
frankx99x: posts the ante 40
Dezrok17: posts the ante 40
Hai1ToPitt: posts the ante 40
apoch19: posts the ante 40
zBeanHeaDz: posts the ante 40
SquadooshBag: posts the ante 40
JJin91: posts the ante 40
Dezrok17: posts small blind 150
Hai1ToPitt: posts big blind 300
*** HOLE CARDS ***
Dealt to JJin91 [8c 2s]
apoch19 has timed out
apoch19: folds=20
apoch19 is sitting out
zBeanHeaDz: folds=20
SquadooshBag: calls 300
JJin91: folds=20
AmTheCaptain: calls 300
frankx99x: calls 300
Dezrok17: calls 150
Hai1ToPitt: checks=20
*** FLOP *** [Kc 6d 4s]
Dezrok17: checks=20
Hai1ToPitt: checks=20
SquadooshBag: bets 300
apoch19 has returned
AmTheCaptain: folds=20
frankx99x: folds=20
Dezrok17: calls 300
Hai1ToPitt: folds=20
*** TURN *** [Kc 6d 4s] [Qc]
Dezrok17: checks=20
SquadooshBag: bets 300
Dezrok17: calls 300
*** RIVER *** [Kc 6d 4s Qc] [2c]
Dezrok17: checks=20
SquadooshBag: checks=20
*** SHOW DOWN ***
Dezrok17: shows [Kd Td] (a pair of Kings)
SquadooshBag: mucks hand=20
Dezrok17 collected 3020 from pot
*** SUMMARY ***
Total pot 3020 | Rake 0=20
Board [Kc 6d 4s Qc 2c]
Seat 1: AmTheCaptain folded on the Flop
Seat 2: frankx99x (button) folded on the Flop
Seat 3: Dezrok17 (small blind) showed [Kd Td] and won (3020) with a pai=
r of Kings
Seat 4: Hai1ToPitt (big blind) folded on the Flop
Seat 5: apoch19 folded before Flop (didn't bet)
Seat 6: zBeanHeaDz folded before Flop (didn't bet)
Seat 7: SquadooshBag mucked [7s Ks]
Seat 9: JJin91 folded before Flop (didn't bet)


*********** # 9 **************
PokerStars Hand #169642133482: Tournament #1622537113, $9.10+$0.90 USD =
Hold'em No Limit - Level IX (150/300) - 2017/05/09 19:33:55 ET
Table '1622537113 4' 9-max Seat #3 is the button
Seat 1: AmTheCaptain (3256 in chips)=20
Seat 2: frankx99x (5610 in chips)=20
Seat 3: Dezrok17 (13120 in chips)=20
Seat 4: Hai1ToPitt (15983 in chips)=20
Seat 5: apoch19 (10974 in chips)=20
Seat 6: zBeanHeaDz (6949 in chips)=20
Seat 7: SquadooshBag (41604 in chips)=20
Seat 8: Heart Tree (24795 in chips)=20
Seat 9: JJin91 (14329 in chips)=20
AmTheCaptain: posts the ante 40
frankx99x: posts the ante 40
Dezrok17: posts the ante 40
Hai1ToPitt: posts the ante 40
apoch19: posts the ante 40
zBeanHeaDz: posts the ante 40
SquadooshBag: posts the ante 40
Heart Tree: posts the ante 40
JJin91: posts the ante 40
Hai1ToPitt: posts small blind 150
apoch19: posts big blind 300
*** HOLE CARDS ***
Dealt to JJin91 [Kd Jh]
zBeanHeaDz: folds=20
SquadooshBag: calls 300
Heart Tree: folds=20
JJin91: folds=20
AmTheCaptain: folds=20
frankx99x: folds=20
Dezrok17: folds=20
Hai1ToPitt: folds=20
apoch19: checks=20
*** FLOP *** [5c 7h Ah]
apoch19: checks=20
SquadooshBag: bets 300
apoch19: calls 300
*** TURN *** [5c 7h Ah] [7d]
apoch19: checks=20
SquadooshBag: bets 600
apoch19: calls 600
*** RIVER *** [5c 7h Ah 7d] [Td]
apoch19: checks=20
SquadooshBag: bets 1500
apoch19: calls 1500
*** SHOW DOWN ***
SquadooshBag: shows [6c 9h] (a pair of Sevens)
apoch19: shows [Ac 6d] (two pair, Aces and Sevens)
apoch19 collected 5910 from pot
*** SUMMARY ***
Total pot 5910 | Rake 0=20
Board [5c 7h Ah 7d Td]
Seat 1: AmTheCaptain folded before Flop (didn't bet)
Seat 2: frankx99x folded before Flop (didn't bet)
Seat 3: Dezrok17 (button) folded before Flop (didn't bet)
Seat 4: Hai1ToPitt (small blind) folded before Flop
Seat 5: apoch19 (big blind) showed [Ac 6d] and won (5910) with two pair=
, Aces and Sevens
Seat 6: zBeanHeaDz folded before Flop (didn't bet)
Seat 7: SquadooshBag showed [6c 9h] and lost with a pair of Sevens
Seat 8: Heart Tree folded before Flop (didn't bet)
Seat 9: JJin91 folded before Flop (didn't bet)


*********** # 10 **************
PokerStars Hand #169642133878: Tournament #1622537113, $9.10+$0.90 USD =
Hold'em No Limit - Level IX (150/300) - 2017/05/09 19:35:05 ET
Table '1622537113 4' 9-max Seat #4 is the button
Seat 1: AmTheCaptain (3216 in chips)=20
Seat 2: frankx99x (5570 in chips)=20
Seat 3: Dezrok17 (13080 in chips)=20
Seat 4: Hai1ToPitt (15793 in chips)=20
Seat 5: apoch19 (14144 in chips)=20
Seat 6: zBeanHeaDz (6909 in chips)=20
Seat 7: SquadooshBag (38864 in chips)=20
Seat 8: Heart Tree (24755 in chips)=20
Seat 9: JJin91 (14289 in chips)=20
AmTheCaptain: posts the ante 40
frankx99x: posts the ante 40
Dezrok17: posts the ante 40
Hai1ToPitt: posts the ante 40
apoch19: posts the ante 40
zBeanHeaDz: posts the ante 40
SquadooshBag: posts the ante 40
Heart Tree: posts the ante 40
JJin91: posts the ante 40
apoch19: posts small blind 150
zBeanHeaDz: posts big blind 300
*** HOLE CARDS ***
Dealt to JJin91 [Qc Qs]
SquadooshBag: folds=20
Heart Tree: folds=20
JJin91: raises 357 to 657
AmTheCaptain: calls 657
frankx99x: folds=20
Dezrok17: folds=20
Hai1ToPitt: folds=20
apoch19: folds=20
zBeanHeaDz: folds=20
*** FLOP *** [Ac 9c Kd]
JJin91: checks=20
AmTheCaptain: checks=20
*** TURN *** [Ac 9c Kd] [Kc]
JJin91: checks=20
AmTheCaptain: checks=20
*** RIVER *** [Ac 9c Kd Kc] [5d]
JJin91: checks=20
AmTheCaptain: checks=20
*** SHOW DOWN ***
JJin91: shows [Qc Qs] (two pair, Kings and Queens)
AmTheCaptain: shows [Jd Th] (a pair of Kings)
JJin91 collected 2124 from pot
*** SUMMARY ***
Total pot 2124 | Rake 0=20
Board [Ac 9c Kd Kc 5d]
Seat 1: AmTheCaptain showed [Jd Th] and lost with a pair of Kings
Seat 2: frankx99x folded before Flop (didn't bet)
Seat 3: Dezrok17 folded before Flop (didn't bet)
Seat 4: Hai1ToPitt (button) folded before Flop (didn't bet)
Seat 5: apoch19 (small blind) folded before Flop
Seat 6: zBeanHeaDz (big blind) folded before Flop
Seat 7: SquadooshBag folded before Flop (didn't bet)
Seat 8: Heart Tree folded before Flop (didn't bet)
Seat 9: JJin91 showed [Qc Qs] and won (2124) with two pair, Kings and Q=
ueens


*********** # 11 **************
PokerStars Hand #169642134171: Tournament #1622537113, $9.10+$0.90 USD =
Hold'em No Limit - Level X (200/400) - 2017/05/09 19:36:01 ET
Table '1622537113 4' 9-max Seat #5 is the button
Seat 1: AmTheCaptain (2519 in chips)=20
Seat 2: frankx99x (5530 in chips)=20
Seat 3: Dezrok17 (13040 in chips)=20
Seat 4: Hai1ToPitt (15753 in chips)=20
Seat 5: apoch19 (13954 in chips)=20
Seat 6: zBeanHeaDz (6569 in chips)=20
Seat 8: Heart Tree (24715 in chips)=20
Seat 9: JJin91 (15716 in chips)=20
AmTheCaptain: posts the ante 50
frankx99x: posts the ante 50
Dezrok17: posts the ante 50
Hai1ToPitt: posts the ante 50
apoch19: posts the ante 50
zBeanHeaDz: posts the ante 50
Heart Tree: posts the ante 50
JJin91: posts the ante 50
zBeanHeaDz: posts small blind 200
Heart Tree: posts big blind 400
*** HOLE CARDS ***
Dealt to JJin91 [9h 6d]
JJin91: folds=20
AmTheCaptain: raises 2069 to 2469 and is all-in
frankx99x: folds=20
Dezrok17: folds=20
Hai1ToPitt: folds=20
apoch19: folds=20
zBeanHeaDz: folds=20
Heart Tree: folds=20
Uncalled bet (2069) returned to AmTheCaptain
AmTheCaptain collected 1400 from pot
*** SUMMARY ***
Total pot 1400 | Rake 0=20
Seat 1: AmTheCaptain collected (1400)
Seat 2: frankx99x folded before Flop (didn't bet)
Seat 3: Dezrok17 folded before Flop (didn't bet)
Seat 4: Hai1ToPitt folded before Flop (didn't bet)
Seat 5: apoch19 (button) folded before Flop (didn't bet)
Seat 6: zBeanHeaDz (small blind) folded before Flop
Seat 8: Heart Tree (big blind) folded before Flop
Seat 9: JJin91 folded before Flop (didn't bet)


*********** # 12 **************
PokerStars Hand #169642134380: Tournament #1622537113, $9.10+$0.90 USD =
Hold'em No Limit - Level X (200/400) - 2017/05/09 19:36:42 ET
Table '1622537113 4' 9-max Seat #6 is the button
Seat 1: AmTheCaptain (3469 in chips)=20
Seat 2: frankx99x (5480 in chips)=20
Seat 3: Dezrok17 (12990 in chips)=20
Seat 4: Hai1ToPitt (15703 in chips)=20
Seat 5: apoch19 (13904 in chips)=20
Seat 6: zBeanHeaDz (6319 in chips)=20
Seat 8: Heart Tree (24265 in chips)=20
Seat 9: JJin91 (15666 in chips)=20
AmTheCaptain: posts the ante 50
frankx99x: posts the ante 50
Dezrok17: posts the ante 50
Hai1ToPitt: posts the ante 50
apoch19: posts the ante 50
zBeanHeaDz: posts the ante 50
Heart Tree: posts the ante 50
JJin91: posts the ante 50
Heart Tree: posts small blind 200
JJin91: posts big blind 400
*** HOLE CARDS ***
Dealt to JJin91 [Tc 7d]
AmTheCaptain: folds=20
frankx99x: folds=20
Dezrok17: raises 440 to 840
Hai1ToPitt: folds=20
apoch19: folds=20
zBeanHeaDz: raises 5429 to 6269 and is all-in
Heart Tree: folds=20
JJin91: folds=20
Dezrok17: folds=20
Uncalled bet (5429) returned to zBeanHeaDz
zBeanHeaDz collected 2680 from pot
zBeanHeaDz: doesn't show hand=20
*** SUMMARY ***
Total pot 2680 | Rake 0=20
Seat 1: AmTheCaptain folded before Flop (didn't bet)
Seat 2: frankx99x folded before Flop (didn't bet)
Seat 3: Dezrok17 folded before Flop
Seat 4: Hai1ToPitt folded before Flop (didn't bet)
Seat 5: apoch19 folded before Flop (didn't bet)
Seat 6: zBeanHeaDz (button) collected (2680)
Seat 8: Heart Tree (small blind) folded before Flop
Seat 9: JJin91 (big blind) folded before Flop


*********** # 13 **************
PokerStars Hand #169642134744: Tournament #1622537113, $9.10+$0.90 USD =
Hold'em No Limit - Level X (200/400) - 2017/05/09 19:37:50 ET
Table '1622537113 4' 9-max Seat #8 is the button
Seat 1: AmTheCaptain (3419 in chips)=20
Seat 2: frankx99x (5430 in chips)=20
Seat 3: Dezrok17 (12100 in chips)=20
Seat 4: Hai1ToPitt (15653 in chips)=20
Seat 5: apoch19 (13854 in chips)=20
Seat 6: zBeanHeaDz (8109 in chips)=20
Seat 8: Heart Tree (24015 in chips)=20
Seat 9: JJin91 (15216 in chips)=20
AmTheCaptain: posts the ante 50
frankx99x: posts the ante 50
Dezrok17: posts the ante 50
Hai1ToPitt: posts the ante 50
apoch19: posts the ante 50
zBeanHeaDz: posts the ante 50
Heart Tree: posts the ante 50
JJin91: posts the ante 50
JJin91: posts small blind 200
AmTheCaptain: posts big blind 400
*** HOLE CARDS ***
Dealt to JJin91 [8c Kh]
frankx99x: raises 4980 to 5380 and is all-in
Dezrok17: folds=20
Hai1ToPitt: folds=20
apoch19: folds=20
zBeanHeaDz: folds=20
Heart Tree: folds=20
JJin91: folds=20
AmTheCaptain: calls 2969 and is all-in
Uncalled bet (2011) returned to frankx99x
*** FLOP *** [7s Ks 5c]
*** TURN *** [7s Ks 5c] [Qc]
*** RIVER *** [7s Ks 5c Qc] [Td]
*** SHOW DOWN ***
AmTheCaptain: shows [Qh 9h] (a pair of Queens)
frankx99x: shows [2c 2s] (a pair of Deuces)
AmTheCaptain collected 7338 from pot
*** SUMMARY ***
Total pot 7338 | Rake 0=20
Board [7s Ks 5c Qc Td]
Seat 1: AmTheCaptain (big blind) showed [Qh 9h] and won (7338) with a p=
air of Queens
Seat 2: frankx99x showed [2c 2s] and lost with a pair of Deuces
Seat 3: Dezrok17 folded before Flop (didn't bet)
Seat 4: Hai1ToPitt folded before Flop (didn't bet)
Seat 5: apoch19 folded before Flop (didn't bet)
Seat 6: zBeanHeaDz folded before Flop (didn't bet)
Seat 8: Heart Tree (button) folded before Flop (didn't bet)
Seat 9: JJin91 (small blind) folded before Flop


*********** # 14 **************
PokerStars Hand #169642134929: Tournament #1622537113, $9.10+$0.90 USD =
Hold'em No Limit - Level X (200/400) - 2017/05/09 19:38:22 ET
Table '1622537113 4' 9-max Seat #9 is the button
Seat 1: AmTheCaptain (7338 in chips)=20
Seat 2: frankx99x (2011 in chips)=20
Seat 3: Dezrok17 (12050 in chips)=20
Seat 4: Hai1ToPitt (15603 in chips)=20
Seat 5: apoch19 (13804 in chips)=20
Seat 6: zBeanHeaDz (8059 in chips)=20
Seat 8: Heart Tree (23965 in chips)=20
Seat 9: JJin91 (14966 in chips)=20
AmTheCaptain: posts the ante 50
frankx99x: posts the ante 50
Dezrok17: posts the ante 50
Hai1ToPitt: posts the ante 50
apoch19: posts the ante 50
zBeanHeaDz: posts the ante 50
Heart Tree: posts the ante 50
JJin91: posts the ante 50
AmTheCaptain: posts small blind 200
frankx99x: posts big blind 400
*** HOLE CARDS ***
Dealt to JJin91 [8s Tc]
Dezrok17: folds=20
Hai1ToPitt: folds=20
apoch19: raises 520 to 920
zBeanHeaDz: folds=20
Heart Tree: folds=20
JJin91: folds=20
AmTheCaptain: folds=20
frankx99x: folds=20
Uncalled bet (520) returned to apoch19
apoch19 collected 1400 from pot
apoch19: doesn't show hand=20
*** SUMMARY ***
Total pot 1400 | Rake 0=20
Seat 1: AmTheCaptain (small blind) folded before Flop
Seat 2: frankx99x (big blind) folded before Flop
Seat 3: Dezrok17 folded before Flop (didn't bet)
Seat 4: Hai1ToPitt folded before Flop (didn't bet)
Seat 5: apoch19 collected (1400)
Seat 6: zBeanHeaDz folded before Flop (didn't bet)
Seat 8: Heart Tree folded before Flop (didn't bet)
Seat 9: JJin91 (button) folded before Flop (didn't bet)


*********** # 15 **************
PokerStars Hand #169642135131: Tournament #1622537113, $9.10+$0.90 USD =
Hold'em No Limit - Level X (200/400) - 2017/05/09 19:38:57 ET
Table '1622537113 4' 9-max Seat #1 is the button
Seat 1: AmTheCaptain (7088 in chips)=20
Seat 2: frankx99x (1561 in chips)=20
Seat 3: Dezrok17 (12000 in chips)=20
Seat 4: Hai1ToPitt (15553 in chips)=20
Seat 5: apoch19 (14754 in chips)=20
Seat 6: zBeanHeaDz (8009 in chips)=20
Seat 8: Heart Tree (23915 in chips)=20
Seat 9: JJin91 (14916 in chips)=20
AmTheCaptain: posts the ante 50
frankx99x: posts the ante 50
Dezrok17: posts the ante 50
Hai1ToPitt: posts the ante 50
apoch19: posts the ante 50
zBeanHeaDz: posts the ante 50
Heart Tree: posts the ante 50
JJin91: posts the ante 50
frankx99x: posts small blind 200
Dezrok17: posts big blind 400
*** HOLE CARDS ***
Dealt to JJin91 [Th 2c]
Hai1ToPitt: raises 488 to 888
apoch19: folds=20
zBeanHeaDz: folds=20
Heart Tree: folds=20
JJin91: folds=20
AmTheCaptain: calls 888
frankx99x: folds=20
Dezrok17: calls 488
*** FLOP *** [3h 2h Kh]
Dezrok17: checks=20
Hai1ToPitt: bets 1404
AmTheCaptain: folds=20
Dezrok17: folds=20
Uncalled bet (1404) returned to Hai1ToPitt
Hai1ToPitt collected 3264 from pot
Hai1ToPitt: doesn't show hand=20
*** SUMMARY ***
Total pot 3264 | Rake 0=20
Board [3h 2h Kh]
Seat 1: AmTheCaptain (button) folded on the Flop
Seat 2: frankx99x (small blind) folded before Flop
Seat 3: Dezrok17 (big blind) folded on the Flop
Seat 4: Hai1ToPitt collected (3264)
Seat 5: apoch19 folded before Flop (didn't bet)
Seat 6: zBeanHeaDz folded before Flop (didn't bet)
Seat 8: Heart Tree folded before Flop (didn't bet)
Seat 9: JJin91 folded before Flop (didn't bet)


*********** # 16 **************
PokerStars Hand #169642135396: Tournament #1622537113, $9.10+$0.90 USD =
Hold'em No Limit - Level X (200/400) - 2017/05/09 19:39:45 ET
Table '1622537113 4' 9-max Seat #2 is the button
Seat 1: AmTheCaptain (6150 in chips)=20
Seat 2: frankx99x (1311 in chips)=20
Seat 3: Dezrok17 (11062 in chips)=20
Seat 4: Hai1ToPitt (17879 in chips)=20
Seat 5: apoch19 (14704 in chips)=20
Seat 6: zBeanHeaDz (7959 in chips)=20
Seat 8: Heart Tree (23865 in chips)=20
Seat 9: JJin91 (14866 in chips)=20
AmTheCaptain: posts the ante 50
frankx99x: posts the ante 50
Dezrok17: posts the ante 50
Hai1ToPitt: posts the ante 50
apoch19: posts the ante 50
zBeanHeaDz: posts the ante 50
Heart Tree: posts the ante 50
JJin91: posts the ante 50
Dezrok17: posts small blind 200
Hai1ToPitt: posts big blind 400
*** HOLE CARDS ***
Dealt to JJin91 [Ah 5h]
apoch19: folds=20
zBeanHeaDz: folds=20
Heart Tree: folds=20
JJin91: raises 476 to 876
AmTheCaptain: folds=20
frankx99x: calls 876
Dezrok17: folds=20
Hai1ToPitt: folds=20
*** FLOP *** [Kh 4h 5s]
JJin91: bets 13940 and is all-in
frankx99x: calls 385 and is all-in
Uncalled bet (13555) returned to JJin91
*** TURN *** [Kh 4h 5s] [5d]
*** RIVER *** [Kh 4h 5s 5d] [8d]
*** SHOW DOWN ***
JJin91: shows [Ah 5h] (three of a kind, Fives)
frankx99x: shows [8c Kc] (two pair, Kings and Eights)
JJin91 collected 3522 from pot
frankx99x finished the tournament in 84th place
*** SUMMARY ***
Total pot 3522 | Rake 0=20
Board [Kh 4h 5s 5d 8d]
Seat 1: AmTheCaptain folded before Flop (didn't bet)
Seat 2: frankx99x (button) showed [8c Kc] and lost with two pair, Kings=
 and Eights
Seat 3: Dezrok17 (small blind) folded before Flop
Seat 4: Hai1ToPitt (big blind) folded before Flop
Seat 5: apoch19 folded before Flop (didn't bet)
Seat 6: zBeanHeaDz folded before Flop (didn't bet)
Seat 8: Heart Tree folded before Flop (didn't bet)
Seat 9: JJin91 showed [Ah 5h] and won (3522) with three of a kind, Fives


*********** # 17 **************
PokerStars Hand #169642135594: Tournament #1622537113, $9.10+$0.90 USD =
Hold'em No Limit - Level X (200/400) - 2017/05/09 19:40:22 ET
Table '1622537113 4' 9-max Seat #3 is the button
Seat 1: AmTheCaptain (6100 in chips)=20
Seat 3: Dezrok17 (10812 in chips)=20
Seat 4: Hai1ToPitt (17429 in chips)=20
Seat 5: apoch19 (14654 in chips)=20
Seat 6: zBeanHeaDz (7909 in chips)=20
Seat 8: Heart Tree (23815 in chips)=20
Seat 9: JJin91 (17077 in chips)=20
AmTheCaptain: posts the ante 50
Dezrok17: posts the ante 50
Hai1ToPitt: posts the ante 50
apoch19: posts the ante 50
zBeanHeaDz: posts the ante 50
Heart Tree: posts the ante 50
JJin91: posts the ante 50
Hai1ToPitt: posts small blind 200
apoch19: posts big blind 400
*** HOLE CARDS ***
Dealt to JJin91 [2s 2d]
zBeanHeaDz: folds=20
Heart Tree: folds=20
JJin91: raises 476 to 876
AmTheCaptain: folds=20
Dezrok17: folds=20
Hai1ToPitt: folds=20
apoch19: folds=20
Uncalled bet (476) returned to JJin91
JJin91 collected 1350 from pot
JJin91: doesn't show hand=20
*** SUMMARY ***
Total pot 1350 | Rake 0=20
Seat 1: AmTheCaptain folded before Flop (didn't bet)
Seat 3: Dezrok17 (button) folded before Flop (didn't bet)
Seat 4: Hai1ToPitt (small blind) folded before Flop
Seat 5: apoch19 (big blind) folded before Flop
Seat 6: zBeanHeaDz folded before Flop (didn't bet)
Seat 8: Heart Tree folded before Flop (didn't bet)
Seat 9: JJin91 collected (1350)


*********** # 18 **************
PokerStars Hand #169642135683: Tournament #1622537113, $9.10+$0.90 USD =
Hold'em No Limit - Level X (200/400) - 2017/05/09 19:40:37 ET
Table '1622537113 4' 9-max Seat #4 is the button
Seat 1: AmTheCaptain (6050 in chips)=20
Seat 3: Dezrok17 (10762 in chips)=20
Seat 4: Hai1ToPitt (17179 in chips)=20
Seat 5: apoch19 (14204 in chips)=20
Seat 6: zBeanHeaDz (7859 in chips)=20
Seat 8: Heart Tree (23765 in chips)=20
Seat 9: JJin91 (17977 in chips)=20
AmTheCaptain: posts the ante 50
Dezrok17: posts the ante 50
Hai1ToPitt: posts the ante 50
apoch19: posts the ante 50
zBeanHeaDz: posts the ante 50
Heart Tree: posts the ante 50
JJin91: posts the ante 50
apoch19: posts small blind 200
zBeanHeaDz: posts big blind 400
*** HOLE CARDS ***
Dealt to JJin91 [8d 2c]
Heart Tree: folds=20
JJin91: folds=20
AmTheCaptain: folds=20
Dezrok17: folds=20
Hai1ToPitt: raises 488 to 888
apoch19: folds=20
zBeanHeaDz: folds=20
Uncalled bet (488) returned to Hai1ToPitt
Hai1ToPitt collected 1350 from pot
Hai1ToPitt: doesn't show hand=20
*** SUMMARY ***
Total pot 1350 | Rake 0=20
Seat 1: AmTheCaptain folded before Flop (didn't bet)
Seat 3: Dezrok17 folded before Flop (didn't bet)
Seat 4: Hai1ToPitt (button) collected (1350)
Seat 5: apoch19 (small blind) folded before Flop
Seat 6: zBeanHeaDz (big blind) folded before Flop
Seat 8: Heart Tree folded before Flop (didn't bet)
Seat 9: JJin91 folded before Flop (didn't bet)


*********** # 19 **************
PokerStars Hand #169642135830: Tournament #1622537113, $9.10+$0.90 USD =
Hold'em No Limit - Level X (200/400) - 2017/05/09 19:41:02 ET
Table '1622537113 4' 9-max Seat #5 is the button
Seat 1: AmTheCaptain (6000 in chips)=20
Seat 3: Dezrok17 (10712 in chips)=20
Seat 4: Hai1ToPitt (18079 in chips)=20
Seat 5: apoch19 (13954 in chips)=20
Seat 6: zBeanHeaDz (7409 in chips)=20
Seat 7: justin66lee (10000 in chips)=20
Seat 8: Heart Tree (23715 in chips)=20
Seat 9: JJin91 (17927 in chips)=20
AmTheCaptain: posts the ante 50
Dezrok17: posts the ante 50
Hai1ToPitt: posts the ante 50
apoch19: posts the ante 50
zBeanHeaDz: posts the ante 50
justin66lee: posts the ante 50
Heart Tree: posts the ante 50
JJin91: posts the ante 50
zBeanHeaDz: posts small blind 200
justin66lee: posts big blind 400
*** HOLE CARDS ***
Dealt to JJin91 [9d Ad]
Heart Tree: folds=20
JJin91: raises 476 to 876
AmTheCaptain: folds=20
Dezrok17: folds=20
Hai1ToPitt: folds=20
apoch19: folds=20
zBeanHeaDz: folds=20
justin66lee: raises 9074 to 9950 and is all-in
JJin91: folds=20
Uncalled bet (9074) returned to justin66lee
justin66lee collected 2352 from pot
justin66lee: doesn't show hand=20
*** SUMMARY ***
Total pot 2352 | Rake 0=20
Seat 1: AmTheCaptain folded before Flop (didn't bet)
Seat 3: Dezrok17 folded before Flop (didn't bet)
Seat 4: Hai1ToPitt folded before Flop (didn't bet)
Seat 5: apoch19 (button) folded before Flop (didn't bet)
Seat 6: zBeanHeaDz (small blind) folded before Flop
Seat 7: justin66lee (big blind) collected (2352)
Seat 8: Heart Tree folded before Flop (didn't bet)
Seat 9: JJin91 folded before Flop


*********** # 20 **************
PokerStars Hand #169642136084: Tournament #1622537113, $9.10+$0.90 USD =
Hold'em No Limit - Level X (200/400) - 2017/05/09 19:41:47 ET
Table '1622537113 4' 9-max Seat #6 is the button
Seat 1: AmTheCaptain (5950 in chips)=20
Seat 3: Dezrok17 (10662 in chips)=20
Seat 4: Hai1ToPitt (18029 in chips)=20
Seat 5: apoch19 (13904 in chips)=20
Seat 6: zBeanHeaDz (7159 in chips)=20
Seat 7: justin66lee (11426 in chips)=20
Seat 8: Heart Tree (23665 in chips)=20
Seat 9: JJin91 (17001 in chips)=20
AmTheCaptain: posts the ante 50
Dezrok17: posts the ante 50
Hai1ToPitt: posts the ante 50
apoch19: posts the ante 50
zBeanHeaDz: posts the ante 50
justin66lee: posts the ante 50
Heart Tree: posts the ante 50
JJin91: posts the ante 50
justin66lee: posts small blind 200
Heart Tree: posts big blind 400
*** HOLE CARDS ***
Dealt to JJin91 [Qs 7c]
JJin91: folds=20
AmTheCaptain: calls 400
Dezrok17: folds=20
Hai1ToPitt: folds=20
apoch19: folds=20
zBeanHeaDz: folds=20
justin66lee: calls 200
Heart Tree: checks=20
*** FLOP *** [9h 8s Ah]
justin66lee: bets 400
Heart Tree: calls 400
AmTheCaptain: calls 400
*** TURN *** [9h 8s Ah] [4c]
justin66lee: bets 1600
Heart Tree: folds=20
AmTheCaptain: folds=20
Uncalled bet (1600) returned to justin66lee
justin66lee collected 2800 from pot
justin66lee: doesn't show hand=20
*** SUMMARY ***
Total pot 2800 | Rake 0=20
Board [9h 8s Ah 4c]
Seat 1: AmTheCaptain folded on the Turn
Seat 3: Dezrok17 folded before Flop (didn't bet)
Seat 4: Hai1ToPitt folded before Flop (didn't bet)
Seat 5: apoch19 folded before Flop (didn't bet)
Seat 6: zBeanHeaDz (button) folded before Flop (didn't bet)
Seat 7: justin66lee (small blind) collected (2800)
Seat 8: Heart Tree (big blind) folded on the Turn
Seat 9: JJin91 folded before Flop (didn't bet)


*********** # 21 **************
PokerStars Hand #169642136347: Tournament #1622537113, $9.10+$0.90 USD =
Hold'em No Limit - Level X (200/400) - 2017/05/09 19:42:36 ET
Table '1622537113 4' 9-max Seat #7 is the button
Seat 1: AmTheCaptain (5100 in chips)=20
Seat 3: Dezrok17 (10612 in chips)=20
Seat 4: Hai1ToPitt (17979 in chips)=20
Seat 5: apoch19 (13854 in chips)=20
Seat 6: zBeanHeaDz (7109 in chips)=20
Seat 7: justin66lee (13376 in chips)=20
Seat 8: Heart Tree (22815 in chips)=20
Seat 9: JJin91 (16951 in chips)=20
AmTheCaptain: posts the ante 50
Dezrok17: posts the ante 50
Hai1ToPitt: posts the ante 50
apoch19: posts the ante 50
zBeanHeaDz: posts the ante 50
justin66lee: posts the ante 50
Heart Tree: posts the ante 50
JJin91: posts the ante 50
Heart Tree: posts small blind 200
JJin91: posts big blind 400
*** HOLE CARDS ***
Dealt to JJin91 [3s Kd]
AmTheCaptain: calls 400
Dezrok17: folds=20
Hai1ToPitt: folds=20
apoch19: folds=20
zBeanHeaDz: folds=20
justin66lee: folds=20
Heart Tree: raises 600 to 1000
JJin91: calls 600
AmTheCaptain: calls 600
*** FLOP *** [Qc Td 3d]
Heart Tree: bets 1020
JJin91: calls 1020
AmTheCaptain: raises 1420 to 2440
Heart Tree: folds=20
JJin91: calls 1420
*** TURN *** [Qc Td 3d] [5h]
JJin91: checks=20
AmTheCaptain: bets 1610 and is all-in
JJin91: calls 1610
*** RIVER *** [Qc Td 3d 5h] [7s]
*** SHOW DOWN ***
JJin91: shows [3s Kd] (a pair of Threes)
AmTheCaptain: shows [Qd Th] (two pair, Queens and Tens)
AmTheCaptain collected 12520 from pot
*** SUMMARY ***
Total pot 12520 | Rake 0=20
Board [Qc Td 3d 5h 7s]
Seat 1: AmTheCaptain showed [Qd Th] and won (12520) with two pair, Quee=
ns and Tens
Seat 3: Dezrok17 folded before Flop (didn't bet)
Seat 4: Hai1ToPitt folded before Flop (didn't bet)
Seat 5: apoch19 folded before Flop (didn't bet)
Seat 6: zBeanHeaDz folded before Flop (didn't bet)
Seat 7: justin66lee (button) folded before Flop (didn't bet)
Seat 8: Heart Tree (small blind) folded on the Flop
Seat 9: JJin91 (big blind) showed [3s Kd] and lost with a pair of Threes


*********** # 22 **************
PokerStars Hand #169642136750: Tournament #1622537113, $9.10+$0.90 USD =
Hold'em No Limit - Level X (200/400) - 2017/05/09 19:43:51 ET
Table '1622537113 4' 9-max Seat #8 is the button
Seat 1: AmTheCaptain (12520 in chips)=20
Seat 3: Dezrok17 (10562 in chips)=20
Seat 4: Hai1ToPitt (17929 in chips)=20
Seat 5: apoch19 (13804 in chips)=20
Seat 6: zBeanHeaDz (7059 in chips)=20
Seat 7: justin66lee (13326 in chips)=20
Seat 8: Heart Tree (20745 in chips)=20
Seat 9: JJin91 (11851 in chips)=20
AmTheCaptain: posts the ante 50
Dezrok17: posts the ante 50
Hai1ToPitt: posts the ante 50
apoch19: posts the ante 50
zBeanHeaDz: posts the ante 50
justin66lee: posts the ante 50
Heart Tree: posts the ante 50
JJin91: posts the ante 50
JJin91: posts small blind 200
AmTheCaptain: posts big blind 400
*** HOLE CARDS ***
Dealt to JJin91 [Kd Td]
Dezrok17: folds=20
Hai1ToPitt: raises 488 to 888
apoch19: folds=20
zBeanHeaDz: folds=20
justin66lee: folds=20
Heart Tree: calls 888
JJin91: raises 1563 to 2451
AmTheCaptain: folds=20
Hai1ToPitt: calls 1563
Heart Tree: calls 1563
*** FLOP *** [Tc Qh Jh]
JJin91: bets 9350 and is all-in
Hai1ToPitt: folds=20
Heart Tree: folds=20
Uncalled bet (9350) returned to JJin91
JJin91 collected 8153 from pot
JJin91: doesn't show hand=20
*** SUMMARY ***
Total pot 8153 | Rake 0=20
Board [Tc Qh Jh]
Seat 1: AmTheCaptain (big blind) folded before Flop
Seat 3: Dezrok17 folded before Flop (didn't bet)
Seat 4: Hai1ToPitt folded on the Flop
Seat 5: apoch19 folded before Flop (didn't bet)
Seat 6: zBeanHeaDz folded before Flop (didn't bet)
Seat 7: justin66lee folded before Flop (didn't bet)
Seat 8: Heart Tree (button) folded on the Flop
Seat 9: JJin91 (small blind) collected (8153)


*********** # 23 **************
PokerStars Hand #169642137325: Tournament #1622537113, $9.10+$0.90 USD =
Hold'em No Limit - Level X (200/400) - 2017/05/09 19:45:43 ET
Table '1622537113 4' 9-max Seat #9 is the button
Seat 1: AmTheCaptain (12070 in chips)=20
Seat 3: Dezrok17 (10512 in chips)=20
Seat 4: Hai1ToPitt (15428 in chips)=20
Seat 5: apoch19 (13754 in chips)=20
Seat 6: zBeanHeaDz (7009 in chips)=20
Seat 7: justin66lee (13276 in chips)=20
Seat 8: Heart Tree (18244 in chips)=20
Seat 9: JJin91 (17503 in chips)=20
AmTheCaptain: posts the ante 50
Dezrok17: posts the ante 50
Hai1ToPitt: posts the ante 50
apoch19: posts the ante 50
zBeanHeaDz: posts the ante 50
justin66lee: posts the ante 50
Heart Tree: posts the ante 50
JJin91: posts the ante 50
AmTheCaptain: posts small blind 200
Dezrok17: posts big blind 400
*** HOLE CARDS ***
Dealt to JJin91 [2c 6s]
Hai1ToPitt: folds=20
apoch19: folds=20
zBeanHeaDz: folds=20
justin66lee: calls 400
Heart Tree: folds=20
JJin91: folds=20
AmTheCaptain: calls 200
Dezrok17: checks=20
*** FLOP *** [5d Js 6h]
AmTheCaptain: bets 800
Dezrok17: folds=20
justin66lee: raises 1600 to 2400
AmTheCaptain: folds=20
Uncalled bet (1600) returned to justin66lee
justin66lee collected 3200 from pot
justin66lee: doesn't show hand=20
*** SUMMARY ***
Total pot 3200 | Rake 0=20
Board [5d Js 6h]
Seat 1: AmTheCaptain (small blind) folded on the Flop
Seat 3: Dezrok17 (big blind) folded on the Flop
Seat 4: Hai1ToPitt folded before Flop (didn't bet)
Seat 5: apoch19 folded before Flop (didn't bet)
Seat 6: zBeanHeaDz folded before Flop (didn't bet)
Seat 7: justin66lee collected (3200)
Seat 8: Heart Tree folded before Flop (didn't bet)
Seat 9: JJin91 (button) folded before Flop (didn't bet)


*********** # 24 **************
PokerStars Hand #169642137542: Tournament #1622537113, $9.10+$0.90 USD =
Hold'em No Limit - Level XI (250/500) - 2017/05/09 19:46:28 ET
Table '1622537113 4' 9-max Seat #1 is the button
Seat 1: AmTheCaptain (10820 in chips)=20
Seat 3: Dezrok17 (10062 in chips)=20
Seat 4: Hai1ToPitt (15378 in chips)=20
Seat 5: apoch19 (13704 in chips)=20
Seat 6: zBeanHeaDz (6959 in chips)=20
Seat 7: justin66lee (15226 in chips)=20
Seat 8: Heart Tree (18194 in chips)=20
Seat 9: JJin91 (17453 in chips)=20
AmTheCaptain: posts the ante 60
Dezrok17: posts the ante 60
Hai1ToPitt: posts the ante 60
apoch19: posts the ante 60
zBeanHeaDz: posts the ante 60
justin66lee: posts the ante 60
Heart Tree: posts the ante 60
JJin91: posts the ante 60
Dezrok17: posts small blind 250
Hai1ToPitt: posts big blind 500
*** HOLE CARDS ***
Dealt to JJin91 [Kc 2d]
apoch19: folds=20
zBeanHeaDz: folds=20
justin66lee: folds=20
Heart Tree: folds=20
JJin91: folds=20
AmTheCaptain: folds=20
Dezrok17: calls 250
Hai1ToPitt: raises 1225 to 1725
Dezrok17: folds=20
Uncalled bet (1225) returned to Hai1ToPitt
Hai1ToPitt collected 1480 from pot
Hai1ToPitt: doesn't show hand=20
*** SUMMARY ***
Total pot 1480 | Rake 0=20
Seat 1: AmTheCaptain (button) folded before Flop (didn't bet)
Seat 3: Dezrok17 (small blind) folded before Flop
Seat 4: Hai1ToPitt (big blind) collected (1480)
Seat 5: apoch19 folded before Flop (didn't bet)
Seat 6: zBeanHeaDz folded before Flop (didn't bet)
Seat 7: justin66lee folded before Flop (didn't bet)
Seat 8: Heart Tree folded before Flop (didn't bet)
Seat 9: JJin91 folded before Flop (didn't bet)


*********** # 25 **************
PokerStars Hand #169642137710: Tournament #1622537113, $9.10+$0.90 USD =
Hold'em No Limit - Level XI (250/500) - 2017/05/09 19:47:02 ET
Table '1622537113 4' 9-max Seat #3 is the button
Seat 1: AmTheCaptain (10760 in chips)=20
Seat 3: Dezrok17 (9502 in chips)=20
Seat 4: Hai1ToPitt (16298 in chips)=20
Seat 5: apoch19 (13644 in chips)=20
Seat 6: zBeanHeaDz (6899 in chips)=20
Seat 7: justin66lee (15166 in chips)=20
Seat 8: Heart Tree (18134 in chips)=20
Seat 9: JJin91 (17393 in chips)=20
AmTheCaptain: posts the ante 60
Dezrok17: posts the ante 60
Hai1ToPitt: posts the ante 60
apoch19: posts the ante 60
zBeanHeaDz: posts the ante 60
justin66lee: posts the ante 60
Heart Tree: posts the ante 60
JJin91: posts the ante 60
Hai1ToPitt: posts small blind 250
apoch19: posts big blind 500
*** HOLE CARDS ***
Dealt to JJin91 [Jc Ad]
zBeanHeaDz: raises 6339 to 6839 and is all-in
justin66lee: folds=20
Heart Tree: folds=20
JJin91: folds=20
AmTheCaptain: folds=20
Dezrok17: folds=20
Hai1ToPitt: folds=20
apoch19: calls 6339
*** FLOP *** [3h Td Ah]
*** TURN *** [3h Td Ah] [7c]
*** RIVER *** [3h Td Ah 7c] [9s]
*** SHOW DOWN ***
apoch19: shows [6s 6h] (a pair of Sixes)
zBeanHeaDz: shows [Ac Kd] (a pair of Aces)
zBeanHeaDz collected 14408 from pot
*** SUMMARY ***
Total pot 14408 | Rake 0=20
Board [3h Td Ah 7c 9s]
Seat 1: AmTheCaptain folded before Flop (didn't bet)
Seat 3: Dezrok17 (button) folded before Flop (didn't bet)
Seat 4: Hai1ToPitt (small blind) folded before Flop
Seat 5: apoch19 (big blind) showed [6s 6h] and lost with a pair of Sixes
Seat 6: zBeanHeaDz showed [Ac Kd] and won (14408) with a pair of Aces
Seat 7: justin66lee folded before Flop (didn't bet)
Seat 8: Heart Tree folded before Flop (didn't bet)
Seat 9: JJin91 folded before Flop (didn't bet)


*********** # 26 **************
PokerStars Hand #169642137870: Tournament #1622537113, $9.10+$0.90 USD =
Hold'em No Limit - Level XI (250/500) - 2017/05/09 19:47:36 ET
Table '1622537113 4' 9-max Seat #4 is the button
Seat 1: AmTheCaptain (10700 in chips)=20
Seat 3: Dezrok17 (9442 in chips)=20
Seat 4: Hai1ToPitt (15988 in chips)=20
Seat 5: apoch19 (6745 in chips)=20
Seat 6: zBeanHeaDz (14408 in chips)=20
Seat 7: justin66lee (15106 in chips)=20
Seat 8: Heart Tree (18074 in chips)=20
Seat 9: JJin91 (17333 in chips)=20
AmTheCaptain: posts the ante 60
Dezrok17: posts the ante 60
Hai1ToPitt: posts the ante 60
apoch19: posts the ante 60
zBeanHeaDz: posts the ante 60
justin66lee: posts the ante 60
Heart Tree: posts the ante 60
JJin91: posts the ante 60
apoch19: posts small blind 250
zBeanHeaDz: posts big blind 500
*** HOLE CARDS ***
Dealt to JJin91 [6d Qh]
justin66lee: folds=20
Heart Tree: folds=20
JJin91: folds=20
AmTheCaptain: folds=20
Dezrok17: raises 550 to 1050
Hai1ToPitt: folds=20
apoch19: folds=20
zBeanHeaDz: folds=20
Uncalled bet (550) returned to Dezrok17
Dezrok17 collected 1730 from pot
*** SUMMARY ***
Total pot 1730 | Rake 0=20
Seat 1: AmTheCaptain folded before Flop (didn't bet)
Seat 3: Dezrok17 collected (1730)
Seat 4: Hai1ToPitt (button) folded before Flop (didn't bet)
Seat 5: apoch19 (small blind) folded before Flop
Seat 6: zBeanHeaDz (big blind) folded before Flop
Seat 7: justin66lee folded before Flop (didn't bet)
Seat 8: Heart Tree folded before Flop (didn't bet)
Seat 9: JJin91 folded before Flop (didn't bet)


*********** # 27 **************
PokerStars Hand #169642138125: Tournament #1622537113, $9.10+$0.90 USD =
Hold'em No Limit - Level XI (250/500) - 2017/05/09 19:48:29 ET
Table '1622537113 5' 9-max Seat #8 is the button
Seat 1: HiGHSTEAK609 (8970 in chips)=20
Seat 3: Mr.Planter (41182 in chips)=20
Seat 4: JJin91 (17273 in chips)=20
Seat 5: DomBagz (7455 in chips)=20
Seat 6: SneakyPete85 (22090 in chips)=20
Seat 8: y3nk_ (26714 in chips)=20
Seat 9: N0InBetween (6677 in chips)=20
HiGHSTEAK609: posts the ante 60
Mr.Planter: posts the ante 60
JJin91: posts the ante 60
DomBagz: posts the ante 60
SneakyPete85: posts the ante 60
y3nk_: posts the ante 60
N0InBetween: posts the ante 60
N0InBetween: posts small blind 250
HiGHSTEAK609: posts big blind 500
*** HOLE CARDS ***
Dealt to JJin91 [Js 9s]
Mr.Planter: folds=20
JJin91: folds=20
DomBagz: folds=20
SneakyPete85: raises 500 to 1000
y3nk_: calls 1000
N0InBetween: folds=20
HiGHSTEAK609: folds=20
*** FLOP *** [3c Jc 6d]
SneakyPete85: checks=20
y3nk_: bets 1500
SneakyPete85: folds=20
Uncalled bet (1500) returned to y3nk_
y3nk_ collected 3170 from pot
*** SUMMARY ***
Total pot 3170 | Rake 0=20
Board [3c Jc 6d]
Seat 1: HiGHSTEAK609 (big blind) folded before Flop
Seat 3: Mr.Planter folded before Flop (didn't bet)
Seat 4: JJin91 folded before Flop (didn't bet)
Seat 5: DomBagz folded before Flop (didn't bet)
Seat 6: SneakyPete85 folded on the Flop
Seat 8: y3nk_ (button) collected (3170)
Seat 9: N0InBetween (small blind) folded before Flop


*********** # 28 **************
PokerStars Hand #169642138360: Tournament #1622537113, $9.10+$0.90 USD =
Hold'em No Limit - Level XI (250/500) - 2017/05/09 19:49:18 ET
Table '1622537113 5' 9-max Seat #9 is the button
Seat 1: HiGHSTEAK609 (8410 in chips)=20
Seat 2: DaBirds23 (10000 in chips)=20
Seat 3: Mr.Planter (41122 in chips)=20
Seat 4: JJin91 (17213 in chips)=20
Seat 5: DomBagz (7395 in chips)=20
Seat 6: SneakyPete85 (21030 in chips)=20
Seat 8: y3nk_ (28824 in chips)=20
Seat 9: N0InBetween (6367 in chips)=20
HiGHSTEAK609: posts the ante 60
DaBirds23: posts the ante 60
Mr.Planter: posts the ante 60
JJin91: posts the ante 60
DomBagz: posts the ante 60
SneakyPete85: posts the ante 60
y3nk_: posts the ante 60
N0InBetween: posts the ante 60
HiGHSTEAK609: posts small blind 250
DaBirds23: posts big blind 500
*** HOLE CARDS ***
Dealt to JJin91 [Kc Js]
Mr.Planter: calls 500
JJin91: folds=20
DomBagz: calls 500
SneakyPete85: folds=20
y3nk_: folds=20
N0InBetween: folds=20
HiGHSTEAK609: folds=20
DaBirds23: checks=20
*** FLOP *** [Th 9h 9c]
DaBirds23: checks=20
Mr.Planter: bets 500
DomBagz: folds=20
DaBirds23: folds=20
Uncalled bet (500) returned to Mr.Planter
Mr.Planter collected 2230 from pot
Mr.Planter: doesn't show hand=20
*** SUMMARY ***
Total pot 2230 | Rake 0=20
Board [Th 9h 9c]
Seat 1: HiGHSTEAK609 (small blind) folded before Flop
Seat 2: DaBirds23 (big blind) folded on the Flop
Seat 3: Mr.Planter collected (2230)
Seat 4: JJin91 folded before Flop (didn't bet)
Seat 5: DomBagz folded on the Flop
Seat 6: SneakyPete85 folded before Flop (didn't bet)
Seat 8: y3nk_ folded before Flop (didn't bet)
Seat 9: N0InBetween (button) folded before Flop (didn't bet)


*********** # 29 **************
PokerStars Hand #169642138509: Tournament #1622537113, $9.10+$0.90 USD =
Hold'em No Limit - Level XI (250/500) - 2017/05/09 19:49:51 ET
Table '1622537113 5' 9-max Seat #1 is the button
Seat 1: HiGHSTEAK609 (8100 in chips)=20
Seat 2: DaBirds23 (9440 in chips)=20
Seat 3: Mr.Planter (42792 in chips)=20
Seat 4: JJin91 (17153 in chips)=20
Seat 5: DomBagz (6835 in chips)=20
Seat 6: SneakyPete85 (20970 in chips)=20
Seat 8: y3nk_ (28764 in chips)=20
Seat 9: N0InBetween (6307 in chips)=20
HiGHSTEAK609: posts the ante 60
DaBirds23: posts the ante 60
Mr.Planter: posts the ante 60
JJin91: posts the ante 60
DomBagz: posts the ante 60
SneakyPete85: posts the ante 60
y3nk_: posts the ante 60
N0InBetween: posts the ante 60
DaBirds23: posts small blind 250
Mr.Planter: posts big blind 500
*** HOLE CARDS ***
Dealt to JJin91 [3d 3s]
JJin91: folds=20
DomBagz: raises 500 to 1000
SneakyPete85: calls 1000
y3nk_: folds=20
N0InBetween: folds=20
HiGHSTEAK609: folds=20
DaBirds23: folds=20
Mr.Planter: calls 500
*** FLOP *** [3c Qs 7c]
Mr.Planter: checks=20
DomBagz: checks=20
SneakyPete85: checks=20
*** TURN *** [3c Qs 7c] [Js]
Mr.Planter: checks=20
DomBagz: checks=20
SneakyPete85: checks=20
*** RIVER *** [3c Qs 7c Js] [9s]
Mr.Planter: checks=20
DomBagz: checks=20
SneakyPete85: bets 1500
Mr.Planter: folds=20
DomBagz: folds=20
Uncalled bet (1500) returned to SneakyPete85
SneakyPete85 collected 3730 from pot
SneakyPete85: doesn't show hand=20
*** SUMMARY ***
Total pot 3730 | Rake 0=20
Board [3c Qs 7c Js 9s]
Seat 1: HiGHSTEAK609 (button) folded before Flop (didn't bet)
Seat 2: DaBirds23 (small blind) folded before Flop
Seat 3: Mr.Planter (big blind) folded on the River
Seat 4: JJin91 folded before Flop (didn't bet)
Seat 5: DomBagz folded on the River
Seat 6: SneakyPete85 collected (3730)
Seat 8: y3nk_ folded before Flop (didn't bet)
Seat 9: N0InBetween folded before Flop (didn't bet)


*********** # 30 **************
PokerStars Hand #169642138943: Tournament #1622537113, $9.10+$0.90 USD =
Hold'em No Limit - Level XI (250/500) - 2017/05/09 19:51:16 ET
Table '1622537113 5' 9-max Seat #2 is the button
Seat 1: HiGHSTEAK609 (8040 in chips)=20
Seat 2: DaBirds23 (9130 in chips)=20
Seat 3: Mr.Planter (41732 in chips)=20
Seat 4: JJin91 (17093 in chips)=20
Seat 5: DomBagz (5775 in chips)=20
Seat 6: SneakyPete85 (23640 in chips)=20
Seat 7: thepaw98 (10000 in chips)=20
Seat 8: y3nk_ (28704 in chips)=20
Seat 9: N0InBetween (6247 in chips)=20
HiGHSTEAK609: posts the ante 60
DaBirds23: posts the ante 60
Mr.Planter: posts the ante 60
JJin91: posts the ante 60
DomBagz: posts the ante 60
SneakyPete85: posts the ante 60
thepaw98: posts the ante 60
y3nk_: posts the ante 60
N0InBetween: posts the ante 60
Mr.Planter: posts small blind 250
JJin91: posts big blind 500
*** HOLE CARDS ***
Dealt to JJin91 [Qd Ks]
DomBagz: folds=20
SneakyPete85: folds=20
thepaw98: folds=20
y3nk_: folds=20
N0InBetween: folds=20
HiGHSTEAK609: raises 600 to 1100
DaBirds23: folds=20
Mr.Planter: folds=20
JJin91: calls 600
*** FLOP *** [Qh 3h 8d]
JJin91: checks=20
HiGHSTEAK609: bets 6880 and is all-in
JJin91: calls 6880
*** TURN *** [Qh 3h 8d] [2h]
*** RIVER *** [Qh 3h 8d 2h] [Ts]
*** SHOW DOWN ***
JJin91: shows [Qd Ks] (a pair of Queens)
HiGHSTEAK609: shows [Qc Jc] (a pair of Queens - lower kicker)
JJin91 collected 16750 from pot
HiGHSTEAK609 finished the tournament in 72nd place
*** SUMMARY ***
Total pot 16750 | Rake 0=20
Board [Qh 3h 8d 2h Ts]
Seat 1: HiGHSTEAK609 showed [Qc Jc] and lost with a pair of Queens
Seat 2: DaBirds23 (button) folded before Flop (didn't bet)
Seat 3: Mr.Planter (small blind) folded before Flop
Seat 4: JJin91 (big blind) showed [Qd Ks] and won (16750) with a pair o=
f Queens
Seat 5: DomBagz folded before Flop (didn't bet)
Seat 6: SneakyPete85 folded before Flop (didn't bet)
Seat 7: thepaw98 folded before Flop (didn't bet)
Seat 8: y3nk_ folded before Flop (didn't bet)
Seat 9: N0InBetween folded before Flop (didn't bet)


*********** # 31 **************
PokerStars Hand #169642139185: Tournament #1622537113, $9.10+$0.90 USD =
Hold'em No Limit - Level XI (250/500) - 2017/05/09 19:52:06 ET
Table '1622537113 5' 9-max Seat #3 is the button
Seat 2: DaBirds23 (9070 in chips)=20
Seat 3: Mr.Planter (41422 in chips)=20
Seat 4: JJin91 (25803 in chips)=20
Seat 5: DomBagz (5715 in chips)=20
Seat 6: SneakyPete85 (23580 in chips)=20
Seat 7: thepaw98 (9940 in chips)=20
Seat 8: y3nk_ (28644 in chips)=20
Seat 9: N0InBetween (6187 in chips)=20
DaBirds23: posts the ante 60
Mr.Planter: posts the ante 60
JJin91: posts the ante 60
DomBagz: posts the ante 60
SneakyPete85: posts the ante 60
thepaw98: posts the ante 60
y3nk_: posts the ante 60
N0InBetween: posts the ante 60
JJin91: posts small blind 250
DomBagz: posts big blind 500
*** HOLE CARDS ***
Dealt to JJin91 [4c 8h]
SneakyPete85: folds=20
thepaw98: folds=20
y3nk_: folds=20
HiGHSTEAK609 said, "nh"
N0InBetween: folds=20
DaBirds23: folds=20
Mr.Planter: folds=20
JJin91: calls 250
DomBagz: checks=20
*** FLOP *** [4h 2s Kh]
JJin91: checks=20
DomBagz: checks=20
*** TURN *** [4h 2s Kh] [3s]
JJin91: bets 784
DomBagz: calls 784
*** RIVER *** [4h 2s Kh 3s] [Qh]
JJin91: checks=20
DomBagz: bets 2286
JJin91: raises 22173 to 24459 and is all-in
DomBagz: folds=20
Uncalled bet (22173) returned to JJin91
JJin91 collected 7620 from pot
JJin91: doesn't show hand=20
*** SUMMARY ***
Total pot 7620 | Rake 0=20
Board [4h 2s Kh 3s Qh]
Seat 2: DaBirds23 folded before Flop (didn't bet)
Seat 3: Mr.Planter (button) folded before Flop (didn't bet)
Seat 4: JJin91 (small blind) collected (7620)
Seat 5: DomBagz (big blind) folded on the River
Seat 6: SneakyPete85 folded before Flop (didn't bet)
Seat 7: thepaw98 folded before Flop (didn't bet)
Seat 8: y3nk_ folded before Flop (didn't bet)
Seat 9: N0InBetween folded before Flop (didn't bet)


*********** # 32 **************
PokerStars Hand #169642139538: Tournament #1622537113, $9.10+$0.90 USD =
Hold'em No Limit - Level XI (250/500) - 2017/05/09 19:53:18 ET
Table '1622537113 5' 9-max Seat #4 is the button
Seat 1: HiGHSTEAK609 (10000 in chips)=20
Seat 2: DaBirds23 (9010 in chips)=20
Seat 3: Mr.Planter (41362 in chips)=20
Seat 4: JJin91 (29793 in chips)=20
Seat 5: DomBagz (2085 in chips)=20
Seat 6: SneakyPete85 (23520 in chips)=20
Seat 7: thepaw98 (9880 in chips)=20
Seat 8: y3nk_ (28584 in chips)=20
Seat 9: N0InBetween (6127 in chips)=20
HiGHSTEAK609: posts the ante 60
DaBirds23: posts the ante 60
Mr.Planter: posts the ante 60
JJin91: posts the ante 60
DomBagz: posts the ante 60
SneakyPete85: posts the ante 60
thepaw98: posts the ante 60
y3nk_: posts the ante 60
N0InBetween: posts the ante 60
DomBagz: posts small blind 250
SneakyPete85: posts big blind 500
*** HOLE CARDS ***
Dealt to JJin91 [Ah Js]
thepaw98: calls 500
y3nk_: folds=20
N0InBetween: folds=20
HiGHSTEAK609: folds=20
DaBirds23: folds=20
Mr.Planter: folds=20
JJin91: raises 1500 to 2000
DomBagz: folds=20
SneakyPete85: folds=20
thepaw98: calls 1500
*** FLOP *** [Td 7h 3d]
thepaw98: checks=20
JJin91: bets 27733 and is all-in
thepaw98: calls 7820 and is all-in
Uncalled bet (19913) returned to JJin91
*** TURN *** [Td 7h 3d] [2d]
*** RIVER *** [Td 7h 3d 2d] [9d]
*** SHOW DOWN ***
thepaw98: shows [Ts As] (a pair of Tens)
JJin91: shows [Ah Js] (high card Ace)
thepaw98 collected 20930 from pot
*** SUMMARY ***
Total pot 20930 | Rake 0=20
Board [Td 7h 3d 2d 9d]
Seat 1: HiGHSTEAK609 folded before Flop (didn't bet)
Seat 2: DaBirds23 folded before Flop (didn't bet)
Seat 3: Mr.Planter folded before Flop (didn't bet)
Seat 4: JJin91 (button) showed [Ah Js] and lost with high card Ace
Seat 5: DomBagz (small blind) folded before Flop
Seat 6: SneakyPete85 (big blind) folded before Flop
Seat 7: thepaw98 showed [Ts As] and won (20930) with a pair of Tens
Seat 8: y3nk_ folded before Flop (didn't bet)
Seat 9: N0InBetween folded before Flop (didn't bet)


*********** # 33 **************
PokerStars Hand #169642139827: Tournament #1622537113, $9.10+$0.90 USD =
Hold'em No Limit - Level XI (250/500) - 2017/05/09 19:54:21 ET
Table '1622537113 5' 9-max Seat #5 is the button
Seat 1: HiGHSTEAK609 (9940 in chips)=20
Seat 2: DaBirds23 (8950 in chips)=20
Seat 3: Mr.Planter (41302 in chips)=20
Seat 4: JJin91 (19913 in chips)=20
Seat 5: DomBagz (1775 in chips)=20
Seat 6: SneakyPete85 (22960 in chips)=20
Seat 7: thepaw98 (20930 in chips)=20
Seat 8: y3nk_ (28524 in chips)=20
Seat 9: N0InBetween (6067 in chips)=20
HiGHSTEAK609: posts the ante 60
DaBirds23: posts the ante 60
Mr.Planter: posts the ante 60
JJin91: posts the ante 60
DomBagz: posts the ante 60
SneakyPete85: posts the ante 60
thepaw98: posts the ante 60
y3nk_: posts the ante 60
N0InBetween: posts the ante 60
SneakyPete85: posts small blind 250
thepaw98: posts big blind 500
*** HOLE CARDS ***
Dealt to JJin91 [4d 7d]
y3nk_: folds=20
N0InBetween: folds=20
HiGHSTEAK609: raises 600 to 1100
DaBirds23: folds=20
Mr.Planter: folds=20
JJin91: folds=20
DomBagz: folds=20
SneakyPete85: folds=20
thepaw98: folds=20
Uncalled bet (600) returned to HiGHSTEAK609
HiGHSTEAK609 collected 1790 from pot
HiGHSTEAK609: doesn't show hand=20
*** SUMMARY ***
Total pot 1790 | Rake 0=20
Seat 1: HiGHSTEAK609 collected (1790)
Seat 2: DaBirds23 folded before Flop (didn't bet)
Seat 3: Mr.Planter folded before Flop (didn't bet)
Seat 4: JJin91 folded before Flop (didn't bet)
Seat 5: DomBagz (button) folded before Flop (didn't bet)
Seat 6: SneakyPete85 (small blind) folded before Flop
Seat 7: thepaw98 (big blind) folded before Flop
Seat 8: y3nk_ folded before Flop (didn't bet)
Seat 9: N0InBetween folded before Flop (didn't bet)


*********** # 34 **************
PokerStars Hand #169642139923: Tournament #1622537113, $9.10+$0.90 USD =
Hold'em No Limit - Level XI (250/500) - 2017/05/09 19:54:43 ET
Table '1622537113 5' 9-max Seat #6 is the button
Seat 1: HiGHSTEAK609 (11170 in chips)=20
Seat 2: DaBirds23 (8890 in chips)=20
Seat 3: Mr.Planter (41242 in chips)=20
Seat 4: JJin91 (19853 in chips)=20
Seat 5: DomBagz (1715 in chips)=20
Seat 6: SneakyPete85 (22650 in chips)=20
Seat 7: thepaw98 (20370 in chips)=20
Seat 8: y3nk_ (28464 in chips)=20
Seat 9: N0InBetween (6007 in chips)=20
HiGHSTEAK609: posts the ante 60
DaBirds23: posts the ante 60
Mr.Planter: posts the ante 60
JJin91: posts the ante 60
DomBagz: posts the ante 60
SneakyPete85: posts the ante 60
thepaw98: posts the ante 60
y3nk_: posts the ante 60
N0InBetween: posts the ante 60
thepaw98: posts small blind 250
y3nk_: posts big blind 500
*** HOLE CARDS ***
Dealt to JJin91 [Ad 4c]
N0InBetween: folds=20
HiGHSTEAK609: folds=20
DaBirds23: folds=20
Mr.Planter: folds=20
JJin91: folds=20
DomBagz: folds=20
SneakyPete85: raises 500 to 1000
thepaw98: folds=20
y3nk_: folds=20
Uncalled bet (500) returned to SneakyPete85
SneakyPete85 collected 1790 from pot
SneakyPete85: doesn't show hand=20
*** SUMMARY ***
Total pot 1790 | Rake 0=20
Seat 1: HiGHSTEAK609 folded before Flop (didn't bet)
Seat 2: DaBirds23 folded before Flop (didn't bet)
Seat 3: Mr.Planter folded before Flop (didn't bet)
Seat 4: JJin91 folded before Flop (didn't bet)
Seat 5: DomBagz folded before Flop (didn't bet)
Seat 6: SneakyPete85 (button) collected (1790)
Seat 7: thepaw98 (small blind) folded before Flop
Seat 8: y3nk_ (big blind) folded before Flop
Seat 9: N0InBetween folded before Flop (didn't bet)


*********** # 35 **************
PokerStars Hand #169644927683: Tournament #1622537113, $9.10+$0.90 USD =
Hold'em No Limit - Level XI (250/500) - 2017/05/09 20:01:01 ET
Table '1622537113 9' 9-max Seat #1 is the button
Seat 1: Labba609 (10000 in chips)=20
Seat 2: CerPrisingLe (10000 in chips)=20
Seat 3: PureWizardry (21520 in chips)=20
Seat 4: JJin91 (19793 in chips)=20
Seat 5: bigpond12 (11828 in chips)=20
Seat 6: broncos713 (9940 in chips)=20
Seat 7: almeida.matt (16749 in chips)=20
Seat 8: apoch19 (4275 in chips)=20
Seat 9: thepaw98 (20060 in chips)=20
Labba609: posts the ante 60
CerPrisingLe: posts the ante 60
PureWizardry: posts the ante 60
JJin91: posts the ante 60
bigpond12: posts the ante 60
broncos713: posts the ante 60
almeida.matt: posts the ante 60
apoch19: posts the ante 60
thepaw98: posts the ante 60
CerPrisingLe: posts small blind 250
PureWizardry: posts big blind 500
*** HOLE CARDS ***
Dealt to JJin91 [2d Qd]
JJin91: folds=20
almeida.matt is disconnected=20
bigpond12: folds=20
broncos713: raises 750 to 1250
almeida.matt is connected=20
almeida.matt: raises 2250 to 3500
apoch19: folds=20
thepaw98 has timed out
thepaw98: folds=20
thepaw98 is sitting out
Labba609: folds=20
CerPrisingLe: folds=20
PureWizardry: folds=20
broncos713: raises 6380 to 9880 and is all-in
almeida.matt: calls 6380
*** FLOP *** [Jd Kh 4d]
*** TURN *** [Jd Kh 4d] [4s]
*** RIVER *** [Jd Kh 4d 4s] [Qc]
*** SHOW DOWN ***
broncos713: shows [Jh Ac] (two pair, Jacks and Fours)
almeida.matt: shows [Ks Kc] (a full house, Kings full of Fours)
almeida.matt collected 21050 from pot
broncos713 finished the tournament in 67th place
*** SUMMARY ***
Total pot 21050 | Rake 0=20
Board [Jd Kh 4d 4s Qc]
Seat 1: Labba609 (button) folded before Flop (didn't bet)
Seat 2: CerPrisingLe (small blind) folded before Flop
Seat 3: PureWizardry (big blind) folded before Flop
Seat 4: JJin91 folded before Flop (didn't bet)
Seat 5: bigpond12 folded before Flop (didn't bet)
Seat 6: broncos713 showed [Jh Ac] and lost with two pair, Jacks and Fou=
rs
Seat 7: almeida.matt showed [Ks Kc] and won (21050) with a full house, =
Kings full of Fours
Seat 8: apoch19 folded before Flop (didn't bet)
Seat 9: thepaw98 folded before Flop (didn't bet)


*********** # 36 **************
PokerStars Hand #169644928370: Tournament #1622537113, $9.10+$0.90 USD =
Hold'em No Limit - Level XII (300/600) - 2017/05/09 20:02:51 ET
Table '1622537113 9' 9-max Seat #2 is the button
Seat 1: Labba609 (9940 in chips)=20
Seat 2: CerPrisingLe (9690 in chips)=20
Seat 3: PureWizardry (20960 in chips)=20
Seat 4: JJin91 (19733 in chips)=20
Seat 5: bigpond12 (11768 in chips)=20
Seat 7: almeida.matt (27859 in chips)=20
Seat 8: apoch19 (4215 in chips)=20
Seat 9: thepaw98 (20000 in chips) is sitting out
Labba609: posts the ante 70
CerPrisingLe: posts the ante 70
PureWizardry: posts the ante 70
JJin91: posts the ante 70
bigpond12: posts the ante 70
almeida.matt: posts the ante 70
apoch19: posts the ante 70
thepaw98: posts the ante 70
PureWizardry: posts small blind 300
JJin91: posts big blind 600
*** HOLE CARDS ***
Dealt to JJin91 [3d 2c]
bigpond12: folds=20
almeida.matt is disconnected=20
almeida.matt is connected=20
almeida.matt: folds=20
apoch19: folds=20
thepaw98: folds=20
Labba609: folds=20
CerPrisingLe: folds=20
PureWizardry: calls 300
JJin91: checks=20
*** FLOP *** [Kh Ac Ks]
PureWizardry: checks=20
JJin91: checks=20
*** TURN *** [Kh Ac Ks] [9h]
PureWizardry: checks=20
JJin91: checks=20
*** RIVER *** [Kh Ac Ks 9h] [2s]
PureWizardry: checks=20
JJin91: bets 933
PureWizardry: calls 933
*** SHOW DOWN ***
JJin91: shows [3d 2c] (two pair, Kings and Deuces)
PureWizardry: shows [2h 5c] (two pair, Kings and Deuces)
PureWizardry collected 1813 from pot
JJin91 collected 1813 from pot
*** SUMMARY ***
Total pot 3626 | Rake 0=20
Board [Kh Ac Ks 9h 2s]
Seat 1: Labba609 folded before Flop (didn't bet)
Seat 2: CerPrisingLe (button) folded before Flop (didn't bet)
Seat 3: PureWizardry (small blind) showed [2h 5c] and won (1813) with t=
wo pair, Kings and Deuces
Seat 4: JJin91 (big blind) showed [3d 2c] and won (1813) with two pair,=
 Kings and Deuces
Seat 5: bigpond12 folded before Flop (didn't bet)
Seat 7: almeida.matt folded before Flop (didn't bet)
Seat 8: apoch19 folded before Flop (didn't bet)
Seat 9: thepaw98 folded before Flop (didn't bet)


*********** # 37 **************
PokerStars Hand #169644929187: Tournament #1622537113, $9.10+$0.90 USD =
Hold'em No Limit - Level XII (300/600) - 2017/05/09 20:04:33 ET
Table '1622537113 9' 9-max Seat #3 is the button
Seat 1: Labba609 (9870 in chips)=20
Seat 2: CerPrisingLe (9620 in chips)=20
Seat 3: PureWizardry (21170 in chips)=20
Seat 4: JJin91 (19943 in chips)=20
Seat 5: bigpond12 (11698 in chips)=20
Seat 7: almeida.matt (27789 in chips)=20
Seat 8: apoch19 (4145 in chips)=20
Seat 9: thepaw98 (19930 in chips) is sitting out
Labba609: posts the ante 70
CerPrisingLe: posts the ante 70
PureWizardry: posts the ante 70
JJin91: posts the ante 70
bigpond12: posts the ante 70
almeida.matt: posts the ante 70
apoch19: posts the ante 70
thepaw98: posts the ante 70
JJin91: posts small blind 300
bigpond12: posts big blind 600
*** HOLE CARDS ***
Dealt to JJin91 [2s Qc]
almeida.matt: folds=20
apoch19: raises 3475 to 4075 and is all-in
thepaw98: folds=20
Labba609: folds=20
CerPrisingLe: folds=20
PureWizardry: folds=20
JJin91: folds=20
bigpond12: calls 3475
*** FLOP *** [8h 9c 5s]
*** TURN *** [8h 9c 5s] [8c]
*** RIVER *** [8h 9c 5s 8c] [Ah]
*** SHOW DOWN ***
bigpond12: shows [4c 4s] (two pair, Eights and Fours)
apoch19: shows [Ts Kc] (a pair of Eights)
bigpond12 collected 9010 from pot
apoch19 finished the tournament in 65th place
*** SUMMARY ***
Total pot 9010 | Rake 0=20
Board [8h 9c 5s 8c Ah]
Seat 1: Labba609 folded before Flop (didn't bet)
Seat 2: CerPrisingLe folded before Flop (didn't bet)
Seat 3: PureWizardry (button) folded before Flop (didn't bet)
Seat 4: JJin91 (small blind) folded before Flop
Seat 5: bigpond12 (big blind) showed [4c 4s] and won (9010) with two pa=
ir, Eights and Fours
Seat 7: almeida.matt folded before Flop (didn't bet)
Seat 8: apoch19 showed [Ts Kc] and lost with a pair of Eights
Seat 9: thepaw98 folded before Flop (didn't bet)


*********** # 38 **************
PokerStars Hand #169644929420: Tournament #1622537113, $9.10+$0.90 USD =
Hold'em No Limit - Level XII (300/600) - 2017/05/09 20:05:02 ET
Table '1622537113 9' 9-max Seat #4 is the button
Seat 1: Labba609 (9800 in chips)=20
Seat 2: CerPrisingLe (9550 in chips)=20
Seat 3: PureWizardry (21100 in chips)=20
Seat 4: JJin91 (19573 in chips)=20
Seat 5: bigpond12 (16563 in chips)=20
Seat 7: almeida.matt (27719 in chips)=20
Seat 9: thepaw98 (19860 in chips) is sitting out
Labba609: posts the ante 70
CerPrisingLe: posts the ante 70
PureWizardry: posts the ante 70
JJin91: posts the ante 70
bigpond12: posts the ante 70
almeida.matt: posts the ante 70
thepaw98: posts the ante 70
bigpond12: posts small blind 300
almeida.matt: posts big blind 600
*** HOLE CARDS ***
Dealt to JJin91 [8h 9d]
thepaw98: folds=20
Labba609: folds=20
CerPrisingLe: raises 8880 to 9480 and is all-in
PureWizardry: folds=20
JJin91: folds=20
bigpond12: calls 9180
almeida.matt: folds=20
*** FLOP *** [Td 2c 8d]
*** TURN *** [Td 2c 8d] [2h]
*** RIVER *** [Td 2c 8d 2h] [7h]
*** SHOW DOWN ***
bigpond12: shows [Ac Qd] (a pair of Deuces)
CerPrisingLe: shows [Js As] (a pair of Deuces - lower kicker)
bigpond12 collected 20050 from pot
CerPrisingLe finished the tournament in 63rd place
*** SUMMARY ***
Total pot 20050 | Rake 0=20
Board [Td 2c 8d 2h 7h]
Seat 1: Labba609 folded before Flop (didn't bet)
Seat 2: CerPrisingLe showed [Js As] and lost with a pair of Deuces
Seat 3: PureWizardry folded before Flop (didn't bet)
Seat 4: JJin91 (button) folded before Flop (didn't bet)
Seat 5: bigpond12 (small blind) showed [Ac Qd] and won (20050) with a p=
air of Deuces
Seat 7: almeida.matt (big blind) folded before Flop
Seat 9: thepaw98 folded before Flop (didn't bet)


*********** # 39 **************
PokerStars Hand #169644929648: Tournament #1622537113, $9.10+$0.90 USD =
Hold'em No Limit - Level XII (300/600) - 2017/05/09 20:05:30 ET
Table '1622537113 9' 9-max Seat #5 is the button
Seat 1: Labba609 (9730 in chips)=20
Seat 3: PureWizardry (21030 in chips)=20
Seat 4: JJin91 (19503 in chips)=20
Seat 5: bigpond12 (27063 in chips)=20
Seat 6: jmaltabes (1668 in chips) out of hand (moved from another table=
 into small blind)
Seat 7: almeida.matt (27049 in chips)=20
Seat 8: JerseyRU (12615 in chips)=20
Seat 9: thepaw98 (19790 in chips) is sitting out
Labba609: posts the ante 70
PureWizardry: posts the ante 70
JJin91: posts the ante 70
bigpond12: posts the ante 70
almeida.matt: posts the ante 70
JerseyRU: posts the ante 70
thepaw98: posts the ante 70
almeida.matt: posts small blind 300
JerseyRU: posts big blind 600
*** HOLE CARDS ***
Dealt to JJin91 [6d 9s]
thepaw98: folds=20
Labba609: folds=20
PureWizardry: folds=20
JJin91: folds=20
bigpond12: folds=20
almeida.matt: calls 300
JerseyRU: raises 1200 to 1800
almeida.matt: folds=20
Uncalled bet (1200) returned to JerseyRU
JerseyRU collected 1690 from pot
JerseyRU: doesn't show hand=20
*** SUMMARY ***
Total pot 1690 | Rake 0=20
Seat 1: Labba609 folded before Flop (didn't bet)
Seat 3: PureWizardry folded before Flop (didn't bet)
Seat 4: JJin91 folded before Flop (didn't bet)
Seat 5: bigpond12 (button) folded before Flop (didn't bet)
Seat 7: almeida.matt (small blind) folded before Flop
Seat 8: JerseyRU (big blind) collected (1690)
Seat 9: thepaw98 folded before Flop (didn't bet)


*********** # 40 **************
PokerStars Hand #169644929866: Tournament #1622537113, $9.10+$0.90 USD =
Hold'em No Limit - Level XII (300/600) - 2017/05/09 20:05:58 ET
Table '1622537113 9' 9-max Seat #7 is the button
Seat 1: Labba609 (9660 in chips)=20
Seat 3: PureWizardry (20960 in chips)=20
Seat 4: JJin91 (19433 in chips)=20
Seat 5: bigpond12 (26993 in chips)=20
Seat 6: jmaltabes (1668 in chips)=20
Seat 7: almeida.matt (26379 in chips)=20
Seat 8: JerseyRU (13635 in chips)=20
Seat 9: thepaw98 (19720 in chips) is sitting out
Labba609: posts the ante 70
PureWizardry: posts the ante 70
JJin91: posts the ante 70
bigpond12: posts the ante 70
jmaltabes: posts the ante 70
almeida.matt: posts the ante 70
JerseyRU: posts the ante 70
thepaw98: posts the ante 70
JerseyRU: posts small blind 300
thepaw98: posts big blind 600
*** HOLE CARDS ***
Dealt to JJin91 [7h Td]
Labba609: folds=20
PureWizardry: folds=20
thepaw98 has returned
JJin91: folds=20
bigpond12: calls 600
jmaltabes: calls 600
almeida.matt: folds=20
JerseyRU: calls 300
thepaw98: checks=20
*** FLOP *** [6c Qh 6h]
JerseyRU: checks=20
thepaw98: checks=20
bigpond12: checks=20
jmaltabes: bets 998 and is all-in
JerseyRU: folds=20
thepaw98: calls 998
bigpond12: folds=20
*** TURN *** [6c Qh 6h] [7s]
*** RIVER *** [6c Qh 6h 7s] [Kd]
*** SHOW DOWN ***
thepaw98: shows [Qc 6d] (a full house, Sixes full of Queens)
jmaltabes: shows [9d Ts] (a pair of Sixes)
thepaw98 collected 4956 from pot
jmaltabes finished the tournament in 60th place
*** SUMMARY ***
Total pot 4956 | Rake 0=20
Board [6c Qh 6h 7s Kd]
Seat 1: Labba609 folded before Flop (didn't bet)
Seat 3: PureWizardry folded before Flop (didn't bet)
Seat 4: JJin91 folded before Flop (didn't bet)
Seat 5: bigpond12 folded on the Flop
Seat 6: jmaltabes showed [9d Ts] and lost with a pair of Sixes
Seat 7: almeida.matt (button) folded before Flop (didn't bet)
Seat 8: JerseyRU (small blind) folded on the Flop
Seat 9: thepaw98 (big blind) showed [Qc 6d] and won (4956) with a full =
house, Sixes full of Queens


*********** # 41 **************
PokerStars Hand #169645932568: Tournament #1622537113, $9.10+$0.90 USD =
Hold'em No Limit - Level XII (300/600) - 2017/05/09 20:07:01 ET
Table '1622537113 9' 9-max Seat #8 is the button
Seat 1: Labba609 (9590 in chips)=20
Seat 3: PureWizardry (20890 in chips)=20
Seat 4: JJin91 (19363 in chips)=20
Seat 5: bigpond12 (26323 in chips)=20
Seat 7: almeida.matt (26309 in chips)=20
Seat 8: JerseyRU (12965 in chips)=20
Seat 9: thepaw98 (23008 in chips)=20
Labba609: posts the ante 70
PureWizardry: posts the ante 70
JJin91: posts the ante 70
bigpond12: posts the ante 70
almeida.matt: posts the ante 70
JerseyRU: posts the ante 70
thepaw98: posts the ante 70
thepaw98: posts small blind 300
Labba609: posts big blind 600
*** HOLE CARDS ***
Dealt to JJin91 [Jc Ac]
PureWizardry: folds=20
JJin91: raises 714 to 1314
bigpond12: folds=20
almeida.matt: folds=20
JerseyRU: folds=20
thepaw98: folds=20
Labba609: folds=20
Uncalled bet (714) returned to JJin91
JJin91 collected 1990 from pot
JJin91: doesn't show hand=20
*** SUMMARY ***
Total pot 1990 | Rake 0=20
Seat 1: Labba609 (big blind) folded before Flop
Seat 3: PureWizardry folded before Flop (didn't bet)
Seat 4: JJin91 collected (1990)
Seat 5: bigpond12 folded before Flop (didn't bet)
Seat 7: almeida.matt folded before Flop (didn't bet)
Seat 8: JerseyRU (button) folded before Flop (didn't bet)
Seat 9: thepaw98 (small blind) folded before Flop


*********** # 42 **************
PokerStars Hand #169645932747: Tournament #1622537113, $9.10+$0.90 USD =
Hold'em No Limit - Level XII (300/600) - 2017/05/09 20:07:25 ET
Table '1622537113 9' 9-max Seat #9 is the button
Seat 1: Labba609 (8920 in chips)=20
Seat 2: ReservoirK@ (41393 in chips)=20
Seat 3: PureWizardry (20820 in chips)=20
Seat 4: JJin91 (20683 in chips)=20
Seat 5: bigpond12 (26253 in chips)=20
Seat 7: almeida.matt (26239 in chips)=20
Seat 8: JerseyRU (12895 in chips)=20
Seat 9: thepaw98 (22638 in chips)=20
Labba609: posts the ante 70
ReservoirK@: posts the ante 70
PureWizardry: posts the ante 70
JJin91: posts the ante 70
bigpond12: posts the ante 70
almeida.matt: posts the ante 70
JerseyRU: posts the ante 70
thepaw98: posts the ante 70
Labba609: posts small blind 300
ReservoirK@: posts big blind 600
*** HOLE CARDS ***
Dealt to JJin91 [Ts 5d]
PureWizardry: folds=20
JJin91: folds=20
bigpond12: folds=20
almeida.matt: raises 600 to 1200
JerseyRU: folds=20
thepaw98: folds=20
Labba609: folds=20
ReservoirK@: calls 600
*** FLOP *** [3c Qc Jc]
ReservoirK@: checks=20
almeida.matt: bets 2200
ReservoirK@: calls 2200
*** TURN *** [3c Qc Jc] [5h]
ReservoirK@: checks=20
almeida.matt: bets 4880
ReservoirK@: raises 4880 to 9760
almeida.matt: calls 4880
*** RIVER *** [3c Qc Jc 5h] [4c]
ReservoirK@: bets 28163 and is all-in
almeida.matt: folds [3s 3d]
Uncalled bet (28163) returned to ReservoirK@
ReservoirK@ collected 27180 from pot
ReservoirK@: doesn't show hand=20
*** SUMMARY ***
Total pot 27180 | Rake 0=20
Board [3c Qc Jc 5h 4c]
Seat 1: Labba609 (small blind) folded before Flop
Seat 2: ReservoirK@ (big blind) collected (27180)
Seat 3: PureWizardry folded before Flop (didn't bet)
Seat 4: JJin91 folded before Flop (didn't bet)
Seat 5: bigpond12 folded before Flop (didn't bet)
Seat 7: almeida.matt folded on the River
Seat 8: JerseyRU folded before Flop (didn't bet)
Seat 9: thepaw98 (button) folded before Flop (didn't bet)


*********** # 43 **************
PokerStars Hand #169645933494: Tournament #1622537113, $9.10+$0.90 USD =
Hold'em No Limit - Level XII (300/600) - 2017/05/09 20:08:59 ET
Table '1622537113 9' 9-max Seat #1 is the button
Seat 1: Labba609 (8550 in chips)=20
Seat 2: ReservoirK@ (55343 in chips)=20
Seat 3: PureWizardry (20750 in chips)=20
Seat 4: JJin91 (20613 in chips)=20
Seat 5: bigpond12 (26183 in chips)=20
Seat 7: almeida.matt (13009 in chips)=20
Seat 8: JerseyRU (12825 in chips)=20
Seat 9: thepaw98 (22568 in chips)=20
Labba609: posts the ante 70
ReservoirK@: posts the ante 70
PureWizardry: posts the ante 70
JJin91: posts the ante 70
bigpond12: posts the ante 70
almeida.matt: posts the ante 70
JerseyRU: posts the ante 70
thepaw98: posts the ante 70
ReservoirK@: posts small blind 300
PureWizardry: posts big blind 600
*** HOLE CARDS ***
Dealt to JJin91 [Jc Kd]
JJin91: folds=20
bigpond12: calls 600
almeida.matt: raises 1200 to 1800
JerseyRU: folds=20
thepaw98: calls 1800
Labba609: folds=20
ReservoirK@: folds=20
PureWizardry: folds=20
bigpond12: calls 1200
*** FLOP *** [5c Ad 5s]
bigpond12: checks=20
almeida.matt: checks=20
thepaw98: bets 1200
bigpond12: calls 1200
almeida.matt: calls 1200
*** TURN *** [5c Ad 5s] [Qs]
bigpond12: checks=20
almeida.matt: checks=20
thepaw98: checks=20
*** RIVER *** [5c Ad 5s Qs] [Th]
bigpond12: bets 10460
almeida.matt: calls 9939 and is all-in
thepaw98: raises 9038 to 19498 and is all-in
bigpond12: calls 9038
*** SHOW DOWN ***
thepaw98: shows [Jh Kh] (a straight, Ten to Ace)
bigpond12: shows [As 5d] (a full house, Fives full of Aces)
bigpond12 collected 19118 from side pot
almeida.matt: shows [Ts Td] (a full house, Tens full of Fives)
almeida.matt collected 40277 from main pot
thepaw98 finished the tournament in 56th place
*** SUMMARY ***
Total pot 59395 Main pot 40277. Side pot 19118. | Rake 0=20
Board [5c Ad 5s Qs Th]
Seat 1: Labba609 (button) folded before Flop (didn't bet)
Seat 2: ReservoirK@ (small blind) folded before Flop
Seat 3: PureWizardry (big blind) folded before Flop
Seat 4: JJin91 folded before Flop (didn't bet)
Seat 5: bigpond12 showed [As 5d] and won (19118) with a full house, Fiv=
es full of Aces
Seat 7: almeida.matt showed [Ts Td] and won (40277) with a full house, =
Tens full of Fives
Seat 8: JerseyRU folded before Flop (didn't bet)
Seat 9: thepaw98 showed [Jh Kh] and lost with a straight, Ten to Ace


*********** # 44 **************
PokerStars Hand #169645934053: Tournament #1622537113, $9.10+$0.90 USD =
Hold'em No Limit - Level XII (300/600) - 2017/05/09 20:10:10 ET
Table '1622537113 9' 9-max Seat #2 is the button
Seat 1: Labba609 (8480 in chips)=20
Seat 2: ReservoirK@ (54973 in chips)=20
Seat 3: PureWizardry (20080 in chips)=20
Seat 4: JJin91 (20543 in chips)=20
Seat 5: bigpond12 (22733 in chips)=20
Seat 7: almeida.matt (40277 in chips)=20
Seat 8: JerseyRU (12755 in chips)=20
Labba609: posts the ante 70
ReservoirK@: posts the ante 70
PureWizardry: posts the ante 70
JJin91: posts the ante 70
bigpond12: posts the ante 70
almeida.matt: posts the ante 70
JerseyRU: posts the ante 70
PureWizardry: posts small blind 300
JJin91: posts big blind 600
*** HOLE CARDS ***
Dealt to JJin91 [8c Kd]
bigpond12: folds=20
almeida.matt: folds=20
JerseyRU: folds=20
Labba609: folds=20
ReservoirK@: folds=20
PureWizardry: calls 300
JJin91: checks=20
*** FLOP *** [Ks 9c 7c]
PureWizardry: bets 879
JJin91: raises 1414 to 2293
PureWizardry: folds=20
Uncalled bet (1414) returned to JJin91
JJin91 collected 3448 from pot
JJin91: doesn't show hand=20
*** SUMMARY ***
Total pot 3448 | Rake 0=20
Board [Ks 9c 7c]
Seat 1: Labba609 folded before Flop (didn't bet)
Seat 2: ReservoirK@ (button) folded before Flop (didn't bet)
Seat 3: PureWizardry (small blind) folded on the Flop
Seat 4: JJin91 (big blind) collected (3448)
Seat 5: bigpond12 folded before Flop (didn't bet)
Seat 7: almeida.matt folded before Flop (didn't bet)
Seat 8: JerseyRU folded before Flop (didn't bet)


*********** # 45 **************
PokerStars Hand #169645934385: Tournament #1622537113, $9.10+$0.90 USD =
Hold'em No Limit - Level XII (300/600) - 2017/05/09 20:10:53 ET
Table '1622537113 9' 9-max Seat #3 is the button
Seat 1: Labba609 (8410 in chips)=20
Seat 2: ReservoirK@ (54903 in chips)=20
Seat 3: PureWizardry (18531 in chips)=20
Seat 4: JJin91 (22442 in chips)=20
Seat 5: bigpond12 (22663 in chips)=20
Seat 7: almeida.matt (40207 in chips)=20
Seat 8: JerseyRU (12685 in chips)=20
Labba609: posts the ante 70
ReservoirK@: posts the ante 70
PureWizardry: posts the ante 70
JJin91: posts the ante 70
bigpond12: posts the ante 70
almeida.matt: posts the ante 70
JerseyRU: posts the ante 70
JJin91: posts small blind 300
bigpond12: posts big blind 600
*** HOLE CARDS ***
Dealt to JJin91 [9d As]
almeida.matt: folds=20
JerseyRU: folds=20
Labba609: folds=20
ReservoirK@: folds=20
PureWizardry: folds=20
JJin91: raises 600 to 1200
bigpond12: calls 600
*** FLOP *** [Ah 3c 3s]
JJin91: checks=20
bigpond12: checks=20
*** TURN *** [Ah 3c 3s] [Ac]
JJin91: bets 896
bigpond12: raises 896 to 1792
JJin91: calls 896
*** RIVER *** [Ah 3c 3s Ac] [9c]
JJin91: checks=20
bigpond12: checks=20
*** SHOW DOWN ***
JJin91: shows [9d As] (a full house, Aces full of Nines)
bigpond12: mucks hand=20
JJin91 collected 6474 from pot
*** SUMMARY ***
Total pot 6474 | Rake 0=20
Board [Ah 3c 3s Ac 9c]
Seat 1: Labba609 folded before Flop (didn't bet)
Seat 2: ReservoirK@ folded before Flop (didn't bet)
Seat 3: PureWizardry (button) folded before Flop (didn't bet)
Seat 4: JJin91 (small blind) showed [9d As] and won (6474) with a full =
house, Aces full of Nines
Seat 5: bigpond12 (big blind) mucked [9h Kh]
Seat 7: almeida.matt folded before Flop (didn't bet)
Seat 8: JerseyRU folded before Flop (didn't bet)


*********** # 46 **************
PokerStars Hand #169645934783: Tournament #1622537113, $9.10+$0.90 USD =
Hold'em No Limit - Level XII (300/600) - 2017/05/09 20:11:42 ET
Table '1622537113 9' 9-max Seat #4 is the button
Seat 1: Labba609 (8340 in chips)=20
Seat 2: ReservoirK@ (54833 in chips)=20
Seat 3: PureWizardry (18461 in chips)=20
Seat 4: JJin91 (25854 in chips)=20
Seat 5: bigpond12 (19601 in chips)=20
Seat 7: almeida.matt (40137 in chips)=20
Seat 8: JerseyRU (12615 in chips)=20
Labba609: posts the ante 70
ReservoirK@: posts the ante 70
PureWizardry: posts the ante 70
JJin91: posts the ante 70
bigpond12: posts the ante 70
almeida.matt: posts the ante 70
JerseyRU: posts the ante 70
bigpond12: posts small blind 300
almeida.matt: posts big blind 600
*** HOLE CARDS ***
Dealt to JJin91 [4s 7d]
JerseyRU: folds=20
Labba609: folds=20
ReservoirK@: calls 600
PureWizardry: folds=20
JJin91: folds=20
bigpond12: calls 300
almeida.matt: raises 1600 to 2200
ReservoirK@: folds=20
bigpond12: calls 1600
*** FLOP *** [5c 7h 6d]
bigpond12: checks=20
almeida.matt: bets 2660
bigpond12: calls 2660
*** TURN *** [5c 7h 6d] [5d]
bigpond12: checks=20
almeida.matt: bets 3300
bigpond12: calls 3300
*** RIVER *** [5c 7h 6d 5d] [8c]
bigpond12: bets 11371 and is all-in
almeida.matt: calls 11371
*** SHOW DOWN ***
bigpond12: shows [2c 4c] (a straight, Four to Eight)
almeida.matt: shows [Qs Qc] (two pair, Queens and Fives)
bigpond12 collected 40152 from pot
*** SUMMARY ***
Total pot 40152 | Rake 0=20
Board [5c 7h 6d 5d 8c]
Seat 1: Labba609 folded before Flop (didn't bet)
Seat 2: ReservoirK@ folded before Flop
Seat 3: PureWizardry folded before Flop (didn't bet)
Seat 4: JJin91 (button) folded before Flop (didn't bet)
Seat 5: bigpond12 (small blind) showed [2c 4c] and won (40152) with a s=
traight, Four to Eight
Seat 7: almeida.matt (big blind) showed [Qs Qc] and lost with two pair,=
 Queens and Fives
Seat 8: JerseyRU folded before Flop (didn't bet)


*********** # 47 **************
PokerStars Hand #169645935574: Tournament #1622537113, $9.10+$0.90 USD =
Hold'em No Limit - Level XIII (350/700) - 2017/05/09 20:13:33 ET
Table '1622537113 9' 9-max Seat #5 is the button
Seat 1: Labba609 (8270 in chips)=20
Seat 2: ReservoirK@ (54163 in chips)=20
Seat 3: PureWizardry (18391 in chips)=20
Seat 4: JJin91 (25784 in chips)=20
Seat 5: bigpond12 (40152 in chips)=20
Seat 7: almeida.matt (20536 in chips)=20
Seat 8: JerseyRU (12545 in chips)=20
Seat 9: AmTheCaptain (36378 in chips)=20
Labba609: posts the ante 85
ReservoirK@: posts the ante 85
PureWizardry: posts the ante 85
JJin91: posts the ante 85
bigpond12: posts the ante 85
almeida.matt: posts the ante 85
JerseyRU: posts the ante 85
AmTheCaptain: posts the ante 85
almeida.matt: posts small blind 350
JerseyRU: posts big blind 700
*** HOLE CARDS ***
Dealt to JJin91 [5s Qd]
AmTheCaptain: folds=20
almeida.matt said, "LOL"
Labba609: folds=20
ReservoirK@: raises 1379 to 2079
PureWizardry: folds=20
JJin91: folds=20
bigpond12: folds=20
almeida.matt: folds=20
JerseyRU: folds=20
Uncalled bet (1379) returned to ReservoirK@
ReservoirK@ collected 2430 from pot
ReservoirK@: doesn't show hand=20
*** SUMMARY ***
Total pot 2430 | Rake 0=20
Seat 1: Labba609 folded before Flop (didn't bet)
Seat 2: ReservoirK@ collected (2430)
Seat 3: PureWizardry folded before Flop (didn't bet)
Seat 4: JJin91 folded before Flop (didn't bet)
Seat 5: bigpond12 (button) folded before Flop (didn't bet)
Seat 7: almeida.matt (small blind) folded before Flop
Seat 8: JerseyRU (big blind) folded before Flop
Seat 9: AmTheCaptain folded before Flop (didn't bet)


*********** # 48 **************
PokerStars Hand #169645935898: Tournament #1622537113, $9.10+$0.90 USD =
Hold'em No Limit - Level XIII (350/700) - 2017/05/09 20:14:17 ET
Table '1622537113 9' 9-max Seat #7 is the button
Seat 1: Labba609 (8185 in chips)=20
Seat 2: ReservoirK@ (55808 in chips)=20
Seat 3: PureWizardry (18306 in chips)=20
Seat 4: JJin91 (25699 in chips)=20
Seat 5: bigpond12 (40067 in chips)=20
Seat 7: almeida.matt (20101 in chips)=20
Seat 8: JerseyRU (11760 in chips)=20
Seat 9: AmTheCaptain (36293 in chips)=20
Labba609: posts the ante 85
ReservoirK@: posts the ante 85
PureWizardry: posts the ante 85
JJin91: posts the ante 85
bigpond12: posts the ante 85
almeida.matt: posts the ante 85
JerseyRU: posts the ante 85
AmTheCaptain: posts the ante 85
JerseyRU: posts small blind 350
AmTheCaptain: posts big blind 700
*** HOLE CARDS ***
Dealt to JJin91 [Js 7h]
Labba609: folds=20
ReservoirK@: raises 1024 to 1724
PureWizardry: folds=20
JJin91: folds=20
bigpond12: folds=20
almeida.matt: folds=20
JerseyRU: folds=20
AmTheCaptain: calls 1024
*** FLOP *** [Kh Ac 5h]
AmTheCaptain: checks=20
ReservoirK@: bets 2202
AmTheCaptain: calls 2202
*** TURN *** [Kh Ac 5h] [5c]
AmTheCaptain: checks=20
ReservoirK@: checks=20
*** RIVER *** [Kh Ac 5h 5c] [Jd]
AmTheCaptain: checks=20
ReservoirK@: checks=20
*** SHOW DOWN ***
AmTheCaptain: shows [9h Ah] (two pair, Aces and Fives)
ReservoirK@: shows [Ts As] (two pair, Aces and Fives)
AmTheCaptain collected 4441 from pot
ReservoirK@ collected 4441 from pot
*** SUMMARY ***
Total pot 8882 | Rake 0=20
Board [Kh Ac 5h 5c Jd]
Seat 1: Labba609 folded before Flop (didn't bet)
Seat 2: ReservoirK@ showed [Ts As] and won (4441) with two pair, Aces a=
nd Fives
Seat 3: PureWizardry folded before Flop (didn't bet)
Seat 4: JJin91 folded before Flop (didn't bet)
Seat 5: bigpond12 folded before Flop (didn't bet)
Seat 7: almeida.matt (button) folded before Flop (didn't bet)
Seat 8: JerseyRU (small blind) folded before Flop
Seat 9: AmTheCaptain (big blind) showed [9h Ah] and won (4441) with two=
 pair, Aces and Fives


*********** # 49 **************
PokerStars Hand #169645936467: Tournament #1622537113, $9.10+$0.90 USD =
Hold'em No Limit - Level XIII (350/700) - 2017/05/09 20:15:37 ET
Table '1622537113 9' 9-max Seat #8 is the button
Seat 1: Labba609 (8100 in chips)=20
Seat 2: ReservoirK@ (56238 in chips)=20
Seat 3: PureWizardry (18221 in chips)=20
Seat 4: JJin91 (25614 in chips)=20
Seat 5: bigpond12 (39982 in chips)=20
Seat 7: almeida.matt (20016 in chips)=20
Seat 8: JerseyRU (11325 in chips)=20
Seat 9: AmTheCaptain (36723 in chips)=20
Labba609: posts the ante 85
ReservoirK@: posts the ante 85
PureWizardry: posts the ante 85
JJin91: posts the ante 85
bigpond12: posts the ante 85
almeida.matt: posts the ante 85
JerseyRU: posts the ante 85
AmTheCaptain: posts the ante 85
AmTheCaptain: posts small blind 350
Labba609: posts big blind 700
*** HOLE CARDS ***
Dealt to JJin91 [6s 4c]
ReservoirK@: calls 700
PureWizardry: folds=20
JJin91: folds=20
ReservoirK@ said, "nh champ"
bigpond12: raises 1400 to 2100
almeida.matt: calls 2100
JerseyRU: folds=20
AmTheCaptain: folds=20
AmTheCaptain said, "ty u2"
Labba609: folds=20
ReservoirK@: calls 1400
*** FLOP *** [Ts 2d 7h]
ReservoirK@: checks=20
bigpond12: bets 3500
almeida.matt: folds=20
ReservoirK@: folds=20
Uncalled bet (3500) returned to bigpond12
bigpond12 collected 8030 from pot
bigpond12: doesn't show hand=20
*** SUMMARY ***
Total pot 8030 | Rake 0=20
Board [Ts 2d 7h]
Seat 1: Labba609 (big blind) folded before Flop
Seat 2: ReservoirK@ folded on the Flop
Seat 3: PureWizardry folded before Flop (didn't bet)
Seat 4: JJin91 folded before Flop (didn't bet)
Seat 5: bigpond12 collected (8030)
Seat 7: almeida.matt folded on the Flop
Seat 8: JerseyRU (button) folded before Flop (didn't bet)
Seat 9: AmTheCaptain (small blind) folded before Flop


*********** # 50 **************
PokerStars Hand #169645936888: Tournament #1622537113, $9.10+$0.90 USD =
Hold'em No Limit - Level XIII (350/700) - 2017/05/09 20:16:33 ET
Table '1622537113 9' 9-max Seat #9 is the button
Seat 1: Labba609 (7315 in chips)=20
Seat 2: ReservoirK@ (54053 in chips)=20
Seat 3: PureWizardry (18136 in chips)=20
Seat 4: JJin91 (25529 in chips)=20
Seat 5: bigpond12 (45827 in chips)=20
Seat 7: almeida.matt (17831 in chips)=20
Seat 8: JerseyRU (11240 in chips)=20
Seat 9: AmTheCaptain (36288 in chips)=20
Labba609: posts the ante 85
ReservoirK@: posts the ante 85
PureWizardry: posts the ante 85
JJin91: posts the ante 85
bigpond12: posts the ante 85
almeida.matt: posts the ante 85
JerseyRU: posts the ante 85
AmTheCaptain: posts the ante 85
Labba609: posts small blind 350
ReservoirK@: posts big blind 700
*** HOLE CARDS ***
Dealt to JJin91 [6c 5h]
PureWizardry: folds=20
JJin91: folds=20
bigpond12: calls 700
almeida.matt: folds=20
JerseyRU: folds=20
AmTheCaptain: raises 2800 to 3500
Labba609: folds=20
ReservoirK@: folds=20
bigpond12: calls 2800
*** FLOP *** [3h 4c Qd]
bigpond12: checks=20
AmTheCaptain: bets 5600
bigpond12: folds=20
Uncalled bet (5600) returned to AmTheCaptain
AmTheCaptain collected 8730 from pot
*** SUMMARY ***
Total pot 8730 | Rake 0=20
Board [3h 4c Qd]
Seat 1: Labba609 (small blind) folded before Flop
Seat 2: ReservoirK@ (big blind) folded before Flop
Seat 3: PureWizardry folded before Flop (didn't bet)
Seat 4: JJin91 folded before Flop (didn't bet)
Seat 5: bigpond12 folded on the Flop
Seat 7: almeida.matt folded before Flop (didn't bet)
Seat 8: JerseyRU folded before Flop (didn't bet)
Seat 9: AmTheCaptain (button) collected (8730)


*********** # 51 **************
PokerStars Hand #169645937205: Tournament #1622537113, $9.10+$0.90 USD =
Hold'em No Limit - Level XIII (350/700) - 2017/05/09 20:17:16 ET
Table '1622537113 9' 9-max Seat #1 is the button
Seat 1: Labba609 (6880 in chips)=20
Seat 2: ReservoirK@ (53268 in chips)=20
Seat 3: PureWizardry (18051 in chips)=20
Seat 4: JJin91 (25444 in chips)=20
Seat 5: bigpond12 (42242 in chips)=20
Seat 7: almeida.matt (17746 in chips)=20
Seat 8: JerseyRU (11155 in chips)=20
Seat 9: AmTheCaptain (41433 in chips)=20
Labba609: posts the ante 85
ReservoirK@: posts the ante 85
PureWizardry: posts the ante 85
JJin91: posts the ante 85
bigpond12: posts the ante 85
almeida.matt: posts the ante 85
JerseyRU: posts the ante 85
AmTheCaptain: posts the ante 85
ReservoirK@: posts small blind 350
PureWizardry: posts big blind 700
*** HOLE CARDS ***
Dealt to JJin91 [5s 6d]
JJin91: folds=20
bigpond12: folds=20
almeida.matt: folds=20
JerseyRU: folds=20
AmTheCaptain: folds=20
Labba609: folds=20
ReservoirK@: calls 350
PureWizardry: raises 1750 to 2450
ReservoirK@: folds=20
Uncalled bet (1750) returned to PureWizardry
PureWizardry collected 2080 from pot
PureWizardry: doesn't show hand=20
*** SUMMARY ***
Total pot 2080 | Rake 0=20
Seat 1: Labba609 (button) folded before Flop (didn't bet)
Seat 2: ReservoirK@ (small blind) folded before Flop
Seat 3: PureWizardry (big blind) collected (2080)
Seat 4: JJin91 folded before Flop (didn't bet)
Seat 5: bigpond12 folded before Flop (didn't bet)
Seat 7: almeida.matt folded before Flop (didn't bet)
Seat 8: JerseyRU folded before Flop (didn't bet)
Seat 9: AmTheCaptain folded before Flop (didn't bet)


*********** # 52 **************
PokerStars Hand #169645937376: Tournament #1622537113, $9.10+$0.90 USD =
Hold'em No Limit - Level XIII (350/700) - 2017/05/09 20:17:40 ET
Table '1622537113 9' 9-max Seat #2 is the button
Seat 1: Labba609 (6795 in chips)=20
Seat 2: ReservoirK@ (52483 in chips)=20
Seat 3: PureWizardry (19346 in chips)=20
Seat 4: JJin91 (25359 in chips)=20
Seat 5: bigpond12 (42157 in chips)=20
Seat 7: almeida.matt (17661 in chips)=20
Seat 8: JerseyRU (11070 in chips)=20
Seat 9: AmTheCaptain (41348 in chips)=20
Labba609: posts the ante 85
ReservoirK@: posts the ante 85
PureWizardry: posts the ante 85
JJin91: posts the ante 85
bigpond12: posts the ante 85
almeida.matt: posts the ante 85
JerseyRU: posts the ante 85
AmTheCaptain: posts the ante 85
PureWizardry: posts small blind 350
JJin91: posts big blind 700
*** HOLE CARDS ***
Dealt to JJin91 [Kd 3c]
bigpond12: calls 700
almeida.matt: folds=20
JerseyRU: folds=20
AmTheCaptain: folds=20
Labba609: folds=20
ReservoirK@: calls 700
PureWizardry: calls 350
JJin91: checks=20
*** FLOP *** [Jc Kh 8d]
PureWizardry: checks=20
JJin91: checks=20
bigpond12: checks=20
ReservoirK@: bets 1699
PureWizardry: folds=20
JJin91: calls 1699
bigpond12: folds=20
*** TURN *** [Jc Kh 8d] [9c]
JJin91: checks=20
ReservoirK@: checks=20
*** RIVER *** [Jc Kh 8d 9c] [5d]
JJin91: checks=20
ReservoirK@: checks=20
*** SHOW DOWN ***
JJin91: shows [Kd 3c] (a pair of Kings)
ReservoirK@: mucks hand=20
JJin91 collected 6878 from pot
*** SUMMARY ***
Total pot 6878 | Rake 0=20
Board [Jc Kh 8d 9c 5d]
Seat 1: Labba609 folded before Flop (didn't bet)
Seat 2: ReservoirK@ (button) mucked [Ah 8s]
Seat 3: PureWizardry (small blind) folded on the Flop
Seat 4: JJin91 (big blind) showed [Kd 3c] and won (6878) with a pair of=
 Kings
Seat 5: bigpond12 folded on the Flop
Seat 7: almeida.matt folded before Flop (didn't bet)
Seat 8: JerseyRU folded before Flop (didn't bet)
Seat 9: AmTheCaptain folded before Flop (didn't bet)


*********** # 53 **************
PokerStars Hand #169645937799: Tournament #1622537113, $9.10+$0.90 USD =
Hold'em No Limit - Level XIII (350/700) - 2017/05/09 20:18:37 ET
Table '1622537113 9' 9-max Seat #3 is the button
Seat 1: Labba609 (6710 in chips)=20
Seat 2: ReservoirK@ (49999 in chips)=20
Seat 3: PureWizardry (18561 in chips)=20
Seat 4: JJin91 (29753 in chips)=20
Seat 5: bigpond12 (41372 in chips)=20
Seat 7: almeida.matt (17576 in chips)=20
Seat 8: JerseyRU (10985 in chips)=20
Seat 9: AmTheCaptain (41263 in chips)=20
Labba609: posts the ante 85
ReservoirK@: posts the ante 85
PureWizardry: posts the ante 85
JJin91: posts the ante 85
bigpond12: posts the ante 85
almeida.matt: posts the ante 85
JerseyRU: posts the ante 85
AmTheCaptain: posts the ante 85
JJin91: posts small blind 350
bigpond12: posts big blind 700
*** HOLE CARDS ***
Dealt to JJin91 [5c Qh]
almeida.matt: raises 785 to 1485
JerseyRU: folds=20
AmTheCaptain: folds=20
Labba609: folds=20
ReservoirK@: folds=20
PureWizardry: folds=20
JJin91: folds=20
bigpond12: raises 2715 to 4200
almeida.matt: calls 2715
*** FLOP *** [9d 8c 3c]
bigpond12: bets 9430
almeida.matt: folds=20
Uncalled bet (9430) returned to bigpond12
bigpond12 collected 9430 from pot
bigpond12: doesn't show hand=20
*** SUMMARY ***
Total pot 9430 | Rake 0=20
Board [9d 8c 3c]
Seat 1: Labba609 folded before Flop (didn't bet)
Seat 2: ReservoirK@ folded before Flop (didn't bet)
Seat 3: PureWizardry (button) folded before Flop (didn't bet)
Seat 4: JJin91 (small blind) folded before Flop
Seat 5: bigpond12 (big blind) collected (9430)
Seat 7: almeida.matt folded on the Flop
Seat 8: JerseyRU folded before Flop (didn't bet)
Seat 9: AmTheCaptain folded before Flop (didn't bet)


*********** # 54 **************
PokerStars Hand #169645938286: Tournament #1622537113, $9.10+$0.90 USD =
Hold'em No Limit - Level XIII (350/700) - 2017/05/09 20:19:39 ET
Table '1622537113 9' 9-max Seat #4 is the button
Seat 1: Labba609 (6625 in chips)=20
Seat 2: ReservoirK@ (49914 in chips)=20
Seat 3: PureWizardry (18476 in chips)=20
Seat 4: JJin91 (29318 in chips)=20
Seat 5: bigpond12 (46517 in chips)=20
Seat 7: almeida.matt (13291 in chips)=20
Seat 8: JerseyRU (10900 in chips)=20
Seat 9: AmTheCaptain (41178 in chips)=20
Labba609: posts the ante 85
ReservoirK@: posts the ante 85
PureWizardry: posts the ante 85
JJin91: posts the ante 85
bigpond12: posts the ante 85
almeida.matt: posts the ante 85
JerseyRU: posts the ante 85
AmTheCaptain: posts the ante 85
bigpond12: posts small blind 350
almeida.matt: posts big blind 700
*** HOLE CARDS ***
Dealt to JJin91 [3s 4d]
JerseyRU: folds=20
AmTheCaptain: folds=20
Labba609: folds=20
ReservoirK@: calls 700
PureWizardry: folds=20
JJin91: folds=20
bigpond12: folds=20
almeida.matt: raises 12506 to 13206 and is all-in
ReservoirK@: folds=20
Uncalled bet (12506) returned to almeida.matt
almeida.matt collected 2430 from pot
*** SUMMARY ***
Total pot 2430 | Rake 0=20
Seat 1: Labba609 folded before Flop (didn't bet)
Seat 2: ReservoirK@ folded before Flop
Seat 3: PureWizardry folded before Flop (didn't bet)
Seat 4: JJin91 (button) folded before Flop (didn't bet)
Seat 5: bigpond12 (small blind) folded before Flop
Seat 7: almeida.matt (big blind) collected (2430)
Seat 8: JerseyRU folded before Flop (didn't bet)
Seat 9: AmTheCaptain folded before Flop (didn't bet)


*********** # 55 **************
PokerStars Hand #169645938611: Tournament #1622537113, $9.10+$0.90 USD =
Hold'em No Limit - Level XIII (350/700) - 2017/05/09 20:20:23 ET
Table '1622537113 9' 9-max Seat #5 is the button
Seat 1: Labba609 (6540 in chips)=20
Seat 2: ReservoirK@ (49129 in chips)=20
Seat 3: PureWizardry (18391 in chips)=20
Seat 4: JJin91 (29233 in chips)=20
Seat 5: bigpond12 (46082 in chips)=20
Seat 7: almeida.matt (14936 in chips)=20
Seat 8: JerseyRU (10815 in chips)=20
Seat 9: AmTheCaptain (41093 in chips)=20
Labba609: posts the ante 85
ReservoirK@: posts the ante 85
PureWizardry: posts the ante 85
JJin91: posts the ante 85
bigpond12: posts the ante 85
almeida.matt: posts the ante 85
JerseyRU: posts the ante 85
AmTheCaptain: posts the ante 85
almeida.matt: posts small blind 350
JerseyRU: posts big blind 700
*** HOLE CARDS ***
Dealt to JJin91 [8s Jd]
AmTheCaptain: folds=20
Labba609: folds=20
ReservoirK@: folds=20
PureWizardry: raises 840 to 1540
JJin91: folds=20
bigpond12: calls 1540
almeida.matt: folds=20
JerseyRU: folds=20
*** FLOP *** [Js Kh 7c]
PureWizardry: checks=20
bigpond12: bets 2405
PureWizardry: folds=20
Uncalled bet (2405) returned to bigpond12
bigpond12 collected 4810 from pot
bigpond12: doesn't show hand=20
*** SUMMARY ***
Total pot 4810 | Rake 0=20
Board [Js Kh 7c]
Seat 1: Labba609 folded before Flop (didn't bet)
Seat 2: ReservoirK@ folded before Flop (didn't bet)
Seat 3: PureWizardry folded on the Flop
Seat 4: JJin91 folded before Flop (didn't bet)
Seat 5: bigpond12 (button) collected (4810)
Seat 7: almeida.matt (small blind) folded before Flop
Seat 8: JerseyRU (big blind) folded before Flop
Seat 9: AmTheCaptain folded before Flop (didn't bet)


*********** # 56 **************
PokerStars Hand #169645939021: Tournament #1622537113, $9.10+$0.90 USD =
Hold'em No Limit - Level XIII (350/700) - 2017/05/09 20:21:14 ET
Table '1622537113 9' 9-max Seat #7 is the button
Seat 1: Labba609 (6455 in chips)=20
Seat 2: ReservoirK@ (49044 in chips)=20
Seat 3: PureWizardry (16766 in chips)=20
Seat 4: JJin91 (29148 in chips)=20
Seat 5: bigpond12 (49267 in chips)=20
Seat 7: almeida.matt (14501 in chips)=20
Seat 8: JerseyRU (10030 in chips)=20
Seat 9: AmTheCaptain (41008 in chips)=20
Labba609: posts the ante 85
ReservoirK@: posts the ante 85
PureWizardry: posts the ante 85
JJin91: posts the ante 85
bigpond12: posts the ante 85
almeida.matt: posts the ante 85
JerseyRU: posts the ante 85
AmTheCaptain: posts the ante 85
JerseyRU: posts small blind 350
AmTheCaptain: posts big blind 700
*** HOLE CARDS ***
Dealt to JJin91 [4h 2d]
Labba609: folds=20
ReservoirK@: folds=20
PureWizardry: raises 840 to 1540
JJin91: folds=20
bigpond12: calls 1540
almeida.matt: folds=20
JerseyRU: folds=20
AmTheCaptain: calls 840
*** FLOP *** [Qs Jc Kh]
AmTheCaptain: checks=20
PureWizardry: checks=20
bigpond12: checks=20
*** TURN *** [Qs Jc Kh] [5c]
AmTheCaptain: checks=20
PureWizardry: checks=20
bigpond12: bets 2800
AmTheCaptain: folds=20
PureWizardry: folds=20
Uncalled bet (2800) returned to bigpond12
bigpond12 collected 5650 from pot
bigpond12: doesn't show hand=20
*** SUMMARY ***
Total pot 5650 | Rake 0=20
Board [Qs Jc Kh 5c]
Seat 1: Labba609 folded before Flop (didn't bet)
Seat 2: ReservoirK@ folded before Flop (didn't bet)
Seat 3: PureWizardry folded on the Turn
Seat 4: JJin91 folded before Flop (didn't bet)
Seat 5: bigpond12 collected (5650)
Seat 7: almeida.matt (button) folded before Flop (didn't bet)
Seat 8: JerseyRU (small blind) folded before Flop
Seat 9: AmTheCaptain (big blind) folded on the Turn


*********** # 57 **************
PokerStars Hand #169645939720: Tournament #1622537113, $9.10+$0.90 USD =
Hold'em No Limit - Level XIV (400/800) - 2017/05/09 20:22:50 ET
Table '1622537113 9' 9-max Seat #8 is the button
Seat 1: Labba609 (6370 in chips)=20
Seat 2: ReservoirK@ (48959 in chips)=20
Seat 3: PureWizardry (15141 in chips)=20
Seat 4: JJin91 (29063 in chips)=20
Seat 5: bigpond12 (53292 in chips)=20
Seat 6: D.Drumpf (18340 in chips)=20
Seat 7: almeida.matt (14416 in chips)=20
Seat 8: JerseyRU (9595 in chips)=20
Seat 9: AmTheCaptain (39383 in chips)=20
Labba609: posts the ante 100
ReservoirK@: posts the ante 100
PureWizardry: posts the ante 100
JJin91: posts the ante 100
bigpond12: posts the ante 100
D.Drumpf: posts the ante 100
almeida.matt: posts the ante 100
JerseyRU: posts the ante 100
AmTheCaptain: posts the ante 100
AmTheCaptain: posts small blind 400
Labba609: posts big blind 800
*** HOLE CARDS ***
Dealt to JJin91 [2d 8c]
ReservoirK@: folds=20
PureWizardry: folds=20
JJin91: folds=20
bigpond12: folds=20
D.Drumpf: folds=20
almeida.matt: folds=20
JerseyRU: folds=20
AmTheCaptain: calls 400
Labba609: raises 5470 to 6270 and is all-in
AmTheCaptain: folds=20
Uncalled bet (5470) returned to Labba609
Labba609 collected 2500 from pot
Labba609: doesn't show hand=20
*** SUMMARY ***
Total pot 2500 | Rake 0=20
Seat 1: Labba609 (big blind) collected (2500)
Seat 2: ReservoirK@ folded before Flop (didn't bet)
Seat 3: PureWizardry folded before Flop (didn't bet)
Seat 4: JJin91 folded before Flop (didn't bet)
Seat 5: bigpond12 folded before Flop (didn't bet)
Seat 6: D.Drumpf folded before Flop (didn't bet)
Seat 7: almeida.matt folded before Flop (didn't bet)
Seat 8: JerseyRU (button) folded before Flop (didn't bet)
Seat 9: AmTheCaptain (small blind) folded before Flop


*********** # 58 **************
PokerStars Hand #169647828640: Tournament #1622537113, $9.10+$0.90 USD =
Hold'em No Limit - Level XIV (400/800) - 2017/05/09 20:23:49 ET
Table '1622537113 9' 9-max Seat #9 is the button
Seat 1: Labba609 (7970 in chips)=20
Seat 2: ReservoirK@ (48859 in chips)=20
Seat 3: PureWizardry (15041 in chips)=20
Seat 4: JJin91 (28963 in chips)=20
Seat 5: bigpond12 (53192 in chips)=20
Seat 6: D.Drumpf (18240 in chips)=20
Seat 7: almeida.matt (14316 in chips)=20
Seat 8: JerseyRU (9495 in chips)=20
Seat 9: AmTheCaptain (38483 in chips)=20
Labba609: posts the ante 100
ReservoirK@: posts the ante 100
PureWizardry: posts the ante 100
JJin91: posts the ante 100
bigpond12: posts the ante 100
D.Drumpf: posts the ante 100
almeida.matt: posts the ante 100
JerseyRU: posts the ante 100
AmTheCaptain: posts the ante 100
Labba609: posts small blind 400
ReservoirK@: posts big blind 800
*** HOLE CARDS ***
Dealt to JJin91 [2s Qc]
PureWizardry: folds=20
JJin91: folds=20
bigpond12: calls 800
D.Drumpf: folds=20
almeida.matt: folds=20
JerseyRU: folds=20
AmTheCaptain: calls 800
Labba609: folds=20
ReservoirK@: checks=20
*** FLOP *** [Qh 9s Tc]
ReservoirK@: checks=20
bigpond12: bets 1850
AmTheCaptain: calls 1850
ReservoirK@: folds=20
*** TURN *** [Qh 9s Tc] [4h]
bigpond12: bets 2400
AmTheCaptain: calls 2400
*** RIVER *** [Qh 9s Tc 4h] [5s]
bigpond12: checks=20
AmTheCaptain: checks=20
*** SHOW DOWN ***
bigpond12: shows [8s Td] (a pair of Tens)
AmTheCaptain: shows [Th As] (a pair of Tens - Ace kicker)
AmTheCaptain collected 12200 from pot
*** SUMMARY ***
Total pot 12200 | Rake 0=20
Board [Qh 9s Tc 4h 5s]
Seat 1: Labba609 (small blind) folded before Flop
Seat 2: ReservoirK@ (big blind) folded on the Flop
Seat 3: PureWizardry folded before Flop (didn't bet)
Seat 4: JJin91 folded before Flop (didn't bet)
Seat 5: bigpond12 showed [8s Td] and lost with a pair of Tens
Seat 6: D.Drumpf folded before Flop (didn't bet)
Seat 7: almeida.matt folded before Flop (didn't bet)
Seat 8: JerseyRU folded before Flop (didn't bet)
Seat 9: AmTheCaptain (button) showed [Th As] and won (12200) with a pai=
r of Tens


*********** # 59 **************
PokerStars Hand #169647829315: Tournament #1622537113, $9.10+$0.90 USD =
Hold'em No Limit - Level XIV (400/800) - 2017/05/09 20:25:23 ET
Table '1622537113 9' 9-max Seat #1 is the button
Seat 1: Labba609 (7470 in chips)=20
Seat 2: ReservoirK@ (47959 in chips)=20
Seat 3: PureWizardry (14941 in chips)=20
Seat 4: JJin91 (28863 in chips)=20
Seat 5: bigpond12 (48042 in chips)=20
Seat 6: D.Drumpf (18140 in chips)=20
Seat 7: almeida.matt (14216 in chips)=20
Seat 8: JerseyRU (9395 in chips)=20
Seat 9: AmTheCaptain (45533 in chips)=20
Labba609: posts the ante 100
ReservoirK@: posts the ante 100
PureWizardry: posts the ante 100
JJin91: posts the ante 100
bigpond12: posts the ante 100
D.Drumpf: posts the ante 100
almeida.matt: posts the ante 100
JerseyRU: posts the ante 100
AmTheCaptain: posts the ante 100
ReservoirK@: posts small blind 400
PureWizardry: posts big blind 800
*** HOLE CARDS ***
Dealt to JJin91 [4c 9h]
JJin91: folds=20
bigpond12: folds=20
D.Drumpf: folds=20
almeida.matt: raises 800 to 1600
JerseyRU: folds=20
AmTheCaptain: folds=20
Labba609: folds=20
ReservoirK@: folds=20
PureWizardry: calls 800
*** FLOP *** [Js Jd Jh]
PureWizardry: checks=20
almeida.matt: bets 2400
PureWizardry: folds=20
Uncalled bet (2400) returned to almeida.matt
almeida.matt collected 4500 from pot
*** SUMMARY ***
Total pot 4500 | Rake 0=20
Board [Js Jd Jh]
Seat 1: Labba609 (button) folded before Flop (didn't bet)
Seat 2: ReservoirK@ (small blind) folded before Flop
Seat 3: PureWizardry (big blind) folded on the Flop
Seat 4: JJin91 folded before Flop (didn't bet)
Seat 5: bigpond12 folded before Flop (didn't bet)
Seat 6: D.Drumpf folded before Flop (didn't bet)
Seat 7: almeida.matt collected (4500)
Seat 8: JerseyRU folded before Flop (didn't bet)
Seat 9: AmTheCaptain folded before Flop (didn't bet)


*********** # 60 **************
PokerStars Hand #169647829872: Tournament #1622537113, $9.10+$0.90 USD =
Hold'em No Limit - Level XIV (400/800) - 2017/05/09 20:26:40 ET
Table '1622537113 9' 9-max Seat #2 is the button
Seat 1: Labba609 (7370 in chips)=20
Seat 2: ReservoirK@ (47459 in chips)=20
Seat 3: PureWizardry (13241 in chips)=20
Seat 4: JJin91 (28763 in chips)=20
Seat 5: bigpond12 (47942 in chips)=20
Seat 6: D.Drumpf (18040 in chips)=20
Seat 7: almeida.matt (17016 in chips)=20
Seat 8: JerseyRU (9295 in chips)=20
Seat 9: AmTheCaptain (45433 in chips)=20
Labba609: posts the ante 100
ReservoirK@: posts the ante 100
PureWizardry: posts the ante 100
JJin91: posts the ante 100
bigpond12: posts the ante 100
D.Drumpf: posts the ante 100
almeida.matt: posts the ante 100
JerseyRU: posts the ante 100
AmTheCaptain: posts the ante 100
PureWizardry: posts small blind 400
JJin91: posts big blind 800
*** HOLE CARDS ***
Dealt to JJin91 [2s Kc]
bigpond12: calls 800
D.Drumpf: raises 1600 to 2400
almeida.matt: folds=20
JerseyRU: folds=20
AmTheCaptain: folds=20
Labba609: folds=20
ReservoirK@: folds=20
PureWizardry: folds=20
JJin91: folds=20
bigpond12: calls 1600
*** FLOP *** [9h Ks 8c]
bigpond12: checks=20
D.Drumpf: bets 3050
bigpond12: calls 3050
*** TURN *** [9h Ks 8c] [Th]
bigpond12: checks=20
D.Drumpf: checks=20
*** RIVER *** [9h Ks 8c Th] [Jc]
bigpond12: checks=20
D.Drumpf: bets 5600
bigpond12: calls 5600
*** SHOW DOWN ***
D.Drumpf: shows [Kd Jd] (two pair, Kings and Jacks)
bigpond12: shows [Js Kh] (two pair, Kings and Jacks)
bigpond12 collected 12100 from pot
D.Drumpf collected 12100 from pot
*** SUMMARY ***
Total pot 24200 | Rake 0=20
Board [9h Ks 8c Th Jc]
Seat 1: Labba609 folded before Flop (didn't bet)
Seat 2: ReservoirK@ (button) folded before Flop (didn't bet)
Seat 3: PureWizardry (small blind) folded before Flop
Seat 4: JJin91 (big blind) folded before Flop
Seat 5: bigpond12 showed [Js Kh] and won (12100) with two pair, Kings a=
nd Jacks
Seat 6: D.Drumpf showed [Kd Jd] and won (12100) with two pair, Kings an=
d Jacks
Seat 7: almeida.matt folded before Flop (didn't bet)
Seat 8: JerseyRU folded before Flop (didn't bet)
Seat 9: AmTheCaptain folded before Flop (didn't bet)


*********** # 61 **************
PokerStars Hand #169648261635: Tournament #1622537113, $9.10+$0.90 USD =
Hold'em No Limit - Level XIV (400/800) - 2017/05/09 20:28:33 ET
Table '1622537113 9' 9-max Seat #3 is the button
Seat 1: Labba609 (7270 in chips)=20
Seat 2: ReservoirK@ (47359 in chips)=20
Seat 3: PureWizardry (12741 in chips)=20
Seat 4: JJin91 (27863 in chips)=20
Seat 5: bigpond12 (48892 in chips)=20
Seat 6: D.Drumpf (18990 in chips)=20
Seat 7: almeida.matt (16916 in chips)=20
Seat 9: AmTheCaptain (45333 in chips)=20
Labba609: posts the ante 100
ReservoirK@: posts the ante 100
PureWizardry: posts the ante 100
JJin91: posts the ante 100
bigpond12: posts the ante 100
D.Drumpf: posts the ante 100
almeida.matt: posts the ante 100
AmTheCaptain: posts the ante 100
JJin91: posts small blind 400
bigpond12: posts big blind 800
*** HOLE CARDS ***
Dealt to JJin91 [6c Ac]
D.Drumpf: folds=20
almeida.matt: folds=20
AmTheCaptain: folds=20
Labba609: folds=20
ReservoirK@: calls 800
PureWizardry: folds=20
JJin91: calls 400
bigpond12: checks=20
*** FLOP *** [8c Kd As]
JJin91: checks=20
bigpond12: checks=20
ReservoirK@: bets 1600
JJin91: calls 1600
bigpond12: folds=20
*** TURN *** [8c Kd As] [Qs]
JJin91: checks=20
ReservoirK@: checks=20
*** RIVER *** [8c Kd As Qs] [5c]
JJin91: bets 1984
ReservoirK@: calls 1984
*** SHOW DOWN ***
JJin91: shows [6c Ac] (a pair of Aces)
ReservoirK@: mucks hand=20
JJin91 collected 10368 from pot
*** SUMMARY ***
Total pot 10368 | Rake 0=20
Board [8c Kd As Qs 5c]
Seat 1: Labba609 folded before Flop (didn't bet)
Seat 2: ReservoirK@ mucked [6h Kh]
Seat 3: PureWizardry (button) folded before Flop (didn't bet)
Seat 4: JJin91 (small blind) showed [6c Ac] and won (10368) with a pair=
 of Aces
Seat 5: bigpond12 (big blind) folded on the Flop
Seat 6: D.Drumpf folded before Flop (didn't bet)
Seat 7: almeida.matt folded before Flop (didn't bet)
Seat 9: AmTheCaptain folded before Flop (didn't bet)


*********** # 62 **************
PokerStars Hand #169648262142: Tournament #1622537113, $9.10+$0.90 USD =
Hold'em No Limit - Level XIV (400/800) - 2017/05/09 20:29:37 ET
Table '1622537113 9' 9-max Seat #4 is the button
Seat 1: Labba609 (7170 in chips)=20
Seat 2: ReservoirK@ (42875 in chips)=20
Seat 3: PureWizardry (12641 in chips)=20
Seat 4: JJin91 (33747 in chips)=20
Seat 5: bigpond12 (47992 in chips)=20
Seat 6: D.Drumpf (18890 in chips)=20
Seat 7: almeida.matt (16816 in chips)=20
Seat 9: AmTheCaptain (45233 in chips)=20
Labba609: posts the ante 100
ReservoirK@: posts the ante 100
PureWizardry: posts the ante 100
JJin91: posts the ante 100
bigpond12: posts the ante 100
D.Drumpf: posts the ante 100
almeida.matt: posts the ante 100
AmTheCaptain: posts the ante 100
bigpond12: posts small blind 400
D.Drumpf: posts big blind 800
*** HOLE CARDS ***
Dealt to JJin91 [Qd 3h]
almeida.matt: folds=20
AmTheCaptain: folds=20
Labba609: folds=20
ReservoirK@: raises 976 to 1776
PureWizardry: folds=20
JJin91: folds=20
bigpond12: folds=20
D.Drumpf: raises 17014 to 18790 and is all-in
ReservoirK@: folds=20
Uncalled bet (17014) returned to D.Drumpf
D.Drumpf collected 4752 from pot
D.Drumpf: doesn't show hand=20
*** SUMMARY ***
Total pot 4752 | Rake 0=20
Seat 1: Labba609 folded before Flop (didn't bet)
Seat 2: ReservoirK@ folded before Flop
Seat 3: PureWizardry folded before Flop (didn't bet)
Seat 4: JJin91 (button) folded before Flop (didn't bet)
Seat 5: bigpond12 (small blind) folded before Flop
Seat 6: D.Drumpf (big blind) collected (4752)
Seat 7: almeida.matt folded before Flop (didn't bet)
Seat 9: AmTheCaptain folded before Flop (didn't bet)


*********** # 63 **************
PokerStars Hand #169648262539: Tournament #1622537113, $9.10+$0.90 USD =
Hold'em No Limit - Level XIV (400/800) - 2017/05/09 20:30:31 ET
Table '1622537113 9' 9-max Seat #5 is the button
Seat 1: Labba609 (7070 in chips)=20
Seat 2: ReservoirK@ (40999 in chips)=20
Seat 3: PureWizardry (12541 in chips)=20
Seat 4: JJin91 (33647 in chips)=20
Seat 5: bigpond12 (47492 in chips)=20
Seat 6: D.Drumpf (21766 in chips)=20
Seat 7: almeida.matt (16716 in chips)=20
Seat 9: AmTheCaptain (45133 in chips)=20
Labba609: posts the ante 100
ReservoirK@: posts the ante 100
PureWizardry: posts the ante 100
JJin91: posts the ante 100
bigpond12: posts the ante 100
D.Drumpf: posts the ante 100
almeida.matt: posts the ante 100
AmTheCaptain: posts the ante 100
D.Drumpf: posts small blind 400
almeida.matt: posts big blind 800
*** HOLE CARDS ***
Dealt to JJin91 [Jd Kd]
Labba609 is disconnected=20
AmTheCaptain: folds=20
Labba609 is connected=20
Labba609: folds=20
ReservoirK@: calls 800
PureWizardry: folds=20
JJin91: raises 1600 to 2400
bigpond12: folds=20
D.Drumpf: folds=20
almeida.matt: folds=20
ReservoirK@: folds=20
Uncalled bet (1600) returned to JJin91
JJin91 collected 3600 from pot
JJin91: doesn't show hand=20
*** SUMMARY ***
Total pot 3600 | Rake 0=20
Seat 1: Labba609 folded before Flop (didn't bet)
Seat 2: ReservoirK@ folded before Flop
Seat 3: PureWizardry folded before Flop (didn't bet)
Seat 4: JJin91 collected (3600)
Seat 5: bigpond12 (button) folded before Flop (didn't bet)
Seat 6: D.Drumpf (small blind) folded before Flop
Seat 7: almeida.matt (big blind) folded before Flop
Seat 9: AmTheCaptain folded before Flop (didn't bet)


*********** # 64 **************
PokerStars Hand #169648262937: Tournament #1622537113, $9.10+$0.90 USD =
Hold'em No Limit - Level XIV (400/800) - 2017/05/09 20:31:26 ET
Table '1622537113 9' 9-max Seat #6 is the button
Seat 1: Labba609 (6970 in chips)=20
Seat 2: ReservoirK@ (40099 in chips)=20
Seat 3: PureWizardry (12441 in chips)=20
Seat 4: JJin91 (36347 in chips)=20
Seat 5: bigpond12 (47392 in chips)=20
Seat 6: D.Drumpf (21266 in chips)=20
Seat 7: almeida.matt (15816 in chips)=20
Seat 9: AmTheCaptain (45033 in chips)=20
Labba609: posts the ante 100
ReservoirK@: posts the ante 100
PureWizardry: posts the ante 100
JJin91: posts the ante 100
bigpond12: posts the ante 100
D.Drumpf: posts the ante 100
almeida.matt: posts the ante 100
AmTheCaptain: posts the ante 100
almeida.matt: posts small blind 400
AmTheCaptain: posts big blind 800
*** HOLE CARDS ***
Dealt to JJin91 [3h Tc]
Labba609: folds=20
ReservoirK@: folds=20
PureWizardry: raises 11541 to 12341 and is all-in
JJin91: folds=20
bigpond12: folds=20
D.Drumpf: folds=20
almeida.matt: folds=20
AmTheCaptain: folds=20
Uncalled bet (11541) returned to PureWizardry
PureWizardry collected 2800 from pot
PureWizardry: doesn't show hand=20
*** SUMMARY ***
Total pot 2800 | Rake 0=20
Seat 1: Labba609 folded before Flop (didn't bet)
Seat 2: ReservoirK@ folded before Flop (didn't bet)
Seat 3: PureWizardry collected (2800)
Seat 4: JJin91 folded before Flop (didn't bet)
Seat 5: bigpond12 folded before Flop (didn't bet)
Seat 6: D.Drumpf (button) folded before Flop (didn't bet)
Seat 7: almeida.matt (small blind) folded before Flop
Seat 9: AmTheCaptain (big blind) folded before Flop


*********** # 65 **************
PokerStars Hand #169648263487: Tournament #1622537113, $9.10+$0.90 USD =
Hold'em No Limit - Level XV (500/1000) - 2017/05/09 20:32:41 ET
Table '1622537113 9' 9-max Seat #7 is the button
Seat 1: Labba609 (6870 in chips)=20
Seat 2: ReservoirK@ (39999 in chips)=20
Seat 3: PureWizardry (14341 in chips)=20
Seat 4: JJin91 (36247 in chips)=20
Seat 5: bigpond12 (47292 in chips)=20
Seat 6: D.Drumpf (21166 in chips)=20
Seat 7: almeida.matt (15316 in chips)=20
Seat 9: AmTheCaptain (44133 in chips)=20
Labba609: posts the ante 125
ReservoirK@: posts the ante 125
PureWizardry: posts the ante 125
JJin91: posts the ante 125
bigpond12: posts the ante 125
D.Drumpf: posts the ante 125
almeida.matt: posts the ante 125
AmTheCaptain: posts the ante 125
AmTheCaptain: posts small blind 500
Labba609: posts big blind 1000
*** HOLE CARDS ***
Dealt to JJin91 [2s Th]
ReservoirK@: folds=20
PureWizardry: folds=20
JJin91: folds=20
bigpond12: raises 2000 to 3000
D.Drumpf: calls 3000
almeida.matt: folds=20
AmTheCaptain: calls 2500
Labba609: folds=20
*** FLOP *** [5c 4d Jd]
AmTheCaptain: checks=20
bigpond12: bets 4000
D.Drumpf: folds=20
AmTheCaptain: folds=20
Uncalled bet (4000) returned to bigpond12
bigpond12 collected 11000 from pot
bigpond12: doesn't show hand=20
*** SUMMARY ***
Total pot 11000 | Rake 0=20
Board [5c 4d Jd]
Seat 1: Labba609 (big blind) folded before Flop
Seat 2: ReservoirK@ folded before Flop (didn't bet)
Seat 3: PureWizardry folded before Flop (didn't bet)
Seat 4: JJin91 folded before Flop (didn't bet)
Seat 5: bigpond12 collected (11000)
Seat 6: D.Drumpf folded on the Flop
Seat 7: almeida.matt (button) folded before Flop (didn't bet)
Seat 9: AmTheCaptain (small blind) folded on the Flop


*********** # 66 **************
PokerStars Hand #169648263998: Tournament #1622537113, $9.10+$0.90 USD =
Hold'em No Limit - Level XV (500/1000) - 2017/05/09 20:33:53 ET
Table '1622537113 9' 9-max Seat #9 is the button
Seat 1: Labba609 (5745 in chips)=20
Seat 2: ReservoirK@ (39874 in chips)=20
Seat 3: PureWizardry (14216 in chips)=20
Seat 4: JJin91 (36122 in chips)=20
Seat 5: bigpond12 (55167 in chips)=20
Seat 6: D.Drumpf (18041 in chips)=20
Seat 7: almeida.matt (15191 in chips)=20
Seat 8: katekars21 (78894 in chips)=20
Seat 9: AmTheCaptain (41008 in chips)=20
Labba609: posts the ante 125
ReservoirK@: posts the ante 125
PureWizardry: posts the ante 125
JJin91: posts the ante 125
bigpond12: posts the ante 125
D.Drumpf: posts the ante 125
almeida.matt: posts the ante 125
katekars21: posts the ante 125
AmTheCaptain: posts the ante 125
Labba609: posts small blind 500
ReservoirK@: posts big blind 1000
*** HOLE CARDS ***
Dealt to JJin91 [6c 7h]
PureWizardry: folds=20
JJin91: folds=20
bigpond12: raises 3000 to 4000
D.Drumpf: folds=20
almeida.matt: folds=20
katekars21: folds=20
AmTheCaptain: calls 4000
Labba609: folds=20
ReservoirK@: folds=20
*** FLOP *** [5s Ks 2h]
bigpond12: bets 7000
AmTheCaptain: raises 7000 to 14000
bigpond12: raises 37042 to 51042 and is all-in
AmTheCaptain: calls 22883 and is all-in
Uncalled bet (14159) returned to bigpond12
*** TURN *** [5s Ks 2h] [Ac]
*** RIVER *** [5s Ks 2h Ac] [9h]
*** SHOW DOWN ***
bigpond12: shows [Ad Ah] (three of a kind, Aces)
AmTheCaptain: shows [As 9s] (two pair, Aces and Nines)
bigpond12 collected 84391 from pot
AmTheCaptain finished the tournament in 35th place
*** SUMMARY ***
Total pot 84391 | Rake 0=20
Board [5s Ks 2h Ac 9h]
Seat 1: Labba609 (small blind) folded before Flop
Seat 2: ReservoirK@ (big blind) folded before Flop
Seat 3: PureWizardry folded before Flop (didn't bet)
Seat 4: JJin91 folded before Flop (didn't bet)
Seat 5: bigpond12 showed [Ad Ah] and won (84391) with three of a kind, =
Aces
Seat 6: D.Drumpf folded before Flop (didn't bet)
Seat 7: almeida.matt folded before Flop (didn't bet)
Seat 8: katekars21 folded before Flop (didn't bet)
Seat 9: AmTheCaptain (button) showed [As 9s] and lost with two pair, Ac=
es and Nines


*********** # 67 **************
PokerStars Hand #169648264269: Tournament #1622537113, $9.10+$0.90 USD =
Hold'em No Limit - Level XV (500/1000) - 2017/05/09 20:34:34 ET
Table '1622537113 9' 9-max Seat #1 is the button
Seat 1: Labba609 (5120 in chips)=20
Seat 2: ReservoirK@ (38749 in chips)=20
Seat 3: PureWizardry (14091 in chips)=20
Seat 4: JJin91 (35997 in chips)=20
Seat 5: bigpond12 (98550 in chips)=20
Seat 6: D.Drumpf (17916 in chips)=20
Seat 7: almeida.matt (15066 in chips)=20
Seat 8: katekars21 (78769 in chips)=20
Labba609: posts the ante 125
ReservoirK@: posts the ante 125
PureWizardry: posts the ante 125
JJin91: posts the ante 125
bigpond12: posts the ante 125
D.Drumpf: posts the ante 125
almeida.matt: posts the ante 125
katekars21: posts the ante 125
ReservoirK@: posts small blind 500
PureWizardry: posts big blind 1000
*** HOLE CARDS ***
Dealt to JJin91 [5s 9s]
JJin91: folds=20
bigpond12: folds=20
D.Drumpf: raises 1500 to 2500
almeida.matt: folds=20
katekars21: folds=20
Labba609: folds=20
ReservoirK@: folds=20
PureWizardry: calls 1500
*** FLOP *** [9c 7h Js]
PureWizardry: checks=20
D.Drumpf: bets 2750
PureWizardry: raises 8716 to 11466 and is all-in
D.Drumpf: calls 8716
*** TURN *** [9c 7h Js] [9d]
*** RIVER *** [9c 7h Js 9d] [5d]
*** SHOW DOWN ***
PureWizardry: shows [8s Ac] (a pair of Nines)
D.Drumpf: shows [Jc Qc] (two pair, Jacks and Nines)
D.Drumpf collected 29432 from pot
PureWizardry finished the tournament in 33rd place
*** SUMMARY ***
Total pot 29432 | Rake 0=20
Board [9c 7h Js 9d 5d]
Seat 1: Labba609 (button) folded before Flop (didn't bet)
Seat 2: ReservoirK@ (small blind) folded before Flop
Seat 3: PureWizardry (big blind) showed [8s Ac] and lost with a pair of=
 Nines
Seat 4: JJin91 folded before Flop (didn't bet)
Seat 5: bigpond12 folded before Flop (didn't bet)
Seat 6: D.Drumpf showed [Jc Qc] and won (29432) with two pair, Jacks an=
d Nines
Seat 7: almeida.matt folded before Flop (didn't bet)
Seat 8: katekars21 folded before Flop (didn't bet)


*********** # 68 **************
PokerStars Hand #169648264751: Tournament #1622537113, $9.10+$0.90 USD =
Hold'em No Limit - Level XV (500/1000) - 2017/05/09 20:35:39 ET
Table '1622537113 9' 9-max Seat #2 is the button
Seat 1: Labba609 (4995 in chips)=20
Seat 2: ReservoirK@ (38124 in chips)=20
Seat 4: JJin91 (35872 in chips)=20
Seat 5: bigpond12 (98425 in chips)=20
Seat 6: D.Drumpf (33257 in chips)=20
Seat 7: almeida.matt (14941 in chips)=20
Seat 8: katekars21 (78644 in chips)=20
Labba609: posts the ante 125
ReservoirK@: posts the ante 125
JJin91: posts the ante 125
bigpond12: posts the ante 125
D.Drumpf: posts the ante 125
almeida.matt: posts the ante 125
katekars21: posts the ante 125
JJin91: posts small blind 500
bigpond12: posts big blind 1000
*** HOLE CARDS ***
Dealt to JJin91 [3h 3s]
D.Drumpf: folds=20
almeida.matt: raises 1200 to 2200
katekars21: folds=20
Labba609: folds=20
ReservoirK@: folds=20
JJin91: calls 1700
bigpond12: raises 4800 to 7000
almeida.matt: folds=20
JJin91: folds=20
Uncalled bet (4800) returned to bigpond12
bigpond12 collected 7475 from pot
bigpond12: doesn't show hand=20
*** SUMMARY ***
Total pot 7475 | Rake 0=20
Seat 1: Labba609 folded before Flop (didn't bet)
Seat 2: ReservoirK@ (button) folded before Flop (didn't bet)
Seat 4: JJin91 (small blind) folded before Flop
Seat 5: bigpond12 (big blind) collected (7475)
Seat 6: D.Drumpf folded before Flop (didn't bet)
Seat 7: almeida.matt folded before Flop
Seat 8: katekars21 folded before Flop (didn't bet)


*********** # 69 **************
PokerStars Hand #169648265278: Tournament #1622537113, $9.10+$0.90 USD =
Hold'em No Limit - Level XV (500/1000) - 2017/05/09 20:37:00 ET
Table '1622537113 9' 9-max Seat #4 is the button
Seat 1: Labba609 (4870 in chips)=20
Seat 2: ReservoirK@ (37999 in chips)=20
Seat 3: Super Donk54 (3370 in chips)=20
Seat 4: JJin91 (33547 in chips)=20
Seat 5: bigpond12 (103575 in chips)=20
Seat 6: D.Drumpf (33132 in chips)=20
Seat 7: almeida.matt (12616 in chips)=20
Seat 8: katekars21 (78519 in chips)=20
Labba609: posts the ante 125
ReservoirK@: posts the ante 125
Super Donk54: posts the ante 125
JJin91: posts the ante 125
bigpond12: posts the ante 125
D.Drumpf: posts the ante 125
almeida.matt: posts the ante 125
katekars21: posts the ante 125
bigpond12: posts small blind 500
D.Drumpf: posts big blind 1000
*** HOLE CARDS ***
Dealt to JJin91 [Tc 6d]
almeida.matt: folds=20
katekars21: folds=20
Labba609: folds=20
ReservoirK@: folds=20
Super Donk54: folds=20
JJin91: folds=20
bigpond12: calls 500
D.Drumpf: raises 2500 to 3500
bigpond12: calls 2500
*** FLOP *** [3d Ts 4h]
bigpond12: checks=20
D.Drumpf: bets 3000
bigpond12: calls 3000
*** TURN *** [3d Ts 4h] [3c]
bigpond12: checks=20
D.Drumpf: bets 5500
bigpond12: calls 5500
*** RIVER *** [3d Ts 4h 3c] [4s]
bigpond12: checks=20
D.Drumpf: bets 21007 and is all-in
bigpond12: calls 21007
*** SHOW DOWN ***
D.Drumpf: shows [Kh Th] (two pair, Tens and Fours)
bigpond12: shows [6c Td] (two pair, Tens and Fours - lower kicker)
D.Drumpf collected 67014 from pot
*** SUMMARY ***
Total pot 67014 | Rake 0=20
Board [3d Ts 4h 3c 4s]
Seat 1: Labba609 folded before Flop (didn't bet)
Seat 2: ReservoirK@ folded before Flop (didn't bet)
Seat 3: Super Donk54 folded before Flop (didn't bet)
Seat 4: JJin91 (button) folded before Flop (didn't bet)
Seat 5: bigpond12 (small blind) showed [6c Td] and lost with two pair, =
Tens and Fours
Seat 6: D.Drumpf (big blind) showed [Kh Th] and won (67014) with two pa=
ir, Tens and Fours
Seat 7: almeida.matt folded before Flop (didn't bet)
Seat 8: katekars21 folded before Flop (didn't bet)


*********** # 70 **************
PokerStars Hand #169648265913: Tournament #1622537113, $9.10+$0.90 USD =
Hold'em No Limit - Level XV (500/1000) - 2017/05/09 20:38:40 ET
Table '1622537113 9' 9-max Seat #5 is the button
Seat 1: Labba609 (4745 in chips)=20
Seat 2: ReservoirK@ (37874 in chips)=20
Seat 3: Super Donk54 (3245 in chips)=20
Seat 4: JJin91 (33422 in chips)=20
Seat 5: bigpond12 (70443 in chips)=20
Seat 6: D.Drumpf (67014 in chips)=20
Seat 7: almeida.matt (12491 in chips)=20
Seat 8: katekars21 (78394 in chips)=20
Labba609: posts the ante 125
ReservoirK@: posts the ante 125
Super Donk54: posts the ante 125
JJin91: posts the ante 125
bigpond12: posts the ante 125
D.Drumpf: posts the ante 125
almeida.matt: posts the ante 125
katekars21: posts the ante 125
D.Drumpf: posts small blind 500
almeida.matt: posts big blind 1000
*** HOLE CARDS ***
Dealt to JJin91 [3h 8d]
katekars21: folds=20
Labba609: folds=20
ReservoirK@: folds=20
Super Donk54: raises 2120 to 3120 and is all-in
JJin91: folds=20
bigpond12: folds=20
D.Drumpf: folds=20
almeida.matt: calls 2120
*** FLOP *** [4s 4d 7c]
*** TURN *** [4s 4d 7c] [5c]
*** RIVER *** [4s 4d 7c 5c] [9h]
*** SHOW DOWN ***
almeida.matt: shows [5h As] (two pair, Fives and Fours)
Super Donk54: shows [6s Ah] (a pair of Fours)
almeida.matt collected 7740 from pot
Super Donk54 finished the tournament in 31st place
*** SUMMARY ***
Total pot 7740 | Rake 0=20
Board [4s 4d 7c 5c 9h]
Seat 1: Labba609 folded before Flop (didn't bet)
Seat 2: ReservoirK@ folded before Flop (didn't bet)
Seat 3: Super Donk54 showed [6s Ah] and lost with a pair of Fours
Seat 4: JJin91 folded before Flop (didn't bet)
Seat 5: bigpond12 (button) folded before Flop (didn't bet)
Seat 6: D.Drumpf (small blind) folded before Flop
Seat 7: almeida.matt (big blind) showed [5h As] and won (7740) with two=
 pair, Fives and Fours
Seat 8: katekars21 folded before Flop (didn't bet)


*********** # 71 **************
PokerStars Hand #169648266125: Tournament #1622537113, $9.10+$0.90 USD =
Hold'em No Limit - Level XV (500/1000) - 2017/05/09 20:39:13 ET
Table '1622537113 9' 9-max Seat #6 is the button
Seat 1: Labba609 (4620 in chips)=20
Seat 2: ReservoirK@ (37749 in chips)=20
Seat 4: JJin91 (33297 in chips)=20
Seat 5: bigpond12 (70318 in chips)=20
Seat 6: D.Drumpf (66389 in chips)=20
Seat 7: almeida.matt (16986 in chips)=20
Seat 8: katekars21 (78269 in chips)=20
Labba609: posts the ante 125
ReservoirK@: posts the ante 125
JJin91: posts the ante 125
bigpond12: posts the ante 125
D.Drumpf: posts the ante 125
almeida.matt: posts the ante 125
katekars21: posts the ante 125
almeida.matt: posts small blind 500
katekars21: posts big blind 1000
*** HOLE CARDS ***
Dealt to JJin91 [5s Jc]
Labba609: folds=20
ReservoirK@: folds=20
JJin91: folds=20
bigpond12 has timed out
bigpond12: folds=20
bigpond12 is sitting out
D.Drumpf: folds=20
almeida.matt: raises 15861 to 16861 and is all-in
katekars21: folds=20
Uncalled bet (15861) returned to almeida.matt
almeida.matt collected 2875 from pot
*** SUMMARY ***
Total pot 2875 | Rake 0=20
Seat 1: Labba609 folded before Flop (didn't bet)
Seat 2: ReservoirK@ folded before Flop (didn't bet)
Seat 4: JJin91 folded before Flop (didn't bet)
Seat 5: bigpond12 folded before Flop (didn't bet)
Seat 6: D.Drumpf (button) folded before Flop (didn't bet)
Seat 7: almeida.matt (small blind) collected (2875)
Seat 8: katekars21 (big blind) folded before Flop


*********** # 72 **************
PokerStars Hand #169648266680: Tournament #1622537113, $9.10+$0.90 USD =
Hold'em No Limit - Level XV (500/1000) - 2017/05/09 20:40:35 ET
Table '1622537113 9' 9-max Seat #7 is the button
Seat 1: Labba609 (4495 in chips)=20
Seat 2: ReservoirK@ (37624 in chips)=20
Seat 4: JJin91 (33172 in chips)=20
Seat 5: bigpond12 (70193 in chips) is sitting out
Seat 6: D.Drumpf (66264 in chips)=20
Seat 7: almeida.matt (18736 in chips)=20
Seat 8: katekars21 (77144 in chips)=20
Labba609: posts the ante 125
ReservoirK@: posts the ante 125
JJin91: posts the ante 125
bigpond12: posts the ante 125
D.Drumpf: posts the ante 125
almeida.matt: posts the ante 125
katekars21: posts the ante 125
katekars21: posts small blind 500
Labba609: posts big blind 1000
*** HOLE CARDS ***
Dealt to JJin91 [6c 8d]
ReservoirK@: folds=20
JJin91: folds=20
bigpond12: folds=20
D.Drumpf: folds=20
almeida.matt: raises 17611 to 18611 and is all-in
katekars21: folds=20
Labba609: calls 3370 and is all-in
Uncalled bet (14241) returned to almeida.matt
*** FLOP *** [4h 5d As]
*** TURN *** [4h 5d As] [2h]
*** RIVER *** [4h 5d As 2h] [6h]
*** SHOW DOWN ***
Labba609: shows [7s Js] (high card Ace)
almeida.matt: shows [Qd Qh] (a pair of Queens)
almeida.matt collected 10115 from pot
Labba609 finished the tournament in 29th place
*** SUMMARY ***
Total pot 10115 | Rake 0=20
Board [4h 5d As 2h 6h]
Seat 1: Labba609 (big blind) showed [7s Js] and lost with high card Ace
Seat 2: ReservoirK@ folded before Flop (didn't bet)
Seat 4: JJin91 folded before Flop (didn't bet)
Seat 5: bigpond12 folded before Flop (didn't bet)
Seat 6: D.Drumpf folded before Flop (didn't bet)
Seat 7: almeida.matt (button) showed [Qd Qh] and won (10115) with a pai=
r of Queens
Seat 8: katekars21 (small blind) folded before Flop


*********** # 73 **************
PokerStars Hand #169648266961: Tournament #1622537113, $9.10+$0.90 USD =
Hold'em No Limit - Level XV (500/1000) - 2017/05/09 20:41:20 ET
Table '1622537113 9' 9-max Seat #8 is the button
Seat 2: ReservoirK@ (37499 in chips)=20
Seat 3: kfoulk833 (23148 in chips)=20
Seat 4: JJin91 (33047 in chips)=20
Seat 5: bigpond12 (70068 in chips) is sitting out
Seat 6: D.Drumpf (66139 in chips)=20
Seat 7: almeida.matt (24356 in chips)=20
Seat 8: katekars21 (76519 in chips)=20
ReservoirK@: posts the ante 125
kfoulk833: posts the ante 125
JJin91: posts the ante 125
bigpond12: posts the ante 125
D.Drumpf: posts the ante 125
almeida.matt: posts the ante 125
katekars21: posts the ante 125
ReservoirK@: posts small blind 500
kfoulk833: posts big blind 1000
*** HOLE CARDS ***
Dealt to JJin91 [2c Th]
JJin91: folds=20
bigpond12: folds=20
D.Drumpf: folds=20
almeida.matt: folds=20
katekars21: raises 1000 to 2000
bigpond12 has returned
ReservoirK@: folds=20
kfoulk833: calls 1000
*** FLOP *** [2h 4h 9d]
kfoulk833: checks=20
katekars21: bets 1000
kfoulk833: calls 1000
*** TURN *** [2h 4h 9d] [Kc]
kfoulk833: checks=20
katekars21: bets 1000
kfoulk833: calls 1000
*** RIVER *** [2h 4h 9d Kc] [Ac]
kfoulk833: bets 6000
katekars21: folds=20
Uncalled bet (6000) returned to kfoulk833
kfoulk833 collected 9375 from pot
kfoulk833: doesn't show hand=20
*** SUMMARY ***
Total pot 9375 | Rake 0=20
Board [2h 4h 9d Kc Ac]
Seat 2: ReservoirK@ (small blind) folded before Flop
Seat 3: kfoulk833 (big blind) collected (9375)
Seat 4: JJin91 folded before Flop (didn't bet)
Seat 5: bigpond12 folded before Flop (didn't bet)
Seat 6: D.Drumpf folded before Flop (didn't bet)
Seat 7: almeida.matt folded before Flop (didn't bet)
Seat 8: katekars21 (button) folded on the River


*********** # 74 **************
PokerStars Hand #169648267422: Tournament #1622537113, $9.10+$0.90 USD =
Hold'em No Limit - Level XVI (600/1200) - 2017/05/09 20:42:34 ET
Table '1622537113 9' 9-max Seat #2 is the button
Seat 2: ReservoirK@ (36874 in chips)=20
Seat 3: kfoulk833 (28398 in chips)=20
Seat 4: JJin91 (32922 in chips)=20
Seat 5: bigpond12 (69943 in chips)=20
Seat 6: D.Drumpf (66014 in chips)=20
Seat 7: almeida.matt (24231 in chips)=20
Seat 8: katekars21 (72394 in chips)=20
ReservoirK@: posts the ante 150
kfoulk833: posts the ante 150
JJin91: posts the ante 150
bigpond12: posts the ante 150
D.Drumpf: posts the ante 150
almeida.matt: posts the ante 150
katekars21: posts the ante 150
kfoulk833: posts small blind 600
JJin91: posts big blind 1200
*** HOLE CARDS ***
Dealt to JJin91 [7c Td]
bigpond12: folds=20
D.Drumpf: folds=20
almeida.matt: folds=20
katekars21: folds=20
ReservoirK@: calls 1200
kfoulk833: calls 600
JJin91: checks=20
*** FLOP *** [Jd 6c As]
kfoulk833: checks=20
JJin91: checks=20
ReservoirK@: bets 2400
kfoulk833: folds=20
JJin91: folds=20
Uncalled bet (2400) returned to ReservoirK@
ReservoirK@ collected 4650 from pot
ReservoirK@: doesn't show hand=20
*** SUMMARY ***
Total pot 4650 | Rake 0=20
Board [Jd 6c As]
Seat 2: ReservoirK@ (button) collected (4650)
Seat 3: kfoulk833 (small blind) folded on the Flop
Seat 4: JJin91 (big blind) folded on the Flop
Seat 5: bigpond12 folded before Flop (didn't bet)
Seat 6: D.Drumpf folded before Flop (didn't bet)
Seat 7: almeida.matt folded before Flop (didn't bet)
Seat 8: katekars21 folded before Flop (didn't bet)


*********** # 75 **************
PokerStars Hand #169648267675: Tournament #1622537113, $9.10+$0.90 USD =
Hold'em No Limit - Level XVI (600/1200) - 2017/05/09 20:43:15 ET
Table '1622537113 9' 9-max Seat #3 is the button
Seat 2: ReservoirK@ (40174 in chips)=20
Seat 3: kfoulk833 (27048 in chips)=20
Seat 4: JJin91 (31572 in chips)=20
Seat 5: bigpond12 (69793 in chips)=20
Seat 6: D.Drumpf (65864 in chips)=20
Seat 7: almeida.matt (24081 in chips)=20
Seat 8: katekars21 (72244 in chips)=20
ReservoirK@: posts the ante 150
kfoulk833: posts the ante 150
JJin91: posts the ante 150
bigpond12: posts the ante 150
D.Drumpf: posts the ante 150
almeida.matt: posts the ante 150
katekars21: posts the ante 150
JJin91: posts small blind 600
bigpond12: posts big blind 1200
*** HOLE CARDS ***
Dealt to JJin91 [Jc 3c]
D.Drumpf: folds=20
almeida.matt: folds=20
katekars21: folds=20
ReservoirK@ has timed out while disconnected
ReservoirK@: folds=20
ReservoirK@ is sitting out
kfoulk833: folds=20
ReservoirK@ has returned
JJin91: calls 600
bigpond12: checks=20
*** FLOP *** [2c 4c Ts]
JJin91: checks=20
bigpond12: bets 1200
JJin91: calls 1200
*** TURN *** [2c 4c Ts] [4s]
JJin91: checks=20
bigpond12: checks=20
*** RIVER *** [2c 4c Ts 4s] [7h]
JJin91: checks=20
bigpond12: checks=20
*** SHOW DOWN ***
JJin91: shows [Jc 3c] (a pair of Fours)
bigpond12: shows [7d 9h] (two pair, Sevens and Fours)
bigpond12 collected 5850 from pot
*** SUMMARY ***
Total pot 5850 | Rake 0=20
Board [2c 4c Ts 4s 7h]
Seat 2: ReservoirK@ folded before Flop (didn't bet)
Seat 3: kfoulk833 (button) folded before Flop (didn't bet)
Seat 4: JJin91 (small blind) showed [Jc 3c] and lost with a pair of Fou=
rs
Seat 5: bigpond12 (big blind) showed [7d 9h] and won (5850) with two pa=
ir, Sevens and Fours
Seat 6: D.Drumpf folded before Flop (didn't bet)
Seat 7: almeida.matt folded before Flop (didn't bet)
Seat 8: katekars21 folded before Flop (didn't bet)


*********** # 76 **************
PokerStars Hand #169648268062: Tournament #1622537113, $9.10+$0.90 USD =
Hold'em No Limit - Level XVI (600/1200) - 2017/05/09 20:44:21 ET
Table '1622537113 9' 9-max Seat #4 is the button
Seat 1: TrademarkTer (30013 in chips)=20
Seat 2: ReservoirK@ (40024 in chips)=20
Seat 3: kfoulk833 (26898 in chips)=20
Seat 4: JJin91 (29022 in chips)=20
Seat 5: bigpond12 (73093 in chips)=20
Seat 6: D.Drumpf (65714 in chips)=20
Seat 7: almeida.matt (23931 in chips)=20
Seat 8: katekars21 (72094 in chips)=20
Seat 9: SquadooshBag (76888 in chips)=20
TrademarkTer: posts the ante 150
ReservoirK@: posts the ante 150
kfoulk833: posts the ante 150
JJin91: posts the ante 150
bigpond12: posts the ante 150
D.Drumpf: posts the ante 150
almeida.matt: posts the ante 150
katekars21: posts the ante 150
SquadooshBag: posts the ante 150
bigpond12: posts small blind 600
D.Drumpf: posts big blind 1200
*** HOLE CARDS ***
Dealt to JJin91 [6d 5h]
almeida.matt: raises 1200 to 2400
katekars21: folds=20
SquadooshBag: calls 2400
TrademarkTer: calls 2400
ReservoirK@: folds=20
kfoulk833: raises 24348 to 26748 and is all-in
JJin91: folds=20
bigpond12: folds=20
D.Drumpf: folds=20
almeida.matt: folds=20
SquadooshBag: calls 24348
TrademarkTer: folds [9h Ah]
*** FLOP *** [7c 5d Ks]
*** TURN *** [7c 5d Ks] [5c]
*** RIVER *** [7c 5d Ks 5c] [Qh]
*** SHOW DOWN ***
SquadooshBag: shows [Js Jh] (two pair, Jacks and Fives)
kfoulk833: shows [Ad Qc] (two pair, Queens and Fives)
kfoulk833 collected 61446 from pot
*** SUMMARY ***
Total pot 61446 | Rake 0=20
Board [7c 5d Ks 5c Qh]
Seat 1: TrademarkTer folded before Flop
Seat 2: ReservoirK@ folded before Flop (didn't bet)
Seat 3: kfoulk833 showed [Ad Qc] and won (61446) with two pair, Queens =
and Fives
Seat 4: JJin91 (button) folded before Flop (didn't bet)
Seat 5: bigpond12 (small blind) folded before Flop
Seat 6: D.Drumpf (big blind) folded before Flop
Seat 7: almeida.matt folded before Flop
Seat 8: katekars21 folded before Flop (didn't bet)
Seat 9: SquadooshBag showed [Js Jh] and lost with two pair, Jacks and F=
ives


*********** # 77 **************
PokerStars Hand #169648268349: Tournament #1622537113, $9.10+$0.90 USD =
Hold'em No Limit - Level XVI (600/1200) - 2017/05/09 20:45:15 ET
Table '1622537113 9' 9-max Seat #5 is the button
Seat 1: TrademarkTer (27463 in chips)=20
Seat 2: ReservoirK@ (39874 in chips)=20
Seat 3: kfoulk833 (61446 in chips)=20
Seat 4: JJin91 (28872 in chips)=20
Seat 5: bigpond12 (72343 in chips)=20
Seat 6: D.Drumpf (64364 in chips)=20
Seat 7: almeida.matt (21381 in chips)=20
Seat 8: katekars21 (71944 in chips)=20
Seat 9: SquadooshBag (49990 in chips)=20
TrademarkTer: posts the ante 150
ReservoirK@: posts the ante 150
kfoulk833: posts the ante 150
JJin91: posts the ante 150
bigpond12: posts the ante 150
D.Drumpf: posts the ante 150
almeida.matt: posts the ante 150
katekars21: posts the ante 150
SquadooshBag: posts the ante 150
D.Drumpf: posts small blind 600
almeida.matt: posts big blind 1200
*** HOLE CARDS ***
Dealt to JJin91 [6d Th]
katekars21: calls 1200
SquadooshBag: folds=20
TrademarkTer: folds=20
SquadooshBag is sitting out
ReservoirK@: raises 1525 to 2725
kfoulk833: folds=20
JJin91: folds=20
bigpond12: calls 2725
D.Drumpf: raises 9325 to 12050
SquadooshBag is disconnected=20
almeida.matt: folds=20
katekars21: folds=20
ReservoirK@: folds=20
bigpond12: folds=20
Uncalled bet (9325) returned to D.Drumpf
D.Drumpf collected 11925 from pot
D.Drumpf: doesn't show hand=20
*** SUMMARY ***
Total pot 11925 | Rake 0=20
Seat 1: TrademarkTer folded before Flop (didn't bet)
Seat 2: ReservoirK@ folded before Flop
Seat 3: kfoulk833 folded before Flop (didn't bet)
Seat 4: JJin91 folded before Flop (didn't bet)
Seat 5: bigpond12 (button) folded before Flop
Seat 6: D.Drumpf (small blind) collected (11925)
Seat 7: almeida.matt (big blind) folded before Flop
Seat 8: katekars21 folded before Flop
Seat 9: SquadooshBag folded before Flop (didn't bet)


*********** # 78 **************
PokerStars Hand #169648268936: Tournament #1622537113, $9.10+$0.90 USD =
Hold'em No Limit - Level XVI (600/1200) - 2017/05/09 20:46:52 ET
Table '1622537113 9' 9-max Seat #6 is the button
Seat 1: TrademarkTer (27313 in chips)=20
Seat 2: ReservoirK@ (36999 in chips)=20
Seat 3: kfoulk833 (61296 in chips)=20
Seat 4: JJin91 (28722 in chips)=20
Seat 5: bigpond12 (69468 in chips)=20
Seat 6: D.Drumpf (73414 in chips)=20
Seat 7: almeida.matt (20031 in chips)=20
Seat 8: katekars21 (70594 in chips)=20
Seat 9: SquadooshBag (49840 in chips) is sitting out
TrademarkTer: posts the ante 150
ReservoirK@: posts the ante 150
kfoulk833: posts the ante 150
JJin91: posts the ante 150
bigpond12: posts the ante 150
D.Drumpf: posts the ante 150
almeida.matt: posts the ante 150
katekars21: posts the ante 150
SquadooshBag: posts the ante 150
almeida.matt: posts small blind 600
katekars21: posts big blind 1200
*** HOLE CARDS ***
Dealt to JJin91 [Th Kd]
SquadooshBag: folds=20
TrademarkTer: raises 1200 to 2400
ReservoirK@: calls 2400
kfoulk833: folds=20
JJin91: folds=20
bigpond12: folds=20
D.Drumpf: folds=20
almeida.matt: folds=20
katekars21: calls 1200
*** FLOP *** [7s 3c 6d]
katekars21: checks=20
TrademarkTer: checks=20
ReservoirK@: checks=20
*** TURN *** [7s 3c 6d] [9s]
katekars21: bets 1200
TrademarkTer: calls 1200
ReservoirK@: calls 1200
*** RIVER *** [7s 3c 6d 9s] [5s]
katekars21: bets 2400
TrademarkTer: calls 2400
ReservoirK@: folds=20
*** SHOW DOWN ***
katekars21: shows [8h Kh] (a straight, Five to Nine)
TrademarkTer: mucks hand=20
katekars21 collected 17550 from pot
*** SUMMARY ***
Total pot 17550 | Rake 0=20
Board [7s 3c 6d 9s 5s]
Seat 1: TrademarkTer mucked [4h 4s]
Seat 2: ReservoirK@ folded on the River
Seat 3: kfoulk833 folded before Flop (didn't bet)
Seat 4: JJin91 folded before Flop (didn't bet)
Seat 5: bigpond12 folded before Flop (didn't bet)
Seat 6: D.Drumpf (button) folded before Flop (didn't bet)
Seat 7: almeida.matt (small blind) folded before Flop
Seat 8: katekars21 (big blind) showed [8h Kh] and won (17550) with a st=
raight, Five to Nine
Seat 9: SquadooshBag folded before Flop (didn't bet)


*********** # 79 **************
PokerStars Hand #169648269236: Tournament #1622537113, $9.10+$0.90 USD =
Hold'em No Limit - Level XVI (600/1200) - 2017/05/09 20:47:44 ET
Table '1622537113 9' 9-max Seat #7 is the button
Seat 1: TrademarkTer (21163 in chips)=20
Seat 2: ReservoirK@ (33249 in chips)=20
Seat 3: kfoulk833 (61146 in chips)=20
Seat 4: JJin91 (28572 in chips)=20
Seat 5: bigpond12 (69318 in chips)=20
Seat 6: D.Drumpf (73264 in chips)=20
Seat 7: almeida.matt (19281 in chips)=20
Seat 8: katekars21 (81994 in chips)=20
Seat 9: SquadooshBag (49690 in chips) is sitting out
TrademarkTer: posts the ante 150
ReservoirK@: posts the ante 150
kfoulk833: posts the ante 150
JJin91: posts the ante 150
bigpond12: posts the ante 150
D.Drumpf: posts the ante 150
almeida.matt: posts the ante 150
katekars21: posts the ante 150
SquadooshBag: posts the ante 150
katekars21: posts small blind 600
SquadooshBag: posts big blind 1200
*** HOLE CARDS ***
Dealt to JJin91 [2d Qh]
TrademarkTer: folds=20
ReservoirK@: folds=20
kfoulk833: folds=20
JJin91: folds=20
bigpond12: raises 2400 to 3600
D.Drumpf: folds=20
almeida.matt: folds=20
katekars21: calls 3000
SquadooshBag: folds=20
*** FLOP *** [Ts 3d Jd]
katekars21: checks=20
bigpond12: bets 4875
katekars21: calls 4875
*** TURN *** [Ts 3d Jd] [Ks]
katekars21: checks=20
bigpond12: bets 12000
katekars21: calls 12000
*** RIVER *** [Ts 3d Jd Ks] [7c]
katekars21: checks=20
bigpond12: checks=20
*** SHOW DOWN ***
katekars21: shows [Th Ac] (a pair of Tens)
bigpond12: mucks hand=20
katekars21 collected 43500 from pot
*** SUMMARY ***
Total pot 43500 | Rake 0=20
Board [Ts 3d Jd Ks 7c]
Seat 1: TrademarkTer folded before Flop (didn't bet)
Seat 2: ReservoirK@ folded before Flop (didn't bet)
Seat 3: kfoulk833 folded before Flop (didn't bet)
Seat 4: JJin91 folded before Flop (didn't bet)
Seat 5: bigpond12 mucked [8h Ah]
Seat 6: D.Drumpf folded before Flop (didn't bet)
Seat 7: almeida.matt (button) folded before Flop (didn't bet)
Seat 8: katekars21 (small blind) showed [Th Ac] and won (43500) with a =
pair of Tens
Seat 9: SquadooshBag (big blind) folded before Flop


*********** # 80 **************
PokerStars Hand #169648269516: Tournament #1622537113, $9.10+$0.90 USD =
Hold'em No Limit - Level XVI (600/1200) - 2017/05/09 20:48:31 ET
Table '1622537113 9' 9-max Seat #8 is the button
Seat 1: TrademarkTer (21013 in chips)=20
Seat 2: ReservoirK@ (33099 in chips)=20
Seat 3: kfoulk833 (60996 in chips)=20
Seat 4: JJin91 (28422 in chips)=20
Seat 5: bigpond12 (48693 in chips)=20
Seat 6: D.Drumpf (73114 in chips)=20
Seat 7: almeida.matt (19131 in chips)=20
Seat 8: katekars21 (104869 in chips)=20
Seat 9: SquadooshBag (48340 in chips) is sitting out
TrademarkTer: posts the ante 150
ReservoirK@: posts the ante 150
kfoulk833: posts the ante 150
JJin91: posts the ante 150
bigpond12: posts the ante 150
D.Drumpf: posts the ante 150
almeida.matt: posts the ante 150
katekars21: posts the ante 150
SquadooshBag: posts the ante 150
SquadooshBag: posts small blind 600
TrademarkTer: posts big blind 1200
*** HOLE CARDS ***
Dealt to JJin91 [Td 2h]
ReservoirK@: folds=20
kfoulk833: folds=20
JJin91: folds=20
bigpond12: calls 1200
D.Drumpf: folds=20
almeida.matt: raises 2400 to 3600
katekars21: folds=20
SquadooshBag: folds=20
TrademarkTer: folds=20
bigpond12: calls 2400
*** FLOP *** [2d 5h 5c]
bigpond12: checks=20
almeida.matt: bets 15381 and is all-in
bigpond12: folds=20
Uncalled bet (15381) returned to almeida.matt
almeida.matt collected 10350 from pot
almeida.matt: doesn't show hand=20
*** SUMMARY ***
Total pot 10350 | Rake 0=20
Board [2d 5h 5c]
Seat 1: TrademarkTer (big blind) folded before Flop
Seat 2: ReservoirK@ folded before Flop (didn't bet)
Seat 3: kfoulk833 folded before Flop (didn't bet)
Seat 4: JJin91 folded before Flop (didn't bet)
Seat 5: bigpond12 folded on the Flop
Seat 6: D.Drumpf folded before Flop (didn't bet)
Seat 7: almeida.matt collected (10350)
Seat 8: katekars21 (button) folded before Flop (didn't bet)
Seat 9: SquadooshBag (small blind) folded before Flop


*********** # 81 **************
PokerStars Hand #169648269700: Tournament #1622537113, $9.10+$0.90 USD =
Hold'em No Limit - Level XVI (600/1200) - 2017/05/09 20:49:02 ET
Table '1622537113 9' 9-max Seat #9 is the button
Seat 1: TrademarkTer (19663 in chips)=20
Seat 2: ReservoirK@ (32949 in chips)=20
Seat 3: kfoulk833 (60846 in chips)=20
Seat 4: JJin91 (28272 in chips)=20
Seat 5: bigpond12 (44943 in chips)=20
Seat 6: D.Drumpf (72964 in chips)=20
Seat 7: almeida.matt (25731 in chips)=20
Seat 8: katekars21 (104719 in chips)=20
Seat 9: SquadooshBag (47590 in chips) is sitting out
TrademarkTer: posts the ante 150
ReservoirK@: posts the ante 150
kfoulk833: posts the ante 150
JJin91: posts the ante 150
bigpond12: posts the ante 150
D.Drumpf: posts the ante 150
almeida.matt: posts the ante 150
katekars21: posts the ante 150
SquadooshBag: posts the ante 150
TrademarkTer: posts small blind 600
ReservoirK@: posts big blind 1200
*** HOLE CARDS ***
Dealt to JJin91 [8c Kh]
kfoulk833: folds=20
JJin91: folds=20
bigpond12: calls 1200
D.Drumpf: raises 3000 to 4200
almeida.matt: folds=20
katekars21: folds=20
SquadooshBag: folds=20
TrademarkTer: folds=20
ReservoirK@: folds=20
bigpond12: calls 3000
*** FLOP *** [Qh Td 5d]
bigpond12: checks=20
D.Drumpf: bets 5775
bigpond12: calls 5775
*** TURN *** [Qh Td 5d] [Ah]
bigpond12: checks=20
D.Drumpf: bets 8550
bigpond12: calls 8550
*** RIVER *** [Qh Td 5d Ah] [2d]
bigpond12: bets 26268 and is all-in
D.Drumpf: calls 26268
*** SHOW DOWN ***
bigpond12: shows [3d 6d] (a flush, Ten high)
D.Drumpf: shows [Kc Jd] (a straight, Ten to Ace)
bigpond12 collected 92736 from pot
*** SUMMARY ***
Total pot 92736 | Rake 0=20
Board [Qh Td 5d Ah 2d]
Seat 1: TrademarkTer (small blind) folded before Flop
Seat 2: ReservoirK@ (big blind) folded before Flop
Seat 3: kfoulk833 folded before Flop (didn't bet)
Seat 4: JJin91 folded before Flop (didn't bet)
Seat 5: bigpond12 showed [3d 6d] and won (92736) with a flush, Ten high
Seat 6: D.Drumpf showed [Kc Jd] and lost with a straight, Ten to Ace
Seat 7: almeida.matt folded before Flop (didn't bet)
Seat 8: katekars21 folded before Flop (didn't bet)
Seat 9: SquadooshBag (button) folded before Flop (didn't bet)


*********** # 82 **************
PokerStars Hand #169650007002: Tournament #1622537113, $9.10+$0.90 USD =
Hold'em No Limit - Level XVI (600/1200) - 2017/05/09 20:50:12 ET
Table '1622537113 9' 9-max Seat #1 is the button
Seat 1: TrademarkTer (18913 in chips)=20
Seat 2: ReservoirK@ (31599 in chips)=20
Seat 3: kfoulk833 (60696 in chips)=20
Seat 4: JJin91 (28122 in chips)=20
Seat 5: bigpond12 (92736 in chips)=20
Seat 6: D.Drumpf (28021 in chips)=20
Seat 7: almeida.matt (25581 in chips)=20
Seat 8: katekars21 (104569 in chips)=20
Seat 9: SquadooshBag (47440 in chips) is sitting out
TrademarkTer: posts the ante 150
ReservoirK@: posts the ante 150
kfoulk833: posts the ante 150
JJin91: posts the ante 150
bigpond12: posts the ante 150
D.Drumpf: posts the ante 150
almeida.matt: posts the ante 150
katekars21: posts the ante 150
SquadooshBag: posts the ante 150
ReservoirK@: posts small blind 600
kfoulk833: posts big blind 1200
*** HOLE CARDS ***
Dealt to JJin91 [Tc 9s]
JJin91: folds=20
bigpond12: calls 1200
D.Drumpf: folds=20
almeida.matt: folds=20
katekars21: folds=20
SquadooshBag: folds=20
SquadooshBag has returned
TrademarkTer: raises 17563 to 18763 and is all-in
ReservoirK@: folds=20
kfoulk833: folds=20
bigpond12: folds=20
Uncalled bet (17563) returned to TrademarkTer
TrademarkTer collected 5550 from pot
*** SUMMARY ***
Total pot 5550 | Rake 0=20
Seat 1: TrademarkTer (button) collected (5550)
Seat 2: ReservoirK@ (small blind) folded before Flop
Seat 3: kfoulk833 (big blind) folded before Flop
Seat 4: JJin91 folded before Flop (didn't bet)
Seat 5: bigpond12 folded before Flop
Seat 6: D.Drumpf folded before Flop (didn't bet)
Seat 7: almeida.matt folded before Flop (didn't bet)
Seat 8: katekars21 folded before Flop (didn't bet)
Seat 9: SquadooshBag folded before Flop (didn't bet)


*********** # 83 **************
PokerStars Hand #169650007151: Tournament #1622537113, $9.10+$0.90 USD =
Hold'em No Limit - Level XVI (600/1200) - 2017/05/09 20:50:39 ET
Table '1622537113 9' 9-max Seat #2 is the button
Seat 1: TrademarkTer (23113 in chips)=20
Seat 2: ReservoirK@ (30849 in chips)=20
Seat 3: kfoulk833 (59346 in chips)=20
Seat 4: JJin91 (27972 in chips)=20
Seat 5: bigpond12 (91386 in chips)=20
Seat 6: D.Drumpf (27871 in chips)=20
Seat 7: almeida.matt (25431 in chips)=20
Seat 8: katekars21 (104419 in chips)=20
Seat 9: SquadooshBag (47290 in chips)=20
TrademarkTer: posts the ante 150
ReservoirK@: posts the ante 150
kfoulk833: posts the ante 150
JJin91: posts the ante 150
bigpond12: posts the ante 150
D.Drumpf: posts the ante 150
almeida.matt: posts the ante 150
katekars21: posts the ante 150
SquadooshBag: posts the ante 150
kfoulk833: posts small blind 600
JJin91: posts big blind 1200
*** HOLE CARDS ***
Dealt to JJin91 [Ad 4s]
bigpond12: calls 1200
D.Drumpf: raises 3000 to 4200
almeida.matt: folds=20
katekars21: folds=20
SquadooshBag: folds=20
TrademarkTer: folds=20
ReservoirK@: folds=20
kfoulk833: folds=20
JJin91: folds=20
bigpond12: calls 3000
*** FLOP *** [6h 4h 6d]
bigpond12: checks=20
D.Drumpf: bets 3600
bigpond12: folds=20
Uncalled bet (3600) returned to D.Drumpf
D.Drumpf collected 11550 from pot
D.Drumpf: doesn't show hand=20
*** SUMMARY ***
Total pot 11550 | Rake 0=20
Board [6h 4h 6d]
Seat 1: TrademarkTer folded before Flop (didn't bet)
Seat 2: ReservoirK@ (button) folded before Flop (didn't bet)
Seat 3: kfoulk833 (small blind) folded before Flop
Seat 4: JJin91 (big blind) folded before Flop
Seat 5: bigpond12 folded on the Flop
Seat 6: D.Drumpf collected (11550)
Seat 7: almeida.matt folded before Flop (didn't bet)
Seat 8: katekars21 folded before Flop (didn't bet)
Seat 9: SquadooshBag folded before Flop (didn't bet)


*********** # 84 **************
PokerStars Hand #169650007372: Tournament #1622537113, $9.10+$0.90 USD =
Hold'em No Limit - Level XVI (600/1200) - 2017/05/09 20:51:14 ET
Table '1622537113 9' 9-max Seat #3 is the button
Seat 1: TrademarkTer (22963 in chips)=20
Seat 2: ReservoirK@ (30699 in chips)=20
Seat 3: kfoulk833 (58596 in chips)=20
Seat 4: JJin91 (26622 in chips)=20
Seat 5: bigpond12 (87036 in chips)=20
Seat 6: D.Drumpf (35071 in chips)=20
Seat 7: almeida.matt (25281 in chips)=20
Seat 8: katekars21 (104269 in chips)=20
Seat 9: SquadooshBag (47140 in chips)=20
TrademarkTer: posts the ante 150
ReservoirK@: posts the ante 150
kfoulk833: posts the ante 150
JJin91: posts the ante 150
bigpond12: posts the ante 150
D.Drumpf: posts the ante 150
almeida.matt: posts the ante 150
katekars21: posts the ante 150
SquadooshBag: posts the ante 150
JJin91: posts small blind 600
bigpond12: posts big blind 1200
*** HOLE CARDS ***
Dealt to JJin91 [7c Kd]
D.Drumpf: folds=20
almeida.matt: folds=20
katekars21: calls 1200
SquadooshBag: folds=20
TrademarkTer: calls 1200
ReservoirK@: folds=20
kfoulk833: folds=20
JJin91: folds=20
bigpond12: checks=20
*** FLOP *** [9d Qs 9s]
bigpond12: bets 1200
katekars21: folds=20
TrademarkTer: calls 1200
*** TURN *** [9d Qs 9s] [7h]
bigpond12: bets 1200
TrademarkTer: calls 1200
*** RIVER *** [9d Qs 9s 7h] [4s]
bigpond12: checks=20
TrademarkTer: checks=20
*** SHOW DOWN ***
bigpond12: shows [6s Ah] (a pair of Nines)
TrademarkTer: mucks hand=20
bigpond12 collected 10350 from pot
*** SUMMARY ***
Total pot 10350 | Rake 0=20
Board [9d Qs 9s 7h 4s]
Seat 1: TrademarkTer mucked [Jd Td]
Seat 2: ReservoirK@ folded before Flop (didn't bet)
Seat 3: kfoulk833 (button) folded before Flop (didn't bet)
Seat 4: JJin91 (small blind) folded before Flop
Seat 5: bigpond12 (big blind) showed [6s Ah] and won (10350) with a pai=
r of Nines
Seat 6: D.Drumpf folded before Flop (didn't bet)
Seat 7: almeida.matt folded before Flop (didn't bet)
Seat 8: katekars21 folded on the Flop
Seat 9: SquadooshBag folded before Flop (didn't bet)


*********** # 85 **************
PokerStars Hand #169650007648: Tournament #1622537113, $9.10+$0.90 USD =
Hold'em No Limit - Level XVII (700/1400) - 2017/05/09 20:52:00 ET
Table '1622537113 9' 9-max Seat #4 is the button
Seat 1: TrademarkTer (19213 in chips)=20
Seat 2: ReservoirK@ (30549 in chips)=20
Seat 3: kfoulk833 (58446 in chips)=20
Seat 4: JJin91 (25872 in chips)=20
Seat 5: bigpond12 (93636 in chips)=20
Seat 6: D.Drumpf (34921 in chips)=20
Seat 7: almeida.matt (25131 in chips)=20
Seat 8: katekars21 (102919 in chips)=20
Seat 9: SquadooshBag (46990 in chips)=20
TrademarkTer: posts the ante 175
ReservoirK@: posts the ante 175
kfoulk833: posts the ante 175
JJin91: posts the ante 175
bigpond12: posts the ante 175
D.Drumpf: posts the ante 175
almeida.matt: posts the ante 175
katekars21: posts the ante 175
SquadooshBag: posts the ante 175
bigpond12: posts small blind 700
D.Drumpf: posts big blind 1400
*** HOLE CARDS ***
Dealt to JJin91 [8c 4c]
almeida.matt: folds=20
katekars21: folds=20
SquadooshBag: folds=20
TrademarkTer: folds=20
ReservoirK@: folds=20
kfoulk833: raises 1400 to 2800
JJin91: folds=20
bigpond12: calls 2100
D.Drumpf: folds=20
*** FLOP *** [3d 3s 9d]
bigpond12: checks=20
kfoulk833: checks=20
*** TURN *** [3d 3s 9d] [2h]
bigpond12: checks=20
kfoulk833: bets 2800
bigpond12: calls 2800
*** RIVER *** [3d 3s 9d 2h] [4h]
bigpond12: checks=20
kfoulk833: bets 5600
bigpond12: folds=20
Uncalled bet (5600) returned to kfoulk833
kfoulk833 collected 14175 from pot
kfoulk833: doesn't show hand=20
*** SUMMARY ***
Total pot 14175 | Rake 0=20
Board [3d 3s 9d 2h 4h]
Seat 1: TrademarkTer folded before Flop (didn't bet)
Seat 2: ReservoirK@ folded before Flop (didn't bet)
Seat 3: kfoulk833 collected (14175)
Seat 4: JJin91 (button) folded before Flop (didn't bet)
Seat 5: bigpond12 (small blind) folded on the River
Seat 6: D.Drumpf (big blind) folded before Flop
Seat 7: almeida.matt folded before Flop (didn't bet)
Seat 8: katekars21 folded before Flop (didn't bet)
Seat 9: SquadooshBag folded before Flop (didn't bet)


*********** # 86 **************
PokerStars Hand #169650007937: Tournament #1622537113, $9.10+$0.90 USD =
Hold'em No Limit - Level XVII (700/1400) - 2017/05/09 20:52:49 ET
Table '1622537113 9' 9-max Seat #5 is the button
Seat 1: TrademarkTer (19038 in chips)=20
Seat 2: ReservoirK@ (30374 in chips)=20
Seat 3: kfoulk833 (66846 in chips)=20
Seat 4: JJin91 (25697 in chips)=20
Seat 5: bigpond12 (87861 in chips)=20
Seat 6: D.Drumpf (33346 in chips)=20
Seat 7: almeida.matt (24956 in chips)=20
Seat 8: katekars21 (102744 in chips)=20
Seat 9: SquadooshBag (46815 in chips)=20
TrademarkTer: posts the ante 175
ReservoirK@: posts the ante 175
kfoulk833: posts the ante 175
JJin91: posts the ante 175
bigpond12: posts the ante 175
D.Drumpf: posts the ante 175
almeida.matt: posts the ante 175
katekars21: posts the ante 175
SquadooshBag: posts the ante 175
D.Drumpf: posts small blind 700
almeida.matt: posts big blind 1400
*** HOLE CARDS ***
Dealt to JJin91 [2c 6d]
katekars21: calls 1400
SquadooshBag: folds=20
TrademarkTer: folds=20
ReservoirK@: folds=20
kfoulk833: folds=20
JJin91: folds=20
bigpond12: folds=20
D.Drumpf: calls 700
almeida.matt: checks=20
*** FLOP *** [Jh Ah 7d]
D.Drumpf: checks=20
almeida.matt: checks=20
katekars21: checks=20
*** TURN *** [Jh Ah 7d] [Ad]
D.Drumpf: bets 2188
almeida.matt: folds=20
katekars21: calls 2188
*** RIVER *** [Jh Ah 7d Ad] [Kc]
D.Drumpf: bets 4200
katekars21: folds=20
Uncalled bet (4200) returned to D.Drumpf
D.Drumpf collected 10151 from pot
D.Drumpf: doesn't show hand=20
*** SUMMARY ***
Total pot 10151 | Rake 0=20
Board [Jh Ah 7d Ad Kc]
Seat 1: TrademarkTer folded before Flop (didn't bet)
Seat 2: ReservoirK@ folded before Flop (didn't bet)
Seat 3: kfoulk833 folded before Flop (didn't bet)
Seat 4: JJin91 folded before Flop (didn't bet)
Seat 5: bigpond12 (button) folded before Flop (didn't bet)
Seat 6: D.Drumpf (small blind) collected (10151)
Seat 7: almeida.matt (big blind) folded on the Turn
Seat 8: katekars21 folded on the River
Seat 9: SquadooshBag folded before Flop (didn't bet)


*********** # 87 **************
PokerStars Hand #169650008369: Tournament #1622537113, $9.10+$0.90 USD =
Hold'em No Limit - Level XVII (700/1400) - 2017/05/09 20:54:03 ET
Table '1622537113 9' 9-max Seat #6 is the button
Seat 1: TrademarkTer (18863 in chips)=20
Seat 2: ReservoirK@ (30199 in chips)=20
Seat 3: kfoulk833 (66671 in chips)=20
Seat 4: JJin91 (25522 in chips)=20
Seat 5: bigpond12 (87686 in chips)=20
Seat 6: D.Drumpf (39734 in chips)=20
Seat 7: almeida.matt (23381 in chips)=20
Seat 9: SquadooshBag (46640 in chips)=20
TrademarkTer: posts the ante 175
ReservoirK@: posts the ante 175
kfoulk833: posts the ante 175
JJin91: posts the ante 175
bigpond12: posts the ante 175
D.Drumpf: posts the ante 175
almeida.matt: posts the ante 175
SquadooshBag: posts the ante 175
almeida.matt: posts small blind 700
SquadooshBag: posts big blind 1400
*** HOLE CARDS ***
Dealt to JJin91 [9h 6h]
TrademarkTer: folds=20
ReservoirK@: raises 1625 to 3025
kfoulk833: folds=20
JJin91: folds=20
bigpond12: calls 3025
D.Drumpf: folds=20
almeida.matt: folds=20
SquadooshBag: calls 1625
*** FLOP *** [8c Ac 6d]
SquadooshBag: bets 2800
ReservoirK@: folds=20
bigpond12: calls 2800
*** TURN *** [8c Ac 6d] [3s]
SquadooshBag: checks=20
bigpond12: bets 5600
SquadooshBag: folds=20
Uncalled bet (5600) returned to bigpond12
bigpond12 collected 16775 from pot
bigpond12: doesn't show hand=20
*** SUMMARY ***
Total pot 16775 | Rake 0=20
Board [8c Ac 6d 3s]
Seat 1: TrademarkTer folded before Flop (didn't bet)
Seat 2: ReservoirK@ folded on the Flop
Seat 3: kfoulk833 folded before Flop (didn't bet)
Seat 4: JJin91 folded before Flop (didn't bet)
Seat 5: bigpond12 collected (16775)
Seat 6: D.Drumpf (button) folded before Flop (didn't bet)
Seat 7: almeida.matt (small blind) folded before Flop
Seat 9: SquadooshBag (big blind) folded on the Turn


*********** # 88 **************
PokerStars Hand #169650585133: Tournament #1622537113, $9.10+$0.90 USD =
Hold'em No Limit - Level XVII (700/1400) - 2017/05/09 21:00:30 ET
Table '1622537113 9' 9-max Seat #7 is the button
Seat 1: TrademarkTer (18688 in chips)=20
Seat 2: ReservoirK@ (26999 in chips)=20
Seat 3: kfoulk833 (66496 in chips)=20
Seat 4: JJin91 (25347 in chips)=20
Seat 5: bigpond12 (98461 in chips)=20
Seat 6: D.Drumpf (39559 in chips)=20
Seat 7: almeida.matt (22506 in chips)=20
Seat 9: SquadooshBag (40640 in chips)=20
TrademarkTer: posts the ante 175
ReservoirK@: posts the ante 175
kfoulk833: posts the ante 175
JJin91: posts the ante 175
bigpond12: posts the ante 175
D.Drumpf: posts the ante 175
almeida.matt: posts the ante 175
SquadooshBag: posts the ante 175
SquadooshBag: posts small blind 700
TrademarkTer: posts big blind 1400
*** HOLE CARDS ***
Dealt to JJin91 [6c Td]
ReservoirK@: folds=20
kfoulk833: raises 1400 to 2800
JJin91: folds=20
bigpond12: calls 2800
D.Drumpf: folds=20
almeida.matt: calls 2800
SquadooshBag: calls 2100
TrademarkTer: folds=20
*** FLOP *** [Kh 9c 4s]
SquadooshBag: checks=20
kfoulk833: checks=20
bigpond12: bets 5600
almeida.matt: raises 13931 to 19531 and is all-in
SquadooshBag: folds=20
kfoulk833: folds=20
bigpond12: folds=20
Uncalled bet (13931) returned to almeida.matt
almeida.matt collected 25200 from pot
almeida.matt: doesn't show hand=20
*** SUMMARY ***
Total pot 25200 | Rake 0=20
Board [Kh 9c 4s]
Seat 1: TrademarkTer (big blind) folded before Flop
Seat 2: ReservoirK@ folded before Flop (didn't bet)
Seat 3: kfoulk833 folded on the Flop
Seat 4: JJin91 folded before Flop (didn't bet)
Seat 5: bigpond12 folded on the Flop
Seat 6: D.Drumpf folded before Flop (didn't bet)
Seat 7: almeida.matt (button) collected (25200)
Seat 9: SquadooshBag (small blind) folded on the Flop


*********** # 89 **************
PokerStars Hand #169650585563: Tournament #1622537113, $9.10+$0.90 USD =
Hold'em No Limit - Level XVII (700/1400) - 2017/05/09 21:01:53 ET
Table '1622537113 9' 9-max Seat #9 is the button
Seat 1: TrademarkTer (17113 in chips)=20
Seat 2: ReservoirK@ (26824 in chips)=20
Seat 3: kfoulk833 (63521 in chips)=20
Seat 4: JJin91 (25172 in chips)=20
Seat 5: bigpond12 (89886 in chips)=20
Seat 6: D.Drumpf (39384 in chips)=20
Seat 7: almeida.matt (39131 in chips)=20
Seat 9: SquadooshBag (37665 in chips)=20
TrademarkTer: posts the ante 175
ReservoirK@: posts the ante 175
kfoulk833: posts the ante 175
JJin91: posts the ante 175
bigpond12: posts the ante 175
D.Drumpf: posts the ante 175
almeida.matt: posts the ante 175
SquadooshBag: posts the ante 175
TrademarkTer: posts small blind 700
ReservoirK@: posts big blind 1400
*** HOLE CARDS ***
Dealt to JJin91 [9s 5h]
kfoulk833: folds=20
JJin91: folds=20
bigpond12: calls 1400
D.Drumpf: folds=20
almeida.matt: folds=20
SquadooshBag: calls 1400
TrademarkTer: calls 700
ReservoirK@: checks=20
*** FLOP *** [9d Ac Ah]
TrademarkTer: checks=20
ReservoirK@: checks=20
bigpond12: bets 1400
SquadooshBag: raises 1400 to 2800
TrademarkTer: folds=20
ReservoirK@: folds=20
bigpond12: folds=20
Uncalled bet (1400) returned to SquadooshBag
SquadooshBag collected 9800 from pot
SquadooshBag: doesn't show hand=20
*** SUMMARY ***
Total pot 9800 | Rake 0=20
Board [9d Ac Ah]
Seat 1: TrademarkTer (small blind) folded on the Flop
Seat 2: ReservoirK@ (big blind) folded on the Flop
Seat 3: kfoulk833 folded before Flop (didn't bet)
Seat 4: JJin91 folded before Flop (didn't bet)
Seat 5: bigpond12 folded on the Flop
Seat 6: D.Drumpf folded before Flop (didn't bet)
Seat 7: almeida.matt folded before Flop (didn't bet)
Seat 9: SquadooshBag (button) collected (9800)


*********** # 90 **************
PokerStars Hand #169650586001: Tournament #1622537113, $9.10+$0.90 USD =
Hold'em No Limit - Level XVII (700/1400) - 2017/05/09 21:03:12 ET
Table '1622537113 9' 9-max Seat #1 is the button
Seat 1: TrademarkTer (15538 in chips)=20
Seat 2: ReservoirK@ (25249 in chips)=20
Seat 3: kfoulk833 (63346 in chips)=20
Seat 4: JJin91 (24997 in chips)=20
Seat 5: bigpond12 (86911 in chips)=20
Seat 6: D.Drumpf (39209 in chips)=20
Seat 7: almeida.matt (38956 in chips)=20
Seat 9: SquadooshBag (44490 in chips)=20
TrademarkTer: posts the ante 175
ReservoirK@: posts the ante 175
kfoulk833: posts the ante 175
JJin91: posts the ante 175
bigpond12: posts the ante 175
D.Drumpf: posts the ante 175
almeida.matt: posts the ante 175
SquadooshBag: posts the ante 175
ReservoirK@: posts small blind 700
kfoulk833: posts big blind 1400
*** HOLE CARDS ***
Dealt to JJin91 [Qh 4c]
JJin91: folds=20
bigpond12: calls 1400
D.Drumpf: folds=20
almeida.matt: folds=20
SquadooshBag: folds=20
TrademarkTer: folds=20
ReservoirK@: calls 700
kfoulk833: checks=20
*** FLOP *** [Ac Ts Kd]
ReservoirK@: checks=20
kfoulk833: checks=20
bigpond12: bets 2800
ReservoirK@: folds=20
kfoulk833: folds=20
Uncalled bet (2800) returned to bigpond12
bigpond12 collected 5600 from pot
bigpond12: doesn't show hand=20
*** SUMMARY ***
Total pot 5600 | Rake 0=20
Board [Ac Ts Kd]
Seat 1: TrademarkTer (button) folded before Flop (didn't bet)
Seat 2: ReservoirK@ (small blind) folded on the Flop
Seat 3: kfoulk833 (big blind) folded on the Flop
Seat 4: JJin91 folded before Flop (didn't bet)
Seat 5: bigpond12 collected (5600)
Seat 6: D.Drumpf folded before Flop (didn't bet)
Seat 7: almeida.matt folded before Flop (didn't bet)
Seat 9: SquadooshBag folded before Flop (didn't bet)


*********** # 91 **************
PokerStars Hand #169650586514: Tournament #1622537113, $9.10+$0.90 USD =
Hold'em No Limit - Level XVII (700/1400) - 2017/05/09 21:04:33 ET
Table '1622537113 9' 9-max Seat #2 is the button
Seat 1: TrademarkTer (15363 in chips)=20
Seat 2: ReservoirK@ (23674 in chips)=20
Seat 3: kfoulk833 (61771 in chips)=20
Seat 4: JJin91 (24822 in chips)=20
Seat 5: bigpond12 (90936 in chips)=20
Seat 6: D.Drumpf (39034 in chips)=20
Seat 7: almeida.matt (38781 in chips)=20
Seat 9: SquadooshBag (44315 in chips)=20
TrademarkTer: posts the ante 175
ReservoirK@: posts the ante 175
kfoulk833: posts the ante 175
JJin91: posts the ante 175
bigpond12: posts the ante 175
D.Drumpf: posts the ante 175
almeida.matt: posts the ante 175
SquadooshBag: posts the ante 175
kfoulk833: posts small blind 700
JJin91: posts big blind 1400
*** HOLE CARDS ***
Dealt to JJin91 [Kh 5h]
bigpond12: calls 1400
D.Drumpf: folds=20
almeida.matt: folds=20
SquadooshBag: folds=20
TrademarkTer: folds=20
ReservoirK@: folds=20
kfoulk833: folds=20
JJin91: checks=20
*** FLOP *** [5c 7c 6s]
JJin91: checks=20
bigpond12: bets 2800
JJin91: calls 2800
*** TURN *** [5c 7c 6s] [3s]
JJin91: checks=20
bigpond12: bets 7000
JJin91: folds=20
Uncalled bet (7000) returned to bigpond12
bigpond12 collected 10500 from pot
bigpond12: doesn't show hand=20
*** SUMMARY ***
Total pot 10500 | Rake 0=20
Board [5c 7c 6s 3s]
Seat 1: TrademarkTer folded before Flop (didn't bet)
Seat 2: ReservoirK@ (button) folded before Flop (didn't bet)
Seat 3: kfoulk833 (small blind) folded before Flop
Seat 4: JJin91 (big blind) folded on the Turn
Seat 5: bigpond12 collected (10500)
Seat 6: D.Drumpf folded before Flop (didn't bet)
Seat 7: almeida.matt folded before Flop (didn't bet)
Seat 9: SquadooshBag folded before Flop (didn't bet)


*********** # 92 **************
PokerStars Hand #169650587064: Tournament #1622537113, $9.10+$0.90 USD =
Hold'em No Limit - Level XVII (700/1400) - 2017/05/09 21:06:10 ET
Table '1622537113 9' 9-max Seat #3 is the button
Seat 1: TrademarkTer (15188 in chips)=20
Seat 2: ReservoirK@ (23499 in chips)=20
Seat 3: kfoulk833 (60896 in chips)=20
Seat 4: JJin91 (20447 in chips)=20
Seat 5: bigpond12 (97061 in chips)=20
Seat 6: D.Drumpf (38859 in chips)=20
Seat 7: almeida.matt (38606 in chips)=20
Seat 9: SquadooshBag (44140 in chips)=20
TrademarkTer: posts the ante 175
ReservoirK@: posts the ante 175
kfoulk833: posts the ante 175
JJin91: posts the ante 175
bigpond12: posts the ante 175
D.Drumpf: posts the ante 175
almeida.matt: posts the ante 175
SquadooshBag: posts the ante 175
JJin91: posts small blind 700
bigpond12: posts big blind 1400
*** HOLE CARDS ***
Dealt to JJin91 [Jh 3s]
D.Drumpf: raises 1400 to 2800
almeida.matt: folds=20
SquadooshBag: folds=20
TrademarkTer: folds=20
ReservoirK@: folds=20
kfoulk833: folds=20
JJin91: folds=20
bigpond12: calls 1400
*** FLOP *** [Tc 7d 5d]
bigpond12: checks=20
D.Drumpf: bets 3150
bigpond12: folds=20
Uncalled bet (3150) returned to D.Drumpf
D.Drumpf collected 7700 from pot
D.Drumpf: doesn't show hand=20
*** SUMMARY ***
Total pot 7700 | Rake 0=20
Board [Tc 7d 5d]
Seat 1: TrademarkTer folded before Flop (didn't bet)
Seat 2: ReservoirK@ folded before Flop (didn't bet)
Seat 3: kfoulk833 (button) folded before Flop (didn't bet)
Seat 4: JJin91 (small blind) folded before Flop
Seat 5: bigpond12 (big blind) folded on the Flop
Seat 6: D.Drumpf collected (7700)
Seat 7: almeida.matt folded before Flop (didn't bet)
Seat 9: SquadooshBag folded before Flop (didn't bet)


*********** # 93 **************
PokerStars Hand #169650587347: Tournament #1622537113, $9.10+$0.90 USD =
Hold'em No Limit - Level XVII (700/1400) - 2017/05/09 21:06:59 ET
Table '1622537113 9' 9-max Seat #4 is the button
Seat 1: TrademarkTer (15013 in chips)=20
Seat 2: ReservoirK@ (23324 in chips)=20
Seat 3: kfoulk833 (60721 in chips)=20
Seat 4: JJin91 (19572 in chips)=20
Seat 5: bigpond12 (94086 in chips)=20
Seat 6: D.Drumpf (43584 in chips)=20
Seat 7: almeida.matt (38431 in chips)=20
Seat 9: SquadooshBag (43965 in chips)=20
TrademarkTer: posts the ante 175
ReservoirK@: posts the ante 175
kfoulk833: posts the ante 175
JJin91: posts the ante 175
bigpond12: posts the ante 175
D.Drumpf: posts the ante 175
almeida.matt: posts the ante 175
SquadooshBag: posts the ante 175
bigpond12: posts small blind 700
D.Drumpf: posts big blind 1400
*** HOLE CARDS ***
Dealt to JJin91 [Td 6s]
almeida.matt: folds=20
SquadooshBag is disconnected=20
SquadooshBag has timed out while disconnected
SquadooshBag: folds=20
SquadooshBag is sitting out
TrademarkTer: folds=20
ReservoirK@: raises 1750 to 3150
kfoulk833: folds=20
JJin91: folds=20
bigpond12: calls 2450
SquadooshBag has returned
D.Drumpf: folds=20
*** FLOP *** [9s Jc 4d]
bigpond12: checks=20
ReservoirK@: checks=20
*** TURN *** [9s Jc 4d] [9d]
bigpond12: bets 2800
ReservoirK@: calls 2800
*** RIVER *** [9s Jc 4d 9d] [7d]
bigpond12: bets 1400
ReservoirK@: calls 1400
*** SHOW DOWN ***
bigpond12: shows [Jh Ah] (two pair, Jacks and Nines)
ReservoirK@: mucks hand=20
bigpond12 collected 17500 from pot
*** SUMMARY ***
Total pot 17500 | Rake 0=20
Board [9s Jc 4d 9d 7d]
Seat 1: TrademarkTer folded before Flop (didn't bet)
Seat 2: ReservoirK@ mucked [As Qd]
Seat 3: kfoulk833 folded before Flop (didn't bet)
Seat 4: JJin91 (button) folded before Flop (didn't bet)
Seat 5: bigpond12 (small blind) showed [Jh Ah] and won (17500) with two=
 pair, Jacks and Nines
Seat 6: D.Drumpf (big blind) folded before Flop
Seat 7: almeida.matt folded before Flop (didn't bet)
Seat 9: SquadooshBag folded before Flop (didn't bet)


*********** # 94 **************
PokerStars Hand #169650587958: Tournament #1622537113, $9.10+$0.90 USD =
Hold'em No Limit - Level XVIII (800/1600) - 2017/05/09 21:08:42 ET
Table '1622537113 7' 9-max Seat #8 is the button
Seat 1: cl1ckinbtns (40579 in chips)=20
Seat 2: katekars21 (100980 in chips)=20
Seat 3: SneakyPete85 (81882 in chips)=20
Seat 6: RunninItUp98 (55070 in chips)=20
Seat 7: kptrpt (40390 in chips)=20
Seat 8: MoZZyNJ (160388 in chips)=20
Seat 9: JJin91 (19397 in chips) out of hand (moved from another table i=
nto small blind)
cl1ckinbtns: posts the ante 200
katekars21: posts the ante 200
SneakyPete85: posts the ante 200
RunninItUp98: posts the ante 200
kptrpt: posts the ante 200
MoZZyNJ: posts the ante 200
cl1ckinbtns: posts small blind 800
katekars21: posts big blind 1600
*** HOLE CARDS ***
SneakyPete85: folds=20
RunninItUp98: raises 2080 to 3680
kptrpt: folds=20
MoZZyNJ: raises 4320 to 8000
cl1ckinbtns: raises 32379 to 40379 and is all-in
katekars21: folds=20
RunninItUp98: folds=20
MoZZyNJ: folds=20
Uncalled bet (32379) returned to cl1ckinbtns
cl1ckinbtns collected 22480 from pot
*** SUMMARY ***
Total pot 22480 | Rake 0=20
Seat 1: cl1ckinbtns (small blind) collected (22480)
Seat 2: katekars21 (big blind) folded before Flop
Seat 3: SneakyPete85 folded before Flop (didn't bet)
Seat 6: RunninItUp98 folded before Flop
Seat 7: kptrpt folded before Flop (didn't bet)
Seat 8: MoZZyNJ (button) folded before Flop


*********** # 95 **************
PokerStars Hand #169650588206: Tournament #1622537113, $9.10+$0.90 USD =
Hold'em No Limit - Level XVIII (800/1600) - 2017/05/09 21:09:14 ET
Table '1622537113 7' 9-max Seat #1 is the button
Seat 1: cl1ckinbtns (54859 in chips)=20
Seat 2: katekars21 (99180 in chips)=20
Seat 3: SneakyPete85 (81682 in chips)=20
Seat 6: RunninItUp98 (51190 in chips)=20
Seat 7: kptrpt (40190 in chips)=20
Seat 8: MoZZyNJ (152188 in chips)=20
Seat 9: JJin91 (19397 in chips)=20
cl1ckinbtns: posts the ante 200
katekars21: posts the ante 200
SneakyPete85: posts the ante 200
RunninItUp98: posts the ante 200
kptrpt: posts the ante 200
MoZZyNJ: posts the ante 200
JJin91: posts the ante 200
katekars21: posts small blind 800
SneakyPete85: posts big blind 1600
*** HOLE CARDS ***
Dealt to JJin91 [Js 6d]
RunninItUp98: folds=20
kptrpt: folds=20
MoZZyNJ: folds=20
JJin91: folds=20
cl1ckinbtns: folds=20
katekars21: calls 800
SneakyPete85: raises 3200 to 4800
katekars21: calls 3200
*** FLOP *** [Th Jh 6s]
katekars21: checks=20
SneakyPete85: checks=20
*** TURN *** [Th Jh 6s] [9d]
katekars21: bets 3200
SneakyPete85: folds=20
Uncalled bet (3200) returned to katekars21
katekars21 collected 11000 from pot
katekars21: doesn't show hand=20
*** SUMMARY ***
Total pot 11000 | Rake 0=20
Board [Th Jh 6s 9d]
Seat 1: cl1ckinbtns (button) folded before Flop (didn't bet)
Seat 2: katekars21 (small blind) collected (11000)
Seat 3: SneakyPete85 (big blind) folded on the Turn
Seat 6: RunninItUp98 folded before Flop (didn't bet)
Seat 7: kptrpt folded before Flop (didn't bet)
Seat 8: MoZZyNJ folded before Flop (didn't bet)
Seat 9: JJin91 folded before Flop (didn't bet)


*********** # 96 **************
PokerStars Hand #169650588470: Tournament #1622537113, $9.10+$0.90 USD =
Hold'em No Limit - Level XVIII (800/1600) - 2017/05/09 21:09:52 ET
Table '1622537113 7' 9-max Seat #2 is the button
Seat 1: cl1ckinbtns (54659 in chips)=20
Seat 2: katekars21 (105180 in chips)=20
Seat 3: SneakyPete85 (76682 in chips)=20
Seat 6: RunninItUp98 (50990 in chips)=20
Seat 7: kptrpt (39990 in chips)=20
Seat 8: MoZZyNJ (151988 in chips)=20
Seat 9: JJin91 (19197 in chips)=20
cl1ckinbtns: posts the ante 200
katekars21: posts the ante 200
SneakyPete85: posts the ante 200
RunninItUp98: posts the ante 200
kptrpt: posts the ante 200
MoZZyNJ: posts the ante 200
JJin91: posts the ante 200
SneakyPete85: posts small blind 800
RunninItUp98: posts big blind 1600
*** HOLE CARDS ***
Dealt to JJin91 [3h 8h]
kptrpt: folds=20
MoZZyNJ: folds=20
JJin91: folds=20
cl1ckinbtns: folds=20
katekars21: raises 1600 to 3200
SneakyPete85: raises 8000 to 11200
RunninItUp98: folds=20
katekars21: calls 8000
*** FLOP *** [5c Jc Kh]
SneakyPete85: bets 12700
katekars21: calls 12700
*** TURN *** [5c Jc Kh] [5s]
SneakyPete85: checks=20
katekars21: bets 9600
SneakyPete85: folds=20
Uncalled bet (9600) returned to katekars21
katekars21 collected 50800 from pot
katekars21: doesn't show hand=20
*** SUMMARY ***
Total pot 50800 | Rake 0=20
Board [5c Jc Kh 5s]
Seat 1: cl1ckinbtns folded before Flop (didn't bet)
Seat 2: katekars21 (button) collected (50800)
Seat 3: SneakyPete85 (small blind) folded on the Turn
Seat 6: RunninItUp98 (big blind) folded before Flop
Seat 7: kptrpt folded before Flop (didn't bet)
Seat 8: MoZZyNJ folded before Flop (didn't bet)
Seat 9: JJin91 folded before Flop (didn't bet)


*********** # 97 **************
PokerStars Hand #169650588874: Tournament #1622537113, $9.10+$0.90 USD =
Hold'em No Limit - Level XVIII (800/1600) - 2017/05/09 21:10:49 ET
Table '1622537113 7' 9-max Seat #3 is the button
Seat 1: cl1ckinbtns (54459 in chips)=20
Seat 2: katekars21 (131880 in chips)=20
Seat 3: SneakyPete85 (52582 in chips)=20
Seat 6: RunninItUp98 (49190 in chips)=20
Seat 7: kptrpt (39790 in chips)=20
Seat 8: MoZZyNJ (151788 in chips)=20
Seat 9: JJin91 (18997 in chips)=20
cl1ckinbtns: posts the ante 200
katekars21: posts the ante 200
SneakyPete85: posts the ante 200
RunninItUp98: posts the ante 200
kptrpt: posts the ante 200
MoZZyNJ: posts the ante 200
JJin91: posts the ante 200
RunninItUp98: posts small blind 800
kptrpt: posts big blind 1600
*** HOLE CARDS ***
Dealt to JJin91 [7s 6c]
MoZZyNJ: folds=20
JJin91: folds=20
cl1ckinbtns: raises 1750 to 3350
katekars21: folds=20
SneakyPete85: folds=20
RunninItUp98: raises 4450 to 7800
kptrpt: folds=20
cl1ckinbtns: calls 4450
*** FLOP *** [Kc Ac Ad]
RunninItUp98: checks=20
cl1ckinbtns: checks=20
*** TURN *** [Kc Ac Ad] [Qc]
RunninItUp98: checks=20
cl1ckinbtns: checks=20
*** RIVER *** [Kc Ac Ad Qc] [6s]
RunninItUp98: bets 9875
cl1ckinbtns: folds=20
Uncalled bet (9875) returned to RunninItUp98
RunninItUp98 collected 18600 from pot
RunninItUp98: doesn't show hand=20
*** SUMMARY ***
Total pot 18600 | Rake 0=20
Board [Kc Ac Ad Qc 6s]
Seat 1: cl1ckinbtns folded on the River
Seat 2: katekars21 folded before Flop (didn't bet)
Seat 3: SneakyPete85 (button) folded before Flop (didn't bet)
Seat 6: RunninItUp98 (small blind) collected (18600)
Seat 7: kptrpt (big blind) folded before Flop
Seat 8: MoZZyNJ folded before Flop (didn't bet)
Seat 9: JJin91 folded before Flop (didn't bet)


*********** # 98 **************
PokerStars Hand #169650589290: Tournament #1622537113, $9.10+$0.90 USD =
Hold'em No Limit - Level XVIII (800/1600) - 2017/05/09 21:11:47 ET
Table '1622537113 7' 9-max Seat #6 is the button
Seat 1: cl1ckinbtns (46459 in chips)=20
Seat 2: katekars21 (131680 in chips)=20
Seat 3: SneakyPete85 (52382 in chips)=20
Seat 6: RunninItUp98 (59790 in chips)=20
Seat 7: kptrpt (37990 in chips)=20
Seat 8: MoZZyNJ (151588 in chips)=20
Seat 9: JJin91 (18797 in chips)=20
cl1ckinbtns: posts the ante 200
katekars21: posts the ante 200
SneakyPete85: posts the ante 200
RunninItUp98: posts the ante 200
kptrpt: posts the ante 200
MoZZyNJ: posts the ante 200
JJin91: posts the ante 200
kptrpt: posts small blind 800
MoZZyNJ: posts big blind 1600
*** HOLE CARDS ***
Dealt to JJin91 [3h 2c]
JJin91: folds=20
cl1ckinbtns: folds=20
katekars21: folds=20
SneakyPete85: folds=20
RunninItUp98: raises 2080 to 3680
kptrpt: folds=20
MoZZyNJ: calls 2080
*** FLOP *** [Jh Qc Ts]
MoZZyNJ: checks=20
RunninItUp98: checks=20
*** TURN *** [Jh Qc Ts] [9d]
MoZZyNJ: checks=20
RunninItUp98: checks=20
*** RIVER *** [Jh Qc Ts 9d] [9c]
MoZZyNJ: checks=20
RunninItUp98: checks=20
*** SHOW DOWN ***
MoZZyNJ: shows [4h Th] (two pair, Tens and Nines)
RunninItUp98: mucks hand=20
MoZZyNJ collected 9560 from pot
*** SUMMARY ***
Total pot 9560 | Rake 0=20
Board [Jh Qc Ts 9d 9c]
Seat 1: cl1ckinbtns folded before Flop (didn't bet)
Seat 2: katekars21 folded before Flop (didn't bet)
Seat 3: SneakyPete85 folded before Flop (didn't bet)
Seat 6: RunninItUp98 (button) mucked [7s As]
Seat 7: kptrpt (small blind) folded before Flop
Seat 8: MoZZyNJ (big blind) showed [4h Th] and won (9560) with two pair=
, Tens and Nines
Seat 9: JJin91 folded before Flop (didn't bet)


*********** # 99 **************
PokerStars Hand #169650589571: Tournament #1622537113, $9.10+$0.90 USD =
Hold'em No Limit - Level XVIII (800/1600) - 2017/05/09 21:12:27 ET
Table '1622537113 7' 9-max Seat #7 is the button
Seat 1: cl1ckinbtns (46259 in chips)=20
Seat 2: katekars21 (131480 in chips)=20
Seat 3: SneakyPete85 (52182 in chips)=20
Seat 6: RunninItUp98 (55910 in chips)=20
Seat 7: kptrpt (36990 in chips)=20
Seat 8: MoZZyNJ (157268 in chips)=20
Seat 9: JJin91 (18597 in chips)=20
cl1ckinbtns: posts the ante 200
katekars21: posts the ante 200
SneakyPete85: posts the ante 200
RunninItUp98: posts the ante 200
kptrpt: posts the ante 200
MoZZyNJ: posts the ante 200
JJin91: posts the ante 200
MoZZyNJ: posts small blind 800
JJin91: posts big blind 1600
*** HOLE CARDS ***
Dealt to JJin91 [4s 6s]
cl1ckinbtns: folds=20
katekars21: folds=20
SneakyPete85: folds=20
RunninItUp98: raises 2080 to 3680
kptrpt: folds=20
MoZZyNJ: folds=20
JJin91: folds=20
Uncalled bet (2080) returned to RunninItUp98
RunninItUp98 collected 5400 from pot
RunninItUp98: doesn't show hand=20
*** SUMMARY ***
Total pot 5400 | Rake 0=20
Seat 1: cl1ckinbtns folded before Flop (didn't bet)
Seat 2: katekars21 folded before Flop (didn't bet)
Seat 3: SneakyPete85 folded before Flop (didn't bet)
Seat 6: RunninItUp98 collected (5400)
Seat 7: kptrpt (button) folded before Flop (didn't bet)
Seat 8: MoZZyNJ (small blind) folded before Flop
Seat 9: JJin91 (big blind) folded before Flop


*********** # 100 **************
PokerStars Hand #169650589718: Tournament #1622537113, $9.10+$0.90 USD =
Hold'em No Limit - Level XVIII (800/1600) - 2017/05/09 21:12:48 ET
Table '1622537113 7' 9-max Seat #8 is the button
Seat 1: cl1ckinbtns (46059 in chips)=20
Seat 2: katekars21 (131280 in chips)=20
Seat 3: SneakyPete85 (51982 in chips)=20
Seat 6: RunninItUp98 (59510 in chips)=20
Seat 7: kptrpt (36790 in chips)=20
Seat 8: MoZZyNJ (156268 in chips)=20
Seat 9: JJin91 (16797 in chips)=20
cl1ckinbtns: posts the ante 200
katekars21: posts the ante 200
SneakyPete85: posts the ante 200
RunninItUp98: posts the ante 200
kptrpt: posts the ante 200
MoZZyNJ: posts the ante 200
JJin91: posts the ante 200
JJin91: posts small blind 800
cl1ckinbtns: posts big blind 1600
*** HOLE CARDS ***
Dealt to JJin91 [5c Jc]
katekars21: folds=20
SneakyPete85: folds=20
RunninItUp98: folds=20
kptrpt: raises 1600 to 3200
MoZZyNJ: folds=20
JJin91: raises 13397 to 16597 and is all-in
cl1ckinbtns: folds=20
kptrpt: calls 13397
*** FLOP *** [Tc 5h 3c]
*** TURN *** [Tc 5h 3c] [9c]
*** RIVER *** [Tc 5h 3c 9c] [Kc]
*** SHOW DOWN ***
JJin91: shows [5c Jc] (a flush, King high)
kptrpt: shows [Qd As] (high card Ace)
JJin91 collected 36194 from pot
*** SUMMARY ***
Total pot 36194 | Rake 0=20
Board [Tc 5h 3c 9c Kc]
Seat 1: cl1ckinbtns (big blind) folded before Flop
Seat 2: katekars21 folded before Flop (didn't bet)
Seat 3: SneakyPete85 folded before Flop (didn't bet)
Seat 6: RunninItUp98 folded before Flop (didn't bet)
Seat 7: kptrpt showed [Qd As] and lost with high card Ace
Seat 8: MoZZyNJ (button) folded before Flop (didn't bet)
Seat 9: JJin91 (small blind) showed [5c Jc] and won (36194) with a flus=
h, King high


*********** # 101 **************
PokerStars Hand #169651297030: Tournament #1622537113, $9.10+$0.90 USD =
Hold'em No Limit - Level XVIII (800/1600) - 2017/05/09 21:13:30 ET
Table '1622537113 7' 9-max Seat #9 is the button
Seat 1: cl1ckinbtns (44259 in chips)=20
Seat 2: katekars21 (131080 in chips)=20
Seat 3: SneakyPete85 (51782 in chips)=20
Seat 6: RunninItUp98 (59310 in chips)=20
Seat 7: kptrpt (19993 in chips)=20
Seat 9: JJin91 (36194 in chips)=20
cl1ckinbtns: posts the ante 200
katekars21: posts the ante 200
SneakyPete85: posts the ante 200
RunninItUp98: posts the ante 200
kptrpt: posts the ante 200
JJin91: posts the ante 200
cl1ckinbtns: posts small blind 800
katekars21: posts big blind 1600
*** HOLE CARDS ***
Dealt to JJin91 [2d 3s]
SneakyPete85: folds=20
RunninItUp98: folds=20
kptrpt: folds=20
JJin91: folds=20
cl1ckinbtns: folds=20
Uncalled bet (800) returned to katekars21
katekars21 collected 2800 from pot
katekars21: doesn't show hand=20
*** SUMMARY ***
Total pot 2800 | Rake 0=20
Seat 1: cl1ckinbtns (small blind) folded before Flop
Seat 2: katekars21 (big blind) collected (2800)
Seat 3: SneakyPete85 folded before Flop (didn't bet)
Seat 6: RunninItUp98 folded before Flop (didn't bet)
Seat 7: kptrpt folded before Flop (didn't bet)
Seat 9: JJin91 (button) folded before Flop (didn't bet)


*********** # 102 **************
PokerStars Hand #169651297508: Tournament #1622537113, $9.10+$0.90 USD =
Hold'em No Limit - Level XVIII (800/1600) - 2017/05/09 21:14:34 ET
Table '1622537113 7' 9-max Seat #1 is the button
Seat 1: cl1ckinbtns (43259 in chips)=20
Seat 2: katekars21 (132880 in chips)=20
Seat 3: SneakyPete85 (51582 in chips)=20
Seat 6: RunninItUp98 (59110 in chips)=20
Seat 7: kptrpt (19793 in chips)=20
Seat 9: JJin91 (35994 in chips)=20
cl1ckinbtns: posts the ante 200
katekars21: posts the ante 200
SneakyPete85: posts the ante 200
RunninItUp98: posts the ante 200
kptrpt: posts the ante 200
JJin91: posts the ante 200
katekars21: posts small blind 800
SneakyPete85: posts big blind 1600
*** HOLE CARDS ***
Dealt to JJin91 [Jc Th]
RunninItUp98: folds=20
kptrpt: folds=20
JJin91: raises 1904 to 3504
cl1ckinbtns: calls 3504
katekars21: folds=20
SneakyPete85: folds=20
*** FLOP *** [4s 9d Kd]
JJin91: checks=20
cl1ckinbtns: bets 4243
JJin91: calls 4243
*** TURN *** [4s 9d Kd] [Qh]
JJin91: checks=20
cl1ckinbtns: checks=20
*** RIVER *** [4s 9d Kd Qh] [Kh]
JJin91: checks=20
cl1ckinbtns: checks=20
*** SHOW DOWN ***
JJin91: shows [Jc Th] (a straight, Nine to King)
cl1ckinbtns: mucks hand=20
JJin91 collected 19094 from pot
*** SUMMARY ***
Total pot 19094 | Rake 0=20
Board [4s 9d Kd Qh Kh]
Seat 1: cl1ckinbtns (button) mucked [6c 6h]
Seat 2: katekars21 (small blind) folded before Flop
Seat 3: SneakyPete85 (big blind) folded before Flop
Seat 6: RunninItUp98 folded before Flop (didn't bet)
Seat 7: kptrpt folded before Flop (didn't bet)
Seat 9: JJin91 showed [Jc Th] and won (19094) with a straight, Nine to =
King


*********** # 103 **************
PokerStars Hand #169651298216: Tournament #1622537113, $9.10+$0.90 USD =
Hold'em No Limit - Level XVIII (800/1600) - 2017/05/09 21:16:05 ET
Table '1622537113 7' 9-max Seat #2 is the button
Seat 1: cl1ckinbtns (35312 in chips)=20
Seat 2: katekars21 (131880 in chips)=20
Seat 3: SneakyPete85 (49782 in chips)=20
Seat 6: RunninItUp98 (58910 in chips)=20
Seat 7: kptrpt (19593 in chips)=20
Seat 9: JJin91 (47141 in chips)=20
cl1ckinbtns: posts the ante 200
katekars21: posts the ante 200
SneakyPete85: posts the ante 200
RunninItUp98: posts the ante 200
kptrpt: posts the ante 200
JJin91: posts the ante 200
SneakyPete85: posts small blind 800
RunninItUp98: posts big blind 1600
*** HOLE CARDS ***
Dealt to JJin91 [4s Td]
kptrpt: folds=20
JJin91: folds=20
cl1ckinbtns: raises 33512 to 35112 and is all-in
katekars21: folds=20
SneakyPete85: folds=20
RunninItUp98: folds=20
Uncalled bet (33512) returned to cl1ckinbtns
cl1ckinbtns collected 5200 from pot
*** SUMMARY ***
Total pot 5200 | Rake 0=20
Seat 1: cl1ckinbtns collected (5200)
Seat 2: katekars21 (button) folded before Flop (didn't bet)
Seat 3: SneakyPete85 (small blind) folded before Flop
Seat 6: RunninItUp98 (big blind) folded before Flop
Seat 7: kptrpt folded before Flop (didn't bet)
Seat 9: JJin91 folded before Flop (didn't bet)


*********** # 104 **************
PokerStars Hand #169651298465: Tournament #1622537113, $9.10+$0.90 USD =
Hold'em No Limit - Level XVIII (800/1600) - 2017/05/09 21:16:39 ET
Table '1622537113 7' 9-max Seat #3 is the button
Seat 1: cl1ckinbtns (38712 in chips)=20
Seat 2: katekars21 (131680 in chips)=20
Seat 3: SneakyPete85 (48782 in chips)=20
Seat 6: RunninItUp98 (57110 in chips)=20
Seat 7: kptrpt (19393 in chips)=20
Seat 9: JJin91 (46941 in chips)=20
cl1ckinbtns: posts the ante 200
katekars21: posts the ante 200
SneakyPete85: posts the ante 200
RunninItUp98: posts the ante 200
kptrpt: posts the ante 200
JJin91: posts the ante 200
RunninItUp98: posts small blind 800
kptrpt: posts big blind 1600
*** HOLE CARDS ***
Dealt to JJin91 [Ks Kh]
JJin91: raises 2576 to 4176
cl1ckinbtns: folds=20
katekars21: folds=20
SneakyPete85: folds=20
RunninItUp98: folds=20
kptrpt: folds=20
Uncalled bet (2576) returned to JJin91
JJin91 collected 5200 from pot
JJin91: doesn't show hand=20
*** SUMMARY ***
Total pot 5200 | Rake 0=20
Seat 1: cl1ckinbtns folded before Flop (didn't bet)
Seat 2: katekars21 folded before Flop (didn't bet)
Seat 3: SneakyPete85 (button) folded before Flop (didn't bet)
Seat 6: RunninItUp98 (small blind) folded before Flop
Seat 7: kptrpt (big blind) folded before Flop
Seat 9: JJin91 collected (5200)


*********** # 105 **************
PokerStars Hand #169651298765: Tournament #1622537113, $9.10+$0.90 USD =
Hold'em No Limit - Level XIX (1000/2000) - 2017/05/09 21:17:20 ET
Table '1622537113 7' 9-max Seat #6 is the button
Seat 1: cl1ckinbtns (38512 in chips)=20
Seat 2: katekars21 (131480 in chips)=20
Seat 3: SneakyPete85 (48582 in chips)=20
Seat 6: RunninItUp98 (56110 in chips)=20
Seat 7: kptrpt (17593 in chips)=20
Seat 9: JJin91 (50341 in chips)=20
cl1ckinbtns: posts the ante 250
katekars21: posts the ante 250
SneakyPete85: posts the ante 250
RunninItUp98: posts the ante 250
kptrpt: posts the ante 250
JJin91: posts the ante 250
kptrpt: posts small blind 1000
JJin91: posts big blind 2000
*** HOLE CARDS ***
Dealt to JJin91 [6d 9d]
cl1ckinbtns: folds=20
katekars21: folds=20
SneakyPete85: folds=20
RunninItUp98: folds=20
kptrpt: raises 15343 to 17343 and is all-in
JJin91: folds=20
Uncalled bet (15343) returned to kptrpt
kptrpt collected 5500 from pot
kptrpt: doesn't show hand=20
*** SUMMARY ***
Total pot 5500 | Rake 0=20
Seat 1: cl1ckinbtns folded before Flop (didn't bet)
Seat 2: katekars21 folded before Flop (didn't bet)
Seat 3: SneakyPete85 folded before Flop (didn't bet)
Seat 6: RunninItUp98 (button) folded before Flop (didn't bet)
Seat 7: kptrpt (small blind) collected (5500)
Seat 9: JJin91 (big blind) folded before Flop


*********** # 106 **************
PokerStars Hand #169651299221: Tournament #1622537113, $9.10+$0.90 USD =
Hold'em No Limit - Level XIX (1000/2000) - 2017/05/09 21:18:22 ET
Table '1622537113 7' 9-max Seat #7 is the button
Seat 1: cl1ckinbtns (38262 in chips)=20
Seat 2: katekars21 (131230 in chips)=20
Seat 3: SneakyPete85 (48332 in chips)=20
Seat 4: MoZZyNJ (177771 in chips)=20
Seat 5: Eowperson (77751 in chips)=20
Seat 6: RunninItUp98 (55860 in chips)=20
Seat 7: kptrpt (20843 in chips)=20
Seat 8: Jenger420 (49653 in chips) out of hand (moved from another tabl=
e into small blind)
Seat 9: JJin91 (48091 in chips)=20
cl1ckinbtns: posts the ante 250
katekars21: posts the ante 250
SneakyPete85: posts the ante 250
MoZZyNJ: posts the ante 250
Eowperson: posts the ante 250
RunninItUp98: posts the ante 250
kptrpt: posts the ante 250
JJin91: posts the ante 250
JJin91: posts small blind 1000
cl1ckinbtns: posts big blind 2000
*** HOLE CARDS ***
Dealt to JJin91 [Jh 3d]
katekars21: raises 2000 to 4000
SneakyPete85: folds=20
MoZZyNJ: folds=20
Eowperson: folds=20
RunninItUp98: folds=20
kptrpt: folds=20
JJin91: folds=20
cl1ckinbtns: calls 2000
*** FLOP *** [Jd 7d Th]
cl1ckinbtns: checks=20
katekars21: bets 4000
RunninItUp98 is sitting out
cl1ckinbtns: raises 30012 to 34012 and is all-in
katekars21: calls 30012
*** TURN *** [Jd 7d Th] [Qs]
*** RIVER *** [Jd 7d Th Qs] [Qd]
*** SHOW DOWN ***
cl1ckinbtns: shows [8s 9s] (a straight, Eight to Queen)
katekars21: shows [As Ts] (two pair, Queens and Tens)
cl1ckinbtns collected 79024 from pot
*** SUMMARY ***
Total pot 79024 | Rake 0=20
Board [Jd 7d Th Qs Qd]
Seat 1: cl1ckinbtns (big blind) showed [8s 9s] and won (79024) with a s=
traight, Eight to Queen
Seat 2: katekars21 showed [As Ts] and lost with two pair, Queens and Te=
ns
Seat 3: SneakyPete85 folded before Flop (didn't bet)
Seat 4: MoZZyNJ folded before Flop (didn't bet)
Seat 5: Eowperson folded before Flop (didn't bet)
Seat 6: RunninItUp98 folded before Flop (didn't bet)
Seat 7: kptrpt (button) folded before Flop (didn't bet)
Seat 9: JJin91 (small blind) folded before Flop


*********** # 107 **************
PokerStars Hand #169651299522: Tournament #1622537113, $9.10+$0.90 USD =
Hold'em No Limit - Level XIX (1000/2000) - 2017/05/09 21:19:08 ET
Table '1622537113 7' 9-max Seat #9 is the button
Seat 1: cl1ckinbtns (79024 in chips)=20
Seat 2: katekars21 (92968 in chips)=20
Seat 3: SneakyPete85 (48082 in chips)=20
Seat 4: MoZZyNJ (177521 in chips)=20
Seat 5: Eowperson (77501 in chips)=20
Seat 6: RunninItUp98 (55610 in chips) is sitting out
Seat 7: kptrpt (20593 in chips)=20
Seat 8: Jenger420 (49653 in chips)=20
Seat 9: JJin91 (46841 in chips)=20
cl1ckinbtns: posts the ante 250
katekars21: posts the ante 250
SneakyPete85: posts the ante 250
MoZZyNJ: posts the ante 250
Eowperson: posts the ante 250
RunninItUp98: posts the ante 250
kptrpt: posts the ante 250
Jenger420: posts the ante 250
JJin91: posts the ante 250
cl1ckinbtns: posts small blind 1000
katekars21: posts big blind 2000
*** HOLE CARDS ***
Dealt to JJin91 [6h 8c]
SneakyPete85: folds=20
MoZZyNJ: folds=20
Eowperson: folds=20
RunninItUp98: folds=20
kptrpt: folds=20
Jenger420: folds=20
JJin91: raises 2380 to 4380
cl1ckinbtns: folds=20
katekars21: folds=20
Uncalled bet (2380) returned to JJin91
JJin91 collected 7250 from pot
JJin91: doesn't show hand=20
*** SUMMARY ***
Total pot 7250 | Rake 0=20
Seat 1: cl1ckinbtns (small blind) folded before Flop
Seat 2: katekars21 (big blind) folded before Flop
Seat 3: SneakyPete85 folded before Flop (didn't bet)
Seat 4: MoZZyNJ folded before Flop (didn't bet)
Seat 5: Eowperson folded before Flop (didn't bet)
Seat 6: RunninItUp98 folded before Flop (didn't bet)
Seat 7: kptrpt folded before Flop (didn't bet)
Seat 8: Jenger420 folded before Flop (didn't bet)
Seat 9: JJin91 (button) collected (7250)


*********** # 108 **************
PokerStars Hand #169651299691: Tournament #1622537113, $9.10+$0.90 USD =
Hold'em No Limit - Level XIX (1000/2000) - 2017/05/09 21:19:31 ET
Table '1622537113 7' 9-max Seat #1 is the button
Seat 1: cl1ckinbtns (77774 in chips)=20
Seat 2: katekars21 (90718 in chips)=20
Seat 3: SneakyPete85 (47832 in chips)=20
Seat 4: MoZZyNJ (177271 in chips)=20
Seat 5: Eowperson (77251 in chips)=20
Seat 6: RunninItUp98 (55360 in chips) is sitting out
Seat 7: kptrpt (20343 in chips)=20
Seat 8: Jenger420 (49403 in chips)=20
Seat 9: JJin91 (51841 in chips)=20
cl1ckinbtns: posts the ante 250
katekars21: posts the ante 250
SneakyPete85: posts the ante 250
MoZZyNJ: posts the ante 250
Eowperson: posts the ante 250
RunninItUp98: posts the ante 250
kptrpt: posts the ante 250
Jenger420: posts the ante 250
JJin91: posts the ante 250
katekars21: posts small blind 1000
SneakyPete85: posts big blind 2000
*** HOLE CARDS ***
Dealt to JJin91 [6h Td]
MoZZyNJ: raises 4000 to 6000
Eowperson: folds=20
RunninItUp98: folds=20
kptrpt: folds=20
Jenger420: folds=20
JJin91: folds=20
cl1ckinbtns: folds=20
katekars21: calls 5000
SneakyPete85 is connected=20
SneakyPete85: folds=20
*** FLOP *** [Qd Jc 6d]
katekars21: checks=20
MoZZyNJ: bets 8288
katekars21: calls 8288
*** TURN *** [Qd Jc 6d] [2c]
katekars21: checks=20
RunninItUp98 has returned
MoZZyNJ: checks=20
*** RIVER *** [Qd Jc 6d 2c] [6s]
katekars21: bets 76180 and is all-in
MoZZyNJ: folds=20
Uncalled bet (76180) returned to katekars21
katekars21 collected 32826 from pot
katekars21: doesn't show hand=20
*** SUMMARY ***
Total pot 32826 | Rake 0=20
Board [Qd Jc 6d 2c 6s]
Seat 1: cl1ckinbtns (button) folded before Flop (didn't bet)
Seat 2: katekars21 (small blind) collected (32826)
Seat 3: SneakyPete85 (big blind) folded before Flop
Seat 4: MoZZyNJ folded on the River
Seat 5: Eowperson folded before Flop (didn't bet)
Seat 6: RunninItUp98 folded before Flop (didn't bet)
Seat 7: kptrpt folded before Flop (didn't bet)
Seat 8: Jenger420 folded before Flop (didn't bet)
Seat 9: JJin91 folded before Flop (didn't bet)


*********** # 109 **************
PokerStars Hand #169651677548: Tournament #1622537113, $9.10+$0.90 USD =
Hold'em No Limit - Level XIX (1000/2000) - 2017/05/09 21:21:02 ET
Table '1622537113 7' 9-max Seat #2 is the button
Seat 1: cl1ckinbtns (77524 in chips)=20
Seat 2: katekars21 (109006 in chips)=20
Seat 3: SneakyPete85 (45582 in chips)=20
Seat 4: MoZZyNJ (162733 in chips)=20
Seat 5: Eowperson (77001 in chips)=20
Seat 6: RunninItUp98 (55110 in chips)=20
Seat 7: kptrpt (20093 in chips)=20
Seat 8: Jenger420 (49153 in chips)=20
Seat 9: JJin91 (51591 in chips)=20
cl1ckinbtns: posts the ante 250
katekars21: posts the ante 250
SneakyPete85: posts the ante 250
MoZZyNJ: posts the ante 250
Eowperson: posts the ante 250
RunninItUp98: posts the ante 250
kptrpt: posts the ante 250
Jenger420: posts the ante 250
JJin91: posts the ante 250
SneakyPete85: posts small blind 1000
MoZZyNJ: posts big blind 2000
*** HOLE CARDS ***
Dealt to JJin91 [2h Ac]
Eowperson: folds=20
MoZZyNJ said, "folded a big one"
MoZZyNJ said, "good bet"
RunninItUp98: folds=20
kptrpt: folds=20
Jenger420: folds=20
JJin91: folds=20
cl1ckinbtns: folds=20
katekars21: folds=20
SneakyPete85: folds=20
Uncalled bet (1000) returned to MoZZyNJ
MoZZyNJ collected 4250 from pot
*** SUMMARY ***
Total pot 4250 | Rake 0=20
Seat 1: cl1ckinbtns folded before Flop (didn't bet)
Seat 2: katekars21 (button) folded before Flop (didn't bet)
Seat 3: SneakyPete85 (small blind) folded before Flop
Seat 4: MoZZyNJ (big blind) collected (4250)
Seat 5: Eowperson folded before Flop (didn't bet)
Seat 6: RunninItUp98 folded before Flop (didn't bet)
Seat 7: kptrpt folded before Flop (didn't bet)
Seat 8: Jenger420 folded before Flop (didn't bet)
Seat 9: JJin91 folded before Flop (didn't bet)


*********** # 110 **************
PokerStars Hand #169651677686: Tournament #1622537113, $9.10+$0.90 USD =
Hold'em No Limit - Level XIX (1000/2000) - 2017/05/09 21:21:22 ET
Table '1622537113 7' 9-max Seat #3 is the button
Seat 1: cl1ckinbtns (77274 in chips)=20
Seat 2: katekars21 (108756 in chips)=20
Seat 3: SneakyPete85 (44332 in chips)=20
Seat 4: MoZZyNJ (165733 in chips)=20
Seat 5: Eowperson (76751 in chips)=20
Seat 6: RunninItUp98 (54860 in chips)=20
Seat 7: kptrpt (19843 in chips)=20
Seat 8: Jenger420 (48903 in chips)=20
Seat 9: JJin91 (51341 in chips)=20
cl1ckinbtns: posts the ante 250
katekars21: posts the ante 250
SneakyPete85: posts the ante 250
MoZZyNJ: posts the ante 250
Eowperson: posts the ante 250
RunninItUp98: posts the ante 250
kptrpt: posts the ante 250
Jenger420: posts the ante 250
JJin91: posts the ante 250
MoZZyNJ: posts small blind 1000
Eowperson: posts big blind 2000
*** HOLE CARDS ***
Dealt to JJin91 [3c Jd]
RunninItUp98: folds=20
kptrpt: folds=20
Jenger420: folds=20
JJin91: folds=20
cl1ckinbtns: folds=20
katekars21: folds=20
SneakyPete85: folds=20
MoZZyNJ: raises 4000 to 6000
Eowperson: folds=20
Uncalled bet (4000) returned to MoZZyNJ
MoZZyNJ collected 6250 from pot
*** SUMMARY ***
Total pot 6250 | Rake 0=20
Seat 1: cl1ckinbtns folded before Flop (didn't bet)
Seat 2: katekars21 folded before Flop (didn't bet)
Seat 3: SneakyPete85 (button) folded before Flop (didn't bet)
Seat 4: MoZZyNJ (small blind) collected (6250)
Seat 5: Eowperson (big blind) folded before Flop
Seat 6: RunninItUp98 folded before Flop (didn't bet)
Seat 7: kptrpt folded before Flop (didn't bet)
Seat 8: Jenger420 folded before Flop (didn't bet)
Seat 9: JJin91 folded before Flop (didn't bet)


*********** # 111 **************
PokerStars Hand #169651677924: Tournament #1622537113, $9.10+$0.90 USD =
Hold'em No Limit - Level XIX (1000/2000) - 2017/05/09 21:22:02 ET
Table '1622537113 7' 9-max Seat #4 is the button
Seat 1: cl1ckinbtns (77024 in chips)=20
Seat 2: katekars21 (108506 in chips)=20
Seat 3: SneakyPete85 (44082 in chips)=20
Seat 4: MoZZyNJ (169733 in chips)=20
Seat 5: Eowperson (74501 in chips)=20
Seat 6: RunninItUp98 (54610 in chips)=20
Seat 7: kptrpt (19593 in chips)=20
Seat 8: Jenger420 (48653 in chips)=20
Seat 9: JJin91 (51091 in chips)=20
cl1ckinbtns: posts the ante 250
katekars21: posts the ante 250
SneakyPete85: posts the ante 250
MoZZyNJ: posts the ante 250
Eowperson: posts the ante 250
RunninItUp98: posts the ante 250
kptrpt: posts the ante 250
Jenger420: posts the ante 250
JJin91: posts the ante 250
Eowperson: posts small blind 1000
RunninItUp98: posts big blind 2000
*** HOLE CARDS ***
Dealt to JJin91 [6h 8d]
kptrpt: raises 17343 to 19343 and is all-in
Jenger420: folds=20
JJin91: folds=20
cl1ckinbtns: folds=20
katekars21: folds=20
SneakyPete85: folds=20
MoZZyNJ: raises 17657 to 37000
Eowperson: folds=20
RunninItUp98: folds=20
Uncalled bet (17657) returned to MoZZyNJ
*** FLOP *** [6c 8c 4h]
*** TURN *** [6c 8c 4h] [Ks]
*** RIVER *** [6c 8c 4h Ks] [3s]
*** SHOW DOWN ***
kptrpt: shows [8s As] (a pair of Eights)
MoZZyNJ: shows [Jc Jd] (a pair of Jacks)
MoZZyNJ collected 43936 from pot
kptrpt finished the tournament in 18th place and received $21.45.
*** SUMMARY ***
Total pot 43936 | Rake 0=20
Board [6c 8c 4h Ks 3s]
Seat 1: cl1ckinbtns folded before Flop (didn't bet)
Seat 2: katekars21 folded before Flop (didn't bet)
Seat 3: SneakyPete85 folded before Flop (didn't bet)
Seat 4: MoZZyNJ (button) showed [Jc Jd] and won (43936) with a pair of =
Jacks
Seat 5: Eowperson (small blind) folded before Flop
Seat 6: RunninItUp98 (big blind) folded before Flop
Seat 7: kptrpt showed [8s As] and lost with a pair of Eights
Seat 8: Jenger420 folded before Flop (didn't bet)
Seat 9: JJin91 folded before Flop (didn't bet)


*********** # 112 **************
PokerStars Hand #169651678136: Tournament #1622537113, $9.10+$0.90 USD =
Hold'em No Limit - Level XIX (1000/2000) - 2017/05/09 21:22:34 ET
Table '1622537113 7' 9-max Seat #5 is the button
Seat 1: cl1ckinbtns (76774 in chips)=20
Seat 2: katekars21 (108256 in chips)=20
Seat 3: SneakyPete85 (43832 in chips)=20
Seat 4: MoZZyNJ (194076 in chips)=20
Seat 5: Eowperson (73251 in chips)=20
Seat 6: RunninItUp98 (52360 in chips)=20
Seat 8: Jenger420 (48403 in chips)=20
Seat 9: JJin91 (50841 in chips)=20
cl1ckinbtns: posts the ante 250
katekars21: posts the ante 250
SneakyPete85: posts the ante 250
MoZZyNJ: posts the ante 250
Eowperson: posts the ante 250
RunninItUp98: posts the ante 250
Jenger420: posts the ante 250
JJin91: posts the ante 250
RunninItUp98: posts small blind 1000
Jenger420: posts big blind 2000
*** HOLE CARDS ***
Dealt to JJin91 [Ac Kh]
JJin91: raises 2380 to 4380
cl1ckinbtns: folds=20
katekars21: folds=20
SneakyPete85: folds=20
MoZZyNJ: folds=20
Eowperson: folds=20
RunninItUp98: folds=20
Jenger420: folds=20
Uncalled bet (2380) returned to JJin91
JJin91 collected 7000 from pot
JJin91: doesn't show hand=20
*** SUMMARY ***
Total pot 7000 | Rake 0=20
Seat 1: cl1ckinbtns folded before Flop (didn't bet)
Seat 2: katekars21 folded before Flop (didn't bet)
Seat 3: SneakyPete85 folded before Flop (didn't bet)
Seat 4: MoZZyNJ folded before Flop (didn't bet)
Seat 5: Eowperson (button) folded before Flop (didn't bet)
Seat 6: RunninItUp98 (small blind) folded before Flop
Seat 8: Jenger420 (big blind) folded before Flop
Seat 9: JJin91 collected (7000)


*********** # 113 **************
PokerStars Hand #169651678308: Tournament #1622537113, $9.10+$0.90 USD =
Hold'em No Limit - Level XIX (1000/2000) - 2017/05/09 21:23:03 ET
Table '1622537113 7' 9-max Seat #6 is the button
Seat 1: cl1ckinbtns (76524 in chips)=20
Seat 2: katekars21 (108006 in chips)=20
Seat 3: SneakyPete85 (43582 in chips)=20
Seat 4: MoZZyNJ (193826 in chips)=20
Seat 5: Eowperson (73001 in chips)=20
Seat 6: RunninItUp98 (51110 in chips)=20
Seat 8: Jenger420 (46153 in chips)=20
Seat 9: JJin91 (55591 in chips)=20
cl1ckinbtns: posts the ante 250
katekars21: posts the ante 250
SneakyPete85: posts the ante 250
MoZZyNJ: posts the ante 250
Eowperson: posts the ante 250
RunninItUp98: posts the ante 250
Jenger420: posts the ante 250
JJin91: posts the ante 250
Jenger420: posts small blind 1000
JJin91: posts big blind 2000
*** HOLE CARDS ***
Dealt to JJin91 [Th Jd]
cl1ckinbtns: folds=20
katekars21: folds=20
SneakyPete85: raises 2000 to 4000
MoZZyNJ: folds=20
Eowperson: folds=20
RunninItUp98: folds=20
Jenger420: folds=20
JJin91: calls 2000
*** FLOP *** [2s Kh 8d]
JJin91: checks=20
SneakyPete85: checks=20
*** TURN *** [2s Kh 8d] [As]
JJin91: checks=20
SneakyPete85: checks=20
*** RIVER *** [2s Kh 8d As] [9c]
JJin91: bets 5830
SneakyPete85: folds=20
Uncalled bet (5830) returned to JJin91
JJin91 collected 11000 from pot
JJin91: doesn't show hand=20
*** SUMMARY ***
Total pot 11000 | Rake 0=20
Board [2s Kh 8d As 9c]
Seat 1: cl1ckinbtns folded before Flop (didn't bet)
Seat 2: katekars21 folded before Flop (didn't bet)
Seat 3: SneakyPete85 folded on the River
Seat 4: MoZZyNJ folded before Flop (didn't bet)
Seat 5: Eowperson folded before Flop (didn't bet)
Seat 6: RunninItUp98 (button) folded before Flop (didn't bet)
Seat 8: Jenger420 (small blind) folded before Flop
Seat 9: JJin91 (big blind) collected (11000)


*********** # 114 **************
PokerStars Hand #169651678688: Tournament #1622537113, $9.10+$0.90 USD =
Hold'em No Limit - Level XIX (1000/2000) - 2017/05/09 21:24:01 ET
Table '1622537113 7' 9-max Seat #8 is the button
Seat 1: cl1ckinbtns (76274 in chips)=20
Seat 2: katekars21 (107756 in chips)=20
Seat 3: SneakyPete85 (39332 in chips)=20
Seat 4: MoZZyNJ (193576 in chips)=20
Seat 5: Eowperson (72751 in chips)=20
Seat 6: RunninItUp98 (50860 in chips)=20
Seat 8: Jenger420 (44903 in chips)=20
Seat 9: JJin91 (62341 in chips)=20
cl1ckinbtns: posts the ante 250
katekars21: posts the ante 250
SneakyPete85: posts the ante 250
MoZZyNJ: posts the ante 250
Eowperson: posts the ante 250
RunninItUp98: posts the ante 250
Jenger420: posts the ante 250
JJin91: posts the ante 250
JJin91: posts small blind 1000
cl1ckinbtns: posts big blind 2000
*** HOLE CARDS ***
Dealt to JJin91 [Jh Kh]
katekars21: folds=20
SneakyPete85: folds=20
MoZZyNJ: raises 3520 to 5520
Eowperson: folds=20
RunninItUp98: folds=20
Jenger420: folds=20
JJin91: calls 4520
cl1ckinbtns: raises 70504 to 76024 and is all-in
MoZZyNJ: folds=20
JJin91: calls 56571 and is all-in
Uncalled bet (13933) returned to cl1ckinbtns
*** FLOP *** [Ts 4h 9c]
*** TURN *** [Ts 4h 9c] [8h]
*** RIVER *** [Ts 4h 9c 8h] [Kc]
*** SHOW DOWN ***
JJin91: shows [Jh Kh] (a pair of Kings)
cl1ckinbtns: shows [Ks As] (a pair of Kings - Ace kicker)
cl1ckinbtns collected 131702 from pot
JJin91 finished the tournament in 17th place and received $21.45.
*** SUMMARY ***
Total pot 131702 | Rake 0=20
Board [Ts 4h 9c 8h Kc]
Seat 1: cl1ckinbtns (big blind) showed [Ks As] and won (131702) with a =
pair of Kings
Seat 2: katekars21 folded before Flop (didn't bet)
Seat 3: SneakyPete85 folded before Flop (didn't bet)
Seat 4: MoZZyNJ folded before Flop
Seat 5: Eowperson folded before Flop (didn't bet)
Seat 6: RunninItUp98 folded before Flop (didn't bet)
Seat 8: Jenger420 (button) folded before Flop (didn't bet)
Seat 9: JJin91 (small blind) showed [Jh Kh] and lost with a pair of Kin=
gs



If you have any questions, please contact us at "PokerStars Support" <s=
upport@pokerstarsnj.com>


