Transcript for tournament #1622573245 requested by JJin91 (jamiejin91@g=
mail.com)

*********** # 1 **************
PokerStars Hand #170338297257: Tournament #1622573245, $4.55+$0.45 USD =
Hold'em No Limit - Level I (25/50) - 2017/05/24 21:00:04 ET
Table '1622573245 2' 9-max Seat #2 is the button
Seat 2: Towerclub735 (10000 in chips)=20
Seat 3: Giants TD (10000 in chips)=20
Seat 4: jbhawaii88 (10000 in chips)=20
Seat 5: Lev Riles (10000 in chips)=20
Seat 6: GoKen99 (10000 in chips)=20
Seat 8: JJin91 (10000 in chips)=20
Seat 9: LaughingLuke (10000 in chips)=20
Giants TD: posts small blind 25
jbhawaii88: posts big blind 50
*** HOLE CARDS ***
Dealt to JJin91 [Ts Qc]
Lev Riles: folds=20
GoKen99: calls 50
JJin91: folds=20
LaughingLuke: folds=20
Towerclub735: calls 50
Giants TD: calls 25
jbhawaii88: checks=20
*** FLOP *** [Kd 3c 5s]
Giants TD: checks=20
jbhawaii88: checks=20
GoKen99: checks=20
Towerclub735: checks=20
*** TURN *** [Kd 3c 5s] [3h]
Giants TD: checks=20
jbhawaii88: bets 110
GoKen99: calls 110
Towerclub735: folds=20
Giants TD: folds=20
*** RIVER *** [Kd 3c 5s 3h] [4h]
jbhawaii88: bets 305
GoKen99: calls 305
*** SHOW DOWN ***
jbhawaii88: shows [6s 3d] (three of a kind, Threes)
GoKen99: mucks hand=20
jbhawaii88 collected 1030 from pot
*** SUMMARY ***
Total pot 1030 | Rake 0=20
Board [Kd 3c 5s 3h 4h]
Seat 2: Towerclub735 (button) folded on the Turn
Seat 3: Giants TD (small blind) folded on the Turn
Seat 4: jbhawaii88 (big blind) showed [6s 3d] and won (1030) with three=
 of a kind, Threes
Seat 5: Lev Riles folded before Flop (didn't bet)
Seat 6: GoKen99 mucked [7h Kc]
Seat 8: JJin91 folded before Flop (didn't bet)
Seat 9: LaughingLuke folded before Flop (didn't bet)


*********** # 2 **************
PokerStars Hand #170338297494: Tournament #1622573245, $4.55+$0.45 USD =
Hold'em No Limit - Level I (25/50) - 2017/05/24 21:01:06 ET
Table '1622573245 2' 9-max Seat #3 is the button
Seat 1: proletariat5 (10000 in chips)=20
Seat 2: Towerclub735 (9950 in chips)=20
Seat 3: Giants TD (9950 in chips)=20
Seat 4: jbhawaii88 (10565 in chips)=20
Seat 5: Lev Riles (10000 in chips)=20
Seat 6: GoKen99 (9535 in chips)=20
Seat 8: JJin91 (10000 in chips)=20
Seat 9: LaughingLuke (10000 in chips)=20
jbhawaii88: posts small blind 25
Lev Riles: posts big blind 50
*** HOLE CARDS ***
Dealt to JJin91 [3s Kc]
GoKen99: folds=20
JJin91: folds=20
LaughingLuke: folds=20
proletariat5: folds=20
Towerclub735: folds=20
Giants TD: calls 50
jbhawaii88: calls 25
Lev Riles: checks=20
*** FLOP *** [8c Ks 7h]
jbhawaii88: checks=20
Lev Riles: bets 54
Giants TD: calls 54
jbhawaii88: calls 54
*** TURN *** [8c Ks 7h] [Ts]
jbhawaii88: checks=20
Lev Riles: checks=20
Giants TD: checks=20
*** RIVER *** [8c Ks 7h Ts] [4h]
jbhawaii88: checks=20
Lev Riles: checks=20
Giants TD: bets 150
jbhawaii88: folds=20
Lev Riles: calls 150
*** SHOW DOWN ***
Giants TD: shows [3d Ac] (high card Ace)
Lev Riles: shows [8s 9c] (a pair of Eights)
Lev Riles collected 612 from pot
*** SUMMARY ***
Total pot 612 | Rake 0=20
Board [8c Ks 7h Ts 4h]
Seat 1: proletariat5 folded before Flop (didn't bet)
Seat 2: Towerclub735 folded before Flop (didn't bet)
Seat 3: Giants TD (button) showed [3d Ac] and lost with high card Ace
Seat 4: jbhawaii88 (small blind) folded on the River
Seat 5: Lev Riles (big blind) showed [8s 9c] and won (612) with a pair =
of Eights
Seat 6: GoKen99 folded before Flop (didn't bet)
Seat 8: JJin91 folded before Flop (didn't bet)
Seat 9: LaughingLuke folded before Flop (didn't bet)


*********** # 3 **************
PokerStars Hand #170338297916: Tournament #1622573245, $4.55+$0.45 USD =
Hold'em No Limit - Level I (25/50) - 2017/05/24 21:02:44 ET
Table '1622573245 2' 9-max Seat #4 is the button
Seat 1: proletariat5 (10000 in chips)=20
Seat 2: Towerclub735 (9950 in chips)=20
Seat 3: Giants TD (9696 in chips)=20
Seat 4: jbhawaii88 (10461 in chips)=20
Seat 5: Lev Riles (10358 in chips)=20
Seat 7: shortdp33 (10000 in chips)=20
Seat 8: JJin91 (10000 in chips)=20
Seat 9: LaughingLuke (10000 in chips)=20
Lev Riles: posts small blind 25
shortdp33: posts big blind 50
*** HOLE CARDS ***
Dealt to JJin91 [Js 6d]
JJin91: folds=20
LaughingLuke: folds=20
proletariat5 has timed out
proletariat5: folds=20
proletariat5 is sitting out
proletariat5 has returned
Towerclub735: folds=20
Giants TD: folds=20
jbhawaii88: folds=20
Lev Riles: folds=20
Uncalled bet (25) returned to shortdp33
shortdp33 collected 50 from pot
shortdp33: doesn't show hand=20
*** SUMMARY ***
Total pot 50 | Rake 0=20
Seat 1: proletariat5 folded before Flop (didn't bet)
Seat 2: Towerclub735 folded before Flop (didn't bet)
Seat 3: Giants TD folded before Flop (didn't bet)
Seat 4: jbhawaii88 (button) folded before Flop (didn't bet)
Seat 5: Lev Riles (small blind) folded before Flop
Seat 7: shortdp33 (big blind) collected (50)
Seat 8: JJin91 folded before Flop (didn't bet)
Seat 9: LaughingLuke folded before Flop (didn't bet)


*********** # 4 **************
PokerStars Hand #170338298142: Tournament #1622573245, $4.55+$0.45 USD =
Hold'em No Limit - Level I (25/50) - 2017/05/24 21:03:38 ET
Table '1622573245 3' 9-max Seat #2 is the button
Seat 1: GoKen99 (9110 in chips)=20
Seat 2: Nick9965 (19925 in chips)=20
Seat 3: keyan349 (10475 in chips)=20
Seat 4: JJin91 (10000 in chips)=20
Seat 6: ccmps (10000 in chips)=20
keyan349: posts small blind 25
JJin91: posts big blind 50
*** HOLE CARDS ***
Dealt to JJin91 [Ah 3d]
ccmps: folds=20
GoKen99: calls 50
Nick9965: folds=20
keyan349: calls 25
JJin91: checks=20
*** FLOP *** [6h 9c 6d]
keyan349: checks=20
JJin91: checks=20
GoKen99: checks=20
*** TURN *** [6h 9c 6d] [Jc]
keyan349: checks=20
JJin91: checks=20
GoKen99: bets 150
keyan349: folds=20
JJin91: calls 150
*** RIVER *** [6h 9c 6d Jc] [2s]
JJin91: checks=20
GoKen99: checks=20
*** SHOW DOWN ***
JJin91: shows [Ah 3d] (a pair of Sixes)
GoKen99: shows [As Kd] (a pair of Sixes - Ace+King kicker)
GoKen99 collected 450 from pot
*** SUMMARY ***
Total pot 450 | Rake 0=20
Board [6h 9c 6d Jc 2s]
Seat 1: GoKen99 showed [As Kd] and won (450) with a pair of Sixes
Seat 2: Nick9965 (button) folded before Flop (didn't bet)
Seat 3: keyan349 (small blind) folded on the Turn
Seat 4: JJin91 (big blind) showed [Ah 3d] and lost with a pair of Sixes
Seat 6: ccmps folded before Flop (didn't bet)


*********** # 5 **************
PokerStars Hand #170338298398: Tournament #1622573245, $4.55+$0.45 USD =
Hold'em No Limit - Level I (25/50) - 2017/05/24 21:04:35 ET
Table '1622573245 3' 9-max Seat #3 is the button
Seat 1: GoKen99 (9360 in chips)=20
Seat 2: Nick9965 (19925 in chips)=20
Seat 3: keyan349 (10425 in chips)=20
Seat 4: JJin91 (9800 in chips)=20
Seat 5: bigpond12 (10025 in chips)=20
Seat 6: ccmps (10000 in chips)=20
Seat 9: burl5759 (10000 in chips)=20
JJin91: posts small blind 25
bigpond12: posts big blind 50
*** HOLE CARDS ***
Dealt to JJin91 [9h 8s]
ccmps: folds=20
burl5759: calls 50
GoKen99: calls 50
Nick9965: folds=20
keyan349: folds=20
JJin91: calls 25
bigpond12: checks=20
*** FLOP *** [2h Ac Ad]
JJin91: checks=20
bigpond12: checks=20
burl5759: checks=20
GoKen99: checks=20
*** TURN *** [2h Ac Ad] [2c]
JJin91: checks=20
bigpond12: checks=20
burl5759: checks=20
GoKen99: checks=20
*** RIVER *** [2h Ac Ad 2c] [7h]
JJin91: checks=20
bigpond12: checks=20
burl5759: bets 100
GoKen99: folds=20
JJin91: folds=20
bigpond12: folds=20
Uncalled bet (100) returned to burl5759
burl5759 collected 200 from pot
burl5759: doesn't show hand=20
*** SUMMARY ***
Total pot 200 | Rake 0=20
Board [2h Ac Ad 2c 7h]
Seat 1: GoKen99 folded on the River
Seat 2: Nick9965 folded before Flop (didn't bet)
Seat 3: keyan349 (button) folded before Flop (didn't bet)
Seat 4: JJin91 (small blind) folded on the River
Seat 5: bigpond12 (big blind) folded on the River
Seat 6: ccmps folded before Flop (didn't bet)
Seat 9: burl5759 collected (200)


*********** # 6 **************
PokerStars Hand #170338298605: Tournament #1622573245, $4.55+$0.45 USD =
Hold'em No Limit - Level II (30/60) - 2017/05/24 21:05:24 ET
Table '1622573245 3' 9-max Seat #4 is the button
Seat 1: GoKen99 (9310 in chips)=20
Seat 2: Nick9965 (19925 in chips)=20
Seat 3: keyan349 (10425 in chips)=20
Seat 4: JJin91 (9750 in chips)=20
Seat 5: bigpond12 (9975 in chips)=20
Seat 6: ccmps (10000 in chips)=20
Seat 7: MyManPotnPan (10000 in chips)=20
Seat 9: burl5759 (10150 in chips)=20
bigpond12: posts small blind 30
ccmps: posts big blind 60
*** HOLE CARDS ***
Dealt to JJin91 [Td 8c]
MyManPotnPan: calls 60
burl5759: calls 60
GoKen99: calls 60
Nick9965: folds=20
keyan349: folds=20
JJin91: folds=20
bigpond12: folds=20
ccmps: checks=20
*** FLOP *** [6c 6s 4s]
ccmps: checks=20
MyManPotnPan: checks=20
burl5759: checks=20
GoKen99: checks=20
*** TURN *** [6c 6s 4s] [7h]
ccmps: bets 178
MyManPotnPan: calls 178
burl5759: folds=20
GoKen99: folds=20
*** RIVER *** [6c 6s 4s 7h] [4h]
ccmps: checks=20
MyManPotnPan: bets 626
ccmps: calls 626
*** SHOW DOWN ***
MyManPotnPan: shows [5s 5c] (two pair, Sixes and Fives)
ccmps: shows [7s 5d] (two pair, Sevens and Sixes)
ccmps collected 1878 from pot
*** SUMMARY ***
Total pot 1878 | Rake 0=20
Board [6c 6s 4s 7h 4h]
Seat 1: GoKen99 folded on the Turn
Seat 2: Nick9965 folded before Flop (didn't bet)
Seat 3: keyan349 folded before Flop (didn't bet)
Seat 4: JJin91 (button) folded before Flop (didn't bet)
Seat 5: bigpond12 (small blind) folded before Flop
Seat 6: ccmps (big blind) showed [7s 5d] and won (1878) with two pair, =
Sevens and Sixes
Seat 7: MyManPotnPan showed [5s 5c] and lost with two pair, Sixes and F=
ives
Seat 9: burl5759 folded on the Turn


*********** # 7 **************
PokerStars Hand #170338298846: Tournament #1622573245, $4.55+$0.45 USD =
Hold'em No Limit - Level II (30/60) - 2017/05/24 21:06:23 ET
Table '1622573245 3' 9-max Seat #5 is the button
Seat 1: GoKen99 (9250 in chips)=20
Seat 2: Nick9965 (19925 in chips)=20
Seat 3: keyan349 (10425 in chips)=20
Seat 4: JJin91 (9750 in chips)=20
Seat 5: bigpond12 (9945 in chips)=20
Seat 6: ccmps (11014 in chips)=20
Seat 7: MyManPotnPan (9136 in chips)=20
Seat 9: burl5759 (10090 in chips)=20
ccmps: posts small blind 30
MyManPotnPan: posts big blind 60
*** HOLE CARDS ***
Dealt to JJin91 [3d 5d]
burl5759: folds=20
GoKen99: calls 60
Nick9965: folds=20
keyan349: raises 120 to 180
JJin91: folds=20
bigpond12: calls 180
ccmps: folds=20
MyManPotnPan: folds=20
GoKen99: folds=20
*** FLOP *** [3c 5s 7s]
keyan349: bets 255
bigpond12: raises 255 to 510
keyan349: calls 255
*** TURN *** [3c 5s 7s] [Tc]
keyan349: checks=20
bigpond12: bets 765
keyan349: folds=20
Uncalled bet (765) returned to bigpond12
bigpond12 collected 1530 from pot
bigpond12: doesn't show hand=20
*** SUMMARY ***
Total pot 1530 | Rake 0=20
Board [3c 5s 7s Tc]
Seat 1: GoKen99 folded before Flop
Seat 2: Nick9965 folded before Flop (didn't bet)
Seat 3: keyan349 folded on the Turn
Seat 4: JJin91 folded before Flop (didn't bet)
Seat 5: bigpond12 (button) collected (1530)
Seat 6: ccmps (small blind) folded before Flop
Seat 7: MyManPotnPan (big blind) folded before Flop
Seat 9: burl5759 folded before Flop (didn't bet)


*********** # 8 **************
PokerStars Hand #170338299002: Tournament #1622573245, $4.55+$0.45 USD =
Hold'em No Limit - Level II (30/60) - 2017/05/24 21:07:06 ET
Table '1622573245 3' 9-max Seat #6 is the button
Seat 1: GoKen99 (9190 in chips)=20
Seat 2: Nick9965 (19925 in chips)=20
Seat 3: keyan349 (9735 in chips)=20
Seat 4: JJin91 (9750 in chips)=20
Seat 5: bigpond12 (10785 in chips)=20
Seat 6: ccmps (10984 in chips)=20
Seat 7: MyManPotnPan (9076 in chips)=20
Seat 8: ytc25 (10000 in chips)=20
MyManPotnPan: posts small blind 30
ytc25: posts big blind 60
*** HOLE CARDS ***
Dealt to JJin91 [7h 9c]
GoKen99 has timed out
GoKen99: folds=20
GoKen99 is sitting out
Nick9965: folds=20
keyan349: folds=20
JJin91: folds=20
bigpond12: folds=20
ccmps: folds=20
MyManPotnPan: folds=20
Uncalled bet (30) returned to ytc25
ytc25 collected 60 from pot
ytc25: doesn't show hand=20
*** SUMMARY ***
Total pot 60 | Rake 0=20
Seat 1: GoKen99 folded before Flop (didn't bet)
Seat 2: Nick9965 folded before Flop (didn't bet)
Seat 3: keyan349 folded before Flop (didn't bet)
Seat 4: JJin91 folded before Flop (didn't bet)
Seat 5: bigpond12 folded before Flop (didn't bet)
Seat 6: ccmps (button) folded before Flop (didn't bet)
Seat 7: MyManPotnPan (small blind) folded before Flop
Seat 8: ytc25 (big blind) collected (60)


*********** # 9 **************
PokerStars Hand #170338299102: Tournament #1622573245, $4.55+$0.45 USD =
Hold'em No Limit - Level II (30/60) - 2017/05/24 21:07:31 ET
Table '1622573245 3' 9-max Seat #7 is the button
Seat 2: Nick9965 (19925 in chips)=20
Seat 3: keyan349 (9735 in chips)=20
Seat 4: JJin91 (9750 in chips)=20
Seat 5: bigpond12 (10785 in chips)=20
Seat 6: ccmps (10984 in chips)=20
Seat 7: MyManPotnPan (9046 in chips)=20
Seat 8: ytc25 (10030 in chips)=20
ytc25: posts small blind 30
Nick9965: posts big blind 60
*** HOLE CARDS ***
Dealt to JJin91 [Js Qh]
keyan349: calls 60
JJin91: folds=20
bigpond12: folds=20
ccmps: folds=20
MyManPotnPan: raises 120 to 180
ytc25: calls 150
Nick9965: calls 120
keyan349: calls 120
*** FLOP *** [5d 7h 3d]
ytc25: checks=20
Nick9965: checks=20
keyan349: checks=20
MyManPotnPan: checks=20
*** TURN *** [5d 7h 3d] [2c]
ytc25: checks=20
Nick9965: bets 720
keyan349: folds=20
MyManPotnPan: folds=20
ytc25: folds=20
Uncalled bet (720) returned to Nick9965
Nick9965 collected 720 from pot
*** SUMMARY ***
Total pot 720 | Rake 0=20
Board [5d 7h 3d 2c]
Seat 2: Nick9965 (big blind) collected (720)
Seat 3: keyan349 folded on the Turn
Seat 4: JJin91 folded before Flop (didn't bet)
Seat 5: bigpond12 folded before Flop (didn't bet)
Seat 6: ccmps folded before Flop (didn't bet)
Seat 7: MyManPotnPan (button) folded on the Turn
Seat 8: ytc25 (small blind) folded on the Turn


*********** # 10 **************
PokerStars Hand #170338299295: Tournament #1622573245, $4.55+$0.45 USD =
Hold'em No Limit - Level II (30/60) - 2017/05/24 21:08:13 ET
Table '1622573245 3' 9-max Seat #8 is the button
Seat 2: Nick9965 (20465 in chips)=20
Seat 3: keyan349 (9555 in chips)=20
Seat 4: JJin91 (9750 in chips)=20
Seat 5: bigpond12 (10785 in chips)=20
Seat 6: ccmps (10984 in chips)=20
Seat 7: MyManPotnPan (8866 in chips)=20
Seat 8: ytc25 (9850 in chips)=20
Nick9965: posts small blind 30
keyan349: posts big blind 60
*** HOLE CARDS ***
Dealt to JJin91 [9c Qh]
JJin91: folds=20
bigpond12: folds=20
ccmps: raises 90 to 150
MyManPotnPan: folds=20
ytc25: calls 150
Nick9965: calls 120
keyan349: calls 90
*** FLOP *** [Td 3s Ad]
Nick9965: checks=20
keyan349: checks=20
ccmps: checks=20
ytc25: bets 600
Nick9965: calls 600
keyan349: folds=20
ccmps: folds=20
*** TURN *** [Td 3s Ad] [Kd]
Nick9965: checks=20
ytc25: bets 1800
Nick9965: calls 1800
*** RIVER *** [Td 3s Ad Kd] [7c]
Nick9965: checks=20
ytc25: checks=20
*** SHOW DOWN ***
Nick9965: shows [Qs Th] (a pair of Tens)
ytc25: shows [2d As] (a pair of Aces)
ytc25 collected 5400 from pot
*** SUMMARY ***
Total pot 5400 | Rake 0=20
Board [Td 3s Ad Kd 7c]
Seat 2: Nick9965 (small blind) showed [Qs Th] and lost with a pair of T=
ens
Seat 3: keyan349 (big blind) folded on the Flop
Seat 4: JJin91 folded before Flop (didn't bet)
Seat 5: bigpond12 folded before Flop (didn't bet)
Seat 6: ccmps folded on the Flop
Seat 7: MyManPotnPan folded before Flop (didn't bet)
Seat 8: ytc25 (button) showed [2d As] and won (5400) with a pair of Aces


*********** # 11 **************
PokerStars Hand #170338299416: Tournament #1622573245, $4.55+$0.45 USD =
Hold'em No Limit - Level II (30/60) - 2017/05/24 21:08:45 ET
Table '1622573245 3' 9-max Seat #2 is the button
Seat 2: Nick9965 (17915 in chips)=20
Seat 3: keyan349 (9405 in chips)=20
Seat 4: JJin91 (9750 in chips)=20
Seat 5: bigpond12 (10785 in chips)=20
Seat 6: ccmps (10834 in chips)=20
Seat 7: MyManPotnPan (8866 in chips)=20
Seat 8: ytc25 (12700 in chips)=20
keyan349: posts small blind 30
JJin91: posts big blind 60
*** HOLE CARDS ***
Dealt to JJin91 [5c Qd]
bigpond12: folds=20
ccmps: folds=20
MyManPotnPan: folds=20
ytc25: raises 240 to 300
Nick9965: folds=20
keyan349: folds=20
JJin91: folds=20
Uncalled bet (240) returned to ytc25
ytc25 collected 150 from pot
ytc25: doesn't show hand=20
*** SUMMARY ***
Total pot 150 | Rake 0=20
Seat 2: Nick9965 (button) folded before Flop (didn't bet)
Seat 3: keyan349 (small blind) folded before Flop
Seat 4: JJin91 (big blind) folded before Flop
Seat 5: bigpond12 folded before Flop (didn't bet)
Seat 6: ccmps folded before Flop (didn't bet)
Seat 7: MyManPotnPan folded before Flop (didn't bet)
Seat 8: ytc25 collected (150)


*********** # 12 **************
PokerStars Hand #170338299481: Tournament #1622573245, $4.55+$0.45 USD =
Hold'em No Limit - Level II (30/60) - 2017/05/24 21:08:59 ET
Table '1622573245 3' 9-max Seat #3 is the button
Seat 1: JoJoe482 (10000 in chips)=20
Seat 2: Nick9965 (17915 in chips)=20
Seat 3: keyan349 (9375 in chips)=20
Seat 4: JJin91 (9690 in chips)=20
Seat 5: bigpond12 (10785 in chips)=20
Seat 6: ccmps (10834 in chips)=20
Seat 7: MyManPotnPan (8866 in chips)=20
Seat 8: ytc25 (12790 in chips)=20
JJin91: posts small blind 30
bigpond12: posts big blind 60
*** HOLE CARDS ***
Dealt to JJin91 [Ac 3c]
ccmps: folds=20
MyManPotnPan: folds=20
ytc25: calls 60
JoJoe482: raises 120 to 180
Nick9965: calls 180
keyan349: folds=20
JJin91: raises 600 to 780
bigpond12: calls 720
ytc25: folds=20
JoJoe482: calls 600
Nick9965: calls 600
*** FLOP *** [Qc 9d Th]
JJin91: checks=20
bigpond12: checks=20
JoJoe482: checks=20
Nick9965: bets 120
JJin91: folds=20
bigpond12: calls 120
JoJoe482: calls 120
*** TURN *** [Qc 9d Th] [4c]
bigpond12: bets 3540
JoJoe482: folds=20
Nick9965: folds=20
Uncalled bet (3540) returned to bigpond12
bigpond12 collected 3540 from pot
bigpond12: doesn't show hand=20
*** SUMMARY ***
Total pot 3540 | Rake 0=20
Board [Qc 9d Th 4c]
Seat 1: JoJoe482 folded on the Turn
Seat 2: Nick9965 folded on the Turn
Seat 3: keyan349 (button) folded before Flop (didn't bet)
Seat 4: JJin91 (small blind) folded on the Flop
Seat 5: bigpond12 (big blind) collected (3540)
Seat 6: ccmps folded before Flop (didn't bet)
Seat 7: MyManPotnPan folded before Flop (didn't bet)
Seat 8: ytc25 folded before Flop


*********** # 13 **************
PokerStars Hand #170338299744: Tournament #1622573245, $4.55+$0.45 USD =
Hold'em No Limit - Level II (30/60) - 2017/05/24 21:10:02 ET
Table '1622573245 3' 9-max Seat #4 is the button
Seat 1: JoJoe482 (9100 in chips)=20
Seat 2: Nick9965 (17015 in chips)=20
Seat 3: keyan349 (9375 in chips)=20
Seat 4: JJin91 (8910 in chips)=20
Seat 5: bigpond12 (13425 in chips)=20
Seat 6: ccmps (10834 in chips)=20
Seat 7: MyManPotnPan (8866 in chips)=20
Seat 8: ytc25 (12730 in chips)=20
bigpond12: posts small blind 30
ccmps: posts big blind 60
*** HOLE CARDS ***
Dealt to JJin91 [Qs 3s]
MyManPotnPan: folds=20
ytc25: calls 60
JoJoe482: folds=20
Nick9965: folds=20
keyan349: folds=20
JJin91: folds=20
bigpond12: folds=20
ccmps: checks=20
*** FLOP *** [4d Ts 7d]
ccmps: checks=20
ytc25: bets 150
ccmps: calls 150
*** TURN *** [4d Ts 7d] [5d]
ccmps: checks=20
ytc25: bets 225
ccmps: calls 225
*** RIVER *** [4d Ts 7d 5d] [2s]
ccmps: checks=20
ytc25: bets 450
ccmps: folds=20
Uncalled bet (450) returned to ytc25
ytc25 collected 900 from pot
ytc25: doesn't show hand=20
*** SUMMARY ***
Total pot 900 | Rake 0=20
Board [4d Ts 7d 5d 2s]
Seat 1: JoJoe482 folded before Flop (didn't bet)
Seat 2: Nick9965 folded before Flop (didn't bet)
Seat 3: keyan349 folded before Flop (didn't bet)
Seat 4: JJin91 (button) folded before Flop (didn't bet)
Seat 5: bigpond12 (small blind) folded before Flop
Seat 6: ccmps (big blind) folded on the River
Seat 7: MyManPotnPan folded before Flop (didn't bet)
Seat 8: ytc25 collected (900)


*********** # 14 **************
PokerStars Hand #170338299929: Tournament #1622573245, $4.55+$0.45 USD =
Hold'em No Limit - Level III (40/80) - 2017/05/24 21:10:47 ET
Table '1622573245 3' 9-max Seat #5 is the button
Seat 1: JoJoe482 (9100 in chips)=20
Seat 2: Nick9965 (17015 in chips)=20
Seat 3: keyan349 (9375 in chips)=20
Seat 4: JJin91 (8910 in chips)=20
Seat 5: bigpond12 (13395 in chips)=20
Seat 6: ccmps (10399 in chips)=20
Seat 7: MyManPotnPan (8866 in chips)=20
Seat 8: ytc25 (13195 in chips)=20
ccmps: posts small blind 40
MyManPotnPan: posts big blind 80
*** HOLE CARDS ***
Dealt to JJin91 [7s Ks]
ytc25: calls 80
JoJoe482: folds=20
Nick9965: calls 80
keyan349: folds=20
JJin91: folds=20
bigpond12: folds=20
ccmps: calls 40
MyManPotnPan: checks=20
*** FLOP *** [6c Ah 7d]
ccmps: checks=20
MyManPotnPan: checks=20
ytc25: bets 320
Nick9965: folds=20
ccmps: folds=20
MyManPotnPan: folds=20
Uncalled bet (320) returned to ytc25
ytc25 collected 320 from pot
ytc25: doesn't show hand=20
*** SUMMARY ***
Total pot 320 | Rake 0=20
Board [6c Ah 7d]
Seat 1: JoJoe482 folded before Flop (didn't bet)
Seat 2: Nick9965 folded on the Flop
Seat 3: keyan349 folded before Flop (didn't bet)
Seat 4: JJin91 folded before Flop (didn't bet)
Seat 5: bigpond12 (button) folded before Flop (didn't bet)
Seat 6: ccmps (small blind) folded on the Flop
Seat 7: MyManPotnPan (big blind) folded on the Flop
Seat 8: ytc25 collected (320)


*********** # 15 **************
PokerStars Hand #170339207350: Tournament #1622573245, $4.55+$0.45 USD =
Hold'em No Limit - Level III (40/80) - 2017/05/24 21:11:12 ET
Table '1622573245 3' 9-max Seat #6 is the button
Seat 1: JoJoe482 (9100 in chips)=20
Seat 2: Nick9965 (16935 in chips)=20
Seat 3: keyan349 (9375 in chips)=20
Seat 4: JJin91 (8910 in chips)=20
Seat 5: bigpond12 (13395 in chips)=20
Seat 6: ccmps (10319 in chips)=20
Seat 7: MyManPotnPan (8786 in chips)=20
Seat 8: ytc25 (13435 in chips)=20
MyManPotnPan: posts small blind 40
ytc25: posts big blind 80
*** HOLE CARDS ***
Dealt to JJin91 [Ad 3d]
JoJoe482: folds=20
Nick9965: folds=20
keyan349: folds=20
JJin91: raises 95 to 175
bigpond12: calls 175
ccmps: folds=20
MyManPotnPan: folds=20
ytc25: calls 95
*** FLOP *** [Ah 9d Kc]
ytc25: checks=20
JJin91: checks=20
bigpond12: checks=20
*** TURN *** [Ah 9d Kc] [3s]
ytc25: bets 565
JJin91: calls 565
bigpond12: folds=20
*** RIVER *** [Ah 9d Kc 3s] [3h]
ytc25: bets 400
JJin91: raises 7770 to 8170 and is all-in
ccmps is sitting out
ytc25: folds=20
Uncalled bet (7770) returned to JJin91
JJin91 collected 2495 from pot
JJin91: doesn't show hand=20
*** SUMMARY ***
Total pot 2495 | Rake 0=20
Board [Ah 9d Kc 3s 3h]
Seat 1: JoJoe482 folded before Flop (didn't bet)
Seat 2: Nick9965 folded before Flop (didn't bet)
Seat 3: keyan349 folded before Flop (didn't bet)
Seat 4: JJin91 collected (2495)
Seat 5: bigpond12 folded on the Turn
Seat 6: ccmps (button) folded before Flop (didn't bet)
Seat 7: MyManPotnPan (small blind) folded before Flop
Seat 8: ytc25 (big blind) folded on the River


*********** # 16 **************
PokerStars Hand #170339207692: Tournament #1622573245, $4.55+$0.45 USD =
Hold'em No Limit - Level III (40/80) - 2017/05/24 21:12:32 ET
Table '1622573245 3' 9-max Seat #7 is the button
Seat 2: Nick9965 (16935 in chips)=20
Seat 3: keyan349 (9375 in chips)=20
Seat 4: JJin91 (10265 in chips)=20
Seat 5: bigpond12 (13220 in chips)=20
Seat 6: ccmps (10319 in chips) is sitting out
Seat 7: MyManPotnPan (8746 in chips)=20
Seat 8: ytc25 (12295 in chips)=20
Seat 9: Lootchie22 (10000 in chips)=20
ytc25: posts small blind 40
Lootchie22: posts big blind 80
*** HOLE CARDS ***
Dealt to JJin91 [3h 8d]
Nick9965: folds=20
keyan349: folds=20
JJin91: folds=20
bigpond12: folds=20
ccmps: folds=20
MyManPotnPan: folds=20
ytc25: folds=20
Uncalled bet (40) returned to Lootchie22
Lootchie22 collected 80 from pot
Lootchie22: doesn't show hand=20
*** SUMMARY ***
Total pot 80 | Rake 0=20
Seat 2: Nick9965 folded before Flop (didn't bet)
Seat 3: keyan349 folded before Flop (didn't bet)
Seat 4: JJin91 folded before Flop (didn't bet)
Seat 5: bigpond12 folded before Flop (didn't bet)
Seat 6: ccmps folded before Flop (didn't bet)
Seat 7: MyManPotnPan (button) folded before Flop (didn't bet)
Seat 8: ytc25 (small blind) folded before Flop
Seat 9: Lootchie22 (big blind) collected (80)


*********** # 17 **************
PokerStars Hand #170339207804: Tournament #1622573245, $4.55+$0.45 USD =
Hold'em No Limit - Level III (40/80) - 2017/05/24 21:13:02 ET
Table '1622573245 5' 9-max Seat #2 is the button
Seat 1: kudman22 (8266 in chips)=20
Seat 2: Towerclub735 (9830 in chips)=20
Seat 3: JoJoe482 (9020 in chips)=20
Seat 4: joiseyjoe15 (10000 in chips)=20
Seat 5: Biglopes54 (10000 in chips)=20
Seat 6: JJin91 (10265 in chips)=20
JoJoe482: posts small blind 40
joiseyjoe15: posts big blind 80
*** HOLE CARDS ***
Dealt to JJin91 [7c Qh]
Biglopes54: calls 80
JJin91: folds=20
kudman22: calls 80
Towerclub735: calls 80
JoJoe482: calls 40
joiseyjoe15: checks=20
*** FLOP *** [9c 9d 8s]
JoJoe482: checks=20
joiseyjoe15: checks=20
Biglopes54: checks=20
kudman22: checks=20
Towerclub735: bets 80
JoJoe482: folds=20
joiseyjoe15: folds=20
Biglopes54: calls 80
kudman22: calls 80
*** TURN *** [9c 9d 8s] [Ac]
Biglopes54: checks=20
kudman22: bets 320
Towerclub735: folds=20
Biglopes54: calls 320
*** RIVER *** [9c 9d 8s Ac] [3d]
Biglopes54: checks=20
kudman22: checks=20
*** SHOW DOWN ***
Biglopes54: shows [Jc Js] (two pair, Jacks and Nines)
kudman22: shows [4d Ad] (two pair, Aces and Nines)
kudman22 collected 1280 from pot
*** SUMMARY ***
Total pot 1280 | Rake 0=20
Board [9c 9d 8s Ac 3d]
Seat 1: kudman22 showed [4d Ad] and won (1280) with two pair, Aces and =
Nines
Seat 2: Towerclub735 (button) folded on the Turn
Seat 3: JoJoe482 (small blind) folded on the Flop
Seat 4: joiseyjoe15 (big blind) folded on the Flop
Seat 5: Biglopes54 showed [Jc Js] and lost with two pair, Jacks and Nin=
es
Seat 6: JJin91 folded before Flop (didn't bet)


*********** # 18 **************
PokerStars Hand #170339208065: Tournament #1622573245, $4.55+$0.45 USD =
Hold'em No Limit - Level III (40/80) - 2017/05/24 21:14:00 ET
Table '1622573245 5' 9-max Seat #3 is the button
Seat 1: kudman22 (9066 in chips)=20
Seat 2: Towerclub735 (9670 in chips)=20
Seat 3: JoJoe482 (8940 in chips)=20
Seat 4: joiseyjoe15 (9920 in chips)=20
Seat 5: Biglopes54 (9520 in chips)=20
Seat 6: JJin91 (10265 in chips)=20
Seat 7: gator856500 (6648 in chips)=20
joiseyjoe15: posts small blind 40
Biglopes54: posts big blind 80
*** HOLE CARDS ***
Dealt to JJin91 [6d Kc]
JJin91: folds=20
gator856500: folds=20
kudman22: folds=20
Towerclub735: folds=20
JoJoe482: folds=20
joiseyjoe15: folds=20
Uncalled bet (40) returned to Biglopes54
Biglopes54 collected 80 from pot
Biglopes54: doesn't show hand=20
*** SUMMARY ***
Total pot 80 | Rake 0=20
Seat 1: kudman22 folded before Flop (didn't bet)
Seat 2: Towerclub735 folded before Flop (didn't bet)
Seat 3: JoJoe482 (button) folded before Flop (didn't bet)
Seat 4: joiseyjoe15 (small blind) folded before Flop
Seat 5: Biglopes54 (big blind) collected (80)
Seat 6: JJin91 folded before Flop (didn't bet)
Seat 7: gator856500 folded before Flop (didn't bet)


*********** # 19 **************
PokerStars Hand #170339208125: Tournament #1622573245, $4.55+$0.45 USD =
Hold'em No Limit - Level III (40/80) - 2017/05/24 21:14:17 ET
Table '1622573245 5' 9-max Seat #4 is the button
Seat 1: kudman22 (9066 in chips)=20
Seat 2: Towerclub735 (9670 in chips)=20
Seat 3: JoJoe482 (8940 in chips)=20
Seat 4: joiseyjoe15 (9880 in chips)=20
Seat 5: Biglopes54 (9560 in chips)=20
Seat 6: JJin91 (10265 in chips)=20
Seat 7: gator856500 (6648 in chips)=20
Biglopes54: posts small blind 40
JJin91: posts big blind 80
*** HOLE CARDS ***
Dealt to JJin91 [3c 5s]
gator856500: folds=20
kudman22: folds=20
Towerclub735: calls 80
JoJoe482: folds=20
joiseyjoe15: folds=20
Biglopes54: calls 40
JJin91: checks=20
*** FLOP *** [Th 4d 4c]
Biglopes54: checks=20
JJin91: checks=20
Towerclub735: bets 80
Biglopes54: folds=20
JJin91: folds=20
Uncalled bet (80) returned to Towerclub735
Towerclub735 collected 240 from pot
*** SUMMARY ***
Total pot 240 | Rake 0=20
Board [Th 4d 4c]
Seat 1: kudman22 folded before Flop (didn't bet)
Seat 2: Towerclub735 collected (240)
Seat 3: JoJoe482 folded before Flop (didn't bet)
Seat 4: joiseyjoe15 (button) folded before Flop (didn't bet)
Seat 5: Biglopes54 (small blind) folded on the Flop
Seat 6: JJin91 (big blind) folded on the Flop
Seat 7: gator856500 folded before Flop (didn't bet)


*********** # 20 **************
PokerStars Hand #170339208264: Tournament #1622573245, $4.55+$0.45 USD =
Hold'em No Limit - Level III (40/80) - 2017/05/24 21:14:49 ET
Table '1622573245 5' 9-max Seat #5 is the button
Seat 1: kudman22 (9066 in chips)=20
Seat 2: Towerclub735 (9830 in chips)=20
Seat 3: JoJoe482 (8940 in chips)=20
Seat 4: joiseyjoe15 (9880 in chips)=20
Seat 5: Biglopes54 (9480 in chips)=20
Seat 6: JJin91 (10185 in chips)=20
Seat 7: gator856500 (6648 in chips)=20
Seat 8: CaptN421 (10000 in chips)=20
JJin91: posts small blind 40
gator856500: posts big blind 80
*** HOLE CARDS ***
Dealt to JJin91 [3h Ah]
CaptN421: raises 200 to 280
kudman22: folds=20
Towerclub735: folds=20
JoJoe482: folds=20
joiseyjoe15: calls 280
Biglopes54: folds=20
JJin91: calls 240
gator856500: folds=20
*** FLOP *** [8c 4c Qh]
JJin91: checks=20
CaptN421: bets 640
joiseyjoe15: raises 2160 to 2800
JJin91: folds=20
CaptN421: calls 2160
*** TURN *** [8c 4c Qh] [7d]
CaptN421: checks=20
joiseyjoe15: bets 6480
CaptN421: folds=20
Uncalled bet (6480) returned to joiseyjoe15
joiseyjoe15 collected 6520 from pot
joiseyjoe15: doesn't show hand=20
*** SUMMARY ***
Total pot 6520 | Rake 0=20
Board [8c 4c Qh 7d]
Seat 1: kudman22 folded before Flop (didn't bet)
Seat 2: Towerclub735 folded before Flop (didn't bet)
Seat 3: JoJoe482 folded before Flop (didn't bet)
Seat 4: joiseyjoe15 collected (6520)
Seat 5: Biglopes54 (button) folded before Flop (didn't bet)
Seat 6: JJin91 (small blind) folded on the Flop
Seat 7: gator856500 (big blind) folded before Flop
Seat 8: CaptN421 folded on the Turn


*********** # 21 **************
PokerStars Hand #170339208519: Tournament #1622573245, $4.55+$0.45 USD =
Hold'em No Limit - Level IV (50/100) - 2017/05/24 21:16:00 ET
Table '1622573245 5' 9-max Seat #6 is the button
Seat 1: kudman22 (9066 in chips)=20
Seat 2: Towerclub735 (9830 in chips)=20
Seat 3: JoJoe482 (8940 in chips)=20
Seat 4: joiseyjoe15 (13320 in chips)=20
Seat 5: Biglopes54 (9480 in chips)=20
Seat 6: JJin91 (9905 in chips)=20
Seat 7: gator856500 (6568 in chips)=20
Seat 8: CaptN421 (6920 in chips)=20
kudman22: posts the ante 10
Towerclub735: posts the ante 10
JoJoe482: posts the ante 10
joiseyjoe15: posts the ante 10
Biglopes54: posts the ante 10
JJin91: posts the ante 10
gator856500: posts the ante 10
CaptN421: posts the ante 10
gator856500: posts small blind 50
CaptN421: posts big blind 100
*** HOLE CARDS ***
Dealt to JJin91 [8d Kd]
kudman22: folds=20
Towerclub735: folds=20
JoJoe482: folds=20
joiseyjoe15: calls 100
Biglopes54: calls 100
JJin91: raises 600 to 700
gator856500: folds=20
CaptN421: raises 6210 to 6910 and is all-in
joiseyjoe15: folds=20
Biglopes54: folds=20
JJin91: folds=20
Uncalled bet (6210) returned to CaptN421
CaptN421 collected 1730 from pot
CaptN421: doesn't show hand=20
*** SUMMARY ***
Total pot 1730 | Rake 0=20
Seat 1: kudman22 folded before Flop (didn't bet)
Seat 2: Towerclub735 folded before Flop (didn't bet)
Seat 3: JoJoe482 folded before Flop (didn't bet)
Seat 4: joiseyjoe15 folded before Flop
Seat 5: Biglopes54 folded before Flop
Seat 6: JJin91 (button) folded before Flop
Seat 7: gator856500 (small blind) folded before Flop
Seat 8: CaptN421 (big blind) collected (1730)


*********** # 22 **************
PokerStars Hand #170339208743: Tournament #1622573245, $4.55+$0.45 USD =
Hold'em No Limit - Level IV (50/100) - 2017/05/24 21:16:53 ET
Table '1622573245 5' 9-max Seat #7 is the button
Seat 1: kudman22 (9056 in chips)=20
Seat 2: Towerclub735 (9820 in chips)=20
Seat 3: JoJoe482 (8930 in chips)=20
Seat 4: joiseyjoe15 (13210 in chips)=20
Seat 5: Biglopes54 (9370 in chips)=20
Seat 6: JJin91 (9195 in chips)=20
Seat 7: gator856500 (6508 in chips)=20
Seat 8: CaptN421 (7940 in chips)=20
Seat 9: vitt409 (10000 in chips)=20
kudman22: posts the ante 10
Towerclub735: posts the ante 10
JoJoe482: posts the ante 10
joiseyjoe15: posts the ante 10
Biglopes54: posts the ante 10
JJin91: posts the ante 10
gator856500: posts the ante 10
CaptN421: posts the ante 10
vitt409: posts the ante 10
CaptN421: posts small blind 50
vitt409: posts big blind 100
*** HOLE CARDS ***
Dealt to JJin91 [7h 2h]
kudman22: raises 150 to 250
Towerclub735: folds=20
JoJoe482: calls 250
joiseyjoe15: folds=20
Biglopes54: raises 350 to 600
JJin91: folds=20
gator856500: folds=20
CaptN421: calls 550
vitt409: folds=20
kudman22: raises 8446 to 9046 and is all-in
JoJoe482: folds=20
Biglopes54: raises 314 to 9360 and is all-in
CaptN421: calls 7330 and is all-in
Uncalled bet (314) returned to Biglopes54
*** FLOP *** [3c Qh As]
*** TURN *** [3c Qh As] [5h]
*** RIVER *** [3c Qh As 5h] [8s]
*** SHOW DOWN ***
kudman22: shows [Ah Kc] (a pair of Aces)
Biglopes54: shows [Jh Jc] (a pair of Jacks)
kudman22 collected 2232 from side pot
CaptN421: shows [Qd Ks] (a pair of Queens)
kudman22 collected 24230 from main pot
CaptN421 finished the tournament in 113th place
*** SUMMARY ***
Total pot 26462 Main pot 24230. Side pot 2232. | Rake 0=20
Board [3c Qh As 5h 8s]
Seat 1: kudman22 showed [Ah Kc] and won (26462) with a pair of Aces
Seat 2: Towerclub735 folded before Flop (didn't bet)
Seat 3: JoJoe482 folded before Flop
Seat 4: joiseyjoe15 folded before Flop (didn't bet)
Seat 5: Biglopes54 showed [Jh Jc] and lost with a pair of Jacks
Seat 6: JJin91 folded before Flop (didn't bet)
Seat 7: gator856500 (button) folded before Flop (didn't bet)
Seat 8: CaptN421 (small blind) showed [Qd Ks] and lost with a pair of Q=
ueens
Seat 9: vitt409 (big blind) folded before Flop


*********** # 23 **************
PokerStars Hand #170339209000: Tournament #1622573245, $4.55+$0.45 USD =
Hold'em No Limit - Level IV (50/100) - 2017/05/24 21:18:00 ET
Table '1622573245 5' 9-max Seat #9 is the button
Seat 1: kudman22 (26462 in chips)=20
Seat 2: Towerclub735 (9810 in chips)=20
Seat 3: JoJoe482 (8670 in chips)=20
Seat 4: joiseyjoe15 (13200 in chips)=20
Seat 5: Biglopes54 (314 in chips)=20
Seat 6: JJin91 (9185 in chips)=20
Seat 7: gator856500 (6498 in chips)=20
Seat 9: vitt409 (9890 in chips)=20
kudman22: posts the ante 10
Towerclub735: posts the ante 10
JoJoe482: posts the ante 10
joiseyjoe15: posts the ante 10
Biglopes54: posts the ante 10
JJin91: posts the ante 10
gator856500: posts the ante 10
vitt409: posts the ante 10
kudman22: posts small blind 50
Towerclub735: posts big blind 100
*** HOLE CARDS ***
Dealt to JJin91 [6d 9s]
JoJoe482: folds=20
joiseyjoe15: folds=20
Biglopes54: raises 204 to 304 and is all-in
JJin91: folds=20
gator856500: folds=20
vitt409: calls 304
kudman22: folds=20
Towerclub735: folds=20
*** FLOP *** [2s As 3d]
*** TURN *** [2s As 3d] [9d]
*** RIVER *** [2s As 3d 9d] [7s]
*** SHOW DOWN ***
Biglopes54: shows [Jc Th] (high card Ace)
vitt409: shows [Qd 7d] (a pair of Sevens)
vitt409 collected 838 from pot
Biglopes54 finished the tournament in 112th place
*** SUMMARY ***
Total pot 838 | Rake 0=20
Board [2s As 3d 9d 7s]
Seat 1: kudman22 (small blind) folded before Flop
Seat 2: Towerclub735 (big blind) folded before Flop
Seat 3: JoJoe482 folded before Flop (didn't bet)
Seat 4: joiseyjoe15 folded before Flop (didn't bet)
Seat 5: Biglopes54 showed [Jc Th] and lost with high card Ace
Seat 6: JJin91 folded before Flop (didn't bet)
Seat 7: gator856500 folded before Flop (didn't bet)
Seat 9: vitt409 (button) showed [Qd 7d] and won (838) with a pair of Se=
vens


*********** # 24 **************
PokerStars Hand #170339209087: Tournament #1622573245, $4.55+$0.45 USD =
Hold'em No Limit - Level IV (50/100) - 2017/05/24 21:18:24 ET
Table '1622573245 5' 9-max Seat #1 is the button
Seat 1: kudman22 (26402 in chips)=20
Seat 2: Towerclub735 (9700 in chips)=20
Seat 3: JoJoe482 (8660 in chips)=20
Seat 4: joiseyjoe15 (13190 in chips)=20
Seat 6: JJin91 (9175 in chips)=20
Seat 7: gator856500 (6488 in chips)=20
Seat 9: vitt409 (10414 in chips)=20
kudman22: posts the ante 10
Towerclub735: posts the ante 10
JoJoe482: posts the ante 10
joiseyjoe15: posts the ante 10
JJin91: posts the ante 10
gator856500: posts the ante 10
vitt409: posts the ante 10
Towerclub735: posts small blind 50
JoJoe482: posts big blind 100
*** HOLE CARDS ***
Dealt to JJin91 [As 5s]
joiseyjoe15: calls 100
JJin91: folds=20
gator856500: calls 100
vitt409: folds=20
kudman22: calls 100
Towerclub735: folds=20
JoJoe482: checks=20
*** FLOP *** [2d 8c 7d]
JoJoe482: checks=20
joiseyjoe15: checks=20
gator856500: checks=20
kudman22: bets 182
JoJoe482: folds=20
joiseyjoe15: folds=20
gator856500: calls 182
*** TURN *** [2d 8c 7d] [3c]
gator856500: bets 442
kudman22: folds=20
Uncalled bet (442) returned to gator856500
gator856500 collected 884 from pot
gator856500: doesn't show hand=20
*** SUMMARY ***
Total pot 884 | Rake 0=20
Board [2d 8c 7d 3c]
Seat 1: kudman22 (button) folded on the Turn
Seat 2: Towerclub735 (small blind) folded before Flop
Seat 3: JoJoe482 (big blind) folded on the Flop
Seat 4: joiseyjoe15 folded on the Flop
Seat 6: JJin91 folded before Flop (didn't bet)
Seat 7: gator856500 collected (884)
Seat 9: vitt409 folded before Flop (didn't bet)


*********** # 25 **************
PokerStars Hand #170339209393: Tournament #1622573245, $4.55+$0.45 USD =
Hold'em No Limit - Level IV (50/100) - 2017/05/24 21:19:43 ET
Table '1622573245 5' 9-max Seat #2 is the button
Seat 1: kudman22 (26110 in chips)=20
Seat 2: Towerclub735 (9640 in chips)=20
Seat 3: JoJoe482 (8550 in chips)=20
Seat 5: Super Donk54 (10000 in chips)=20
Seat 6: JJin91 (9165 in chips)=20
Seat 7: gator856500 (7080 in chips)=20
Seat 8: Biglopes54 (10000 in chips)=20
Seat 9: vitt409 (10404 in chips)=20
kudman22: posts the ante 10
Towerclub735: posts the ante 10
JoJoe482: posts the ante 10
Super Donk54: posts the ante 10
JJin91: posts the ante 10
gator856500: posts the ante 10
Biglopes54: posts the ante 10
vitt409: posts the ante 10
JoJoe482: posts small blind 50
Super Donk54: posts big blind 100
*** HOLE CARDS ***
Dealt to JJin91 [2s 5s]
JJin91: folds=20
gator856500: folds=20
Biglopes54: folds=20
vitt409: folds=20
kudman22: folds=20
Towerclub735: calls 100
JoJoe482: folds=20
Super Donk54: checks=20
*** FLOP *** [7d Jh Ad]
Super Donk54: checks=20
Towerclub735: checks=20
*** TURN *** [7d Jh Ad] [6s]
Super Donk54: bets 100
Towerclub735: calls 100
*** RIVER *** [7d Jh Ad 6s] [Kh]
Super Donk54: checks=20
Towerclub735: checks=20
*** SHOW DOWN ***
Super Donk54: shows [5d Td] (high card Ace)
Towerclub735: shows [Ts Tc] (a pair of Tens)
Towerclub735 collected 530 from pot
*** SUMMARY ***
Total pot 530 | Rake 0=20
Board [7d Jh Ad 6s Kh]
Seat 1: kudman22 folded before Flop (didn't bet)
Seat 2: Towerclub735 (button) showed [Ts Tc] and won (530) with a pair =
of Tens
Seat 3: JoJoe482 (small blind) folded before Flop
Seat 5: Super Donk54 (big blind) showed [5d Td] and lost with high card=
 Ace
Seat 6: JJin91 folded before Flop (didn't bet)
Seat 7: gator856500 folded before Flop (didn't bet)
Seat 8: Biglopes54 folded before Flop (didn't bet)
Seat 9: vitt409 folded before Flop (didn't bet)


*********** # 26 **************
PokerStars Hand #170339209584: Tournament #1622573245, $4.55+$0.45 USD =
Hold'em No Limit - Level V (60/120) - 2017/05/24 21:20:32 ET
Table '1622573245 5' 9-max Seat #3 is the button
Seat 1: kudman22 (26100 in chips)=20
Seat 2: Towerclub735 (9960 in chips)=20
Seat 3: JoJoe482 (8490 in chips)=20
Seat 5: Super Donk54 (9790 in chips)=20
Seat 6: JJin91 (9155 in chips)=20
Seat 7: gator856500 (7070 in chips)=20
Seat 9: vitt409 (10394 in chips)=20
kudman22: posts the ante 15
Towerclub735: posts the ante 15
JoJoe482: posts the ante 15
Super Donk54: posts the ante 15
JJin91: posts the ante 15
gator856500: posts the ante 15
vitt409: posts the ante 15
Super Donk54: posts small blind 60
JJin91: posts big blind 120
*** HOLE CARDS ***
Dealt to JJin91 [6d As]
gator856500: calls 120
vitt409: calls 120
kudman22: folds=20
Towerclub735: folds=20
JoJoe482: raises 360 to 480
Super Donk54: folds=20
JJin91: folds=20
gator856500: calls 360
vitt409: folds=20
*** FLOP *** [Qh Ts Jh]
gator856500: checks=20
JoJoe482: bets 1320
gator856500: calls 1320
*** TURN *** [Qh Ts Jh] [8c]
gator856500: checks=20
JoJoe482: bets 3960
gator856500: calls 3960
*** RIVER *** [Qh Ts Jh 8c] [5s]
gator856500: checks=20
JoJoe482: bets 2715 and is all-in
gator856500: calls 1295 and is all-in
Uncalled bet (1420) returned to JoJoe482
*** SHOW DOWN ***
JoJoe482: shows [Qd Qc] (three of a kind, Queens)
gator856500: shows [Ah Jd] (a pair of Jacks)
JoJoe482 collected 14515 from pot
gator856500 finished the tournament in 110th place
*** SUMMARY ***
Total pot 14515 | Rake 0=20
Board [Qh Ts Jh 8c 5s]
Seat 1: kudman22 folded before Flop (didn't bet)
Seat 2: Towerclub735 folded before Flop (didn't bet)
Seat 3: JoJoe482 (button) showed [Qd Qc] and won (14515) with three of =
a kind, Queens
Seat 5: Super Donk54 (small blind) folded before Flop
Seat 6: JJin91 (big blind) folded before Flop
Seat 7: gator856500 showed [Ah Jd] and lost with a pair of Jacks
Seat 9: vitt409 folded before Flop


*********** # 27 **************
PokerStars Hand #170339209868: Tournament #1622573245, $4.55+$0.45 USD =
Hold'em No Limit - Level V (60/120) - 2017/05/24 21:21:46 ET
Table '1622573245 5' 9-max Seat #5 is the button
Seat 1: kudman22 (26085 in chips)=20
Seat 2: Towerclub735 (9945 in chips)=20
Seat 3: JoJoe482 (15935 in chips)=20
Seat 4: ssweetn (10000 in chips)=20
Seat 5: Super Donk54 (9715 in chips)=20
Seat 6: JJin91 (9020 in chips)=20
Seat 7: gator856500 (10000 in chips)=20
Seat 8: slb9724 (9945 in chips)=20
Seat 9: vitt409 (10259 in chips)=20
kudman22: posts the ante 15
Towerclub735: posts the ante 15
JoJoe482: posts the ante 15
ssweetn: posts the ante 15
Super Donk54: posts the ante 15
JJin91: posts the ante 15
gator856500: posts the ante 15
slb9724: posts the ante 15
vitt409: posts the ante 15
JJin91: posts small blind 60
gator856500: posts big blind 120
*** HOLE CARDS ***
Dealt to JJin91 [3s 3d]
slb9724: folds=20
vitt409: raises 240 to 360
kudman22: folds=20
Towerclub735: folds=20
JoJoe482: folds=20
ssweetn: folds=20
Super Donk54: calls 360
JJin91: calls 300
gator856500: folds=20
*** FLOP *** [8s 9c 5s]
JJin91: checks=20
vitt409: bets 120
Super Donk54: folds=20
JJin91: calls 120
*** TURN *** [8s 9c 5s] [Ks]
JJin91: checks=20
vitt409: checks=20
*** RIVER *** [8s 9c 5s Ks] [Ts]
JJin91: checks=20
vitt409: checks=20
*** SHOW DOWN ***
JJin91: shows [3s 3d] (a flush, King high)
vitt409: mucks hand=20
JJin91 collected 1575 from pot
*** SUMMARY ***
Total pot 1575 | Rake 0=20
Board [8s 9c 5s Ks Ts]
Seat 1: kudman22 folded before Flop (didn't bet)
Seat 2: Towerclub735 folded before Flop (didn't bet)
Seat 3: JoJoe482 folded before Flop (didn't bet)
Seat 4: ssweetn folded before Flop (didn't bet)
Seat 5: Super Donk54 (button) folded on the Flop
Seat 6: JJin91 (small blind) showed [3s 3d] and won (1575) with a flush=
, King high
Seat 7: gator856500 (big blind) folded before Flop
Seat 8: slb9724 folded before Flop (didn't bet)
Seat 9: vitt409 mucked [Tc Ac]


*********** # 28 **************
PokerStars Hand #170339538084: Tournament #1622573245, $4.55+$0.45 USD =
Hold'em No Limit - Level V (60/120) - 2017/05/24 21:23:02 ET
Table '1622573245 5' 9-max Seat #6 is the button
Seat 1: kudman22 (26070 in chips)=20
Seat 2: Towerclub735 (9930 in chips)=20
Seat 3: JoJoe482 (15920 in chips)=20
Seat 4: ssweetn (9985 in chips)=20
Seat 5: Super Donk54 (9340 in chips)=20
Seat 6: JJin91 (10100 in chips)=20
Seat 7: gator856500 (9865 in chips)=20
Seat 8: slb9724 (9930 in chips)=20
Seat 9: vitt409 (9764 in chips)=20
kudman22: posts the ante 15
Towerclub735: posts the ante 15
JoJoe482: posts the ante 15
ssweetn: posts the ante 15
Super Donk54: posts the ante 15
JJin91: posts the ante 15
gator856500: posts the ante 15
slb9724: posts the ante 15
vitt409: posts the ante 15
gator856500: posts small blind 60
slb9724: posts big blind 120
*** HOLE CARDS ***
Dealt to JJin91 [5s Qh]
vitt409: calls 120
kudman22: calls 120
Towerclub735: calls 120
JoJoe482: folds=20
ssweetn: raises 360 to 480
Super Donk54: folds=20
JJin91: folds=20
gator856500: folds=20
slb9724: calls 360
vitt409: calls 360
kudman22: calls 360
Towerclub735: folds=20
*** FLOP *** [Qs 6d Kc]
slb9724: checks=20
vitt409: checks=20
kudman22: checks=20
ssweetn: bets 1080
slb9724: calls 1080
vitt409: folds=20
kudman22: folds=20
*** TURN *** [Qs 6d Kc] [9s]
slb9724: checks=20
ssweetn: checks=20
*** RIVER *** [Qs 6d Kc 9s] [Ks]
slb9724: bets 2198
ssweetn: folds=20
Uncalled bet (2198) returned to slb9724
slb9724 collected 4395 from pot
slb9724: doesn't show hand=20
*** SUMMARY ***
Total pot 4395 | Rake 0=20
Board [Qs 6d Kc 9s Ks]
Seat 1: kudman22 folded on the Flop
Seat 2: Towerclub735 folded before Flop
Seat 3: JoJoe482 folded before Flop (didn't bet)
Seat 4: ssweetn folded on the River
Seat 5: Super Donk54 folded before Flop (didn't bet)
Seat 6: JJin91 (button) folded before Flop (didn't bet)
Seat 7: gator856500 (small blind) folded before Flop
Seat 8: slb9724 (big blind) collected (4395)
Seat 9: vitt409 folded on the Flop


*********** # 29 **************
PokerStars Hand #170339538404: Tournament #1622573245, $4.55+$0.45 USD =
Hold'em No Limit - Level V (60/120) - 2017/05/24 21:24:16 ET
Table '1622573245 5' 9-max Seat #7 is the button
Seat 1: kudman22 (25575 in chips)=20
Seat 2: Towerclub735 (9795 in chips)=20
Seat 3: JoJoe482 (15905 in chips)=20
Seat 4: ssweetn (8410 in chips)=20
Seat 5: Super Donk54 (9325 in chips)=20
Seat 6: JJin91 (10085 in chips)=20
Seat 7: gator856500 (9790 in chips)=20
Seat 8: slb9724 (12750 in chips)=20
Seat 9: vitt409 (9269 in chips)=20
kudman22: posts the ante 15
Towerclub735: posts the ante 15
JoJoe482: posts the ante 15
ssweetn: posts the ante 15
Super Donk54: posts the ante 15
JJin91: posts the ante 15
gator856500: posts the ante 15
slb9724: posts the ante 15
vitt409: posts the ante 15
slb9724: posts small blind 60
vitt409: posts big blind 120
*** HOLE CARDS ***
Dealt to JJin91 [5c Qh]
kudman22: raises 195 to 315
Towerclub735: folds=20
JoJoe482: folds=20
ssweetn: folds=20
Super Donk54: folds=20
JJin91: folds=20
gator856500: calls 315
slb9724: folds=20
vitt409: calls 195
*** FLOP *** [Qs 2s Ac]
vitt409: bets 120
kudman22: raises 483 to 603
gator856500: folds=20
vitt409: calls 483
*** TURN *** [Qs 2s Ac] [Jc]
vitt409: checks=20
kudman22: bets 821
vitt409: calls 821
*** RIVER *** [Qs 2s Ac Jc] [5s]
vitt409: checks=20
kudman22: checks=20
*** SHOW DOWN ***
vitt409: shows [As 6s] (a flush, Ace high)
kudman22: mucks hand=20
vitt409 collected 3988 from pot
*** SUMMARY ***
Total pot 3988 | Rake 0=20
Board [Qs 2s Ac Jc 5s]
Seat 1: kudman22 mucked [Js Ad]
Seat 2: Towerclub735 folded before Flop (didn't bet)
Seat 3: JoJoe482 folded before Flop (didn't bet)
Seat 4: ssweetn folded before Flop (didn't bet)
Seat 5: Super Donk54 folded before Flop (didn't bet)
Seat 6: JJin91 folded before Flop (didn't bet)
Seat 7: gator856500 (button) folded on the Flop
Seat 8: slb9724 (small blind) folded before Flop
Seat 9: vitt409 (big blind) showed [As 6s] and won (3988) with a flush,=
 Ace high


*********** # 30 **************
PokerStars Hand #170339538713: Tournament #1622573245, $4.55+$0.45 USD =
Hold'em No Limit - Level VI (75/150) - 2017/05/24 21:25:28 ET
Table '1622573245 5' 9-max Seat #8 is the button
Seat 1: kudman22 (23821 in chips)=20
Seat 2: Towerclub735 (9780 in chips)=20
Seat 3: JoJoe482 (15890 in chips)=20
Seat 4: ssweetn (8395 in chips)=20
Seat 5: Super Donk54 (9310 in chips)=20
Seat 6: JJin91 (10070 in chips)=20
Seat 7: gator856500 (9460 in chips)=20
Seat 8: slb9724 (12675 in chips)=20
Seat 9: vitt409 (11503 in chips)=20
kudman22: posts the ante 20
Towerclub735: posts the ante 20
JoJoe482: posts the ante 20
ssweetn: posts the ante 20
Super Donk54: posts the ante 20
JJin91: posts the ante 20
gator856500: posts the ante 20
slb9724: posts the ante 20
vitt409: posts the ante 20
vitt409: posts small blind 75
kudman22: posts big blind 150
*** HOLE CARDS ***
Dealt to JJin91 [9s 4c]
Towerclub735: folds=20
JoJoe482: folds=20
ssweetn: raises 150 to 300
Super Donk54: folds=20
JJin91: folds=20
gator856500: folds=20
slb9724: folds=20
vitt409: folds=20
kudman22: calls 150
*** FLOP *** [8d Td Jh]
kudman22: checks=20
ssweetn: bets 450
kudman22: raises 450 to 900
ssweetn: calls 450
*** TURN *** [8d Td Jh] [Tc]
kudman22: checks=20
ssweetn: checks=20
*** RIVER *** [8d Td Jh Tc] [Qs]
kudman22: bets 929
ssweetn: calls 929
*** SHOW DOWN ***
kudman22: shows [9h Js] (a straight, Eight to Queen)
ssweetn: mucks hand=20
kudman22 collected 4513 from pot
*** SUMMARY ***
Total pot 4513 | Rake 0=20
Board [8d Td Jh Tc Qs]
Seat 1: kudman22 (big blind) showed [9h Js] and won (4513) with a strai=
ght, Eight to Queen
Seat 2: Towerclub735 folded before Flop (didn't bet)
Seat 3: JoJoe482 folded before Flop (didn't bet)
Seat 4: ssweetn mucked [Qd 8s]
Seat 5: Super Donk54 folded before Flop (didn't bet)
Seat 6: JJin91 folded before Flop (didn't bet)
Seat 7: gator856500 folded before Flop (didn't bet)
Seat 8: slb9724 (button) folded before Flop (didn't bet)
Seat 9: vitt409 (small blind) folded before Flop


*********** # 31 **************
PokerStars Hand #170339538958: Tournament #1622573245, $4.55+$0.45 USD =
Hold'em No Limit - Level VI (75/150) - 2017/05/24 21:26:22 ET
Table '1622573245 5' 9-max Seat #9 is the button
Seat 1: kudman22 (26185 in chips)=20
Seat 2: Towerclub735 (9760 in chips)=20
Seat 3: JoJoe482 (15870 in chips)=20
Seat 4: ssweetn (6246 in chips)=20
Seat 5: Super Donk54 (9290 in chips)=20
Seat 6: JJin91 (10050 in chips)=20
Seat 7: gator856500 (9440 in chips)=20
Seat 8: slb9724 (12655 in chips)=20
Seat 9: vitt409 (11408 in chips)=20
kudman22: posts the ante 20
Towerclub735: posts the ante 20
JoJoe482: posts the ante 20
ssweetn: posts the ante 20
Super Donk54: posts the ante 20
JJin91: posts the ante 20
gator856500: posts the ante 20
slb9724: posts the ante 20
vitt409: posts the ante 20
kudman22: posts small blind 75
Towerclub735: posts big blind 150
*** HOLE CARDS ***
Dealt to JJin91 [Kc 9h]
JoJoe482: folds=20
ssweetn: raises 6076 to 6226 and is all-in
Super Donk54: folds=20
JJin91: folds=20
gator856500: folds=20
slb9724: folds=20
vitt409: folds=20
kudman22: folds=20
Towerclub735: folds=20
Uncalled bet (6076) returned to ssweetn
ssweetn collected 555 from pot
ssweetn: doesn't show hand=20
*** SUMMARY ***
Total pot 555 | Rake 0=20
Seat 1: kudman22 (small blind) folded before Flop
Seat 2: Towerclub735 (big blind) folded before Flop
Seat 3: JoJoe482 folded before Flop (didn't bet)
Seat 4: ssweetn collected (555)
Seat 5: Super Donk54 folded before Flop (didn't bet)
Seat 6: JJin91 folded before Flop (didn't bet)
Seat 7: gator856500 folded before Flop (didn't bet)
Seat 8: slb9724 folded before Flop (didn't bet)
Seat 9: vitt409 (button) folded before Flop (didn't bet)


*********** # 32 **************
PokerStars Hand #170339539074: Tournament #1622573245, $4.55+$0.45 USD =
Hold'em No Limit - Level VI (75/150) - 2017/05/24 21:26:48 ET
Table '1622573245 5' 9-max Seat #1 is the button
Seat 1: kudman22 (26090 in chips)=20
Seat 2: Towerclub735 (9590 in chips)=20
Seat 3: JoJoe482 (15850 in chips)=20
Seat 4: ssweetn (6631 in chips)=20
Seat 5: Super Donk54 (9270 in chips)=20
Seat 6: JJin91 (10030 in chips)=20
Seat 7: gator856500 (9420 in chips)=20
Seat 8: slb9724 (12635 in chips)=20
Seat 9: vitt409 (11388 in chips)=20
kudman22: posts the ante 20
Towerclub735: posts the ante 20
JoJoe482: posts the ante 20
ssweetn: posts the ante 20
Super Donk54: posts the ante 20
JJin91: posts the ante 20
gator856500: posts the ante 20
slb9724: posts the ante 20
vitt409: posts the ante 20
Towerclub735: posts small blind 75
JoJoe482: posts big blind 150
*** HOLE CARDS ***
Dealt to JJin91 [7s 8c]
ssweetn: folds=20
Super Donk54: folds=20
JJin91: folds=20
gator856500: folds=20
slb9724: folds=20
vitt409: calls 150
kudman22: calls 150
Towerclub735: folds=20
JoJoe482: checks=20
*** FLOP *** [9d 2s 6d]
JoJoe482: checks=20
vitt409: bets 150
kudman22: calls 150
JoJoe482: calls 150
*** TURN *** [9d 2s 6d] [7d]
JoJoe482: checks=20
vitt409: bets 150
kudman22: folds=20
JoJoe482: raises 450 to 600
vitt409: calls 450
*** RIVER *** [9d 2s 6d 7d] [Ad]
JoJoe482: checks=20
vitt409: bets 1200
JoJoe482: folds=20
Uncalled bet (1200) returned to vitt409
vitt409 collected 2355 from pot
*** SUMMARY ***
Total pot 2355 | Rake 0=20
Board [9d 2s 6d 7d Ad]
Seat 1: kudman22 (button) folded on the Turn
Seat 2: Towerclub735 (small blind) folded before Flop
Seat 3: JoJoe482 (big blind) folded on the River
Seat 4: ssweetn folded before Flop (didn't bet)
Seat 5: Super Donk54 folded before Flop (didn't bet)
Seat 6: JJin91 folded before Flop (didn't bet)
Seat 7: gator856500 folded before Flop (didn't bet)
Seat 8: slb9724 folded before Flop (didn't bet)
Seat 9: vitt409 collected (2355)


*********** # 33 **************
PokerStars Hand #170339539344: Tournament #1622573245, $4.55+$0.45 USD =
Hold'em No Limit - Level VI (75/150) - 2017/05/24 21:27:55 ET
Table '1622573245 5' 9-max Seat #2 is the button
Seat 1: kudman22 (25770 in chips)=20
Seat 2: Towerclub735 (9495 in chips)=20
Seat 3: JoJoe482 (14930 in chips)=20
Seat 4: ssweetn (6611 in chips)=20
Seat 5: Super Donk54 (9250 in chips)=20
Seat 6: JJin91 (10010 in chips)=20
Seat 7: gator856500 (9400 in chips)=20
Seat 8: slb9724 (12615 in chips)=20
Seat 9: vitt409 (12823 in chips)=20
kudman22: posts the ante 20
Towerclub735: posts the ante 20
JoJoe482: posts the ante 20
ssweetn: posts the ante 20
Super Donk54: posts the ante 20
JJin91: posts the ante 20
gator856500: posts the ante 20
slb9724: posts the ante 20
vitt409: posts the ante 20
JoJoe482: posts small blind 75
ssweetn: posts big blind 150
*** HOLE CARDS ***
Dealt to JJin91 [8h 6h]
Super Donk54: folds=20
JJin91: folds=20
gator856500: folds=20
slb9724: folds=20
vitt409: folds=20
kudman22: raises 255 to 405
Towerclub735: folds=20
JoJoe482: folds=20
ssweetn: calls 255
*** FLOP *** [5s 2h Jd]
ssweetn: checks=20
kudman22: bets 373
ssweetn: calls 373
*** TURN *** [5s 2h Jd] [Ah]
ssweetn: checks=20
kudman22: bets 634
ssweetn: calls 634
*** RIVER *** [5s 2h Jd Ah] [Kh]
ssweetn: checks=20
kudman22: checks=20
*** SHOW DOWN ***
ssweetn: shows [Kd Ts] (a pair of Kings)
kudman22: mucks hand=20
ssweetn collected 3079 from pot
*** SUMMARY ***
Total pot 3079 | Rake 0=20
Board [5s 2h Jd Ah Kh]
Seat 1: kudman22 mucked [Kc 8c]
Seat 2: Towerclub735 (button) folded before Flop (didn't bet)
Seat 3: JoJoe482 (small blind) folded before Flop
Seat 4: ssweetn (big blind) showed [Kd Ts] and won (3079) with a pair o=
f Kings
Seat 5: Super Donk54 folded before Flop (didn't bet)
Seat 6: JJin91 folded before Flop (didn't bet)
Seat 7: gator856500 folded before Flop (didn't bet)
Seat 8: slb9724 folded before Flop (didn't bet)
Seat 9: vitt409 folded before Flop (didn't bet)


*********** # 34 **************
PokerStars Hand #170339539544: Tournament #1622573245, $4.55+$0.45 USD =
Hold'em No Limit - Level VI (75/150) - 2017/05/24 21:28:44 ET
Table '1622573245 5' 9-max Seat #3 is the button
Seat 1: kudman22 (24338 in chips)=20
Seat 2: Towerclub735 (9475 in chips)=20
Seat 3: JoJoe482 (14835 in chips)=20
Seat 4: ssweetn (8258 in chips)=20
Seat 5: Super Donk54 (9230 in chips)=20
Seat 6: JJin91 (9990 in chips)=20
Seat 7: gator856500 (9380 in chips)=20
Seat 8: slb9724 (12595 in chips)=20
Seat 9: vitt409 (12803 in chips)=20
kudman22: posts the ante 20
Towerclub735: posts the ante 20
JoJoe482: posts the ante 20
ssweetn: posts the ante 20
Super Donk54: posts the ante 20
JJin91: posts the ante 20
gator856500: posts the ante 20
slb9724: posts the ante 20
vitt409: posts the ante 20
ssweetn: posts small blind 75
Super Donk54: posts big blind 150
*** HOLE CARDS ***
Dealt to JJin91 [8s 4s]
JJin91: folds=20
gator856500: folds=20
slb9724: folds=20
vitt409: calls 150
kudman22: folds=20
Towerclub735: calls 150
JoJoe482: folds=20
ssweetn: calls 75
Super Donk54: checks=20
*** FLOP *** [Ad 5s 6s]
ssweetn: checks=20
Super Donk54: bets 150
vitt409: calls 150
Towerclub735: folds=20
ssweetn: folds=20
*** TURN *** [Ad 5s 6s] [7h]
Super Donk54: bets 150
vitt409: calls 150
*** RIVER *** [Ad 5s 6s 7h] [9d]
Super Donk54: checks=20
vitt409: bets 750
Super Donk54: folds=20
Uncalled bet (750) returned to vitt409
vitt409 collected 1380 from pot
*** SUMMARY ***
Total pot 1380 | Rake 0=20
Board [Ad 5s 6s 7h 9d]
Seat 1: kudman22 folded before Flop (didn't bet)
Seat 2: Towerclub735 folded on the Flop
Seat 3: JoJoe482 (button) folded before Flop (didn't bet)
Seat 4: ssweetn (small blind) folded on the Flop
Seat 5: Super Donk54 (big blind) folded on the River
Seat 6: JJin91 folded before Flop (didn't bet)
Seat 7: gator856500 folded before Flop (didn't bet)
Seat 8: slb9724 folded before Flop (didn't bet)
Seat 9: vitt409 collected (1380)


*********** # 35 **************
PokerStars Hand #170339539755: Tournament #1622573245, $4.55+$0.45 USD =
Hold'em No Limit - Level VI (75/150) - 2017/05/24 21:29:33 ET
Table '1622573245 5' 9-max Seat #4 is the button
Seat 1: kudman22 (24318 in chips)=20
Seat 2: Towerclub735 (9305 in chips)=20
Seat 3: JoJoe482 (14815 in chips)=20
Seat 4: ssweetn (8088 in chips)=20
Seat 5: Super Donk54 (8760 in chips)=20
Seat 6: JJin91 (9970 in chips)=20
Seat 7: gator856500 (9360 in chips)=20
Seat 8: slb9724 (12575 in chips)=20
Seat 9: vitt409 (13713 in chips)=20
kudman22: posts the ante 20
Towerclub735: posts the ante 20
JoJoe482: posts the ante 20
ssweetn: posts the ante 20
Super Donk54: posts the ante 20
JJin91: posts the ante 20
gator856500: posts the ante 20
slb9724: posts the ante 20
vitt409: posts the ante 20
Super Donk54: posts small blind 75
JJin91: posts big blind 150
*** HOLE CARDS ***
Dealt to JJin91 [9d Jd]
gator856500: folds=20
slb9724: folds=20
vitt409: folds=20
kudman22: folds=20
Towerclub735: folds=20
JoJoe482: folds=20
ssweetn: folds=20
Super Donk54: raises 300 to 450
JJin91: calls 300
*** FLOP *** [3d 2c Th]
Super Donk54: bets 540
JJin91: calls 540
*** TURN *** [3d 2c Th] [4s]
Super Donk54: checks=20
JJin91: bets 799
Super Donk54: folds=20
Uncalled bet (799) returned to JJin91
JJin91 collected 2160 from pot
JJin91: doesn't show hand=20
*** SUMMARY ***
Total pot 2160 | Rake 0=20
Board [3d 2c Th 4s]
Seat 1: kudman22 folded before Flop (didn't bet)
Seat 2: Towerclub735 folded before Flop (didn't bet)
Seat 3: JoJoe482 folded before Flop (didn't bet)
Seat 4: ssweetn (button) folded before Flop (didn't bet)
Seat 5: Super Donk54 (small blind) folded on the Turn
Seat 6: JJin91 (big blind) collected (2160)
Seat 7: gator856500 folded before Flop (didn't bet)
Seat 8: slb9724 folded before Flop (didn't bet)
Seat 9: vitt409 folded before Flop (didn't bet)


*********** # 36 **************
PokerStars Hand #170339760409: Tournament #1622573245, $4.55+$0.45 USD =
Hold'em No Limit - Level VII (100/200) - 2017/05/24 21:30:34 ET
Table '1622573245 5' 9-max Seat #5 is the button
Seat 1: kudman22 (24298 in chips)=20
Seat 2: Towerclub735 (9285 in chips)=20
Seat 3: JoJoe482 (14795 in chips)=20
Seat 4: ssweetn (8068 in chips)=20
Seat 5: Super Donk54 (7750 in chips)=20
Seat 6: JJin91 (11120 in chips)=20
Seat 7: gator856500 (9340 in chips)=20
Seat 8: slb9724 (12555 in chips)=20
Seat 9: vitt409 (13693 in chips)=20
kudman22: posts the ante 25
Towerclub735: posts the ante 25
JoJoe482: posts the ante 25
ssweetn: posts the ante 25
Super Donk54: posts the ante 25
JJin91: posts the ante 25
gator856500: posts the ante 25
slb9724: posts the ante 25
vitt409: posts the ante 25
JJin91: posts small blind 100
gator856500: posts big blind 200
*** HOLE CARDS ***
Dealt to JJin91 [As Td]
slb9724: folds=20
vitt409: calls 200
kudman22: calls 200
Towerclub735: folds=20
JoJoe482: folds=20
ssweetn: raises 1400 to 1600
Super Donk54: folds=20
JJin91: folds=20
gator856500: calls 1400
vitt409: calls 1400
kudman22: folds=20
*** FLOP *** [9d Qd 5d]
gator856500: checks=20
vitt409: checks=20
ssweetn: bets 6443 and is all-in
gator856500: calls 6443
vitt409: folds=20
*** TURN *** [9d Qd 5d] [3h]
*** RIVER *** [9d Qd 5d 3h] [Jh]
*** SHOW DOWN ***
gator856500: shows [Kc Ad] (high card Ace)
ssweetn: shows [9h Qh] (two pair, Queens and Nines)
ssweetn collected 18211 from pot
*** SUMMARY ***
Total pot 18211 | Rake 0=20
Board [9d Qd 5d 3h Jh]
Seat 1: kudman22 folded before Flop
Seat 2: Towerclub735 folded before Flop (didn't bet)
Seat 3: JoJoe482 folded before Flop (didn't bet)
Seat 4: ssweetn showed [9h Qh] and won (18211) with two pair, Queens an=
d Nines
Seat 5: Super Donk54 (button) folded before Flop (didn't bet)
Seat 6: JJin91 (small blind) folded before Flop
Seat 7: gator856500 (big blind) showed [Kc Ad] and lost with high card =
Ace
Seat 8: slb9724 folded before Flop (didn't bet)
Seat 9: vitt409 folded on the Flop


*********** # 37 **************
PokerStars Hand #170339760711: Tournament #1622573245, $4.55+$0.45 USD =
Hold'em No Limit - Level VII (100/200) - 2017/05/24 21:31:40 ET
Table '1622573245 5' 9-max Seat #6 is the button
Seat 1: kudman22 (24073 in chips)=20
Seat 2: Towerclub735 (9260 in chips)=20
Seat 3: JoJoe482 (14770 in chips)=20
Seat 4: ssweetn (18211 in chips)=20
Seat 5: Super Donk54 (7725 in chips)=20
Seat 6: JJin91 (10995 in chips)=20
Seat 7: gator856500 (1272 in chips)=20
Seat 9: vitt409 (12068 in chips)=20
kudman22: posts the ante 25
Towerclub735: posts the ante 25
JoJoe482: posts the ante 25
ssweetn: posts the ante 25
Super Donk54: posts the ante 25
JJin91: posts the ante 25
gator856500: posts the ante 25
vitt409: posts the ante 25
gator856500: posts small blind 100
vitt409: posts big blind 200
*** HOLE CARDS ***
Dealt to JJin91 [Js 9c]
kudman22: folds=20
Towerclub735: folds=20
JoJoe482: folds=20
ssweetn: raises 200 to 400
Super Donk54: folds=20
JJin91: folds=20
gator856500: calls 300
vitt409: calls 200
*** FLOP *** [Qc 5c 2s]
gator856500: checks=20
vitt409: bets 200
ssweetn: folds=20
gator856500: calls 200
*** TURN *** [Qc 5c 2s] [4h]
gator856500: checks=20
vitt409: bets 200
gator856500: calls 200
*** RIVER *** [Qc 5c 2s 4h] [Ks]
gator856500: bets 447 and is all-in
vitt409: calls 447
*** SHOW DOWN ***
gator856500: shows [Jd Kh] (a pair of Kings)
vitt409: shows [As 5s] (a pair of Fives)
gator856500 collected 3094 from pot
*** SUMMARY ***
Total pot 3094 | Rake 0=20
Board [Qc 5c 2s 4h Ks]
Seat 1: kudman22 folded before Flop (didn't bet)
Seat 2: Towerclub735 folded before Flop (didn't bet)
Seat 3: JoJoe482 folded before Flop (didn't bet)
Seat 4: ssweetn folded on the Flop
Seat 5: Super Donk54 folded before Flop (didn't bet)
Seat 6: JJin91 (button) folded before Flop (didn't bet)
Seat 7: gator856500 (small blind) showed [Jd Kh] and won (3094) with a =
pair of Kings
Seat 9: vitt409 (big blind) showed [As 5s] and lost with a pair of Fives


*********** # 38 **************
PokerStars Hand #170339760907: Tournament #1622573245, $4.55+$0.45 USD =
Hold'em No Limit - Level VII (100/200) - 2017/05/24 21:32:21 ET
Table '1622573245 5' 9-max Seat #7 is the button
Seat 1: kudman22 (24048 in chips)=20
Seat 2: Towerclub735 (9235 in chips)=20
Seat 4: ssweetn (17786 in chips)=20
Seat 5: Super Donk54 (7700 in chips)=20
Seat 6: JJin91 (10970 in chips)=20
Seat 7: gator856500 (3094 in chips)=20
Seat 8: Paceman2jr (8330 in chips) out of hand (moved from another tabl=
e into small blind)
Seat 9: vitt409 (10796 in chips)=20
kudman22: posts the ante 25
Towerclub735: posts the ante 25
ssweetn: posts the ante 25
Super Donk54: posts the ante 25
JJin91: posts the ante 25
gator856500: posts the ante 25
vitt409: posts the ante 25
vitt409: posts small blind 100
kudman22: posts big blind 200
*** HOLE CARDS ***
Dealt to JJin91 [Qh Ad]
Towerclub735: calls 200
ssweetn: raises 400 to 600
Super Donk54: folds=20
JJin91: raises 1434 to 2034
gator856500: folds=20
vitt409 has timed out
vitt409: folds=20
vitt409 is sitting out
kudman22: folds=20
Towerclub735: folds=20
ssweetn: raises 15727 to 17761 and is all-in
JJin91: folds=20
Uncalled bet (15727) returned to ssweetn
ssweetn collected 4743 from pot
ssweetn: doesn't show hand=20
*** SUMMARY ***
Total pot 4743 | Rake 0=20
Seat 1: kudman22 (big blind) folded before Flop
Seat 2: Towerclub735 folded before Flop
Seat 4: ssweetn collected (4743)
Seat 5: Super Donk54 folded before Flop (didn't bet)
Seat 6: JJin91 folded before Flop
Seat 7: gator856500 (button) folded before Flop (didn't bet)
Seat 9: vitt409 (small blind) folded before Flop


*********** # 39 **************
PokerStars Hand #170339761425: Tournament #1622573245, $4.55+$0.45 USD =
Hold'em No Limit - Level VII (100/200) - 2017/05/24 21:34:21 ET
Table '1622573245 5' 9-max Seat #9 is the button
Seat 1: kudman22 (23823 in chips)=20
Seat 2: Towerclub735 (9010 in chips)=20
Seat 4: ssweetn (20470 in chips)=20
Seat 5: Super Donk54 (7675 in chips)=20
Seat 6: JJin91 (8911 in chips)=20
Seat 7: gator856500 (3069 in chips)=20
Seat 8: Paceman2jr (8330 in chips)=20
Seat 9: vitt409 (10671 in chips) is sitting out
kudman22: posts the ante 25
Towerclub735: posts the ante 25
ssweetn: posts the ante 25
Super Donk54: posts the ante 25
JJin91: posts the ante 25
gator856500: posts the ante 25
Paceman2jr: posts the ante 25
vitt409: posts the ante 25
kudman22: posts small blind 100
Towerclub735: posts big blind 200
*** HOLE CARDS ***
Dealt to JJin91 [9d Jh]
ssweetn: calls 200
Super Donk54: calls 200
JJin91: folds=20
gator856500: folds=20
Paceman2jr: folds=20
vitt409: folds=20
kudman22: calls 100
Towerclub735: checks=20
*** FLOP *** [7s Jd 5d]
kudman22: checks=20
Towerclub735: checks=20
ssweetn: bets 800
Super Donk54: folds=20
kudman22: folds=20
Towerclub735: folds=20
Uncalled bet (800) returned to ssweetn
ssweetn collected 1000 from pot
ssweetn: doesn't show hand=20
*** SUMMARY ***
Total pot 1000 | Rake 0=20
Board [7s Jd 5d]
Seat 1: kudman22 (small blind) folded on the Flop
Seat 2: Towerclub735 (big blind) folded on the Flop
Seat 4: ssweetn collected (1000)
Seat 5: Super Donk54 folded on the Flop
Seat 6: JJin91 folded before Flop (didn't bet)
Seat 7: gator856500 folded before Flop (didn't bet)
Seat 8: Paceman2jr folded before Flop (didn't bet)
Seat 9: vitt409 (button) folded before Flop (didn't bet)


*********** # 40 **************
PokerStars Hand #170339761571: Tournament #1622573245, $4.55+$0.45 USD =
Hold'em No Limit - Level VII (100/200) - 2017/05/24 21:34:58 ET
Table '1622573245 5' 9-max Seat #1 is the button
Seat 1: kudman22 (23598 in chips)=20
Seat 2: Towerclub735 (8785 in chips)=20
Seat 4: ssweetn (21245 in chips)=20
Seat 5: Super Donk54 (7450 in chips)=20
Seat 6: JJin91 (8886 in chips)=20
Seat 8: Paceman2jr (8305 in chips)=20
Seat 9: vitt409 (10646 in chips) is sitting out
kudman22: posts the ante 25
Towerclub735: posts the ante 25
ssweetn: posts the ante 25
Super Donk54: posts the ante 25
JJin91: posts the ante 25
Paceman2jr: posts the ante 25
vitt409: posts the ante 25
Towerclub735: posts small blind 100
ssweetn: posts big blind 200
*** HOLE CARDS ***
Dealt to JJin91 [2d Td]
Super Donk54: folds=20
JJin91: folds=20
Paceman2jr: folds=20
vitt409: folds=20
kudman22: raises 275 to 475
Towerclub735: folds=20
ssweetn: folds=20
Uncalled bet (275) returned to kudman22
kudman22 collected 675 from pot
kudman22: doesn't show hand=20
*** SUMMARY ***
Total pot 675 | Rake 0=20
Seat 1: kudman22 (button) collected (675)
Seat 2: Towerclub735 (small blind) folded before Flop
Seat 4: ssweetn (big blind) folded before Flop
Seat 5: Super Donk54 folded before Flop (didn't bet)
Seat 6: JJin91 folded before Flop (didn't bet)
Seat 8: Paceman2jr folded before Flop (didn't bet)
Seat 9: vitt409 folded before Flop (didn't bet)


*********** # 41 **************
PokerStars Hand #170339761669: Tournament #1622573245, $4.55+$0.45 USD =
Hold'em No Limit - Level VIII (125/250) - 2017/05/24 21:35:19 ET
Table '1622573245 5' 9-max Seat #2 is the button
Seat 1: kudman22 (24048 in chips)=20
Seat 2: Towerclub735 (8660 in chips)=20
Seat 4: ssweetn (21020 in chips)=20
Seat 5: Super Donk54 (7425 in chips)=20
Seat 6: JJin91 (8861 in chips)=20
Seat 8: Paceman2jr (8280 in chips)=20
Seat 9: vitt409 (10621 in chips) is sitting out
kudman22: posts the ante 30
Towerclub735: posts the ante 30
ssweetn: posts the ante 30
Super Donk54: posts the ante 30
JJin91: posts the ante 30
Paceman2jr: posts the ante 30
vitt409: posts the ante 30
ssweetn: posts small blind 125
Super Donk54: posts big blind 250
*** HOLE CARDS ***
Dealt to JJin91 [5h 3s]
JJin91: folds=20
Paceman2jr: folds=20
vitt409: folds=20
kudman22: folds=20
Towerclub735: folds=20
ssweetn: calls 125
Super Donk54: checks=20
*** FLOP *** [9s 3d 5c]
ssweetn: bets 750
Super Donk54: raises 750 to 1500
ssweetn: calls 750
*** TURN *** [9s 3d 5c] [Ah]
ssweetn: bets 750
Super Donk54: folds=20
Uncalled bet (750) returned to ssweetn
ssweetn collected 3710 from pot
ssweetn: doesn't show hand=20
*** SUMMARY ***
Total pot 3710 | Rake 0=20
Board [9s 3d 5c Ah]
Seat 1: kudman22 folded before Flop (didn't bet)
Seat 2: Towerclub735 (button) folded before Flop (didn't bet)
Seat 4: ssweetn (small blind) collected (3710)
Seat 5: Super Donk54 (big blind) folded on the Turn
Seat 6: JJin91 folded before Flop (didn't bet)
Seat 8: Paceman2jr folded before Flop (didn't bet)
Seat 9: vitt409 folded before Flop (didn't bet)


*********** # 42 **************
PokerStars Hand #170339761960: Tournament #1622573245, $4.55+$0.45 USD =
Hold'em No Limit - Level VIII (125/250) - 2017/05/24 21:36:30 ET
Table '1622573245 5' 9-max Seat #4 is the button
Seat 1: kudman22 (24018 in chips)=20
Seat 2: Towerclub735 (8630 in chips)=20
Seat 4: ssweetn (22950 in chips)=20
Seat 5: Super Donk54 (5645 in chips)=20
Seat 6: JJin91 (8831 in chips)=20
Seat 8: Paceman2jr (8250 in chips)=20
Seat 9: vitt409 (10591 in chips) is sitting out
kudman22: posts the ante 30
Towerclub735: posts the ante 30
ssweetn: posts the ante 30
Super Donk54: posts the ante 30
JJin91: posts the ante 30
Paceman2jr: posts the ante 30
vitt409: posts the ante 30
Super Donk54: posts small blind 125
JJin91: posts big blind 250
*** HOLE CARDS ***
Dealt to JJin91 [9h 4h]
Paceman2jr: folds=20
vitt409: folds=20
kudman22: folds=20
Towerclub735: calls 250
ssweetn: folds=20
Super Donk54: calls 125
JJin91: checks=20
*** FLOP *** [6d Ah Jd]
Super Donk54: checks=20
JJin91: checks=20
Towerclub735: bets 1250
Super Donk54: folds=20
JJin91: folds=20
Uncalled bet (1250) returned to Towerclub735
Towerclub735 collected 960 from pot
*** SUMMARY ***
Total pot 960 | Rake 0=20
Board [6d Ah Jd]
Seat 1: kudman22 folded before Flop (didn't bet)
Seat 2: Towerclub735 collected (960)
Seat 4: ssweetn (button) folded before Flop (didn't bet)
Seat 5: Super Donk54 (small blind) folded on the Flop
Seat 6: JJin91 (big blind) folded on the Flop
Seat 8: Paceman2jr folded before Flop (didn't bet)
Seat 9: vitt409 folded before Flop (didn't bet)


*********** # 43 **************
PokerStars Hand #170339762163: Tournament #1622573245, $4.55+$0.45 USD =
Hold'em No Limit - Level VIII (125/250) - 2017/05/24 21:37:19 ET
Table '1622573245 5' 9-max Seat #5 is the button
Seat 1: kudman22 (23988 in chips)=20
Seat 2: Towerclub735 (9310 in chips)=20
Seat 4: ssweetn (22920 in chips)=20
Seat 5: Super Donk54 (5365 in chips)=20
Seat 6: JJin91 (8551 in chips)=20
Seat 7: sbyrne1 (10000 in chips)=20
Seat 8: Paceman2jr (8220 in chips)=20
Seat 9: vitt409 (10561 in chips) is sitting out
kudman22: posts the ante 30
Towerclub735: posts the ante 30
ssweetn: posts the ante 30
Super Donk54: posts the ante 30
JJin91: posts the ante 30
sbyrne1: posts the ante 30
Paceman2jr: posts the ante 30
vitt409: posts the ante 30
JJin91: posts small blind 125
sbyrne1: posts big blind 250
*** HOLE CARDS ***
Dealt to JJin91 [7c 6d]
Paceman2jr: folds=20
vitt409: folds=20
kudman22: folds=20
Towerclub735: folds=20
ssweetn: folds=20
Super Donk54: folds=20
JJin91: calls 125
sbyrne1: checks=20
*** FLOP *** [2s 8d Qd]
JJin91: bets 422
sbyrne1: raises 422 to 844
JJin91: calls 422
*** TURN *** [2s 8d Qd] [4s]
JJin91: checks=20
sbyrne1: bets 2428
vitt409 has returned
JJin91: folds=20
Uncalled bet (2428) returned to sbyrne1
sbyrne1 collected 2428 from pot
sbyrne1: doesn't show hand=20
*** SUMMARY ***
Total pot 2428 | Rake 0=20
Board [2s 8d Qd 4s]
Seat 1: kudman22 folded before Flop (didn't bet)
Seat 2: Towerclub735 folded before Flop (didn't bet)
Seat 4: ssweetn folded before Flop (didn't bet)
Seat 5: Super Donk54 (button) folded before Flop (didn't bet)
Seat 6: JJin91 (small blind) folded on the Turn
Seat 7: sbyrne1 (big blind) collected (2428)
Seat 8: Paceman2jr folded before Flop (didn't bet)
Seat 9: vitt409 folded before Flop (didn't bet)


*********** # 44 **************
PokerStars Hand #170339762391: Tournament #1622573245, $4.55+$0.45 USD =
Hold'em No Limit - Level VIII (125/250) - 2017/05/24 21:38:17 ET
Table '1622573245 5' 9-max Seat #6 is the button
Seat 1: kudman22 (23958 in chips)=20
Seat 2: Towerclub735 (9280 in chips)=20
Seat 4: ssweetn (22890 in chips)=20
Seat 5: Super Donk54 (5335 in chips)=20
Seat 6: JJin91 (7427 in chips)=20
Seat 7: sbyrne1 (11304 in chips)=20
Seat 8: Paceman2jr (8190 in chips)=20
Seat 9: vitt409 (10531 in chips)=20
kudman22: posts the ante 30
Towerclub735: posts the ante 30
ssweetn: posts the ante 30
Super Donk54: posts the ante 30
JJin91: posts the ante 30
sbyrne1: posts the ante 30
Paceman2jr: posts the ante 30
vitt409: posts the ante 30
sbyrne1: posts small blind 125
Paceman2jr: posts big blind 250
*** HOLE CARDS ***
Dealt to JJin91 [9h 4d]
vitt409: folds=20
kudman22: folds=20
Towerclub735: folds=20
ssweetn: folds=20
Super Donk54: folds=20
JJin91: folds=20
sbyrne1: calls 125
Paceman2jr: checks=20
*** FLOP *** [Tc Qd Qs]
sbyrne1: bets 250
Paceman2jr: folds=20
Uncalled bet (250) returned to sbyrne1
sbyrne1 collected 740 from pot
sbyrne1: doesn't show hand=20
*** SUMMARY ***
Total pot 740 | Rake 0=20
Board [Tc Qd Qs]
Seat 1: kudman22 folded before Flop (didn't bet)
Seat 2: Towerclub735 folded before Flop (didn't bet)
Seat 4: ssweetn folded before Flop (didn't bet)
Seat 5: Super Donk54 folded before Flop (didn't bet)
Seat 6: JJin91 (button) folded before Flop (didn't bet)
Seat 7: sbyrne1 (small blind) collected (740)
Seat 8: Paceman2jr (big blind) folded on the Flop
Seat 9: vitt409 folded before Flop (didn't bet)


*********** # 45 **************
PokerStars Hand #170339762478: Tournament #1622573245, $4.55+$0.45 USD =
Hold'em No Limit - Level VIII (125/250) - 2017/05/24 21:38:42 ET
Table '1622573245 5' 9-max Seat #7 is the button
Seat 1: kudman22 (23928 in chips)=20
Seat 2: Towerclub735 (9250 in chips)=20
Seat 4: ssweetn (22860 in chips)=20
Seat 5: Super Donk54 (5305 in chips)=20
Seat 6: JJin91 (7397 in chips)=20
Seat 7: sbyrne1 (11764 in chips)=20
Seat 8: Paceman2jr (7910 in chips)=20
Seat 9: vitt409 (10501 in chips)=20
kudman22: posts the ante 30
Towerclub735: posts the ante 30
ssweetn: posts the ante 30
Super Donk54: posts the ante 30
JJin91: posts the ante 30
sbyrne1: posts the ante 30
Paceman2jr: posts the ante 30
vitt409: posts the ante 30
Paceman2jr: posts small blind 125
vitt409: posts big blind 250
*** HOLE CARDS ***
Dealt to JJin91 [4c Qc]
kudman22: folds=20
Towerclub735: calls 250
ssweetn: raises 500 to 750
Super Donk54: raises 4525 to 5275 and is all-in
JJin91: folds=20
sbyrne1: folds=20
Paceman2jr: folds=20
vitt409: folds=20
Towerclub735: folds=20
ssweetn: calls 4525
*** FLOP *** [Td Kh 6c]
*** TURN *** [Td Kh 6c] [Ad]
*** RIVER *** [Td Kh 6c Ad] [Ks]
*** SHOW DOWN ***
ssweetn: shows [8h 9h] (a pair of Kings)
Super Donk54: shows [7c 7s] (two pair, Kings and Sevens)
Super Donk54 collected 11415 from pot
*** SUMMARY ***
Total pot 11415 | Rake 0=20
Board [Td Kh 6c Ad Ks]
Seat 1: kudman22 folded before Flop (didn't bet)
Seat 2: Towerclub735 folded before Flop
Seat 4: ssweetn showed [8h 9h] and lost with a pair of Kings
Seat 5: Super Donk54 showed [7c 7s] and won (11415) with two pair, King=
s and Sevens
Seat 6: JJin91 folded before Flop (didn't bet)
Seat 7: sbyrne1 (button) folded before Flop (didn't bet)
Seat 8: Paceman2jr (small blind) folded before Flop
Seat 9: vitt409 (big blind) folded before Flop


*********** # 46 **************
PokerStars Hand #170339762611: Tournament #1622573245, $4.55+$0.45 USD =
Hold'em No Limit - Level VIII (125/250) - 2017/05/24 21:39:17 ET
Table '1622573245 5' 9-max Seat #8 is the button
Seat 1: kudman22 (23898 in chips)=20
Seat 2: Towerclub735 (8970 in chips)=20
Seat 4: ssweetn (17555 in chips)=20
Seat 5: Super Donk54 (11415 in chips)=20
Seat 6: JJin91 (7367 in chips)=20
Seat 7: sbyrne1 (11734 in chips)=20
Seat 8: Paceman2jr (7755 in chips)=20
Seat 9: vitt409 (10221 in chips)=20
kudman22: posts the ante 30
Towerclub735: posts the ante 30
ssweetn: posts the ante 30
Super Donk54: posts the ante 30
JJin91: posts the ante 30
sbyrne1: posts the ante 30
Paceman2jr: posts the ante 30
vitt409: posts the ante 30
vitt409: posts small blind 125
kudman22: posts big blind 250
*** HOLE CARDS ***
Dealt to JJin91 [Qs Kd]
Towerclub735: folds=20
ssweetn: calls 250
Super Donk54: folds=20
JJin91: folds=20
sbyrne1: calls 250
Paceman2jr: raises 750 to 1000
vitt409: folds=20
kudman22: calls 750
ssweetn: calls 750
sbyrne1: folds=20
*** FLOP *** [9h 5s 5h]
kudman22: checks=20
ssweetn: checks=20
Paceman2jr: bets 1808
kudman22: raises 1808 to 3616
ssweetn: folds=20
Paceman2jr: raises 3109 to 6725 and is all-in
kudman22: calls 3109
*** TURN *** [9h 5s 5h] [2s]
*** RIVER *** [9h 5s 5h 2s] [2c]
*** SHOW DOWN ***
kudman22: shows [Js Jc] (two pair, Jacks and Fives)
Paceman2jr: shows [8h 8d] (two pair, Eights and Fives)
kudman22 collected 17065 from pot
Paceman2jr finished the tournament in 91st place
*** SUMMARY ***
Total pot 17065 | Rake 0=20
Board [9h 5s 5h 2s 2c]
Seat 1: kudman22 (big blind) showed [Js Jc] and won (17065) with two pa=
ir, Jacks and Fives
Seat 2: Towerclub735 folded before Flop (didn't bet)
Seat 4: ssweetn folded on the Flop
Seat 5: Super Donk54 folded before Flop (didn't bet)
Seat 6: JJin91 folded before Flop (didn't bet)
Seat 7: sbyrne1 folded before Flop
Seat 8: Paceman2jr (button) showed [8h 8d] and lost with two pair, Eigh=
ts and Fives
Seat 9: vitt409 (small blind) folded before Flop


*********** # 47 **************
PokerStars Hand #170339762934: Tournament #1622573245, $4.55+$0.45 USD =
Hold'em No Limit - Level IX (150/300) - 2017/05/24 21:40:30 ET
Table '1622573245 5' 9-max Seat #9 is the button
Seat 1: kudman22 (33208 in chips)=20
Seat 2: Towerclub735 (8940 in chips)=20
Seat 4: ssweetn (16525 in chips)=20
Seat 5: Super Donk54 (11385 in chips)=20
Seat 6: JJin91 (7337 in chips)=20
Seat 7: sbyrne1 (11454 in chips)=20
Seat 9: vitt409 (10066 in chips)=20
kudman22: posts the ante 40
Towerclub735: posts the ante 40
ssweetn: posts the ante 40
Super Donk54: posts the ante 40
JJin91: posts the ante 40
sbyrne1: posts the ante 40
vitt409: posts the ante 40
kudman22: posts small blind 150
Towerclub735: posts big blind 300
*** HOLE CARDS ***
Dealt to JJin91 [Qc 9h]
ssweetn: calls 300
Super Donk54: folds=20
JJin91: folds=20
sbyrne1: folds=20
vitt409: folds=20
kudman22: calls 150
Towerclub735: checks=20
*** FLOP *** [6d 8d 6s]
kudman22: checks=20
Towerclub735: bets 300
ssweetn: raises 600 to 900
kudman22: folds=20
Towerclub735: folds=20
Uncalled bet (600) returned to ssweetn
ssweetn collected 1780 from pot
ssweetn: doesn't show hand=20
*** SUMMARY ***
Total pot 1780 | Rake 0=20
Board [6d 8d 6s]
Seat 1: kudman22 (small blind) folded on the Flop
Seat 2: Towerclub735 (big blind) folded on the Flop
Seat 4: ssweetn collected (1780)
Seat 5: Super Donk54 folded before Flop (didn't bet)
Seat 6: JJin91 folded before Flop (didn't bet)
Seat 7: sbyrne1 folded before Flop (didn't bet)
Seat 9: vitt409 (button) folded before Flop (didn't bet)


*********** # 48 **************
PokerStars Hand #170339763110: Tournament #1622573245, $4.55+$0.45 USD =
Hold'em No Limit - Level IX (150/300) - 2017/05/24 21:41:13 ET
Table '1622573245 5' 9-max Seat #1 is the button
Seat 1: kudman22 (32868 in chips)=20
Seat 2: Towerclub735 (8300 in chips)=20
Seat 3: alsson17 (10000 in chips)=20
Seat 4: ssweetn (17665 in chips)=20
Seat 5: Super Donk54 (11345 in chips)=20
Seat 6: JJin91 (7297 in chips)=20
Seat 7: sbyrne1 (11414 in chips)=20
Seat 8: Paceman2jr (10000 in chips)=20
Seat 9: vitt409 (10026 in chips)=20
kudman22: posts the ante 40
Towerclub735: posts the ante 40
alsson17: posts the ante 40
ssweetn: posts the ante 40
Super Donk54: posts the ante 40
JJin91: posts the ante 40
sbyrne1: posts the ante 40
Paceman2jr: posts the ante 40
vitt409: posts the ante 40
Towerclub735: posts small blind 150
alsson17: posts big blind 300
*** HOLE CARDS ***
Dealt to JJin91 [Jh Kc]
ssweetn: calls 300
Super Donk54: folds=20
JJin91: folds=20
sbyrne1: raises 300 to 600
Paceman2jr: folds=20
vitt409: folds=20
kudman22: folds=20
Towerclub735: folds=20
alsson17: calls 300
ssweetn: calls 300
*** FLOP *** [Tc 8c 5s]
alsson17: bets 9360 and is all-in
ssweetn: folds=20
sbyrne1: calls 9360
*** TURN *** [Tc 8c 5s] [Qs]
*** RIVER *** [Tc 8c 5s Qs] [9h]
*** SHOW DOWN ***
alsson17: shows [5d Ts] (two pair, Tens and Fives)
sbyrne1: shows [Qd Td] (two pair, Queens and Tens)
sbyrne1 collected 21030 from pot
alsson17 finished the tournament in 88th place
*** SUMMARY ***
Total pot 21030 | Rake 0=20
Board [Tc 8c 5s Qs 9h]
Seat 1: kudman22 (button) folded before Flop (didn't bet)
Seat 2: Towerclub735 (small blind) folded before Flop
Seat 3: alsson17 (big blind) showed [5d Ts] and lost with two pair, Ten=
s and Fives
Seat 4: ssweetn folded on the Flop
Seat 5: Super Donk54 folded before Flop (didn't bet)
Seat 6: JJin91 folded before Flop (didn't bet)
Seat 7: sbyrne1 showed [Qd Td] and won (21030) with two pair, Queens an=
d Tens
Seat 8: Paceman2jr folded before Flop (didn't bet)
Seat 9: vitt409 folded before Flop (didn't bet)


*********** # 49 **************
PokerStars Hand #170339763292: Tournament #1622573245, $4.55+$0.45 USD =
Hold'em No Limit - Level IX (150/300) - 2017/05/24 21:41:58 ET
Table '1622573245 5' 9-max Seat #2 is the button
Seat 1: kudman22 (32828 in chips)=20
Seat 2: Towerclub735 (8110 in chips)=20
Seat 4: ssweetn (17025 in chips)=20
Seat 5: Super Donk54 (11305 in chips)=20
Seat 6: JJin91 (7257 in chips)=20
Seat 7: sbyrne1 (22444 in chips)=20
Seat 8: Paceman2jr (9960 in chips)=20
Seat 9: vitt409 (9986 in chips)=20
kudman22: posts the ante 40
Towerclub735: posts the ante 40
ssweetn: posts the ante 40
Super Donk54: posts the ante 40
JJin91: posts the ante 40
sbyrne1: posts the ante 40
Paceman2jr: posts the ante 40
vitt409: posts the ante 40
ssweetn: posts small blind 150
Super Donk54: posts big blind 300
*** HOLE CARDS ***
Dealt to JJin91 [3d 8h]
JJin91: folds=20
sbyrne1: folds=20
Paceman2jr: calls 300
vitt409: folds=20
kudman22: calls 300
Towerclub735: folds=20
ssweetn: calls 150
Super Donk54: checks=20
*** FLOP *** [2d Tc 5d]
ssweetn: checks=20
Super Donk54: checks=20
Paceman2jr: bets 760
kudman22: folds=20
ssweetn: calls 760
Super Donk54: folds=20
*** TURN *** [2d Tc 5d] [9c]
ssweetn: bets 2700
Paceman2jr: calls 2700
*** RIVER *** [2d Tc 5d 9c] [Js]
ssweetn: bets 3300
Paceman2jr: folds=20
Uncalled bet (3300) returned to ssweetn
ssweetn collected 8440 from pot
ssweetn: doesn't show hand=20
*** SUMMARY ***
Total pot 8440 | Rake 0=20
Board [2d Tc 5d 9c Js]
Seat 1: kudman22 folded on the Flop
Seat 2: Towerclub735 (button) folded before Flop (didn't bet)
Seat 4: ssweetn (small blind) collected (8440)
Seat 5: Super Donk54 (big blind) folded on the Flop
Seat 6: JJin91 folded before Flop (didn't bet)
Seat 7: sbyrne1 folded before Flop (didn't bet)
Seat 8: Paceman2jr folded on the River
Seat 9: vitt409 folded before Flop (didn't bet)


*********** # 50 **************
PokerStars Hand #170339763568: Tournament #1622573245, $4.55+$0.45 USD =
Hold'em No Limit - Level IX (150/300) - 2017/05/24 21:43:05 ET
Table '1622573245 5' 9-max Seat #4 is the button
Seat 1: kudman22 (32488 in chips)=20
Seat 2: Towerclub735 (8070 in chips)=20
Seat 4: ssweetn (21665 in chips)=20
Seat 5: Super Donk54 (10965 in chips)=20
Seat 6: JJin91 (7217 in chips)=20
Seat 7: sbyrne1 (22404 in chips)=20
Seat 8: Paceman2jr (6160 in chips)=20
Seat 9: vitt409 (9946 in chips)=20
kudman22: posts the ante 40
Towerclub735: posts the ante 40
ssweetn: posts the ante 40
Super Donk54: posts the ante 40
JJin91: posts the ante 40
sbyrne1: posts the ante 40
Paceman2jr: posts the ante 40
vitt409: posts the ante 40
Super Donk54: posts small blind 150
JJin91: posts big blind 300
*** HOLE CARDS ***
Dealt to JJin91 [Qc Kc]
sbyrne1: folds=20
Paceman2jr: folds=20
vitt409: folds=20
kudman22: raises 470 to 770
Towerclub735: raises 470 to 1240
ssweetn: folds=20
Super Donk54: folds=20
JJin91: folds=20
kudman22: calls 470
*** FLOP *** [Qd 7s 6h]
kudman22: checks=20
Towerclub735: checks=20
*** TURN *** [Qd 7s 6h] [9s]
kudman22: checks=20
Towerclub735: bets 6790 and is all-in
kudman22: folds=20
Uncalled bet (6790) returned to Towerclub735
Towerclub735 collected 3250 from pot
*** SUMMARY ***
Total pot 3250 | Rake 0=20
Board [Qd 7s 6h 9s]
Seat 1: kudman22 folded on the Turn
Seat 2: Towerclub735 collected (3250)
Seat 4: ssweetn (button) folded before Flop (didn't bet)
Seat 5: Super Donk54 (small blind) folded before Flop
Seat 6: JJin91 (big blind) folded before Flop
Seat 7: sbyrne1 folded before Flop (didn't bet)
Seat 8: Paceman2jr folded before Flop (didn't bet)
Seat 9: vitt409 folded before Flop (didn't bet)


*********** # 51 **************
PokerStars Hand #170339763938: Tournament #1622573245, $4.55+$0.45 USD =
Hold'em No Limit - Level IX (150/300) - 2017/05/24 21:44:27 ET
Table '1622573245 5' 9-max Seat #6 is the button
Seat 1: kudman22 (31208 in chips)=20
Seat 2: Towerclub735 (10040 in chips)=20
Seat 3: PlzDontCallx (10000 in chips)=20
Seat 4: ssweetn (21625 in chips)=20
Seat 6: JJin91 (6877 in chips)=20
Seat 7: sbyrne1 (22364 in chips)=20
Seat 8: Paceman2jr (6120 in chips)=20
Seat 9: vitt409 (9906 in chips)=20
kudman22: posts the ante 40
Towerclub735: posts the ante 40
PlzDontCallx: posts the ante 40
ssweetn: posts the ante 40
JJin91: posts the ante 40
sbyrne1: posts the ante 40
Paceman2jr: posts the ante 40
vitt409: posts the ante 40
sbyrne1: posts small blind 150
Paceman2jr: posts big blind 300
*** HOLE CARDS ***
Dealt to JJin91 [Ts Qh]
vitt409: calls 300
kudman22: folds=20
Towerclub735: folds=20
PlzDontCallx: folds=20
ssweetn: folds=20
JJin91: folds=20
sbyrne1: calls 150
Paceman2jr: checks=20
*** FLOP *** [3s Ac 3d]
sbyrne1: bets 300
Paceman2jr: folds=20
vitt409: calls 300
*** TURN *** [3s Ac 3d] [Qd]
sbyrne1: checks=20
vitt409: bets 300
sbyrne1: calls 300
*** RIVER *** [3s Ac 3d Qd] [Ks]
sbyrne1: checks=20
vitt409: checks=20
*** SHOW DOWN ***
sbyrne1: shows [5c As] (two pair, Aces and Threes)
vitt409: mucks hand=20
sbyrne1 collected 2420 from pot
*** SUMMARY ***
Total pot 2420 | Rake 0=20
Board [3s Ac 3d Qd Ks]
Seat 1: kudman22 folded before Flop (didn't bet)
Seat 2: Towerclub735 folded before Flop (didn't bet)
Seat 3: PlzDontCallx folded before Flop (didn't bet)
Seat 4: ssweetn folded before Flop (didn't bet)
Seat 6: JJin91 (button) folded before Flop (didn't bet)
Seat 7: sbyrne1 (small blind) showed [5c As] and won (2420) with two pa=
ir, Aces and Threes
Seat 8: Paceman2jr (big blind) folded on the Flop
Seat 9: vitt409 mucked [Js Qs]


*********** # 52 **************
PokerStars Hand #170339764150: Tournament #1622573245, $4.55+$0.45 USD =
Hold'em No Limit - Level X (200/400) - 2017/05/24 21:45:13 ET
Table '1622573245 5' 9-max Seat #7 is the button
Seat 1: kudman22 (31168 in chips)=20
Seat 2: Towerclub735 (10000 in chips)=20
Seat 3: PlzDontCallx (9960 in chips)=20
Seat 4: ssweetn (21585 in chips)=20
Seat 6: JJin91 (6837 in chips)=20
Seat 7: sbyrne1 (23844 in chips)=20
Seat 8: Paceman2jr (5780 in chips)=20
Seat 9: vitt409 (8966 in chips)=20
kudman22: posts the ante 50
Towerclub735: posts the ante 50
PlzDontCallx: posts the ante 50
ssweetn: posts the ante 50
JJin91: posts the ante 50
sbyrne1: posts the ante 50
Paceman2jr: posts the ante 50
vitt409: posts the ante 50
Paceman2jr: posts small blind 200
vitt409: posts big blind 400
*** HOLE CARDS ***
Dealt to JJin91 [2c 8h]
kudman22: calls 400
Towerclub735: folds=20
PlzDontCallx: folds=20
ssweetn: calls 400
JJin91: folds=20
sbyrne1: folds=20
Paceman2jr: folds=20
vitt409: checks=20
*** FLOP *** [Ts Qc 5s]
vitt409: checks=20
kudman22: checks=20
ssweetn: checks=20
*** TURN *** [Ts Qc 5s] [3c]
vitt409: checks=20
kudman22: bets 400
ssweetn: calls 400
vitt409: folds=20
*** RIVER *** [Ts Qc 5s 3c] [9h]
kudman22: checks=20
ssweetn: bets 2000
kudman22: folds=20
Uncalled bet (2000) returned to ssweetn
ssweetn collected 2600 from pot
ssweetn: doesn't show hand=20
*** SUMMARY ***
Total pot 2600 | Rake 0=20
Board [Ts Qc 5s 3c 9h]
Seat 1: kudman22 folded on the River
Seat 2: Towerclub735 folded before Flop (didn't bet)
Seat 3: PlzDontCallx folded before Flop (didn't bet)
Seat 4: ssweetn collected (2600)
Seat 6: JJin91 folded before Flop (didn't bet)
Seat 7: sbyrne1 (button) folded before Flop (didn't bet)
Seat 8: Paceman2jr (small blind) folded before Flop
Seat 9: vitt409 (big blind) folded on the Turn


*********** # 53 **************
PokerStars Hand #170339764519: Tournament #1622573245, $4.55+$0.45 USD =
Hold'em No Limit - Level X (200/400) - 2017/05/24 21:46:36 ET
Table '1622573245 5' 9-max Seat #8 is the button
Seat 1: kudman22 (30318 in chips)=20
Seat 2: Towerclub735 (9950 in chips)=20
Seat 3: PlzDontCallx (9910 in chips)=20
Seat 4: ssweetn (23335 in chips)=20
Seat 6: JJin91 (6787 in chips)=20
Seat 7: sbyrne1 (23794 in chips)=20
Seat 8: Paceman2jr (5530 in chips)=20
Seat 9: vitt409 (8516 in chips)=20
kudman22: posts the ante 50
Towerclub735: posts the ante 50
PlzDontCallx: posts the ante 50
ssweetn: posts the ante 50
JJin91: posts the ante 50
sbyrne1: posts the ante 50
Paceman2jr: posts the ante 50
vitt409: posts the ante 50
vitt409: posts small blind 200
kudman22: posts big blind 400
*** HOLE CARDS ***
Dealt to JJin91 [6c Qc]
Towerclub735: raises 400 to 800
PlzDontCallx: folds=20
ssweetn: folds=20
JJin91: folds=20
sbyrne1: folds=20
Paceman2jr: folds=20
vitt409: calls 600
kudman22: calls 400
*** FLOP *** [Qs 9d 5d]
vitt409: checks=20
kudman22: checks=20
Towerclub735: bets 1600
vitt409: calls 1600
kudman22: folds=20
*** TURN *** [Qs 9d 5d] [4h]
vitt409: checks=20
Towerclub735: checks=20
*** RIVER *** [Qs 9d 5d 4h] [2s]
vitt409: checks=20
Towerclub735: checks=20
*** SHOW DOWN ***
vitt409: shows [Ad Th] (high card Ace)
Towerclub735: mucks hand=20
vitt409 collected 6000 from pot
*** SUMMARY ***
Total pot 6000 | Rake 0=20
Board [Qs 9d 5d 4h 2s]
Seat 1: kudman22 (big blind) folded on the Flop
Seat 2: Towerclub735 mucked [Tc Jd]
Seat 3: PlzDontCallx folded before Flop (didn't bet)
Seat 4: ssweetn folded before Flop (didn't bet)
Seat 6: JJin91 folded before Flop (didn't bet)
Seat 7: sbyrne1 folded before Flop (didn't bet)
Seat 8: Paceman2jr (button) folded before Flop (didn't bet)
Seat 9: vitt409 (small blind) showed [Ad Th] and won (6000) with high c=
ard Ace


*********** # 54 **************
PokerStars Hand #170339764704: Tournament #1622573245, $4.55+$0.45 USD =
Hold'em No Limit - Level X (200/400) - 2017/05/24 21:47:18 ET
Table '1622573245 5' 9-max Seat #9 is the button
Seat 1: kudman22 (29468 in chips)=20
Seat 2: Towerclub735 (7500 in chips)=20
Seat 3: PlzDontCallx (9860 in chips)=20
Seat 4: ssweetn (23285 in chips)=20
Seat 6: JJin91 (6737 in chips)=20
Seat 7: sbyrne1 (23744 in chips)=20
Seat 8: Paceman2jr (5480 in chips)=20
Seat 9: vitt409 (12066 in chips)=20
kudman22: posts the ante 50
Towerclub735: posts the ante 50
PlzDontCallx: posts the ante 50
ssweetn: posts the ante 50
JJin91: posts the ante 50
sbyrne1: posts the ante 50
Paceman2jr: posts the ante 50
vitt409: posts the ante 50
kudman22: posts small blind 200
Towerclub735: posts big blind 400
*** HOLE CARDS ***
Dealt to JJin91 [8c 6c]
PlzDontCallx: folds=20
ssweetn: calls 400
JJin91: folds=20
sbyrne1: folds=20
Paceman2jr: folds=20
vitt409: folds=20
kudman22: calls 200
Towerclub735: raises 3600 to 4000
ssweetn: folds=20
kudman22: folds=20
Uncalled bet (3600) returned to Towerclub735
Towerclub735 collected 1600 from pot
Towerclub735: doesn't show hand=20
*** SUMMARY ***
Total pot 1600 | Rake 0=20
Seat 1: kudman22 (small blind) folded before Flop
Seat 2: Towerclub735 (big blind) collected (1600)
Seat 3: PlzDontCallx folded before Flop (didn't bet)
Seat 4: ssweetn folded before Flop
Seat 6: JJin91 folded before Flop (didn't bet)
Seat 7: sbyrne1 folded before Flop (didn't bet)
Seat 8: Paceman2jr folded before Flop (didn't bet)
Seat 9: vitt409 (button) folded before Flop (didn't bet)


*********** # 55 **************
PokerStars Hand #170339764965: Tournament #1622573245, $4.55+$0.45 USD =
Hold'em No Limit - Level X (200/400) - 2017/05/24 21:48:15 ET
Table '1622573245 5' 9-max Seat #1 is the button
Seat 1: kudman22 (29018 in chips)=20
Seat 2: Towerclub735 (8650 in chips)=20
Seat 3: PlzDontCallx (9810 in chips)=20
Seat 4: ssweetn (22835 in chips)=20
Seat 6: JJin91 (6687 in chips)=20
Seat 7: sbyrne1 (23694 in chips)=20
Seat 8: Paceman2jr (5430 in chips)=20
Seat 9: vitt409 (12016 in chips)=20
kudman22: posts the ante 50
Towerclub735: posts the ante 50
PlzDontCallx: posts the ante 50
ssweetn: posts the ante 50
JJin91: posts the ante 50
sbyrne1: posts the ante 50
Paceman2jr: posts the ante 50
vitt409: posts the ante 50
Towerclub735: posts small blind 200
PlzDontCallx: posts big blind 400
*** HOLE CARDS ***
Dealt to JJin91 [7c Qc]
ssweetn: calls 400
JJin91: folds=20
sbyrne1: calls 400
Paceman2jr: raises 4980 to 5380 and is all-in
vitt409: folds=20
kudman22: folds=20
Towerclub735: folds=20
PlzDontCallx: folds=20
ssweetn: folds=20
sbyrne1: folds=20
Uncalled bet (4980) returned to Paceman2jr
Paceman2jr collected 2200 from pot
*** SUMMARY ***
Total pot 2200 | Rake 0=20
Seat 1: kudman22 (button) folded before Flop (didn't bet)
Seat 2: Towerclub735 (small blind) folded before Flop
Seat 3: PlzDontCallx (big blind) folded before Flop
Seat 4: ssweetn folded before Flop
Seat 6: JJin91 folded before Flop (didn't bet)
Seat 7: sbyrne1 folded before Flop
Seat 8: Paceman2jr collected (2200)
Seat 9: vitt409 folded before Flop (didn't bet)


*********** # 56 **************
PokerStars Hand #170339765084: Tournament #1622573245, $4.55+$0.45 USD =
Hold'em No Limit - Level X (200/400) - 2017/05/24 21:48:41 ET
Table '1622573245 5' 9-max Seat #2 is the button
Seat 1: kudman22 (28968 in chips)=20
Seat 2: Towerclub735 (8400 in chips)=20
Seat 3: PlzDontCallx (9360 in chips)=20
Seat 4: ssweetn (22385 in chips)=20
Seat 6: JJin91 (6637 in chips)=20
Seat 7: sbyrne1 (23244 in chips)=20
Seat 8: Paceman2jr (7180 in chips)=20
Seat 9: vitt409 (11966 in chips)=20
kudman22: posts the ante 50
Towerclub735: posts the ante 50
PlzDontCallx: posts the ante 50
ssweetn: posts the ante 50
JJin91: posts the ante 50
sbyrne1: posts the ante 50
Paceman2jr: posts the ante 50
vitt409: posts the ante 50
PlzDontCallx: posts small blind 200
ssweetn: posts big blind 400
*** HOLE CARDS ***
Dealt to JJin91 [Qc 2s]
JJin91: folds=20
sbyrne1: folds=20
Paceman2jr: folds=20
vitt409: raises 400 to 800
kudman22: folds=20
Towerclub735: folds=20
PlzDontCallx: folds=20
ssweetn: calls 400
*** FLOP *** [Kc 2c 5d]
ssweetn: checks=20
vitt409: bets 400
ssweetn: folds=20
Uncalled bet (400) returned to vitt409
vitt409 collected 2200 from pot
*** SUMMARY ***
Total pot 2200 | Rake 0=20
Board [Kc 2c 5d]
Seat 1: kudman22 folded before Flop (didn't bet)
Seat 2: Towerclub735 (button) folded before Flop (didn't bet)
Seat 3: PlzDontCallx (small blind) folded before Flop
Seat 4: ssweetn (big blind) folded on the Flop
Seat 6: JJin91 folded before Flop (didn't bet)
Seat 7: sbyrne1 folded before Flop (didn't bet)
Seat 8: Paceman2jr folded before Flop (didn't bet)
Seat 9: vitt409 collected (2200)


*********** # 57 **************
PokerStars Hand #170339765199: Tournament #1622573245, $4.55+$0.45 USD =
Hold'em No Limit - Level X (200/400) - 2017/05/24 21:49:09 ET
Table '1622573245 5' 9-max Seat #3 is the button
Seat 1: kudman22 (28918 in chips)=20
Seat 2: Towerclub735 (8350 in chips)=20
Seat 3: PlzDontCallx (9110 in chips)=20
Seat 4: ssweetn (21535 in chips)=20
Seat 6: JJin91 (6587 in chips)=20
Seat 7: sbyrne1 (23194 in chips)=20
Seat 8: Paceman2jr (7130 in chips)=20
Seat 9: vitt409 (13316 in chips)=20
kudman22: posts the ante 50
Towerclub735: posts the ante 50
PlzDontCallx: posts the ante 50
ssweetn: posts the ante 50
JJin91: posts the ante 50
sbyrne1: posts the ante 50
Paceman2jr: posts the ante 50
vitt409: posts the ante 50
ssweetn: posts small blind 200
JJin91: posts big blind 400
*** HOLE CARDS ***
Dealt to JJin91 [4c Ac]
sbyrne1: folds=20
Paceman2jr: raises 800 to 1200
vitt409: folds=20
kudman22: folds=20
Towerclub735: folds=20
PlzDontCallx: folds=20
ssweetn: folds=20
JJin91: raises 5337 to 6537 and is all-in
Paceman2jr: calls 5337
*** FLOP *** [3s Kh 5d]
*** TURN *** [3s Kh 5d] [2s]
*** RIVER *** [3s Kh 5d 2s] [2d]
*** SHOW DOWN ***
JJin91: shows [4c Ac] (a straight, Ace to Five)
Paceman2jr: shows [8d 8c] (two pair, Eights and Deuces)
JJin91 collected 13674 from pot
*** SUMMARY ***
Total pot 13674 | Rake 0=20
Board [3s Kh 5d 2s 2d]
Seat 1: kudman22 folded before Flop (didn't bet)
Seat 2: Towerclub735 folded before Flop (didn't bet)
Seat 3: PlzDontCallx (button) folded before Flop (didn't bet)
Seat 4: ssweetn (small blind) folded before Flop
Seat 6: JJin91 (big blind) showed [4c Ac] and won (13674) with a straig=
ht, Ace to Five
Seat 7: sbyrne1 folded before Flop (didn't bet)
Seat 8: Paceman2jr showed [8d 8c] and lost with two pair, Eights and De=
uces
Seat 9: vitt409 folded before Flop (didn't bet)


*********** # 58 **************
PokerStars Hand #170339765394: Tournament #1622573245, $4.55+$0.45 USD =
Hold'em No Limit - Level X (200/400) - 2017/05/24 21:49:53 ET
Table '1622573245 5' 9-max Seat #4 is the button
Seat 1: kudman22 (28868 in chips)=20
Seat 2: Towerclub735 (8300 in chips)=20
Seat 3: PlzDontCallx (9060 in chips)=20
Seat 4: ssweetn (21285 in chips)=20
Seat 6: JJin91 (13674 in chips)=20
Seat 7: sbyrne1 (23144 in chips)=20
Seat 8: Paceman2jr (543 in chips)=20
Seat 9: vitt409 (13266 in chips)=20
kudman22: posts the ante 50
Towerclub735: posts the ante 50
PlzDontCallx: posts the ante 50
ssweetn: posts the ante 50
JJin91: posts the ante 50
sbyrne1: posts the ante 50
Paceman2jr: posts the ante 50
vitt409: posts the ante 50
JJin91: posts small blind 200
sbyrne1: posts big blind 400
*** HOLE CARDS ***
Dealt to JJin91 [Ad 6h]
Paceman2jr: raises 93 to 493 and is all-in
vitt409: calls 493
kudman22: folds=20
Towerclub735: raises 307 to 800
PlzDontCallx: raises 8210 to 9010 and is all-in
ssweetn: folds=20
JJin91: folds=20
sbyrne1: folds=20
vitt409: folds=20
Towerclub735: calls 7450 and is all-in
Uncalled bet (760) returned to PlzDontCallx
*** FLOP *** [Th 9h 4c]
*** TURN *** [Th 9h 4c] [3c]
*** RIVER *** [Th 9h 4c 3c] [7h]
*** SHOW DOWN ***
Towerclub735: shows [Js Kh] (high card King)
PlzDontCallx: shows [Kc As] (high card Ace)
PlzDontCallx collected 15514 from side pot
Paceman2jr: shows [4s 8s] (a pair of Fours)
Paceman2jr collected 2972 from main pot
Towerclub735 finished the tournament in 76th place
*** SUMMARY ***
Total pot 18486 Main pot 2972. Side pot 15514. | Rake 0=20
Board [Th 9h 4c 3c 7h]
Seat 1: kudman22 folded before Flop (didn't bet)
Seat 2: Towerclub735 showed [Js Kh] and lost with high card King
Seat 3: PlzDontCallx showed [Kc As] and won (15514) with high card Ace
Seat 4: ssweetn (button) folded before Flop (didn't bet)
Seat 6: JJin91 (small blind) folded before Flop
Seat 7: sbyrne1 (big blind) folded before Flop
Seat 8: Paceman2jr showed [4s 8s] and won (2972) with a pair of Fours
Seat 9: vitt409 folded before Flop


*********** # 59 **************
PokerStars Hand #170339765586: Tournament #1622573245, $4.55+$0.45 USD =
Hold'em No Limit - Level XI (250/500) - 2017/05/24 21:50:36 ET
Table '1622573245 5' 9-max Seat #6 is the button
Seat 1: kudman22 (28818 in chips)=20
Seat 2: Giants TD (27027 in chips)=20
Seat 3: PlzDontCallx (16274 in chips)=20
Seat 4: ssweetn (21235 in chips)=20
Seat 6: JJin91 (13424 in chips)=20
Seat 7: sbyrne1 (22694 in chips)=20
Seat 8: Paceman2jr (2972 in chips)=20
Seat 9: vitt409 (12723 in chips)=20
kudman22: posts the ante 60
Giants TD: posts the ante 60
PlzDontCallx: posts the ante 60
ssweetn: posts the ante 60
JJin91: posts the ante 60
sbyrne1: posts the ante 60
Paceman2jr: posts the ante 60
vitt409: posts the ante 60
sbyrne1: posts small blind 250
Paceman2jr: posts big blind 500
*** HOLE CARDS ***
Dealt to JJin91 [Kh 9h]
vitt409: folds=20
kudman22: folds=20
Giants TD: calls 500
PlzDontCallx: folds=20
ssweetn: folds=20
JJin91: calls 500
sbyrne1: calls 250
Paceman2jr: checks=20
*** FLOP *** [Kc Jc 4c]
sbyrne1: checks=20
Paceman2jr: checks=20
Giants TD: bets 2500
JJin91: folds=20
sbyrne1: folds=20
Paceman2jr: folds=20
Uncalled bet (2500) returned to Giants TD
Giants TD collected 2480 from pot
Giants TD: doesn't show hand=20
*** SUMMARY ***
Total pot 2480 | Rake 0=20
Board [Kc Jc 4c]
Seat 1: kudman22 folded before Flop (didn't bet)
Seat 2: Giants TD collected (2480)
Seat 3: PlzDontCallx folded before Flop (didn't bet)
Seat 4: ssweetn folded before Flop (didn't bet)
Seat 6: JJin91 (button) folded on the Flop
Seat 7: sbyrne1 (small blind) folded on the Flop
Seat 8: Paceman2jr (big blind) folded on the Flop
Seat 9: vitt409 folded before Flop (didn't bet)


*********** # 60 **************
PokerStars Hand #170339765708: Tournament #1622573245, $4.55+$0.45 USD =
Hold'em No Limit - Level XI (250/500) - 2017/05/24 21:51:02 ET
Table '1622573245 5' 9-max Seat #7 is the button
Seat 1: kudman22 (28758 in chips)=20
Seat 2: Giants TD (28947 in chips)=20
Seat 3: PlzDontCallx (16214 in chips)=20
Seat 4: ssweetn (21175 in chips)=20
Seat 6: JJin91 (12864 in chips)=20
Seat 7: sbyrne1 (22134 in chips)=20
Seat 8: Paceman2jr (2412 in chips)=20
Seat 9: vitt409 (12663 in chips)=20
kudman22: posts the ante 60
Giants TD: posts the ante 60
PlzDontCallx: posts the ante 60
ssweetn: posts the ante 60
JJin91: posts the ante 60
sbyrne1: posts the ante 60
Paceman2jr: posts the ante 60
vitt409: posts the ante 60
Paceman2jr: posts small blind 250
vitt409: posts big blind 500
*** HOLE CARDS ***
Dealt to JJin91 [Tc Ac]
kudman22: folds=20
Giants TD: folds=20
PlzDontCallx: raises 750 to 1250
ssweetn: folds=20
JJin91: calls 1250
sbyrne1: folds=20
Paceman2jr: folds=20
vitt409: folds=20
*** FLOP *** [4c 7c Qh]
PlzDontCallx: checks=20
JJin91: checks=20
*** TURN *** [4c 7c Qh] [7d]
PlzDontCallx: bets 1455
JJin91: calls 1455
*** RIVER *** [4c 7c Qh 7d] [9h]
PlzDontCallx: checks=20
JJin91: checks=20
*** SHOW DOWN ***
PlzDontCallx: shows [5h 6h] (a pair of Sevens)
JJin91: shows [Tc Ac] (a pair of Sevens - Ace kicker)
JJin91 collected 6640 from pot
*** SUMMARY ***
Total pot 6640 | Rake 0=20
Board [4c 7c Qh 7d 9h]
Seat 1: kudman22 folded before Flop (didn't bet)
Seat 2: Giants TD folded before Flop (didn't bet)
Seat 3: PlzDontCallx showed [5h 6h] and lost with a pair of Sevens
Seat 4: ssweetn folded before Flop (didn't bet)
Seat 6: JJin91 showed [Tc Ac] and won (6640) with a pair of Sevens
Seat 7: sbyrne1 (button) folded before Flop (didn't bet)
Seat 8: Paceman2jr (small blind) folded before Flop
Seat 9: vitt409 (big blind) folded before Flop


*********** # 61 **************
PokerStars Hand #170339766089: Tournament #1622573245, $4.55+$0.45 USD =
Hold'em No Limit - Level XI (250/500) - 2017/05/24 21:52:28 ET
Table '1622573245 5' 9-max Seat #8 is the button
Seat 1: kudman22 (28698 in chips)=20
Seat 2: Giants TD (28887 in chips)=20
Seat 3: PlzDontCallx (13449 in chips)=20
Seat 4: ssweetn (21115 in chips)=20
Seat 6: JJin91 (16739 in chips)=20
Seat 7: sbyrne1 (22074 in chips)=20
Seat 8: Paceman2jr (2102 in chips)=20
Seat 9: vitt409 (12103 in chips)=20
kudman22: posts the ante 60
Giants TD: posts the ante 60
PlzDontCallx: posts the ante 60
ssweetn: posts the ante 60
JJin91: posts the ante 60
sbyrne1: posts the ante 60
Paceman2jr: posts the ante 60
vitt409: posts the ante 60
vitt409: posts small blind 250
kudman22: posts big blind 500
*** HOLE CARDS ***
Dealt to JJin91 [8d 7c]
Giants TD: calls 500
PlzDontCallx: folds=20
ssweetn: folds=20
JJin91: folds=20
sbyrne1: folds=20
Paceman2jr: raises 1542 to 2042 and is all-in
vitt409: folds=20
kudman22: folds=20
Giants TD: folds=20
Uncalled bet (1542) returned to Paceman2jr
Paceman2jr collected 2230 from pot
*** SUMMARY ***
Total pot 2230 | Rake 0=20
Seat 1: kudman22 (big blind) folded before Flop
Seat 2: Giants TD folded before Flop
Seat 3: PlzDontCallx folded before Flop (didn't bet)
Seat 4: ssweetn folded before Flop (didn't bet)
Seat 6: JJin91 folded before Flop (didn't bet)
Seat 7: sbyrne1 folded before Flop (didn't bet)
Seat 8: Paceman2jr (button) collected (2230)
Seat 9: vitt409 (small blind) folded before Flop


*********** # 62 **************
PokerStars Hand #170339766169: Tournament #1622573245, $4.55+$0.45 USD =
Hold'em No Limit - Level XI (250/500) - 2017/05/24 21:52:47 ET
Table '1622573245 5' 9-max Seat #9 is the button
Seat 1: kudman22 (28138 in chips)=20
Seat 2: Giants TD (28327 in chips)=20
Seat 3: PlzDontCallx (13389 in chips)=20
Seat 4: ssweetn (21055 in chips)=20
Seat 6: JJin91 (16679 in chips)=20
Seat 7: sbyrne1 (22014 in chips)=20
Seat 8: Paceman2jr (3772 in chips)=20
Seat 9: vitt409 (11793 in chips)=20
kudman22: posts the ante 60
Giants TD: posts the ante 60
PlzDontCallx: posts the ante 60
ssweetn: posts the ante 60
JJin91: posts the ante 60
sbyrne1: posts the ante 60
Paceman2jr: posts the ante 60
vitt409: posts the ante 60
kudman22: posts small blind 250
Giants TD: posts big blind 500
*** HOLE CARDS ***
Dealt to JJin91 [8h 7d]
PlzDontCallx: folds=20
ssweetn: raises 1000 to 1500
JJin91: folds=20
sbyrne1: folds=20
Paceman2jr: folds=20
vitt409: folds=20
kudman22: folds=20
Giants TD: calls 1000
*** FLOP *** [4h Jh Ts]
Giants TD: checks=20
ssweetn: bets 2000
Giants TD: folds=20
Uncalled bet (2000) returned to ssweetn
ssweetn collected 3730 from pot
ssweetn: doesn't show hand=20
*** SUMMARY ***
Total pot 3730 | Rake 0=20
Board [4h Jh Ts]
Seat 1: kudman22 (small blind) folded before Flop
Seat 2: Giants TD (big blind) folded on the Flop
Seat 3: PlzDontCallx folded before Flop (didn't bet)
Seat 4: ssweetn collected (3730)
Seat 6: JJin91 folded before Flop (didn't bet)
Seat 7: sbyrne1 folded before Flop (didn't bet)
Seat 8: Paceman2jr folded before Flop (didn't bet)
Seat 9: vitt409 (button) folded before Flop (didn't bet)


*********** # 63 **************
PokerStars Hand #170339766289: Tournament #1622573245, $4.55+$0.45 USD =
Hold'em No Limit - Level XI (250/500) - 2017/05/24 21:53:14 ET
Table '1622573245 5' 9-max Seat #1 is the button
Seat 1: kudman22 (27828 in chips)=20
Seat 2: Giants TD (26767 in chips)=20
Seat 3: PlzDontCallx (13329 in chips)=20
Seat 4: ssweetn (23225 in chips)=20
Seat 6: JJin91 (16619 in chips)=20
Seat 7: sbyrne1 (21954 in chips)=20
Seat 8: Paceman2jr (3712 in chips)=20
Seat 9: vitt409 (11733 in chips)=20
kudman22: posts the ante 60
Giants TD: posts the ante 60
PlzDontCallx: posts the ante 60
ssweetn: posts the ante 60
JJin91: posts the ante 60
sbyrne1: posts the ante 60
Paceman2jr: posts the ante 60
vitt409: posts the ante 60
Giants TD: posts small blind 250
PlzDontCallx: posts big blind 500
*** HOLE CARDS ***
Dealt to JJin91 [Ts Jd]
ssweetn: folds=20
JJin91: folds=20
sbyrne1: folds=20
Paceman2jr: folds=20
vitt409: folds=20
kudman22: folds=20
Giants TD: calls 250
PlzDontCallx: raises 1050 to 1550
Giants TD: folds=20
Uncalled bet (1050) returned to PlzDontCallx
PlzDontCallx collected 1480 from pot
PlzDontCallx: doesn't show hand=20
*** SUMMARY ***
Total pot 1480 | Rake 0=20
Seat 1: kudman22 (button) folded before Flop (didn't bet)
Seat 2: Giants TD (small blind) folded before Flop
Seat 3: PlzDontCallx (big blind) collected (1480)
Seat 4: ssweetn folded before Flop (didn't bet)
Seat 6: JJin91 folded before Flop (didn't bet)
Seat 7: sbyrne1 folded before Flop (didn't bet)
Seat 8: Paceman2jr folded before Flop (didn't bet)
Seat 9: vitt409 folded before Flop (didn't bet)


*********** # 64 **************
PokerStars Hand #170339766461: Tournament #1622573245, $4.55+$0.45 USD =
Hold'em No Limit - Level XI (250/500) - 2017/05/24 21:53:54 ET
Table '1622573245 5' 9-max Seat #2 is the button
Seat 1: kudman22 (27768 in chips)=20
Seat 2: Giants TD (26207 in chips)=20
Seat 3: PlzDontCallx (14249 in chips)=20
Seat 4: ssweetn (23165 in chips)=20
Seat 5: Force O Will (10000 in chips)=20
Seat 6: JJin91 (16559 in chips)=20
Seat 7: sbyrne1 (21894 in chips)=20
Seat 8: Paceman2jr (3652 in chips)=20
Seat 9: vitt409 (11673 in chips)=20
kudman22: posts the ante 60
Giants TD: posts the ante 60
PlzDontCallx: posts the ante 60
ssweetn: posts the ante 60
Force O Will: posts the ante 60
JJin91: posts the ante 60
sbyrne1: posts the ante 60
Paceman2jr: posts the ante 60
vitt409: posts the ante 60
PlzDontCallx: posts small blind 250
ssweetn: posts big blind 500
*** HOLE CARDS ***
Dealt to JJin91 [Kc 9s]
Force O Will: folds=20
JJin91: folds=20
sbyrne1: folds=20
Paceman2jr: folds=20
vitt409: calls 500
kudman22: folds=20
Giants TD: folds=20
PlzDontCallx: folds=20
ssweetn: raises 2000 to 2500
vitt409: calls 2000
*** FLOP *** [3d 3s Js]
ssweetn: bets 6000
vitt409: folds=20
Uncalled bet (6000) returned to ssweetn
ssweetn collected 5790 from pot
ssweetn: doesn't show hand=20
*** SUMMARY ***
Total pot 5790 | Rake 0=20
Board [3d 3s Js]
Seat 1: kudman22 folded before Flop (didn't bet)
Seat 2: Giants TD (button) folded before Flop (didn't bet)
Seat 3: PlzDontCallx (small blind) folded before Flop
Seat 4: ssweetn (big blind) collected (5790)
Seat 5: Force O Will folded before Flop (didn't bet)
Seat 6: JJin91 folded before Flop (didn't bet)
Seat 7: sbyrne1 folded before Flop (didn't bet)
Seat 8: Paceman2jr folded before Flop (didn't bet)
Seat 9: vitt409 folded on the Flop


*********** # 65 **************
PokerStars Hand #170339766659: Tournament #1622573245, $4.55+$0.45 USD =
Hold'em No Limit - Level XI (250/500) - 2017/05/24 21:54:42 ET
Table '1622573245 5' 9-max Seat #3 is the button
Seat 1: kudman22 (27708 in chips)=20
Seat 2: Giants TD (26147 in chips)=20
Seat 3: PlzDontCallx (13939 in chips)=20
Seat 4: ssweetn (26395 in chips)=20
Seat 5: Force O Will (9940 in chips)=20
Seat 6: JJin91 (16499 in chips)=20
Seat 7: sbyrne1 (21834 in chips)=20
Seat 8: Paceman2jr (3592 in chips)=20
Seat 9: vitt409 (9113 in chips)=20
kudman22: posts the ante 60
Giants TD: posts the ante 60
PlzDontCallx: posts the ante 60
ssweetn: posts the ante 60
Force O Will: posts the ante 60
JJin91: posts the ante 60
sbyrne1: posts the ante 60
Paceman2jr: posts the ante 60
vitt409: posts the ante 60
ssweetn: posts small blind 250
Force O Will: posts big blind 500
*** HOLE CARDS ***
Dealt to JJin91 [9d 2d]
JJin91: folds=20
sbyrne1 has timed out
sbyrne1: folds=20
sbyrne1 is sitting out
Paceman2jr: folds=20
sbyrne1 has returned
vitt409: folds=20
kudman22: folds=20
Giants TD: folds=20
PlzDontCallx: folds=20
ssweetn: calls 250
Force O Will: checks=20
*** FLOP *** [5h Td Qd]
ssweetn: bets 1000
Force O Will: folds=20
Uncalled bet (1000) returned to ssweetn
ssweetn collected 1540 from pot
ssweetn: doesn't show hand=20
*** SUMMARY ***
Total pot 1540 | Rake 0=20
Board [5h Td Qd]
Seat 1: kudman22 folded before Flop (didn't bet)
Seat 2: Giants TD folded before Flop (didn't bet)
Seat 3: PlzDontCallx (button) folded before Flop (didn't bet)
Seat 4: ssweetn (small blind) collected (1540)
Seat 5: Force O Will (big blind) folded on the Flop
Seat 6: JJin91 folded before Flop (didn't bet)
Seat 7: sbyrne1 folded before Flop (didn't bet)
Seat 8: Paceman2jr folded before Flop (didn't bet)
Seat 9: vitt409 folded before Flop (didn't bet)


*********** # 66 **************
PokerStars Hand #170339768101: Tournament #1622573245, $4.55+$0.45 USD =
Hold'em No Limit - Level XII (300/600) - 2017/05/24 22:01:41 ET
Table '1622573245 8' 9-max Seat #1 is the button
Seat 1: hockingjoe (41350 in chips)=20
Seat 2: MyManPotnPan (33547 in chips)=20
Seat 3: LaBori85 (28240 in chips)=20
Seat 4: ShooterrrNJ (3920 in chips)=20
Seat 5: JJin91 (16439 in chips)=20
Seat 6: betgo (7600 in chips)=20
Seat 7: kidpokerUNO (13840 in chips)=20
Seat 8: Guvee (16790 in chips)=20
Seat 9: bighand18 (20050 in chips)=20
hockingjoe: posts the ante 70
MyManPotnPan: posts the ante 70
LaBori85: posts the ante 70
ShooterrrNJ: posts the ante 70
JJin91: posts the ante 70
betgo: posts the ante 70
kidpokerUNO: posts the ante 70
Guvee: posts the ante 70
bighand18: posts the ante 70
MyManPotnPan: posts small blind 300
LaBori85: posts big blind 600
*** HOLE CARDS ***
Dealt to JJin91 [Ks Ac]
ShooterrrNJ: raises 3250 to 3850 and is all-in
JJin91: calls 3850
betgo: folds=20
kidpokerUNO: folds=20
Guvee: folds=20
bighand18: folds=20
hockingjoe: folds=20
MyManPotnPan: folds=20
LaBori85: folds=20
*** FLOP *** [7d Ad 6h]
*** TURN *** [7d Ad 6h] [9d]
*** RIVER *** [7d Ad 6h 9d] [3h]
*** SHOW DOWN ***
ShooterrrNJ: shows [Td Ts] (a pair of Tens)
JJin91: shows [Ks Ac] (a pair of Aces)
JJin91 collected 9230 from pot
ShooterrrNJ finished the tournament in 69th place
*** SUMMARY ***
Total pot 9230 | Rake 0=20
Board [7d Ad 6h 9d 3h]
Seat 1: hockingjoe (button) folded before Flop (didn't bet)
Seat 2: MyManPotnPan (small blind) folded before Flop
Seat 3: LaBori85 (big blind) folded before Flop
Seat 4: ShooterrrNJ showed [Td Ts] and lost with a pair of Tens
Seat 5: JJin91 showed [Ks Ac] and won (9230) with a pair of Aces
Seat 6: betgo folded before Flop (didn't bet)
Seat 7: kidpokerUNO folded before Flop (didn't bet)
Seat 8: Guvee folded before Flop (didn't bet)
Seat 9: bighand18 folded before Flop (didn't bet)


*********** # 67 **************
PokerStars Hand #170339768215: Tournament #1622573245, $4.55+$0.45 USD =
Hold'em No Limit - Level XII (300/600) - 2017/05/24 22:02:09 ET
Table '1622573245 8' 9-max Seat #2 is the button
Seat 1: hockingjoe (41280 in chips)=20
Seat 2: MyManPotnPan (33177 in chips)=20
Seat 3: LaBori85 (27570 in chips)=20
Seat 5: JJin91 (21749 in chips)=20
Seat 6: betgo (7530 in chips)=20
Seat 7: kidpokerUNO (13770 in chips)=20
Seat 8: Guvee (16720 in chips)=20
Seat 9: bighand18 (19980 in chips)=20
hockingjoe: posts the ante 70
MyManPotnPan: posts the ante 70
LaBori85: posts the ante 70
JJin91: posts the ante 70
betgo: posts the ante 70
kidpokerUNO: posts the ante 70
Guvee: posts the ante 70
bighand18: posts the ante 70
LaBori85: posts small blind 300
JJin91: posts big blind 600
*** HOLE CARDS ***
Dealt to JJin91 [Qs 2h]
betgo: folds=20
kidpokerUNO: raises 600 to 1200
Guvee: folds=20
bighand18: calls 1200
hockingjoe: folds=20
MyManPotnPan: folds=20
LaBori85: raises 26300 to 27500 and is all-in
JJin91: folds=20
kidpokerUNO: calls 12500 and is all-in
bighand18: folds=20
Uncalled bet (13800) returned to LaBori85
*** FLOP *** [5c 5d 3h]
*** TURN *** [5c 5d 3h] [5h]
*** RIVER *** [5c 5d 3h 5h] [9c]
*** SHOW DOWN ***
LaBori85: shows [Ks Ah] (three of a kind, Fives)
kidpokerUNO: shows [Qd Qh] (a full house, Fives full of Queens)
kidpokerUNO collected 29760 from pot
*** SUMMARY ***
Total pot 29760 | Rake 0=20
Board [5c 5d 3h 5h 9c]
Seat 1: hockingjoe folded before Flop (didn't bet)
Seat 2: MyManPotnPan (button) folded before Flop (didn't bet)
Seat 3: LaBori85 (small blind) showed [Ks Ah] and lost with three of a =
kind, Fives
Seat 5: JJin91 (big blind) folded before Flop
Seat 6: betgo folded before Flop (didn't bet)
Seat 7: kidpokerUNO showed [Qd Qh] and won (29760) with a full house, F=
ives full of Queens
Seat 8: Guvee folded before Flop (didn't bet)
Seat 9: bighand18 folded before Flop


*********** # 68 **************
PokerStars Hand #170339768402: Tournament #1622573245, $4.55+$0.45 USD =
Hold'em No Limit - Level XII (300/600) - 2017/05/24 22:02:58 ET
Table '1622573245 8' 9-max Seat #3 is the button
Seat 1: hockingjoe (41210 in chips)=20
Seat 2: MyManPotnPan (33107 in chips)=20
Seat 3: LaBori85 (13800 in chips)=20
Seat 5: JJin91 (21079 in chips)=20
Seat 6: betgo (7460 in chips)=20
Seat 7: kidpokerUNO (29760 in chips)=20
Seat 8: Guvee (16650 in chips)=20
Seat 9: bighand18 (18710 in chips)=20
hockingjoe: posts the ante 70
MyManPotnPan: posts the ante 70
LaBori85: posts the ante 70
JJin91: posts the ante 70
betgo: posts the ante 70
kidpokerUNO: posts the ante 70
Guvee: posts the ante 70
bighand18: posts the ante 70
JJin91: posts small blind 300
betgo: posts big blind 600
*** HOLE CARDS ***
Dealt to JJin91 [Th Jd]
kidpokerUNO: folds=20
Guvee: folds=20
bighand18: folds=20
hockingjoe: folds=20
MyManPotnPan: folds=20
LaBori85: folds=20
JJin91: calls 300
betgo: raises 6790 to 7390 and is all-in
JJin91: folds=20
Uncalled bet (6790) returned to betgo
betgo collected 1760 from pot
betgo: doesn't show hand=20
*** SUMMARY ***
Total pot 1760 | Rake 0=20
Seat 1: hockingjoe folded before Flop (didn't bet)
Seat 2: MyManPotnPan folded before Flop (didn't bet)
Seat 3: LaBori85 (button) folded before Flop (didn't bet)
Seat 5: JJin91 (small blind) folded before Flop
Seat 6: betgo (big blind) collected (1760)
Seat 7: kidpokerUNO folded before Flop (didn't bet)
Seat 8: Guvee folded before Flop (didn't bet)
Seat 9: bighand18 folded before Flop (didn't bet)


*********** # 69 **************
PokerStars Hand #170339768518: Tournament #1622573245, $4.55+$0.45 USD =
Hold'em No Limit - Level XII (300/600) - 2017/05/24 22:03:26 ET
Table '1622573245 8' 9-max Seat #5 is the button
Seat 1: hockingjoe (41140 in chips)=20
Seat 2: MyManPotnPan (33037 in chips)=20
Seat 3: LaBori85 (13730 in chips)=20
Seat 5: JJin91 (20409 in chips)=20
Seat 6: betgo (8550 in chips)=20
Seat 7: kidpokerUNO (29690 in chips)=20
Seat 8: Guvee (16580 in chips)=20
Seat 9: bighand18 (18640 in chips)=20
hockingjoe: posts the ante 70
MyManPotnPan: posts the ante 70
LaBori85: posts the ante 70
JJin91: posts the ante 70
betgo: posts the ante 70
kidpokerUNO: posts the ante 70
Guvee: posts the ante 70
bighand18: posts the ante 70
betgo: posts small blind 300
kidpokerUNO: posts big blind 600
*** HOLE CARDS ***
Dealt to JJin91 [Kd 7s]
Guvee: calls 600
bighand18: raises 17970 to 18570 and is all-in
hockingjoe: folds=20
MyManPotnPan: folds=20
LaBori85: folds=20
JJin91: folds=20
betgo: folds=20
kidpokerUNO: folds=20
Guvee: folds=20
Uncalled bet (17970) returned to bighand18
bighand18 collected 2660 from pot
bighand18: doesn't show hand=20
*** SUMMARY ***
Total pot 2660 | Rake 0=20
Seat 1: hockingjoe folded before Flop (didn't bet)
Seat 2: MyManPotnPan folded before Flop (didn't bet)
Seat 3: LaBori85 folded before Flop (didn't bet)
Seat 5: JJin91 (button) folded before Flop (didn't bet)
Seat 6: betgo (small blind) folded before Flop
Seat 7: kidpokerUNO (big blind) folded before Flop
Seat 8: Guvee folded before Flop
Seat 9: bighand18 collected (2660)


*********** # 70 **************
PokerStars Hand #170339768603: Tournament #1622573245, $4.55+$0.45 USD =
Hold'em No Limit - Level XII (300/600) - 2017/05/24 22:03:46 ET
Table '1622573245 8' 9-max Seat #6 is the button
Seat 1: hockingjoe (41070 in chips)=20
Seat 2: MyManPotnPan (32967 in chips)=20
Seat 3: LaBori85 (13660 in chips)=20
Seat 5: JJin91 (20339 in chips)=20
Seat 6: betgo (8180 in chips)=20
Seat 7: kidpokerUNO (29020 in chips)=20
Seat 8: Guvee (15910 in chips)=20
Seat 9: bighand18 (20630 in chips)=20
hockingjoe: posts the ante 70
MyManPotnPan: posts the ante 70
LaBori85: posts the ante 70
JJin91: posts the ante 70
betgo: posts the ante 70
kidpokerUNO: posts the ante 70
Guvee: posts the ante 70
bighand18: posts the ante 70
kidpokerUNO: posts small blind 300
Guvee: posts big blind 600
*** HOLE CARDS ***
Dealt to JJin91 [Kh Jc]
bighand18: calls 600
hockingjoe: raises 1200 to 1800
MyManPotnPan: folds=20
LaBori85: folds=20
JJin91: folds=20
betgo: folds=20
kidpokerUNO: folds=20
Guvee: folds=20
bighand18: calls 1200
*** FLOP *** [Jd 7h 7d]
bighand18: checks=20
hockingjoe: bets 5000
bighand18: calls 5000
*** TURN *** [Jd 7h 7d] [5d]
bighand18: checks=20
hockingjoe: checks=20
*** RIVER *** [Jd 7h 7d 5d] [4d]
bighand18: bets 7200
hockingjoe: folds [Th Ts]
Uncalled bet (7200) returned to bighand18
bighand18 collected 15060 from pot
bighand18: doesn't show hand=20
*** SUMMARY ***
Total pot 15060 | Rake 0=20
Board [Jd 7h 7d 5d 4d]
Seat 1: hockingjoe folded on the River
Seat 2: MyManPotnPan folded before Flop (didn't bet)
Seat 3: LaBori85 folded before Flop (didn't bet)
Seat 5: JJin91 folded before Flop (didn't bet)
Seat 6: betgo (button) folded before Flop (didn't bet)
Seat 7: kidpokerUNO (small blind) folded before Flop
Seat 8: Guvee (big blind) folded before Flop
Seat 9: bighand18 collected (15060)


*********** # 71 **************
PokerStars Hand #170339769018: Tournament #1622573245, $4.55+$0.45 USD =
Hold'em No Limit - Level XII (300/600) - 2017/05/24 22:05:31 ET
Table '1622573245 8' 9-max Seat #7 is the button
Seat 1: hockingjoe (34200 in chips)=20
Seat 2: MyManPotnPan (32897 in chips)=20
Seat 3: LaBori85 (13590 in chips)=20
Seat 4: ReservoirK@ (20140 in chips)=20
Seat 5: JJin91 (20269 in chips)=20
Seat 6: betgo (8110 in chips)=20
Seat 7: kidpokerUNO (28650 in chips)=20
Seat 8: Guvee (15240 in chips)=20
Seat 9: bighand18 (28820 in chips)=20
hockingjoe: posts the ante 70
MyManPotnPan: posts the ante 70
LaBori85: posts the ante 70
ReservoirK@: posts the ante 70
JJin91: posts the ante 70
betgo: posts the ante 70
kidpokerUNO: posts the ante 70
Guvee: posts the ante 70
bighand18: posts the ante 70
Guvee: posts small blind 300
bighand18: posts big blind 600
*** HOLE CARDS ***
Dealt to JJin91 [4c Ac]
hockingjoe: folds=20
MyManPotnPan: folds=20
LaBori85: folds=20
ReservoirK@: folds=20
JJin91: raises 714 to 1314
betgo: folds=20
kidpokerUNO: calls 1314
Guvee: folds=20
bighand18: calls 714
*** FLOP *** [Ts 2d Qd]
bighand18: checks=20
JJin91: checks=20
kidpokerUNO: bets 2200
bighand18: calls 2200
JJin91: folds=20
*** TURN *** [Ts 2d Qd] [3d]
bighand18: checks=20
kidpokerUNO: checks=20
*** RIVER *** [Ts 2d Qd 3d] [8h]
bighand18: checks=20
kidpokerUNO: checks=20
*** SHOW DOWN ***
bighand18: shows [Jc Kc] (high card King)
kidpokerUNO: shows [7c As] (high card Ace)
kidpokerUNO collected 9272 from pot
*** SUMMARY ***
Total pot 9272 | Rake 0=20
Board [Ts 2d Qd 3d 8h]
Seat 1: hockingjoe folded before Flop (didn't bet)
Seat 2: MyManPotnPan folded before Flop (didn't bet)
Seat 3: LaBori85 folded before Flop (didn't bet)
Seat 4: ReservoirK@ folded before Flop (didn't bet)
Seat 5: JJin91 folded on the Flop
Seat 6: betgo folded before Flop (didn't bet)
Seat 7: kidpokerUNO (button) showed [7c As] and won (9272) with high ca=
rd Ace
Seat 8: Guvee (small blind) folded before Flop
Seat 9: bighand18 (big blind) showed [Jc Kc] and lost with high card Ki=
ng


*********** # 72 **************
PokerStars Hand #170339769259: Tournament #1622573245, $4.55+$0.45 USD =
Hold'em No Limit - Level XII (300/600) - 2017/05/24 22:06:27 ET
Table '1622573245 8' 9-max Seat #8 is the button
Seat 1: hockingjoe (34130 in chips)=20
Seat 2: MyManPotnPan (32827 in chips)=20
Seat 4: ReservoirK@ (20070 in chips)=20
Seat 5: JJin91 (18885 in chips)=20
Seat 6: betgo (8040 in chips)=20
Seat 7: kidpokerUNO (34338 in chips)=20
Seat 8: Guvee (14870 in chips)=20
Seat 9: bighand18 (25236 in chips)=20
hockingjoe: posts the ante 70
MyManPotnPan: posts the ante 70
ReservoirK@: posts the ante 70
JJin91: posts the ante 70
betgo: posts the ante 70
kidpokerUNO: posts the ante 70
Guvee: posts the ante 70
bighand18: posts the ante 70
bighand18: posts small blind 300
hockingjoe: posts big blind 600
*** HOLE CARDS ***
Dealt to JJin91 [8s 2s]
MyManPotnPan: raises 1200 to 1800
ReservoirK@: folds=20
JJin91: folds=20
kidpokerUNO is disconnected=20
betgo: folds=20
kidpokerUNO has timed out while disconnected
kidpokerUNO: folds=20
kidpokerUNO is sitting out
Guvee: folds=20
bighand18: folds=20
hockingjoe: folds=20
Uncalled bet (1200) returned to MyManPotnPan
MyManPotnPan collected 2060 from pot
MyManPotnPan: doesn't show hand=20
*** SUMMARY ***
Total pot 2060 | Rake 0=20
Seat 1: hockingjoe (big blind) folded before Flop
Seat 2: MyManPotnPan collected (2060)
Seat 4: ReservoirK@ folded before Flop (didn't bet)
Seat 5: JJin91 folded before Flop (didn't bet)
Seat 6: betgo folded before Flop (didn't bet)
Seat 7: kidpokerUNO folded before Flop (didn't bet)
Seat 8: Guvee (button) folded before Flop (didn't bet)
Seat 9: bighand18 (small blind) folded before Flop


*********** # 73 **************
PokerStars Hand #170339769538: Tournament #1622573245, $4.55+$0.45 USD =
Hold'em No Limit - Level XIII (350/700) - 2017/05/24 22:07:33 ET
Table '1622573245 8' 9-max Seat #9 is the button
Seat 1: hockingjoe (33460 in chips)=20
Seat 2: MyManPotnPan (34217 in chips)=20
Seat 4: ReservoirK@ (20000 in chips)=20
Seat 5: JJin91 (18815 in chips)=20
Seat 6: betgo (7970 in chips)=20
Seat 7: kidpokerUNO (34268 in chips) is sitting out
Seat 8: Guvee (14800 in chips)=20
Seat 9: bighand18 (24866 in chips)=20
hockingjoe: posts the ante 85
MyManPotnPan: posts the ante 85
ReservoirK@: posts the ante 85
JJin91: posts the ante 85
betgo: posts the ante 85
kidpokerUNO: posts the ante 85
Guvee: posts the ante 85
bighand18: posts the ante 85
hockingjoe: posts small blind 350
MyManPotnPan: posts big blind 700
*** HOLE CARDS ***
Dealt to JJin91 [9h 2h]
ReservoirK@: folds=20
JJin91: folds=20
betgo: folds=20
kidpokerUNO: folds=20
Guvee: calls 700
bighand18: folds=20
hockingjoe: calls 350
MyManPotnPan: checks=20
*** FLOP *** [4h 7c As]
hockingjoe: checks=20
MyManPotnPan: checks=20
Guvee: bets 1390
hockingjoe: folds=20
MyManPotnPan: folds=20
Uncalled bet (1390) returned to Guvee
Guvee collected 2780 from pot
Guvee: doesn't show hand=20
*** SUMMARY ***
Total pot 2780 | Rake 0=20
Board [4h 7c As]
Seat 1: hockingjoe (small blind) folded on the Flop
Seat 2: MyManPotnPan (big blind) folded on the Flop
Seat 4: ReservoirK@ folded before Flop (didn't bet)
Seat 5: JJin91 folded before Flop (didn't bet)
Seat 6: betgo folded before Flop (didn't bet)
Seat 7: kidpokerUNO folded before Flop (didn't bet)
Seat 8: Guvee collected (2780)
Seat 9: bighand18 (button) folded before Flop (didn't bet)


*********** # 74 **************
PokerStars Hand #170339769725: Tournament #1622573245, $4.55+$0.45 USD =
Hold'em No Limit - Level XIII (350/700) - 2017/05/24 22:08:18 ET
Table '1622573245 8' 9-max Seat #1 is the button
Seat 1: hockingjoe (32675 in chips)=20
Seat 2: MyManPotnPan (33432 in chips)=20
Seat 3: TrademarkTer (8545 in chips)=20
Seat 4: ReservoirK@ (19915 in chips)=20
Seat 5: JJin91 (18730 in chips)=20
Seat 6: betgo (7885 in chips)=20
Seat 7: kidpokerUNO (34183 in chips) is sitting out
Seat 8: Guvee (16795 in chips)=20
Seat 9: bighand18 (24781 in chips)=20
hockingjoe: posts the ante 85
MyManPotnPan: posts the ante 85
TrademarkTer: posts the ante 85
ReservoirK@: posts the ante 85
JJin91: posts the ante 85
betgo: posts the ante 85
kidpokerUNO: posts the ante 85
Guvee: posts the ante 85
bighand18: posts the ante 85
MyManPotnPan: posts small blind 350
TrademarkTer: posts big blind 700
*** HOLE CARDS ***
Dealt to JJin91 [6d 7c]
ReservoirK@: raises 1131 to 1831
JJin91: folds=20
betgo: folds=20
kidpokerUNO: folds=20
Guvee: folds=20
bighand18: folds=20
hockingjoe: folds=20
MyManPotnPan: folds=20
TrademarkTer said, "all you can eat!!!!"
TrademarkTer: raises 6629 to 8460 and is all-in
ReservoirK@: calls 6629
*** FLOP *** [Jd As 8h]
*** TURN *** [Jd As 8h] [Jh]
*** RIVER *** [Jd As 8h Jh] [9d]
*** SHOW DOWN ***
TrademarkTer: shows [Ks Ah] (two pair, Aces and Jacks)
ReservoirK@: shows [Qh Ac] (two pair, Aces and Jacks - lower kicker)
TrademarkTer collected 18035 from pot
*** SUMMARY ***
Total pot 18035 | Rake 0=20
Board [Jd As 8h Jh 9d]
Seat 1: hockingjoe (button) folded before Flop (didn't bet)
Seat 2: MyManPotnPan (small blind) folded before Flop
Seat 3: TrademarkTer (big blind) showed [Ks Ah] and won (18035) with tw=
o pair, Aces and Jacks
Seat 4: ReservoirK@ showed [Qh Ac] and lost with two pair, Aces and Jac=
ks
Seat 5: JJin91 folded before Flop (didn't bet)
Seat 6: betgo folded before Flop (didn't bet)
Seat 7: kidpokerUNO folded before Flop (didn't bet)
Seat 8: Guvee folded before Flop (didn't bet)
Seat 9: bighand18 folded before Flop (didn't bet)


*********** # 75 **************
PokerStars Hand #170339769945: Tournament #1622573245, $4.55+$0.45 USD =
Hold'em No Limit - Level XIII (350/700) - 2017/05/24 22:09:11 ET
Table '1622573245 8' 9-max Seat #2 is the button
Seat 1: hockingjoe (32590 in chips)=20
Seat 2: MyManPotnPan (32997 in chips)=20
Seat 3: TrademarkTer (18035 in chips)=20
Seat 4: ReservoirK@ (11370 in chips)=20
Seat 5: JJin91 (18645 in chips)=20
Seat 6: betgo (7800 in chips)=20
Seat 7: kidpokerUNO (34098 in chips) is sitting out
Seat 8: Guvee (16710 in chips)=20
Seat 9: bighand18 (24696 in chips)=20
hockingjoe: posts the ante 85
MyManPotnPan: posts the ante 85
TrademarkTer: posts the ante 85
ReservoirK@: posts the ante 85
JJin91: posts the ante 85
betgo: posts the ante 85
kidpokerUNO: posts the ante 85
Guvee: posts the ante 85
bighand18: posts the ante 85
TrademarkTer: posts small blind 350
ReservoirK@: posts big blind 700
*** HOLE CARDS ***
Dealt to JJin91 [6d Td]
JJin91: folds=20
betgo: folds=20
kidpokerUNO: folds=20
Guvee: folds=20
bighand18: calls 700
hockingjoe: folds=20
MyManPotnPan: raises 1400 to 2100
TrademarkTer: calls 1750
ReservoirK@: folds=20
bighand18: folds=20
*** FLOP *** [Jh 2c Ts]
TrademarkTer: checks=20
MyManPotnPan: checks=20
*** TURN *** [Jh 2c Ts] [4s]
TrademarkTer: checks=20
MyManPotnPan: checks=20
*** RIVER *** [Jh 2c Ts 4s] [Ks]
TrademarkTer: checks=20
MyManPotnPan: bets 2800
TrademarkTer: folds=20
Uncalled bet (2800) returned to MyManPotnPan
MyManPotnPan collected 6365 from pot
MyManPotnPan: doesn't show hand=20
*** SUMMARY ***
Total pot 6365 | Rake 0=20
Board [Jh 2c Ts 4s Ks]
Seat 1: hockingjoe folded before Flop (didn't bet)
Seat 2: MyManPotnPan (button) collected (6365)
Seat 3: TrademarkTer (small blind) folded on the River
Seat 4: ReservoirK@ (big blind) folded before Flop
Seat 5: JJin91 folded before Flop (didn't bet)
Seat 6: betgo folded before Flop (didn't bet)
Seat 7: kidpokerUNO folded before Flop (didn't bet)
Seat 8: Guvee folded before Flop (didn't bet)
Seat 9: bighand18 folded before Flop


*********** # 76 **************
PokerStars Hand #170340689509: Tournament #1622573245, $4.55+$0.45 USD =
Hold'em No Limit - Level XIII (350/700) - 2017/05/24 22:09:51 ET
Table '1622573245 8' 9-max Seat #3 is the button
Seat 1: hockingjoe (32505 in chips)=20
Seat 2: MyManPotnPan (37177 in chips)=20
Seat 3: TrademarkTer (15850 in chips)=20
Seat 4: ReservoirK@ (10585 in chips)=20
Seat 5: JJin91 (18560 in chips)=20
Seat 6: betgo (7715 in chips)=20
Seat 7: kidpokerUNO (34013 in chips) is sitting out
Seat 8: Guvee (16625 in chips)=20
Seat 9: bighand18 (23911 in chips)=20
hockingjoe: posts the ante 85
MyManPotnPan: posts the ante 85
TrademarkTer: posts the ante 85
ReservoirK@: posts the ante 85
JJin91: posts the ante 85
betgo: posts the ante 85
kidpokerUNO: posts the ante 85
Guvee: posts the ante 85
bighand18: posts the ante 85
ReservoirK@: posts small blind 350
JJin91: posts big blind 700
*** HOLE CARDS ***
Dealt to JJin91 [9c Kc]
betgo: folds=20
kidpokerUNO: folds=20
Guvee: folds=20
bighand18: folds=20
hockingjoe: folds=20
MyManPotnPan: raises 1400 to 2100
TrademarkTer: calls 2100
ReservoirK@: calls 1750
JJin91: calls 1400
*** FLOP *** [3c Qc Ac]
ReservoirK@: checks=20
JJin91: checks=20
MyManPotnPan: checks=20
TrademarkTer: bets 3500
ReservoirK@: folds=20
JJin91: calls 3500
MyManPotnPan: folds=20
*** TURN *** [3c Qc Ac] [6h]
JJin91: checks=20
TrademarkTer: bets 10165 and is all-in
JJin91: calls 10165
*** RIVER *** [3c Qc Ac 6h] [3d]
*** SHOW DOWN ***
JJin91: shows [9c Kc] (a flush, Ace high)
TrademarkTer: shows [Ad 9d] (two pair, Aces and Threes)
JJin91 collected 36495 from pot
TrademarkTer finished the tournament in 49th place
*** SUMMARY ***
Total pot 36495 | Rake 0=20
Board [3c Qc Ac 6h 3d]
Seat 1: hockingjoe folded before Flop (didn't bet)
Seat 2: MyManPotnPan folded on the Flop
Seat 3: TrademarkTer (button) showed [Ad 9d] and lost with two pair, Ac=
es and Threes
Seat 4: ReservoirK@ (small blind) folded on the Flop
Seat 5: JJin91 (big blind) showed [9c Kc] and won (36495) with a flush,=
 Ace high
Seat 6: betgo folded before Flop (didn't bet)
Seat 7: kidpokerUNO folded before Flop (didn't bet)
Seat 8: Guvee folded before Flop (didn't bet)
Seat 9: bighand18 folded before Flop (didn't bet)


*********** # 77 **************
PokerStars Hand #170340689768: Tournament #1622573245, $4.55+$0.45 USD =
Hold'em No Limit - Level XIII (350/700) - 2017/05/24 22:10:55 ET
Table '1622573245 8' 9-max Seat #4 is the button
Seat 1: hockingjoe (32420 in chips)=20
Seat 2: MyManPotnPan (34992 in chips)=20
Seat 4: ReservoirK@ (8400 in chips)=20
Seat 5: JJin91 (39205 in chips)=20
Seat 6: betgo (7630 in chips)=20
Seat 7: kidpokerUNO (33928 in chips) is sitting out
Seat 8: Guvee (16540 in chips)=20
Seat 9: bighand18 (23826 in chips)=20
hockingjoe: posts the ante 85
MyManPotnPan: posts the ante 85
ReservoirK@: posts the ante 85
JJin91: posts the ante 85
betgo: posts the ante 85
kidpokerUNO: posts the ante 85
Guvee: posts the ante 85
bighand18: posts the ante 85
JJin91: posts small blind 350
betgo: posts big blind 700
*** HOLE CARDS ***
Dealt to JJin91 [Jc 8s]
kidpokerUNO: folds=20
Guvee: folds=20
bighand18: raises 700 to 1400
hockingjoe: folds=20
kidpokerUNO has returned
MyManPotnPan: calls 1400
ReservoirK@: raises 6915 to 8315 and is all-in
JJin91: folds=20
betgo: folds=20
bighand18: raises 15426 to 23741 and is all-in
MyManPotnPan: folds=20
Uncalled bet (15426) returned to bighand18
*** FLOP *** [7d Ks 2h]
*** TURN *** [7d Ks 2h] [9s]
*** RIVER *** [7d Ks 2h 9s] [Qc]
*** SHOW DOWN ***
bighand18: shows [Ad Kh] (a pair of Kings)
ReservoirK@: shows [4d 4h] (a pair of Fours)
bighand18 collected 19760 from pot
ReservoirK@ finished the tournament in 48th place
*** SUMMARY ***
Total pot 19760 | Rake 0=20
Board [7d Ks 2h 9s Qc]
Seat 1: hockingjoe folded before Flop (didn't bet)
Seat 2: MyManPotnPan folded before Flop
Seat 4: ReservoirK@ (button) showed [4d 4h] and lost with a pair of Fou=
rs
Seat 5: JJin91 (small blind) folded before Flop
Seat 6: betgo (big blind) folded before Flop
Seat 7: kidpokerUNO folded before Flop (didn't bet)
Seat 8: Guvee folded before Flop (didn't bet)
Seat 9: bighand18 showed [Ad Kh] and won (19760) with a pair of Kings


*********** # 78 **************
PokerStars Hand #170340689913: Tournament #1622573245, $4.55+$0.45 USD =
Hold'em No Limit - Level XIII (350/700) - 2017/05/24 22:11:27 ET
Table '1622573245 8' 9-max Seat #5 is the button
Seat 1: hockingjoe (32335 in chips)=20
Seat 2: MyManPotnPan (33507 in chips)=20
Seat 5: JJin91 (38770 in chips)=20
Seat 6: betgo (6845 in chips)=20
Seat 7: kidpokerUNO (33843 in chips)=20
Seat 8: Guvee (16455 in chips)=20
Seat 9: bighand18 (35186 in chips)=20
hockingjoe: posts the ante 85
MyManPotnPan: posts the ante 85
JJin91: posts the ante 85
betgo: posts the ante 85
kidpokerUNO: posts the ante 85
Guvee: posts the ante 85
bighand18: posts the ante 85
betgo: posts small blind 350
kidpokerUNO: posts big blind 700
*** HOLE CARDS ***
Dealt to JJin91 [6s Ts]
Guvee: folds=20
bighand18: folds=20
hockingjoe: folds=20
MyManPotnPan: folds=20
JJin91: folds=20
betgo: raises 6060 to 6760 and is all-in
kidpokerUNO: folds=20
Uncalled bet (6060) returned to betgo
betgo collected 1995 from pot
betgo: doesn't show hand=20
*** SUMMARY ***
Total pot 1995 | Rake 0=20
Seat 1: hockingjoe folded before Flop (didn't bet)
Seat 2: MyManPotnPan folded before Flop (didn't bet)
Seat 5: JJin91 (button) folded before Flop (didn't bet)
Seat 6: betgo (small blind) collected (1995)
Seat 7: kidpokerUNO (big blind) folded before Flop
Seat 8: Guvee folded before Flop (didn't bet)
Seat 9: bighand18 folded before Flop (didn't bet)


*********** # 79 **************
PokerStars Hand #170340739909: Tournament #1622573245, $4.55+$0.45 USD =
Hold'em No Limit - Level XIV (400/800) - 2017/05/24 22:11:53 ET
Table '1622573245 8' 9-max Seat #6 is the button
Seat 1: hockingjoe (32250 in chips)=20
Seat 2: MyManPotnPan (33422 in chips)=20
Seat 5: JJin91 (38685 in chips)=20
Seat 6: betgo (8055 in chips)=20
Seat 7: kidpokerUNO (33058 in chips)=20
Seat 8: Guvee (16370 in chips)=20
Seat 9: bighand18 (35101 in chips)=20
hockingjoe: posts the ante 100
MyManPotnPan: posts the ante 100
JJin91: posts the ante 100
betgo: posts the ante 100
kidpokerUNO: posts the ante 100
Guvee: posts the ante 100
bighand18: posts the ante 100
kidpokerUNO: posts small blind 400
Guvee: posts big blind 800
*** HOLE CARDS ***
Dealt to JJin91 [Ac 4s]
bighand18: folds=20
hockingjoe: folds=20
MyManPotnPan: folds=20
JJin91: raises 952 to 1752
betgo: folds=20
kidpokerUNO: folds=20
Guvee: folds=20
Uncalled bet (952) returned to JJin91
JJin91 collected 2700 from pot
JJin91: doesn't show hand=20
*** SUMMARY ***
Total pot 2700 | Rake 0=20
Seat 1: hockingjoe folded before Flop (didn't bet)
Seat 2: MyManPotnPan folded before Flop (didn't bet)
Seat 5: JJin91 collected (2700)
Seat 6: betgo (button) folded before Flop (didn't bet)
Seat 7: kidpokerUNO (small blind) folded before Flop
Seat 8: Guvee (big blind) folded before Flop
Seat 9: bighand18 folded before Flop (didn't bet)


*********** # 80 **************
PokerStars Hand #170340748514: Tournament #1622573245, $4.55+$0.45 USD =
Hold'em No Limit - Level XIV (400/800) - 2017/05/24 22:12:19 ET
Table '1622573245 8' 9-max Seat #7 is the button
Seat 1: hockingjoe (32150 in chips)=20
Seat 2: MyManPotnPan (33322 in chips)=20
Seat 5: JJin91 (40485 in chips)=20
Seat 6: betgo (7955 in chips)=20
Seat 7: kidpokerUNO (32558 in chips)=20
Seat 8: Guvee (15470 in chips)=20
Seat 9: bighand18 (35001 in chips)=20
hockingjoe: posts the ante 100
MyManPotnPan: posts the ante 100
JJin91: posts the ante 100
betgo: posts the ante 100
kidpokerUNO: posts the ante 100
Guvee: posts the ante 100
bighand18: posts the ante 100
Guvee: posts small blind 400
bighand18: posts big blind 800
*** HOLE CARDS ***
Dealt to JJin91 [2h Td]
hockingjoe: raises 800 to 1600
MyManPotnPan: folds=20
JJin91: folds=20
betgo: folds=20
kidpokerUNO: folds=20
Guvee: calls 1200
bighand18: folds=20
*** FLOP *** [9c 5d Jh]
Guvee: checks=20
hockingjoe: checks=20
*** TURN *** [9c 5d Jh] [7s]
Guvee: checks=20
hockingjoe: checks=20
*** RIVER *** [9c 5d Jh 7s] [8h]
Guvee: checks=20
hockingjoe: bets 1600
Guvee: folds=20
Uncalled bet (1600) returned to hockingjoe
hockingjoe collected 4700 from pot
hockingjoe: doesn't show hand=20
*** SUMMARY ***
Total pot 4700 | Rake 0=20
Board [9c 5d Jh 7s 8h]
Seat 1: hockingjoe collected (4700)
Seat 2: MyManPotnPan folded before Flop (didn't bet)
Seat 5: JJin91 folded before Flop (didn't bet)
Seat 6: betgo folded before Flop (didn't bet)
Seat 7: kidpokerUNO (button) folded before Flop (didn't bet)
Seat 8: Guvee (small blind) folded on the River
Seat 9: bighand18 (big blind) folded before Flop


*********** # 81 **************
PokerStars Hand #170340748743: Tournament #1622573245, $4.55+$0.45 USD =
Hold'em No Limit - Level XIV (400/800) - 2017/05/24 22:13:14 ET
Table '1622573245 8' 9-max Seat #8 is the button
Seat 1: hockingjoe (35150 in chips)=20
Seat 2: MyManPotnPan (33222 in chips)=20
Seat 5: JJin91 (40385 in chips)=20
Seat 6: betgo (7855 in chips)=20
Seat 7: kidpokerUNO (32458 in chips)=20
Seat 8: Guvee (13770 in chips)=20
Seat 9: bighand18 (34101 in chips)=20
hockingjoe: posts the ante 100
MyManPotnPan: posts the ante 100
JJin91: posts the ante 100
betgo: posts the ante 100
kidpokerUNO: posts the ante 100
Guvee: posts the ante 100
bighand18: posts the ante 100
bighand18: posts small blind 400
hockingjoe: posts big blind 800
*** HOLE CARDS ***
Dealt to JJin91 [As Tc]
MyManPotnPan: folds=20
JJin91: raises 952 to 1752
betgo: folds=20
kidpokerUNO: folds=20
Guvee: folds=20
bighand18: folds=20
hockingjoe: folds=20
Uncalled bet (952) returned to JJin91
JJin91 collected 2700 from pot
JJin91: doesn't show hand=20
*** SUMMARY ***
Total pot 2700 | Rake 0=20
Seat 1: hockingjoe (big blind) folded before Flop
Seat 2: MyManPotnPan folded before Flop (didn't bet)
Seat 5: JJin91 collected (2700)
Seat 6: betgo folded before Flop (didn't bet)
Seat 7: kidpokerUNO folded before Flop (didn't bet)
Seat 8: Guvee (button) folded before Flop (didn't bet)
Seat 9: bighand18 (small blind) folded before Flop


*********** # 82 **************
PokerStars Hand #170340748845: Tournament #1622573245, $4.55+$0.45 USD =
Hold'em No Limit - Level XIV (400/800) - 2017/05/24 22:13:37 ET
Table '1622573245 8' 9-max Seat #9 is the button
Seat 1: hockingjoe (34250 in chips)=20
Seat 2: MyManPotnPan (33122 in chips)=20
Seat 5: JJin91 (42185 in chips)=20
Seat 6: betgo (7755 in chips)=20
Seat 7: kidpokerUNO (32358 in chips)=20
Seat 8: Guvee (13670 in chips)=20
Seat 9: bighand18 (33601 in chips)=20
hockingjoe: posts the ante 100
MyManPotnPan: posts the ante 100
JJin91: posts the ante 100
betgo: posts the ante 100
kidpokerUNO: posts the ante 100
Guvee: posts the ante 100
bighand18: posts the ante 100
hockingjoe: posts small blind 400
MyManPotnPan: posts big blind 800
*** HOLE CARDS ***
Dealt to JJin91 [8h 5d]
JJin91: folds=20
betgo: folds=20
kidpokerUNO: folds=20
Guvee: folds=20
bighand18: calls 800
hockingjoe: folds=20
MyManPotnPan: checks=20
*** FLOP *** [6d Qs Ad]
MyManPotnPan: checks=20
bighand18: bets 2400
MyManPotnPan: folds=20
Uncalled bet (2400) returned to bighand18
bighand18 collected 2700 from pot
bighand18: doesn't show hand=20
*** SUMMARY ***
Total pot 2700 | Rake 0=20
Board [6d Qs Ad]
Seat 1: hockingjoe (small blind) folded before Flop
Seat 2: MyManPotnPan (big blind) folded on the Flop
Seat 5: JJin91 folded before Flop (didn't bet)
Seat 6: betgo folded before Flop (didn't bet)
Seat 7: kidpokerUNO folded before Flop (didn't bet)
Seat 8: Guvee folded before Flop (didn't bet)
Seat 9: bighand18 (button) collected (2700)


*********** # 83 **************
PokerStars Hand #170340748998: Tournament #1622573245, $4.55+$0.45 USD =
Hold'em No Limit - Level XIV (400/800) - 2017/05/24 22:14:09 ET
Table '1622573245 8' 9-max Seat #1 is the button
Seat 1: hockingjoe (33750 in chips)=20
Seat 2: MyManPotnPan (32222 in chips)=20
Seat 3: FizzEdJohn (28207 in chips)=20
Seat 4: audwhwh1 (17440 in chips)=20
Seat 5: JJin91 (42085 in chips)=20
Seat 6: betgo (7655 in chips)=20
Seat 7: kidpokerUNO (32258 in chips)=20
Seat 8: Guvee (13570 in chips)=20
Seat 9: bighand18 (35401 in chips)=20
hockingjoe: posts the ante 100
MyManPotnPan: posts the ante 100
FizzEdJohn: posts the ante 100
audwhwh1: posts the ante 100
JJin91: posts the ante 100
betgo: posts the ante 100
kidpokerUNO: posts the ante 100
Guvee: posts the ante 100
bighand18: posts the ante 100
MyManPotnPan: posts small blind 400
FizzEdJohn: posts big blind 800
*** HOLE CARDS ***
Dealt to JJin91 [7d 6h]
audwhwh1: folds=20
JJin91: folds=20
betgo: folds=20
kidpokerUNO: folds=20
Guvee: folds=20
bighand18: folds=20
hockingjoe: raises 1600 to 2400
MyManPotnPan: folds=20
FizzEdJohn: folds=20
Uncalled bet (1600) returned to hockingjoe
hockingjoe collected 2900 from pot
hockingjoe: doesn't show hand=20
*** SUMMARY ***
Total pot 2900 | Rake 0=20
Seat 1: hockingjoe (button) collected (2900)
Seat 2: MyManPotnPan (small blind) folded before Flop
Seat 3: FizzEdJohn (big blind) folded before Flop
Seat 4: audwhwh1 folded before Flop (didn't bet)
Seat 5: JJin91 folded before Flop (didn't bet)
Seat 6: betgo folded before Flop (didn't bet)
Seat 7: kidpokerUNO folded before Flop (didn't bet)
Seat 8: Guvee folded before Flop (didn't bet)
Seat 9: bighand18 folded before Flop (didn't bet)


*********** # 84 **************
PokerStars Hand #170340749086: Tournament #1622573245, $4.55+$0.45 USD =
Hold'em No Limit - Level XIV (400/800) - 2017/05/24 22:14:31 ET
Table '1622573245 8' 9-max Seat #2 is the button
Seat 1: hockingjoe (35750 in chips)=20
Seat 2: MyManPotnPan (31722 in chips)=20
Seat 3: FizzEdJohn (27307 in chips)=20
Seat 4: audwhwh1 (17340 in chips)=20
Seat 5: JJin91 (41985 in chips)=20
Seat 6: betgo (7555 in chips)=20
Seat 7: kidpokerUNO (32158 in chips)=20
Seat 8: Guvee (13470 in chips)=20
Seat 9: bighand18 (35301 in chips)=20
hockingjoe: posts the ante 100
MyManPotnPan: posts the ante 100
FizzEdJohn: posts the ante 100
audwhwh1: posts the ante 100
JJin91: posts the ante 100
betgo: posts the ante 100
kidpokerUNO: posts the ante 100
Guvee: posts the ante 100
bighand18: posts the ante 100
FizzEdJohn: posts small blind 400
audwhwh1: posts big blind 800
*** HOLE CARDS ***
Dealt to JJin91 [5c Qs]
JJin91: folds=20
betgo: folds=20
kidpokerUNO: folds=20
Guvee: folds=20
bighand18: folds=20
hockingjoe: folds=20
MyManPotnPan: folds=20
FizzEdJohn: calls 400
audwhwh1: checks=20
*** FLOP *** [Ad 2h 5s]
FizzEdJohn: checks=20
audwhwh1: checks=20
*** TURN *** [Ad 2h 5s] [Js]
FizzEdJohn: bets 1000
audwhwh1: folds=20
Uncalled bet (1000) returned to FizzEdJohn
FizzEdJohn collected 2500 from pot
FizzEdJohn: doesn't show hand=20
*** SUMMARY ***
Total pot 2500 | Rake 0=20
Board [Ad 2h 5s Js]
Seat 1: hockingjoe folded before Flop (didn't bet)
Seat 2: MyManPotnPan (button) folded before Flop (didn't bet)
Seat 3: FizzEdJohn (small blind) collected (2500)
Seat 4: audwhwh1 (big blind) folded on the Turn
Seat 5: JJin91 folded before Flop (didn't bet)
Seat 6: betgo folded before Flop (didn't bet)
Seat 7: kidpokerUNO folded before Flop (didn't bet)
Seat 8: Guvee folded before Flop (didn't bet)
Seat 9: bighand18 folded before Flop (didn't bet)


*********** # 85 **************
PokerStars Hand #170340749258: Tournament #1622573245, $4.55+$0.45 USD =
Hold'em No Limit - Level XIV (400/800) - 2017/05/24 22:15:13 ET
Table '1622573245 8' 9-max Seat #3 is the button
Seat 1: hockingjoe (35650 in chips)=20
Seat 2: MyManPotnPan (31622 in chips)=20
Seat 3: FizzEdJohn (28907 in chips)=20
Seat 4: audwhwh1 (16440 in chips)=20
Seat 5: JJin91 (41885 in chips)=20
Seat 6: betgo (7455 in chips)=20
Seat 7: kidpokerUNO (32058 in chips)=20
Seat 8: Guvee (13370 in chips)=20
Seat 9: bighand18 (35201 in chips)=20
hockingjoe: posts the ante 100
MyManPotnPan: posts the ante 100
FizzEdJohn: posts the ante 100
audwhwh1: posts the ante 100
JJin91: posts the ante 100
betgo: posts the ante 100
kidpokerUNO: posts the ante 100
Guvee: posts the ante 100
bighand18: posts the ante 100
audwhwh1: posts small blind 400
JJin91: posts big blind 800
*** HOLE CARDS ***
Dealt to JJin91 [8h 6d]
betgo: folds=20
kidpokerUNO: folds=20
Guvee: folds=20
bighand18: raises 800 to 1600
hockingjoe: folds=20
MyManPotnPan: folds=20
FizzEdJohn: folds=20
audwhwh1: calls 1200
JJin91: calls 800
*** FLOP *** [5h 7s Ah]
audwhwh1: checks=20
JJin91: checks=20
bighand18: bets 2400
betgo is sitting out
audwhwh1: raises 2400 to 4800
JJin91: folds=20
bighand18: folds=20
Uncalled bet (2400) returned to audwhwh1
audwhwh1 collected 10500 from pot
audwhwh1: doesn't show hand=20
*** SUMMARY ***
Total pot 10500 | Rake 0=20
Board [5h 7s Ah]
Seat 1: hockingjoe folded before Flop (didn't bet)
Seat 2: MyManPotnPan folded before Flop (didn't bet)
Seat 3: FizzEdJohn (button) folded before Flop (didn't bet)
Seat 4: audwhwh1 (small blind) collected (10500)
Seat 5: JJin91 (big blind) folded on the Flop
Seat 6: betgo folded before Flop (didn't bet)
Seat 7: kidpokerUNO folded before Flop (didn't bet)
Seat 8: Guvee folded before Flop (didn't bet)
Seat 9: bighand18 folded on the Flop


*********** # 86 **************
PokerStars Hand #170340749590: Tournament #1622573245, $4.55+$0.45 USD =
Hold'em No Limit - Level XIV (400/800) - 2017/05/24 22:16:29 ET
Table '1622573245 8' 9-max Seat #4 is the button
Seat 1: hockingjoe (35550 in chips)=20
Seat 2: MyManPotnPan (31522 in chips)=20
Seat 3: FizzEdJohn (28807 in chips)=20
Seat 4: audwhwh1 (22840 in chips)=20
Seat 5: JJin91 (40185 in chips)=20
Seat 6: betgo (7355 in chips) is sitting out
Seat 7: kidpokerUNO (31958 in chips)=20
Seat 8: Guvee (13270 in chips)=20
Seat 9: bighand18 (31101 in chips)=20
hockingjoe: posts the ante 100
MyManPotnPan: posts the ante 100
FizzEdJohn: posts the ante 100
audwhwh1: posts the ante 100
JJin91: posts the ante 100
betgo: posts the ante 100
kidpokerUNO: posts the ante 100
Guvee: posts the ante 100
bighand18: posts the ante 100
JJin91: posts small blind 400
betgo: posts big blind 800
*** HOLE CARDS ***
Dealt to JJin91 [7d 8d]
kidpokerUNO: folds=20
Guvee: folds=20
bighand18: folds=20
hockingjoe: calls 800
MyManPotnPan: folds=20
FizzEdJohn: folds=20
audwhwh1: calls 800
JJin91: calls 400
betgo: folds=20
*** FLOP *** [4s Jd Jh]
JJin91: checks=20
hockingjoe: checks=20
audwhwh1: checks=20
*** TURN *** [4s Jd Jh] [5h]
JJin91: checks=20
hockingjoe: checks=20
audwhwh1: checks=20
*** RIVER *** [4s Jd Jh 5h] [Jc]
JJin91: checks=20
hockingjoe: checks=20
audwhwh1: checks=20
*** SHOW DOWN ***
JJin91: shows [7d 8d] (three of a kind, Jacks)
hockingjoe: shows [Tc Kc] (three of a kind, Jacks - King kicker)
audwhwh1: mucks hand=20
hockingjoe collected 4100 from pot
*** SUMMARY ***
Total pot 4100 | Rake 0=20
Board [4s Jd Jh 5h Jc]
Seat 1: hockingjoe showed [Tc Kc] and won (4100) with three of a kind, =
Jacks
Seat 2: MyManPotnPan folded before Flop (didn't bet)
Seat 3: FizzEdJohn folded before Flop (didn't bet)
Seat 4: audwhwh1 (button) mucked [Ts 9c]
Seat 5: JJin91 (small blind) showed [7d 8d] and lost with three of a ki=
nd, Jacks
Seat 6: betgo (big blind) folded before Flop
Seat 7: kidpokerUNO folded before Flop (didn't bet)
Seat 8: Guvee folded before Flop (didn't bet)
Seat 9: bighand18 folded before Flop (didn't bet)


*********** # 87 **************
PokerStars Hand #170340749867: Tournament #1622573245, $4.55+$0.45 USD =
Hold'em No Limit - Level XV (500/1000) - 2017/05/24 22:17:32 ET
Table '1622573245 8' 9-max Seat #5 is the button
Seat 1: hockingjoe (38750 in chips)=20
Seat 2: MyManPotnPan (31422 in chips)=20
Seat 3: FizzEdJohn (28707 in chips)=20
Seat 4: audwhwh1 (21940 in chips)=20
Seat 5: JJin91 (39285 in chips)=20
Seat 6: betgo (6455 in chips) is sitting out
Seat 7: kidpokerUNO (31858 in chips)=20
Seat 9: bighand18 (31001 in chips)=20
hockingjoe: posts the ante 125
MyManPotnPan: posts the ante 125
FizzEdJohn: posts the ante 125
audwhwh1: posts the ante 125
JJin91: posts the ante 125
betgo: posts the ante 125
kidpokerUNO: posts the ante 125
bighand18: posts the ante 125
betgo: posts small blind 500
kidpokerUNO: posts big blind 1000
*** HOLE CARDS ***
Dealt to JJin91 [9h Ks]
bighand18: folds=20
hockingjoe: raises 2000 to 3000
MyManPotnPan: folds=20
FizzEdJohn: folds=20
audwhwh1: folds=20
JJin91: folds=20
betgo: folds=20
kidpokerUNO: folds=20
Uncalled bet (2000) returned to hockingjoe
hockingjoe collected 3500 from pot
hockingjoe: doesn't show hand=20
*** SUMMARY ***
Total pot 3500 | Rake 0=20
Seat 1: hockingjoe collected (3500)
Seat 2: MyManPotnPan folded before Flop (didn't bet)
Seat 3: FizzEdJohn folded before Flop (didn't bet)
Seat 4: audwhwh1 folded before Flop (didn't bet)
Seat 5: JJin91 (button) folded before Flop (didn't bet)
Seat 6: betgo (small blind) folded before Flop
Seat 7: kidpokerUNO (big blind) folded before Flop
Seat 9: bighand18 folded before Flop (didn't bet)


*********** # 88 **************
PokerStars Hand #170340879709: Tournament #1622573245, $4.55+$0.45 USD =
Hold'em No Limit - Level XV (500/1000) - 2017/05/24 22:18:02 ET
Table '1622573245 8' 9-max Seat #6 is the button
Seat 1: hockingjoe (41125 in chips)=20
Seat 2: MyManPotnPan (31297 in chips)=20
Seat 3: FizzEdJohn (28582 in chips)=20
Seat 4: audwhwh1 (21815 in chips)=20
Seat 5: JJin91 (39160 in chips)=20
Seat 6: betgo (5830 in chips) is sitting out
Seat 7: kidpokerUNO (30733 in chips)=20
Seat 9: bighand18 (30876 in chips)=20
hockingjoe: posts the ante 125
MyManPotnPan: posts the ante 125
FizzEdJohn: posts the ante 125
audwhwh1: posts the ante 125
JJin91: posts the ante 125
betgo: posts the ante 125
kidpokerUNO: posts the ante 125
bighand18: posts the ante 125
kidpokerUNO: posts small blind 500
bighand18: posts big blind 1000
*** HOLE CARDS ***
Dealt to JJin91 [8h Th]
hockingjoe: folds=20
MyManPotnPan: raises 2000 to 3000
FizzEdJohn: folds=20
audwhwh1: folds=20
JJin91: folds=20
betgo: folds=20
kidpokerUNO: folds=20
bighand18: folds=20
Uncalled bet (2000) returned to MyManPotnPan
MyManPotnPan collected 3500 from pot
MyManPotnPan: doesn't show hand=20
*** SUMMARY ***
Total pot 3500 | Rake 0=20
Seat 1: hockingjoe folded before Flop (didn't bet)
Seat 2: MyManPotnPan collected (3500)
Seat 3: FizzEdJohn folded before Flop (didn't bet)
Seat 4: audwhwh1 folded before Flop (didn't bet)
Seat 5: JJin91 folded before Flop (didn't bet)
Seat 6: betgo (button) folded before Flop (didn't bet)
Seat 7: kidpokerUNO (small blind) folded before Flop
Seat 9: bighand18 (big blind) folded before Flop


*********** # 89 **************
PokerStars Hand #170340879861: Tournament #1622573245, $4.55+$0.45 USD =
Hold'em No Limit - Level XV (500/1000) - 2017/05/24 22:18:33 ET
Table '1622573245 8' 9-max Seat #7 is the button
Seat 1: hockingjoe (41000 in chips)=20
Seat 2: MyManPotnPan (33672 in chips)=20
Seat 3: FizzEdJohn (28457 in chips)=20
Seat 4: audwhwh1 (21690 in chips)=20
Seat 5: JJin91 (39035 in chips)=20
Seat 6: betgo (5705 in chips) is sitting out
Seat 7: kidpokerUNO (30108 in chips)=20
Seat 9: bighand18 (29751 in chips)=20
hockingjoe: posts the ante 125
MyManPotnPan: posts the ante 125
FizzEdJohn: posts the ante 125
audwhwh1: posts the ante 125
JJin91: posts the ante 125
betgo: posts the ante 125
kidpokerUNO: posts the ante 125
bighand18: posts the ante 125
bighand18: posts small blind 500
hockingjoe: posts big blind 1000
*** HOLE CARDS ***
Dealt to JJin91 [9d 3s]
MyManPotnPan: folds=20
FizzEdJohn: folds=20
audwhwh1: calls 1000
JJin91: folds=20
betgo: folds=20
kidpokerUNO: folds=20
bighand18: calls 500
hockingjoe: checks=20
*** FLOP *** [Qd 5c Kd]
bighand18: bets 2000
hockingjoe: calls 2000
audwhwh1: folds=20
*** TURN *** [Qd 5c Kd] [7s]
bighand18: bets 3000
hockingjoe: calls 3000
*** RIVER *** [Qd 5c Kd 7s] [6c]
bighand18: checks=20
hockingjoe: checks=20
*** SHOW DOWN ***
bighand18: shows [8h Qs] (a pair of Queens)
hockingjoe: shows [Kc 9c] (a pair of Kings)
hockingjoe collected 14000 from pot
*** SUMMARY ***
Total pot 14000 | Rake 0=20
Board [Qd 5c Kd 7s 6c]
Seat 1: hockingjoe (big blind) showed [Kc 9c] and won (14000) with a pa=
ir of Kings
Seat 2: MyManPotnPan folded before Flop (didn't bet)
Seat 3: FizzEdJohn folded before Flop (didn't bet)
Seat 4: audwhwh1 folded on the Flop
Seat 5: JJin91 folded before Flop (didn't bet)
Seat 6: betgo folded before Flop (didn't bet)
Seat 7: kidpokerUNO (button) folded before Flop (didn't bet)
Seat 9: bighand18 (small blind) showed [8h Qs] and lost with a pair of =
Queens


*********** # 90 **************
PokerStars Hand #170340906491: Tournament #1622573245, $4.55+$0.45 USD =
Hold'em No Limit - Level XV (500/1000) - 2017/05/24 22:19:32 ET
Table '1622573245 8' 9-max Seat #9 is the button
Seat 1: hockingjoe (48875 in chips)=20
Seat 2: MyManPotnPan (33547 in chips)=20
Seat 3: FizzEdJohn (28332 in chips)=20
Seat 4: audwhwh1 (20565 in chips)=20
Seat 5: JJin91 (38910 in chips)=20
Seat 6: betgo (5580 in chips) is sitting out
Seat 7: kidpokerUNO (29983 in chips)=20
Seat 9: bighand18 (23626 in chips)=20
hockingjoe: posts the ante 125
MyManPotnPan: posts the ante 125
FizzEdJohn: posts the ante 125
audwhwh1: posts the ante 125
JJin91: posts the ante 125
betgo: posts the ante 125
kidpokerUNO: posts the ante 125
bighand18: posts the ante 125
hockingjoe: posts small blind 500
MyManPotnPan: posts big blind 1000
*** HOLE CARDS ***
Dealt to JJin91 [9c 2d]
FizzEdJohn: folds=20
audwhwh1: raises 1000 to 2000
JJin91: folds=20
betgo: folds=20
kidpokerUNO: folds=20
bighand18: folds=20
hockingjoe: folds=20
MyManPotnPan: calls 1000
*** FLOP *** [7h 4s 4d]
MyManPotnPan: bets 2750
audwhwh1: calls 2750
*** TURN *** [7h 4s 4d] [3d]
MyManPotnPan: bets 5500
audwhwh1: calls 5500
*** RIVER *** [7h 4s 4d 3d] [6s]
MyManPotnPan: checks=20
audwhwh1: bets 10190 and is all-in
MyManPotnPan: folds=20
Uncalled bet (10190) returned to audwhwh1
audwhwh1 collected 22000 from pot
audwhwh1: doesn't show hand=20
*** SUMMARY ***
Total pot 22000 | Rake 0=20
Board [7h 4s 4d 3d 6s]
Seat 1: hockingjoe (small blind) folded before Flop
Seat 2: MyManPotnPan (big blind) folded on the River
Seat 3: FizzEdJohn folded before Flop (didn't bet)
Seat 4: audwhwh1 collected (22000)
Seat 5: JJin91 folded before Flop (didn't bet)
Seat 6: betgo folded before Flop (didn't bet)
Seat 7: kidpokerUNO folded before Flop (didn't bet)
Seat 9: bighand18 (button) folded before Flop (didn't bet)


*********** # 91 **************
PokerStars Hand #170340906740: Tournament #1622573245, $4.55+$0.45 USD =
Hold'em No Limit - Level XV (500/1000) - 2017/05/24 22:20:34 ET
Table '1622573245 8' 9-max Seat #1 is the button
Seat 1: hockingjoe (48250 in chips)=20
Seat 2: MyManPotnPan (23172 in chips)=20
Seat 3: FizzEdJohn (28207 in chips)=20
Seat 4: audwhwh1 (32190 in chips)=20
Seat 5: JJin91 (38785 in chips)=20
Seat 6: betgo (5455 in chips) is sitting out
Seat 7: kidpokerUNO (29858 in chips)=20
Seat 9: bighand18 (23501 in chips)=20
hockingjoe: posts the ante 125
MyManPotnPan: posts the ante 125
FizzEdJohn: posts the ante 125
audwhwh1: posts the ante 125
JJin91: posts the ante 125
betgo: posts the ante 125
kidpokerUNO: posts the ante 125
bighand18: posts the ante 125
MyManPotnPan: posts small blind 500
FizzEdJohn: posts big blind 1000
*** HOLE CARDS ***
Dealt to JJin91 [Ad Th]
audwhwh1: calls 1000
JJin91: calls 1000
betgo: folds=20
kidpokerUNO: folds=20
bighand18: folds=20
hockingjoe: folds=20
MyManPotnPan: calls 500
FizzEdJohn: checks=20
*** FLOP *** [7c 3d Ts]
MyManPotnPan: checks=20
FizzEdJohn: bets 2000
audwhwh1: calls 2000
JJin91: raises 4000 to 6000
MyManPotnPan: folds=20
FizzEdJohn: folds=20
audwhwh1: raises 19000 to 25000
JJin91: folds=20
Uncalled bet (19000) returned to audwhwh1
audwhwh1 collected 19000 from pot
audwhwh1: doesn't show hand=20
*** SUMMARY ***
Total pot 19000 | Rake 0=20
Board [7c 3d Ts]
Seat 1: hockingjoe (button) folded before Flop (didn't bet)
Seat 2: MyManPotnPan (small blind) folded on the Flop
Seat 3: FizzEdJohn (big blind) folded on the Flop
Seat 4: audwhwh1 collected (19000)
Seat 5: JJin91 folded on the Flop
Seat 6: betgo folded before Flop (didn't bet)
Seat 7: kidpokerUNO folded before Flop (didn't bet)
Seat 9: bighand18 folded before Flop (didn't bet)


*********** # 92 **************
PokerStars Hand #170340907028: Tournament #1622573245, $4.55+$0.45 USD =
Hold'em No Limit - Level XVI (600/1200) - 2017/05/24 22:21:46 ET
Table '1622573245 8' 9-max Seat #2 is the button
Seat 1: hockingjoe (48125 in chips)=20
Seat 2: MyManPotnPan (22047 in chips)=20
Seat 3: FizzEdJohn (25082 in chips)=20
Seat 4: audwhwh1 (44065 in chips)=20
Seat 5: JJin91 (31660 in chips)=20
Seat 6: betgo (5330 in chips) is sitting out
Seat 7: kidpokerUNO (29733 in chips)=20
Seat 9: bighand18 (23376 in chips)=20
hockingjoe: posts the ante 150
MyManPotnPan: posts the ante 150
FizzEdJohn: posts the ante 150
audwhwh1: posts the ante 150
JJin91: posts the ante 150
betgo: posts the ante 150
kidpokerUNO: posts the ante 150
bighand18: posts the ante 150
FizzEdJohn: posts small blind 600
audwhwh1: posts big blind 1200
*** HOLE CARDS ***
Dealt to JJin91 [Jc 5h]
JJin91: folds=20
betgo: folds=20
kidpokerUNO: folds=20
bighand18: raises 22026 to 23226 and is all-in
hockingjoe: folds=20
MyManPotnPan: folds=20
FizzEdJohn: folds=20
audwhwh1: folds=20
Uncalled bet (22026) returned to bighand18
bighand18 collected 4200 from pot
bighand18: doesn't show hand=20
*** SUMMARY ***
Total pot 4200 | Rake 0=20
Seat 1: hockingjoe folded before Flop (didn't bet)
Seat 2: MyManPotnPan (button) folded before Flop (didn't bet)
Seat 3: FizzEdJohn (small blind) folded before Flop
Seat 4: audwhwh1 (big blind) folded before Flop
Seat 5: JJin91 folded before Flop (didn't bet)
Seat 6: betgo folded before Flop (didn't bet)
Seat 7: kidpokerUNO folded before Flop (didn't bet)
Seat 9: bighand18 collected (4200)


*********** # 93 **************
PokerStars Hand #170340907128: Tournament #1622573245, $4.55+$0.45 USD =
Hold'em No Limit - Level XVI (600/1200) - 2017/05/24 22:22:07 ET
Table '1622573245 8' 9-max Seat #3 is the button
Seat 1: hockingjoe (47975 in chips)=20
Seat 2: MyManPotnPan (21897 in chips)=20
Seat 3: FizzEdJohn (24332 in chips)=20
Seat 4: audwhwh1 (42715 in chips)=20
Seat 5: JJin91 (31510 in chips)=20
Seat 6: betgo (5180 in chips) is sitting out
Seat 7: kidpokerUNO (29583 in chips)=20
Seat 8: megun1008 (23175 in chips)=20
Seat 9: bighand18 (26226 in chips)=20
hockingjoe: posts the ante 150
MyManPotnPan: posts the ante 150
FizzEdJohn: posts the ante 150
audwhwh1: posts the ante 150
JJin91: posts the ante 150
betgo: posts the ante 150
kidpokerUNO: posts the ante 150
megun1008: posts the ante 150
bighand18: posts the ante 150
audwhwh1: posts small blind 600
JJin91: posts big blind 1200
*** HOLE CARDS ***
Dealt to JJin91 [9h 6s]
betgo: folds=20
kidpokerUNO: folds=20
megun1008: calls 1200
bighand18: folds=20
hockingjoe: folds=20
MyManPotnPan: folds=20
FizzEdJohn: folds=20
audwhwh1: calls 600
JJin91: checks=20
*** FLOP *** [4h Js Qh]
audwhwh1: bets 2400
JJin91: folds=20
megun1008: calls 2400
*** TURN *** [4h Js Qh] [8c]
audwhwh1: bets 4800
megun1008: calls 4800
*** RIVER *** [4h Js Qh 8c] [7d]
audwhwh1: bets 19200
megun1008: calls 14625 and is all-in
Uncalled bet (4575) returned to audwhwh1
*** SHOW DOWN ***
audwhwh1: shows [9d Qc] (a pair of Queens)
megun1008: shows [Qd Ah] (a pair of Queens - Ace kicker)
megun1008 collected 48600 from pot
*** SUMMARY ***
Total pot 48600 | Rake 0=20
Board [4h Js Qh 8c 7d]
Seat 1: hockingjoe folded before Flop (didn't bet)
Seat 2: MyManPotnPan folded before Flop (didn't bet)
Seat 3: FizzEdJohn (button) folded before Flop (didn't bet)
Seat 4: audwhwh1 (small blind) showed [9d Qc] and lost with a pair of Q=
ueens
Seat 5: JJin91 (big blind) folded on the Flop
Seat 6: betgo folded before Flop (didn't bet)
Seat 7: kidpokerUNO folded before Flop (didn't bet)
Seat 8: megun1008 showed [Qd Ah] and won (48600) with a pair of Queens
Seat 9: bighand18 folded before Flop (didn't bet)


*********** # 94 **************
PokerStars Hand #170340907369: Tournament #1622573245, $4.55+$0.45 USD =
Hold'em No Limit - Level XVI (600/1200) - 2017/05/24 22:22:59 ET
Table '1622573245 8' 9-max Seat #4 is the button
Seat 1: hockingjoe (47825 in chips)=20
Seat 2: MyManPotnPan (21747 in chips)=20
Seat 3: FizzEdJohn (24182 in chips)=20
Seat 4: audwhwh1 (19540 in chips)=20
Seat 5: JJin91 (30160 in chips)=20
Seat 6: betgo (5030 in chips) is sitting out
Seat 7: kidpokerUNO (29433 in chips)=20
Seat 8: megun1008 (48600 in chips)=20
Seat 9: bighand18 (26076 in chips)=20
hockingjoe: posts the ante 150
MyManPotnPan: posts the ante 150
FizzEdJohn: posts the ante 150
audwhwh1: posts the ante 150
JJin91: posts the ante 150
betgo: posts the ante 150
kidpokerUNO: posts the ante 150
megun1008: posts the ante 150
bighand18: posts the ante 150
JJin91: posts small blind 600
betgo: posts big blind 1200
*** HOLE CARDS ***
Dealt to JJin91 [Th 2c]
kidpokerUNO: folds=20
megun1008: folds=20
betgo has returned
bighand18: folds=20
hockingjoe: folds=20
MyManPotnPan: folds=20
FizzEdJohn: raises 1200 to 2400
audwhwh1: folds=20
JJin91: folds=20
betgo: folds=20
Uncalled bet (1200) returned to FizzEdJohn
FizzEdJohn collected 4350 from pot
FizzEdJohn: doesn't show hand=20
*** SUMMARY ***
Total pot 4350 | Rake 0=20
Seat 1: hockingjoe folded before Flop (didn't bet)
Seat 2: MyManPotnPan folded before Flop (didn't bet)
Seat 3: FizzEdJohn collected (4350)
Seat 4: audwhwh1 (button) folded before Flop (didn't bet)
Seat 5: JJin91 (small blind) folded before Flop
Seat 6: betgo (big blind) folded before Flop
Seat 7: kidpokerUNO folded before Flop (didn't bet)
Seat 8: megun1008 folded before Flop (didn't bet)
Seat 9: bighand18 folded before Flop (didn't bet)


*********** # 95 **************
PokerStars Hand #170340907448: Tournament #1622573245, $4.55+$0.45 USD =
Hold'em No Limit - Level XVI (600/1200) - 2017/05/24 22:23:22 ET
Table '1622573245 8' 9-max Seat #5 is the button
Seat 1: hockingjoe (47675 in chips)=20
Seat 2: MyManPotnPan (21597 in chips)=20
Seat 3: FizzEdJohn (27182 in chips)=20
Seat 4: audwhwh1 (19390 in chips)=20
Seat 5: JJin91 (29410 in chips)=20
Seat 6: betgo (3680 in chips)=20
Seat 7: kidpokerUNO (29283 in chips)=20
Seat 8: megun1008 (48450 in chips)=20
Seat 9: bighand18 (25926 in chips)=20
hockingjoe: posts the ante 150
MyManPotnPan: posts the ante 150
FizzEdJohn: posts the ante 150
audwhwh1: posts the ante 150
JJin91: posts the ante 150
betgo: posts the ante 150
kidpokerUNO: posts the ante 150
megun1008: posts the ante 150
bighand18: posts the ante 150
betgo: posts small blind 600
kidpokerUNO: posts big blind 1200
*** HOLE CARDS ***
Dealt to JJin91 [3s Jh]
megun1008: folds=20
bighand18: folds=20
hockingjoe: folds=20
MyManPotnPan: folds=20
FizzEdJohn: raises 1200 to 2400
audwhwh1: calls 2400
JJin91: folds=20
betgo: folds=20
kidpokerUNO: calls 1200
*** FLOP *** [7s Js 6s]
kidpokerUNO: checks=20
FizzEdJohn: checks=20
audwhwh1: bets 4800
kidpokerUNO: calls 4800
FizzEdJohn: folds=20
*** TURN *** [7s Js 6s] [Tc]
kidpokerUNO: checks=20
audwhwh1: bets 12040 and is all-in
kidpokerUNO: folds=20
Uncalled bet (12040) returned to audwhwh1
audwhwh1 collected 18750 from pot
audwhwh1: doesn't show hand=20
*** SUMMARY ***
Total pot 18750 | Rake 0=20
Board [7s Js 6s Tc]
Seat 1: hockingjoe folded before Flop (didn't bet)
Seat 2: MyManPotnPan folded before Flop (didn't bet)
Seat 3: FizzEdJohn folded on the Flop
Seat 4: audwhwh1 collected (18750)
Seat 5: JJin91 (button) folded before Flop (didn't bet)
Seat 6: betgo (small blind) folded before Flop
Seat 7: kidpokerUNO (big blind) folded on the Turn
Seat 8: megun1008 folded before Flop (didn't bet)
Seat 9: bighand18 folded before Flop (didn't bet)


*********** # 96 **************
PokerStars Hand #170340907806: Tournament #1622573245, $4.55+$0.45 USD =
Hold'em No Limit - Level XVI (600/1200) - 2017/05/24 22:24:45 ET
Table '1622573245 8' 9-max Seat #6 is the button
Seat 1: hockingjoe (47525 in chips)=20
Seat 2: MyManPotnPan (21447 in chips)=20
Seat 3: FizzEdJohn (24632 in chips)=20
Seat 4: audwhwh1 (30790 in chips)=20
Seat 5: JJin91 (29260 in chips)=20
Seat 6: betgo (2930 in chips)=20
Seat 7: kidpokerUNO (21933 in chips)=20
Seat 8: megun1008 (48300 in chips)=20
Seat 9: bighand18 (25776 in chips)=20
hockingjoe: posts the ante 150
MyManPotnPan: posts the ante 150
FizzEdJohn: posts the ante 150
audwhwh1: posts the ante 150
JJin91: posts the ante 150
betgo: posts the ante 150
kidpokerUNO: posts the ante 150
megun1008: posts the ante 150
bighand18: posts the ante 150
kidpokerUNO: posts small blind 600
megun1008: posts big blind 1200
*** HOLE CARDS ***
Dealt to JJin91 [4h Kh]
bighand18: folds=20
hockingjoe: folds=20
MyManPotnPan: folds=20
FizzEdJohn: folds=20
audwhwh1: raises 2400 to 3600
JJin91: folds=20
betgo: folds=20
kidpokerUNO: folds=20
megun1008: folds=20
Uncalled bet (2400) returned to audwhwh1
audwhwh1 collected 4350 from pot
audwhwh1: doesn't show hand=20
*** SUMMARY ***
Total pot 4350 | Rake 0=20
Seat 1: hockingjoe folded before Flop (didn't bet)
Seat 2: MyManPotnPan folded before Flop (didn't bet)
Seat 3: FizzEdJohn folded before Flop (didn't bet)
Seat 4: audwhwh1 collected (4350)
Seat 5: JJin91 folded before Flop (didn't bet)
Seat 6: betgo (button) folded before Flop (didn't bet)
Seat 7: kidpokerUNO (small blind) folded before Flop
Seat 8: megun1008 (big blind) folded before Flop
Seat 9: bighand18 folded before Flop (didn't bet)


*********** # 97 **************
PokerStars Hand #170340907897: Tournament #1622573245, $4.55+$0.45 USD =
Hold'em No Limit - Level XVI (600/1200) - 2017/05/24 22:25:08 ET
Table '1622573245 8' 9-max Seat #7 is the button
Seat 1: hockingjoe (47375 in chips)=20
Seat 2: MyManPotnPan (21297 in chips)=20
Seat 3: FizzEdJohn (24482 in chips)=20
Seat 4: audwhwh1 (33790 in chips)=20
Seat 5: JJin91 (29110 in chips)=20
Seat 6: betgo (2780 in chips)=20
Seat 7: kidpokerUNO (21183 in chips)=20
Seat 8: megun1008 (46950 in chips)=20
Seat 9: bighand18 (25626 in chips)=20
hockingjoe: posts the ante 150
MyManPotnPan: posts the ante 150
FizzEdJohn: posts the ante 150
audwhwh1: posts the ante 150
JJin91: posts the ante 150
betgo: posts the ante 150
kidpokerUNO: posts the ante 150
megun1008: posts the ante 150
bighand18: posts the ante 150
megun1008: posts small blind 600
bighand18: posts big blind 1200
*** HOLE CARDS ***
Dealt to JJin91 [5s Jc]
hockingjoe: folds=20
MyManPotnPan: folds=20
FizzEdJohn: raises 1380 to 2580
audwhwh1: folds=20
JJin91: folds=20
betgo: folds=20
kidpokerUNO: folds=20
megun1008: folds=20
bighand18: folds=20
Uncalled bet (1380) returned to FizzEdJohn
FizzEdJohn collected 4350 from pot
FizzEdJohn: doesn't show hand=20
*** SUMMARY ***
Total pot 4350 | Rake 0=20
Seat 1: hockingjoe folded before Flop (didn't bet)
Seat 2: MyManPotnPan folded before Flop (didn't bet)
Seat 3: FizzEdJohn collected (4350)
Seat 4: audwhwh1 folded before Flop (didn't bet)
Seat 5: JJin91 folded before Flop (didn't bet)
Seat 6: betgo folded before Flop (didn't bet)
Seat 7: kidpokerUNO (button) folded before Flop (didn't bet)
Seat 8: megun1008 (small blind) folded before Flop
Seat 9: bighand18 (big blind) folded before Flop


*********** # 98 **************
PokerStars Hand #170340908022: Tournament #1622573245, $4.55+$0.45 USD =
Hold'em No Limit - Level XVI (600/1200) - 2017/05/24 22:25:38 ET
Table '1622573245 8' 9-max Seat #8 is the button
Seat 1: hockingjoe (47225 in chips)=20
Seat 2: MyManPotnPan (21147 in chips)=20
Seat 3: FizzEdJohn (27482 in chips)=20
Seat 4: audwhwh1 (33640 in chips)=20
Seat 5: JJin91 (28960 in chips)=20
Seat 6: betgo (2630 in chips)=20
Seat 7: kidpokerUNO (21033 in chips)=20
Seat 8: megun1008 (46200 in chips)=20
Seat 9: bighand18 (24276 in chips)=20
hockingjoe: posts the ante 150
MyManPotnPan: posts the ante 150
FizzEdJohn: posts the ante 150
audwhwh1: posts the ante 150
JJin91: posts the ante 150
betgo: posts the ante 150
kidpokerUNO: posts the ante 150
megun1008: posts the ante 150
bighand18: posts the ante 150
bighand18: posts small blind 600
hockingjoe: posts big blind 1200
*** HOLE CARDS ***
Dealt to JJin91 [7d 4s]
MyManPotnPan: folds=20
FizzEdJohn: raises 1380 to 2580
audwhwh1: folds=20
JJin91: folds=20
betgo: folds=20
kidpokerUNO: raises 2220 to 4800
megun1008: folds=20
bighand18: folds=20
hockingjoe: folds=20
FizzEdJohn: folds=20
Uncalled bet (2220) returned to kidpokerUNO
kidpokerUNO collected 8310 from pot
*** SUMMARY ***
Total pot 8310 | Rake 0=20
Seat 1: hockingjoe (big blind) folded before Flop
Seat 2: MyManPotnPan folded before Flop (didn't bet)
Seat 3: FizzEdJohn folded before Flop
Seat 4: audwhwh1 folded before Flop (didn't bet)
Seat 5: JJin91 folded before Flop (didn't bet)
Seat 6: betgo folded before Flop (didn't bet)
Seat 7: kidpokerUNO collected (8310)
Seat 8: megun1008 (button) folded before Flop (didn't bet)
Seat 9: bighand18 (small blind) folded before Flop


*********** # 99 **************
PokerStars Hand #170340908214: Tournament #1622573245, $4.55+$0.45 USD =
Hold'em No Limit - Level XVI (600/1200) - 2017/05/24 22:26:27 ET
Table '1622573245 8' 9-max Seat #9 is the button
Seat 1: hockingjoe (45875 in chips)=20
Seat 2: MyManPotnPan (20997 in chips)=20
Seat 3: FizzEdJohn (24752 in chips)=20
Seat 5: JJin91 (28810 in chips)=20
Seat 6: betgo (2480 in chips)=20
Seat 7: kidpokerUNO (26613 in chips)=20
Seat 8: megun1008 (46050 in chips)=20
Seat 9: bighand18 (23526 in chips)=20
hockingjoe: posts the ante 150
MyManPotnPan: posts the ante 150
FizzEdJohn: posts the ante 150
JJin91: posts the ante 150
betgo: posts the ante 150
kidpokerUNO: posts the ante 150
megun1008: posts the ante 150
bighand18: posts the ante 150
hockingjoe: posts small blind 600
MyManPotnPan: posts big blind 1200
*** HOLE CARDS ***
Dealt to JJin91 [Kc 3h]
FizzEdJohn: folds=20
JJin91: folds=20
betgo: folds=20
kidpokerUNO: folds=20
megun1008: calls 1200
bighand18: folds=20
hockingjoe: calls 600
MyManPotnPan: checks=20
*** FLOP *** [Qd 4h 8c]
hockingjoe: checks=20
MyManPotnPan: bets 2400
megun1008: folds=20
hockingjoe: folds=20
Uncalled bet (2400) returned to MyManPotnPan
MyManPotnPan collected 4800 from pot
MyManPotnPan: doesn't show hand=20
*** SUMMARY ***
Total pot 4800 | Rake 0=20
Board [Qd 4h 8c]
Seat 1: hockingjoe (small blind) folded on the Flop
Seat 2: MyManPotnPan (big blind) collected (4800)
Seat 3: FizzEdJohn folded before Flop (didn't bet)
Seat 5: JJin91 folded before Flop (didn't bet)
Seat 6: betgo folded before Flop (didn't bet)
Seat 7: kidpokerUNO folded before Flop (didn't bet)
Seat 8: megun1008 folded on the Flop
Seat 9: bighand18 (button) folded before Flop (didn't bet)


*********** # 100 **************
PokerStars Hand #170340908393: Tournament #1622573245, $4.55+$0.45 USD =
Hold'em No Limit - Level XVII (700/1400) - 2017/05/24 22:27:06 ET
Table '1622573245 8' 9-max Seat #1 is the button
Seat 1: hockingjoe (44525 in chips)=20
Seat 2: MyManPotnPan (24447 in chips)=20
Seat 3: FizzEdJohn (24602 in chips)=20
Seat 5: JJin91 (28660 in chips)=20
Seat 6: betgo (2330 in chips)=20
Seat 7: kidpokerUNO (26463 in chips)=20
Seat 8: megun1008 (44700 in chips)=20
Seat 9: bighand18 (23376 in chips)=20
hockingjoe: posts the ante 175
MyManPotnPan: posts the ante 175
FizzEdJohn: posts the ante 175
JJin91: posts the ante 175
betgo: posts the ante 175
kidpokerUNO: posts the ante 175
megun1008: posts the ante 175
bighand18: posts the ante 175
MyManPotnPan: posts small blind 700
FizzEdJohn: posts big blind 1400
*** HOLE CARDS ***
Dealt to JJin91 [Jh 4d]
JJin91: folds=20
betgo: folds=20
kidpokerUNO: folds=20
megun1008: folds=20
bighand18: folds=20
hockingjoe: folds=20
MyManPotnPan: calls 700
FizzEdJohn: raises 2601 to 4001
MyManPotnPan: folds=20
Uncalled bet (2601) returned to FizzEdJohn
FizzEdJohn collected 4200 from pot
FizzEdJohn: doesn't show hand=20
*** SUMMARY ***
Total pot 4200 | Rake 0=20
Seat 1: hockingjoe (button) folded before Flop (didn't bet)
Seat 2: MyManPotnPan (small blind) folded before Flop
Seat 3: FizzEdJohn (big blind) collected (4200)
Seat 5: JJin91 folded before Flop (didn't bet)
Seat 6: betgo folded before Flop (didn't bet)
Seat 7: kidpokerUNO folded before Flop (didn't bet)
Seat 8: megun1008 folded before Flop (didn't bet)
Seat 9: bighand18 folded before Flop (didn't bet)


*********** # 101 **************
PokerStars Hand #170340908514: Tournament #1622573245, $4.55+$0.45 USD =
Hold'em No Limit - Level XVII (700/1400) - 2017/05/24 22:27:32 ET
Table '1622573245 8' 9-max Seat #2 is the button
Seat 1: hockingjoe (44350 in chips)=20
Seat 2: MyManPotnPan (22872 in chips)=20
Seat 3: FizzEdJohn (27227 in chips)=20
Seat 5: JJin91 (28485 in chips)=20
Seat 6: betgo (2155 in chips)=20
Seat 7: kidpokerUNO (26288 in chips)=20
Seat 8: megun1008 (44525 in chips)=20
Seat 9: bighand18 (23201 in chips)=20
hockingjoe: posts the ante 175
MyManPotnPan: posts the ante 175
FizzEdJohn: posts the ante 175
JJin91: posts the ante 175
betgo: posts the ante 175
kidpokerUNO: posts the ante 175
megun1008: posts the ante 175
bighand18: posts the ante 175
FizzEdJohn: posts small blind 700
JJin91: posts big blind 1400
*** HOLE CARDS ***
Dealt to JJin91 [Ad 8c]
betgo: folds=20
kidpokerUNO: folds=20
megun1008: folds=20
bighand18: raises 21626 to 23026 and is all-in
hockingjoe: folds=20
MyManPotnPan: folds=20
FizzEdJohn: folds=20
JJin91: folds=20
Uncalled bet (21626) returned to bighand18
bighand18 collected 4900 from pot
bighand18: doesn't show hand=20
*** SUMMARY ***
Total pot 4900 | Rake 0=20
Seat 1: hockingjoe folded before Flop (didn't bet)
Seat 2: MyManPotnPan (button) folded before Flop (didn't bet)
Seat 3: FizzEdJohn (small blind) folded before Flop
Seat 5: JJin91 (big blind) folded before Flop
Seat 6: betgo folded before Flop (didn't bet)
Seat 7: kidpokerUNO folded before Flop (didn't bet)
Seat 8: megun1008 folded before Flop (didn't bet)
Seat 9: bighand18 collected (4900)


*********** # 102 **************
PokerStars Hand #170340908659: Tournament #1622573245, $4.55+$0.45 USD =
Hold'em No Limit - Level XVII (700/1400) - 2017/05/24 22:28:05 ET
Table '1622573245 8' 9-max Seat #3 is the button
Seat 1: hockingjoe (44175 in chips)=20
Seat 2: MyManPotnPan (22697 in chips)=20
Seat 3: FizzEdJohn (26352 in chips)=20
Seat 5: JJin91 (26910 in chips)=20
Seat 6: betgo (1980 in chips)=20
Seat 7: kidpokerUNO (26113 in chips)=20
Seat 8: megun1008 (44350 in chips)=20
Seat 9: bighand18 (26526 in chips)=20
hockingjoe: posts the ante 175
MyManPotnPan: posts the ante 175
FizzEdJohn: posts the ante 175
JJin91: posts the ante 175
betgo: posts the ante 175
kidpokerUNO: posts the ante 175
megun1008: posts the ante 175
bighand18: posts the ante 175
JJin91: posts small blind 700
betgo: posts big blind 1400
*** HOLE CARDS ***
Dealt to JJin91 [5c As]
kidpokerUNO: folds=20
megun1008: folds=20
bighand18: folds=20
hockingjoe: folds=20
MyManPotnPan: folds=20
FizzEdJohn: raises 1400 to 2800
JJin91: calls 2100
betgo: calls 405 and is all-in
*** FLOP *** [7s 3h 4c]
JJin91: bets 5019
FizzEdJohn: folds=20
Uncalled bet (5019) returned to JJin91
*** TURN *** [7s 3h 4c] [7d]
*** RIVER *** [7s 3h 4c 7d] [Js]
*** SHOW DOWN ***
JJin91: shows [5c As] (a pair of Sevens)
JJin91 collected 1990 from side pot
betgo: shows [Qc 6c] (a pair of Sevens - lower kicker)
JJin91 collected 6815 from main pot
betgo finished the tournament in 31st place
*** SUMMARY ***
Total pot 8805 Main pot 6815. Side pot 1990. | Rake 0=20
Board [7s 3h 4c 7d Js]
Seat 1: hockingjoe folded before Flop (didn't bet)
Seat 2: MyManPotnPan folded before Flop (didn't bet)
Seat 3: FizzEdJohn (button) folded on the Flop
Seat 5: JJin91 (small blind) showed [5c As] and won (8805) with a pair =
of Sevens
Seat 6: betgo (big blind) showed [Qc 6c] and lost with a pair of Sevens
Seat 7: kidpokerUNO folded before Flop (didn't bet)
Seat 8: megun1008 folded before Flop (didn't bet)
Seat 9: bighand18 folded before Flop (didn't bet)


*********** # 103 **************
PokerStars Hand #170340908880: Tournament #1622573245, $4.55+$0.45 USD =
Hold'em No Limit - Level XVII (700/1400) - 2017/05/24 22:28:52 ET
Table '1622573245 8' 9-max Seat #5 is the button
Seat 1: hockingjoe (44000 in chips)=20
Seat 2: MyManPotnPan (22522 in chips)=20
Seat 3: FizzEdJohn (23377 in chips)=20
Seat 5: JJin91 (32740 in chips)=20
Seat 7: kidpokerUNO (25938 in chips)=20
Seat 8: megun1008 (44175 in chips)=20
Seat 9: bighand18 (26351 in chips)=20
hockingjoe: posts the ante 175
MyManPotnPan: posts the ante 175
FizzEdJohn: posts the ante 175
JJin91: posts the ante 175
kidpokerUNO: posts the ante 175
megun1008: posts the ante 175
bighand18: posts the ante 175
kidpokerUNO: posts small blind 700
megun1008: posts big blind 1400
*** HOLE CARDS ***
Dealt to JJin91 [9h Ac]
bighand18: folds=20
hockingjoe: folds=20
MyManPotnPan: folds=20
FizzEdJohn: folds=20
JJin91: raises 1666 to 3066
kidpokerUNO: folds=20
megun1008: calls 1666
*** FLOP *** [3h 8s 8d]
megun1008: checks=20
JJin91: checks=20
*** TURN *** [3h 8s 8d] [Js]
megun1008: bets 2800
JJin91: calls 2800
*** RIVER *** [3h 8s 8d Js] [3d]
megun1008: checks=20
JJin91: checks=20
*** SHOW DOWN ***
megun1008: shows [Ks 9s] (two pair, Eights and Threes)
JJin91: shows [9h Ac] (two pair, Eights and Threes - Ace kicker)
JJin91 collected 13657 from pot
*** SUMMARY ***
Total pot 13657 | Rake 0=20
Board [3h 8s 8d Js 3d]
Seat 1: hockingjoe folded before Flop (didn't bet)
Seat 2: MyManPotnPan folded before Flop (didn't bet)
Seat 3: FizzEdJohn folded before Flop (didn't bet)
Seat 5: JJin91 (button) showed [9h Ac] and won (13657) with two pair, E=
ights and Threes
Seat 7: kidpokerUNO (small blind) folded before Flop
Seat 8: megun1008 (big blind) showed [Ks 9s] and lost with two pair, Ei=
ghts and Threes
Seat 9: bighand18 folded before Flop (didn't bet)


*********** # 104 **************
PokerStars Hand #170340909107: Tournament #1622573245, $4.55+$0.45 USD =
Hold'em No Limit - Level XVII (700/1400) - 2017/05/24 22:29:44 ET
Table '1622573245 8' 9-max Seat #7 is the button
Seat 1: hockingjoe (43825 in chips)=20
Seat 2: MyManPotnPan (22347 in chips)=20
Seat 3: FizzEdJohn (23202 in chips)=20
Seat 5: JJin91 (40356 in chips)=20
Seat 7: kidpokerUNO (25063 in chips)=20
Seat 8: megun1008 (38134 in chips)=20
Seat 9: bighand18 (26176 in chips)=20
hockingjoe: posts the ante 175
MyManPotnPan: posts the ante 175
FizzEdJohn: posts the ante 175
JJin91: posts the ante 175
kidpokerUNO: posts the ante 175
megun1008: posts the ante 175
bighand18: posts the ante 175
megun1008: posts small blind 700
bighand18: posts big blind 1400
*** HOLE CARDS ***
Dealt to JJin91 [2c Th]
hockingjoe: folds=20
MyManPotnPan: calls 1400
FizzEdJohn: folds=20
JJin91: folds=20
kidpokerUNO: folds=20
megun1008: folds=20
bighand18: checks=20
*** FLOP *** [6c Ad 5h]
bighand18: bets 4200
MyManPotnPan: folds=20
Uncalled bet (4200) returned to bighand18
bighand18 collected 4725 from pot
bighand18: doesn't show hand=20
*** SUMMARY ***
Total pot 4725 | Rake 0=20
Board [6c Ad 5h]
Seat 1: hockingjoe folded before Flop (didn't bet)
Seat 2: MyManPotnPan folded on the Flop
Seat 3: FizzEdJohn folded before Flop (didn't bet)
Seat 5: JJin91 folded before Flop (didn't bet)
Seat 7: kidpokerUNO (button) folded before Flop (didn't bet)
Seat 8: megun1008 (small blind) folded before Flop
Seat 9: bighand18 (big blind) collected (4725)


*********** # 105 **************
PokerStars Hand #170340909216: Tournament #1622573245, $4.55+$0.45 USD =
Hold'em No Limit - Level XVII (700/1400) - 2017/05/24 22:30:10 ET
Table '1622573245 8' 9-max Seat #8 is the button
Seat 1: hockingjoe (43650 in chips)=20
Seat 2: MyManPotnPan (20772 in chips)=20
Seat 3: FizzEdJohn (23027 in chips)=20
Seat 5: JJin91 (40181 in chips)=20
Seat 7: kidpokerUNO (24888 in chips)=20
Seat 8: megun1008 (37259 in chips)=20
Seat 9: bighand18 (29326 in chips)=20
hockingjoe: posts the ante 175
MyManPotnPan: posts the ante 175
FizzEdJohn: posts the ante 175
JJin91: posts the ante 175
kidpokerUNO: posts the ante 175
megun1008: posts the ante 175
bighand18: posts the ante 175
bighand18: posts small blind 700
hockingjoe: posts big blind 1400
*** HOLE CARDS ***
Dealt to JJin91 [6s 9h]
MyManPotnPan: calls 1400
FizzEdJohn: raises 21452 to 22852 and is all-in
JJin91: folds=20
kidpokerUNO: folds=20
megun1008: folds=20
bighand18: folds=20
hockingjoe: folds=20
MyManPotnPan: folds=20
Uncalled bet (21452) returned to FizzEdJohn
FizzEdJohn collected 6125 from pot
FizzEdJohn: doesn't show hand=20
*** SUMMARY ***
Total pot 6125 | Rake 0=20
Seat 1: hockingjoe (big blind) folded before Flop
Seat 2: MyManPotnPan folded before Flop
Seat 3: FizzEdJohn collected (6125)
Seat 5: JJin91 folded before Flop (didn't bet)
Seat 7: kidpokerUNO folded before Flop (didn't bet)
Seat 8: megun1008 (button) folded before Flop (didn't bet)
Seat 9: bighand18 (small blind) folded before Flop


*********** # 106 **************
PokerStars Hand #170340909317: Tournament #1622573245, $4.55+$0.45 USD =
Hold'em No Limit - Level XVII (700/1400) - 2017/05/24 22:30:38 ET
Table '1622573245 8' 9-max Seat #9 is the button
Seat 1: hockingjoe (42075 in chips)=20
Seat 2: MyManPotnPan (19197 in chips)=20
Seat 3: FizzEdJohn (27577 in chips)=20
Seat 5: JJin91 (40006 in chips)=20
Seat 7: kidpokerUNO (24713 in chips)=20
Seat 8: megun1008 (37084 in chips)=20
Seat 9: bighand18 (28451 in chips)=20
hockingjoe: posts the ante 175
MyManPotnPan: posts the ante 175
FizzEdJohn: posts the ante 175
JJin91: posts the ante 175
kidpokerUNO: posts the ante 175
megun1008: posts the ante 175
bighand18: posts the ante 175
hockingjoe: posts small blind 700
MyManPotnPan: posts big blind 1400
*** HOLE CARDS ***
Dealt to JJin91 [3s 4c]
FizzEdJohn: folds=20
JJin91: folds=20
kidpokerUNO: folds=20
megun1008: folds=20
bighand18: folds=20
hockingjoe: raises 2800 to 4200
MyManPotnPan: folds=20
Uncalled bet (2800) returned to hockingjoe
hockingjoe collected 4025 from pot
hockingjoe: doesn't show hand=20
*** SUMMARY ***
Total pot 4025 | Rake 0=20
Seat 1: hockingjoe (small blind) collected (4025)
Seat 2: MyManPotnPan (big blind) folded before Flop
Seat 3: FizzEdJohn folded before Flop (didn't bet)
Seat 5: JJin91 folded before Flop (didn't bet)
Seat 7: kidpokerUNO folded before Flop (didn't bet)
Seat 8: megun1008 folded before Flop (didn't bet)
Seat 9: bighand18 (button) folded before Flop (didn't bet)


*********** # 107 **************
PokerStars Hand #170340909394: Tournament #1622573245, $4.55+$0.45 USD =
Hold'em No Limit - Level XVII (700/1400) - 2017/05/24 22:30:57 ET
Table '1622573245 8' 9-max Seat #1 is the button
Seat 1: hockingjoe (44525 in chips)=20
Seat 2: MyManPotnPan (17622 in chips)=20
Seat 3: FizzEdJohn (27402 in chips)=20
Seat 5: JJin91 (39831 in chips)=20
Seat 7: kidpokerUNO (24538 in chips)=20
Seat 8: megun1008 (36909 in chips)=20
Seat 9: bighand18 (28276 in chips)=20
hockingjoe: posts the ante 175
MyManPotnPan: posts the ante 175
FizzEdJohn: posts the ante 175
JJin91: posts the ante 175
kidpokerUNO: posts the ante 175
megun1008: posts the ante 175
bighand18: posts the ante 175
MyManPotnPan: posts small blind 700
FizzEdJohn: posts big blind 1400
*** HOLE CARDS ***
Dealt to JJin91 [4s 5d]
JJin91: folds=20
kidpokerUNO: calls 1400
megun1008: folds=20
bighand18: folds=20
hockingjoe: folds=20
MyManPotnPan: calls 700
FizzEdJohn: checks=20
*** FLOP *** [Kd Td 2d]
MyManPotnPan: checks=20
FizzEdJohn: bets 3001
kidpokerUNO: folds=20
MyManPotnPan: folds=20
Uncalled bet (3001) returned to FizzEdJohn
FizzEdJohn collected 5425 from pot
FizzEdJohn: doesn't show hand=20
*** SUMMARY ***
Total pot 5425 | Rake 0=20
Board [Kd Td 2d]
Seat 1: hockingjoe (button) folded before Flop (didn't bet)
Seat 2: MyManPotnPan (small blind) folded on the Flop
Seat 3: FizzEdJohn (big blind) collected (5425)
Seat 5: JJin91 folded before Flop (didn't bet)
Seat 7: kidpokerUNO folded on the Flop
Seat 8: megun1008 folded before Flop (didn't bet)
Seat 9: bighand18 folded before Flop (didn't bet)


*********** # 108 **************
PokerStars Hand #170340909529: Tournament #1622573245, $4.55+$0.45 USD =
Hold'em No Limit - Level XVII (700/1400) - 2017/05/24 22:31:30 ET
Table '1622573245 8' 9-max Seat #2 is the button
Seat 1: hockingjoe (44350 in chips)=20
Seat 2: MyManPotnPan (16047 in chips)=20
Seat 3: FizzEdJohn (31252 in chips)=20
Seat 5: JJin91 (39656 in chips)=20
Seat 7: kidpokerUNO (22963 in chips)=20
Seat 8: megun1008 (36734 in chips)=20
Seat 9: bighand18 (28101 in chips)=20
hockingjoe: posts the ante 175
MyManPotnPan: posts the ante 175
FizzEdJohn: posts the ante 175
JJin91: posts the ante 175
kidpokerUNO: posts the ante 175
megun1008: posts the ante 175
bighand18: posts the ante 175
FizzEdJohn: posts small blind 700
JJin91: posts big blind 1400
*** HOLE CARDS ***
Dealt to JJin91 [Kh 4c]
kidpokerUNO: folds=20
megun1008: calls 1400
bighand18: folds=20
hockingjoe: folds=20
MyManPotnPan: folds=20
FizzEdJohn: folds=20
JJin91: checks=20
*** FLOP *** [4d 4s Qc]
JJin91: checks=20
megun1008: bets 5600
JJin91: calls 5600
*** TURN *** [4d 4s Qc] [Jh]
JJin91: checks=20
megun1008: bets 8400
JJin91: calls 8400
*** RIVER *** [4d 4s Qc Jh] [8d]
JJin91: checks=20
megun1008: checks=20
*** SHOW DOWN ***
JJin91: shows [Kh 4c] (three of a kind, Fours)
megun1008: mucks hand=20
JJin91 collected 32725 from pot
*** SUMMARY ***
Total pot 32725 | Rake 0=20
Board [4d 4s Qc Jh 8d]
Seat 1: hockingjoe folded before Flop (didn't bet)
Seat 2: MyManPotnPan (button) folded before Flop (didn't bet)
Seat 3: FizzEdJohn (small blind) folded before Flop
Seat 5: JJin91 (big blind) showed [Kh 4c] and won (32725) with three of=
 a kind, Fours
Seat 7: kidpokerUNO folded before Flop (didn't bet)
Seat 8: megun1008 mucked [Js Kd]
Seat 9: bighand18 folded before Flop (didn't bet)


*********** # 109 **************
PokerStars Hand #170340909743: Tournament #1622573245, $4.55+$0.45 USD =
Hold'em No Limit - Level XVIII (800/1600) - 2017/05/24 22:32:19 ET
Table '1622573245 8' 9-max Seat #3 is the button
Seat 1: hockingjoe (44175 in chips)=20
Seat 2: MyManPotnPan (15872 in chips)=20
Seat 3: FizzEdJohn (30377 in chips)=20
Seat 5: JJin91 (56806 in chips)=20
Seat 7: kidpokerUNO (22788 in chips)=20
Seat 8: megun1008 (21159 in chips)=20
Seat 9: bighand18 (27926 in chips)=20
hockingjoe: posts the ante 200
MyManPotnPan: posts the ante 200
FizzEdJohn: posts the ante 200
JJin91: posts the ante 200
kidpokerUNO: posts the ante 200
megun1008: posts the ante 200
bighand18: posts the ante 200
JJin91: posts small blind 800
kidpokerUNO: posts big blind 1600
*** HOLE CARDS ***
Dealt to JJin91 [Js 2s]
megun1008: raises 19359 to 20959 and is all-in
bighand18: folds=20
hockingjoe: folds=20
MyManPotnPan: folds=20
FizzEdJohn: folds=20
JJin91: folds=20
kidpokerUNO: folds=20
Uncalled bet (19359) returned to megun1008
megun1008 collected 5400 from pot
megun1008: doesn't show hand=20
*** SUMMARY ***
Total pot 5400 | Rake 0=20
Seat 1: hockingjoe folded before Flop (didn't bet)
Seat 2: MyManPotnPan folded before Flop (didn't bet)
Seat 3: FizzEdJohn (button) folded before Flop (didn't bet)
Seat 5: JJin91 (small blind) folded before Flop
Seat 7: kidpokerUNO (big blind) folded before Flop
Seat 8: megun1008 collected (5400)
Seat 9: bighand18 folded before Flop (didn't bet)


*********** # 110 **************
PokerStars Hand #170340909805: Tournament #1622573245, $4.55+$0.45 USD =
Hold'em No Limit - Level XVIII (800/1600) - 2017/05/24 22:32:33 ET
Table '1622573245 8' 9-max Seat #5 is the button
Seat 1: hockingjoe (43975 in chips)=20
Seat 2: MyManPotnPan (15672 in chips)=20
Seat 3: FizzEdJohn (30177 in chips)=20
Seat 5: JJin91 (55806 in chips)=20
Seat 7: kidpokerUNO (20988 in chips)=20
Seat 8: megun1008 (24759 in chips)=20
Seat 9: bighand18 (27726 in chips)=20
hockingjoe: posts the ante 200
MyManPotnPan: posts the ante 200
FizzEdJohn: posts the ante 200
JJin91: posts the ante 200
kidpokerUNO: posts the ante 200
megun1008: posts the ante 200
bighand18: posts the ante 200
kidpokerUNO: posts small blind 800
megun1008: posts big blind 1600
*** HOLE CARDS ***
Dealt to JJin91 [3s 4d]
bighand18: folds=20
hockingjoe: folds=20
MyManPotnPan: folds=20
FizzEdJohn: folds=20
JJin91: folds=20
kidpokerUNO: calls 800
megun1008: checks=20
*** FLOP *** [3d 6c 4s]
kidpokerUNO: bets 2200
megun1008: calls 2200
*** TURN *** [3d 6c 4s] [9c]
kidpokerUNO: bets 4800
megun1008: calls 4800
*** RIVER *** [3d 6c 4s 9c] [2d]
kidpokerUNO: checks=20
megun1008: checks=20
*** SHOW DOWN ***
kidpokerUNO: shows [Qs 6h] (a pair of Sixes)
megun1008: shows [Ks 6s] (a pair of Sixes - King kicker)
megun1008 collected 18600 from pot
*** SUMMARY ***
Total pot 18600 | Rake 0=20
Board [3d 6c 4s 9c 2d]
Seat 1: hockingjoe folded before Flop (didn't bet)
Seat 2: MyManPotnPan folded before Flop (didn't bet)
Seat 3: FizzEdJohn folded before Flop (didn't bet)
Seat 5: JJin91 (button) folded before Flop (didn't bet)
Seat 7: kidpokerUNO (small blind) showed [Qs 6h] and lost with a pair o=
f Sixes
Seat 8: megun1008 (big blind) showed [Ks 6s] and won (18600) with a pai=
r of Sixes
Seat 9: bighand18 folded before Flop (didn't bet)


*********** # 111 **************
PokerStars Hand #170341229605: Tournament #1622573245, $4.55+$0.45 USD =
Hold'em No Limit - Level XVIII (800/1600) - 2017/05/24 22:33:22 ET
Table '1622573245 8' 9-max Seat #7 is the button
Seat 1: hockingjoe (43775 in chips)=20
Seat 2: MyManPotnPan (15472 in chips)=20
Seat 3: FizzEdJohn (29977 in chips)=20
Seat 5: JJin91 (55606 in chips)=20
Seat 7: kidpokerUNO (12188 in chips)=20
Seat 8: megun1008 (34559 in chips)=20
Seat 9: bighand18 (27526 in chips)=20
hockingjoe: posts the ante 200
MyManPotnPan: posts the ante 200
FizzEdJohn: posts the ante 200
JJin91: posts the ante 200
kidpokerUNO: posts the ante 200
megun1008: posts the ante 200
bighand18: posts the ante 200
megun1008: posts small blind 800
bighand18: posts big blind 1600
*** HOLE CARDS ***
Dealt to JJin91 [7h 3d]
hockingjoe: folds=20
MyManPotnPan: folds=20
FizzEdJohn: folds=20
JJin91: folds=20
kidpokerUNO: folds=20
megun1008: calls 800
bighand18: checks=20
*** FLOP *** [Ac Qc 3h]
megun1008: bets 6400
bighand18: folds=20
Uncalled bet (6400) returned to megun1008
megun1008 collected 4600 from pot
megun1008: doesn't show hand=20
*** SUMMARY ***
Total pot 4600 | Rake 0=20
Board [Ac Qc 3h]
Seat 1: hockingjoe folded before Flop (didn't bet)
Seat 2: MyManPotnPan folded before Flop (didn't bet)
Seat 3: FizzEdJohn folded before Flop (didn't bet)
Seat 5: JJin91 folded before Flop (didn't bet)
Seat 7: kidpokerUNO (button) folded before Flop (didn't bet)
Seat 8: megun1008 (small blind) collected (4600)
Seat 9: bighand18 (big blind) folded on the Flop


*********** # 112 **************
PokerStars Hand #170341229710: Tournament #1622573245, $4.55+$0.45 USD =
Hold'em No Limit - Level XVIII (800/1600) - 2017/05/24 22:33:49 ET
Table '1622573245 8' 9-max Seat #8 is the button
Seat 1: hockingjoe (43575 in chips)=20
Seat 2: MyManPotnPan (15272 in chips)=20
Seat 3: FizzEdJohn (29777 in chips)=20
Seat 5: JJin91 (55406 in chips)=20
Seat 7: kidpokerUNO (11988 in chips)=20
Seat 8: megun1008 (37359 in chips)=20
Seat 9: bighand18 (25726 in chips)=20
hockingjoe: posts the ante 200
MyManPotnPan: posts the ante 200
FizzEdJohn: posts the ante 200
JJin91: posts the ante 200
kidpokerUNO: posts the ante 200
megun1008: posts the ante 200
bighand18: posts the ante 200
bighand18: posts small blind 800
hockingjoe: posts big blind 1600
*** HOLE CARDS ***
Dealt to JJin91 [2c Ac]
MyManPotnPan: calls 1600
FizzEdJohn: folds=20
JJin91: calls 1600
kidpokerUNO: folds=20
megun1008: folds=20
bighand18: calls 800
hockingjoe: checks=20
*** FLOP *** [Tc Qd 7h]
bighand18: checks=20
hockingjoe: checks=20
MyManPotnPan: checks=20
JJin91: checks=20
*** TURN *** [Tc Qd 7h] [3d]
bighand18: checks=20
hockingjoe: checks=20
MyManPotnPan: bets 3900
JJin91: folds=20
bighand18: folds=20
hockingjoe: calls 3900
*** RIVER *** [Tc Qd 7h 3d] [4s]
hockingjoe: checks=20
MyManPotnPan: checks=20
*** SHOW DOWN ***
hockingjoe: shows [Th Ah] (a pair of Tens)
MyManPotnPan: mucks hand=20
hockingjoe collected 15600 from pot
*** SUMMARY ***
Total pot 15600 | Rake 0=20
Board [Tc Qd 7h 3d 4s]
Seat 1: hockingjoe (big blind) showed [Th Ah] and won (15600) with a pa=
ir of Tens
Seat 2: MyManPotnPan mucked [Jd Ks]
Seat 3: FizzEdJohn folded before Flop (didn't bet)
Seat 5: JJin91 folded on the Turn
Seat 7: kidpokerUNO folded before Flop (didn't bet)
Seat 8: megun1008 (button) folded before Flop (didn't bet)
Seat 9: bighand18 (small blind) folded on the Turn


*********** # 113 **************
PokerStars Hand #170341229936: Tournament #1622573245, $4.55+$0.45 USD =
Hold'em No Limit - Level XVIII (800/1600) - 2017/05/24 22:34:40 ET
Table '1622573245 8' 9-max Seat #9 is the button
Seat 1: hockingjoe (53475 in chips)=20
Seat 2: MyManPotnPan (9572 in chips)=20
Seat 3: FizzEdJohn (29577 in chips)=20
Seat 4: ytc25 (39905 in chips)=20
Seat 5: JJin91 (53606 in chips)=20
Seat 6: slb9724 (48236 in chips)=20
Seat 7: kidpokerUNO (11788 in chips)=20
Seat 8: megun1008 (37159 in chips)=20
Seat 9: bighand18 (23926 in chips)=20
hockingjoe: posts the ante 200
MyManPotnPan: posts the ante 200
FizzEdJohn: posts the ante 200
ytc25: posts the ante 200
JJin91: posts the ante 200
slb9724: posts the ante 200
kidpokerUNO: posts the ante 200
megun1008: posts the ante 200
bighand18: posts the ante 200
hockingjoe: posts small blind 800
MyManPotnPan: posts big blind 1600
*** HOLE CARDS ***
Dealt to JJin91 [Kd Jd]
FizzEdJohn: folds=20
ytc25: calls 1600
JJin91: raises 3423 to 5023
slb9724: folds=20
kidpokerUNO: folds=20
megun1008: folds=20
bighand18: folds=20
hockingjoe: folds=20
MyManPotnPan: folds=20
ytc25: calls 3423
*** FLOP *** [2s 2h 3h]
ytc25: checks=20
JJin91: checks=20
*** TURN *** [2s 2h 3h] [Qh]
ytc25: checks=20
JJin91: bets 5271
ytc25: folds=20
Uncalled bet (5271) returned to JJin91
JJin91 collected 14246 from pot
JJin91: doesn't show hand=20
*** SUMMARY ***
Total pot 14246 | Rake 0=20
Board [2s 2h 3h Qh]
Seat 1: hockingjoe (small blind) folded before Flop
Seat 2: MyManPotnPan (big blind) folded before Flop
Seat 3: FizzEdJohn folded before Flop (didn't bet)
Seat 4: ytc25 folded on the Turn
Seat 5: JJin91 collected (14246)
Seat 6: slb9724 folded before Flop (didn't bet)
Seat 7: kidpokerUNO folded before Flop (didn't bet)
Seat 8: megun1008 folded before Flop (didn't bet)
Seat 9: bighand18 (button) folded before Flop (didn't bet)


*********** # 114 **************
PokerStars Hand #170341261342: Tournament #1622573245, $4.55+$0.45 USD =
Hold'em No Limit - Level XVIII (800/1600) - 2017/05/24 22:35:50 ET
Table '1622573245 8' 9-max Seat #1 is the button
Seat 1: hockingjoe (52475 in chips)=20
Seat 2: MyManPotnPan (7772 in chips)=20
Seat 3: FizzEdJohn (29377 in chips)=20
Seat 4: ytc25 (34682 in chips)=20
Seat 5: JJin91 (62629 in chips)=20
Seat 6: slb9724 (48036 in chips)=20
Seat 7: kidpokerUNO (11588 in chips)=20
Seat 8: megun1008 (36959 in chips)=20
Seat 9: bighand18 (23726 in chips)=20
hockingjoe: posts the ante 200
MyManPotnPan: posts the ante 200
FizzEdJohn: posts the ante 200
ytc25: posts the ante 200
JJin91: posts the ante 200
slb9724: posts the ante 200
kidpokerUNO: posts the ante 200
megun1008: posts the ante 200
bighand18: posts the ante 200
MyManPotnPan: posts small blind 800
FizzEdJohn: posts big blind 1600
*** HOLE CARDS ***
Dealt to JJin91 [6s Jh]
ytc25: folds=20
JJin91: folds=20
slb9724: folds=20
kidpokerUNO: folds=20
megun1008: calls 1600
bighand18: folds=20
hockingjoe: raises 1600 to 3200
MyManPotnPan: folds=20
FizzEdJohn: folds=20
megun1008: calls 1600
*** FLOP *** [Qh 4h 9s]
megun1008: checks=20
hockingjoe: bets 5000
megun1008: folds=20
Uncalled bet (5000) returned to hockingjoe
hockingjoe collected 10600 from pot
hockingjoe: doesn't show hand=20
*** SUMMARY ***
Total pot 10600 | Rake 0=20
Board [Qh 4h 9s]
Seat 1: hockingjoe (button) collected (10600)
Seat 2: MyManPotnPan (small blind) folded before Flop
Seat 3: FizzEdJohn (big blind) folded before Flop
Seat 4: ytc25 folded before Flop (didn't bet)
Seat 5: JJin91 folded before Flop (didn't bet)
Seat 6: slb9724 folded before Flop (didn't bet)
Seat 7: kidpokerUNO folded before Flop (didn't bet)
Seat 8: megun1008 folded on the Flop
Seat 9: bighand18 folded before Flop (didn't bet)


*********** # 115 **************
PokerStars Hand #170341261487: Tournament #1622573245, $4.55+$0.45 USD =
Hold'em No Limit - Level XVIII (800/1600) - 2017/05/24 22:36:25 ET
Table '1622573245 8' 9-max Seat #2 is the button
Seat 1: hockingjoe (59675 in chips)=20
Seat 2: MyManPotnPan (6772 in chips)=20
Seat 3: FizzEdJohn (27577 in chips)=20
Seat 4: ytc25 (34482 in chips)=20
Seat 5: JJin91 (62429 in chips)=20
Seat 6: slb9724 (47836 in chips)=20
Seat 7: kidpokerUNO (11388 in chips)=20
Seat 8: megun1008 (33559 in chips)=20
Seat 9: bighand18 (23526 in chips)=20
hockingjoe: posts the ante 200
MyManPotnPan: posts the ante 200
FizzEdJohn: posts the ante 200
ytc25: posts the ante 200
JJin91: posts the ante 200
slb9724: posts the ante 200
kidpokerUNO: posts the ante 200
megun1008: posts the ante 200
bighand18: posts the ante 200
FizzEdJohn: posts small blind 800
ytc25: posts big blind 1600
*** HOLE CARDS ***
Dealt to JJin91 [Jc 2c]
JJin91: folds=20
slb9724: folds=20
kidpokerUNO: folds=20
megun1008: folds=20
bighand18: raises 3200 to 4800
hockingjoe: folds=20
MyManPotnPan: folds=20
FizzEdJohn: folds=20
ytc25: calls 3200
*** FLOP *** [7d 3s 8c]
ytc25: checks=20
bighand18: bets 8000
ytc25: folds=20
Uncalled bet (8000) returned to bighand18
bighand18 collected 12200 from pot
bighand18: doesn't show hand=20
*** SUMMARY ***
Total pot 12200 | Rake 0=20
Board [7d 3s 8c]
Seat 1: hockingjoe folded before Flop (didn't bet)
Seat 2: MyManPotnPan (button) folded before Flop (didn't bet)
Seat 3: FizzEdJohn (small blind) folded before Flop
Seat 4: ytc25 (big blind) folded on the Flop
Seat 5: JJin91 folded before Flop (didn't bet)
Seat 6: slb9724 folded before Flop (didn't bet)
Seat 7: kidpokerUNO folded before Flop (didn't bet)
Seat 8: megun1008 folded before Flop (didn't bet)
Seat 9: bighand18 collected (12200)


*********** # 116 **************
PokerStars Hand #170341261660: Tournament #1622573245, $4.55+$0.45 USD =
Hold'em No Limit - Level XIX (1000/2000) - 2017/05/24 22:37:00 ET
Table '1622573245 8' 9-max Seat #3 is the button
Seat 1: hockingjoe (59475 in chips)=20
Seat 2: MyManPotnPan (6572 in chips)=20
Seat 3: FizzEdJohn (26577 in chips)=20
Seat 4: ytc25 (29482 in chips)=20
Seat 5: JJin91 (62229 in chips)=20
Seat 6: slb9724 (47636 in chips)=20
Seat 7: kidpokerUNO (11188 in chips)=20
Seat 8: megun1008 (33359 in chips)=20
Seat 9: bighand18 (30726 in chips)=20
hockingjoe: posts the ante 250
MyManPotnPan: posts the ante 250
FizzEdJohn: posts the ante 250
ytc25: posts the ante 250
JJin91: posts the ante 250
slb9724: posts the ante 250
kidpokerUNO: posts the ante 250
megun1008: posts the ante 250
bighand18: posts the ante 250
ytc25: posts small blind 1000
JJin91: posts big blind 2000
*** HOLE CARDS ***
Dealt to JJin91 [3h 5h]
slb9724: folds=20
kidpokerUNO: folds=20
megun1008: folds=20
bighand18: folds=20
hockingjoe: folds=20
MyManPotnPan: folds=20
FizzEdJohn: raises 24327 to 26327 and is all-in
ytc25: folds=20
JJin91: folds=20
Uncalled bet (24327) returned to FizzEdJohn
FizzEdJohn collected 7250 from pot
FizzEdJohn: doesn't show hand=20
*** SUMMARY ***
Total pot 7250 | Rake 0=20
Seat 1: hockingjoe folded before Flop (didn't bet)
Seat 2: MyManPotnPan folded before Flop (didn't bet)
Seat 3: FizzEdJohn (button) collected (7250)
Seat 4: ytc25 (small blind) folded before Flop
Seat 5: JJin91 (big blind) folded before Flop
Seat 6: slb9724 folded before Flop (didn't bet)
Seat 7: kidpokerUNO folded before Flop (didn't bet)
Seat 8: megun1008 folded before Flop (didn't bet)
Seat 9: bighand18 folded before Flop (didn't bet)


*********** # 117 **************
PokerStars Hand #170341261755: Tournament #1622573245, $4.55+$0.45 USD =
Hold'em No Limit - Level XIX (1000/2000) - 2017/05/24 22:37:21 ET
Table '1622573245 8' 9-max Seat #4 is the button
Seat 1: hockingjoe (59225 in chips)=20
Seat 2: MyManPotnPan (6322 in chips)=20
Seat 3: FizzEdJohn (31577 in chips)=20
Seat 4: ytc25 (28232 in chips)=20
Seat 5: JJin91 (59979 in chips)=20
Seat 6: slb9724 (47386 in chips)=20
Seat 7: kidpokerUNO (10938 in chips)=20
Seat 8: megun1008 (33109 in chips)=20
Seat 9: bighand18 (30476 in chips)=20
hockingjoe: posts the ante 250
MyManPotnPan: posts the ante 250
FizzEdJohn: posts the ante 250
ytc25: posts the ante 250
JJin91: posts the ante 250
slb9724: posts the ante 250
kidpokerUNO: posts the ante 250
megun1008: posts the ante 250
bighand18: posts the ante 250
JJin91: posts small blind 1000
slb9724: posts big blind 2000
*** HOLE CARDS ***
Dealt to JJin91 [Kd 8d]
kidpokerUNO: folds=20
megun1008: folds=20
bighand18: folds=20
hockingjoe: raises 4000 to 6000
MyManPotnPan: folds=20
FizzEdJohn: folds=20
ytc25: folds=20
JJin91: folds=20
slb9724: folds=20
Uncalled bet (4000) returned to hockingjoe
hockingjoe collected 7250 from pot
hockingjoe: doesn't show hand=20
*** SUMMARY ***
Total pot 7250 | Rake 0=20
Seat 1: hockingjoe collected (7250)
Seat 2: MyManPotnPan folded before Flop (didn't bet)
Seat 3: FizzEdJohn folded before Flop (didn't bet)
Seat 4: ytc25 (button) folded before Flop (didn't bet)
Seat 5: JJin91 (small blind) folded before Flop
Seat 6: slb9724 (big blind) folded before Flop
Seat 7: kidpokerUNO folded before Flop (didn't bet)
Seat 8: megun1008 folded before Flop (didn't bet)
Seat 9: bighand18 folded before Flop (didn't bet)


*********** # 118 **************
PokerStars Hand #170341261891: Tournament #1622573245, $4.55+$0.45 USD =
Hold'em No Limit - Level XIX (1000/2000) - 2017/05/24 22:37:52 ET
Table '1622573245 8' 9-max Seat #5 is the button
Seat 1: hockingjoe (64225 in chips)=20
Seat 2: MyManPotnPan (6072 in chips)=20
Seat 3: FizzEdJohn (31327 in chips)=20
Seat 4: ytc25 (27982 in chips)=20
Seat 5: JJin91 (58729 in chips)=20
Seat 6: slb9724 (45136 in chips)=20
Seat 7: kidpokerUNO (10688 in chips)=20
Seat 8: megun1008 (32859 in chips)=20
Seat 9: bighand18 (30226 in chips)=20
hockingjoe: posts the ante 250
MyManPotnPan: posts the ante 250
FizzEdJohn: posts the ante 250
ytc25: posts the ante 250
JJin91: posts the ante 250
slb9724: posts the ante 250
kidpokerUNO: posts the ante 250
megun1008: posts the ante 250
bighand18: posts the ante 250
slb9724: posts small blind 1000
kidpokerUNO: posts big blind 2000
*** HOLE CARDS ***
Dealt to JJin91 [Ts Kd]
megun1008: folds=20
bighand18: folds=20
hockingjoe: folds=20
MyManPotnPan: raises 3822 to 5822 and is all-in
FizzEdJohn: folds=20
ytc25: folds=20
JJin91: folds=20
slb9724: raises 39064 to 44886 and is all-in
kidpokerUNO: folds=20
Uncalled bet (39064) returned to slb9724
*** FLOP *** [2s 4s 9h]
*** TURN *** [2s 4s 9h] [8c]
*** RIVER *** [2s 4s 9h 8c] [4d]
*** SHOW DOWN ***
slb9724: shows [Qs Qh] (two pair, Queens and Fours)
MyManPotnPan: shows [Kh Jh] (a pair of Fours)
slb9724 collected 15894 from pot
MyManPotnPan finished the tournament in 27th place
*** SUMMARY ***
Total pot 15894 | Rake 0=20
Board [2s 4s 9h 8c 4d]
Seat 1: hockingjoe folded before Flop (didn't bet)
Seat 2: MyManPotnPan showed [Kh Jh] and lost with a pair of Fours
Seat 3: FizzEdJohn folded before Flop (didn't bet)
Seat 4: ytc25 folded before Flop (didn't bet)
Seat 5: JJin91 (button) folded before Flop (didn't bet)
Seat 6: slb9724 (small blind) showed [Qs Qh] and won (15894) with two p=
air, Queens and Fours
Seat 7: kidpokerUNO (big blind) folded before Flop
Seat 8: megun1008 folded before Flop (didn't bet)
Seat 9: bighand18 folded before Flop (didn't bet)


*********** # 119 **************
PokerStars Hand #170341262009: Tournament #1622573245, $4.55+$0.45 USD =
Hold'em No Limit - Level XIX (1000/2000) - 2017/05/24 22:38:20 ET
Table '1622573245 8' 9-max Seat #6 is the button
Seat 1: hockingjoe (63975 in chips)=20
Seat 3: FizzEdJohn (31077 in chips)=20
Seat 4: ytc25 (27732 in chips)=20
Seat 5: JJin91 (58479 in chips)=20
Seat 6: slb9724 (54958 in chips)=20
Seat 7: kidpokerUNO (8438 in chips)=20
Seat 8: megun1008 (32609 in chips)=20
Seat 9: bighand18 (29976 in chips)=20
hockingjoe: posts the ante 250
FizzEdJohn: posts the ante 250
ytc25: posts the ante 250
JJin91: posts the ante 250
slb9724: posts the ante 250
kidpokerUNO: posts the ante 250
megun1008: posts the ante 250
bighand18: posts the ante 250
kidpokerUNO: posts small blind 1000
megun1008: posts big blind 2000
*** HOLE CARDS ***
Dealt to JJin91 [Ah 8s]
bighand18: folds=20
hockingjoe: folds=20
FizzEdJohn: folds=20
ytc25: folds=20
JJin91: raises 2380 to 4380
slb9724: folds=20
kidpokerUNO: folds=20
megun1008: folds=20
Uncalled bet (2380) returned to JJin91
JJin91 collected 7000 from pot
JJin91: doesn't show hand=20
*** SUMMARY ***
Total pot 7000 | Rake 0=20
Seat 1: hockingjoe folded before Flop (didn't bet)
Seat 3: FizzEdJohn folded before Flop (didn't bet)
Seat 4: ytc25 folded before Flop (didn't bet)
Seat 5: JJin91 collected (7000)
Seat 6: slb9724 (button) folded before Flop (didn't bet)
Seat 7: kidpokerUNO (small blind) folded before Flop
Seat 8: megun1008 (big blind) folded before Flop
Seat 9: bighand18 folded before Flop (didn't bet)


*********** # 120 **************
PokerStars Hand #170341262083: Tournament #1622573245, $4.55+$0.45 USD =
Hold'em No Limit - Level XIX (1000/2000) - 2017/05/24 22:38:35 ET
Table '1622573245 8' 9-max Seat #7 is the button
Seat 1: hockingjoe (63725 in chips)=20
Seat 3: FizzEdJohn (30827 in chips)=20
Seat 4: ytc25 (27482 in chips)=20
Seat 5: JJin91 (63229 in chips)=20
Seat 6: slb9724 (54708 in chips)=20
Seat 7: kidpokerUNO (7188 in chips)=20
Seat 8: megun1008 (30359 in chips)=20
Seat 9: bighand18 (29726 in chips)=20
hockingjoe: posts the ante 250
FizzEdJohn: posts the ante 250
ytc25: posts the ante 250
JJin91: posts the ante 250
slb9724: posts the ante 250
kidpokerUNO: posts the ante 250
megun1008: posts the ante 250
bighand18: posts the ante 250
megun1008: posts small blind 1000
bighand18: posts big blind 2000
*** HOLE CARDS ***
Dealt to JJin91 [9s 6d]
hockingjoe: folds=20
FizzEdJohn: folds=20
ytc25: raises 25232 to 27232 and is all-in
JJin91: folds=20
slb9724: folds=20
kidpokerUNO: folds=20
megun1008: folds=20
bighand18: folds=20
Uncalled bet (25232) returned to ytc25
ytc25 collected 7000 from pot
ytc25: doesn't show hand=20
*** SUMMARY ***
Total pot 7000 | Rake 0=20
Seat 1: hockingjoe folded before Flop (didn't bet)
Seat 3: FizzEdJohn folded before Flop (didn't bet)
Seat 4: ytc25 collected (7000)
Seat 5: JJin91 folded before Flop (didn't bet)
Seat 6: slb9724 folded before Flop (didn't bet)
Seat 7: kidpokerUNO (button) folded before Flop (didn't bet)
Seat 8: megun1008 (small blind) folded before Flop
Seat 9: bighand18 (big blind) folded before Flop


*********** # 121 **************
PokerStars Hand #170341262144: Tournament #1622573245, $4.55+$0.45 USD =
Hold'em No Limit - Level XIX (1000/2000) - 2017/05/24 22:38:47 ET
Table '1622573245 8' 9-max Seat #8 is the button
Seat 1: hockingjoe (63475 in chips)=20
Seat 3: FizzEdJohn (30577 in chips)=20
Seat 4: ytc25 (32232 in chips)=20
Seat 5: JJin91 (62979 in chips)=20
Seat 6: slb9724 (54458 in chips)=20
Seat 7: kidpokerUNO (6938 in chips)=20
Seat 8: megun1008 (29109 in chips)=20
Seat 9: bighand18 (27476 in chips)=20
hockingjoe: posts the ante 250
FizzEdJohn: posts the ante 250
ytc25: posts the ante 250
JJin91: posts the ante 250
slb9724: posts the ante 250
kidpokerUNO: posts the ante 250
megun1008: posts the ante 250
bighand18: posts the ante 250
bighand18: posts small blind 1000
hockingjoe: posts big blind 2000
*** HOLE CARDS ***
Dealt to JJin91 [6d 3c]
FizzEdJohn: folds=20
ytc25: folds=20
JJin91: folds=20
slb9724: folds=20
kidpokerUNO: raises 4688 to 6688 and is all-in
megun1008: calls 6688
bighand18: folds=20
hockingjoe: calls 4688
*** FLOP *** [4c Th Qh]
hockingjoe: bets 32000
megun1008: folds=20
Uncalled bet (32000) returned to hockingjoe
*** TURN *** [4c Th Qh] [7s]
*** RIVER *** [4c Th Qh 7s] [2c]
*** SHOW DOWN ***
hockingjoe: shows [Qs Ks] (a pair of Queens)
kidpokerUNO: shows [As 7c] (a pair of Sevens)
hockingjoe collected 23064 from pot
kidpokerUNO finished the tournament in 26th place
*** SUMMARY ***
Total pot 23064 | Rake 0=20
Board [4c Th Qh 7s 2c]
Seat 1: hockingjoe (big blind) showed [Qs Ks] and won (23064) with a pa=
ir of Queens
Seat 3: FizzEdJohn folded before Flop (didn't bet)
Seat 4: ytc25 folded before Flop (didn't bet)
Seat 5: JJin91 folded before Flop (didn't bet)
Seat 6: slb9724 folded before Flop (didn't bet)
Seat 7: kidpokerUNO showed [As 7c] and lost with a pair of Sevens
Seat 8: megun1008 (button) folded on the Flop
Seat 9: bighand18 (small blind) folded before Flop


*********** # 122 **************
PokerStars Hand #170341262288: Tournament #1622573245, $4.55+$0.45 USD =
Hold'em No Limit - Level XIX (1000/2000) - 2017/05/24 22:39:20 ET
Table '1622573245 8' 9-max Seat #9 is the button
Seat 1: hockingjoe (79601 in chips)=20
Seat 3: FizzEdJohn (30327 in chips)=20
Seat 4: ytc25 (31982 in chips)=20
Seat 5: JJin91 (62729 in chips)=20
Seat 6: slb9724 (54208 in chips)=20
Seat 8: megun1008 (22171 in chips)=20
Seat 9: bighand18 (26226 in chips)=20
hockingjoe: posts the ante 250
FizzEdJohn: posts the ante 250
ytc25: posts the ante 250
JJin91: posts the ante 250
slb9724: posts the ante 250
megun1008: posts the ante 250
bighand18: posts the ante 250
hockingjoe: posts small blind 1000
FizzEdJohn: posts big blind 2000
*** HOLE CARDS ***
Dealt to JJin91 [5c Td]
ytc25: raises 29732 to 31732 and is all-in
JJin91: folds=20
slb9724: folds=20
megun1008: folds=20
bighand18: folds=20
hockingjoe: folds=20
FizzEdJohn: calls 28077 and is all-in
Uncalled bet (1655) returned to ytc25
*** FLOP *** [Qd 4c Jd]
*** TURN *** [Qd 4c Jd] [9d]
*** RIVER *** [Qd 4c Jd 9d] [2c]
*** SHOW DOWN ***
FizzEdJohn: shows [Qh Ah] (a pair of Queens)
ytc25: shows [Th Ac] (high card Ace)
FizzEdJohn collected 62904 from pot
*** SUMMARY ***
Total pot 62904 | Rake 0=20
Board [Qd 4c Jd 9d 2c]
Seat 1: hockingjoe (small blind) folded before Flop
Seat 3: FizzEdJohn (big blind) showed [Qh Ah] and won (62904) with a pa=
ir of Queens
Seat 4: ytc25 showed [Th Ac] and lost with high card Ace
Seat 5: JJin91 folded before Flop (didn't bet)
Seat 6: slb9724 folded before Flop (didn't bet)
Seat 8: megun1008 folded before Flop (didn't bet)
Seat 9: bighand18 (button) folded before Flop (didn't bet)


*********** # 123 **************
PokerStars Hand #170341262400: Tournament #1622573245, $4.55+$0.45 USD =
Hold'em No Limit - Level XIX (1000/2000) - 2017/05/24 22:39:43 ET
Table '1622573245 8' 9-max Seat #1 is the button
Seat 1: hockingjoe (78351 in chips)=20
Seat 2: LUVthoseNUTZ (28994 in chips) out of hand (moved from another t=
able into small blind)
Seat 3: FizzEdJohn (62904 in chips)=20
Seat 4: ytc25 (1655 in chips)=20
Seat 5: JJin91 (62479 in chips)=20
Seat 6: slb9724 (53958 in chips)=20
Seat 8: megun1008 (21921 in chips)=20
Seat 9: bighand18 (25976 in chips)=20
hockingjoe: posts the ante 250
FizzEdJohn: posts the ante 250
ytc25: posts the ante 250
JJin91: posts the ante 250
slb9724: posts the ante 250
megun1008: posts the ante 250
bighand18: posts the ante 250
FizzEdJohn: posts small blind 1000
ytc25: posts big blind 1405 and is all-in
*** HOLE CARDS ***
Dealt to JJin91 [3d Th]
JJin91: folds=20
slb9724: folds=20
megun1008: folds=20
bighand18: folds=20
hockingjoe: folds=20
FizzEdJohn: calls 405
*** FLOP *** [4d 7d Qc]
*** TURN *** [4d 7d Qc] [5h]
*** RIVER *** [4d 7d Qc 5h] [2d]
*** SHOW DOWN ***
FizzEdJohn: shows [4c 8c] (a pair of Fours)
ytc25: shows [5c Kh] (a pair of Fives)
ytc25 collected 4560 from pot
*** SUMMARY ***
Total pot 4560 | Rake 0=20
Board [4d 7d Qc 5h 2d]
Seat 1: hockingjoe (button) folded before Flop (didn't bet)
Seat 3: FizzEdJohn (small blind) showed [4c 8c] and lost with a pair of=
 Fours
Seat 4: ytc25 (big blind) showed [5c Kh] and won (4560) with a pair of =
Fives
Seat 5: JJin91 folded before Flop (didn't bet)
Seat 6: slb9724 folded before Flop (didn't bet)
Seat 8: megun1008 folded before Flop (didn't bet)
Seat 9: bighand18 folded before Flop (didn't bet)


*********** # 124 **************
PokerStars Hand #170341262495: Tournament #1622573245, $4.55+$0.45 USD =
Hold'em No Limit - Level XIX (1000/2000) - 2017/05/24 22:40:02 ET
Table '1622573245 8' 9-max Seat #3 is the button
Seat 1: hockingjoe (78101 in chips)=20
Seat 2: LUVthoseNUTZ (28994 in chips)=20
Seat 3: FizzEdJohn (61249 in chips)=20
Seat 4: ytc25 (4560 in chips)=20
Seat 5: JJin91 (62229 in chips)=20
Seat 6: slb9724 (53708 in chips)=20
Seat 8: megun1008 (21671 in chips)=20
Seat 9: bighand18 (25726 in chips)=20
hockingjoe: posts the ante 250
LUVthoseNUTZ: posts the ante 250
FizzEdJohn: posts the ante 250
ytc25: posts the ante 250
JJin91: posts the ante 250
slb9724: posts the ante 250
megun1008: posts the ante 250
bighand18: posts the ante 250
ytc25: posts small blind 1000
JJin91: posts big blind 2000
*** HOLE CARDS ***
Dealt to JJin91 [Jh 3d]
slb9724: folds=20
megun1008: folds=20
bighand18: folds=20
hockingjoe: folds=20
LUVthoseNUTZ: raises 7000 to 9000
FizzEdJohn: folds=20
ytc25: calls 3310 and is all-in
JJin91: folds=20
Uncalled bet (4690) returned to LUVthoseNUTZ
*** FLOP *** [Qc Kc 5c]
*** TURN *** [Qc Kc 5c] [8d]
*** RIVER *** [Qc Kc 5c 8d] [2c]
*** SHOW DOWN ***
ytc25: shows [4s 7s] (high card King)
LUVthoseNUTZ: shows [9d 9s] (a pair of Nines)
LUVthoseNUTZ collected 12620 from pot
ytc25 finished the tournament in 25th place
*** SUMMARY ***
Total pot 12620 | Rake 0=20
Board [Qc Kc 5c 8d 2c]
Seat 1: hockingjoe folded before Flop (didn't bet)
Seat 2: LUVthoseNUTZ showed [9d 9s] and won (12620) with a pair of Nines
Seat 3: FizzEdJohn (button) folded before Flop (didn't bet)
Seat 4: ytc25 (small blind) showed [4s 7s] and lost with high card King
Seat 5: JJin91 (big blind) folded before Flop
Seat 6: slb9724 folded before Flop (didn't bet)
Seat 8: megun1008 folded before Flop (didn't bet)
Seat 9: bighand18 folded before Flop (didn't bet)


*********** # 125 **************
PokerStars Hand #170341262583: Tournament #1622573245, $4.55+$0.45 USD =
Hold'em No Limit - Level XIX (1000/2000) - 2017/05/24 22:40:24 ET
Table '1622573245 8' 9-max Seat #5 is the button
Seat 1: hockingjoe (77851 in chips)=20
Seat 2: LUVthoseNUTZ (37054 in chips)=20
Seat 3: FizzEdJohn (60999 in chips)=20
Seat 5: JJin91 (59979 in chips)=20
Seat 6: slb9724 (53458 in chips)=20
Seat 8: megun1008 (21421 in chips)=20
Seat 9: bighand18 (25476 in chips)=20
hockingjoe: posts the ante 250
LUVthoseNUTZ: posts the ante 250
FizzEdJohn: posts the ante 250
JJin91: posts the ante 250
slb9724: posts the ante 250
megun1008: posts the ante 250
bighand18: posts the ante 250
slb9724: posts small blind 1000
megun1008: posts big blind 2000
*** HOLE CARDS ***
Dealt to JJin91 [8s Jh]
bighand18: folds=20
hockingjoe: folds=20
LUVthoseNUTZ: folds=20
FizzEdJohn: raises 2000 to 4000
JJin91: folds=20
slb9724: folds=20
megun1008: folds=20
Uncalled bet (2000) returned to FizzEdJohn
FizzEdJohn collected 6750 from pot
FizzEdJohn: doesn't show hand=20
*** SUMMARY ***
Total pot 6750 | Rake 0=20
Seat 1: hockingjoe folded before Flop (didn't bet)
Seat 2: LUVthoseNUTZ folded before Flop (didn't bet)
Seat 3: FizzEdJohn collected (6750)
Seat 5: JJin91 (button) folded before Flop (didn't bet)
Seat 6: slb9724 (small blind) folded before Flop
Seat 8: megun1008 (big blind) folded before Flop
Seat 9: bighand18 folded before Flop (didn't bet)


*********** # 126 **************
PokerStars Hand #170341262672: Tournament #1622573245, $4.55+$0.45 USD =
Hold'em No Limit - Level XIX (1000/2000) - 2017/05/24 22:40:42 ET
Table '1622573245 8' 9-max Seat #6 is the button
Seat 1: hockingjoe (77601 in chips)=20
Seat 2: LUVthoseNUTZ (36804 in chips)=20
Seat 3: FizzEdJohn (65499 in chips)=20
Seat 5: JJin91 (59729 in chips)=20
Seat 6: slb9724 (52208 in chips)=20
Seat 8: megun1008 (19171 in chips)=20
Seat 9: bighand18 (25226 in chips)=20
hockingjoe: posts the ante 250
LUVthoseNUTZ: posts the ante 250
FizzEdJohn: posts the ante 250
JJin91: posts the ante 250
slb9724: posts the ante 250
megun1008: posts the ante 250
bighand18: posts the ante 250
megun1008: posts small blind 1000
bighand18: posts big blind 2000
*** HOLE CARDS ***
Dealt to JJin91 [Jd 6s]
hockingjoe: folds=20
LUVthoseNUTZ: folds=20
FizzEdJohn: folds=20
JJin91: folds=20
slb9724: folds=20
megun1008: folds=20
Uncalled bet (1000) returned to bighand18
bighand18 collected 3750 from pot
bighand18: doesn't show hand=20
*** SUMMARY ***
Total pot 3750 | Rake 0=20
Seat 1: hockingjoe folded before Flop (didn't bet)
Seat 2: LUVthoseNUTZ folded before Flop (didn't bet)
Seat 3: FizzEdJohn folded before Flop (didn't bet)
Seat 5: JJin91 folded before Flop (didn't bet)
Seat 6: slb9724 (button) folded before Flop (didn't bet)
Seat 8: megun1008 (small blind) folded before Flop
Seat 9: bighand18 (big blind) collected (3750)


*********** # 127 **************
PokerStars Hand #170341262700: Tournament #1622573245, $4.55+$0.45 USD =
Hold'em No Limit - Level XIX (1000/2000) - 2017/05/24 22:40:51 ET
Table '1622573245 8' 9-max Seat #8 is the button
Seat 1: hockingjoe (77351 in chips)=20
Seat 2: LUVthoseNUTZ (36554 in chips)=20
Seat 3: FizzEdJohn (65249 in chips)=20
Seat 5: JJin91 (59479 in chips)=20
Seat 6: slb9724 (51958 in chips)=20
Seat 8: megun1008 (17921 in chips)=20
Seat 9: bighand18 (27726 in chips)=20
hockingjoe: posts the ante 250
LUVthoseNUTZ: posts the ante 250
FizzEdJohn: posts the ante 250
JJin91: posts the ante 250
slb9724: posts the ante 250
megun1008: posts the ante 250
bighand18: posts the ante 250
bighand18: posts small blind 1000
hockingjoe: posts big blind 2000
*** HOLE CARDS ***
Dealt to JJin91 [2c 2d]
LUVthoseNUTZ: folds=20
FizzEdJohn: raises 2000 to 4000
JJin91: folds=20
slb9724: folds=20
megun1008: folds=20
bighand18: folds=20
hockingjoe: raises 6000 to 10000
FizzEdJohn: folds=20
Uncalled bet (6000) returned to hockingjoe
hockingjoe collected 10750 from pot
hockingjoe: doesn't show hand=20
*** SUMMARY ***
Total pot 10750 | Rake 0=20
Seat 1: hockingjoe (big blind) collected (10750)
Seat 2: LUVthoseNUTZ folded before Flop (didn't bet)
Seat 3: FizzEdJohn folded before Flop
Seat 5: JJin91 folded before Flop (didn't bet)
Seat 6: slb9724 folded before Flop (didn't bet)
Seat 8: megun1008 (button) folded before Flop (didn't bet)
Seat 9: bighand18 (small blind) folded before Flop


*********** # 128 **************
PokerStars Hand #170341262805: Tournament #1622573245, $4.55+$0.45 USD =
Hold'em No Limit - Level XIX (1000/2000) - 2017/05/24 22:41:16 ET
Table '1622573245 8' 9-max Seat #9 is the button
Seat 1: hockingjoe (83851 in chips)=20
Seat 2: LUVthoseNUTZ (36304 in chips)=20
Seat 3: FizzEdJohn (60999 in chips)=20
Seat 4: richsal1 (27431 in chips)=20
Seat 5: JJin91 (59229 in chips)=20
Seat 6: slb9724 (51708 in chips)=20
Seat 8: megun1008 (17671 in chips)=20
Seat 9: bighand18 (26476 in chips)=20
hockingjoe: posts the ante 250
LUVthoseNUTZ: posts the ante 250
FizzEdJohn: posts the ante 250
richsal1: posts the ante 250
JJin91: posts the ante 250
slb9724: posts the ante 250
megun1008: posts the ante 250
bighand18: posts the ante 250
hockingjoe: posts small blind 1000
LUVthoseNUTZ: posts big blind 2000
*** HOLE CARDS ***
Dealt to JJin91 [2h 3h]
FizzEdJohn: folds=20
richsal1: folds=20
JJin91: folds=20
slb9724: folds=20
megun1008: folds=20
bighand18: folds=20
hockingjoe: calls 1000
LUVthoseNUTZ: checks=20
*** FLOP *** [Jh Qs 8h]
hockingjoe: checks=20
LUVthoseNUTZ: bets 4000
hockingjoe: raises 68000 to 72000
LUVthoseNUTZ: calls 30054 and is all-in
Uncalled bet (37946) returned to hockingjoe
*** TURN *** [Jh Qs 8h] [6c]
*** RIVER *** [Jh Qs 8h 6c] [7d]
*** SHOW DOWN ***
hockingjoe: shows [Kd Kc] (a pair of Kings)
LUVthoseNUTZ: shows [6s Qh] (two pair, Queens and Sixes)
LUVthoseNUTZ collected 74108 from pot
*** SUMMARY ***
Total pot 74108 | Rake 0=20
Board [Jh Qs 8h 6c 7d]
Seat 1: hockingjoe (small blind) showed [Kd Kc] and lost with a pair of=
 Kings
Seat 2: LUVthoseNUTZ (big blind) showed [6s Qh] and won (74108) with tw=
o pair, Queens and Sixes
Seat 3: FizzEdJohn folded before Flop (didn't bet)
Seat 4: richsal1 folded before Flop (didn't bet)
Seat 5: JJin91 folded before Flop (didn't bet)
Seat 6: slb9724 folded before Flop (didn't bet)
Seat 8: megun1008 folded before Flop (didn't bet)
Seat 9: bighand18 (button) folded before Flop (didn't bet)


*********** # 129 **************
PokerStars Hand #170341262974: Tournament #1622573245, $4.55+$0.45 USD =
Hold'em No Limit - Level XX (1250/2500) - 2017/05/24 22:41:54 ET
Table '1622573245 8' 9-max Seat #1 is the button
Seat 1: hockingjoe (47547 in chips)=20
Seat 2: LUVthoseNUTZ (74108 in chips)=20
Seat 3: FizzEdJohn (60749 in chips)=20
Seat 4: richsal1 (27181 in chips)=20
Seat 5: JJin91 (58979 in chips)=20
Seat 6: slb9724 (51458 in chips)=20
Seat 8: megun1008 (17421 in chips)=20
Seat 9: bighand18 (26226 in chips)=20
hockingjoe: posts the ante 325
LUVthoseNUTZ: posts the ante 325
FizzEdJohn: posts the ante 325
richsal1: posts the ante 325
JJin91: posts the ante 325
slb9724: posts the ante 325
megun1008: posts the ante 325
bighand18: posts the ante 325
LUVthoseNUTZ: posts small blind 1250
FizzEdJohn: posts big blind 2500
*** HOLE CARDS ***
Dealt to JJin91 [5h 8d]
richsal1: folds=20
JJin91: folds=20
slb9724: folds=20
megun1008: folds=20
bighand18: folds=20
hockingjoe: folds=20
hockingjoe said, ":("
LUVthoseNUTZ: raises 2500 to 5000
FizzEdJohn: calls 2500
*** FLOP *** [8h Qs Th]
LUVthoseNUTZ: bets 4536
FizzEdJohn: folds=20
Uncalled bet (4536) returned to LUVthoseNUTZ
LUVthoseNUTZ collected 12600 from pot
LUVthoseNUTZ: doesn't show hand=20
*** SUMMARY ***
Total pot 12600 | Rake 0=20
Board [8h Qs Th]
Seat 1: hockingjoe (button) folded before Flop (didn't bet)
Seat 2: LUVthoseNUTZ (small blind) collected (12600)
Seat 3: FizzEdJohn (big blind) folded on the Flop
Seat 4: richsal1 folded before Flop (didn't bet)
Seat 5: JJin91 folded before Flop (didn't bet)
Seat 6: slb9724 folded before Flop (didn't bet)
Seat 8: megun1008 folded before Flop (didn't bet)
Seat 9: bighand18 folded before Flop (didn't bet)


*********** # 130 **************
PokerStars Hand #170341263123: Tournament #1622573245, $4.55+$0.45 USD =
Hold'em No Limit - Level XX (1250/2500) - 2017/05/24 22:42:30 ET
Table '1622573245 8' 9-max Seat #2 is the button
Seat 1: hockingjoe (47222 in chips)=20
Seat 2: LUVthoseNUTZ (81383 in chips)=20
Seat 3: FizzEdJohn (55424 in chips)=20
Seat 4: richsal1 (26856 in chips)=20
Seat 5: JJin91 (58654 in chips)=20
Seat 6: slb9724 (51133 in chips)=20
Seat 8: megun1008 (17096 in chips)=20
Seat 9: bighand18 (25901 in chips)=20
hockingjoe: posts the ante 325
LUVthoseNUTZ: posts the ante 325
FizzEdJohn: posts the ante 325
richsal1: posts the ante 325
JJin91: posts the ante 325
slb9724: posts the ante 325
megun1008: posts the ante 325
bighand18: posts the ante 325
FizzEdJohn: posts small blind 1250
richsal1: posts big blind 2500
*** HOLE CARDS ***
Dealt to JJin91 [Kh 5s]
JJin91: folds=20
slb9724: raises 2500 to 5000
megun1008: folds=20
bighand18: folds=20
hockingjoe: folds=20
LUVthoseNUTZ: calls 5000
FizzEdJohn: folds=20
richsal1: calls 2500
*** FLOP *** [4h 4c Ac]
richsal1: checks=20
slb9724: bets 9425
LUVthoseNUTZ: folds=20
richsal1: calls 9425
*** TURN *** [4h 4c Ac] [7c]
richsal1: checks=20
slb9724: checks=20
*** RIVER *** [4h 4c Ac 7c] [6d]
richsal1: bets 12106 and is all-in
slb9724: folds=20
Uncalled bet (12106) returned to richsal1
richsal1 collected 37700 from pot
richsal1: doesn't show hand=20
*** SUMMARY ***
Total pot 37700 | Rake 0=20
Board [4h 4c Ac 7c 6d]
Seat 1: hockingjoe folded before Flop (didn't bet)
Seat 2: LUVthoseNUTZ (button) folded on the Flop
Seat 3: FizzEdJohn (small blind) folded before Flop
Seat 4: richsal1 (big blind) collected (37700)
Seat 5: JJin91 folded before Flop (didn't bet)
Seat 6: slb9724 folded on the River
Seat 8: megun1008 folded before Flop (didn't bet)
Seat 9: bighand18 folded before Flop (didn't bet)


*********** # 131 **************
PokerStars Hand #170341263321: Tournament #1622573245, $4.55+$0.45 USD =
Hold'em No Limit - Level XX (1250/2500) - 2017/05/24 22:43:18 ET
Table '1622573245 8' 9-max Seat #3 is the button
Seat 1: hockingjoe (46897 in chips)=20
Seat 2: LUVthoseNUTZ (76058 in chips)=20
Seat 3: FizzEdJohn (53849 in chips)=20
Seat 4: richsal1 (49806 in chips)=20
Seat 5: JJin91 (58329 in chips)=20
Seat 6: slb9724 (36383 in chips)=20
Seat 8: megun1008 (16771 in chips)=20
Seat 9: bighand18 (25576 in chips)=20
hockingjoe: posts the ante 325
LUVthoseNUTZ: posts the ante 325
FizzEdJohn: posts the ante 325
richsal1: posts the ante 325
JJin91: posts the ante 325
slb9724: posts the ante 325
megun1008: posts the ante 325
bighand18: posts the ante 325
richsal1: posts small blind 1250
JJin91: posts big blind 2500
*** HOLE CARDS ***
Dealt to JJin91 [2c 2h]
slb9724: folds=20
megun1008: folds=20
bighand18: folds=20
hockingjoe: raises 5000 to 7500
LUVthoseNUTZ: folds=20
FizzEdJohn: folds=20
richsal1: folds=20
JJin91: calls 5000
*** FLOP *** [7s 4d Qc]
JJin91: checks=20
hockingjoe: bets 7500
JJin91: folds=20
Uncalled bet (7500) returned to hockingjoe
hockingjoe collected 18850 from pot
hockingjoe: doesn't show hand=20
*** SUMMARY ***
Total pot 18850 | Rake 0=20
Board [7s 4d Qc]
Seat 1: hockingjoe collected (18850)
Seat 2: LUVthoseNUTZ folded before Flop (didn't bet)
Seat 3: FizzEdJohn (button) folded before Flop (didn't bet)
Seat 4: richsal1 (small blind) folded before Flop
Seat 5: JJin91 (big blind) folded on the Flop
Seat 6: slb9724 folded before Flop (didn't bet)
Seat 8: megun1008 folded before Flop (didn't bet)
Seat 9: bighand18 folded before Flop (didn't bet)


*********** # 132 **************
PokerStars Hand #170341263526: Tournament #1622573245, $4.55+$0.45 USD =
Hold'em No Limit - Level XX (1250/2500) - 2017/05/24 22:44:04 ET
Table '1622573245 8' 9-max Seat #4 is the button
Seat 1: hockingjoe (57922 in chips)=20
Seat 2: LUVthoseNUTZ (75733 in chips)=20
Seat 3: FizzEdJohn (53524 in chips)=20
Seat 4: richsal1 (48231 in chips)=20
Seat 5: JJin91 (50504 in chips)=20
Seat 6: slb9724 (36058 in chips)=20
Seat 8: megun1008 (16446 in chips)=20
Seat 9: bighand18 (25251 in chips)=20
hockingjoe: posts the ante 325
LUVthoseNUTZ: posts the ante 325
FizzEdJohn: posts the ante 325
richsal1: posts the ante 325
JJin91: posts the ante 325
slb9724: posts the ante 325
megun1008: posts the ante 325
bighand18: posts the ante 325
JJin91: posts small blind 1250
slb9724: posts big blind 2500
*** HOLE CARDS ***
Dealt to JJin91 [6d 4c]
megun1008: folds=20
bighand18: folds=20
hockingjoe: folds=20
LUVthoseNUTZ: folds=20
FizzEdJohn: raises 2500 to 5000
richsal1: folds=20
JJin91: folds=20
slb9724: raises 7500 to 12500
FizzEdJohn: raises 40699 to 53199 and is all-in
slb9724: calls 23233 and is all-in
Uncalled bet (17466) returned to FizzEdJohn
*** FLOP *** [Jd Td 6h]
*** TURN *** [Jd Td 6h] [4s]
*** RIVER *** [Jd Td 6h 4s] [7c]
*** SHOW DOWN ***
slb9724: shows [Kh Ks] (a pair of Kings)
FizzEdJohn: shows [9s 9h] (a pair of Nines)
slb9724 collected 75316 from pot
*** SUMMARY ***
Total pot 75316 | Rake 0=20
Board [Jd Td 6h 4s 7c]
Seat 1: hockingjoe folded before Flop (didn't bet)
Seat 2: LUVthoseNUTZ folded before Flop (didn't bet)
Seat 3: FizzEdJohn showed [9s 9h] and lost with a pair of Nines
Seat 4: richsal1 (button) folded before Flop (didn't bet)
Seat 5: JJin91 (small blind) folded before Flop
Seat 6: slb9724 (big blind) showed [Kh Ks] and won (75316) with a pair =
of Kings
Seat 8: megun1008 folded before Flop (didn't bet)
Seat 9: bighand18 folded before Flop (didn't bet)


*********** # 133 **************
PokerStars Hand #170341263767: Tournament #1622573245, $4.55+$0.45 USD =
Hold'em No Limit - Level XX (1250/2500) - 2017/05/24 22:44:58 ET
Table '1622573245 8' 9-max Seat #5 is the button
Seat 1: hockingjoe (57597 in chips)=20
Seat 2: LUVthoseNUTZ (75408 in chips)=20
Seat 3: FizzEdJohn (17466 in chips)=20
Seat 4: richsal1 (47906 in chips)=20
Seat 5: JJin91 (48929 in chips)=20
Seat 6: slb9724 (75316 in chips)=20
Seat 8: megun1008 (16121 in chips)=20
Seat 9: bighand18 (24926 in chips)=20
hockingjoe: posts the ante 325
LUVthoseNUTZ: posts the ante 325
FizzEdJohn: posts the ante 325
richsal1: posts the ante 325
JJin91: posts the ante 325
slb9724: posts the ante 325
megun1008: posts the ante 325
bighand18: posts the ante 325
slb9724: posts small blind 1250
megun1008: posts big blind 2500
*** HOLE CARDS ***
Dealt to JJin91 [6h Kd]
bighand18: folds=20
hockingjoe: folds=20
LUVthoseNUTZ: folds=20
FizzEdJohn: raises 14641 to 17141 and is all-in
richsal1: folds=20
JJin91: raises 14641 to 31782
slb9724: folds=20
megun1008: folds=20
Uncalled bet (14641) returned to JJin91
*** FLOP *** [6s 5c 4h]
*** TURN *** [6s 5c 4h] [4s]
*** RIVER *** [6s 5c 4h 4s] [8h]
*** SHOW DOWN ***
FizzEdJohn: shows [Ad 7s] (a straight, Four to Eight)
JJin91: shows [6h Kd] (two pair, Sixes and Fours)
FizzEdJohn collected 40632 from pot
JJin91 said, ".... mis click lol"
*** SUMMARY ***
Total pot 40632 | Rake 0=20
Board [6s 5c 4h 4s 8h]
Seat 1: hockingjoe folded before Flop (didn't bet)
Seat 2: LUVthoseNUTZ folded before Flop (didn't bet)
Seat 3: FizzEdJohn showed [Ad 7s] and won (40632) with a straight, Four=
 to Eight
Seat 4: richsal1 folded before Flop (didn't bet)
Seat 5: JJin91 (button) showed [6h Kd] and lost with two pair, Sixes an=
d Fours
Seat 6: slb9724 (small blind) folded before Flop
Seat 8: megun1008 (big blind) folded before Flop
Seat 9: bighand18 folded before Flop (didn't bet)


*********** # 134 **************
PokerStars Hand #170341263864: Tournament #1622573245, $4.55+$0.45 USD =
Hold'em No Limit - Level XX (1250/2500) - 2017/05/24 22:45:22 ET
Table '1622573245 8' 9-max Seat #6 is the button
Seat 1: hockingjoe (57272 in chips)=20
Seat 2: LUVthoseNUTZ (75083 in chips)=20
Seat 3: FizzEdJohn (40632 in chips)=20
Seat 4: richsal1 (47581 in chips)=20
Seat 5: JJin91 (31463 in chips)=20
Seat 6: slb9724 (73741 in chips)=20
Seat 8: megun1008 (13296 in chips)=20
Seat 9: bighand18 (24601 in chips)=20
hockingjoe: posts the ante 325
LUVthoseNUTZ: posts the ante 325
FizzEdJohn: posts the ante 325
richsal1: posts the ante 325
JJin91: posts the ante 325
slb9724: posts the ante 325
megun1008: posts the ante 325
bighand18: posts the ante 325
megun1008: posts small blind 1250
bighand18: posts big blind 2500
*** HOLE CARDS ***
Dealt to JJin91 [Qs Qh]
hockingjoe: folds=20
LUVthoseNUTZ: folds=20
richsal1 said, "that was kinda quick"
FizzEdJohn: folds=20
richsal1: folds=20
JJin91 said, "i was looking at previous had lol"
JJin91: raises 2975 to 5475
slb9724: folds=20
megun1008: folds=20
bighand18: calls 2975
*** FLOP *** [2d 6s Ts]
bighand18: checks=20
JJin91: bets 5476
FizzEdJohn said, "oh my punt"
bighand18: folds=20
Uncalled bet (5476) returned to JJin91
JJin91 collected 14800 from pot
JJin91: doesn't show hand=20
*** SUMMARY ***
Total pot 14800 | Rake 0=20
Board [2d 6s Ts]
Seat 1: hockingjoe folded before Flop (didn't bet)
Seat 2: LUVthoseNUTZ folded before Flop (didn't bet)
Seat 3: FizzEdJohn folded before Flop (didn't bet)
Seat 4: richsal1 folded before Flop (didn't bet)
Seat 5: JJin91 collected (14800)
Seat 6: slb9724 (button) folded before Flop (didn't bet)
Seat 8: megun1008 (small blind) folded before Flop
Seat 9: bighand18 (big blind) folded on the Flop


*********** # 135 **************
PokerStars Hand #170341264070: Tournament #1622573245, $4.55+$0.45 USD =
Hold'em No Limit - Level XX (1250/2500) - 2017/05/24 22:46:06 ET
Table '1622573245 8' 9-max Seat #8 is the button
Seat 1: hockingjoe (56947 in chips)=20
Seat 2: LUVthoseNUTZ (74758 in chips)=20
Seat 3: FizzEdJohn (40307 in chips)=20
Seat 4: richsal1 (47256 in chips)=20
Seat 5: JJin91 (40463 in chips)=20
Seat 6: slb9724 (73416 in chips)=20
Seat 8: megun1008 (11721 in chips)=20
Seat 9: bighand18 (18801 in chips)=20
hockingjoe: posts the ante 325
LUVthoseNUTZ: posts the ante 325
FizzEdJohn: posts the ante 325
richsal1: posts the ante 325
JJin91: posts the ante 325
slb9724: posts the ante 325
megun1008: posts the ante 325
bighand18: posts the ante 325
bighand18: posts small blind 1250
hockingjoe: posts big blind 2500
*** HOLE CARDS ***
Dealt to JJin91 [3d 8s]
LUVthoseNUTZ: folds=20
FizzEdJohn: folds=20
richsal1: raises 2500 to 5000
JJin91: folds=20
JJin91 said, "=3D-/"
slb9724: folds=20
megun1008: folds=20
bighand18: folds=20
hockingjoe: folds=20
Uncalled bet (2500) returned to richsal1
richsal1 collected 8850 from pot
richsal1: doesn't show hand=20
*** SUMMARY ***
Total pot 8850 | Rake 0=20
Seat 1: hockingjoe (big blind) folded before Flop
Seat 2: LUVthoseNUTZ folded before Flop (didn't bet)
Seat 3: FizzEdJohn folded before Flop (didn't bet)
Seat 4: richsal1 collected (8850)
Seat 5: JJin91 folded before Flop (didn't bet)
Seat 6: slb9724 folded before Flop (didn't bet)
Seat 8: megun1008 (button) folded before Flop (didn't bet)
Seat 9: bighand18 (small blind) folded before Flop


*********** # 136 **************
PokerStars Hand #170341264146: Tournament #1622573245, $4.55+$0.45 USD =
Hold'em No Limit - Level XX (1250/2500) - 2017/05/24 22:46:25 ET
Table '1622573245 8' 9-max Seat #9 is the button
Seat 1: hockingjoe (54122 in chips)=20
Seat 2: LUVthoseNUTZ (74433 in chips)=20
Seat 3: FizzEdJohn (39982 in chips)=20
Seat 4: richsal1 (53281 in chips)=20
Seat 5: JJin91 (40138 in chips)=20
Seat 6: slb9724 (73091 in chips)=20
Seat 8: megun1008 (11396 in chips)=20
Seat 9: bighand18 (17226 in chips)=20
hockingjoe: posts the ante 325
LUVthoseNUTZ: posts the ante 325
FizzEdJohn: posts the ante 325
richsal1: posts the ante 325
JJin91: posts the ante 325
slb9724: posts the ante 325
megun1008: posts the ante 325
bighand18: posts the ante 325
hockingjoe: posts small blind 1250
LUVthoseNUTZ: posts big blind 2500
*** HOLE CARDS ***
Dealt to JJin91 [2c 8h]
JJin91 said, "sucks playing on a laptop with small ass screeen lol"
FizzEdJohn: raises 37157 to 39657 and is all-in
richsal1: folds=20
JJin91: folds=20
slb9724: folds=20
megun1008: calls 11071 and is all-in
bighand18: folds=20
hockingjoe: folds=20
LUVthoseNUTZ: folds=20
Uncalled bet (28586) returned to FizzEdJohn
*** FLOP *** [Kh Ts Kd]
richsal1 said, "try on ur phone"
*** TURN *** [Kh Ts Kd] [Ah]
*** RIVER *** [Kh Ts Kd Ah] [5s]
*** SHOW DOWN ***
FizzEdJohn: shows [6h 6c] (two pair, Kings and Sixes)
megun1008: shows [Ks As] (a full house, Kings full of Aces)
megun1008 collected 28492 from pot
*** SUMMARY ***
Total pot 28492 | Rake 0=20
Board [Kh Ts Kd Ah 5s]
Seat 1: hockingjoe (small blind) folded before Flop
Seat 2: LUVthoseNUTZ (big blind) folded before Flop
Seat 3: FizzEdJohn showed [6h 6c] and lost with two pair, Kings and Six=
es
Seat 4: richsal1 folded before Flop (didn't bet)
Seat 5: JJin91 folded before Flop (didn't bet)
Seat 6: slb9724 folded before Flop (didn't bet)
Seat 8: megun1008 showed [Ks As] and won (28492) with a full house, Kin=
gs full of Aces
Seat 9: bighand18 (button) folded before Flop (didn't bet)


*********** # 137 **************
PokerStars Hand #170341264288: Tournament #1622573245, $4.55+$0.45 USD =
Hold'em No Limit - Level XXI (1500/3000) - 2017/05/24 22:46:56 ET
Table '1622573245 8' 9-max Seat #1 is the button
Seat 1: hockingjoe (52547 in chips)=20
Seat 2: LUVthoseNUTZ (71608 in chips)=20
Seat 3: FizzEdJohn (28586 in chips)=20
Seat 4: richsal1 (52956 in chips)=20
Seat 5: JJin91 (39813 in chips)=20
Seat 6: slb9724 (72766 in chips)=20
Seat 8: megun1008 (28492 in chips)=20
Seat 9: bighand18 (16901 in chips)=20
hockingjoe: posts the ante 375
LUVthoseNUTZ: posts the ante 375
FizzEdJohn: posts the ante 375
richsal1: posts the ante 375
JJin91: posts the ante 375
slb9724: posts the ante 375
megun1008: posts the ante 375
bighand18: posts the ante 375
LUVthoseNUTZ: posts small blind 1500
FizzEdJohn: posts big blind 3000
*** HOLE CARDS ***
Dealt to JJin91 [2d 8c]
richsal1: folds=20
JJin91: folds=20
slb9724: folds=20
megun1008: folds=20
bighand18: raises 13526 to 16526 and is all-in
hockingjoe: folds=20
LUVthoseNUTZ: folds=20
FizzEdJohn: folds=20
Uncalled bet (13526) returned to bighand18
bighand18 collected 10500 from pot
bighand18: doesn't show hand=20
*** SUMMARY ***
Total pot 10500 | Rake 0=20
Seat 1: hockingjoe (button) folded before Flop (didn't bet)
Seat 2: LUVthoseNUTZ (small blind) folded before Flop
Seat 3: FizzEdJohn (big blind) folded before Flop
Seat 4: richsal1 folded before Flop (didn't bet)
Seat 5: JJin91 folded before Flop (didn't bet)
Seat 6: slb9724 folded before Flop (didn't bet)
Seat 8: megun1008 folded before Flop (didn't bet)
Seat 9: bighand18 collected (10500)


*********** # 138 **************
PokerStars Hand #170341264373: Tournament #1622573245, $4.55+$0.45 USD =
Hold'em No Limit - Level XXI (1500/3000) - 2017/05/24 22:47:17 ET
Table '1622573245 8' 9-max Seat #2 is the button
Seat 1: hockingjoe (52172 in chips)=20
Seat 2: LUVthoseNUTZ (69733 in chips)=20
Seat 3: FizzEdJohn (25211 in chips)=20
Seat 4: richsal1 (52581 in chips)=20
Seat 5: JJin91 (39438 in chips)=20
Seat 6: slb9724 (72391 in chips)=20
Seat 8: megun1008 (28117 in chips)=20
Seat 9: bighand18 (24026 in chips)=20
hockingjoe: posts the ante 375
LUVthoseNUTZ: posts the ante 375
FizzEdJohn: posts the ante 375
richsal1: posts the ante 375
JJin91: posts the ante 375
slb9724: posts the ante 375
megun1008: posts the ante 375
bighand18: posts the ante 375
FizzEdJohn: posts small blind 1500
richsal1: posts big blind 3000
*** HOLE CARDS ***
Dealt to JJin91 [Ts 6h]
JJin91: folds=20
slb9724: folds=20
megun1008: folds=20
bighand18: folds=20
hockingjoe: folds=20
LUVthoseNUTZ: raises 3300 to 6300
FizzEdJohn: folds=20
richsal1: folds=20
Uncalled bet (3300) returned to LUVthoseNUTZ
LUVthoseNUTZ collected 10500 from pot
LUVthoseNUTZ: doesn't show hand=20
*** SUMMARY ***
Total pot 10500 | Rake 0=20
Seat 1: hockingjoe folded before Flop (didn't bet)
Seat 2: LUVthoseNUTZ (button) collected (10500)
Seat 3: FizzEdJohn (small blind) folded before Flop
Seat 4: richsal1 (big blind) folded before Flop
Seat 5: JJin91 folded before Flop (didn't bet)
Seat 6: slb9724 folded before Flop (didn't bet)
Seat 8: megun1008 folded before Flop (didn't bet)
Seat 9: bighand18 folded before Flop (didn't bet)


*********** # 139 **************
PokerStars Hand #170341264472: Tournament #1622573245, $4.55+$0.45 USD =
Hold'em No Limit - Level XXI (1500/3000) - 2017/05/24 22:47:44 ET
Table '1622573245 8' 9-max Seat #3 is the button
Seat 1: hockingjoe (51797 in chips)=20
Seat 2: LUVthoseNUTZ (76858 in chips)=20
Seat 3: FizzEdJohn (23336 in chips)=20
Seat 4: richsal1 (49206 in chips)=20
Seat 5: JJin91 (39063 in chips)=20
Seat 6: slb9724 (72016 in chips)=20
Seat 8: megun1008 (27742 in chips)=20
Seat 9: bighand18 (23651 in chips)=20
hockingjoe: posts the ante 375
LUVthoseNUTZ: posts the ante 375
FizzEdJohn: posts the ante 375
richsal1: posts the ante 375
JJin91: posts the ante 375
slb9724: posts the ante 375
megun1008: posts the ante 375
bighand18: posts the ante 375
richsal1: posts small blind 1500
JJin91: posts big blind 3000
*** HOLE CARDS ***
Dealt to JJin91 [3c Ac]
slb9724: folds=20
megun1008: calls 3000
bighand18: folds=20
hockingjoe: folds=20
LUVthoseNUTZ: folds=20
FizzEdJohn: folds=20
richsal1: folds=20
JJin91 said, "i want to pay 2 tables atleast tho lol"
JJin91: checks=20
*** FLOP *** [Th 6c Jd]
JJin91: checks=20
megun1008: bets 6000
JJin91: calls 6000
*** TURN *** [Th 6c Jd] [9h]
JJin91: checks=20
megun1008: checks=20
*** RIVER *** [Th 6c Jd 9h] [7s]
JJin91: checks=20
megun1008: checks=20
*** SHOW DOWN ***
JJin91: shows [3c Ac] (high card Ace)
megun1008: shows [3s As] (high card Ace)
JJin91 collected 11250 from pot
megun1008 collected 11250 from pot
*** SUMMARY ***
Total pot 22500 | Rake 0=20
Board [Th 6c Jd 9h 7s]
Seat 1: hockingjoe folded before Flop (didn't bet)
Seat 2: LUVthoseNUTZ folded before Flop (didn't bet)
Seat 3: FizzEdJohn (button) folded before Flop (didn't bet)
Seat 4: richsal1 (small blind) folded before Flop
Seat 5: JJin91 (big blind) showed [3c Ac] and won (11250) with high car=
d Ace
Seat 6: slb9724 folded before Flop (didn't bet)
Seat 8: megun1008 showed [3s As] and won (11250) with high card Ace
Seat 9: bighand18 folded before Flop (didn't bet)


*********** # 140 **************
PokerStars Hand #170341264623: Tournament #1622573245, $4.55+$0.45 USD =
Hold'em No Limit - Level XXI (1500/3000) - 2017/05/24 22:48:21 ET
Table '1622573245 8' 9-max Seat #4 is the button
Seat 1: hockingjoe (51422 in chips)=20
Seat 2: LUVthoseNUTZ (76483 in chips)=20
Seat 3: FizzEdJohn (22961 in chips)=20
Seat 4: richsal1 (47331 in chips)=20
Seat 5: JJin91 (40938 in chips)=20
Seat 6: slb9724 (71641 in chips)=20
Seat 8: megun1008 (29617 in chips)=20
Seat 9: bighand18 (23276 in chips)=20
hockingjoe: posts the ante 375
LUVthoseNUTZ: posts the ante 375
FizzEdJohn: posts the ante 375
richsal1: posts the ante 375
JJin91: posts the ante 375
slb9724: posts the ante 375
megun1008: posts the ante 375
bighand18: posts the ante 375
JJin91: posts small blind 1500
slb9724: posts big blind 3000
*** HOLE CARDS ***
Dealt to JJin91 [5h Th]
megun1008: folds=20
bighand18: folds=20
hockingjoe: folds=20
LUVthoseNUTZ: folds=20
FizzEdJohn: folds=20
richsal1: folds=20
JJin91: folds=20
Uncalled bet (1500) returned to slb9724
slb9724 collected 6000 from pot
slb9724: doesn't show hand=20
*** SUMMARY ***
Total pot 6000 | Rake 0=20
Seat 1: hockingjoe folded before Flop (didn't bet)
Seat 2: LUVthoseNUTZ folded before Flop (didn't bet)
Seat 3: FizzEdJohn folded before Flop (didn't bet)
Seat 4: richsal1 (button) folded before Flop (didn't bet)
Seat 5: JJin91 (small blind) folded before Flop
Seat 6: slb9724 (big blind) collected (6000)
Seat 8: megun1008 folded before Flop (didn't bet)
Seat 9: bighand18 folded before Flop (didn't bet)


*********** # 141 **************
PokerStars Hand #170341264672: Tournament #1622573245, $4.55+$0.45 USD =
Hold'em No Limit - Level XXI (1500/3000) - 2017/05/24 22:48:32 ET
Table '1622573245 8' 9-max Seat #5 is the button
Seat 1: hockingjoe (51047 in chips)=20
Seat 2: LUVthoseNUTZ (76108 in chips)=20
Seat 3: FizzEdJohn (22586 in chips)=20
Seat 4: richsal1 (46956 in chips)=20
Seat 5: JJin91 (39063 in chips)=20
Seat 6: slb9724 (75766 in chips)=20
Seat 8: megun1008 (29242 in chips)=20
Seat 9: bighand18 (22901 in chips)=20
hockingjoe: posts the ante 375
LUVthoseNUTZ: posts the ante 375
FizzEdJohn: posts the ante 375
richsal1: posts the ante 375
JJin91: posts the ante 375
slb9724: posts the ante 375
megun1008: posts the ante 375
bighand18: posts the ante 375
slb9724: posts small blind 1500
megun1008: posts big blind 3000
*** HOLE CARDS ***
Dealt to JJin91 [3d 9h]
bighand18: folds=20
hockingjoe: folds=20
LUVthoseNUTZ: folds=20
FizzEdJohn: folds=20
richsal1: folds=20
JJin91: folds=20
slb9724: folds=20
Uncalled bet (1500) returned to megun1008
megun1008 collected 6000 from pot
megun1008: doesn't show hand=20
*** SUMMARY ***
Total pot 6000 | Rake 0=20
Seat 1: hockingjoe folded before Flop (didn't bet)
Seat 2: LUVthoseNUTZ folded before Flop (didn't bet)
Seat 3: FizzEdJohn folded before Flop (didn't bet)
Seat 4: richsal1 folded before Flop (didn't bet)
Seat 5: JJin91 (button) folded before Flop (didn't bet)
Seat 6: slb9724 (small blind) folded before Flop
Seat 8: megun1008 (big blind) collected (6000)
Seat 9: bighand18 folded before Flop (didn't bet)


*********** # 142 **************
PokerStars Hand #170341264714: Tournament #1622573245, $4.55+$0.45 USD =
Hold'em No Limit - Level XXI (1500/3000) - 2017/05/24 22:48:42 ET
Table '1622573245 8' 9-max Seat #6 is the button
Seat 1: hockingjoe (50672 in chips)=20
Seat 2: LUVthoseNUTZ (75733 in chips)=20
Seat 3: FizzEdJohn (22211 in chips)=20
Seat 4: richsal1 (46581 in chips)=20
Seat 5: JJin91 (38688 in chips)=20
Seat 6: slb9724 (73891 in chips)=20
Seat 8: megun1008 (33367 in chips)=20
Seat 9: bighand18 (22526 in chips)=20
hockingjoe: posts the ante 375
LUVthoseNUTZ: posts the ante 375
FizzEdJohn: posts the ante 375
richsal1: posts the ante 375
JJin91: posts the ante 375
slb9724: posts the ante 375
megun1008: posts the ante 375
bighand18: posts the ante 375
megun1008: posts small blind 1500
bighand18: posts big blind 3000
*** HOLE CARDS ***
Dealt to JJin91 [As 7c]
hockingjoe: folds=20
LUVthoseNUTZ: raises 3750 to 6750
FizzEdJohn: folds=20
richsal1: folds=20
JJin91: folds=20
slb9724: folds=20
megun1008: calls 5250
bighand18: folds=20
*** FLOP *** [2c 4c Ts]
megun1008: checks=20
LUVthoseNUTZ: bets 10140
megun1008: folds=20
Uncalled bet (10140) returned to LUVthoseNUTZ
LUVthoseNUTZ collected 19500 from pot
LUVthoseNUTZ: doesn't show hand=20
*** SUMMARY ***
Total pot 19500 | Rake 0=20
Board [2c 4c Ts]
Seat 1: hockingjoe folded before Flop (didn't bet)
Seat 2: LUVthoseNUTZ collected (19500)
Seat 3: FizzEdJohn folded before Flop (didn't bet)
Seat 4: richsal1 folded before Flop (didn't bet)
Seat 5: JJin91 folded before Flop (didn't bet)
Seat 6: slb9724 (button) folded before Flop (didn't bet)
Seat 8: megun1008 (small blind) folded on the Flop
Seat 9: bighand18 (big blind) folded before Flop


*********** # 143 **************
PokerStars Hand #170341264885: Tournament #1622573245, $4.55+$0.45 USD =
Hold'em No Limit - Level XXI (1500/3000) - 2017/05/24 22:49:29 ET
Table '1622573245 8' 9-max Seat #8 is the button
Seat 1: hockingjoe (50297 in chips)=20
Seat 2: LUVthoseNUTZ (88108 in chips)=20
Seat 3: FizzEdJohn (21836 in chips)=20
Seat 4: richsal1 (46206 in chips)=20
Seat 5: JJin91 (38313 in chips)=20
Seat 6: slb9724 (73516 in chips)=20
Seat 8: megun1008 (26242 in chips)=20
Seat 9: bighand18 (19151 in chips)=20
hockingjoe: posts the ante 375
LUVthoseNUTZ: posts the ante 375
FizzEdJohn: posts the ante 375
richsal1: posts the ante 375
JJin91: posts the ante 375
slb9724: posts the ante 375
megun1008: posts the ante 375
bighand18: posts the ante 375
bighand18: posts small blind 1500
hockingjoe: posts big blind 3000
*** HOLE CARDS ***
Dealt to JJin91 [Qd 7c]
LUVthoseNUTZ: folds=20
FizzEdJohn: folds=20
richsal1: folds=20
JJin91: folds=20
slb9724: folds=20
megun1008: folds=20
bighand18: folds=20
Uncalled bet (1500) returned to hockingjoe
hockingjoe collected 6000 from pot
hockingjoe: doesn't show hand=20
*** SUMMARY ***
Total pot 6000 | Rake 0=20
Seat 1: hockingjoe (big blind) collected (6000)
Seat 2: LUVthoseNUTZ folded before Flop (didn't bet)
Seat 3: FizzEdJohn folded before Flop (didn't bet)
Seat 4: richsal1 folded before Flop (didn't bet)
Seat 5: JJin91 folded before Flop (didn't bet)
Seat 6: slb9724 folded before Flop (didn't bet)
Seat 8: megun1008 (button) folded before Flop (didn't bet)
Seat 9: bighand18 (small blind) folded before Flop


*********** # 144 **************
PokerStars Hand #170341264944: Tournament #1622573245, $4.55+$0.45 USD =
Hold'em No Limit - Level XXI (1500/3000) - 2017/05/24 22:49:45 ET
Table '1622573245 8' 9-max Seat #9 is the button
Seat 1: hockingjoe (54422 in chips)=20
Seat 2: LUVthoseNUTZ (87733 in chips)=20
Seat 3: FizzEdJohn (21461 in chips)=20
Seat 4: richsal1 (45831 in chips)=20
Seat 5: JJin91 (37938 in chips)=20
Seat 6: slb9724 (73141 in chips)=20
Seat 8: megun1008 (25867 in chips)=20
Seat 9: bighand18 (17276 in chips)=20
hockingjoe: posts the ante 375
LUVthoseNUTZ: posts the ante 375
FizzEdJohn: posts the ante 375
richsal1: posts the ante 375
JJin91: posts the ante 375
slb9724: posts the ante 375
megun1008: posts the ante 375
bighand18: posts the ante 375
hockingjoe: posts small blind 1500
LUVthoseNUTZ: posts big blind 3000
*** HOLE CARDS ***
Dealt to JJin91 [Kh 8c]
FizzEdJohn: folds=20
richsal1: folds=20
JJin91: folds=20
slb9724: folds=20
megun1008: folds=20
bighand18: folds=20
hockingjoe: raises 6000 to 9000
LUVthoseNUTZ: folds=20
Uncalled bet (6000) returned to hockingjoe
hockingjoe collected 9000 from pot
hockingjoe: doesn't show hand=20
*** SUMMARY ***
Total pot 9000 | Rake 0=20
Seat 1: hockingjoe (small blind) collected (9000)
Seat 2: LUVthoseNUTZ (big blind) folded before Flop
Seat 3: FizzEdJohn folded before Flop (didn't bet)
Seat 4: richsal1 folded before Flop (didn't bet)
Seat 5: JJin91 folded before Flop (didn't bet)
Seat 6: slb9724 folded before Flop (didn't bet)
Seat 8: megun1008 folded before Flop (didn't bet)
Seat 9: bighand18 (button) folded before Flop (didn't bet)


*********** # 145 **************
PokerStars Hand #170341265024: Tournament #1622573245, $4.55+$0.45 USD =
Hold'em No Limit - Level XXI (1500/3000) - 2017/05/24 22:50:07 ET
Table '1622573245 8' 9-max Seat #1 is the button
Seat 1: hockingjoe (60047 in chips)=20
Seat 2: LUVthoseNUTZ (84358 in chips)=20
Seat 3: FizzEdJohn (21086 in chips)=20
Seat 4: richsal1 (45456 in chips)=20
Seat 5: JJin91 (37563 in chips)=20
Seat 6: slb9724 (72766 in chips)=20
Seat 8: megun1008 (25492 in chips)=20
Seat 9: bighand18 (16901 in chips)=20
hockingjoe: posts the ante 375
LUVthoseNUTZ: posts the ante 375
FizzEdJohn: posts the ante 375
richsal1: posts the ante 375
JJin91: posts the ante 375
slb9724: posts the ante 375
megun1008: posts the ante 375
bighand18: posts the ante 375
LUVthoseNUTZ: posts small blind 1500
FizzEdJohn: posts big blind 3000
*** HOLE CARDS ***
Dealt to JJin91 [Kd Jh]
richsal1: raises 3000 to 6000
JJin91: folds=20
slb9724: folds=20
megun1008: folds=20
bighand18: folds=20
hockingjoe: folds=20
LUVthoseNUTZ: folds=20
FizzEdJohn: folds=20
Uncalled bet (3000) returned to richsal1
richsal1 collected 10500 from pot
richsal1: doesn't show hand=20
*** SUMMARY ***
Total pot 10500 | Rake 0=20
Seat 1: hockingjoe (button) folded before Flop (didn't bet)
Seat 2: LUVthoseNUTZ (small blind) folded before Flop
Seat 3: FizzEdJohn (big blind) folded before Flop
Seat 4: richsal1 collected (10500)
Seat 5: JJin91 folded before Flop (didn't bet)
Seat 6: slb9724 folded before Flop (didn't bet)
Seat 8: megun1008 folded before Flop (didn't bet)
Seat 9: bighand18 folded before Flop (didn't bet)


*********** # 146 **************
PokerStars Hand #170341265126: Tournament #1622573245, $4.55+$0.45 USD =
Hold'em No Limit - Level XXI (1500/3000) - 2017/05/24 22:50:36 ET
Table '1622573245 8' 9-max Seat #2 is the button
Seat 1: hockingjoe (59672 in chips)=20
Seat 2: LUVthoseNUTZ (82483 in chips)=20
Seat 3: FizzEdJohn (17711 in chips)=20
Seat 4: richsal1 (52581 in chips)=20
Seat 5: JJin91 (37188 in chips)=20
Seat 6: slb9724 (72391 in chips)=20
Seat 9: bighand18 (16526 in chips)=20
hockingjoe: posts the ante 375
LUVthoseNUTZ: posts the ante 375
FizzEdJohn: posts the ante 375
richsal1: posts the ante 375
JJin91: posts the ante 375
slb9724: posts the ante 375
bighand18: posts the ante 375
FizzEdJohn: posts small blind 1500
richsal1: posts big blind 3000
*** HOLE CARDS ***
Dealt to JJin91 [Kh 3c]
JJin91: folds=20
slb9724: folds=20
bighand18: raises 13151 to 16151 and is all-in
hockingjoe: folds=20
LUVthoseNUTZ: folds=20
FizzEdJohn: folds=20
richsal1: folds=20
Uncalled bet (13151) returned to bighand18
bighand18 collected 10125 from pot
bighand18: doesn't show hand=20
*** SUMMARY ***
Total pot 10125 | Rake 0=20
Seat 1: hockingjoe folded before Flop (didn't bet)
Seat 2: LUVthoseNUTZ (button) folded before Flop (didn't bet)
Seat 3: FizzEdJohn (small blind) folded before Flop
Seat 4: richsal1 (big blind) folded before Flop
Seat 5: JJin91 folded before Flop (didn't bet)
Seat 6: slb9724 folded before Flop (didn't bet)
Seat 9: bighand18 collected (10125)


*********** # 147 **************
PokerStars Hand #170341265268: Tournament #1622573245, $4.55+$0.45 USD =
Hold'em No Limit - Level XXI (1500/3000) - 2017/05/24 22:51:11 ET
Table '1622573245 8' 9-max Seat #3 is the button
Seat 1: hockingjoe (59297 in chips)=20
Seat 2: LUVthoseNUTZ (82108 in chips)=20
Seat 3: FizzEdJohn (15836 in chips)=20
Seat 4: richsal1 (49206 in chips)=20
Seat 5: JJin91 (36813 in chips)=20
Seat 6: slb9724 (72016 in chips)=20
Seat 9: bighand18 (23276 in chips)=20
hockingjoe: posts the ante 375
LUVthoseNUTZ: posts the ante 375
FizzEdJohn: posts the ante 375
richsal1: posts the ante 375
JJin91: posts the ante 375
slb9724: posts the ante 375
bighand18: posts the ante 375
richsal1: posts small blind 1500
JJin91: posts big blind 3000
*** HOLE CARDS ***
Dealt to JJin91 [9h Jh]
slb9724: folds=20
bighand18: folds=20
hockingjoe: folds=20
LUVthoseNUTZ: folds=20
FizzEdJohn: raises 12461 to 15461 and is all-in
richsal1: folds=20
JJin91: folds=20
Uncalled bet (12461) returned to FizzEdJohn
FizzEdJohn collected 10125 from pot
FizzEdJohn: doesn't show hand=20
*** SUMMARY ***
Total pot 10125 | Rake 0=20
Seat 1: hockingjoe folded before Flop (didn't bet)
Seat 2: LUVthoseNUTZ folded before Flop (didn't bet)
Seat 3: FizzEdJohn (button) collected (10125)
Seat 4: richsal1 (small blind) folded before Flop
Seat 5: JJin91 (big blind) folded before Flop
Seat 6: slb9724 folded before Flop (didn't bet)
Seat 9: bighand18 folded before Flop (didn't bet)


*********** # 148 **************
PokerStars Hand #170341265401: Tournament #1622573245, $4.55+$0.45 USD =
Hold'em No Limit - Level XXII (2000/4000) - 2017/05/24 22:51:45 ET
Table '1622573245 8' 9-max Seat #4 is the button
Seat 1: hockingjoe (58922 in chips)=20
Seat 2: LUVthoseNUTZ (81733 in chips)=20
Seat 3: FizzEdJohn (22586 in chips)=20
Seat 4: richsal1 (47331 in chips)=20
Seat 5: JJin91 (33438 in chips)=20
Seat 6: slb9724 (71641 in chips)=20
Seat 9: bighand18 (22901 in chips)=20
hockingjoe: posts the ante 500
LUVthoseNUTZ: posts the ante 500
FizzEdJohn: posts the ante 500
richsal1: posts the ante 500
JJin91: posts the ante 500
slb9724: posts the ante 500
bighand18: posts the ante 500
JJin91: posts small blind 2000
slb9724: posts big blind 4000
*** HOLE CARDS ***
Dealt to JJin91 [2s 4d]
bighand18: folds=20
hockingjoe: folds=20
LUVthoseNUTZ: raises 4400 to 8400
FizzEdJohn: folds=20
richsal1: folds=20
JJin91: folds=20
slb9724: folds=20
Uncalled bet (4400) returned to LUVthoseNUTZ
LUVthoseNUTZ collected 13500 from pot
LUVthoseNUTZ: doesn't show hand=20
*** SUMMARY ***
Total pot 13500 | Rake 0=20
Seat 1: hockingjoe folded before Flop (didn't bet)
Seat 2: LUVthoseNUTZ collected (13500)
Seat 3: FizzEdJohn folded before Flop (didn't bet)
Seat 4: richsal1 (button) folded before Flop (didn't bet)
Seat 5: JJin91 (small blind) folded before Flop
Seat 6: slb9724 (big blind) folded before Flop
Seat 9: bighand18 folded before Flop (didn't bet)


*********** # 149 **************
PokerStars Hand #170341265485: Tournament #1622573245, $4.55+$0.45 USD =
Hold'em No Limit - Level XXII (2000/4000) - 2017/05/24 22:52:06 ET
Table '1622573245 8' 9-max Seat #5 is the button
Seat 1: hockingjoe (58422 in chips)=20
Seat 2: LUVthoseNUTZ (90733 in chips)=20
Seat 3: FizzEdJohn (22086 in chips)=20
Seat 4: richsal1 (46831 in chips)=20
Seat 5: JJin91 (30938 in chips)=20
Seat 6: slb9724 (67141 in chips)=20
Seat 9: bighand18 (22401 in chips)=20
hockingjoe: posts the ante 500
LUVthoseNUTZ: posts the ante 500
FizzEdJohn: posts the ante 500
richsal1: posts the ante 500
JJin91: posts the ante 500
slb9724: posts the ante 500
bighand18: posts the ante 500
slb9724: posts small blind 2000
bighand18: posts big blind 4000
*** HOLE CARDS ***
Dealt to JJin91 [9c Jh]
hockingjoe: folds=20
LUVthoseNUTZ: raises 4400 to 8400
FizzEdJohn: folds=20
richsal1: folds=20
JJin91: folds=20
slb9724: folds=20
bighand18: folds=20
Uncalled bet (4400) returned to LUVthoseNUTZ
LUVthoseNUTZ collected 13500 from pot
LUVthoseNUTZ: doesn't show hand=20
*** SUMMARY ***
Total pot 13500 | Rake 0=20
Seat 1: hockingjoe folded before Flop (didn't bet)
Seat 2: LUVthoseNUTZ collected (13500)
Seat 3: FizzEdJohn folded before Flop (didn't bet)
Seat 4: richsal1 folded before Flop (didn't bet)
Seat 5: JJin91 (button) folded before Flop (didn't bet)
Seat 6: slb9724 (small blind) folded before Flop
Seat 9: bighand18 (big blind) folded before Flop


*********** # 150 **************
PokerStars Hand #170341265667: Tournament #1622573245, $4.55+$0.45 USD =
Hold'em No Limit - Level XXII (2000/4000) - 2017/05/24 22:52:53 ET
Table '1622573245 8' 9-max Seat #6 is the button
Seat 1: hockingjoe (57922 in chips)=20
Seat 2: LUVthoseNUTZ (99733 in chips)=20
Seat 3: FizzEdJohn (21586 in chips)=20
Seat 4: richsal1 (46331 in chips)=20
Seat 5: JJin91 (30438 in chips)=20
Seat 6: slb9724 (64641 in chips)=20
Seat 9: bighand18 (17901 in chips)=20
hockingjoe: posts the ante 500
LUVthoseNUTZ: posts the ante 500
FizzEdJohn: posts the ante 500
richsal1: posts the ante 500
JJin91: posts the ante 500
slb9724: posts the ante 500
bighand18: posts the ante 500
bighand18: posts small blind 2000
hockingjoe: posts big blind 4000
*** HOLE CARDS ***
Dealt to JJin91 [2h Qd]
LUVthoseNUTZ: folds=20
FizzEdJohn: folds=20
richsal1: folds=20
JJin91: folds=20
slb9724: folds=20
bighand18: folds=20
Uncalled bet (2000) returned to hockingjoe
hockingjoe collected 7500 from pot
hockingjoe: doesn't show hand=20
*** SUMMARY ***
Total pot 7500 | Rake 0=20
Seat 1: hockingjoe (big blind) collected (7500)
Seat 2: LUVthoseNUTZ folded before Flop (didn't bet)
Seat 3: FizzEdJohn folded before Flop (didn't bet)
Seat 4: richsal1 folded before Flop (didn't bet)
Seat 5: JJin91 folded before Flop (didn't bet)
Seat 6: slb9724 (button) folded before Flop (didn't bet)
Seat 9: bighand18 (small blind) folded before Flop


*********** # 151 **************
PokerStars Hand #170341265749: Tournament #1622573245, $4.55+$0.45 USD =
Hold'em No Limit - Level XXII (2000/4000) - 2017/05/24 22:53:13 ET
Table '1622573245 8' 9-max Seat #9 is the button
Seat 1: hockingjoe (62922 in chips)=20
Seat 2: LUVthoseNUTZ (99233 in chips)=20
Seat 3: FizzEdJohn (21086 in chips)=20
Seat 4: richsal1 (45831 in chips)=20
Seat 5: JJin91 (29938 in chips)=20
Seat 6: slb9724 (64141 in chips)=20
Seat 9: bighand18 (15401 in chips)=20
hockingjoe: posts the ante 500
LUVthoseNUTZ: posts the ante 500
FizzEdJohn: posts the ante 500
richsal1: posts the ante 500
JJin91: posts the ante 500
slb9724: posts the ante 500
bighand18: posts the ante 500
hockingjoe: posts small blind 2000
LUVthoseNUTZ: posts big blind 4000
*** HOLE CARDS ***
Dealt to JJin91 [4h Jc]
FizzEdJohn: folds=20
richsal1: folds=20
JJin91: folds=20
slb9724: raises 4000 to 8000
bighand18: folds=20
hockingjoe: folds=20
LUVthoseNUTZ: calls 4000
*** FLOP *** [8c 7s Jd]
LUVthoseNUTZ: checks=20
slb9724: checks=20
*** TURN *** [8c 7s Jd] [9d]
LUVthoseNUTZ: bets 7740
slb9724: calls 7740
*** RIVER *** [8c 7s Jd 9d] [8d]
LUVthoseNUTZ: bets 13313
slb9724: folds=20
Uncalled bet (13313) returned to LUVthoseNUTZ
LUVthoseNUTZ collected 36980 from pot
LUVthoseNUTZ: doesn't show hand=20
*** SUMMARY ***
Total pot 36980 | Rake 0=20
Board [8c 7s Jd 9d 8d]
Seat 1: hockingjoe (small blind) folded before Flop
Seat 2: LUVthoseNUTZ (big blind) collected (36980)
Seat 3: FizzEdJohn folded before Flop (didn't bet)
Seat 4: richsal1 folded before Flop (didn't bet)
Seat 5: JJin91 folded before Flop (didn't bet)
Seat 6: slb9724 folded on the River
Seat 9: bighand18 (button) folded before Flop (didn't bet)


*********** # 152 **************
PokerStars Hand #170341266046: Tournament #1622573245, $4.55+$0.45 USD =
Hold'em No Limit - Level XXII (2000/4000) - 2017/05/24 22:54:19 ET
Table '1622573245 8' 9-max Seat #1 is the button
Seat 1: hockingjoe (60422 in chips)=20
Seat 2: LUVthoseNUTZ (119973 in chips)=20
Seat 3: FizzEdJohn (20586 in chips)=20
Seat 4: richsal1 (45331 in chips)=20
Seat 5: JJin91 (29438 in chips)=20
Seat 6: slb9724 (47901 in chips)=20
Seat 9: bighand18 (14901 in chips)=20
hockingjoe: posts the ante 500
LUVthoseNUTZ: posts the ante 500
FizzEdJohn: posts the ante 500
richsal1: posts the ante 500
JJin91: posts the ante 500
slb9724: posts the ante 500
bighand18: posts the ante 500
LUVthoseNUTZ: posts small blind 2000
FizzEdJohn: posts big blind 4000
*** HOLE CARDS ***
Dealt to JJin91 [Ts Tc]
richsal1: folds=20
JJin91: raises 4760 to 8760
slb9724: folds=20
bighand18: folds=20
hockingjoe: folds=20
LUVthoseNUTZ: folds=20
FizzEdJohn: folds=20
Uncalled bet (4760) returned to JJin91
JJin91 collected 13500 from pot
JJin91: doesn't show hand=20
*** SUMMARY ***
Total pot 13500 | Rake 0=20
Seat 1: hockingjoe (button) folded before Flop (didn't bet)
Seat 2: LUVthoseNUTZ (small blind) folded before Flop
Seat 3: FizzEdJohn (big blind) folded before Flop
Seat 4: richsal1 folded before Flop (didn't bet)
Seat 5: JJin91 collected (13500)
Seat 6: slb9724 folded before Flop (didn't bet)
Seat 9: bighand18 folded before Flop (didn't bet)


*********** # 153 **************
PokerStars Hand #170341266246: Tournament #1622573245, $4.55+$0.45 USD =
Hold'em No Limit - Level XXII (2000/4000) - 2017/05/24 22:55:07 ET
Table '1622573245 8' 9-max Seat #2 is the button
Seat 1: hockingjoe (59922 in chips)=20
Seat 2: LUVthoseNUTZ (117473 in chips)=20
Seat 3: FizzEdJohn (16086 in chips)=20
Seat 4: richsal1 (44831 in chips)=20
Seat 5: JJin91 (38438 in chips)=20
Seat 6: slb9724 (47401 in chips)=20
Seat 7: kingolof (281165 in chips)=20
Seat 8: Pantsqm (63707 in chips)=20
Seat 9: bighand18 (14401 in chips)=20
hockingjoe: posts the ante 500
LUVthoseNUTZ: posts the ante 500
FizzEdJohn: posts the ante 500
richsal1: posts the ante 500
JJin91: posts the ante 500
slb9724: posts the ante 500
kingolof: posts the ante 500
Pantsqm: posts the ante 500
bighand18: posts the ante 500
FizzEdJohn: posts small blind 2000
richsal1: posts big blind 4000
*** HOLE CARDS ***
Dealt to JJin91 [Kd 6d]
JJin91: folds=20
slb9724: folds=20
kingolof: folds=20
Pantsqm: folds=20
bighand18: raises 9901 to 13901 and is all-in
hockingjoe: folds=20
LUVthoseNUTZ: folds=20
FizzEdJohn: folds=20
richsal1: calls 9901
*** FLOP *** [9s 4h 6h]
*** TURN *** [9s 4h 6h] [9c]
*** RIVER *** [9s 4h 6h 9c] [Jd]
*** SHOW DOWN ***
richsal1: shows [Ah 5h] (a pair of Nines)
bighand18: shows [Ac 8s] (a pair of Nines - Ace+Jack+Eight kicker)
bighand18 collected 34302 from pot
*** SUMMARY ***
Total pot 34302 | Rake 0=20
Board [9s 4h 6h 9c Jd]
Seat 1: hockingjoe folded before Flop (didn't bet)
Seat 2: LUVthoseNUTZ (button) folded before Flop (didn't bet)
Seat 3: FizzEdJohn (small blind) folded before Flop
Seat 4: richsal1 (big blind) showed [Ah 5h] and lost with a pair of Nin=
es
Seat 5: JJin91 folded before Flop (didn't bet)
Seat 6: slb9724 folded before Flop (didn't bet)
Seat 7: kingolof folded before Flop (didn't bet)
Seat 8: Pantsqm folded before Flop (didn't bet)
Seat 9: bighand18 showed [Ac 8s] and won (34302) with a pair of Nines


*********** # 154 **************
PokerStars Hand #170341267262: Tournament #1622573245, $4.55+$0.45 USD =
Hold'em No Limit - Level XXII (2000/4000) - 2017/05/24 23:00:34 ET
Table '1622573245 8' 9-max Seat #3 is the button
Seat 1: hockingjoe (59422 in chips)=20
Seat 2: LUVthoseNUTZ (116973 in chips)=20
Seat 3: FizzEdJohn (13586 in chips)=20
Seat 4: richsal1 (30430 in chips)=20
Seat 5: JJin91 (37938 in chips)=20
Seat 6: slb9724 (46901 in chips)=20
Seat 7: kingolof (280665 in chips)=20
Seat 8: Pantsqm (63207 in chips)=20
Seat 9: bighand18 (34302 in chips)=20
hockingjoe: posts the ante 500
LUVthoseNUTZ: posts the ante 500
FizzEdJohn: posts the ante 500
richsal1: posts the ante 500
JJin91: posts the ante 500
slb9724: posts the ante 500
kingolof: posts the ante 500
Pantsqm: posts the ante 500
bighand18: posts the ante 500
richsal1: posts small blind 2000
JJin91: posts big blind 4000
*** HOLE CARDS ***
Dealt to JJin91 [4d Tc]
slb9724: folds=20
kingolof: raises 14500 to 18500
Pantsqm: folds=20
bighand18: folds=20
hockingjoe: folds=20
LUVthoseNUTZ: folds=20
FizzEdJohn: folds=20
richsal1: folds=20
JJin91: folds=20
Uncalled bet (14500) returned to kingolof
kingolof collected 14500 from pot
kingolof: doesn't show hand=20
*** SUMMARY ***
Total pot 14500 | Rake 0=20
Seat 1: hockingjoe folded before Flop (didn't bet)
Seat 2: LUVthoseNUTZ folded before Flop (didn't bet)
Seat 3: FizzEdJohn (button) folded before Flop (didn't bet)
Seat 4: richsal1 (small blind) folded before Flop
Seat 5: JJin91 (big blind) folded before Flop
Seat 6: slb9724 folded before Flop (didn't bet)
Seat 7: kingolof collected (14500)
Seat 8: Pantsqm folded before Flop (didn't bet)
Seat 9: bighand18 folded before Flop (didn't bet)


*********** # 155 **************
PokerStars Hand #170341267377: Tournament #1622573245, $4.55+$0.45 USD =
Hold'em No Limit - Level XXII (2000/4000) - 2017/05/24 23:01:09 ET
Table '1622573245 8' 9-max Seat #4 is the button
Seat 1: hockingjoe (58922 in chips)=20
Seat 2: LUVthoseNUTZ (116473 in chips)=20
Seat 3: FizzEdJohn (13086 in chips)=20
Seat 4: richsal1 (27930 in chips)=20
Seat 5: JJin91 (33438 in chips)=20
Seat 6: slb9724 (46401 in chips)=20
Seat 7: kingolof (290665 in chips)=20
Seat 8: Pantsqm (62707 in chips)=20
Seat 9: bighand18 (33802 in chips)=20
hockingjoe: posts the ante 500
LUVthoseNUTZ: posts the ante 500
FizzEdJohn: posts the ante 500
richsal1: posts the ante 500
JJin91: posts the ante 500
slb9724: posts the ante 500
kingolof: posts the ante 500
Pantsqm: posts the ante 500
bighand18: posts the ante 500
JJin91: posts small blind 2000
slb9724: posts big blind 4000
*** HOLE CARDS ***
Dealt to JJin91 [7d Kc]
kingolof: folds=20
Pantsqm: folds=20
bighand18: folds=20
hockingjoe: folds=20
LUVthoseNUTZ: folds=20
FizzEdJohn: folds=20
richsal1: folds=20
JJin91: raises 28938 to 32938 and is all-in
slb9724: folds=20
Uncalled bet (28938) returned to JJin91
JJin91 collected 12500 from pot
JJin91: doesn't show hand=20
*** SUMMARY ***
Total pot 12500 | Rake 0=20
Seat 1: hockingjoe folded before Flop (didn't bet)
Seat 2: LUVthoseNUTZ folded before Flop (didn't bet)
Seat 3: FizzEdJohn folded before Flop (didn't bet)
Seat 4: richsal1 (button) folded before Flop (didn't bet)
Seat 5: JJin91 (small blind) collected (12500)
Seat 6: slb9724 (big blind) folded before Flop
Seat 7: kingolof folded before Flop (didn't bet)
Seat 8: Pantsqm folded before Flop (didn't bet)
Seat 9: bighand18 folded before Flop (didn't bet)


*********** # 156 **************
PokerStars Hand #170341267489: Tournament #1622573245, $4.55+$0.45 USD =
Hold'em No Limit - Level XXII (2000/4000) - 2017/05/24 23:01:35 ET
Table '1622573245 8' 9-max Seat #5 is the button
Seat 1: hockingjoe (58422 in chips)=20
Seat 2: LUVthoseNUTZ (115973 in chips)=20
Seat 3: FizzEdJohn (12586 in chips)=20
Seat 4: richsal1 (27430 in chips)=20
Seat 5: JJin91 (41438 in chips)=20
Seat 6: slb9724 (41901 in chips)=20
Seat 7: kingolof (290165 in chips)=20
Seat 8: Pantsqm (62207 in chips)=20
Seat 9: bighand18 (33302 in chips)=20
hockingjoe: posts the ante 500
LUVthoseNUTZ: posts the ante 500
FizzEdJohn: posts the ante 500
richsal1: posts the ante 500
JJin91: posts the ante 500
slb9724: posts the ante 500
kingolof: posts the ante 500
Pantsqm: posts the ante 500
bighand18: posts the ante 500
slb9724: posts small blind 2000
kingolof: posts big blind 4000
*** HOLE CARDS ***
Dealt to JJin91 [8s Qc]
Pantsqm: folds=20
bighand18: folds=20
hockingjoe: folds=20
LUVthoseNUTZ: folds=20
FizzEdJohn: folds=20
richsal1: folds=20
JJin91: folds=20
slb9724: raises 37401 to 41401 and is all-in
kingolof: folds=20
Uncalled bet (37401) returned to slb9724
slb9724 collected 12500 from pot
slb9724: doesn't show hand=20
*** SUMMARY ***
Total pot 12500 | Rake 0=20
Seat 1: hockingjoe folded before Flop (didn't bet)
Seat 2: LUVthoseNUTZ folded before Flop (didn't bet)
Seat 3: FizzEdJohn folded before Flop (didn't bet)
Seat 4: richsal1 folded before Flop (didn't bet)
Seat 5: JJin91 (button) folded before Flop (didn't bet)
Seat 6: slb9724 (small blind) collected (12500)
Seat 7: kingolof (big blind) folded before Flop
Seat 8: Pantsqm folded before Flop (didn't bet)
Seat 9: bighand18 folded before Flop (didn't bet)


*********** # 157 **************
PokerStars Hand #170341267607: Tournament #1622573245, $4.55+$0.45 USD =
Hold'em No Limit - Level XXIII (2500/5000) - 2017/05/24 23:02:13 ET
Table '1622573245 8' 9-max Seat #6 is the button
Seat 1: hockingjoe (57922 in chips)=20
Seat 2: LUVthoseNUTZ (115473 in chips)=20
Seat 3: FizzEdJohn (12086 in chips)=20
Seat 4: richsal1 (26930 in chips)=20
Seat 5: JJin91 (40938 in chips)=20
Seat 6: slb9724 (49901 in chips)=20
Seat 7: kingolof (285665 in chips)=20
Seat 8: Pantsqm (61707 in chips)=20
Seat 9: bighand18 (32802 in chips)=20
hockingjoe: posts the ante 625
LUVthoseNUTZ: posts the ante 625
FizzEdJohn: posts the ante 625
richsal1: posts the ante 625
JJin91: posts the ante 625
slb9724: posts the ante 625
kingolof: posts the ante 625
Pantsqm: posts the ante 625
bighand18: posts the ante 625
kingolof: posts small blind 2500
Pantsqm: posts big blind 5000
*** HOLE CARDS ***
Dealt to JJin91 [5h 2h]
bighand18: raises 27177 to 32177 and is all-in
hockingjoe: folds=20
LUVthoseNUTZ: folds=20
FizzEdJohn: folds=20
richsal1: folds=20
JJin91: folds=20
slb9724: folds=20
kingolof: folds=20
Pantsqm: folds=20
Uncalled bet (27177) returned to bighand18
bighand18 collected 18125 from pot
*** SUMMARY ***
Total pot 18125 | Rake 0=20
Seat 1: hockingjoe folded before Flop (didn't bet)
Seat 2: LUVthoseNUTZ folded before Flop (didn't bet)
Seat 3: FizzEdJohn folded before Flop (didn't bet)
Seat 4: richsal1 folded before Flop (didn't bet)
Seat 5: JJin91 folded before Flop (didn't bet)
Seat 6: slb9724 (button) folded before Flop (didn't bet)
Seat 7: kingolof (small blind) folded before Flop
Seat 8: Pantsqm (big blind) folded before Flop
Seat 9: bighand18 collected (18125)


*********** # 158 **************
PokerStars Hand #170341267757: Tournament #1622573245, $4.55+$0.45 USD =
Hold'em No Limit - Level XXIII (2500/5000) - 2017/05/24 23:02:53 ET
Table '1622573245 8' 9-max Seat #7 is the button
Seat 1: hockingjoe (57297 in chips)=20
Seat 2: LUVthoseNUTZ (114848 in chips)=20
Seat 3: FizzEdJohn (11461 in chips)=20
Seat 4: richsal1 (26305 in chips)=20
Seat 5: JJin91 (40313 in chips)=20
Seat 6: slb9724 (49276 in chips)=20
Seat 7: kingolof (282540 in chips)=20
Seat 8: Pantsqm (56082 in chips)=20
hockingjoe: posts the ante 625
LUVthoseNUTZ: posts the ante 625
FizzEdJohn: posts the ante 625
richsal1: posts the ante 625
JJin91: posts the ante 625
slb9724: posts the ante 625
kingolof: posts the ante 625
Pantsqm: posts the ante 625
Pantsqm: posts small blind 2500
hockingjoe: posts big blind 5000
*** HOLE CARDS ***
Dealt to JJin91 [2h 7s]
LUVthoseNUTZ: folds=20
FizzEdJohn: folds=20
richsal1: folds=20
JJin91: folds=20
slb9724: folds=20
kingolof: calls 5000
Pantsqm: folds=20
hockingjoe: checks=20
*** FLOP *** [6h Kc 3c]
hockingjoe: checks=20
kingolof: bets 5000
hockingjoe: calls 5000
*** TURN *** [6h Kc 3c] [Tc]
hockingjoe: checks=20
kingolof: bets 27500
hockingjoe: folds=20
Uncalled bet (27500) returned to kingolof
kingolof collected 27500 from pot
kingolof: doesn't show hand=20
*** SUMMARY ***
Total pot 27500 | Rake 0=20
Board [6h Kc 3c Tc]
Seat 1: hockingjoe (big blind) folded on the Turn
Seat 2: LUVthoseNUTZ folded before Flop (didn't bet)
Seat 3: FizzEdJohn folded before Flop (didn't bet)
Seat 4: richsal1 folded before Flop (didn't bet)
Seat 5: JJin91 folded before Flop (didn't bet)
Seat 6: slb9724 folded before Flop (didn't bet)
Seat 7: kingolof (button) collected (27500)
Seat 8: Pantsqm (small blind) folded before Flop


*********** # 159 **************
PokerStars Hand #170341267919: Tournament #1622573245, $4.55+$0.45 USD =
Hold'em No Limit - Level XXIII (2500/5000) - 2017/05/24 23:03:36 ET
Table '1622573245 8' 9-max Seat #8 is the button
Seat 1: hockingjoe (46672 in chips)=20
Seat 2: LUVthoseNUTZ (114223 in chips)=20
Seat 3: FizzEdJohn (10836 in chips)=20
Seat 4: richsal1 (25680 in chips)=20
Seat 5: JJin91 (39688 in chips)=20
Seat 6: slb9724 (48651 in chips)=20
Seat 7: kingolof (299415 in chips)=20
Seat 8: Pantsqm (52957 in chips)=20
hockingjoe: posts the ante 625
LUVthoseNUTZ: posts the ante 625
FizzEdJohn: posts the ante 625
richsal1: posts the ante 625
JJin91: posts the ante 625
slb9724: posts the ante 625
kingolof: posts the ante 625
Pantsqm: posts the ante 625
hockingjoe: posts small blind 2500
LUVthoseNUTZ: posts big blind 5000
*** HOLE CARDS ***
Dealt to JJin91 [9h 3s]
FizzEdJohn: raises 5211 to 10211 and is all-in
richsal1: raises 14844 to 25055 and is all-in
JJin91: folds=20
slb9724: folds=20
kingolof: folds=20
Pantsqm: folds=20
hockingjoe: folds=20
LUVthoseNUTZ: calls 20055
*** FLOP *** [4d 7d 9c]
*** TURN *** [4d 7d 9c] [Kc]
*** RIVER *** [4d 7d 9c Kc] [3c]
*** SHOW DOWN ***
LUVthoseNUTZ: shows [Th Ts] (a pair of Tens)
richsal1: shows [Kd Ks] (three of a kind, Kings)
richsal1 collected 29688 from side pot
FizzEdJohn: shows [9d Qs] (a pair of Nines)
richsal1 collected 38133 from main pot
FizzEdJohn finished the tournament in 16th place and received $11.09.
*** SUMMARY ***
Total pot 67821 Main pot 38133. Side pot 29688. | Rake 0=20
Board [4d 7d 9c Kc 3c]
Seat 1: hockingjoe (small blind) folded before Flop
Seat 2: LUVthoseNUTZ (big blind) showed [Th Ts] and lost with a pair of=
 Tens
Seat 3: FizzEdJohn showed [9d Qs] and lost with a pair of Nines
Seat 4: richsal1 showed [Kd Ks] and won (67821) with three of a kind, K=
ings
Seat 5: JJin91 folded before Flop (didn't bet)
Seat 6: slb9724 folded before Flop (didn't bet)
Seat 7: kingolof folded before Flop (didn't bet)
Seat 8: Pantsqm (button) folded before Flop (didn't bet)


*********** # 160 **************
PokerStars Hand #170341268077: Tournament #1622573245, $4.55+$0.45 USD =
Hold'em No Limit - Level XXIII (2500/5000) - 2017/05/24 23:04:14 ET
Table '1622573245 8' 9-max Seat #1 is the button
Seat 1: hockingjoe (43547 in chips)=20
Seat 2: LUVthoseNUTZ (88543 in chips)=20
Seat 4: richsal1 (67821 in chips)=20
Seat 5: JJin91 (39063 in chips)=20
Seat 6: slb9724 (48026 in chips)=20
Seat 7: kingolof (298790 in chips)=20
Seat 8: Pantsqm (52332 in chips)=20
hockingjoe: posts the ante 625
LUVthoseNUTZ: posts the ante 625
richsal1: posts the ante 625
JJin91: posts the ante 625
slb9724: posts the ante 625
kingolof: posts the ante 625
Pantsqm: posts the ante 625
LUVthoseNUTZ: posts small blind 2500
richsal1: posts big blind 5000
*** HOLE CARDS ***
Dealt to JJin91 [Ts Qs]
JJin91: folds=20
slb9724: folds=20
kingolof: folds=20
Pantsqm: folds=20
hockingjoe: folds=20
LUVthoseNUTZ: raises 82918 to 87918 and is all-in
richsal1: folds=20
Uncalled bet (82918) returned to LUVthoseNUTZ
LUVthoseNUTZ collected 14375 from pot
LUVthoseNUTZ: doesn't show hand=20
*** SUMMARY ***
Total pot 14375 | Rake 0=20
Seat 1: hockingjoe (button) folded before Flop (didn't bet)
Seat 2: LUVthoseNUTZ (small blind) collected (14375)
Seat 4: richsal1 (big blind) folded before Flop
Seat 5: JJin91 folded before Flop (didn't bet)
Seat 6: slb9724 folded before Flop (didn't bet)
Seat 7: kingolof folded before Flop (didn't bet)
Seat 8: Pantsqm folded before Flop (didn't bet)


*********** # 161 **************
PokerStars Hand #170341268233: Tournament #1622573245, $4.55+$0.45 USD =
Hold'em No Limit - Level XXIII (2500/5000) - 2017/05/24 23:04:56 ET
Table '1622573245 8' 9-max Seat #2 is the button
Seat 1: hockingjoe (42922 in chips)=20
Seat 2: LUVthoseNUTZ (97293 in chips)=20
Seat 4: richsal1 (62196 in chips)=20
Seat 5: JJin91 (38438 in chips)=20
Seat 6: slb9724 (47401 in chips)=20
Seat 7: kingolof (298165 in chips)=20
Seat 8: Pantsqm (51707 in chips)=20
hockingjoe: posts the ante 625
LUVthoseNUTZ: posts the ante 625
richsal1: posts the ante 625
JJin91: posts the ante 625
slb9724: posts the ante 625
kingolof: posts the ante 625
Pantsqm: posts the ante 625
richsal1: posts small blind 2500
JJin91: posts big blind 5000
*** HOLE CARDS ***
Dealt to JJin91 [3h 6c]
slb9724: folds=20
kingolof: folds=20
Pantsqm: folds=20
hockingjoe: folds=20
LUVthoseNUTZ: raises 6250 to 11250
richsal1: folds=20
JJin91: folds=20
Uncalled bet (6250) returned to LUVthoseNUTZ
LUVthoseNUTZ collected 16875 from pot
LUVthoseNUTZ: doesn't show hand=20
*** SUMMARY ***
Total pot 16875 | Rake 0=20
Seat 1: hockingjoe folded before Flop (didn't bet)
Seat 2: LUVthoseNUTZ (button) collected (16875)
Seat 4: richsal1 (small blind) folded before Flop
Seat 5: JJin91 (big blind) folded before Flop
Seat 6: slb9724 folded before Flop (didn't bet)
Seat 7: kingolof folded before Flop (didn't bet)
Seat 8: Pantsqm folded before Flop (didn't bet)


*********** # 162 **************
PokerStars Hand #170341268308: Tournament #1622573245, $4.55+$0.45 USD =
Hold'em No Limit - Level XXIII (2500/5000) - 2017/05/24 23:05:15 ET
Table '1622573245 8' 9-max Seat #4 is the button
Seat 1: hockingjoe (42297 in chips)=20
Seat 2: LUVthoseNUTZ (108543 in chips)=20
Seat 4: richsal1 (59071 in chips)=20
Seat 5: JJin91 (32813 in chips)=20
Seat 6: slb9724 (46776 in chips)=20
Seat 7: kingolof (297540 in chips)=20
Seat 8: Pantsqm (51082 in chips)=20
hockingjoe: posts the ante 625
LUVthoseNUTZ: posts the ante 625
richsal1: posts the ante 625
JJin91: posts the ante 625
slb9724: posts the ante 625
kingolof: posts the ante 625
Pantsqm: posts the ante 625
JJin91: posts small blind 2500
slb9724: posts big blind 5000
*** HOLE CARDS ***
Dealt to JJin91 [7h 6h]
kingolof: folds=20
Pantsqm: folds=20
hockingjoe: folds=20
LUVthoseNUTZ: raises 6250 to 11250
richsal1: folds=20
JJin91: raises 20938 to 32188 and is all-in
slb9724: folds=20
LUVthoseNUTZ: calls 20938
*** FLOP *** [8h Tc Js]
*** TURN *** [8h Tc Js] [Ad]
*** RIVER *** [8h Tc Js Ad] [Qh]
*** SHOW DOWN ***
JJin91: shows [7h 6h] (high card Ace)
LUVthoseNUTZ: shows [Kd Jd] (a straight, Ten to Ace)
LUVthoseNUTZ collected 73751 from pot
JJin91 finished the tournament in 14th place and received $11.64.
*** SUMMARY ***
Total pot 73751 | Rake 0=20
Board [8h Tc Js Ad Qh]
Seat 1: hockingjoe folded before Flop (didn't bet)
Seat 2: LUVthoseNUTZ showed [Kd Jd] and won (73751) with a straight, Te=
n to Ace
Seat 4: richsal1 (button) folded before Flop (didn't bet)
Seat 5: JJin91 (small blind) showed [7h 6h] and lost with high card Ace
Seat 6: slb9724 (big blind) folded before Flop
Seat 7: kingolof folded before Flop (didn't bet)
Seat 8: Pantsqm folded before Flop (didn't bet)



If you have any questions, please contact us at "PokerStars Support" <s=
upport@pokerstarsnj.com>


