Transcript for tournament #1622537329 requested by JJin91 (jamiejin91@g=
mail.com)

*********** # 1 **************
PokerStars Hand #169862158972: Tournament #1622537329, $13.50+$1.50 USD=
 Hold'em No Limit - Level VI (75/150) - 2017/05/14 14:28:09 ET
Table '1622537329 2' 6-max Seat #3 is the button
Seat 1: ToneJabrone (9415 in chips)=20
Seat 2: pukem0n (5700 in chips)=20
Seat 3: Stripsack (495 in chips) is sitting out
Seat 4: J<3Tutu (15939 in chips)=20
Seat 5: JJin91 (10000 in chips)=20
Seat 6: thaprodigy88 (34263 in chips)=20
ToneJabrone: posts the ante 20
pukem0n: posts the ante 20
Stripsack: posts the ante 20
J<3Tutu: posts the ante 20
JJin91: posts the ante 20
thaprodigy88: posts the ante 20
J<3Tutu: posts small blind 75
JJin91: posts big blind 150
*** HOLE CARDS ***
Dealt to JJin91 [Jh Th]
thaprodigy88: folds=20
ToneJabrone: folds=20
pukem0n: folds=20
Stripsack: folds=20
J<3Tutu: folds=20
Uncalled bet (75) returned to JJin91
JJin91 collected 270 from pot
JJin91: doesn't show hand=20
*** SUMMARY ***
Total pot 270 | Rake 0=20
Seat 1: ToneJabrone folded before Flop (didn't bet)
Seat 2: pukem0n folded before Flop (didn't bet)
Seat 3: Stripsack (button) folded before Flop (didn't bet)
Seat 4: J<3Tutu (small blind) folded before Flop
Seat 5: JJin91 (big blind) collected (270)
Seat 6: thaprodigy88 folded before Flop (didn't bet)


*********** # 2 **************
PokerStars Hand #169862159026: Tournament #1622537329, $13.50+$1.50 USD=
 Hold'em No Limit - Level VI (75/150) - 2017/05/14 14:28:29 ET
Table '1622537329 2' 6-max Seat #4 is the button
Seat 1: ToneJabrone (9395 in chips)=20
Seat 2: pukem0n (5680 in chips)=20
Seat 3: Stripsack (475 in chips) is sitting out
Seat 4: J<3Tutu (15844 in chips)=20
Seat 5: JJin91 (10175 in chips)=20
Seat 6: thaprodigy88 (34243 in chips)=20
ToneJabrone: posts the ante 20
pukem0n: posts the ante 20
Stripsack: posts the ante 20
J<3Tutu: posts the ante 20
JJin91: posts the ante 20
thaprodigy88: posts the ante 20
JJin91: posts small blind 75
thaprodigy88: posts big blind 150
*** HOLE CARDS ***
Dealt to JJin91 [4c 3h]
ToneJabrone: raises 150 to 300
pukem0n: calls 300
Stripsack: folds=20
J<3Tutu: raises 1050 to 1350
JJin91: folds=20
thaprodigy88: folds=20
ToneJabrone: raises 8025 to 9375 and is all-in
pukem0n: folds=20
J<3Tutu: calls 8025
*** FLOP *** [5c 4h 9c]
*** TURN *** [5c 4h 9c] [8c]
*** RIVER *** [5c 4h 9c 8c] [Th]
*** SHOW DOWN ***
ToneJabrone: shows [Qh Qs] (a pair of Queens)
J<3Tutu: shows [Ts Tc] (three of a kind, Tens)
J<3Tutu collected 19395 from pot
ToneJabrone finished the tournament in 105th place
*** SUMMARY ***
Total pot 19395 | Rake 0=20
Board [5c 4h 9c 8c Th]
Seat 1: ToneJabrone showed [Qh Qs] and lost with a pair of Queens
Seat 2: pukem0n folded before Flop
Seat 3: Stripsack folded before Flop (didn't bet)
Seat 4: J<3Tutu (button) showed [Ts Tc] and won (19395) with three of a=
 kind, Tens
Seat 5: JJin91 (small blind) folded before Flop
Seat 6: thaprodigy88 (big blind) folded before Flop


*********** # 3 **************
PokerStars Hand #169862159166: Tournament #1622537329, $13.50+$1.50 USD=
 Hold'em No Limit - Level VI (75/150) - 2017/05/14 14:29:18 ET
Table '1622537329 2' 6-max Seat #5 is the button
Seat 2: pukem0n (5360 in chips)=20
Seat 3: Stripsack (455 in chips) is sitting out
Seat 4: J<3Tutu (25844 in chips)=20
Seat 5: JJin91 (10080 in chips)=20
Seat 6: thaprodigy88 (34073 in chips)=20
pukem0n: posts the ante 20
Stripsack: posts the ante 20
J<3Tutu: posts the ante 20
JJin91: posts the ante 20
thaprodigy88: posts the ante 20
thaprodigy88: posts small blind 75
pukem0n: posts big blind 150
*** HOLE CARDS ***
Dealt to JJin91 [2d 8c]
Stripsack: folds=20
J<3Tutu: raises 175 to 325
JJin91: folds=20
thaprodigy88: folds=20
pukem0n: calls 175
*** FLOP *** [Jd 2h 7h]
pukem0n: checks=20
J<3Tutu: bets 347
pukem0n: folds=20
Uncalled bet (347) returned to J<3Tutu
J<3Tutu collected 825 from pot
J<3Tutu: doesn't show hand=20
*** SUMMARY ***
Total pot 825 | Rake 0=20
Board [Jd 2h 7h]
Seat 2: pukem0n (big blind) folded on the Flop
Seat 3: Stripsack folded before Flop (didn't bet)
Seat 4: J<3Tutu collected (825)
Seat 5: JJin91 (button) folded before Flop (didn't bet)
Seat 6: thaprodigy88 (small blind) folded before Flop


*********** # 4 **************
PokerStars Hand #169862159270: Tournament #1622537329, $13.50+$1.50 USD=
 Hold'em No Limit - Level VI (75/150) - 2017/05/14 14:29:56 ET
Table '1622537329 2' 6-max Seat #6 is the button
Seat 2: pukem0n (5015 in chips)=20
Seat 3: Stripsack (435 in chips) is sitting out
Seat 4: J<3Tutu (26324 in chips)=20
Seat 5: JJin91 (10060 in chips)=20
Seat 6: thaprodigy88 (33978 in chips)=20
pukem0n: posts the ante 20
Stripsack: posts the ante 20
J<3Tutu: posts the ante 20
JJin91: posts the ante 20
thaprodigy88: posts the ante 20
pukem0n: posts small blind 75
Stripsack: posts big blind 150
*** HOLE CARDS ***
Dealt to JJin91 [Js Kd]
J<3Tutu: raises 175 to 325
JJin91: folds=20
thaprodigy88: folds=20
pukem0n: folds=20
Stripsack: folds=20
Uncalled bet (175) returned to J<3Tutu
J<3Tutu collected 475 from pot
J<3Tutu: doesn't show hand=20
*** SUMMARY ***
Total pot 475 | Rake 0=20
Seat 2: pukem0n (small blind) folded before Flop
Seat 3: Stripsack (big blind) folded before Flop
Seat 4: J<3Tutu collected (475)
Seat 5: JJin91 folded before Flop (didn't bet)
Seat 6: thaprodigy88 (button) folded before Flop (didn't bet)


*********** # 5 **************
PokerStars Hand #169862159317: Tournament #1622537329, $13.50+$1.50 USD=
 Hold'em No Limit - Level VI (75/150) - 2017/05/14 14:30:13 ET
Table '1622537329 2' 6-max Seat #2 is the button
Seat 2: pukem0n (4920 in chips)=20
Seat 3: Stripsack (265 in chips) is sitting out
Seat 4: J<3Tutu (26629 in chips)=20
Seat 5: JJin91 (10040 in chips)=20
Seat 6: thaprodigy88 (33958 in chips)=20
pukem0n: posts the ante 20
Stripsack: posts the ante 20
J<3Tutu: posts the ante 20
JJin91: posts the ante 20
thaprodigy88: posts the ante 20
Stripsack: posts small blind 75
J<3Tutu: posts big blind 150
*** HOLE CARDS ***
Dealt to JJin91 [6s 9c]
JJin91: folds=20
thaprodigy88: folds=20
pukem0n: raises 300 to 450
Stripsack: folds=20
J<3Tutu: raises 3075 to 3525
pukem0n: raises 1375 to 4900 and is all-in
J<3Tutu: calls 1375
*** FLOP *** [Kd 7c 7h]
*** TURN *** [Kd 7c 7h] [6d]
*** RIVER *** [Kd 7c 7h 6d] [Ks]
*** SHOW DOWN ***
J<3Tutu: shows [Ah Ts] (two pair, Kings and Sevens)
pukem0n: shows [Ad Ac] (two pair, Aces and Kings)
pukem0n collected 9975 from pot
*** SUMMARY ***
Total pot 9975 | Rake 0=20
Board [Kd 7c 7h 6d Ks]
Seat 2: pukem0n (button) showed [Ad Ac] and won (9975) with two pair, A=
ces and Kings
Seat 3: Stripsack (small blind) folded before Flop
Seat 4: J<3Tutu (big blind) showed [Ah Ts] and lost with two pair, King=
s and Sevens
Seat 5: JJin91 folded before Flop (didn't bet)
Seat 6: thaprodigy88 folded before Flop (didn't bet)


*********** # 6 **************
PokerStars Hand #169862159432: Tournament #1622537329, $13.50+$1.50 USD=
 Hold'em No Limit - Level VI (75/150) - 2017/05/14 14:30:57 ET
Table '1622537329 2' 6-max Seat #3 is the button
Seat 1: jonnycongo (10000 in chips)=20
Seat 2: pukem0n (9975 in chips)=20
Seat 3: Stripsack (170 in chips) is sitting out
Seat 4: J<3Tutu (21709 in chips)=20
Seat 5: JJin91 (10020 in chips)=20
Seat 6: thaprodigy88 (33938 in chips)=20
jonnycongo: posts the ante 20
pukem0n: posts the ante 20
Stripsack: posts the ante 20
J<3Tutu: posts the ante 20
JJin91: posts the ante 20
thaprodigy88: posts the ante 20
J<3Tutu: posts small blind 75
JJin91: posts big blind 150
*** HOLE CARDS ***
Dealt to JJin91 [4s 3s]
thaprodigy88: folds=20
jonnycongo: folds=20
pukem0n: folds=20
Stripsack: folds=20
J<3Tutu: calls 75
JJin91: checks=20
*** FLOP *** [7s Td 2s]
J<3Tutu: checks=20
JJin91: bets 239
J<3Tutu: folds=20
Uncalled bet (239) returned to JJin91
JJin91 collected 420 from pot
JJin91: doesn't show hand=20
*** SUMMARY ***
Total pot 420 | Rake 0=20
Board [7s Td 2s]
Seat 1: jonnycongo folded before Flop (didn't bet)
Seat 2: pukem0n folded before Flop (didn't bet)
Seat 3: Stripsack (button) folded before Flop (didn't bet)
Seat 4: J<3Tutu (small blind) folded on the Flop
Seat 5: JJin91 (big blind) collected (420)
Seat 6: thaprodigy88 folded before Flop (didn't bet)


*********** # 7 **************
PokerStars Hand #169862159492: Tournament #1622537329, $13.50+$1.50 USD=
 Hold'em No Limit - Level VI (75/150) - 2017/05/14 14:31:21 ET
Table '1622537329 2' 6-max Seat #4 is the button
Seat 1: jonnycongo (9980 in chips)=20
Seat 2: pukem0n (9955 in chips)=20
Seat 3: Stripsack (150 in chips) is sitting out
Seat 4: J<3Tutu (21539 in chips)=20
Seat 5: JJin91 (10270 in chips)=20
Seat 6: thaprodigy88 (33918 in chips)=20
jonnycongo: posts the ante 20
pukem0n: posts the ante 20
Stripsack: posts the ante 20
J<3Tutu: posts the ante 20
JJin91: posts the ante 20
thaprodigy88: posts the ante 20
JJin91: posts small blind 75
thaprodigy88: posts big blind 150
*** HOLE CARDS ***
Dealt to JJin91 [Kc 3s]
jonnycongo: folds=20
pukem0n: folds=20
Stripsack: folds=20
J<3Tutu: calls 150
JJin91: folds=20
thaprodigy88: checks=20
*** FLOP *** [2c Qc 3d]
thaprodigy88: checks=20
J<3Tutu: bets 277
thaprodigy88: folds=20
Uncalled bet (277) returned to J<3Tutu
J<3Tutu collected 495 from pot
J<3Tutu: doesn't show hand=20
*** SUMMARY ***
Total pot 495 | Rake 0=20
Board [2c Qc 3d]
Seat 1: jonnycongo folded before Flop (didn't bet)
Seat 2: pukem0n folded before Flop (didn't bet)
Seat 3: Stripsack folded before Flop (didn't bet)
Seat 4: J<3Tutu (button) collected (495)
Seat 5: JJin91 (small blind) folded before Flop
Seat 6: thaprodigy88 (big blind) folded on the Flop


*********** # 8 **************
PokerStars Hand #169862159571: Tournament #1622537329, $13.50+$1.50 USD=
 Hold'em No Limit - Level VI (75/150) - 2017/05/14 14:31:48 ET
Table '1622537329 2' 6-max Seat #5 is the button
Seat 1: jonnycongo (9960 in chips)=20
Seat 2: pukem0n (9935 in chips)=20
Seat 3: Stripsack (130 in chips) is sitting out
Seat 4: J<3Tutu (21864 in chips)=20
Seat 5: JJin91 (10175 in chips)=20
Seat 6: thaprodigy88 (33748 in chips)=20
jonnycongo: posts the ante 20
pukem0n: posts the ante 20
Stripsack: posts the ante 20
J<3Tutu: posts the ante 20
JJin91: posts the ante 20
thaprodigy88: posts the ante 20
thaprodigy88: posts small blind 75
jonnycongo: posts big blind 150
*** HOLE CARDS ***
Dealt to JJin91 [8s 4d]
pukem0n: calls 150
Stripsack: folds=20
J<3Tutu: calls 150
JJin91: folds=20
thaprodigy88: calls 75
jonnycongo: checks=20
*** FLOP *** [5s Qd 6c]
thaprodigy88: checks=20
jonnycongo: checks=20
pukem0n: checks=20
J<3Tutu: bets 403
thaprodigy88: folds=20
jonnycongo: folds=20
pukem0n: calls 403
*** TURN *** [5s Qd 6c] [Ts]
pukem0n: bets 610
J<3Tutu: calls 610
*** RIVER *** [5s Qd 6c Ts] [8h]
pukem0n: bets 2060
J<3Tutu: folds=20
Uncalled bet (2060) returned to pukem0n
pukem0n collected 2746 from pot
*** SUMMARY ***
Total pot 2746 | Rake 0=20
Board [5s Qd 6c Ts 8h]
Seat 1: jonnycongo (big blind) folded on the Flop
Seat 2: pukem0n collected (2746)
Seat 3: Stripsack folded before Flop (didn't bet)
Seat 4: J<3Tutu folded on the River
Seat 5: JJin91 (button) folded before Flop (didn't bet)
Seat 6: thaprodigy88 (small blind) folded on the Flop


*********** # 9 **************
PokerStars Hand #169862159808: Tournament #1622537329, $13.50+$1.50 USD=
 Hold'em No Limit - Level VI (75/150) - 2017/05/14 14:33:19 ET
Table '1622537329 2' 6-max Seat #6 is the button
Seat 1: jonnycongo (9790 in chips)=20
Seat 2: pukem0n (11498 in chips)=20
Seat 3: Stripsack (110 in chips) is sitting out
Seat 4: J<3Tutu (20681 in chips)=20
Seat 5: JJin91 (10155 in chips)=20
Seat 6: thaprodigy88 (33578 in chips)=20
jonnycongo: posts the ante 20
pukem0n: posts the ante 20
Stripsack: posts the ante 20
J<3Tutu: posts the ante 20
JJin91: posts the ante 20
thaprodigy88: posts the ante 20
jonnycongo: posts small blind 75
pukem0n: posts big blind 150
*** HOLE CARDS ***
Dealt to JJin91 [9c Th]
Stripsack: folds=20
J<3Tutu: folds=20
JJin91: folds=20
thaprodigy88 is disconnected=20
thaprodigy88 is connected=20
thaprodigy88: folds=20
jonnycongo: folds=20
Uncalled bet (75) returned to pukem0n
pukem0n collected 270 from pot
*** SUMMARY ***
Total pot 270 | Rake 0=20
Seat 1: jonnycongo (small blind) folded before Flop
Seat 2: pukem0n (big blind) collected (270)
Seat 3: Stripsack folded before Flop (didn't bet)
Seat 4: J<3Tutu folded before Flop (didn't bet)
Seat 5: JJin91 folded before Flop (didn't bet)
Seat 6: thaprodigy88 (button) folded before Flop (didn't bet)


*********** # 10 **************
PokerStars Hand #169862159911: Tournament #1622537329, $13.50+$1.50 USD=
 Hold'em No Limit - Level VI (75/150) - 2017/05/14 14:33:55 ET
Table '1622537329 2' 6-max Seat #1 is the button
Seat 1: jonnycongo (9695 in chips)=20
Seat 2: pukem0n (11673 in chips)=20
Seat 3: Stripsack (90 in chips) is sitting out
Seat 4: J<3Tutu (20661 in chips)=20
Seat 5: JJin91 (10135 in chips)=20
Seat 6: thaprodigy88 (33558 in chips)=20
jonnycongo: posts the ante 20
pukem0n: posts the ante 20
Stripsack: posts the ante 20
J<3Tutu: posts the ante 20
JJin91: posts the ante 20
thaprodigy88: posts the ante 20
pukem0n: posts small blind 75
Stripsack: posts big blind 70 and is all-in
*** HOLE CARDS ***
Dealt to JJin91 [Kh 8d]
J<3Tutu: folds=20
JJin91: folds=20
thaprodigy88: folds=20
jonnycongo: calls 150
pukem0n: folds=20
Stripsack: folds=20
Uncalled bet (75) returned to jonnycongo
jonnycongo collected 340 from pot
Stripsack finished the tournament in 103rd place
*** SUMMARY ***
Total pot 340 | Rake 0=20
Seat 1: jonnycongo (button) collected (340)
Seat 2: pukem0n (small blind) folded before Flop
Seat 3: Stripsack (big blind) folded before Flop
Seat 4: J<3Tutu folded before Flop (didn't bet)
Seat 5: JJin91 folded before Flop (didn't bet)
Seat 6: thaprodigy88 folded before Flop (didn't bet)


*********** # 11 **************
PokerStars Hand #169862159963: Tournament #1622537329, $13.50+$1.50 USD=
 Hold'em No Limit - Level VI (75/150) - 2017/05/14 14:34:12 ET
Table '1622537329 2' 6-max Seat #2 is the button
Seat 1: jonnycongo (9940 in chips)=20
Seat 2: pukem0n (11578 in chips)=20
Seat 4: J<3Tutu (20641 in chips)=20
Seat 5: JJin91 (10115 in chips)=20
Seat 6: thaprodigy88 (33538 in chips)=20
jonnycongo: posts the ante 20
pukem0n: posts the ante 20
J<3Tutu: posts the ante 20
JJin91: posts the ante 20
thaprodigy88: posts the ante 20
J<3Tutu: posts small blind 75
JJin91: posts big blind 150
*** HOLE CARDS ***
Dealt to JJin91 [9h 9d]
thaprodigy88: folds=20
jonnycongo: folds=20
pukem0n: raises 225 to 375
J<3Tutu: raises 975 to 1350
JJin91: folds=20
pukem0n: folds=20
Uncalled bet (975) returned to J<3Tutu
J<3Tutu collected 1000 from pot
J<3Tutu: doesn't show hand=20
*** SUMMARY ***
Total pot 1000 | Rake 0=20
Seat 1: jonnycongo folded before Flop (didn't bet)
Seat 2: pukem0n (button) folded before Flop
Seat 4: J<3Tutu (small blind) collected (1000)
Seat 5: JJin91 (big blind) folded before Flop
Seat 6: thaprodigy88 folded before Flop (didn't bet)


*********** # 12 **************
PokerStars Hand #169865642472: Tournament #1622537329, $13.50+$1.50 USD=
 Hold'em No Limit - Level VI (75/150) - 2017/05/14 14:35:28 ET
Table '1622537329 2' 6-max Seat #4 is the button
Seat 1: jonnycongo (9920 in chips)=20
Seat 2: pukem0n (11183 in chips)=20
Seat 4: J<3Tutu (21246 in chips)=20
Seat 5: JJin91 (9945 in chips)=20
Seat 6: thaprodigy88 (33518 in chips)=20
jonnycongo: posts the ante 20
pukem0n: posts the ante 20
J<3Tutu: posts the ante 20
JJin91: posts the ante 20
thaprodigy88: posts the ante 20
JJin91: posts small blind 75
thaprodigy88: posts big blind 150
*** HOLE CARDS ***
Dealt to JJin91 [2s 2d]
jonnycongo: folds=20
pukem0n: folds=20
J<3Tutu: folds=20
JJin91: raises 300 to 450
thaprodigy88: folds=20
Uncalled bet (300) returned to JJin91
JJin91 collected 400 from pot
JJin91: doesn't show hand=20
*** SUMMARY ***
Total pot 400 | Rake 0=20
Seat 1: jonnycongo folded before Flop (didn't bet)
Seat 2: pukem0n folded before Flop (didn't bet)
Seat 4: J<3Tutu (button) folded before Flop (didn't bet)
Seat 5: JJin91 (small blind) collected (400)
Seat 6: thaprodigy88 (big blind) folded before Flop


*********** # 13 **************
PokerStars Hand #169865642610: Tournament #1622537329, $13.50+$1.50 USD=
 Hold'em No Limit - Level VII (100/200) - 2017/05/14 14:36:21 ET
Table '1622537329 2' 6-max Seat #5 is the button
Seat 1: jonnycongo (9900 in chips)=20
Seat 2: pukem0n (11163 in chips)=20
Seat 4: J<3Tutu (21226 in chips)=20
Seat 5: JJin91 (10175 in chips)=20
Seat 6: thaprodigy88 (33348 in chips)=20
jonnycongo: posts the ante 25
pukem0n: posts the ante 25
J<3Tutu: posts the ante 25
JJin91: posts the ante 25
thaprodigy88: posts the ante 25
thaprodigy88: posts small blind 100
jonnycongo: posts big blind 200
*** HOLE CARDS ***
Dealt to JJin91 [Kc 8d]
pukem0n: folds=20
J<3Tutu: folds=20
JJin91: raises 238 to 438
thaprodigy88 has timed out while being disconnected
thaprodigy88: folds=20
thaprodigy88 is sitting out
jonnycongo: calls 238
*** FLOP *** [5s 8s 9s]
jonnycongo: checks=20
JJin91: bets 728
jonnycongo: raises 1272 to 2000
thaprodigy88 has returned
JJin91: calls 1272
*** TURN *** [5s 8s 9s] [6s]
jonnycongo: bets 7437 and is all-in
JJin91: folds=20
Uncalled bet (7437) returned to jonnycongo
jonnycongo collected 5101 from pot
*** SUMMARY ***
Total pot 5101 | Rake 0=20
Board [5s 8s 9s 6s]
Seat 1: jonnycongo (big blind) collected (5101)
Seat 2: pukem0n folded before Flop (didn't bet)
Seat 4: J<3Tutu folded before Flop (didn't bet)
Seat 5: JJin91 (button) folded on the Turn
Seat 6: thaprodigy88 (small blind) folded before Flop


*********** # 14 **************
PokerStars Hand #169865642816: Tournament #1622537329, $13.50+$1.50 USD=
 Hold'em No Limit - Level VII (100/200) - 2017/05/14 14:37:38 ET
Table '1622537329 2' 6-max Seat #6 is the button
Seat 1: jonnycongo (12538 in chips)=20
Seat 2: pukem0n (11138 in chips)=20
Seat 4: J<3Tutu (21201 in chips)=20
Seat 5: JJin91 (7712 in chips)=20
Seat 6: thaprodigy88 (33223 in chips)=20
jonnycongo: posts the ante 25
pukem0n: posts the ante 25
J<3Tutu: posts the ante 25
JJin91: posts the ante 25
thaprodigy88: posts the ante 25
jonnycongo: posts small blind 100
pukem0n: posts big blind 200
*** HOLE CARDS ***
Dealt to JJin91 [7h 5s]
J<3Tutu: raises 234 to 434
JJin91: folds=20
thaprodigy88: calls 434
jonnycongo: folds=20
pukem0n: calls 234
*** FLOP *** [8h 8c Ac]
jonnycongo said, "shytty spade"
pukem0n: checks=20
J<3Tutu: checks=20
jonnycongo said, "i flopped it"
thaprodigy88: checks=20
*** TURN *** [8h 8c Ac] [5c]
pukem0n: checks=20
J<3Tutu: checks=20
thaprodigy88: bets 400
pukem0n: folds=20
J<3Tutu: calls 400
*** RIVER *** [8h 8c Ac 5c] [2c]
J<3Tutu: checks=20
thaprodigy88: bets 800
J<3Tutu: folds=20
Uncalled bet (800) returned to thaprodigy88
thaprodigy88 collected 2327 from pot
thaprodigy88: doesn't show hand=20
*** SUMMARY ***
Total pot 2327 | Rake 0=20
Board [8h 8c Ac 5c 2c]
Seat 1: jonnycongo (small blind) folded before Flop
Seat 2: pukem0n (big blind) folded on the Turn
Seat 4: J<3Tutu folded on the River
Seat 5: JJin91 folded before Flop (didn't bet)
Seat 6: thaprodigy88 (button) collected (2327)


*********** # 15 **************
PokerStars Hand #169865643008: Tournament #1622537329, $13.50+$1.50 USD=
 Hold'em No Limit - Level VII (100/200) - 2017/05/14 14:38:49 ET
Table '1622537329 2' 6-max Seat #1 is the button
Seat 1: jonnycongo (12413 in chips)=20
Seat 2: pukem0n (10679 in chips)=20
Seat 4: J<3Tutu (20342 in chips)=20
Seat 5: JJin91 (7687 in chips)=20
Seat 6: thaprodigy88 (34691 in chips)=20
jonnycongo: posts the ante 25
pukem0n: posts the ante 25
J<3Tutu: posts the ante 25
JJin91: posts the ante 25
thaprodigy88: posts the ante 25
pukem0n: posts small blind 100
J<3Tutu: posts big blind 200
*** HOLE CARDS ***
Dealt to JJin91 [4c 2h]
JJin91: folds=20
thaprodigy88: folds=20
jonnycongo: folds=20
pukem0n: folds=20
Uncalled bet (100) returned to J<3Tutu
J<3Tutu collected 325 from pot
J<3Tutu: doesn't show hand=20
*** SUMMARY ***
Total pot 325 | Rake 0=20
Seat 1: jonnycongo (button) folded before Flop (didn't bet)
Seat 2: pukem0n (small blind) folded before Flop
Seat 4: J<3Tutu (big blind) collected (325)
Seat 5: JJin91 folded before Flop (didn't bet)
Seat 6: thaprodigy88 folded before Flop (didn't bet)


*********** # 16 **************
PokerStars Hand #169865643066: Tournament #1622537329, $13.50+$1.50 USD=
 Hold'em No Limit - Level VII (100/200) - 2017/05/14 14:39:11 ET
Table '1622537329 2' 6-max Seat #2 is the button
Seat 1: jonnycongo (12388 in chips)=20
Seat 2: pukem0n (10554 in chips)=20
Seat 4: J<3Tutu (20542 in chips)=20
Seat 5: JJin91 (7662 in chips)=20
Seat 6: thaprodigy88 (34666 in chips)=20
jonnycongo: posts the ante 25
pukem0n: posts the ante 25
J<3Tutu: posts the ante 25
JJin91: posts the ante 25
thaprodigy88: posts the ante 25
J<3Tutu: posts small blind 100
JJin91: posts big blind 200
*** HOLE CARDS ***
Dealt to JJin91 [8h 4d]
thaprodigy88: folds=20
jonnycongo: folds=20
pukem0n: raises 300 to 500
J<3Tutu: raises 1300 to 1800
JJin91: folds=20
pukem0n: calls 1300
*** FLOP *** [Js 3h Tc]
J<3Tutu: bets 1138
pukem0n: calls 1138
*** TURN *** [Js 3h Tc] [Jc]
J<3Tutu: bets 1798
pukem0n: calls 1798
*** RIVER *** [Js 3h Tc Jc] [8c]
J<3Tutu: bets 7250
pukem0n: calls 5793 and is all-in
Uncalled bet (1457) returned to J<3Tutu
*** SHOW DOWN ***
J<3Tutu: shows [Ts Td] (a full house, Tens full of Jacks)
pukem0n: shows [6c 7c] (a flush, Jack high)
J<3Tutu collected 21383 from pot
pukem0n finished the tournament in 102nd place
*** SUMMARY ***
Total pot 21383 | Rake 0=20
Board [Js 3h Tc Jc 8c]
Seat 1: jonnycongo folded before Flop (didn't bet)
Seat 2: pukem0n (button) showed [6c 7c] and lost with a flush, Jack high
Seat 4: J<3Tutu (small blind) showed [Ts Td] and won (21383) with a ful=
l house, Tens full of Jacks
Seat 5: JJin91 (big blind) folded before Flop
Seat 6: thaprodigy88 folded before Flop (didn't bet)


*********** # 17 **************
PokerStars Hand #169865643245: Tournament #1622537329, $13.50+$1.50 USD=
 Hold'em No Limit - Level VII (100/200) - 2017/05/14 14:40:20 ET
Table '1622537329 2' 6-max Seat #4 is the button
Seat 1: jonnycongo (12363 in chips)=20
Seat 2: Vixxx23 (4744 in chips)=20
Seat 4: J<3Tutu (31371 in chips)=20
Seat 5: JJin91 (7437 in chips)=20
Seat 6: thaprodigy88 (34641 in chips)=20
jonnycongo: posts the ante 25
Vixxx23: posts the ante 25
J<3Tutu: posts the ante 25
JJin91: posts the ante 25
thaprodigy88: posts the ante 25
JJin91: posts small blind 100
thaprodigy88: posts big blind 200
*** HOLE CARDS ***
Dealt to JJin91 [Ac 2c]
jonnycongo: folds=20
Vixxx23: folds=20
J<3Tutu: folds=20
JJin91: raises 238 to 438
thaprodigy88: calls 238
*** FLOP *** [Js Ks 9h]
JJin91: checks=20
thaprodigy88: bets 400
JJin91: folds=20
Uncalled bet (400) returned to thaprodigy88
thaprodigy88 collected 1001 from pot
thaprodigy88: doesn't show hand=20
*** SUMMARY ***
Total pot 1001 | Rake 0=20
Board [Js Ks 9h]
Seat 1: jonnycongo folded before Flop (didn't bet)
Seat 2: Vixxx23 folded before Flop (didn't bet)
Seat 4: J<3Tutu (button) folded before Flop (didn't bet)
Seat 5: JJin91 (small blind) folded on the Flop
Seat 6: thaprodigy88 (big blind) collected (1001)


*********** # 18 **************
PokerStars Hand #169865643356: Tournament #1622537329, $13.50+$1.50 USD=
 Hold'em No Limit - Level VII (100/200) - 2017/05/14 14:40:57 ET
Table '1622537329 2' 6-max Seat #5 is the button
Seat 1: jonnycongo (12338 in chips)=20
Seat 2: Vixxx23 (4719 in chips)=20
Seat 4: J<3Tutu (31346 in chips)=20
Seat 5: JJin91 (6974 in chips)=20
Seat 6: thaprodigy88 (35179 in chips)=20
jonnycongo: posts the ante 25
Vixxx23: posts the ante 25
J<3Tutu: posts the ante 25
JJin91: posts the ante 25
thaprodigy88: posts the ante 25
thaprodigy88: posts small blind 100
jonnycongo: posts big blind 200
*** HOLE CARDS ***
Dealt to JJin91 [7d Ad]
Vixxx23: folds=20
J<3Tutu: folds=20
JJin91: raises 6749 to 6949 and is all-in
thaprodigy88: folds=20
jonnycongo: folds=20
Uncalled bet (6749) returned to JJin91
JJin91 collected 625 from pot
JJin91: doesn't show hand=20
*** SUMMARY ***
Total pot 625 | Rake 0=20
Seat 1: jonnycongo (big blind) folded before Flop
Seat 2: Vixxx23 folded before Flop (didn't bet)
Seat 4: J<3Tutu folded before Flop (didn't bet)
Seat 5: JJin91 (button) collected (625)
Seat 6: thaprodigy88 (small blind) folded before Flop


*********** # 19 **************
PokerStars Hand #169865643451: Tournament #1622537329, $13.50+$1.50 USD=
 Hold'em No Limit - Level VII (100/200) - 2017/05/14 14:41:35 ET
Table '1622537329 2' 6-max Seat #6 is the button
Seat 1: jonnycongo (12113 in chips)=20
Seat 2: Vixxx23 (4694 in chips)=20
Seat 4: J<3Tutu (31321 in chips)=20
Seat 5: JJin91 (7374 in chips)=20
Seat 6: thaprodigy88 (35054 in chips)=20
jonnycongo: posts the ante 25
Vixxx23: posts the ante 25
J<3Tutu: posts the ante 25
JJin91: posts the ante 25
thaprodigy88: posts the ante 25
jonnycongo: posts small blind 100
Vixxx23: posts big blind 200
*** HOLE CARDS ***
Dealt to JJin91 [Jc 4d]
J<3Tutu: folds=20
JJin91: folds=20
thaprodigy88: calls 200
jonnycongo: raises 400 to 600
Vixxx23: folds=20
thaprodigy88 is disconnected=20
thaprodigy88 has timed out while disconnected
thaprodigy88: folds=20
Uncalled bet (400) returned to jonnycongo
thaprodigy88 is sitting out
jonnycongo collected 725 from pot
jonnycongo said, "zzzzz"
*** SUMMARY ***
Total pot 725 | Rake 0=20
Seat 1: jonnycongo (small blind) collected (725)
Seat 2: Vixxx23 (big blind) folded before Flop
Seat 4: J<3Tutu folded before Flop (didn't bet)
Seat 5: JJin91 folded before Flop (didn't bet)
Seat 6: thaprodigy88 (button) folded before Flop


*********** # 20 **************
PokerStars Hand #169865643648: Tournament #1622537329, $13.50+$1.50 USD=
 Hold'em No Limit - Level VII (100/200) - 2017/05/14 14:42:42 ET
Table '1622537329 2' 6-max Seat #1 is the button
Seat 1: jonnycongo (12613 in chips)=20
Seat 2: Vixxx23 (4469 in chips)=20
Seat 4: J<3Tutu (31296 in chips)=20
Seat 5: JJin91 (7349 in chips)=20
Seat 6: thaprodigy88 (34829 in chips) is sitting out
jonnycongo: posts the ante 25
Vixxx23: posts the ante 25
J<3Tutu: posts the ante 25
JJin91: posts the ante 25
thaprodigy88: posts the ante 25
Vixxx23: posts small blind 100
J<3Tutu: posts big blind 200
*** HOLE CARDS ***
Dealt to JJin91 [Td 8h]
JJin91: folds=20
thaprodigy88: folds=20
jonnycongo: folds=20
thaprodigy88 has returned
Vixxx23: calls 100
J<3Tutu: checks=20
*** FLOP *** [Kd Qd Qs]
Vixxx23: checks=20
J<3Tutu: checks=20
*** TURN *** [Kd Qd Qs] [Jd]
Vixxx23: checks=20
J<3Tutu: checks=20
*** RIVER *** [Kd Qd Qs Jd] [Ah]
Vixxx23: checks=20
J<3Tutu: bets 294
Vixxx23: calls 294
*** SHOW DOWN ***
J<3Tutu: shows [Ts 4h] (a straight, Ten to Ace)
Vixxx23: mucks hand=20
J<3Tutu collected 1113 from pot
*** SUMMARY ***
Total pot 1113 | Rake 0=20
Board [Kd Qd Qs Jd Ah]
Seat 1: jonnycongo (button) folded before Flop (didn't bet)
Seat 2: Vixxx23 (small blind) mucked [Ac 3c]
Seat 4: J<3Tutu (big blind) showed [Ts 4h] and won (1113) with a straig=
ht, Ten to Ace
Seat 5: JJin91 folded before Flop (didn't bet)
Seat 6: thaprodigy88 folded before Flop (didn't bet)


*********** # 21 **************
PokerStars Hand #169865643798: Tournament #1622537329, $13.50+$1.50 USD=
 Hold'em No Limit - Level VII (100/200) - 2017/05/14 14:43:29 ET
Table '1622537329 2' 6-max Seat #2 is the button
Seat 1: jonnycongo (12588 in chips)=20
Seat 2: Vixxx23 (3950 in chips)=20
Seat 4: J<3Tutu (31890 in chips)=20
Seat 5: JJin91 (7324 in chips)=20
Seat 6: thaprodigy88 (34804 in chips)=20
jonnycongo: posts the ante 25
Vixxx23: posts the ante 25
J<3Tutu: posts the ante 25
JJin91: posts the ante 25
thaprodigy88: posts the ante 25
J<3Tutu: posts small blind 100
JJin91: posts big blind 200
*** HOLE CARDS ***
Dealt to JJin91 [Ad Jd]
thaprodigy88: folds=20
jonnycongo: folds=20
Vixxx23: raises 600 to 800
J<3Tutu: folds=20
JJin91: raises 6499 to 7299 and is all-in
Vixxx23: calls 3125 and is all-in
Uncalled bet (3374) returned to JJin91
*** FLOP *** [4h 5h Tc]
*** TURN *** [4h 5h Tc] [4c]
*** RIVER *** [4h 5h Tc 4c] [Th]
*** SHOW DOWN ***
JJin91: shows [Ad Jd] (two pair, Tens and Fours)
Vixxx23: shows [Kd Qh] (two pair, Tens and Fours - lower kicker)
JJin91 collected 8075 from pot
Vixxx23 finished the tournament in 98th place
*** SUMMARY ***
Total pot 8075 | Rake 0=20
Board [4h 5h Tc 4c Th]
Seat 1: jonnycongo folded before Flop (didn't bet)
Seat 2: Vixxx23 (button) showed [Kd Qh] and lost with two pair, Tens an=
d Fours
Seat 4: J<3Tutu (small blind) folded before Flop
Seat 5: JJin91 (big blind) showed [Ad Jd] and won (8075) with two pair,=
 Tens and Fours
Seat 6: thaprodigy88 folded before Flop (didn't bet)


*********** # 22 **************
PokerStars Hand #169865643893: Tournament #1622537329, $13.50+$1.50 USD=
 Hold'em No Limit - Level VII (100/200) - 2017/05/14 14:44:00 ET
Table '1622537329 2' 6-max Seat #4 is the button
Seat 1: jonnycongo (12563 in chips)=20
Seat 4: J<3Tutu (31765 in chips)=20
Seat 5: JJin91 (11449 in chips)=20
Seat 6: thaprodigy88 (34779 in chips)=20
jonnycongo: posts the ante 25
J<3Tutu: posts the ante 25
JJin91: posts the ante 25
thaprodigy88: posts the ante 25
JJin91: posts small blind 100
thaprodigy88: posts big blind 200
*** HOLE CARDS ***
Dealt to JJin91 [4d 9c]
jonnycongo: folds=20
J<3Tutu: raises 286 to 486
JJin91: folds=20
thaprodigy88: calls 286
*** FLOP *** [6c Jd 8c]
thaprodigy88: checks=20
J<3Tutu: checks=20
*** TURN *** [6c Jd 8c] [Ac]
thaprodigy88: checks=20
J<3Tutu: checks=20
*** RIVER *** [6c Jd 8c Ac] [9s]
thaprodigy88: checks=20
J<3Tutu: checks=20
*** SHOW DOWN ***
thaprodigy88: shows [Ts Kd] (high card Ace)
J<3Tutu: shows [Kh Kc] (a pair of Kings)
J<3Tutu collected 1172 from pot
*** SUMMARY ***
Total pot 1172 | Rake 0=20
Board [6c Jd 8c Ac 9s]
Seat 1: jonnycongo folded before Flop (didn't bet)
Seat 4: J<3Tutu (button) showed [Kh Kc] and won (1172) with a pair of K=
ings
Seat 5: JJin91 (small blind) folded before Flop
Seat 6: thaprodigy88 (big blind) showed [Ts Kd] and lost with high card=
 Ace


*********** # 23 **************
PokerStars Hand #169865644040: Tournament #1622537329, $13.50+$1.50 USD=
 Hold'em No Limit - Level VII (100/200) - 2017/05/14 14:44:45 ET
Table '1622537329 2' 6-max Seat #5 is the button
Seat 1: jonnycongo (12538 in chips)=20
Seat 2: eliozica (27510 in chips)=20
Seat 4: J<3Tutu (32426 in chips)=20
Seat 5: JJin91 (11324 in chips)=20
Seat 6: thaprodigy88 (34268 in chips)=20
jonnycongo: posts the ante 25
eliozica: posts the ante 25
J<3Tutu: posts the ante 25
JJin91: posts the ante 25
thaprodigy88: posts the ante 25
thaprodigy88: posts small blind 100
jonnycongo: posts big blind 200
*** HOLE CARDS ***
Dealt to JJin91 [7s 7c]
eliozica: folds=20
J<3Tutu: raises 286 to 486
JJin91: calls 486
thaprodigy88: folds=20
jonnycongo: calls 286
*** FLOP *** [2s 4d 5h]
jonnycongo: checks=20
J<3Tutu: bets 1045
JJin91: calls 1045
jonnycongo: folds=20
*** TURN *** [2s 4d 5h] [Ah]
J<3Tutu: checks=20
JJin91: checks=20
*** RIVER *** [2s 4d 5h Ah] [Js]
J<3Tutu: checks=20
JJin91: checks=20
*** SHOW DOWN ***
J<3Tutu: shows [8s 8h] (a pair of Eights)
JJin91: mucks hand=20
J<3Tutu collected 3773 from pot
*** SUMMARY ***
Total pot 3773 | Rake 0=20
Board [2s 4d 5h Ah Js]
Seat 1: jonnycongo (big blind) folded on the Flop
Seat 2: eliozica folded before Flop (didn't bet)
Seat 4: J<3Tutu showed [8s 8h] and won (3773) with a pair of Eights
Seat 5: JJin91 (button) mucked [7s 7c]
Seat 6: thaprodigy88 (small blind) folded before Flop


*********** # 24 **************
PokerStars Hand #169865644223: Tournament #1622537329, $13.50+$1.50 USD=
 Hold'em No Limit - Level VIII (125/250) - 2017/05/14 14:45:55 ET
Table '1622537329 2' 6-max Seat #6 is the button
Seat 1: jonnycongo (12027 in chips)=20
Seat 2: eliozica (27485 in chips)=20
Seat 3: IPuntStacks (10000 in chips)=20
Seat 4: J<3Tutu (34643 in chips)=20
Seat 5: JJin91 (9768 in chips)=20
Seat 6: thaprodigy88 (34143 in chips)=20
jonnycongo: posts the ante 30
eliozica: posts the ante 30
IPuntStacks: posts the ante 30
J<3Tutu: posts the ante 30
JJin91: posts the ante 30
thaprodigy88: posts the ante 30
jonnycongo: posts small blind 125
eliozica: posts big blind 250
*** HOLE CARDS ***
Dealt to JJin91 [Ac Ad]
IPuntStacks: folds=20
J<3Tutu: raises 292 to 542
JJin91: raises 958 to 1500
thaprodigy88: folds=20
jonnycongo: folds=20
eliozica: folds=20
J<3Tutu: raises 33113 to 34613 and is all-in
JJin91: calls 8238 and is all-in
Uncalled bet (24875) returned to J<3Tutu
*** FLOP *** [6h 7h As]
*** TURN *** [6h 7h As] [Qc]
*** RIVER *** [6h 7h As Qc] [Kh]
*** SHOW DOWN ***
J<3Tutu: shows [Qs Qd] (three of a kind, Queens)
JJin91: shows [Ac Ad] (three of a kind, Aces)
JJin91 collected 20031 from pot
*** SUMMARY ***
Total pot 20031 | Rake 0=20
Board [6h 7h As Qc Kh]
Seat 1: jonnycongo (small blind) folded before Flop
Seat 2: eliozica (big blind) folded before Flop
Seat 3: IPuntStacks folded before Flop (didn't bet)
Seat 4: J<3Tutu showed [Qs Qd] and lost with three of a kind, Queens
Seat 5: JJin91 showed [Ac Ad] and won (20031) with three of a kind, Aces
Seat 6: thaprodigy88 (button) folded before Flop (didn't bet)


*********** # 25 **************
PokerStars Hand #169865644342: Tournament #1622537329, $13.50+$1.50 USD=
 Hold'em No Limit - Level VIII (125/250) - 2017/05/14 14:46:38 ET
Table '1622537329 2' 6-max Seat #1 is the button
Seat 1: jonnycongo (11872 in chips)=20
Seat 2: eliozica (27205 in chips)=20
Seat 3: IPuntStacks (9970 in chips)=20
Seat 4: J<3Tutu (24875 in chips)=20
Seat 5: JJin91 (20031 in chips)=20
Seat 6: thaprodigy88 (34113 in chips)=20
jonnycongo: posts the ante 30
eliozica: posts the ante 30
IPuntStacks: posts the ante 30
J<3Tutu: posts the ante 30
JJin91: posts the ante 30
thaprodigy88: posts the ante 30
eliozica: posts small blind 125
IPuntStacks: posts big blind 250
*** HOLE CARDS ***
Dealt to JJin91 [6s Kh]
J<3Tutu: folds=20
JJin91: folds=20
thaprodigy88 has timed out while being disconnected
thaprodigy88: folds=20
thaprodigy88 is sitting out
thaprodigy88 is disconnected=20
jonnycongo: calls 250
eliozica: calls 125
IPuntStacks: checks=20
*** FLOP *** [2h As 5d]
eliozica: checks=20
IPuntStacks: checks=20
jonnycongo: bets 750
eliozica: folds=20
IPuntStacks: calls 750
*** TURN *** [2h As 5d] [Kd]
IPuntStacks: checks=20
jonnycongo: bets 2750
IPuntStacks: folds=20
Uncalled bet (2750) returned to jonnycongo
jonnycongo collected 2430 from pot
*** SUMMARY ***
Total pot 2430 | Rake 0=20
Board [2h As 5d Kd]
Seat 1: jonnycongo (button) collected (2430)
Seat 2: eliozica (small blind) folded on the Flop
Seat 3: IPuntStacks (big blind) folded on the Turn
Seat 4: J<3Tutu folded before Flop (didn't bet)
Seat 5: JJin91 folded before Flop (didn't bet)
Seat 6: thaprodigy88 folded before Flop (didn't bet)


*********** # 26 **************
PokerStars Hand #169865644498: Tournament #1622537329, $13.50+$1.50 USD=
 Hold'em No Limit - Level VIII (125/250) - 2017/05/14 14:47:33 ET
Table '1622537329 2' 6-max Seat #2 is the button
Seat 1: jonnycongo (13272 in chips)=20
Seat 2: eliozica (26925 in chips)=20
Seat 3: IPuntStacks (8940 in chips)=20
Seat 4: J<3Tutu (24845 in chips)=20
Seat 5: JJin91 (20001 in chips)=20
Seat 6: thaprodigy88 (34083 in chips) is sitting out
jonnycongo: posts the ante 30
eliozica: posts the ante 30
IPuntStacks: posts the ante 30
J<3Tutu: posts the ante 30
JJin91: posts the ante 30
thaprodigy88: posts the ante 30
IPuntStacks: posts small blind 125
J<3Tutu: posts big blind 250
*** HOLE CARDS ***
Dealt to JJin91 [6c 4c]
JJin91: folds=20
thaprodigy88: folds=20
jonnycongo: calls 250
thaprodigy88 has returned
eliozica: raises 1055 to 1305
IPuntStacks: folds=20
J<3Tutu: folds=20
jonnycongo: calls 1055
*** FLOP *** [7c 8d Tc]
jonnycongo: checks=20
eliozica: bets 3250
jonnycongo: calls 3250
*** TURN *** [7c 8d Tc] [3d]
jonnycongo: checks=20
eliozica: bets 9750
jonnycongo: folds=20
Uncalled bet (9750) returned to eliozica
eliozica collected 9665 from pot
eliozica: doesn't show hand=20
*** SUMMARY ***
Total pot 9665 | Rake 0=20
Board [7c 8d Tc 3d]
Seat 1: jonnycongo folded on the Turn
Seat 2: eliozica (button) collected (9665)
Seat 3: IPuntStacks (small blind) folded before Flop
Seat 4: J<3Tutu (big blind) folded before Flop
Seat 5: JJin91 folded before Flop (didn't bet)
Seat 6: thaprodigy88 folded before Flop (didn't bet)


*********** # 27 **************
PokerStars Hand #169865644633: Tournament #1622537329, $13.50+$1.50 USD=
 Hold'em No Limit - Level VIII (125/250) - 2017/05/14 14:48:16 ET
Table '1622537329 2' 6-max Seat #3 is the button
Seat 1: jonnycongo (8687 in chips)=20
Seat 2: eliozica (32005 in chips)=20
Seat 3: IPuntStacks (8785 in chips)=20
Seat 4: J<3Tutu (24565 in chips)=20
Seat 5: JJin91 (19971 in chips)=20
Seat 6: thaprodigy88 (34053 in chips)=20
jonnycongo: posts the ante 30
eliozica: posts the ante 30
IPuntStacks: posts the ante 30
J<3Tutu: posts the ante 30
JJin91: posts the ante 30
thaprodigy88: posts the ante 30
J<3Tutu: posts small blind 125
JJin91: posts big blind 250
*** HOLE CARDS ***
Dealt to JJin91 [Jd 7s]
thaprodigy88: calls 250
jonnycongo: folds=20
eliozica: folds=20
IPuntStacks: folds=20
J<3Tutu: calls 125
JJin91: checks=20
*** FLOP *** [2c 8h 6h]
J<3Tutu: bets 391
JJin91: folds=20
thaprodigy88: folds=20
Uncalled bet (391) returned to J<3Tutu
J<3Tutu collected 930 from pot
J<3Tutu: doesn't show hand=20
*** SUMMARY ***
Total pot 930 | Rake 0=20
Board [2c 8h 6h]
Seat 1: jonnycongo folded before Flop (didn't bet)
Seat 2: eliozica folded before Flop (didn't bet)
Seat 3: IPuntStacks (button) folded before Flop (didn't bet)
Seat 4: J<3Tutu (small blind) collected (930)
Seat 5: JJin91 (big blind) folded on the Flop
Seat 6: thaprodigy88 folded on the Flop


*********** # 28 **************
PokerStars Hand #169865644775: Tournament #1622537329, $13.50+$1.50 USD=
 Hold'em No Limit - Level VIII (125/250) - 2017/05/14 14:48:59 ET
Table '1622537329 2' 6-max Seat #4 is the button
Seat 1: jonnycongo (8657 in chips)=20
Seat 2: eliozica (31975 in chips)=20
Seat 3: IPuntStacks (8755 in chips)=20
Seat 4: J<3Tutu (25215 in chips)=20
Seat 5: JJin91 (19691 in chips)=20
Seat 6: thaprodigy88 (33773 in chips)=20
jonnycongo: posts the ante 30
eliozica: posts the ante 30
IPuntStacks: posts the ante 30
J<3Tutu: posts the ante 30
JJin91: posts the ante 30
thaprodigy88: posts the ante 30
JJin91: posts small blind 125
thaprodigy88: posts big blind 250
*** HOLE CARDS ***
Dealt to JJin91 [Jh Ts]
jonnycongo: calls 250
eliozica: calls 250
IPuntStacks: calls 250
J<3Tutu: calls 250
JJin91: folds=20
thaprodigy88: checks=20
*** FLOP *** [6c 5c 2s]
thaprodigy88: checks=20
jonnycongo: checks=20
eliozica: checks=20
IPuntStacks: bets 778
J<3Tutu: folds=20
thaprodigy88: folds=20
jonnycongo: folds=20
eliozica: folds=20
Uncalled bet (778) returned to IPuntStacks
IPuntStacks collected 1555 from pot
*** SUMMARY ***
Total pot 1555 | Rake 0=20
Board [6c 5c 2s]
Seat 1: jonnycongo folded on the Flop
Seat 2: eliozica folded on the Flop
Seat 3: IPuntStacks collected (1555)
Seat 4: J<3Tutu (button) folded on the Flop
Seat 5: JJin91 (small blind) folded before Flop
Seat 6: thaprodigy88 (big blind) folded on the Flop


*********** # 29 **************
PokerStars Hand #169865644913: Tournament #1622537329, $13.50+$1.50 USD=
 Hold'em No Limit - Level VIII (125/250) - 2017/05/14 14:49:44 ET
Table '1622537329 2' 6-max Seat #5 is the button
Seat 1: jonnycongo (8377 in chips)=20
Seat 2: eliozica (31695 in chips)=20
Seat 3: IPuntStacks (10030 in chips)=20
Seat 4: J<3Tutu (24935 in chips)=20
Seat 5: JJin91 (19536 in chips)=20
Seat 6: thaprodigy88 (33493 in chips)=20
jonnycongo: posts the ante 30
eliozica: posts the ante 30
IPuntStacks: posts the ante 30
J<3Tutu: posts the ante 30
JJin91: posts the ante 30
thaprodigy88: posts the ante 30
thaprodigy88: posts small blind 125
jonnycongo: posts big blind 250
*** HOLE CARDS ***
Dealt to JJin91 [4d 4c]
eliozica: calls 250
IPuntStacks: folds=20
J<3Tutu: calls 250
JJin91: raises 1250 to 1500
thaprodigy88: folds=20
jonnycongo: folds=20
eliozica: folds=20
J<3Tutu: folds=20
Uncalled bet (1250) returned to JJin91
JJin91 collected 1305 from pot
JJin91: doesn't show hand=20
*** SUMMARY ***
Total pot 1305 | Rake 0=20
Seat 1: jonnycongo (big blind) folded before Flop
Seat 2: eliozica folded before Flop
Seat 3: IPuntStacks folded before Flop (didn't bet)
Seat 4: J<3Tutu folded before Flop
Seat 5: JJin91 (button) collected (1305)
Seat 6: thaprodigy88 (small blind) folded before Flop


*********** # 30 **************
PokerStars Hand #169865645023: Tournament #1622537329, $13.50+$1.50 USD=
 Hold'em No Limit - Level VIII (125/250) - 2017/05/14 14:50:16 ET
Table '1622537329 2' 6-max Seat #6 is the button
Seat 1: jonnycongo (8097 in chips)=20
Seat 2: eliozica (31415 in chips)=20
Seat 3: IPuntStacks (10000 in chips)=20
Seat 4: J<3Tutu (24655 in chips)=20
Seat 5: JJin91 (20561 in chips)=20
Seat 6: thaprodigy88 (33338 in chips)=20
jonnycongo: posts the ante 30
eliozica: posts the ante 30
IPuntStacks: posts the ante 30
J<3Tutu: posts the ante 30
JJin91: posts the ante 30
thaprodigy88: posts the ante 30
jonnycongo: posts small blind 125
eliozica: posts big blind 250
*** HOLE CARDS ***
Dealt to JJin91 [Kh 9s]
IPuntStacks: folds=20
J<3Tutu: folds=20
JJin91: folds=20
thaprodigy88: calls 250
jonnycongo: raises 250 to 500
eliozica: folds=20
thaprodigy88: calls 250
*** FLOP *** [Jh 5h Jc]
jonnycongo: checks=20
thaprodigy88: checks=20
*** TURN *** [Jh 5h Jc] [4c]
jonnycongo: checks=20
thaprodigy88: checks=20
*** RIVER *** [Jh 5h Jc 4c] [8d]
jonnycongo: bets 750
thaprodigy88: raises 1750 to 2500
jonnycongo: calls 1750
*** SHOW DOWN ***
thaprodigy88: shows [Tc Jd] (three of a kind, Jacks)
jonnycongo: mucks hand=20
thaprodigy88 collected 6430 from pot
*** SUMMARY ***
Total pot 6430 | Rake 0=20
Board [Jh 5h Jc 4c 8d]
Seat 1: jonnycongo (small blind) mucked [As Ah]
Seat 2: eliozica (big blind) folded before Flop
Seat 3: IPuntStacks folded before Flop (didn't bet)
Seat 4: J<3Tutu folded before Flop (didn't bet)
Seat 5: JJin91 folded before Flop (didn't bet)
Seat 6: thaprodigy88 (button) showed [Tc Jd] and won (6430) with three =
of a kind, Jacks


*********** # 31 **************
PokerStars Hand #169865645217: Tournament #1622537329, $13.50+$1.50 USD=
 Hold'em No Limit - Level VIII (125/250) - 2017/05/14 14:51:19 ET
Table '1622537329 2' 6-max Seat #1 is the button
Seat 1: jonnycongo (5067 in chips)=20
Seat 2: eliozica (31135 in chips)=20
Seat 3: IPuntStacks (9970 in chips)=20
Seat 4: J<3Tutu (24625 in chips)=20
Seat 5: JJin91 (20531 in chips)=20
Seat 6: thaprodigy88 (36738 in chips)=20
jonnycongo: posts the ante 30
eliozica: posts the ante 30
IPuntStacks: posts the ante 30
J<3Tutu: posts the ante 30
JJin91: posts the ante 30
thaprodigy88: posts the ante 30
eliozica: posts small blind 125
IPuntStacks: posts big blind 250
*** HOLE CARDS ***
Dealt to JJin91 [4h Ah]
J<3Tutu: folds=20
JJin91: raises 297 to 547
thaprodigy88: folds=20
jonnycongo: folds=20
eliozica: folds=20
IPuntStacks: calls 297
*** FLOP *** [3s 9c Qc]
IPuntStacks: checks=20
JJin91: bets 518
IPuntStacks: folds=20
Uncalled bet (518) returned to JJin91
JJin91 collected 1399 from pot
JJin91: doesn't show hand=20
*** SUMMARY ***
Total pot 1399 | Rake 0=20
Board [3s 9c Qc]
Seat 1: jonnycongo (button) folded before Flop (didn't bet)
Seat 2: eliozica (small blind) folded before Flop
Seat 3: IPuntStacks (big blind) folded on the Flop
Seat 4: J<3Tutu folded before Flop (didn't bet)
Seat 5: JJin91 collected (1399)
Seat 6: thaprodigy88 folded before Flop (didn't bet)


*********** # 32 **************
PokerStars Hand #169865645305: Tournament #1622537329, $13.50+$1.50 USD=
 Hold'em No Limit - Level VIII (125/250) - 2017/05/14 14:51:46 ET
Table '1622537329 2' 6-max Seat #2 is the button
Seat 1: jonnycongo (5037 in chips)=20
Seat 2: eliozica (30980 in chips)=20
Seat 3: IPuntStacks (9393 in chips)=20
Seat 4: J<3Tutu (24595 in chips)=20
Seat 5: JJin91 (21353 in chips)=20
Seat 6: thaprodigy88 (36708 in chips)=20
jonnycongo: posts the ante 30
eliozica: posts the ante 30
IPuntStacks: posts the ante 30
J<3Tutu: posts the ante 30
JJin91: posts the ante 30
thaprodigy88: posts the ante 30
IPuntStacks: posts small blind 125
J<3Tutu: posts big blind 250
*** HOLE CARDS ***
Dealt to JJin91 [3c 3s]
JJin91: raises 297 to 547
thaprodigy88: folds=20
jonnycongo: folds=20
eliozica: folds=20
IPuntStacks: folds=20
J<3Tutu: calls 297
*** FLOP *** [Qd 2h 2d]
J<3Tutu: checks=20
JJin91: checks=20
*** TURN *** [Qd 2h 2d] [7s]
J<3Tutu: bets 468
JJin91: calls 468
*** RIVER *** [Qd 2h 2d 7s] [8h]
J<3Tutu: bets 1628
JJin91: calls 1628
*** SHOW DOWN ***
J<3Tutu: shows [2c Qc] (a full house, Deuces full of Queens)
JJin91: mucks hand=20
J<3Tutu collected 5591 from pot
*** SUMMARY ***
Total pot 5591 | Rake 0=20
Board [Qd 2h 2d 7s 8h]
Seat 1: jonnycongo folded before Flop (didn't bet)
Seat 2: eliozica (button) folded before Flop (didn't bet)
Seat 3: IPuntStacks (small blind) folded before Flop
Seat 4: J<3Tutu (big blind) showed [2c Qc] and won (5591) with a full h=
ouse, Deuces full of Queens
Seat 5: JJin91 mucked [3c 3s]
Seat 6: thaprodigy88 folded before Flop (didn't bet)


*********** # 33 **************
PokerStars Hand #169865645532: Tournament #1622537329, $13.50+$1.50 USD=
 Hold'em No Limit - Level VIII (125/250) - 2017/05/14 14:53:02 ET
Table '1622537329 2' 6-max Seat #3 is the button
Seat 1: jonnycongo (5007 in chips)=20
Seat 2: eliozica (30950 in chips)=20
Seat 3: IPuntStacks (9238 in chips)=20
Seat 4: J<3Tutu (27513 in chips)=20
Seat 5: JJin91 (18680 in chips)=20
jonnycongo: posts the ante 30
eliozica: posts the ante 30
IPuntStacks: posts the ante 30
J<3Tutu: posts the ante 30
JJin91: posts the ante 30
J<3Tutu: posts small blind 125
JJin91: posts big blind 250
*** HOLE CARDS ***
Dealt to JJin91 [3c Kc]
jonnycongo: calls 250
eliozica: folds=20
IPuntStacks: raises 312 to 562
J<3Tutu: folds=20
JJin91: calls 312
jonnycongo: calls 312
*** FLOP *** [2d 3s 8c]
JJin91: checks=20
jonnycongo: bets 1961
IPuntStacks: calls 1961
JJin91: folds=20
*** TURN *** [2d 3s 8c] [9c]
jonnycongo: bets 2454 and is all-in
IPuntStacks: calls 2454
*** RIVER *** [2d 3s 8c 9c] [Ks]
*** SHOW DOWN ***
jonnycongo: shows [9h Th] (a pair of Nines)
IPuntStacks: shows [3d 6d] (a pair of Threes)
jonnycongo collected 10791 from pot
*** SUMMARY ***
Total pot 10791 | Rake 0=20
Board [2d 3s 8c 9c Ks]
Seat 1: jonnycongo showed [9h Th] and won (10791) with a pair of Nines
Seat 2: eliozica folded before Flop (didn't bet)
Seat 3: IPuntStacks (button) showed [3d 6d] and lost with a pair of Thr=
ees
Seat 4: J<3Tutu (small blind) folded before Flop
Seat 5: JJin91 (big blind) folded on the Flop


*********** # 34 **************
PokerStars Hand #169865645681: Tournament #1622537329, $13.50+$1.50 USD=
 Hold'em No Limit - Level VIII (125/250) - 2017/05/14 14:53:49 ET
Table '1622537329 2' 6-max Seat #4 is the button
Seat 1: jonnycongo (10791 in chips)=20
Seat 2: eliozica (30920 in chips)=20
Seat 3: IPuntStacks (4231 in chips)=20
Seat 4: J<3Tutu (27358 in chips)=20
Seat 5: JJin91 (18088 in chips)=20
jonnycongo: posts the ante 30
eliozica: posts the ante 30
IPuntStacks: posts the ante 30
J<3Tutu: posts the ante 30
JJin91: posts the ante 30
JJin91: posts small blind 125
jonnycongo: posts big blind 250
*** HOLE CARDS ***
Dealt to JJin91 [Qd 6s]
eliozica: folds=20
IPuntStacks: folds=20
J<3Tutu: raises 292 to 542
JJin91: folds=20
jonnycongo: calls 292
*** FLOP *** [9h Tc 4h]
jonnycongo: checks=20
J<3Tutu: checks=20
*** TURN *** [9h Tc 4h] [9c]
jonnycongo: bets 1359
J<3Tutu: calls 1359
*** RIVER *** [9h Tc 4h 9c] [5d]
jonnycongo: bets 8860 and is all-in
J<3Tutu: calls 8860
*** SHOW DOWN ***
jonnycongo: shows [Th 6h] (two pair, Tens and Nines)
J<3Tutu: shows [4d Ad] (two pair, Nines and Fours)
jonnycongo collected 21797 from pot
*** SUMMARY ***
Total pot 21797 | Rake 0=20
Board [9h Tc 4h 9c 5d]
Seat 1: jonnycongo (big blind) showed [Th 6h] and won (21797) with two =
pair, Tens and Nines
Seat 2: eliozica folded before Flop (didn't bet)
Seat 3: IPuntStacks folded before Flop (didn't bet)
Seat 4: J<3Tutu (button) showed [4d Ad] and lost with two pair, Nines a=
nd Fours
Seat 5: JJin91 (small blind) folded before Flop


*********** # 35 **************
PokerStars Hand #169865645843: Tournament #1622537329, $13.50+$1.50 USD=
 Hold'em No Limit - Level VIII (125/250) - 2017/05/14 14:54:38 ET
Table '1622537329 2' 6-max Seat #5 is the button
Seat 1: jonnycongo (21797 in chips)=20
Seat 2: eliozica (30890 in chips)=20
Seat 3: IPuntStacks (4201 in chips)=20
Seat 4: J<3Tutu (16567 in chips)=20
Seat 5: JJin91 (17933 in chips)=20
jonnycongo: posts the ante 30
eliozica: posts the ante 30
IPuntStacks: posts the ante 30
J<3Tutu: posts the ante 30
JJin91: posts the ante 30
jonnycongo: posts small blind 125
eliozica: posts big blind 250
*** HOLE CARDS ***
Dealt to JJin91 [4h Kh]
IPuntStacks: calls 250
J<3Tutu: folds=20
JJin91: folds=20
jonnycongo: folds=20
eliozica: checks=20
*** FLOP *** [Ac Js 2s]
eliozica: checks=20
IPuntStacks: checks=20
*** TURN *** [Ac Js 2s] [2d]
eliozica: checks=20
IPuntStacks: bets 256
eliozica: calls 256
*** RIVER *** [Ac Js 2s 2d] [Ad]
eliozica: checks=20
IPuntStacks: bets 644
eliozica: calls 644
*** SHOW DOWN ***
IPuntStacks: shows [9d 7d] (two pair, Aces and Deuces)
eliozica: shows [Qd 6s] (two pair, Aces and Deuces - Queen kicker)
eliozica collected 2575 from pot
*** SUMMARY ***
Total pot 2575 | Rake 0=20
Board [Ac Js 2s 2d Ad]
Seat 1: jonnycongo (small blind) folded before Flop
Seat 2: eliozica (big blind) showed [Qd 6s] and won (2575) with two pai=
r, Aces and Deuces
Seat 3: IPuntStacks showed [9d 7d] and lost with two pair, Aces and Deu=
ces
Seat 4: J<3Tutu folded before Flop (didn't bet)
Seat 5: JJin91 (button) folded before Flop (didn't bet)


*********** # 36 **************
PokerStars Hand #169865646950: Tournament #1622537329, $13.50+$1.50 USD=
 Hold'em No Limit - Level VIII (125/250) - 2017/05/14 15:01:02 ET
Table '1622537329 2' 6-max Seat #1 is the button
Seat 1: jonnycongo (21642 in chips)=20
Seat 2: eliozica (32285 in chips)=20
Seat 3: IPuntStacks (3021 in chips)=20
Seat 4: J<3Tutu (16537 in chips)=20
Seat 5: JJin91 (17903 in chips)=20
Seat 6: robaydin (10000 in chips)=20
jonnycongo: posts the ante 30
eliozica: posts the ante 30
IPuntStacks: posts the ante 30
J<3Tutu: posts the ante 30
JJin91: posts the ante 30
robaydin: posts the ante 30
eliozica: posts small blind 125
IPuntStacks: posts big blind 250
*** HOLE CARDS ***
Dealt to JJin91 [Ts 3d]
J<3Tutu: raises 292 to 542
JJin91: folds=20
robaydin: calls 542
jonnycongo: folds=20
eliozica: calls 417
IPuntStacks: raises 2449 to 2991 and is all-in
J<3Tutu: raises 13516 to 16507 and is all-in
robaydin: folds=20
eliozica: folds=20
Uncalled bet (13516) returned to J<3Tutu
*** FLOP *** [5h 2c 7h]
*** TURN *** [5h 2c 7h] [7d]
*** RIVER *** [5h 2c 7h 7d] [3s]
*** SHOW DOWN ***
IPuntStacks: shows [8d 8s] (two pair, Eights and Sevens)
J<3Tutu: shows [Qd Jh] (a pair of Sevens)
IPuntStacks collected 7246 from pot
*** SUMMARY ***
Total pot 7246 | Rake 0=20
Board [5h 2c 7h 7d 3s]
Seat 1: jonnycongo (button) folded before Flop (didn't bet)
Seat 2: eliozica (small blind) folded before Flop
Seat 3: IPuntStacks (big blind) showed [8d 8s] and won (7246) with two =
pair, Eights and Sevens
Seat 4: J<3Tutu showed [Qd Jh] and lost with a pair of Sevens
Seat 5: JJin91 folded before Flop (didn't bet)
Seat 6: robaydin folded before Flop


*********** # 37 **************
PokerStars Hand #169865647145: Tournament #1622537329, $13.50+$1.50 USD=
 Hold'em No Limit - Level IX (150/300) - 2017/05/14 15:01:54 ET
Table '1622537329 2' 6-max Seat #2 is the button
Seat 1: jonnycongo (21612 in chips)=20
Seat 2: eliozica (31713 in chips)=20
Seat 3: IPuntStacks (7246 in chips)=20
Seat 5: JJin91 (17873 in chips)=20
Seat 6: robaydin (9428 in chips)=20
jonnycongo: posts the ante 40
eliozica: posts the ante 40
IPuntStacks: posts the ante 40
JJin91: posts the ante 40
robaydin: posts the ante 40
IPuntStacks: posts small blind 150
JJin91: posts big blind 300
*** HOLE CARDS ***
Dealt to JJin91 [Jd 2s]
robaydin: folds=20
jonnycongo: folds=20
eliozica: raises 300 to 600
IPuntStacks: folds=20
JJin91: folds=20
Uncalled bet (300) returned to eliozica
eliozica collected 950 from pot
eliozica: doesn't show hand=20
*** SUMMARY ***
Total pot 950 | Rake 0=20
Seat 1: jonnycongo folded before Flop (didn't bet)
Seat 2: eliozica (button) collected (950)
Seat 3: IPuntStacks (small blind) folded before Flop
Seat 5: JJin91 (big blind) folded before Flop
Seat 6: robaydin folded before Flop (didn't bet)


*********** # 38 **************
PokerStars Hand #169865647222: Tournament #1622537329, $13.50+$1.50 USD=
 Hold'em No Limit - Level IX (150/300) - 2017/05/14 15:02:16 ET
Table '1622537329 2' 6-max Seat #3 is the button
Seat 1: jonnycongo (21572 in chips)=20
Seat 2: eliozica (32323 in chips)=20
Seat 3: IPuntStacks (7056 in chips)=20
Seat 5: JJin91 (17533 in chips)=20
Seat 6: robaydin (9388 in chips)=20
jonnycongo: posts the ante 40
eliozica: posts the ante 40
IPuntStacks: posts the ante 40
JJin91: posts the ante 40
robaydin: posts the ante 40
JJin91: posts small blind 150
robaydin: posts big blind 300
*** HOLE CARDS ***
Dealt to JJin91 [2h 3s]
jonnycongo: folds=20
eliozica: raises 300 to 600
IPuntStacks: folds=20
JJin91: folds=20
robaydin: folds=20
Uncalled bet (300) returned to eliozica
eliozica collected 950 from pot
eliozica: doesn't show hand=20
*** SUMMARY ***
Total pot 950 | Rake 0=20
Seat 1: jonnycongo folded before Flop (didn't bet)
Seat 2: eliozica collected (950)
Seat 3: IPuntStacks (button) folded before Flop (didn't bet)
Seat 5: JJin91 (small blind) folded before Flop
Seat 6: robaydin (big blind) folded before Flop


*********** # 39 **************
PokerStars Hand #169865647309: Tournament #1622537329, $13.50+$1.50 USD=
 Hold'em No Limit - Level IX (150/300) - 2017/05/14 15:02:39 ET
Table '1622537329 2' 6-max Seat #5 is the button
Seat 1: jonnycongo (21532 in chips)=20
Seat 2: eliozica (32933 in chips)=20
Seat 3: IPuntStacks (7016 in chips)=20
Seat 5: JJin91 (17343 in chips)=20
Seat 6: robaydin (9048 in chips)=20
jonnycongo: posts the ante 40
eliozica: posts the ante 40
IPuntStacks: posts the ante 40
JJin91: posts the ante 40
robaydin: posts the ante 40
robaydin: posts small blind 150
jonnycongo: posts big blind 300
*** HOLE CARDS ***
Dealt to JJin91 [5s 9s]
eliozica: calls 300
IPuntStacks: folds=20
JJin91: folds=20
robaydin: calls 150
jonnycongo: checks=20
*** FLOP *** [8h Ks 8c]
robaydin: checks=20
jonnycongo: checks=20
eliozica: bets 600
robaydin: folds=20
jonnycongo: folds=20
Uncalled bet (600) returned to eliozica
eliozica collected 1100 from pot
eliozica: doesn't show hand=20
*** SUMMARY ***
Total pot 1100 | Rake 0=20
Board [8h Ks 8c]
Seat 1: jonnycongo (big blind) folded on the Flop
Seat 2: eliozica collected (1100)
Seat 3: IPuntStacks folded before Flop (didn't bet)
Seat 5: JJin91 (button) folded before Flop (didn't bet)
Seat 6: robaydin (small blind) folded on the Flop


*********** # 40 **************
PokerStars Hand #169865647451: Tournament #1622537329, $13.50+$1.50 USD=
 Hold'em No Limit - Level IX (150/300) - 2017/05/14 15:03:15 ET
Table '1622537329 2' 6-max Seat #6 is the button
Seat 1: jonnycongo (21192 in chips)=20
Seat 2: eliozica (33693 in chips)=20
Seat 3: IPuntStacks (6976 in chips)=20
Seat 5: JJin91 (17303 in chips)=20
Seat 6: robaydin (8708 in chips)=20
jonnycongo: posts the ante 40
eliozica: posts the ante 40
IPuntStacks: posts the ante 40
JJin91: posts the ante 40
robaydin: posts the ante 40
jonnycongo: posts small blind 150
eliozica: posts big blind 300
*** HOLE CARDS ***
Dealt to JJin91 [Ad Ah]
IPuntStacks: folds=20
JJin91: raises 357 to 657
robaydin: folds=20
jonnycongo: calls 507
eliozica: folds=20
*** FLOP *** [Js 5s 5h]
jonnycongo: checks=20
JJin91: bets 1034
jonnycongo: calls 1034
*** TURN *** [Js 5s 5h] [9d]
jonnycongo: checks=20
JJin91: bets 2413
jonnycongo: calls 2413
*** RIVER *** [Js 5s 5h 9d] [7c]
jonnycongo: checks=20
JJin91: bets 6964
jonnycongo: folds=20
Uncalled bet (6964) returned to JJin91
JJin91 collected 8708 from pot
JJin91: doesn't show hand=20
*** SUMMARY ***
Total pot 8708 | Rake 0=20
Board [Js 5s 5h 9d 7c]
Seat 1: jonnycongo (small blind) folded on the River
Seat 2: eliozica (big blind) folded before Flop
Seat 3: IPuntStacks folded before Flop (didn't bet)
Seat 5: JJin91 collected (8708)
Seat 6: robaydin (button) folded before Flop (didn't bet)


*********** # 41 **************
PokerStars Hand #169865647698: Tournament #1622537329, $13.50+$1.50 USD=
 Hold'em No Limit - Level IX (150/300) - 2017/05/14 15:04:24 ET
Table '1622537329 2' 6-max Seat #1 is the button
Seat 1: jonnycongo (17048 in chips)=20
Seat 2: eliozica (33353 in chips)=20
Seat 3: IPuntStacks (6936 in chips)=20
Seat 4: P0tty Mouth (10000 in chips)=20
Seat 5: JJin91 (21867 in chips)=20
Seat 6: robaydin (8668 in chips)=20
jonnycongo: posts the ante 40
eliozica: posts the ante 40
IPuntStacks: posts the ante 40
P0tty Mouth: posts the ante 40
JJin91: posts the ante 40
robaydin: posts the ante 40
eliozica: posts small blind 150
IPuntStacks: posts big blind 300
*** HOLE CARDS ***
Dealt to JJin91 [9s 2c]
P0tty Mouth: folds=20
JJin91: folds=20
robaydin: folds=20
jonnycongo: folds=20
eliozica: calls 150
IPuntStacks: checks=20
*** FLOP *** [Qc 6c 5d]
eliozica: bets 300
IPuntStacks: folds=20
Uncalled bet (300) returned to eliozica
eliozica collected 840 from pot
eliozica: doesn't show hand=20
*** SUMMARY ***
Total pot 840 | Rake 0=20
Board [Qc 6c 5d]
Seat 1: jonnycongo (button) folded before Flop (didn't bet)
Seat 2: eliozica (small blind) collected (840)
Seat 3: IPuntStacks (big blind) folded on the Flop
Seat 4: P0tty Mouth folded before Flop (didn't bet)
Seat 5: JJin91 folded before Flop (didn't bet)
Seat 6: robaydin folded before Flop (didn't bet)


*********** # 42 **************
PokerStars Hand #169865647822: Tournament #1622537329, $13.50+$1.50 USD=
 Hold'em No Limit - Level IX (150/300) - 2017/05/14 15:04:58 ET
Table '1622537329 2' 6-max Seat #2 is the button
Seat 1: jonnycongo (17008 in chips)=20
Seat 2: eliozica (33853 in chips)=20
Seat 3: IPuntStacks (6596 in chips)=20
Seat 4: P0tty Mouth (9960 in chips)=20
Seat 5: JJin91 (21827 in chips)=20
Seat 6: robaydin (8628 in chips)=20
jonnycongo: posts the ante 40
eliozica: posts the ante 40
IPuntStacks: posts the ante 40
P0tty Mouth: posts the ante 40
JJin91: posts the ante 40
robaydin: posts the ante 40
IPuntStacks: posts small blind 150
P0tty Mouth: posts big blind 300
*** HOLE CARDS ***
Dealt to JJin91 [9s 3c]
JJin91: folds=20
robaydin: raises 8288 to 8588 and is all-in
jonnycongo: folds=20
eliozica: calls 8588
IPuntStacks: folds=20
P0tty Mouth: folds=20
*** FLOP *** [3h 2s 5c]
*** TURN *** [3h 2s 5c] [Js]
*** RIVER *** [3h 2s 5c Js] [As]
*** SHOW DOWN ***
robaydin: shows [Ah Jd] (two pair, Aces and Jacks)
eliozica: shows [Ks Ad] (a pair of Aces)
robaydin collected 17866 from pot
*** SUMMARY ***
Total pot 17866 | Rake 0=20
Board [3h 2s 5c Js As]
Seat 1: jonnycongo folded before Flop (didn't bet)
Seat 2: eliozica (button) showed [Ks Ad] and lost with a pair of Aces
Seat 3: IPuntStacks (small blind) folded before Flop
Seat 4: P0tty Mouth (big blind) folded before Flop
Seat 5: JJin91 folded before Flop (didn't bet)
Seat 6: robaydin showed [Ah Jd] and won (17866) with two pair, Aces and=
 Jacks


*********** # 43 **************
PokerStars Hand #169865647893: Tournament #1622537329, $13.50+$1.50 USD=
 Hold'em No Limit - Level IX (150/300) - 2017/05/14 15:05:18 ET
Table '1622537329 2' 6-max Seat #3 is the button
Seat 1: jonnycongo (16968 in chips)=20
Seat 2: eliozica (25225 in chips)=20
Seat 3: IPuntStacks (6406 in chips)=20
Seat 4: P0tty Mouth (9620 in chips)=20
Seat 5: JJin91 (21787 in chips)=20
Seat 6: robaydin (17866 in chips)=20
jonnycongo: posts the ante 40
eliozica: posts the ante 40
IPuntStacks: posts the ante 40
P0tty Mouth: posts the ante 40
JJin91: posts the ante 40
robaydin: posts the ante 40
P0tty Mouth: posts small blind 150
JJin91: posts big blind 300
*** HOLE CARDS ***
Dealt to JJin91 [4s Qs]
robaydin: folds=20
jonnycongo: folds=20
eliozica: raises 300 to 600
IPuntStacks: raises 5766 to 6366 and is all-in
P0tty Mouth: folds=20
JJin91: folds=20
eliozica: folds=20
Uncalled bet (5766) returned to IPuntStacks
IPuntStacks collected 1890 from pot
*** SUMMARY ***
Total pot 1890 | Rake 0=20
Seat 1: jonnycongo folded before Flop (didn't bet)
Seat 2: eliozica folded before Flop
Seat 3: IPuntStacks (button) collected (1890)
Seat 4: P0tty Mouth (small blind) folded before Flop
Seat 5: JJin91 (big blind) folded before Flop
Seat 6: robaydin folded before Flop (didn't bet)


*********** # 44 **************
PokerStars Hand #169865647973: Tournament #1622537329, $13.50+$1.50 USD=
 Hold'em No Limit - Level IX (150/300) - 2017/05/14 15:05:41 ET
Table '1622537329 2' 6-max Seat #4 is the button
Seat 1: jonnycongo (16928 in chips)=20
Seat 2: eliozica (24585 in chips)=20
Seat 3: IPuntStacks (7656 in chips)=20
Seat 4: P0tty Mouth (9430 in chips)=20
Seat 5: JJin91 (21447 in chips)=20
Seat 6: robaydin (17826 in chips)=20
jonnycongo: posts the ante 40
eliozica: posts the ante 40
IPuntStacks: posts the ante 40
P0tty Mouth: posts the ante 40
JJin91: posts the ante 40
robaydin: posts the ante 40
JJin91: posts small blind 150
robaydin: posts big blind 300
*** HOLE CARDS ***
Dealt to JJin91 [5s 4c]
jonnycongo: folds=20
eliozica: calls 300
IPuntStacks: raises 575 to 875
P0tty Mouth: folds=20
JJin91: folds=20
robaydin: calls 575
eliozica: calls 575
*** FLOP *** [5c 6h Qd]
robaydin: checks=20
eliozica: checks=20
IPuntStacks: checks=20
*** TURN *** [5c 6h Qd] [7d]
robaydin: checks=20
eliozica: bets 600
IPuntStacks: calls 600
robaydin: calls 600
*** RIVER *** [5c 6h Qd 7d] [Jh]
robaydin: checks=20
eliozica: bets 2400
IPuntStacks: folds=20
robaydin: folds=20
Uncalled bet (2400) returned to eliozica
eliozica collected 4815 from pot
eliozica: doesn't show hand=20
*** SUMMARY ***
Total pot 4815 | Rake 0=20
Board [5c 6h Qd 7d Jh]
Seat 1: jonnycongo folded before Flop (didn't bet)
Seat 2: eliozica collected (4815)
Seat 3: IPuntStacks folded on the River
Seat 4: P0tty Mouth (button) folded before Flop (didn't bet)
Seat 5: JJin91 (small blind) folded before Flop
Seat 6: robaydin (big blind) folded on the River


*********** # 45 **************
PokerStars Hand #169865648269: Tournament #1622537329, $13.50+$1.50 USD=
 Hold'em No Limit - Level IX (150/300) - 2017/05/14 15:07:07 ET
Table '1622537329 2' 6-max Seat #5 is the button
Seat 1: jonnycongo (16888 in chips)=20
Seat 2: eliozica (27885 in chips)=20
Seat 3: IPuntStacks (6141 in chips)=20
Seat 4: P0tty Mouth (9390 in chips)=20
Seat 5: JJin91 (21257 in chips)=20
Seat 6: robaydin (16311 in chips)=20
jonnycongo: posts the ante 40
eliozica: posts the ante 40
IPuntStacks: posts the ante 40
P0tty Mouth: posts the ante 40
JJin91: posts the ante 40
robaydin: posts the ante 40
robaydin: posts small blind 150
jonnycongo: posts big blind 300
*** HOLE CARDS ***
Dealt to JJin91 [Kd 5s]
eliozica: folds=20
IPuntStacks: folds=20
P0tty Mouth: calls 300
JJin91: folds=20
robaydin: raises 1140 to 1440
jonnycongo: folds=20
P0tty Mouth: calls 1140
*** FLOP *** [2s 4s 3h]
robaydin: bets 1800
P0tty Mouth: folds=20
Uncalled bet (1800) returned to robaydin
robaydin collected 3420 from pot
robaydin: doesn't show hand=20
*** SUMMARY ***
Total pot 3420 | Rake 0=20
Board [2s 4s 3h]
Seat 1: jonnycongo (big blind) folded before Flop
Seat 2: eliozica folded before Flop (didn't bet)
Seat 3: IPuntStacks folded before Flop (didn't bet)
Seat 4: P0tty Mouth folded on the Flop
Seat 5: JJin91 (button) folded before Flop (didn't bet)
Seat 6: robaydin (small blind) collected (3420)


*********** # 46 **************
PokerStars Hand #169865648450: Tournament #1622537329, $13.50+$1.50 USD=
 Hold'em No Limit - Level IX (150/300) - 2017/05/14 15:07:55 ET
Table '1622537329 2' 6-max Seat #6 is the button
Seat 1: jonnycongo (16548 in chips)=20
Seat 2: eliozica (27845 in chips)=20
Seat 3: IPuntStacks (6101 in chips)=20
Seat 4: P0tty Mouth (7910 in chips)=20
Seat 5: JJin91 (21217 in chips)=20
Seat 6: robaydin (18251 in chips)=20
jonnycongo: posts the ante 40
eliozica: posts the ante 40
IPuntStacks: posts the ante 40
P0tty Mouth: posts the ante 40
JJin91: posts the ante 40
robaydin: posts the ante 40
jonnycongo: posts small blind 150
eliozica: posts big blind 300
*** HOLE CARDS ***
Dealt to JJin91 [Ad Kh]
IPuntStacks: calls 300
P0tty Mouth: folds=20
JJin91: raises 900 to 1200
robaydin: folds=20
jonnycongo: folds=20
eliozica: folds=20
IPuntStacks: calls 900
*** FLOP *** [5c Kd 6h]
IPuntStacks: checks=20
JJin91: bets 1143
IPuntStacks: raises 3718 to 4861 and is all-in
JJin91: calls 3718
*** TURN *** [5c Kd 6h] [Jd]
*** RIVER *** [5c Kd 6h Jd] [7h]
*** SHOW DOWN ***
IPuntStacks: shows [Js Kc] (two pair, Kings and Jacks)
JJin91: shows [Ad Kh] (a pair of Kings)
IPuntStacks collected 12812 from pot
*** SUMMARY ***
Total pot 12812 | Rake 0=20
Board [5c Kd 6h Jd 7h]
Seat 1: jonnycongo (small blind) folded before Flop
Seat 2: eliozica (big blind) folded before Flop
Seat 3: IPuntStacks showed [Js Kc] and won (12812) with two pair, Kings=
 and Jacks
Seat 4: P0tty Mouth folded before Flop (didn't bet)
Seat 5: JJin91 showed [Ad Kh] and lost with a pair of Kings
Seat 6: robaydin (button) folded before Flop (didn't bet)


*********** # 47 **************
PokerStars Hand #169865648568: Tournament #1622537329, $13.50+$1.50 USD=
 Hold'em No Limit - Level IX (150/300) - 2017/05/14 15:08:34 ET
Table '1622537329 2' 6-max Seat #1 is the button
Seat 1: jonnycongo (16358 in chips)=20
Seat 2: eliozica (27505 in chips)=20
Seat 3: IPuntStacks (12812 in chips)=20
Seat 4: P0tty Mouth (7870 in chips)=20
Seat 5: JJin91 (15116 in chips)=20
Seat 6: robaydin (18211 in chips)=20
jonnycongo: posts the ante 40
eliozica: posts the ante 40
IPuntStacks: posts the ante 40
P0tty Mouth: posts the ante 40
JJin91: posts the ante 40
robaydin: posts the ante 40
eliozica: posts small blind 150
IPuntStacks: posts big blind 300
*** HOLE CARDS ***
Dealt to JJin91 [2h 8c]
P0tty Mouth: folds=20
JJin91: folds=20
robaydin: folds=20
jonnycongo: folds=20
eliozica: calls 150
IPuntStacks: checks=20
*** FLOP *** [6c Kh 5h]
eliozica: bets 300
IPuntStacks: folds=20
Uncalled bet (300) returned to eliozica
eliozica collected 840 from pot
eliozica: doesn't show hand=20
*** SUMMARY ***
Total pot 840 | Rake 0=20
Board [6c Kh 5h]
Seat 1: jonnycongo (button) folded before Flop (didn't bet)
Seat 2: eliozica (small blind) collected (840)
Seat 3: IPuntStacks (big blind) folded on the Flop
Seat 4: P0tty Mouth folded before Flop (didn't bet)
Seat 5: JJin91 folded before Flop (didn't bet)
Seat 6: robaydin folded before Flop (didn't bet)


*********** # 48 **************
PokerStars Hand #169865648659: Tournament #1622537329, $13.50+$1.50 USD=
 Hold'em No Limit - Level IX (150/300) - 2017/05/14 15:09:03 ET
Table '1622537329 2' 6-max Seat #2 is the button
Seat 1: jonnycongo (16318 in chips)=20
Seat 2: eliozica (28005 in chips)=20
Seat 3: IPuntStacks (12472 in chips)=20
Seat 4: P0tty Mouth (7830 in chips)=20
Seat 5: JJin91 (15076 in chips)=20
Seat 6: robaydin (18171 in chips)=20
jonnycongo: posts the ante 40
eliozica: posts the ante 40
IPuntStacks: posts the ante 40
P0tty Mouth: posts the ante 40
JJin91: posts the ante 40
robaydin: posts the ante 40
IPuntStacks: posts small blind 150
P0tty Mouth: posts big blind 300
*** HOLE CARDS ***
Dealt to JJin91 [Jh 8c]
JJin91: folds=20
robaydin: folds=20
jonnycongo: calls 300
eliozica: calls 300
IPuntStacks: calls 150
P0tty Mouth: checks=20
*** FLOP *** [2s 9d 4c]
IPuntStacks: checks=20
P0tty Mouth: bets 300
jonnycongo: folds=20
eliozica: folds=20
IPuntStacks: folds=20
Uncalled bet (300) returned to P0tty Mouth
P0tty Mouth collected 1440 from pot
P0tty Mouth: doesn't show hand=20
*** SUMMARY ***
Total pot 1440 | Rake 0=20
Board [2s 9d 4c]
Seat 1: jonnycongo folded on the Flop
Seat 2: eliozica (button) folded on the Flop
Seat 3: IPuntStacks (small blind) folded on the Flop
Seat 4: P0tty Mouth (big blind) collected (1440)
Seat 5: JJin91 folded before Flop (didn't bet)
Seat 6: robaydin folded before Flop (didn't bet)


*********** # 49 **************
PokerStars Hand #169865648805: Tournament #1622537329, $13.50+$1.50 USD=
 Hold'em No Limit - Level IX (150/300) - 2017/05/14 15:09:44 ET
Table '1622537329 2' 6-max Seat #3 is the button
Seat 1: jonnycongo (15978 in chips)=20
Seat 2: eliozica (27665 in chips)=20
Seat 3: IPuntStacks (12132 in chips)=20
Seat 4: P0tty Mouth (8930 in chips)=20
Seat 5: JJin91 (15036 in chips)=20
Seat 6: robaydin (18131 in chips)=20
jonnycongo: posts the ante 40
eliozica: posts the ante 40
IPuntStacks: posts the ante 40
P0tty Mouth: posts the ante 40
JJin91: posts the ante 40
robaydin: posts the ante 40
P0tty Mouth: posts small blind 150
JJin91: posts big blind 300
*** HOLE CARDS ***
Dealt to JJin91 [3c 4h]
robaydin: calls 300
jonnycongo: folds=20
eliozica: raises 300 to 600
IPuntStacks: folds=20
P0tty Mouth: calls 450
JJin91: folds=20
robaydin: calls 300
*** FLOP *** [5d 7s 9h]
P0tty Mouth: bets 300
robaydin: calls 300
eliozica: calls 300
*** TURN *** [5d 7s 9h] [As]
P0tty Mouth: bets 900
robaydin: folds=20
eliozica: folds=20
Uncalled bet (900) returned to P0tty Mouth
P0tty Mouth collected 3240 from pot
P0tty Mouth: doesn't show hand=20
*** SUMMARY ***
Total pot 3240 | Rake 0=20
Board [5d 7s 9h As]
Seat 1: jonnycongo folded before Flop (didn't bet)
Seat 2: eliozica folded on the Turn
Seat 3: IPuntStacks (button) folded before Flop (didn't bet)
Seat 4: P0tty Mouth (small blind) collected (3240)
Seat 5: JJin91 (big blind) folded before Flop
Seat 6: robaydin folded on the Turn


*********** # 50 **************
PokerStars Hand #169865648944: Tournament #1622537329, $13.50+$1.50 USD=
 Hold'em No Limit - Level IX (150/300) - 2017/05/14 15:10:25 ET
Table '1622537329 2' 6-max Seat #4 is the button
Seat 1: jonnycongo (15938 in chips)=20
Seat 2: eliozica (26725 in chips)=20
Seat 3: IPuntStacks (12092 in chips)=20
Seat 4: P0tty Mouth (11230 in chips)=20
Seat 5: JJin91 (14696 in chips)=20
Seat 6: robaydin (17191 in chips)=20
jonnycongo: posts the ante 40
eliozica: posts the ante 40
IPuntStacks: posts the ante 40
P0tty Mouth: posts the ante 40
JJin91: posts the ante 40
robaydin: posts the ante 40
JJin91: posts small blind 150
robaydin: posts big blind 300
*** HOLE CARDS ***
Dealt to JJin91 [7s 3s]
jonnycongo: folds=20
eliozica: raises 300 to 600
IPuntStacks: folds=20
P0tty Mouth: calls 600
JJin91: folds=20
robaydin: calls 300
*** FLOP *** [9s 4h 3h]
robaydin: checks=20
eliozica: checks=20
P0tty Mouth: bets 300
robaydin: calls 300
eliozica: raises 3000 to 3300
P0tty Mouth: calls 3000
robaydin: calls 3000
*** TURN *** [9s 4h 3h] [Ad]
robaydin: checks=20
eliozica: bets 12000
P0tty Mouth: folds=20
robaydin: calls 12000
*** RIVER *** [9s 4h 3h Ad] [2h]
robaydin: bets 1251 and is all-in
eliozica: calls 1251
*** SHOW DOWN ***
robaydin: shows [5h 8h] (a flush, Eight high)
eliozica: shows [Th Jh] (a flush, Jack high)
eliozica collected 38592 from pot
robaydin finished the tournament in 86th place
*** SUMMARY ***
Total pot 38592 | Rake 0=20
Board [9s 4h 3h Ad 2h]
Seat 1: jonnycongo folded before Flop (didn't bet)
Seat 2: eliozica showed [Th Jh] and won (38592) with a flush, Jack high
Seat 3: IPuntStacks folded before Flop (didn't bet)
Seat 4: P0tty Mouth (button) folded on the Turn
Seat 5: JJin91 (small blind) folded before Flop
Seat 6: robaydin (big blind) showed [5h 8h] and lost with a flush, Eigh=
t high


*********** # 51 **************
PokerStars Hand #169865649090: Tournament #1622537329, $13.50+$1.50 USD=
 Hold'em No Limit - Level IX (150/300) - 2017/05/14 15:11:08 ET
Table '1622537329 2' 6-max Seat #5 is the button
Seat 1: jonnycongo (15898 in chips)=20
Seat 2: eliozica (48126 in chips)=20
Seat 3: IPuntStacks (12052 in chips)=20
Seat 4: P0tty Mouth (7290 in chips)=20
Seat 5: JJin91 (14506 in chips)=20
jonnycongo: posts the ante 40
eliozica: posts the ante 40
IPuntStacks: posts the ante 40
P0tty Mouth: posts the ante 40
JJin91: posts the ante 40
jonnycongo: posts small blind 150
eliozica: posts big blind 300
*** HOLE CARDS ***
Dealt to JJin91 [Th 8c]
IPuntStacks: folds=20
P0tty Mouth: folds=20
JJin91: raises 357 to 657
jonnycongo: folds=20
eliozica: folds=20
Uncalled bet (357) returned to JJin91
JJin91 collected 950 from pot
JJin91: doesn't show hand=20
*** SUMMARY ***
Total pot 950 | Rake 0=20
Seat 1: jonnycongo (small blind) folded before Flop
Seat 2: eliozica (big blind) folded before Flop
Seat 3: IPuntStacks folded before Flop (didn't bet)
Seat 4: P0tty Mouth folded before Flop (didn't bet)
Seat 5: JJin91 (button) collected (950)


*********** # 52 **************
PokerStars Hand #169865649166: Tournament #1622537329, $13.50+$1.50 USD=
 Hold'em No Limit - Level IX (150/300) - 2017/05/14 15:11:32 ET
Table '1622537329 2' 6-max Seat #1 is the button
Seat 1: jonnycongo (15708 in chips)=20
Seat 2: eliozica (47786 in chips)=20
Seat 3: IPuntStacks (12012 in chips)=20
Seat 4: P0tty Mouth (7250 in chips)=20
Seat 5: JJin91 (15116 in chips)=20
jonnycongo: posts the ante 40
eliozica: posts the ante 40
IPuntStacks: posts the ante 40
P0tty Mouth: posts the ante 40
JJin91: posts the ante 40
eliozica: posts small blind 150
IPuntStacks: posts big blind 300
*** HOLE CARDS ***
Dealt to JJin91 [5h Th]
P0tty Mouth: folds=20
JJin91: folds=20
jonnycongo: raises 300 to 600
eliozica: calls 450
IPuntStacks: calls 300
*** FLOP *** [3c 7d Kh]
eliozica: checks=20
IPuntStacks: checks=20
jonnycongo: checks=20
*** TURN *** [3c 7d Kh] [5s]
eliozica: checks=20
IPuntStacks: bets 660
jonnycongo: folds=20
eliozica: folds=20
Uncalled bet (660) returned to IPuntStacks
IPuntStacks collected 2000 from pot
*** SUMMARY ***
Total pot 2000 | Rake 0=20
Board [3c 7d Kh 5s]
Seat 1: jonnycongo (button) folded on the Turn
Seat 2: eliozica (small blind) folded on the Turn
Seat 3: IPuntStacks (big blind) collected (2000)
Seat 4: P0tty Mouth folded before Flop (didn't bet)
Seat 5: JJin91 folded before Flop (didn't bet)


*********** # 53 **************
PokerStars Hand #169865649312: Tournament #1622537329, $13.50+$1.50 USD=
 Hold'em No Limit - Level X (200/400) - 2017/05/14 15:12:15 ET
Table '1622537329 2' 6-max Seat #2 is the button
Seat 1: jonnycongo (15068 in chips)=20
Seat 2: eliozica (47146 in chips)=20
Seat 3: IPuntStacks (13372 in chips)=20
Seat 4: P0tty Mouth (7210 in chips)=20
Seat 5: JJin91 (15076 in chips)=20
jonnycongo: posts the ante 50
eliozica: posts the ante 50
IPuntStacks: posts the ante 50
P0tty Mouth: posts the ante 50
JJin91: posts the ante 50
IPuntStacks: posts small blind 200
P0tty Mouth: posts big blind 400
*** HOLE CARDS ***
Dealt to JJin91 [6d 5c]
JJin91: folds=20
jonnycongo: calls 400
eliozica: calls 400
IPuntStacks: calls 200
P0tty Mouth: checks=20
*** FLOP *** [Js 9s 4d]
IPuntStacks: checks=20
P0tty Mouth: checks=20
jonnycongo: bets 800
eliozica: calls 800
IPuntStacks: folds=20
P0tty Mouth: calls 800
*** TURN *** [Js 9s 4d] [Ts]
P0tty Mouth: checks=20
jonnycongo: bets 13818 and is all-in
eliozica: folds=20
P0tty Mouth: folds=20
Uncalled bet (13818) returned to jonnycongo
jonnycongo collected 4250 from pot
*** SUMMARY ***
Total pot 4250 | Rake 0=20
Board [Js 9s 4d Ts]
Seat 1: jonnycongo collected (4250)
Seat 2: eliozica (button) folded on the Turn
Seat 3: IPuntStacks (small blind) folded on the Flop
Seat 4: P0tty Mouth (big blind) folded on the Turn
Seat 5: JJin91 folded before Flop (didn't bet)


*********** # 54 **************
PokerStars Hand #169865649472: Tournament #1622537329, $13.50+$1.50 USD=
 Hold'em No Limit - Level X (200/400) - 2017/05/14 15:12:58 ET
Table '1622537329 2' 6-max Seat #3 is the button
Seat 1: jonnycongo (18068 in chips)=20
Seat 2: eliozica (45896 in chips)=20
Seat 3: IPuntStacks (12922 in chips)=20
Seat 4: P0tty Mouth (5960 in chips)=20
Seat 5: JJin91 (15026 in chips)=20
jonnycongo: posts the ante 50
eliozica: posts the ante 50
IPuntStacks: posts the ante 50
P0tty Mouth: posts the ante 50
JJin91: posts the ante 50
P0tty Mouth: posts small blind 200
JJin91: posts big blind 400
*** HOLE CARDS ***
Dealt to JJin91 [Js 6d]
jonnycongo: folds=20
eliozica: folds=20
IPuntStacks: folds=20
P0tty Mouth: folds=20
Uncalled bet (200) returned to JJin91
JJin91 collected 650 from pot
JJin91: doesn't show hand=20
*** SUMMARY ***
Total pot 650 | Rake 0=20
Seat 1: jonnycongo folded before Flop (didn't bet)
Seat 2: eliozica folded before Flop (didn't bet)
Seat 3: IPuntStacks (button) folded before Flop (didn't bet)
Seat 4: P0tty Mouth (small blind) folded before Flop
Seat 5: JJin91 (big blind) collected (650)


*********** # 55 **************
PokerStars Hand #169865649535: Tournament #1622537329, $13.50+$1.50 USD=
 Hold'em No Limit - Level X (200/400) - 2017/05/14 15:13:14 ET
Table '1622537329 2' 6-max Seat #4 is the button
Seat 1: jonnycongo (18018 in chips)=20
Seat 2: eliozica (45846 in chips)=20
Seat 3: IPuntStacks (12872 in chips)=20
Seat 4: P0tty Mouth (5710 in chips)=20
Seat 5: JJin91 (15426 in chips)=20
jonnycongo: posts the ante 50
eliozica: posts the ante 50
IPuntStacks: posts the ante 50
P0tty Mouth: posts the ante 50
JJin91: posts the ante 50
JJin91: posts small blind 200
jonnycongo: posts big blind 400
*** HOLE CARDS ***
Dealt to JJin91 [2s 9d]
eliozica: folds=20
IPuntStacks: folds=20
P0tty Mouth: calls 400
JJin91: folds=20
jonnycongo: checks=20
*** FLOP *** [Th 6d Qh]
jonnycongo: checks=20
P0tty Mouth: bets 800
jonnycongo: folds=20
Uncalled bet (800) returned to P0tty Mouth
P0tty Mouth collected 1250 from pot
P0tty Mouth: doesn't show hand=20
*** SUMMARY ***
Total pot 1250 | Rake 0=20
Board [Th 6d Qh]
Seat 1: jonnycongo (big blind) folded on the Flop
Seat 2: eliozica folded before Flop (didn't bet)
Seat 3: IPuntStacks folded before Flop (didn't bet)
Seat 4: P0tty Mouth (button) collected (1250)
Seat 5: JJin91 (small blind) folded before Flop


*********** # 56 **************
PokerStars Hand #169865649645: Tournament #1622537329, $13.50+$1.50 USD=
 Hold'em No Limit - Level X (200/400) - 2017/05/14 15:13:43 ET
Table '1622537329 2' 6-max Seat #5 is the button
Seat 1: jonnycongo (17568 in chips)=20
Seat 2: eliozica (45796 in chips)=20
Seat 3: IPuntStacks (12822 in chips)=20
Seat 4: P0tty Mouth (6510 in chips)=20
Seat 5: JJin91 (15176 in chips)=20
jonnycongo: posts the ante 50
eliozica: posts the ante 50
IPuntStacks: posts the ante 50
P0tty Mouth: posts the ante 50
JJin91: posts the ante 50
jonnycongo: posts small blind 200
eliozica: posts big blind 400
*** HOLE CARDS ***
Dealt to JJin91 [2c Qs]
IPuntStacks: folds=20
P0tty Mouth: folds=20
JJin91: folds=20
jonnycongo: raises 400 to 800
eliozica: calls 400
*** FLOP *** [6s 9h 9c]
jonnycongo: checks=20
eliozica: bets 800
jonnycongo: calls 800
*** TURN *** [6s 9h 9c] [6d]
jonnycongo: checks=20
eliozica: bets 1600
jonnycongo: calls 1600
*** RIVER *** [6s 9h 9c 6d] [Ks]
jonnycongo: checks=20
eliozica: checks=20
*** SHOW DOWN ***
jonnycongo: shows [Kd Ah] (two pair, Kings and Nines)
eliozica: mucks hand=20
jonnycongo collected 6650 from pot
*** SUMMARY ***
Total pot 6650 | Rake 0=20
Board [6s 9h 9c 6d Ks]
Seat 1: jonnycongo (small blind) showed [Kd Ah] and won (6650) with two=
 pair, Kings and Nines
Seat 2: eliozica (big blind) mucked [Th 3d]
Seat 3: IPuntStacks folded before Flop (didn't bet)
Seat 4: P0tty Mouth folded before Flop (didn't bet)
Seat 5: JJin91 (button) folded before Flop (didn't bet)


*********** # 57 **************
PokerStars Hand #169865649760: Tournament #1622537329, $13.50+$1.50 USD=
 Hold'em No Limit - Level X (200/400) - 2017/05/14 15:14:14 ET
Table '1622537329 2' 6-max Seat #1 is the button
Seat 1: jonnycongo (20968 in chips)=20
Seat 2: eliozica (42546 in chips)=20
Seat 3: IPuntStacks (12772 in chips)=20
Seat 4: P0tty Mouth (6460 in chips)=20
Seat 5: JJin91 (15126 in chips)=20
jonnycongo: posts the ante 50
eliozica: posts the ante 50
IPuntStacks: posts the ante 50
P0tty Mouth: posts the ante 50
JJin91: posts the ante 50
eliozica: posts small blind 200
IPuntStacks: posts big blind 400
*** HOLE CARDS ***
Dealt to JJin91 [Ac 4c]
P0tty Mouth: folds=20
JJin91: raises 476 to 876
jonnycongo: folds=20
eliozica: calls 676
IPuntStacks: folds=20
*** FLOP *** [Ad Qd Qh]
eliozica: checks=20
JJin91: bets 1369
eliozica: folds=20
Uncalled bet (1369) returned to JJin91
JJin91 collected 2402 from pot
JJin91: doesn't show hand=20
*** SUMMARY ***
Total pot 2402 | Rake 0=20
Board [Ad Qd Qh]
Seat 1: jonnycongo (button) folded before Flop (didn't bet)
Seat 2: eliozica (small blind) folded on the Flop
Seat 3: IPuntStacks (big blind) folded before Flop
Seat 4: P0tty Mouth folded before Flop (didn't bet)
Seat 5: JJin91 collected (2402)


*********** # 58 **************
PokerStars Hand #169865649870: Tournament #1622537329, $13.50+$1.50 USD=
 Hold'em No Limit - Level X (200/400) - 2017/05/14 15:14:45 ET
Table '1622537329 2' 6-max Seat #2 is the button
Seat 1: jonnycongo (20918 in chips)=20
Seat 2: eliozica (41620 in chips)=20
Seat 3: IPuntStacks (12322 in chips)=20
Seat 4: P0tty Mouth (6410 in chips)=20
Seat 5: JJin91 (16602 in chips)=20
jonnycongo: posts the ante 50
eliozica: posts the ante 50
IPuntStacks: posts the ante 50
P0tty Mouth: posts the ante 50
JJin91: posts the ante 50
IPuntStacks: posts small blind 200
P0tty Mouth: posts big blind 400
*** HOLE CARDS ***
Dealt to JJin91 [5h 2d]
JJin91: folds=20
jonnycongo: folds=20
eliozica: folds=20
IPuntStacks: calls 200
P0tty Mouth: checks=20
*** FLOP *** [2s 4h Jh]
IPuntStacks: checks=20
P0tty Mouth: bets 400
IPuntStacks: folds=20
Uncalled bet (400) returned to P0tty Mouth
P0tty Mouth collected 1050 from pot
P0tty Mouth: doesn't show hand=20
*** SUMMARY ***
Total pot 1050 | Rake 0=20
Board [2s 4h Jh]
Seat 1: jonnycongo folded before Flop (didn't bet)
Seat 2: eliozica (button) folded before Flop (didn't bet)
Seat 3: IPuntStacks (small blind) folded on the Flop
Seat 4: P0tty Mouth (big blind) collected (1050)
Seat 5: JJin91 folded before Flop (didn't bet)


*********** # 59 **************
PokerStars Hand #169868506865: Tournament #1622537329, $13.50+$1.50 USD=
 Hold'em No Limit - Level X (200/400) - 2017/05/14 15:15:35 ET
Table '1622537329 2' 6-max Seat #3 is the button
Seat 1: jonnycongo (20868 in chips)=20
Seat 2: eliozica (41570 in chips)=20
Seat 3: IPuntStacks (11872 in chips)=20
Seat 4: P0tty Mouth (7010 in chips)=20
Seat 5: JJin91 (16552 in chips)=20
jonnycongo: posts the ante 50
eliozica: posts the ante 50
IPuntStacks: posts the ante 50
P0tty Mouth: posts the ante 50
JJin91: posts the ante 50
P0tty Mouth: posts small blind 200
JJin91: posts big blind 400
*** HOLE CARDS ***
Dealt to JJin91 [Qs 4s]
jonnycongo: folds=20
eliozica: calls 400
IPuntStacks: raises 700 to 1100
P0tty Mouth: raises 5860 to 6960 and is all-in
JJin91: folds=20
eliozica: folds=20
IPuntStacks: calls 5860
*** FLOP *** [5h Kc 5d]
*** TURN *** [5h Kc 5d] [2s]
*** RIVER *** [5h Kc 5d 2s] [4c]
*** SHOW DOWN ***
P0tty Mouth: shows [9c 9s] (two pair, Nines and Fives)
IPuntStacks: shows [Ad 8s] (a pair of Fives)
P0tty Mouth collected 14970 from pot
*** SUMMARY ***
Total pot 14970 | Rake 0=20
Board [5h Kc 5d 2s 4c]
Seat 1: jonnycongo folded before Flop (didn't bet)
Seat 2: eliozica folded before Flop
Seat 3: IPuntStacks (button) showed [Ad 8s] and lost with a pair of Fiv=
es
Seat 4: P0tty Mouth (small blind) showed [9c 9s] and won (14970) with t=
wo pair, Nines and Fives
Seat 5: JJin91 (big blind) folded before Flop


*********** # 60 **************
PokerStars Hand #169868507047: Tournament #1622537329, $13.50+$1.50 USD=
 Hold'em No Limit - Level X (200/400) - 2017/05/14 15:16:24 ET
Table '1622537329 2' 6-max Seat #4 is the button
Seat 1: jonnycongo (20818 in chips)=20
Seat 2: eliozica (41120 in chips)=20
Seat 3: IPuntStacks (4862 in chips)=20
Seat 4: P0tty Mouth (14970 in chips)=20
Seat 5: JJin91 (16102 in chips)=20
Seat 6: JohnnyMania (10000 in chips)=20
jonnycongo: posts the ante 50
eliozica: posts the ante 50
IPuntStacks: posts the ante 50
P0tty Mouth: posts the ante 50
JJin91: posts the ante 50
JohnnyMania: posts the ante 50
JJin91: posts small blind 200
JohnnyMania: posts big blind 400
*** HOLE CARDS ***
Dealt to JJin91 [4d 9d]
jonnycongo: calls 400
eliozica: folds=20
IPuntStacks: calls 400
P0tty Mouth: folds=20
JJin91: calls 200
JohnnyMania: checks=20
*** FLOP *** [3d 3c Ac]
JJin91: checks=20
JohnnyMania: checks=20
jonnycongo: bets 400
IPuntStacks: folds=20
JJin91: raises 1600 to 2000
JohnnyMania: folds=20
jonnycongo: calls 1600
*** TURN *** [3d 3c Ac] [2h]
JJin91: checks=20
jonnycongo: bets 5900
JJin91: folds=20
Uncalled bet (5900) returned to jonnycongo
jonnycongo collected 5900 from pot
*** SUMMARY ***
Total pot 5900 | Rake 0=20
Board [3d 3c Ac 2h]
Seat 1: jonnycongo collected (5900)
Seat 2: eliozica folded before Flop (didn't bet)
Seat 3: IPuntStacks folded on the Flop
Seat 4: P0tty Mouth (button) folded before Flop (didn't bet)
Seat 5: JJin91 (small blind) folded on the Turn
Seat 6: JohnnyMania (big blind) folded on the Flop


*********** # 61 **************
PokerStars Hand #169868507242: Tournament #1622537329, $13.50+$1.50 USD=
 Hold'em No Limit - Level X (200/400) - 2017/05/14 15:17:23 ET
Table '1622537329 2' 6-max Seat #5 is the button
Seat 1: jonnycongo (24268 in chips)=20
Seat 2: eliozica (41070 in chips)=20
Seat 3: IPuntStacks (4412 in chips)=20
Seat 4: P0tty Mouth (14920 in chips)=20
Seat 5: JJin91 (13652 in chips)=20
Seat 6: JohnnyMania (9550 in chips)=20
jonnycongo: posts the ante 50
eliozica: posts the ante 50
IPuntStacks: posts the ante 50
P0tty Mouth: posts the ante 50
JJin91: posts the ante 50
JohnnyMania: posts the ante 50
JohnnyMania: posts small blind 200
jonnycongo: posts big blind 400
*** HOLE CARDS ***
Dealt to JJin91 [As 6s]
eliozica: raises 400 to 800
IPuntStacks: folds=20
P0tty Mouth: folds=20
JJin91: calls 800
JohnnyMania: raises 8700 to 9500 and is all-in
jonnycongo: folds=20
eliozica: calls 8700
JJin91: folds=20
*** FLOP *** [6d 4h Ah]
*** TURN *** [6d 4h Ah] [Ac]
*** RIVER *** [6d 4h Ah Ac] [4d]
*** SHOW DOWN ***
JohnnyMania: shows [Th Td] (two pair, Aces and Tens)
eliozica: shows [Ad 9c] (a full house, Aces full of Fours)
eliozica collected 20500 from pot
JohnnyMania finished the tournament in 82nd place
*** SUMMARY ***
Total pot 20500 | Rake 0=20
Board [6d 4h Ah Ac 4d]
Seat 1: jonnycongo (big blind) folded before Flop
Seat 2: eliozica showed [Ad 9c] and won (20500) with a full house, Aces=
 full of Fours
Seat 3: IPuntStacks folded before Flop (didn't bet)
Seat 4: P0tty Mouth folded before Flop (didn't bet)
Seat 5: JJin91 (button) folded before Flop
Seat 6: JohnnyMania (small blind) showed [Th Td] and lost with two pair=
, Aces and Tens


*********** # 62 **************
PokerStars Hand #169868507359: Tournament #1622537329, $13.50+$1.50 USD=
 Hold'em No Limit - Level X (200/400) - 2017/05/14 15:17:58 ET
Table '1622537329 2' 6-max Seat #1 is the button
Seat 1: jonnycongo (23818 in chips)=20
Seat 2: eliozica (52020 in chips)=20
Seat 3: IPuntStacks (4362 in chips)=20
Seat 4: P0tty Mouth (14870 in chips)=20
Seat 5: JJin91 (12802 in chips)=20
jonnycongo: posts the ante 50
eliozica: posts the ante 50
IPuntStacks: posts the ante 50
P0tty Mouth: posts the ante 50
JJin91: posts the ante 50
eliozica: posts small blind 200
IPuntStacks: posts big blind 400
*** HOLE CARDS ***
Dealt to JJin91 [Jc Jh]
P0tty Mouth: calls 400
JJin91: raises 1200 to 1600
jonnycongo: folds=20
eliozica: folds=20
IPuntStacks: raises 2712 to 4312 and is all-in
P0tty Mouth: calls 3912
JJin91: raises 8440 to 12752 and is all-in
P0tty Mouth: folds=20
Uncalled bet (8440) returned to JJin91
*** FLOP *** [Ah Kc Jd]
*** TURN *** [Ah Kc Jd] [Js]
*** RIVER *** [Ah Kc Jd Js] [5s]
*** SHOW DOWN ***
IPuntStacks: shows [8c 7c] (a pair of Jacks)
JJin91: shows [Jc Jh] (four of a kind, Jacks)
JJin91 collected 13386 from pot
IPuntStacks finished the tournament in 81st place
*** SUMMARY ***
Total pot 13386 | Rake 0=20
Board [Ah Kc Jd Js 5s]
Seat 1: jonnycongo (button) folded before Flop (didn't bet)
Seat 2: eliozica (small blind) folded before Flop
Seat 3: IPuntStacks (big blind) showed [8c 7c] and lost with a pair of =
Jacks
Seat 4: P0tty Mouth folded before Flop
Seat 5: JJin91 showed [Jc Jh] and won (13386) with four of a kind, Jacks


*********** # 63 **************
PokerStars Hand #169868507482: Tournament #1622537329, $13.50+$1.50 USD=
 Hold'em No Limit - Level X (200/400) - 2017/05/14 15:18:36 ET
Table '1622537329 2' 6-max Seat #2 is the button
Seat 1: jonnycongo (23768 in chips)=20
Seat 2: eliozica (51770 in chips)=20
Seat 4: P0tty Mouth (10508 in chips)=20
Seat 5: JJin91 (21826 in chips)=20
Seat 6: JerseyJinx28 (10000 in chips)=20
jonnycongo: posts the ante 50
eliozica: posts the ante 50
P0tty Mouth: posts the ante 50
JJin91: posts the ante 50
JerseyJinx28: posts the ante 50
P0tty Mouth: posts small blind 200
JJin91: posts big blind 400
*** HOLE CARDS ***
Dealt to JJin91 [5d 7d]
JerseyJinx28: calls 400
jonnycongo: folds=20
eliozica: folds=20
P0tty Mouth: calls 200
JJin91: checks=20
*** FLOP *** [4h 8c 9s]
P0tty Mouth: bets 1200
JJin91: calls 1200
JerseyJinx28: folds=20
*** TURN *** [4h 8c 9s] [Ks]
P0tty Mouth: bets 800
JJin91: calls 800
*** RIVER *** [4h 8c 9s Ks] [Ts]
P0tty Mouth: bets 1600
JJin91: raises 17776 to 19376 and is all-in
P0tty Mouth: folds=20
Uncalled bet (17776) returned to JJin91
JJin91 collected 8650 from pot
JJin91: doesn't show hand=20
*** SUMMARY ***
Total pot 8650 | Rake 0=20
Board [4h 8c 9s Ks Ts]
Seat 1: jonnycongo folded before Flop (didn't bet)
Seat 2: eliozica (button) folded before Flop (didn't bet)
Seat 4: P0tty Mouth (small blind) folded on the River
Seat 5: JJin91 (big blind) collected (8650)
Seat 6: JerseyJinx28 folded on the Flop


*********** # 64 **************
PokerStars Hand #169868507691: Tournament #1622537329, $13.50+$1.50 USD=
 Hold'em No Limit - Level X (200/400) - 2017/05/14 15:19:35 ET
Table '1622537329 2' 6-max Seat #4 is the button
Seat 1: jonnycongo (23718 in chips)=20
Seat 2: eliozica (51720 in chips)=20
Seat 4: P0tty Mouth (6458 in chips)=20
Seat 5: JJin91 (26426 in chips)=20
Seat 6: JerseyJinx28 (9550 in chips)=20
jonnycongo: posts the ante 50
eliozica: posts the ante 50
P0tty Mouth: posts the ante 50
JJin91: posts the ante 50
JerseyJinx28: posts the ante 50
JJin91: posts small blind 200
JerseyJinx28: posts big blind 400
*** HOLE CARDS ***
Dealt to JJin91 [3h Th]
jonnycongo: folds=20
eliozica: folds=20
P0tty Mouth: folds=20
JJin91: folds=20
Uncalled bet (200) returned to JerseyJinx28
JerseyJinx28 collected 650 from pot
JerseyJinx28: doesn't show hand=20
*** SUMMARY ***
Total pot 650 | Rake 0=20
Seat 1: jonnycongo folded before Flop (didn't bet)
Seat 2: eliozica folded before Flop (didn't bet)
Seat 4: P0tty Mouth (button) folded before Flop (didn't bet)
Seat 5: JJin91 (small blind) folded before Flop
Seat 6: JerseyJinx28 (big blind) collected (650)


*********** # 65 **************
PokerStars Hand #169868507721: Tournament #1622537329, $13.50+$1.50 USD=
 Hold'em No Limit - Level X (200/400) - 2017/05/14 15:19:44 ET
Table '1622537329 2' 6-max Seat #5 is the button
Seat 1: jonnycongo (23668 in chips)=20
Seat 2: eliozica (51670 in chips)=20
Seat 4: P0tty Mouth (6408 in chips)=20
Seat 5: JJin91 (26176 in chips)=20
Seat 6: JerseyJinx28 (9950 in chips)=20
jonnycongo: posts the ante 50
eliozica: posts the ante 50
P0tty Mouth: posts the ante 50
JJin91: posts the ante 50
JerseyJinx28: posts the ante 50
JerseyJinx28: posts small blind 200
jonnycongo: posts big blind 400
*** HOLE CARDS ***
Dealt to JJin91 [6s Th]
eliozica: folds=20
P0tty Mouth: calls 400
JJin91: folds=20
JerseyJinx28: raises 800 to 1200
jonnycongo: raises 22418 to 23618 and is all-in
P0tty Mouth: folds=20
JerseyJinx28: calls 8700 and is all-in
Uncalled bet (13718) returned to jonnycongo
*** FLOP *** [7h 5c Jc]
*** TURN *** [7h 5c Jc] [Kc]
*** RIVER *** [7h 5c Jc Kc] [Td]
*** SHOW DOWN ***
JerseyJinx28: shows [Qd Jd] (a pair of Jacks)
jonnycongo: shows [Js Jh] (three of a kind, Jacks)
jonnycongo collected 20450 from pot
JerseyJinx28 finished the tournament in 77th place
*** SUMMARY ***
Total pot 20450 | Rake 0=20
Board [7h 5c Jc Kc Td]
Seat 1: jonnycongo (big blind) showed [Js Jh] and won (20450) with thre=
e of a kind, Jacks
Seat 2: eliozica folded before Flop (didn't bet)
Seat 4: P0tty Mouth folded before Flop
Seat 5: JJin91 (button) folded before Flop (didn't bet)
Seat 6: JerseyJinx28 (small blind) showed [Qd Jd] and lost with a pair =
of Jacks


*********** # 66 **************
PokerStars Hand #169868507830: Tournament #1622537329, $13.50+$1.50 USD=
 Hold'em No Limit - Level X (200/400) - 2017/05/14 15:20:16 ET
Table '1622537329 2' 6-max Seat #1 is the button
Seat 1: jonnycongo (34168 in chips)=20
Seat 2: eliozica (51620 in chips)=20
Seat 4: P0tty Mouth (5958 in chips)=20
Seat 5: JJin91 (26126 in chips)=20
Seat 6: excon tyrone (5750 in chips)=20
jonnycongo: posts the ante 50
eliozica: posts the ante 50
P0tty Mouth: posts the ante 50
JJin91: posts the ante 50
excon tyrone: posts the ante 50
eliozica: posts small blind 200
P0tty Mouth: posts big blind 400
*** HOLE CARDS ***
Dealt to JJin91 [Ts 4d]
JJin91: folds=20
excon tyrone: calls 400
jonnycongo: folds=20
eliozica: calls 200
P0tty Mouth: checks=20
*** FLOP *** [Jc 5s 9c]
eliozica: checks=20
P0tty Mouth: bets 5508 and is all-in
excon tyrone: calls 5300 and is all-in
eliozica: folds=20
Uncalled bet (208) returned to P0tty Mouth
*** TURN *** [Jc 5s 9c] [7s]
*** RIVER *** [Jc 5s 9c 7s] [3d]
*** SHOW DOWN ***
P0tty Mouth: shows [6c 3c] (a pair of Threes)
excon tyrone: shows [4c Ac] (high card Ace)
P0tty Mouth collected 12050 from pot
excon tyrone finished the tournament in 74th place
*** SUMMARY ***
Total pot 12050 | Rake 0=20
Board [Jc 5s 9c 7s 3d]
Seat 1: jonnycongo (button) folded before Flop (didn't bet)
Seat 2: eliozica (small blind) folded on the Flop
Seat 4: P0tty Mouth (big blind) showed [6c 3c] and won (12050) with a p=
air of Threes
Seat 5: JJin91 folded before Flop (didn't bet)
Seat 6: excon tyrone showed [4c Ac] and lost with high card Ace


*********** # 67 **************
PokerStars Hand #169868507955: Tournament #1622537329, $13.50+$1.50 USD=
 Hold'em No Limit - Level X (200/400) - 2017/05/14 15:20:49 ET
Table '1622537329 2' 6-max Seat #2 is the button
Seat 1: jonnycongo (34118 in chips)=20
Seat 2: eliozica (51170 in chips)=20
Seat 4: P0tty Mouth (12258 in chips)=20
Seat 5: JJin91 (26076 in chips)=20
jonnycongo: posts the ante 50
eliozica: posts the ante 50
P0tty Mouth: posts the ante 50
JJin91: posts the ante 50
P0tty Mouth: posts small blind 200
JJin91: posts big blind 400
*** HOLE CARDS ***
Dealt to JJin91 [3d 5c]
jonnycongo: calls 400
eliozica: folds=20
P0tty Mouth: folds=20
JJin91: checks=20
*** FLOP *** [9d 9h As]
JJin91: checks=20
jonnycongo: bets 400
JJin91: folds=20
Uncalled bet (400) returned to jonnycongo
jonnycongo collected 1200 from pot
*** SUMMARY ***
Total pot 1200 | Rake 0=20
Board [9d 9h As]
Seat 1: jonnycongo collected (1200)
Seat 2: eliozica (button) folded before Flop (didn't bet)
Seat 4: P0tty Mouth (small blind) folded before Flop
Seat 5: JJin91 (big blind) folded on the Flop


*********** # 68 **************
PokerStars Hand #169868508059: Tournament #1622537329, $13.50+$1.50 USD=
 Hold'em No Limit - Level X (200/400) - 2017/05/14 15:21:12 ET
Table '1622537329 2' 6-max Seat #4 is the button
Seat 1: jonnycongo (34868 in chips)=20
Seat 2: eliozica (51120 in chips)=20
Seat 4: P0tty Mouth (12008 in chips)=20
Seat 5: JJin91 (25626 in chips)=20
Seat 6: MelzWay (9213 in chips)=20
jonnycongo: posts the ante 50
eliozica: posts the ante 50
P0tty Mouth: posts the ante 50
JJin91: posts the ante 50
MelzWay: posts the ante 50
JJin91: posts small blind 200
MelzWay: posts big blind 400
*** HOLE CARDS ***
Dealt to JJin91 [7s Tc]
excon tyrone [observer] said, "F U CK YOU"
jonnycongo: folds=20
eliozica: calls 400
P0tty Mouth: calls 400
JJin91: folds=20
MelzWay: checks=20
*** FLOP *** [7c Jd 7d]
excon tyrone [observer] said, "FU CK YOU"
MelzWay: bets 400
eliozica: calls 400
P0tty Mouth: folds=20
*** TURN *** [7c Jd 7d] [9h]
excon tyrone [observer] said, "CROOKED SCUMS"
MelzWay: checks=20
eliozica: bets 400
MelzWay: calls 400
*** RIVER *** [7c Jd 7d 9h] [9d]
MelzWay: checks=20
eliozica: bets 1600
MelzWay: folds=20
Uncalled bet (1600) returned to eliozica
eliozica collected 3250 from pot
eliozica: doesn't show hand=20
P0tty Mouth said, "?"
*** SUMMARY ***
Total pot 3250 | Rake 0=20
Board [7c Jd 7d 9h 9d]
Seat 1: jonnycongo folded before Flop (didn't bet)
Seat 2: eliozica collected (3250)
Seat 4: P0tty Mouth (button) folded on the Flop
Seat 5: JJin91 (small blind) folded before Flop
Seat 6: MelzWay (big blind) folded on the River


*********** # 69 **************
PokerStars Hand #169868508442: Tournament #1622537329, $13.50+$1.50 USD=
 Hold'em No Limit - Level XI (250/500) - 2017/05/14 15:22:43 ET
Table '1622537329 2' 6-max Seat #5 is the button
Seat 1: jonnycongo (34818 in chips)=20
Seat 2: eliozica (53120 in chips)=20
Seat 4: P0tty Mouth (11558 in chips)=20
Seat 5: JJin91 (25376 in chips)=20
Seat 6: MelzWay (7963 in chips)=20
jonnycongo: posts the ante 60
eliozica: posts the ante 60
P0tty Mouth: posts the ante 60
JJin91: posts the ante 60
MelzWay: posts the ante 60
MelzWay: posts small blind 250
jonnycongo: posts big blind 500
*** HOLE CARDS ***
Dealt to JJin91 [Jd 7s]
eliozica: folds=20
P0tty Mouth: folds=20
JJin91: folds=20
MelzWay: folds=20
Uncalled bet (250) returned to jonnycongo
jonnycongo collected 800 from pot
*** SUMMARY ***
Total pot 800 | Rake 0=20
Seat 1: jonnycongo (big blind) collected (800)
Seat 2: eliozica folded before Flop (didn't bet)
Seat 4: P0tty Mouth folded before Flop (didn't bet)
Seat 5: JJin91 (button) folded before Flop (didn't bet)
Seat 6: MelzWay (small blind) folded before Flop


*********** # 70 **************
PokerStars Hand #169868508536: Tournament #1622537329, $13.50+$1.50 USD=
 Hold'em No Limit - Level XI (250/500) - 2017/05/14 15:23:05 ET
Table '1622537329 2' 6-max Seat #6 is the button
Seat 1: jonnycongo (35308 in chips)=20
Seat 2: eliozica (53060 in chips)=20
Seat 3: proletariat5 (49578 in chips)=20
Seat 4: P0tty Mouth (11498 in chips)=20
Seat 5: JJin91 (25316 in chips)=20
Seat 6: MelzWay (7653 in chips)=20
jonnycongo: posts the ante 60
eliozica: posts the ante 60
proletariat5: posts the ante 60
P0tty Mouth: posts the ante 60
JJin91: posts the ante 60
MelzWay: posts the ante 60
jonnycongo: posts small blind 250
eliozica: posts big blind 500
*** HOLE CARDS ***
Dealt to JJin91 [Qh 6c]
proletariat5: folds=20
P0tty Mouth: calls 500
JJin91: folds=20
MelzWay: folds=20
jonnycongo: calls 250
eliozica: checks=20
*** FLOP *** [6h Th 6s]
jonnycongo: checks=20
eliozica: checks=20
P0tty Mouth: checks=20
*** TURN *** [6h Th 6s] [Td]
jonnycongo: checks=20
eliozica: checks=20
P0tty Mouth: checks=20
*** RIVER *** [6h Th 6s Td] [Ad]
jonnycongo: bets 500
eliozica: folds=20
P0tty Mouth: calls 500
*** SHOW DOWN ***
jonnycongo: shows [3d Ah] (two pair, Aces and Tens)
P0tty Mouth: shows [8c Ac] (two pair, Aces and Tens - Eight kicker)
P0tty Mouth collected 2860 from pot
*** SUMMARY ***
Total pot 2860 | Rake 0=20
Board [6h Th 6s Td Ad]
Seat 1: jonnycongo (small blind) showed [3d Ah] and lost with two pair,=
 Aces and Tens
Seat 2: eliozica (big blind) folded on the River
Seat 3: proletariat5 folded before Flop (didn't bet)
Seat 4: P0tty Mouth showed [8c Ac] and won (2860) with two pair, Aces a=
nd Tens
Seat 5: JJin91 folded before Flop (didn't bet)
Seat 6: MelzWay (button) folded before Flop (didn't bet)


*********** # 71 **************
PokerStars Hand #169868508678: Tournament #1622537329, $13.50+$1.50 USD=
 Hold'em No Limit - Level XI (250/500) - 2017/05/14 15:23:44 ET
Table '1622537329 2' 6-max Seat #1 is the button
Seat 1: jonnycongo (34248 in chips)=20
Seat 2: eliozica (52500 in chips)=20
Seat 3: proletariat5 (49518 in chips)=20
Seat 4: P0tty Mouth (13298 in chips)=20
Seat 5: JJin91 (25256 in chips)=20
Seat 6: MelzWay (7593 in chips)=20
jonnycongo: posts the ante 60
eliozica: posts the ante 60
proletariat5: posts the ante 60
P0tty Mouth: posts the ante 60
JJin91: posts the ante 60
MelzWay: posts the ante 60
eliozica: posts small blind 250
proletariat5: posts big blind 500
*** HOLE CARDS ***
Dealt to JJin91 [2s Ks]
P0tty Mouth: folds=20
JJin91: folds=20
MelzWay: folds=20
jonnycongo: folds=20
eliozica: raises 500 to 1000
proletariat5: folds=20
Uncalled bet (500) returned to eliozica
eliozica collected 1360 from pot
eliozica: doesn't show hand=20
*** SUMMARY ***
Total pot 1360 | Rake 0=20
Seat 1: jonnycongo (button) folded before Flop (didn't bet)
Seat 2: eliozica (small blind) collected (1360)
Seat 3: proletariat5 (big blind) folded before Flop
Seat 4: P0tty Mouth folded before Flop (didn't bet)
Seat 5: JJin91 folded before Flop (didn't bet)
Seat 6: MelzWay folded before Flop (didn't bet)


*********** # 72 **************
PokerStars Hand #169868508782: Tournament #1622537329, $13.50+$1.50 USD=
 Hold'em No Limit - Level XI (250/500) - 2017/05/14 15:24:10 ET
Table '1622537329 2' 6-max Seat #2 is the button
Seat 1: jonnycongo (34188 in chips)=20
Seat 2: eliozica (53300 in chips)=20
Seat 3: proletariat5 (48958 in chips)=20
Seat 4: P0tty Mouth (13238 in chips)=20
Seat 5: JJin91 (25196 in chips)=20
Seat 6: MelzWay (7533 in chips)=20
jonnycongo: posts the ante 60
eliozica: posts the ante 60
proletariat5: posts the ante 60
P0tty Mouth: posts the ante 60
JJin91: posts the ante 60
MelzWay: posts the ante 60
proletariat5: posts small blind 250
P0tty Mouth: posts big blind 500
*** HOLE CARDS ***
Dealt to JJin91 [8d Qd]
JJin91: folds=20
MelzWay: folds=20
jonnycongo: raises 500 to 1000
eliozica: folds=20
proletariat5: folds=20
P0tty Mouth: calls 500
*** FLOP *** [9c 6d Th]
P0tty Mouth: checks=20
jonnycongo: checks=20
*** TURN *** [9c 6d Th] [Kh]
P0tty Mouth: checks=20
jonnycongo: bets 500
P0tty Mouth: calls 500
*** RIVER *** [9c 6d Th Kh] [2c]
P0tty Mouth: bets 1500
jonnycongo: calls 1500
*** SHOW DOWN ***
P0tty Mouth: shows [7s Jd] (high card King)
jonnycongo: shows [Qh As] (high card Ace)
jonnycongo collected 6610 from pot
*** SUMMARY ***
Total pot 6610 | Rake 0=20
Board [9c 6d Th Kh 2c]
Seat 1: jonnycongo showed [Qh As] and won (6610) with high card Ace
Seat 2: eliozica (button) folded before Flop (didn't bet)
Seat 3: proletariat5 (small blind) folded before Flop
Seat 4: P0tty Mouth (big blind) showed [7s Jd] and lost with high card =
King
Seat 5: JJin91 folded before Flop (didn't bet)
Seat 6: MelzWay folded before Flop (didn't bet)


*********** # 73 **************
PokerStars Hand #169868508909: Tournament #1622537329, $13.50+$1.50 USD=
 Hold'em No Limit - Level XI (250/500) - 2017/05/14 15:24:43 ET
Table '1622537329 2' 6-max Seat #3 is the button
Seat 1: jonnycongo (37738 in chips)=20
Seat 2: eliozica (53240 in chips)=20
Seat 3: proletariat5 (48648 in chips)=20
Seat 4: P0tty Mouth (10178 in chips)=20
Seat 5: JJin91 (25136 in chips)=20
Seat 6: MelzWay (7473 in chips)=20
jonnycongo: posts the ante 60
eliozica: posts the ante 60
proletariat5: posts the ante 60
P0tty Mouth: posts the ante 60
JJin91: posts the ante 60
MelzWay: posts the ante 60
P0tty Mouth: posts small blind 250
JJin91: posts big blind 500
*** HOLE CARDS ***
Dealt to JJin91 [2h 9c]
MelzWay: folds=20
jonnycongo: folds=20
eliozica: calls 500
P0tty Mouth said, "shoulda jumped higher lol"
proletariat5: raises 1055 to 1555
P0tty Mouth: folds=20
jonnycongo said, "probably woulda calle"
JJin91: folds=20
eliozica: folds=20
Uncalled bet (1055) returned to proletariat5
proletariat5 collected 2110 from pot
proletariat5: doesn't show hand=20
*** SUMMARY ***
Total pot 2110 | Rake 0=20
Seat 1: jonnycongo folded before Flop (didn't bet)
Seat 2: eliozica folded before Flop
Seat 3: proletariat5 (button) collected (2110)
Seat 4: P0tty Mouth (small blind) folded before Flop
Seat 5: JJin91 (big blind) folded before Flop
Seat 6: MelzWay folded before Flop (didn't bet)


*********** # 74 **************
PokerStars Hand #169868509018: Tournament #1622537329, $13.50+$1.50 USD=
 Hold'em No Limit - Level XI (250/500) - 2017/05/14 15:25:12 ET
Table '1622537329 2' 6-max Seat #4 is the button
Seat 1: jonnycongo (37678 in chips)=20
Seat 2: eliozica (52680 in chips)=20
Seat 3: proletariat5 (50198 in chips)=20
Seat 4: P0tty Mouth (9868 in chips)=20
Seat 5: JJin91 (24576 in chips)=20
Seat 6: MelzWay (7413 in chips)=20
jonnycongo: posts the ante 60
eliozica: posts the ante 60
proletariat5: posts the ante 60
P0tty Mouth: posts the ante 60
JJin91: posts the ante 60
MelzWay: posts the ante 60
JJin91: posts small blind 250
MelzWay: posts big blind 500
*** HOLE CARDS ***
Dealt to JJin91 [5h 7s]
P0tty Mouth said, "small stack problems"
jonnycongo said, "if you waited till i bet the river and reraised i mig=
hta folded"
jonnycongo: folds=20
eliozica: folds=20
proletariat5: folds=20
P0tty Mouth: calls 500
JJin91: folds=20
jonnycongo said, "lol"
MelzWay: checks=20
*** FLOP *** [Js Ac 9c]
MelzWay: checks=20
P0tty Mouth: bets 1610
MelzWay: folds=20
Uncalled bet (1610) returned to P0tty Mouth
P0tty Mouth collected 1610 from pot
P0tty Mouth: doesn't show hand=20
*** SUMMARY ***
Total pot 1610 | Rake 0=20
Board [Js Ac 9c]
Seat 1: jonnycongo folded before Flop (didn't bet)
Seat 2: eliozica folded before Flop (didn't bet)
Seat 3: proletariat5 folded before Flop (didn't bet)
Seat 4: P0tty Mouth (button) collected (1610)
Seat 5: JJin91 (small blind) folded before Flop
Seat 6: MelzWay (big blind) folded on the Flop


*********** # 75 **************
PokerStars Hand #169868509184: Tournament #1622537329, $13.50+$1.50 USD=
 Hold'em No Limit - Level XI (250/500) - 2017/05/14 15:26:00 ET
Table '1622537329 2' 6-max Seat #5 is the button
Seat 1: jonnycongo (37618 in chips)=20
Seat 2: eliozica (52620 in chips)=20
Seat 3: proletariat5 (50138 in chips)=20
Seat 4: P0tty Mouth (10918 in chips)=20
Seat 5: JJin91 (24266 in chips)=20
Seat 6: MelzWay (6853 in chips)=20
jonnycongo: posts the ante 60
eliozica: posts the ante 60
proletariat5: posts the ante 60
P0tty Mouth: posts the ante 60
JJin91: posts the ante 60
MelzWay: posts the ante 60
MelzWay: posts small blind 250
jonnycongo: posts big blind 500
*** HOLE CARDS ***
Dealt to JJin91 [7d 5h]
eliozica: folds=20
proletariat5: folds=20
P0tty Mouth: folds=20
JJin91: folds=20
MelzWay: calls 250
jonnycongo: checks=20
*** FLOP *** [Kd 3d Jd]
MelzWay: checks=20
jonnycongo: checks=20
*** TURN *** [Kd 3d Jd] [4h]
MelzWay: checks=20
jonnycongo: checks=20
*** RIVER *** [Kd 3d Jd 4h] [Qd]
MelzWay: bets 6293 and is all-in
jonnycongo: folds=20
Uncalled bet (6293) returned to MelzWay
MelzWay collected 1360 from pot
MelzWay: doesn't show hand=20
*** SUMMARY ***
Total pot 1360 | Rake 0=20
Board [Kd 3d Jd 4h Qd]
Seat 1: jonnycongo (big blind) folded on the River
Seat 2: eliozica folded before Flop (didn't bet)
Seat 3: proletariat5 folded before Flop (didn't bet)
Seat 4: P0tty Mouth folded before Flop (didn't bet)
Seat 5: JJin91 (button) folded before Flop (didn't bet)
Seat 6: MelzWay (small blind) collected (1360)


*********** # 76 **************
PokerStars Hand #169868509396: Tournament #1622537329, $13.50+$1.50 USD=
 Hold'em No Limit - Level XI (250/500) - 2017/05/14 15:26:59 ET
Table '1622537329 2' 6-max Seat #6 is the button
Seat 1: jonnycongo (37058 in chips)=20
Seat 2: eliozica (52560 in chips)=20
Seat 3: proletariat5 (50078 in chips)=20
Seat 4: P0tty Mouth (10858 in chips)=20
Seat 5: JJin91 (24206 in chips)=20
Seat 6: MelzWay (7653 in chips)=20
jonnycongo: posts the ante 60
eliozica: posts the ante 60
proletariat5: posts the ante 60
P0tty Mouth: posts the ante 60
JJin91: posts the ante 60
MelzWay: posts the ante 60
jonnycongo: posts small blind 250
eliozica: posts big blind 500
*** HOLE CARDS ***
Dealt to JJin91 [Th Js]
proletariat5: folds=20
P0tty Mouth: folds=20
JJin91: folds=20
MelzWay: folds=20
jonnycongo: folds=20
Uncalled bet (250) returned to eliozica
eliozica collected 860 from pot
eliozica: doesn't show hand=20
*** SUMMARY ***
Total pot 860 | Rake 0=20
Seat 1: jonnycongo (small blind) folded before Flop
Seat 2: eliozica (big blind) collected (860)
Seat 3: proletariat5 folded before Flop (didn't bet)
Seat 4: P0tty Mouth folded before Flop (didn't bet)
Seat 5: JJin91 folded before Flop (didn't bet)
Seat 6: MelzWay (button) folded before Flop (didn't bet)


*********** # 77 **************
PokerStars Hand #169868509524: Tournament #1622537329, $13.50+$1.50 USD=
 Hold'em No Limit - Level XI (250/500) - 2017/05/14 15:27:34 ET
Table '1622537329 2' 6-max Seat #1 is the button
Seat 1: jonnycongo (36748 in chips)=20
Seat 2: eliozica (53110 in chips)=20
Seat 3: proletariat5 (50018 in chips)=20
Seat 4: P0tty Mouth (10798 in chips)=20
Seat 5: JJin91 (24146 in chips)=20
Seat 6: MelzWay (7593 in chips)=20
jonnycongo: posts the ante 60
eliozica: posts the ante 60
proletariat5: posts the ante 60
P0tty Mouth: posts the ante 60
JJin91: posts the ante 60
MelzWay: posts the ante 60
eliozica: posts small blind 250
proletariat5: posts big blind 500
*** HOLE CARDS ***
Dealt to JJin91 [6c 7h]
P0tty Mouth: folds=20
JJin91: folds=20
MelzWay: calls 500
jonnycongo: folds=20
eliozica: calls 250
proletariat5: raises 1055 to 1555
MelzWay: folds=20
eliozica: calls 1055
*** FLOP *** [9d 6s 9s]
eliozica: checks=20
proletariat5: checks=20
*** TURN *** [9d 6s 9s] [Js]
eliozica: bets 1500
proletariat5: folds=20
Uncalled bet (1500) returned to eliozica
eliozica collected 3970 from pot
eliozica: doesn't show hand=20
*** SUMMARY ***
Total pot 3970 | Rake 0=20
Board [9d 6s 9s Js]
Seat 1: jonnycongo (button) folded before Flop (didn't bet)
Seat 2: eliozica (small blind) collected (3970)
Seat 3: proletariat5 (big blind) folded on the Turn
Seat 4: P0tty Mouth folded before Flop (didn't bet)
Seat 5: JJin91 folded before Flop (didn't bet)
Seat 6: MelzWay folded before Flop


*********** # 78 **************
PokerStars Hand #169868509749: Tournament #1622537329, $13.50+$1.50 USD=
 Hold'em No Limit - Level XI (250/500) - 2017/05/14 15:28:36 ET
Table '1622537329 2' 6-max Seat #2 is the button
Seat 1: jonnycongo (36688 in chips)=20
Seat 2: eliozica (55465 in chips)=20
Seat 3: proletariat5 (48403 in chips)=20
Seat 4: P0tty Mouth (10738 in chips)=20
Seat 5: JJin91 (24086 in chips)=20
Seat 6: MelzWay (7033 in chips)=20
jonnycongo: posts the ante 60
eliozica: posts the ante 60
proletariat5: posts the ante 60
P0tty Mouth: posts the ante 60
JJin91: posts the ante 60
MelzWay: posts the ante 60
proletariat5: posts small blind 250
P0tty Mouth: posts big blind 500
*** HOLE CARDS ***
Dealt to JJin91 [Qc 7h]
JJin91: folds=20
MelzWay: folds=20
jonnycongo: folds=20
eliozica: folds=20
proletariat5: raises 615 to 1115
P0tty Mouth: calls 615
*** FLOP *** [5d 9s Ah]
proletariat5: bets 829
P0tty Mouth: calls 829
*** TURN *** [5d 9s Ah] [Js]
proletariat5: checks=20
P0tty Mouth: checks=20
*** RIVER *** [5d 9s Ah Js] [7d]
proletariat5: checks=20
P0tty Mouth: checks=20
*** SHOW DOWN ***
proletariat5: shows [Kd Jc] (a pair of Jacks)
P0tty Mouth: mucks hand=20
proletariat5 collected 4248 from pot
*** SUMMARY ***
Total pot 4248 | Rake 0=20
Board [5d 9s Ah Js 7d]
Seat 1: jonnycongo folded before Flop (didn't bet)
Seat 2: eliozica (button) folded before Flop (didn't bet)
Seat 3: proletariat5 (small blind) showed [Kd Jc] and won (4248) with a=
 pair of Jacks
Seat 4: P0tty Mouth (big blind) mucked [8h 5h]
Seat 5: JJin91 folded before Flop (didn't bet)
Seat 6: MelzWay folded before Flop (didn't bet)


*********** # 79 **************
PokerStars Hand #169868509863: Tournament #1622537329, $13.50+$1.50 USD=
 Hold'em No Limit - Level XI (250/500) - 2017/05/14 15:29:10 ET
Table '1622537329 2' 6-max Seat #3 is the button
Seat 1: jonnycongo (36628 in chips)=20
Seat 2: eliozica (55405 in chips)=20
Seat 3: proletariat5 (50647 in chips)=20
Seat 4: P0tty Mouth (8734 in chips)=20
Seat 5: JJin91 (24026 in chips)=20
Seat 6: MelzWay (6973 in chips)=20
jonnycongo: posts the ante 60
eliozica: posts the ante 60
proletariat5: posts the ante 60
P0tty Mouth: posts the ante 60
JJin91: posts the ante 60
MelzWay: posts the ante 60
P0tty Mouth: posts small blind 250
JJin91: posts big blind 500
*** HOLE CARDS ***
Dealt to JJin91 [Tc Qd]
MelzWay: folds=20
jonnycongo: folds=20
eliozica: folds=20
proletariat5: folds=20
P0tty Mouth: calls 250
JJin91: checks=20
*** FLOP *** [Ad As Th]
P0tty Mouth: bets 500
JJin91: raises 1500 to 2000
P0tty Mouth: folds=20
Uncalled bet (1500) returned to JJin91
JJin91 collected 2360 from pot
JJin91: doesn't show hand=20
*** SUMMARY ***
Total pot 2360 | Rake 0=20
Board [Ad As Th]
Seat 1: jonnycongo folded before Flop (didn't bet)
Seat 2: eliozica folded before Flop (didn't bet)
Seat 3: proletariat5 (button) folded before Flop (didn't bet)
Seat 4: P0tty Mouth (small blind) folded on the Flop
Seat 5: JJin91 (big blind) collected (2360)
Seat 6: MelzWay folded before Flop (didn't bet)


*********** # 80 **************
PokerStars Hand #169868509948: Tournament #1622537329, $13.50+$1.50 USD=
 Hold'em No Limit - Level XI (250/500) - 2017/05/14 15:29:39 ET
Table '1622537329 2' 6-max Seat #4 is the button
Seat 1: jonnycongo (36568 in chips)=20
Seat 2: eliozica (55345 in chips)=20
Seat 3: proletariat5 (50587 in chips)=20
Seat 4: P0tty Mouth (7674 in chips)=20
Seat 5: JJin91 (25326 in chips)=20
Seat 6: MelzWay (6913 in chips)=20
jonnycongo: posts the ante 60
eliozica: posts the ante 60
proletariat5: posts the ante 60
P0tty Mouth: posts the ante 60
JJin91: posts the ante 60
MelzWay: posts the ante 60
JJin91: posts small blind 250
MelzWay: posts big blind 500
*** HOLE CARDS ***
Dealt to JJin91 [9s 6c]
jonnycongo: folds=20
eliozica: folds=20
proletariat5: folds=20
P0tty Mouth: calls 500
JJin91: folds=20
MelzWay: checks=20
*** FLOP *** [7s 9h 4d]
MelzWay: checks=20
P0tty Mouth: bets 7114 and is all-in
MelzWay: folds=20
Uncalled bet (7114) returned to P0tty Mouth
P0tty Mouth collected 1610 from pot
P0tty Mouth: doesn't show hand=20
*** SUMMARY ***
Total pot 1610 | Rake 0=20
Board [7s 9h 4d]
Seat 1: jonnycongo folded before Flop (didn't bet)
Seat 2: eliozica folded before Flop (didn't bet)
Seat 3: proletariat5 folded before Flop (didn't bet)
Seat 4: P0tty Mouth (button) collected (1610)
Seat 5: JJin91 (small blind) folded before Flop
Seat 6: MelzWay (big blind) folded on the Flop


*********** # 81 **************
PokerStars Hand #169869526662: Tournament #1622537329, $13.50+$1.50 USD=
 Hold'em No Limit - Level XI (250/500) - 2017/05/14 15:30:20 ET
Table '1622537329 2' 6-max Seat #5 is the button
Seat 1: jonnycongo (36508 in chips)=20
Seat 2: eliozica (55285 in chips)=20
Seat 3: proletariat5 (50527 in chips)=20
Seat 4: P0tty Mouth (8724 in chips)=20
Seat 5: JJin91 (25016 in chips)=20
Seat 6: MelzWay (6353 in chips)=20
jonnycongo: posts the ante 60
eliozica: posts the ante 60
proletariat5: posts the ante 60
P0tty Mouth: posts the ante 60
JJin91: posts the ante 60
MelzWay: posts the ante 60
MelzWay: posts small blind 250
jonnycongo: posts big blind 500
*** HOLE CARDS ***
Dealt to JJin91 [3s 7s]
eliozica: folds=20
proletariat5: folds=20
P0tty Mouth: folds=20
JJin91: folds=20
MelzWay: calls 250
jonnycongo: checks=20
*** FLOP *** [9h 9s 2d]
MelzWay: checks=20
jonnycongo: checks=20
*** TURN *** [9h 9s 2d] [3c]
MelzWay: checks=20
jonnycongo: checks=20
*** RIVER *** [9h 9s 2d 3c] [Jd]
MelzWay: bets 500
jonnycongo: calls 500
*** SHOW DOWN ***
MelzWay: shows [Jc 7c] (two pair, Jacks and Nines)
jonnycongo: mucks hand=20
MelzWay collected 2360 from pot
*** SUMMARY ***
Total pot 2360 | Rake 0=20
Board [9h 9s 2d 3c Jd]
Seat 1: jonnycongo (big blind) mucked [2h 3h]
Seat 2: eliozica folded before Flop (didn't bet)
Seat 3: proletariat5 folded before Flop (didn't bet)
Seat 4: P0tty Mouth folded before Flop (didn't bet)
Seat 5: JJin91 (button) folded before Flop (didn't bet)
Seat 6: MelzWay (small blind) showed [Jc 7c] and won (2360) with two pa=
ir, Jacks and Nines


*********** # 82 **************
PokerStars Hand #169869526813: Tournament #1622537329, $13.50+$1.50 USD=
 Hold'em No Limit - Level XI (250/500) - 2017/05/14 15:31:11 ET
Table '1622537329 2' 6-max Seat #6 is the button
Seat 1: jonnycongo (35448 in chips)=20
Seat 2: eliozica (55225 in chips)=20
Seat 3: proletariat5 (50467 in chips)=20
Seat 4: P0tty Mouth (8664 in chips)=20
Seat 5: JJin91 (24956 in chips)=20
Seat 6: MelzWay (7653 in chips)=20
jonnycongo: posts the ante 60
eliozica: posts the ante 60
proletariat5: posts the ante 60
P0tty Mouth: posts the ante 60
JJin91: posts the ante 60
MelzWay: posts the ante 60
jonnycongo: posts small blind 250
eliozica: posts big blind 500
*** HOLE CARDS ***
Dealt to JJin91 [6h 3c]
proletariat5: folds=20
P0tty Mouth: folds=20
JJin91: folds=20
MelzWay: folds=20
jonnycongo: folds=20
Uncalled bet (250) returned to eliozica
eliozica collected 860 from pot
eliozica: doesn't show hand=20
*** SUMMARY ***
Total pot 860 | Rake 0=20
Seat 1: jonnycongo (small blind) folded before Flop
Seat 2: eliozica (big blind) collected (860)
Seat 3: proletariat5 folded before Flop (didn't bet)
Seat 4: P0tty Mouth folded before Flop (didn't bet)
Seat 5: JJin91 folded before Flop (didn't bet)
Seat 6: MelzWay (button) folded before Flop (didn't bet)


*********** # 83 **************
PokerStars Hand #169869526867: Tournament #1622537329, $13.50+$1.50 USD=
 Hold'em No Limit - Level XI (250/500) - 2017/05/14 15:31:29 ET
Table '1622537329 2' 6-max Seat #1 is the button
Seat 1: jonnycongo (35138 in chips)=20
Seat 2: eliozica (55775 in chips)=20
Seat 3: proletariat5 (50407 in chips)=20
Seat 4: P0tty Mouth (8604 in chips)=20
Seat 5: JJin91 (24896 in chips)=20
Seat 6: MelzWay (7593 in chips)=20
jonnycongo: posts the ante 60
eliozica: posts the ante 60
proletariat5: posts the ante 60
P0tty Mouth: posts the ante 60
JJin91: posts the ante 60
MelzWay: posts the ante 60
eliozica: posts small blind 250
proletariat5: posts big blind 500
*** HOLE CARDS ***
Dealt to JJin91 [2s 6d]
P0tty Mouth: calls 500
JJin91: folds=20
MelzWay: folds=20
jonnycongo: calls 500
eliozica: calls 250
proletariat5: checks=20
*** FLOP *** [Ks 8d Kc]
eliozica: checks=20
proletariat5: checks=20
P0tty Mouth: checks=20
jonnycongo: checks=20
*** TURN *** [Ks 8d Kc] [6s]
eliozica: checks=20
proletariat5: checks=20
P0tty Mouth: checks=20
jonnycongo: checks=20
*** RIVER *** [Ks 8d Kc 6s] [7h]
eliozica: checks=20
proletariat5: checks=20
P0tty Mouth: checks=20
jonnycongo: checks=20
*** SHOW DOWN ***
eliozica: shows [3d 4c] (a pair of Kings)
proletariat5: shows [4h Qs] (a pair of Kings - Queen kicker)
P0tty Mouth: mucks hand=20
jonnycongo: shows [Jc As] (a pair of Kings - Ace kicker)
jonnycongo collected 2360 from pot
*** SUMMARY ***
Total pot 2360 | Rake 0=20
Board [Ks 8d Kc 6s 7h]
Seat 1: jonnycongo (button) showed [Jc As] and won (2360) with a pair o=
f Kings
Seat 2: eliozica (small blind) showed [3d 4c] and lost with a pair of K=
ings
Seat 3: proletariat5 (big blind) showed [4h Qs] and lost with a pair of=
 Kings
Seat 4: P0tty Mouth mucked [5s 3s]
Seat 5: JJin91 folded before Flop (didn't bet)
Seat 6: MelzWay folded before Flop (didn't bet)


*********** # 84 **************
PokerStars Hand #169869527076: Tournament #1622537329, $13.50+$1.50 USD=
 Hold'em No Limit - Level XII (300/600) - 2017/05/14 15:32:38 ET
Table '1622537329 2' 6-max Seat #2 is the button
Seat 1: jonnycongo (36938 in chips)=20
Seat 2: eliozica (55215 in chips)=20
Seat 3: proletariat5 (49847 in chips)=20
Seat 4: P0tty Mouth (8044 in chips)=20
Seat 5: JJin91 (24836 in chips)=20
Seat 6: MelzWay (7533 in chips)=20
jonnycongo: posts the ante 70
eliozica: posts the ante 70
proletariat5: posts the ante 70
P0tty Mouth: posts the ante 70
JJin91: posts the ante 70
MelzWay: posts the ante 70
proletariat5: posts small blind 300
P0tty Mouth: posts big blind 600
*** HOLE CARDS ***
Dealt to JJin91 [Qh 9c]
JJin91: folds=20
MelzWay: folds=20
jonnycongo: folds=20
eliozica: folds=20
proletariat5: folds=20
Uncalled bet (300) returned to P0tty Mouth
P0tty Mouth collected 1020 from pot
P0tty Mouth: doesn't show hand=20
*** SUMMARY ***
Total pot 1020 | Rake 0=20
Seat 1: jonnycongo folded before Flop (didn't bet)
Seat 2: eliozica (button) folded before Flop (didn't bet)
Seat 3: proletariat5 (small blind) folded before Flop
Seat 4: P0tty Mouth (big blind) collected (1020)
Seat 5: JJin91 folded before Flop (didn't bet)
Seat 6: MelzWay folded before Flop (didn't bet)


*********** # 85 **************
PokerStars Hand #169869527112: Tournament #1622537329, $13.50+$1.50 USD=
 Hold'em No Limit - Level XII (300/600) - 2017/05/14 15:32:51 ET
Table '1622537329 2' 6-max Seat #3 is the button
Seat 1: jonnycongo (36868 in chips)=20
Seat 2: eliozica (55145 in chips)=20
Seat 3: proletariat5 (49477 in chips)=20
Seat 4: P0tty Mouth (8694 in chips)=20
Seat 5: JJin91 (24766 in chips)=20
Seat 6: MelzWay (7463 in chips)=20
jonnycongo: posts the ante 70
eliozica: posts the ante 70
proletariat5: posts the ante 70
P0tty Mouth: posts the ante 70
JJin91: posts the ante 70
MelzWay: posts the ante 70
P0tty Mouth: posts small blind 300
JJin91: posts big blind 600
*** HOLE CARDS ***
Dealt to JJin91 [2c Kd]
MelzWay: calls 600
jonnycongo: folds=20
eliozica: folds=20
proletariat5: folds=20
P0tty Mouth: calls 300
JJin91: checks=20
*** FLOP *** [9d Ks 2h]
P0tty Mouth: checks=20
JJin91: checks=20
MelzWay: checks=20
*** TURN *** [9d Ks 2h] [9s]
P0tty Mouth: checks=20
JJin91: checks=20
MelzWay: checks=20
*** RIVER *** [9d Ks 2h 9s] [9h]
P0tty Mouth: checks=20
JJin91: bets 1265
MelzWay: folds=20
P0tty Mouth: folds=20
Uncalled bet (1265) returned to JJin91
JJin91 collected 2220 from pot
JJin91: doesn't show hand=20
*** SUMMARY ***
Total pot 2220 | Rake 0=20
Board [9d Ks 2h 9s 9h]
Seat 1: jonnycongo folded before Flop (didn't bet)
Seat 2: eliozica folded before Flop (didn't bet)
Seat 3: proletariat5 (button) folded before Flop (didn't bet)
Seat 4: P0tty Mouth (small blind) folded on the River
Seat 5: JJin91 (big blind) collected (2220)
Seat 6: MelzWay folded on the River


*********** # 86 **************
PokerStars Hand #169869527250: Tournament #1622537329, $13.50+$1.50 USD=
 Hold'em No Limit - Level XII (300/600) - 2017/05/14 15:33:40 ET
Table '1622537329 2' 6-max Seat #4 is the button
Seat 1: jonnycongo (36798 in chips)=20
Seat 2: eliozica (55075 in chips)=20
Seat 3: proletariat5 (49407 in chips)=20
Seat 4: P0tty Mouth (8024 in chips)=20
Seat 5: JJin91 (26316 in chips)=20
Seat 6: MelzWay (6793 in chips)=20
jonnycongo: posts the ante 70
eliozica: posts the ante 70
proletariat5: posts the ante 70
P0tty Mouth: posts the ante 70
JJin91: posts the ante 70
MelzWay: posts the ante 70
JJin91: posts small blind 300
MelzWay: posts big blind 600
*** HOLE CARDS ***
Dealt to JJin91 [Jd Qh]
jonnycongo: folds=20
eliozica: calls 600
proletariat5: folds=20
P0tty Mouth: folds=20
JJin91: folds=20
MelzWay: checks=20
*** FLOP *** [8h 9h 9s]
MelzWay: checks=20
eliozica: bets 600
MelzWay: folds=20
Uncalled bet (600) returned to eliozica
eliozica collected 1920 from pot
eliozica: doesn't show hand=20
*** SUMMARY ***
Total pot 1920 | Rake 0=20
Board [8h 9h 9s]
Seat 1: jonnycongo folded before Flop (didn't bet)
Seat 2: eliozica collected (1920)
Seat 3: proletariat5 folded before Flop (didn't bet)
Seat 4: P0tty Mouth (button) folded before Flop (didn't bet)
Seat 5: JJin91 (small blind) folded before Flop
Seat 6: MelzWay (big blind) folded on the Flop


*********** # 87 **************
PokerStars Hand #169869527331: Tournament #1622537329, $13.50+$1.50 USD=
 Hold'em No Limit - Level XII (300/600) - 2017/05/14 15:34:09 ET
Table '1622537329 2' 6-max Seat #5 is the button
Seat 1: jonnycongo (36728 in chips)=20
Seat 2: eliozica (56325 in chips)=20
Seat 3: proletariat5 (49337 in chips)=20
Seat 4: P0tty Mouth (7954 in chips)=20
Seat 5: JJin91 (25946 in chips)=20
Seat 6: MelzWay (6123 in chips)=20
jonnycongo: posts the ante 70
eliozica: posts the ante 70
proletariat5: posts the ante 70
P0tty Mouth: posts the ante 70
JJin91: posts the ante 70
MelzWay: posts the ante 70
MelzWay: posts small blind 300
jonnycongo: posts big blind 600
*** HOLE CARDS ***
Dealt to JJin91 [As 9s]
eliozica: calls 600
proletariat5: folds=20
P0tty Mouth: calls 600
JJin91: raises 1800 to 2400
MelzWay: folds=20
jonnycongo: folds=20
eliozica: folds=20
P0tty Mouth: folds=20
Uncalled bet (1800) returned to JJin91
JJin91 collected 3120 from pot
JJin91: doesn't show hand=20
*** SUMMARY ***
Total pot 3120 | Rake 0=20
Seat 1: jonnycongo (big blind) folded before Flop
Seat 2: eliozica folded before Flop
Seat 3: proletariat5 folded before Flop (didn't bet)
Seat 4: P0tty Mouth folded before Flop
Seat 5: JJin91 (button) collected (3120)
Seat 6: MelzWay (small blind) folded before Flop


*********** # 88 **************
PokerStars Hand #169869527398: Tournament #1622537329, $13.50+$1.50 USD=
 Hold'em No Limit - Level XII (300/600) - 2017/05/14 15:34:35 ET
Table '1622537329 2' 6-max Seat #6 is the button
Seat 1: jonnycongo (36058 in chips)=20
Seat 2: eliozica (55655 in chips)=20
Seat 3: proletariat5 (49267 in chips)=20
Seat 4: P0tty Mouth (7284 in chips)=20
Seat 5: JJin91 (28396 in chips)=20
Seat 6: MelzWay (5753 in chips)=20
jonnycongo: posts the ante 70
eliozica: posts the ante 70
proletariat5: posts the ante 70
P0tty Mouth: posts the ante 70
JJin91: posts the ante 70
MelzWay: posts the ante 70
jonnycongo: posts small blind 300
eliozica: posts big blind 600
*** HOLE CARDS ***
Dealt to JJin91 [Qc 4s]
proletariat5: folds=20
P0tty Mouth: calls 600
JJin91: folds=20
MelzWay: folds=20
jonnycongo: folds=20
eliozica: checks=20
*** FLOP *** [Qd Jc 5s]
eliozica: checks=20
P0tty Mouth: bets 1200
eliozica: calls 1200
*** TURN *** [Qd Jc 5s] [3s]
eliozica: checks=20
P0tty Mouth: bets 5414 and is all-in
eliozica: folds=20
Uncalled bet (5414) returned to P0tty Mouth
P0tty Mouth collected 4320 from pot
P0tty Mouth: doesn't show hand=20
*** SUMMARY ***
Total pot 4320 | Rake 0=20
Board [Qd Jc 5s 3s]
Seat 1: jonnycongo (small blind) folded before Flop
Seat 2: eliozica (big blind) folded on the Turn
Seat 3: proletariat5 folded before Flop (didn't bet)
Seat 4: P0tty Mouth collected (4320)
Seat 5: JJin91 folded before Flop (didn't bet)
Seat 6: MelzWay (button) folded before Flop (didn't bet)


*********** # 89 **************
PokerStars Hand #169869527482: Tournament #1622537329, $13.50+$1.50 USD=
 Hold'em No Limit - Level XII (300/600) - 2017/05/14 15:35:01 ET
Table '1622537329 2' 6-max Seat #1 is the button
Seat 1: jonnycongo (35688 in chips)=20
Seat 2: eliozica (53785 in chips)=20
Seat 3: proletariat5 (49197 in chips)=20
Seat 4: P0tty Mouth (9734 in chips)=20
Seat 5: JJin91 (28326 in chips)=20
Seat 6: MelzWay (5683 in chips)=20
jonnycongo: posts the ante 70
eliozica: posts the ante 70
proletariat5: posts the ante 70
P0tty Mouth: posts the ante 70
JJin91: posts the ante 70
MelzWay: posts the ante 70
eliozica: posts small blind 300
proletariat5: posts big blind 600
*** HOLE CARDS ***
Dealt to JJin91 [2h 4c]
P0tty Mouth: calls 600
JJin91: folds=20
MelzWay: calls 600
jonnycongo: folds=20
eliozica: calls 300
proletariat5: checks=20
*** FLOP *** [7d Ks 9d]
eliozica: checks=20
proletariat5: checks=20
P0tty Mouth: bets 600
MelzWay: calls 600
eliozica: calls 600
proletariat5: folds=20
*** TURN *** [7d Ks 9d] [6c]
eliozica: checks=20
P0tty Mouth: bets 600
MelzWay: folds=20
eliozica: calls 600
*** RIVER *** [7d Ks 9d 6c] [Jc]
eliozica: checks=20
P0tty Mouth: checks=20
*** SHOW DOWN ***
eliozica: shows [4d 6d] (a pair of Sixes)
P0tty Mouth: shows [Ah 9c] (a pair of Nines)
P0tty Mouth collected 5820 from pot
*** SUMMARY ***
Total pot 5820 | Rake 0=20
Board [7d Ks 9d 6c Jc]
Seat 1: jonnycongo (button) folded before Flop (didn't bet)
Seat 2: eliozica (small blind) showed [4d 6d] and lost with a pair of S=
ixes
Seat 3: proletariat5 (big blind) folded on the Flop
Seat 4: P0tty Mouth showed [Ah 9c] and won (5820) with a pair of Nines
Seat 5: JJin91 folded before Flop (didn't bet)
Seat 6: MelzWay folded on the Turn


*********** # 90 **************
PokerStars Hand #169869527611: Tournament #1622537329, $13.50+$1.50 USD=
 Hold'em No Limit - Level XII (300/600) - 2017/05/14 15:35:51 ET
Table '1622537329 2' 6-max Seat #2 is the button
Seat 1: jonnycongo (35618 in chips)=20
Seat 2: eliozica (51915 in chips)=20
Seat 3: proletariat5 (48527 in chips)=20
Seat 4: P0tty Mouth (13684 in chips)=20
Seat 5: JJin91 (28256 in chips)=20
Seat 6: MelzWay (4413 in chips)=20
jonnycongo: posts the ante 70
eliozica: posts the ante 70
proletariat5: posts the ante 70
P0tty Mouth: posts the ante 70
JJin91: posts the ante 70
MelzWay: posts the ante 70
proletariat5: posts small blind 300
P0tty Mouth: posts big blind 600
*** HOLE CARDS ***
Dealt to JJin91 [9d Tc]
JJin91: folds=20
MelzWay: folds=20
jonnycongo: folds=20
eliozica: folds=20
proletariat5: raises 738 to 1338
P0tty Mouth: folds=20
Uncalled bet (738) returned to proletariat5
proletariat5 collected 1620 from pot
proletariat5: doesn't show hand=20
*** SUMMARY ***
Total pot 1620 | Rake 0=20
Seat 1: jonnycongo folded before Flop (didn't bet)
Seat 2: eliozica (button) folded before Flop (didn't bet)
Seat 3: proletariat5 (small blind) collected (1620)
Seat 4: P0tty Mouth (big blind) folded before Flop
Seat 5: JJin91 folded before Flop (didn't bet)
Seat 6: MelzWay folded before Flop (didn't bet)


*********** # 91 **************
PokerStars Hand #169869527682: Tournament #1622537329, $13.50+$1.50 USD=
 Hold'em No Limit - Level XII (300/600) - 2017/05/14 15:36:12 ET
Table '1622537329 2' 6-max Seat #3 is the button
Seat 1: jonnycongo (35548 in chips)=20
Seat 2: eliozica (51845 in chips)=20
Seat 3: proletariat5 (49477 in chips)=20
Seat 4: P0tty Mouth (13014 in chips)=20
Seat 5: JJin91 (28186 in chips)=20
Seat 6: MelzWay (4343 in chips)=20
jonnycongo: posts the ante 70
eliozica: posts the ante 70
proletariat5: posts the ante 70
P0tty Mouth: posts the ante 70
JJin91: posts the ante 70
MelzWay: posts the ante 70
P0tty Mouth: posts small blind 300
JJin91: posts big blind 600
*** HOLE CARDS ***
Dealt to JJin91 [4d 8c]
MelzWay: calls 600
jonnycongo: folds=20
eliozica: folds=20
proletariat5: folds=20
P0tty Mouth: calls 300
JJin91: checks=20
*** FLOP *** [8d 9d Kd]
P0tty Mouth: checks=20
JJin91: checks=20
MelzWay: bets 1200
P0tty Mouth: folds=20
JJin91: raises 26316 to 27516 and is all-in
MelzWay: calls 2473 and is all-in
Uncalled bet (23843) returned to JJin91
*** TURN *** [8d 9d Kd] [6c]
*** RIVER *** [8d 9d Kd 6c] [7h]
*** SHOW DOWN ***
JJin91: shows [4d 8c] (a pair of Eights)
MelzWay: shows [7s Ks] (two pair, Kings and Sevens)
MelzWay collected 9566 from pot
*** SUMMARY ***
Total pot 9566 | Rake 0=20
Board [8d 9d Kd 6c 7h]
Seat 1: jonnycongo folded before Flop (didn't bet)
Seat 2: eliozica folded before Flop (didn't bet)
Seat 3: proletariat5 (button) folded before Flop (didn't bet)
Seat 4: P0tty Mouth (small blind) folded on the Flop
Seat 5: JJin91 (big blind) showed [4d 8c] and lost with a pair of Eights
Seat 6: MelzWay showed [7s Ks] and won (9566) with two pair, Kings and =
Sevens


*********** # 92 **************
PokerStars Hand #169869527868: Tournament #1622537329, $13.50+$1.50 USD=
 Hold'em No Limit - Level XII (300/600) - 2017/05/14 15:37:14 ET
Table '1622537329 2' 6-max Seat #4 is the button
Seat 1: jonnycongo (35478 in chips)=20
Seat 2: eliozica (51775 in chips)=20
Seat 3: proletariat5 (49407 in chips)=20
Seat 4: P0tty Mouth (12344 in chips)=20
Seat 5: JJin91 (23843 in chips)=20
Seat 6: MelzWay (9566 in chips)=20
jonnycongo: posts the ante 70
eliozica: posts the ante 70
proletariat5: posts the ante 70
P0tty Mouth: posts the ante 70
JJin91: posts the ante 70
MelzWay: posts the ante 70
JJin91: posts small blind 300
MelzWay: posts big blind 600
*** HOLE CARDS ***
Dealt to JJin91 [As 5h]
jonnycongo: folds=20
eliozica: folds=20
proletariat5: folds=20
P0tty Mouth: folds=20
JJin91: raises 600 to 1200
MelzWay: calls 600
*** FLOP *** [4d Ts 8c]
JJin91: checks=20
MelzWay: checks=20
*** TURN *** [4d Ts 8c] [6d]
JJin91: checks=20
MelzWay: checks=20
*** RIVER *** [4d Ts 8c 6d] [8d]
JJin91: checks=20
MelzWay: checks=20
*** SHOW DOWN ***
JJin91: shows [As 5h] (a pair of Eights)
MelzWay: shows [Ad 9s] (a pair of Eights - Ace+Ten+Nine kicker)
MelzWay collected 2820 from pot
*** SUMMARY ***
Total pot 2820 | Rake 0=20
Board [4d Ts 8c 6d 8d]
Seat 1: jonnycongo folded before Flop (didn't bet)
Seat 2: eliozica folded before Flop (didn't bet)
Seat 3: proletariat5 folded before Flop (didn't bet)
Seat 4: P0tty Mouth (button) folded before Flop (didn't bet)
Seat 5: JJin91 (small blind) showed [As 5h] and lost with a pair of Eig=
hts
Seat 6: MelzWay (big blind) showed [Ad 9s] and won (2820) with a pair o=
f Eights


*********** # 93 **************
PokerStars Hand #169869527971: Tournament #1622537329, $13.50+$1.50 USD=
 Hold'em No Limit - Level XII (300/600) - 2017/05/14 15:37:50 ET
Table '1622537329 2' 6-max Seat #5 is the button
Seat 1: jonnycongo (35408 in chips)=20
Seat 2: eliozica (51705 in chips)=20
Seat 3: proletariat5 (49337 in chips)=20
Seat 4: P0tty Mouth (12274 in chips)=20
Seat 5: JJin91 (22573 in chips)=20
Seat 6: MelzWay (11116 in chips)=20
jonnycongo: posts the ante 70
eliozica: posts the ante 70
proletariat5: posts the ante 70
P0tty Mouth: posts the ante 70
JJin91: posts the ante 70
MelzWay: posts the ante 70
MelzWay: posts small blind 300
jonnycongo: posts big blind 600
*** HOLE CARDS ***
Dealt to JJin91 [7c Tc]
eliozica: folds=20
proletariat5: raises 738 to 1338
P0tty Mouth: folds=20
JJin91: folds=20
MelzWay: folds=20
jonnycongo: calls 738
*** FLOP *** [Kc Td 7h]
jonnycongo: checks=20
proletariat5: checks=20
*** TURN *** [Kc Td 7h] [8h]
jonnycongo: bets 1200
proletariat5: calls 1200
*** RIVER *** [Kc Td 7h 8h] [5s]
jonnycongo: bets 5796
proletariat5: folds=20
Uncalled bet (5796) returned to jonnycongo
jonnycongo collected 5796 from pot
*** SUMMARY ***
Total pot 5796 | Rake 0=20
Board [Kc Td 7h 8h 5s]
Seat 1: jonnycongo (big blind) collected (5796)
Seat 2: eliozica folded before Flop (didn't bet)
Seat 3: proletariat5 folded on the River
Seat 4: P0tty Mouth folded before Flop (didn't bet)
Seat 5: JJin91 (button) folded before Flop (didn't bet)
Seat 6: MelzWay (small blind) folded before Flop


*********** # 94 **************
PokerStars Hand #169869528082: Tournament #1622537329, $13.50+$1.50 USD=
 Hold'em No Limit - Level XII (300/600) - 2017/05/14 15:38:30 ET
Table '1622537329 2' 6-max Seat #6 is the button
Seat 1: jonnycongo (38596 in chips)=20
Seat 2: eliozica (51635 in chips)=20
Seat 3: proletariat5 (46729 in chips)=20
Seat 4: P0tty Mouth (12204 in chips)=20
Seat 5: JJin91 (22503 in chips)=20
Seat 6: MelzWay (10746 in chips)=20
jonnycongo: posts the ante 70
eliozica: posts the ante 70
proletariat5: posts the ante 70
P0tty Mouth: posts the ante 70
JJin91: posts the ante 70
MelzWay: posts the ante 70
jonnycongo: posts small blind 300
eliozica: posts big blind 600
*** HOLE CARDS ***
Dealt to JJin91 [9h 8s]
proletariat5: folds=20
P0tty Mouth: calls 600
JJin91: folds=20
MelzWay: calls 600
jonnycongo: folds=20
eliozica: checks=20
*** FLOP *** [8d Kh 8h]
eliozica: checks=20
P0tty Mouth: checks=20
JJin91 is sitting out
MelzWay: checks=20
*** TURN *** [8d Kh 8h] [8c]
eliozica: checks=20
P0tty Mouth: checks=20
MelzWay: checks=20
*** RIVER *** [8d Kh 8h 8c] [Ad]
eliozica: checks=20
P0tty Mouth: bets 1200
MelzWay: raises 1200 to 2400
eliozica: folds=20
P0tty Mouth: calls 1200
*** SHOW DOWN ***
MelzWay: shows [Kd Jd] (a full house, Eights full of Kings)
P0tty Mouth: shows [Ac 9s] (a full house, Eights full of Aces)
P0tty Mouth collected 7320 from pot
*** SUMMARY ***
Total pot 7320 | Rake 0=20
Board [8d Kh 8h 8c Ad]
Seat 1: jonnycongo (small blind) folded before Flop
Seat 2: eliozica (big blind) folded on the River
Seat 3: proletariat5 folded before Flop (didn't bet)
Seat 4: P0tty Mouth showed [Ac 9s] and won (7320) with a full house, Ei=
ghts full of Aces
Seat 5: JJin91 folded before Flop (didn't bet)
Seat 6: MelzWay (button) showed [Kd Jd] and lost with a full house, Eig=
hts full of Kings


*********** # 95 **************
PokerStars Hand #169869528243: Tournament #1622537329, $13.50+$1.50 USD=
 Hold'em No Limit - Level XII (300/600) - 2017/05/14 15:39:25 ET
Table '1622537329 2' 6-max Seat #1 is the button
Seat 1: jonnycongo (38226 in chips)=20
Seat 2: eliozica (50965 in chips)=20
Seat 3: proletariat5 (46659 in chips)=20
Seat 4: P0tty Mouth (16454 in chips)=20
Seat 5: JJin91 (22433 in chips) is sitting out
Seat 6: MelzWay (7676 in chips)=20
jonnycongo: posts the ante 70
eliozica: posts the ante 70
proletariat5: posts the ante 70
P0tty Mouth: posts the ante 70
JJin91: posts the ante 70
MelzWay: posts the ante 70
eliozica: posts small blind 300
proletariat5: posts big blind 600
*** HOLE CARDS ***
Dealt to JJin91 [Ad Th]
P0tty Mouth: folds=20
JJin91: folds=20
MelzWay: folds=20
jonnycongo: folds=20
JJin91 has returned
eliozica: raises 1620 to 2220
proletariat5: folds=20
Uncalled bet (1620) returned to eliozica
eliozica collected 1620 from pot
eliozica: doesn't show hand=20
*** SUMMARY ***
Total pot 1620 | Rake 0=20
Seat 1: jonnycongo (button) folded before Flop (didn't bet)
Seat 2: eliozica (small blind) collected (1620)
Seat 3: proletariat5 (big blind) folded before Flop
Seat 4: P0tty Mouth folded before Flop (didn't bet)
Seat 5: JJin91 folded before Flop (didn't bet)
Seat 6: MelzWay folded before Flop (didn't bet)


*********** # 96 **************
PokerStars Hand #169869528320: Tournament #1622537329, $13.50+$1.50 USD=
 Hold'em No Limit - Level XII (300/600) - 2017/05/14 15:39:52 ET
Table '1622537329 2' 6-max Seat #2 is the button
Seat 1: jonnycongo (38156 in chips)=20
Seat 2: eliozica (51915 in chips)=20
Seat 3: proletariat5 (45989 in chips)=20
Seat 4: P0tty Mouth (16384 in chips)=20
Seat 5: JJin91 (22363 in chips)=20
Seat 6: MelzWay (7606 in chips)=20
jonnycongo: posts the ante 70
eliozica: posts the ante 70
proletariat5: posts the ante 70
P0tty Mouth: posts the ante 70
JJin91: posts the ante 70
MelzWay: posts the ante 70
proletariat5: posts small blind 300
P0tty Mouth: posts big blind 600
*** HOLE CARDS ***
Dealt to JJin91 [8h 4s]
JJin91: folds=20
MelzWay: folds=20
jonnycongo: folds=20
eliozica: folds=20
proletariat5: raises 738 to 1338
P0tty Mouth: folds=20
Uncalled bet (738) returned to proletariat5
proletariat5 collected 1620 from pot
proletariat5: doesn't show hand=20
*** SUMMARY ***
Total pot 1620 | Rake 0=20
Seat 1: jonnycongo folded before Flop (didn't bet)
Seat 2: eliozica (button) folded before Flop (didn't bet)
Seat 3: proletariat5 (small blind) collected (1620)
Seat 4: P0tty Mouth (big blind) folded before Flop
Seat 5: JJin91 folded before Flop (didn't bet)
Seat 6: MelzWay folded before Flop (didn't bet)


*********** # 97 **************
PokerStars Hand #169869528404: Tournament #1622537329, $13.50+$1.50 USD=
 Hold'em No Limit - Level XII (300/600) - 2017/05/14 15:40:21 ET
Table '1622537329 2' 6-max Seat #3 is the button
Seat 1: jonnycongo (38086 in chips)=20
Seat 2: eliozica (51845 in chips)=20
Seat 3: proletariat5 (46939 in chips)=20
Seat 4: P0tty Mouth (15714 in chips)=20
Seat 5: JJin91 (22293 in chips)=20
Seat 6: MelzWay (7536 in chips)=20
jonnycongo: posts the ante 70
eliozica: posts the ante 70
proletariat5: posts the ante 70
P0tty Mouth: posts the ante 70
JJin91: posts the ante 70
MelzWay: posts the ante 70
P0tty Mouth: posts small blind 300
JJin91: posts big blind 600
*** HOLE CARDS ***
Dealt to JJin91 [Jh 4s]
MelzWay: calls 600
jonnycongo: folds=20
eliozica: folds=20
proletariat5: calls 600
P0tty Mouth: calls 300
JJin91: checks=20
*** FLOP *** [Kh Kd 9s]
P0tty Mouth: checks=20
JJin91: checks=20
MelzWay: bets 600
proletariat5: calls 600
P0tty Mouth: folds=20
JJin91: folds=20
*** TURN *** [Kh Kd 9s] [Qc]
MelzWay: checks=20
proletariat5: bets 2211
MelzWay: folds=20
Uncalled bet (2211) returned to proletariat5
proletariat5 collected 4020 from pot
proletariat5: doesn't show hand=20
*** SUMMARY ***
Total pot 4020 | Rake 0=20
Board [Kh Kd 9s Qc]
Seat 1: jonnycongo folded before Flop (didn't bet)
Seat 2: eliozica folded before Flop (didn't bet)
Seat 3: proletariat5 (button) collected (4020)
Seat 4: P0tty Mouth (small blind) folded on the Flop
Seat 5: JJin91 (big blind) folded on the Flop
Seat 6: MelzWay folded on the Turn


*********** # 98 **************
PokerStars Hand #169869528606: Tournament #1622537329, $13.50+$1.50 USD=
 Hold'em No Limit - Level XII (300/600) - 2017/05/14 15:41:21 ET
Table '1622537329 2' 6-max Seat #4 is the button
Seat 1: jonnycongo (38016 in chips)=20
Seat 2: eliozica (51775 in chips)=20
Seat 3: proletariat5 (49689 in chips)=20
Seat 4: P0tty Mouth (15044 in chips)=20
Seat 5: JJin91 (21623 in chips)=20
Seat 6: MelzWay (6266 in chips)=20
jonnycongo: posts the ante 70
eliozica: posts the ante 70
proletariat5: posts the ante 70
P0tty Mouth: posts the ante 70
JJin91: posts the ante 70
MelzWay: posts the ante 70
JJin91: posts small blind 300
MelzWay: posts big blind 600
*** HOLE CARDS ***
Dealt to JJin91 [4s Ah]
jonnycongo: folds=20
eliozica: folds=20
proletariat5: raises 738 to 1338
P0tty Mouth: folds=20
JJin91: folds=20
MelzWay: raises 4858 to 6196 and is all-in
proletariat5: calls 4858
*** FLOP *** [Jc 3c 2h]
*** TURN *** [Jc 3c 2h] [9c]
*** RIVER *** [Jc 3c 2h 9c] [9s]
*** SHOW DOWN ***
MelzWay: shows [Ac 8d] (a pair of Nines)
proletariat5: shows [6d 6s] (two pair, Nines and Sixes)
proletariat5 collected 13112 from pot
MelzWay finished the tournament in 45th place
*** SUMMARY ***
Total pot 13112 | Rake 0=20
Board [Jc 3c 2h 9c 9s]
Seat 1: jonnycongo folded before Flop (didn't bet)
Seat 2: eliozica folded before Flop (didn't bet)
Seat 3: proletariat5 showed [6d 6s] and won (13112) with two pair, Nine=
s and Sixes
Seat 4: P0tty Mouth (button) folded before Flop (didn't bet)
Seat 5: JJin91 (small blind) folded before Flop
Seat 6: MelzWay (big blind) showed [Ac 8d] and lost with a pair of Nines


*********** # 99 **************
PokerStars Hand #169869528736: Tournament #1622537329, $13.50+$1.50 USD=
 Hold'em No Limit - Level XIII (350/700) - 2017/05/14 15:41:57 ET
Table '1622537329 2' 6-max Seat #5 is the button
Seat 1: jonnycongo (37946 in chips)=20
Seat 2: eliozica (51705 in chips)=20
Seat 3: proletariat5 (56535 in chips)=20
Seat 4: P0tty Mouth (14974 in chips)=20
Seat 5: JJin91 (21253 in chips)=20
jonnycongo: posts the ante 85
eliozica: posts the ante 85
proletariat5: posts the ante 85
P0tty Mouth: posts the ante 85
JJin91: posts the ante 85
jonnycongo: posts small blind 350
eliozica: posts big blind 700
*** HOLE CARDS ***
Dealt to JJin91 [2s Ac]
proletariat5: folds=20
P0tty Mouth: folds=20
JJin91: raises 833 to 1533
jonnycongo: folds=20
eliozica: calls 833
*** FLOP *** [3s Ts 8h]
eliozica: checks=20
JJin91: bets 2189
eliozica: folds=20
Uncalled bet (2189) returned to JJin91
JJin91 collected 3841 from pot
JJin91: doesn't show hand=20
*** SUMMARY ***
Total pot 3841 | Rake 0=20
Board [3s Ts 8h]
Seat 1: jonnycongo (small blind) folded before Flop
Seat 2: eliozica (big blind) folded on the Flop
Seat 3: proletariat5 folded before Flop (didn't bet)
Seat 4: P0tty Mouth folded before Flop (didn't bet)
Seat 5: JJin91 (button) collected (3841)


*********** # 100 **************
PokerStars Hand #169869528821: Tournament #1622537329, $13.50+$1.50 USD=
 Hold'em No Limit - Level XIII (350/700) - 2017/05/14 15:42:23 ET
Table '1622537329 2' 6-max Seat #1 is the button
Seat 1: jonnycongo (37511 in chips)=20
Seat 2: eliozica (50087 in chips)=20
Seat 3: proletariat5 (56450 in chips)=20
Seat 4: P0tty Mouth (14889 in chips)=20
Seat 5: JJin91 (23476 in chips)=20
jonnycongo: posts the ante 85
eliozica: posts the ante 85
proletariat5: posts the ante 85
P0tty Mouth: posts the ante 85
JJin91: posts the ante 85
eliozica: posts small blind 350
proletariat5: posts big blind 700
*** HOLE CARDS ***
Dealt to JJin91 [7d 9c]
P0tty Mouth: folds=20
JJin91: folds=20
jonnycongo: folds=20
eliozica: calls 350
proletariat5: checks=20
*** FLOP *** [3c 2h 9d]
eliozica: checks=20
proletariat5: checks=20
*** TURN *** [3c 2h 9d] [Js]
eliozica: checks=20
proletariat5: checks=20
*** RIVER *** [3c 2h 9d Js] [Ad]
eliozica: checks=20
proletariat5: checks=20
*** SHOW DOWN ***
eliozica: shows [7s Qd] (high card Ace)
proletariat5: mucks hand=20
eliozica collected 1825 from pot
*** SUMMARY ***
Total pot 1825 | Rake 0=20
Board [3c 2h 9d Js Ad]
Seat 1: jonnycongo (button) folded before Flop (didn't bet)
Seat 2: eliozica (small blind) showed [7s Qd] and won (1825) with high =
card Ace
Seat 3: proletariat5 (big blind) mucked [5d 6c]
Seat 4: P0tty Mouth folded before Flop (didn't bet)
Seat 5: JJin91 folded before Flop (didn't bet)


*********** # 101 **************
PokerStars Hand #169869528917: Tournament #1622537329, $13.50+$1.50 USD=
 Hold'em No Limit - Level XIII (350/700) - 2017/05/14 15:42:51 ET
Table '1622537329 2' 6-max Seat #2 is the button
Seat 1: jonnycongo (37426 in chips)=20
Seat 2: eliozica (51127 in chips)=20
Seat 3: proletariat5 (55665 in chips)=20
Seat 4: P0tty Mouth (14804 in chips)=20
Seat 5: JJin91 (23391 in chips)=20
jonnycongo: posts the ante 85
eliozica: posts the ante 85
proletariat5: posts the ante 85
P0tty Mouth: posts the ante 85
JJin91: posts the ante 85
proletariat5: posts small blind 350
P0tty Mouth: posts big blind 700
*** HOLE CARDS ***
Dealt to JJin91 [Qh Qs]
JJin91: raises 833 to 1533
jonnycongo: folds=20
eliozica: folds=20
proletariat5: folds=20
P0tty Mouth: calls 833
*** FLOP *** [Ks 9d 5c]
P0tty Mouth: checks=20
JJin91: bets 1421
P0tty Mouth: folds=20
Uncalled bet (1421) returned to JJin91
JJin91 collected 3841 from pot
JJin91: doesn't show hand=20
*** SUMMARY ***
Total pot 3841 | Rake 0=20
Board [Ks 9d 5c]
Seat 1: jonnycongo folded before Flop (didn't bet)
Seat 2: eliozica (button) folded before Flop (didn't bet)
Seat 3: proletariat5 (small blind) folded before Flop
Seat 4: P0tty Mouth (big blind) folded on the Flop
Seat 5: JJin91 collected (3841)


*********** # 102 **************
PokerStars Hand #169869529010: Tournament #1622537329, $13.50+$1.50 USD=
 Hold'em No Limit - Level XIII (350/700) - 2017/05/14 15:43:20 ET
Table '1622537329 2' 6-max Seat #3 is the button
Seat 1: jonnycongo (37341 in chips)=20
Seat 2: eliozica (51042 in chips)=20
Seat 3: proletariat5 (55230 in chips)=20
Seat 4: P0tty Mouth (13186 in chips)=20
Seat 5: JJin91 (25614 in chips)=20
jonnycongo: posts the ante 85
eliozica: posts the ante 85
proletariat5: posts the ante 85
P0tty Mouth: posts the ante 85
JJin91: posts the ante 85
P0tty Mouth: posts small blind 350
JJin91: posts big blind 700
*** HOLE CARDS ***
Dealt to JJin91 [Qs Th]
jonnycongo: folds=20
eliozica: folds=20
proletariat5: folds=20
jonnycongo is disconnected=20
P0tty Mouth: calls 350
JJin91: checks=20
*** FLOP *** [9c 9d Kc]
P0tty Mouth: checks=20
JJin91: checks=20
*** TURN *** [9c 9d Kc] [8c]
P0tty Mouth: bets 700
JJin91: folds=20
Uncalled bet (700) returned to P0tty Mouth
P0tty Mouth collected 1825 from pot
P0tty Mouth: doesn't show hand=20
*** SUMMARY ***
Total pot 1825 | Rake 0=20
Board [9c 9d Kc 8c]
Seat 1: jonnycongo folded before Flop (didn't bet)
Seat 2: eliozica folded before Flop (didn't bet)
Seat 3: proletariat5 (button) folded before Flop (didn't bet)
Seat 4: P0tty Mouth (small blind) collected (1825)
Seat 5: JJin91 (big blind) folded on the Turn


*********** # 103 **************
PokerStars Hand #169869529159: Tournament #1622537329, $13.50+$1.50 USD=
 Hold'em No Limit - Level XIII (350/700) - 2017/05/14 15:44:07 ET
Table '1622537329 2' 6-max Seat #4 is the button
Seat 1: jonnycongo (37256 in chips)=20
Seat 2: eliozica (50957 in chips)=20
Seat 3: proletariat5 (55145 in chips)=20
Seat 4: P0tty Mouth (14226 in chips)=20
Seat 5: JJin91 (24829 in chips)=20
Seat 6: hainesiv2 (34033 in chips)=20
jonnycongo: posts the ante 85
eliozica: posts the ante 85
proletariat5: posts the ante 85
P0tty Mouth: posts the ante 85
JJin91: posts the ante 85
hainesiv2: posts the ante 85
JJin91: posts small blind 350
hainesiv2: posts big blind 700
*** HOLE CARDS ***
Dealt to JJin91 [5s 7d]
jonnycongo is connected=20
jonnycongo is connected=20
jonnycongo: folds=20
eliozica: folds=20
proletariat5: folds=20
P0tty Mouth: folds=20
JJin91: folds=20
Uncalled bet (350) returned to hainesiv2
hainesiv2 collected 1210 from pot
hainesiv2: doesn't show hand=20
*** SUMMARY ***
Total pot 1210 | Rake 0=20
Seat 1: jonnycongo folded before Flop (didn't bet)
Seat 2: eliozica folded before Flop (didn't bet)
Seat 3: proletariat5 folded before Flop (didn't bet)
Seat 4: P0tty Mouth (button) folded before Flop (didn't bet)
Seat 5: JJin91 (small blind) folded before Flop
Seat 6: hainesiv2 (big blind) collected (1210)


*********** # 104 **************
PokerStars Hand #169869529285: Tournament #1622537329, $13.50+$1.50 USD=
 Hold'em No Limit - Level XIII (350/700) - 2017/05/14 15:44:51 ET
Table '1622537329 2' 6-max Seat #5 is the button
Seat 1: jonnycongo (37171 in chips)=20
Seat 2: eliozica (50872 in chips)=20
Seat 3: proletariat5 (55060 in chips)=20
Seat 4: P0tty Mouth (14141 in chips)=20
Seat 5: JJin91 (24394 in chips)=20
Seat 6: hainesiv2 (34808 in chips)=20
jonnycongo: posts the ante 85
eliozica: posts the ante 85
proletariat5: posts the ante 85
P0tty Mouth: posts the ante 85
JJin91: posts the ante 85
hainesiv2: posts the ante 85
hainesiv2: posts small blind 350
jonnycongo: posts big blind 700
*** HOLE CARDS ***
Dealt to JJin91 [2h Jd]
eliozica: folds=20
proletariat5: raises 861 to 1561
P0tty Mouth: calls 1561
JJin91: folds=20
hainesiv2: folds=20
jonnycongo: folds=20
*** FLOP *** [6d 3s 4s]
proletariat5: bets 1498
P0tty Mouth: raises 10997 to 12495 and is all-in
proletariat5: folds=20
Uncalled bet (10997) returned to P0tty Mouth
P0tty Mouth collected 7678 from pot
P0tty Mouth: doesn't show hand=20
*** SUMMARY ***
Total pot 7678 | Rake 0=20
Board [6d 3s 4s]
Seat 1: jonnycongo (big blind) folded before Flop
Seat 2: eliozica folded before Flop (didn't bet)
Seat 3: proletariat5 folded on the Flop
Seat 4: P0tty Mouth collected (7678)
Seat 5: JJin91 (button) folded before Flop (didn't bet)
Seat 6: hainesiv2 (small blind) folded before Flop


*********** # 105 **************
PokerStars Hand #169869529421: Tournament #1622537329, $13.50+$1.50 USD=
 Hold'em No Limit - Level XIII (350/700) - 2017/05/14 15:45:27 ET
Table '1622537329 2' 6-max Seat #6 is the button
Seat 1: jonnycongo (36386 in chips)=20
Seat 2: eliozica (50787 in chips)=20
Seat 3: proletariat5 (51916 in chips)=20
Seat 4: P0tty Mouth (18675 in chips)=20
Seat 5: JJin91 (24309 in chips)=20
Seat 6: hainesiv2 (34373 in chips)=20
jonnycongo: posts the ante 85
eliozica: posts the ante 85
proletariat5: posts the ante 85
P0tty Mouth: posts the ante 85
JJin91: posts the ante 85
hainesiv2: posts the ante 85
jonnycongo: posts small blind 350
eliozica: posts big blind 700
*** HOLE CARDS ***
Dealt to JJin91 [7s 4d]
proletariat5: folds=20
P0tty Mouth: folds=20
JJin91: folds=20
hainesiv2: folds=20
jonnycongo: calls 350
eliozica: raises 3310 to 4010
jonnycongo: folds=20
Uncalled bet (3310) returned to eliozica
eliozica collected 1910 from pot
eliozica: doesn't show hand=20
*** SUMMARY ***
Total pot 1910 | Rake 0=20
Seat 1: jonnycongo (small blind) folded before Flop
Seat 2: eliozica (big blind) collected (1910)
Seat 3: proletariat5 folded before Flop (didn't bet)
Seat 4: P0tty Mouth folded before Flop (didn't bet)
Seat 5: JJin91 folded before Flop (didn't bet)
Seat 6: hainesiv2 (button) folded before Flop (didn't bet)


*********** # 106 **************
PokerStars Hand #169869529519: Tournament #1622537329, $13.50+$1.50 USD=
 Hold'em No Limit - Level XIII (350/700) - 2017/05/14 15:45:57 ET
Table '1622537329 2' 6-max Seat #1 is the button
Seat 1: jonnycongo (35601 in chips)=20
Seat 2: eliozica (51912 in chips)=20
Seat 3: proletariat5 (51831 in chips)=20
Seat 4: P0tty Mouth (18590 in chips)=20
Seat 5: JJin91 (24224 in chips)=20
jonnycongo: posts the ante 85
eliozica: posts the ante 85
proletariat5: posts the ante 85
P0tty Mouth: posts the ante 85
JJin91: posts the ante 85
eliozica: posts small blind 350
proletariat5: posts big blind 700
*** HOLE CARDS ***
Dealt to JJin91 [As 3s]
P0tty Mouth: folds=20
JJin91: raises 833 to 1533
jonnycongo: folds=20
eliozica: calls 1183
proletariat5: folds=20
*** FLOP *** [2h 4c 4d]
eliozica: checks=20
JJin91: bets 1551
eliozica: raises 3651 to 5202
JJin91: calls 3651
*** TURN *** [2h 4c 4d] [Jd]
eliozica: bets 7000
JJin91: calls 7000
*** RIVER *** [2h 4c 4d Jd] [7s]
eliozica: checks=20
JJin91: bets 10404 and is all-in
eliozica: folds=20
Uncalled bet (10404) returned to JJin91
JJin91 collected 28595 from pot
JJin91: doesn't show hand=20
*** SUMMARY ***
Total pot 28595 | Rake 0=20
Board [2h 4c 4d Jd 7s]
Seat 1: jonnycongo (button) folded before Flop (didn't bet)
Seat 2: eliozica (small blind) folded on the River
Seat 3: proletariat5 (big blind) folded before Flop
Seat 4: P0tty Mouth folded before Flop (didn't bet)
Seat 5: JJin91 collected (28595)


*********** # 107 **************
PokerStars Hand #169869529734: Tournament #1622537329, $13.50+$1.50 USD=
 Hold'em No Limit - Level XIII (350/700) - 2017/05/14 15:47:04 ET
Table '1622537329 2' 6-max Seat #2 is the button
Seat 1: jonnycongo (35516 in chips)=20
Seat 2: eliozica (38092 in chips)=20
Seat 3: proletariat5 (51046 in chips)=20
Seat 4: P0tty Mouth (18505 in chips)=20
Seat 5: JJin91 (38999 in chips)=20
jonnycongo: posts the ante 85
eliozica: posts the ante 85
proletariat5: posts the ante 85
P0tty Mouth: posts the ante 85
JJin91: posts the ante 85
proletariat5: posts small blind 350
P0tty Mouth: posts big blind 700
*** HOLE CARDS ***
Dealt to JJin91 [Tc 2h]
JJin91: folds=20
jonnycongo: folds=20
eliozica: raises 700 to 1400
proletariat5: calls 1050
P0tty Mouth: folds=20
*** FLOP *** [5d Ts Td]
proletariat5: checks=20
eliozica: bets 4200
proletariat5: folds=20
Uncalled bet (4200) returned to eliozica
eliozica collected 3925 from pot
eliozica: doesn't show hand=20
*** SUMMARY ***
Total pot 3925 | Rake 0=20
Board [5d Ts Td]
Seat 1: jonnycongo folded before Flop (didn't bet)
Seat 2: eliozica (button) collected (3925)
Seat 3: proletariat5 (small blind) folded on the Flop
Seat 4: P0tty Mouth (big blind) folded before Flop
Seat 5: JJin91 folded before Flop (didn't bet)


*********** # 108 **************
PokerStars Hand #169869529849: Tournament #1622537329, $13.50+$1.50 USD=
 Hold'em No Limit - Level XIII (350/700) - 2017/05/14 15:47:40 ET
Table '1622537329 2' 6-max Seat #3 is the button
Seat 1: jonnycongo (35431 in chips)=20
Seat 2: eliozica (40532 in chips)=20
Seat 3: proletariat5 (49561 in chips)=20
Seat 4: P0tty Mouth (17720 in chips)=20
Seat 5: JJin91 (38914 in chips)=20
jonnycongo: posts the ante 85
eliozica: posts the ante 85
proletariat5: posts the ante 85
P0tty Mouth: posts the ante 85
JJin91: posts the ante 85
P0tty Mouth: posts small blind 350
JJin91: posts big blind 700
*** HOLE CARDS ***
Dealt to JJin91 [4h 9h]
jonnycongo: raises 700 to 1400
eliozica: calls 1400
proletariat5: folds=20
P0tty Mouth: folds=20
JJin91: calls 700
*** FLOP *** [Jd 5d 9d]
JJin91: checks=20
jonnycongo: bets 4900
eliozica: folds=20
JJin91: folds=20
Uncalled bet (4900) returned to jonnycongo
jonnycongo collected 4975 from pot
jonnycongo: doesn't show hand=20
*** SUMMARY ***
Total pot 4975 | Rake 0=20
Board [Jd 5d 9d]
Seat 1: jonnycongo collected (4975)
Seat 2: eliozica folded on the Flop
Seat 3: proletariat5 (button) folded before Flop (didn't bet)
Seat 4: P0tty Mouth (small blind) folded before Flop
Seat 5: JJin91 (big blind) folded on the Flop


*********** # 109 **************
PokerStars Hand #169869529965: Tournament #1622537329, $13.50+$1.50 USD=
 Hold'em No Limit - Level XIII (350/700) - 2017/05/14 15:48:16 ET
Table '1622537329 2' 6-max Seat #4 is the button
Seat 1: jonnycongo (38921 in chips)=20
Seat 2: eliozica (39047 in chips)=20
Seat 3: proletariat5 (49476 in chips)=20
Seat 4: P0tty Mouth (17285 in chips)=20
Seat 5: JJin91 (37429 in chips)=20
jonnycongo: posts the ante 85
eliozica: posts the ante 85
proletariat5: posts the ante 85
P0tty Mouth: posts the ante 85
JJin91: posts the ante 85
JJin91: posts small blind 350
jonnycongo: posts big blind 700
*** HOLE CARDS ***
Dealt to JJin91 [Qd Kd]
eliozica: folds=20
proletariat5: folds=20
P0tty Mouth: calls 700
JJin91: raises 1572 to 2272
jonnycongo: folds=20
P0tty Mouth: calls 1572
*** FLOP *** [Tc 5c 2s]
JJin91: checks=20
jonnycongo is sitting out
P0tty Mouth: bets 2100
jonnycongo has returned
JJin91: folds=20
Uncalled bet (2100) returned to P0tty Mouth
P0tty Mouth collected 5669 from pot
P0tty Mouth: doesn't show hand=20
*** SUMMARY ***
Total pot 5669 | Rake 0=20
Board [Tc 5c 2s]
Seat 1: jonnycongo (big blind) folded before Flop
Seat 2: eliozica folded before Flop (didn't bet)
Seat 3: proletariat5 folded before Flop (didn't bet)
Seat 4: P0tty Mouth (button) collected (5669)
Seat 5: JJin91 (small blind) folded on the Flop


*********** # 110 **************
PokerStars Hand #169870580509: Tournament #1622537329, $13.50+$1.50 USD=
 Hold'em No Limit - Level XIII (350/700) - 2017/05/14 15:49:00 ET
Table '1622537329 2' 6-max Seat #5 is the button
Seat 1: jonnycongo (38136 in chips)=20
Seat 2: eliozica (38962 in chips)=20
Seat 3: proletariat5 (49391 in chips)=20
Seat 4: P0tty Mouth (20597 in chips)=20
Seat 5: JJin91 (35072 in chips)=20
Seat 6: Bullets4Rick (32636 in chips) out of hand (moved from another t=
able into small blind)
jonnycongo: posts the ante 85
eliozica: posts the ante 85
proletariat5: posts the ante 85
P0tty Mouth: posts the ante 85
JJin91: posts the ante 85
jonnycongo: posts small blind 350
eliozica: posts big blind 700
*** HOLE CARDS ***
Dealt to JJin91 [4h Tc]
proletariat5: folds=20
P0tty Mouth: folds=20
JJin91: folds=20
jonnycongo: raises 1400 to 2100
eliozica: calls 1400
*** FLOP *** [6c As 3h]
jonnycongo: bets 4625
eliozica: calls 4625
*** TURN *** [6c As 3h] [2h]
jonnycongo: bets 13875
eliozica: folds=20
Uncalled bet (13875) returned to jonnycongo
jonnycongo collected 13875 from pot
*** SUMMARY ***
Total pot 13875 | Rake 0=20
Board [6c As 3h 2h]
Seat 1: jonnycongo (small blind) collected (13875)
Seat 2: eliozica (big blind) folded on the Turn
Seat 3: proletariat5 folded before Flop (didn't bet)
Seat 4: P0tty Mouth folded before Flop (didn't bet)
Seat 5: JJin91 (button) folded before Flop (didn't bet)


*********** # 111 **************
PokerStars Hand #169870580603: Tournament #1622537329, $13.50+$1.50 USD=
 Hold'em No Limit - Level XIII (350/700) - 2017/05/14 15:49:27 ET
Table '1622537329 2' 6-max Seat #1 is the button
Seat 1: jonnycongo (45201 in chips)=20
Seat 2: eliozica (32152 in chips)=20
Seat 3: proletariat5 (49306 in chips)=20
Seat 4: P0tty Mouth (20512 in chips)=20
Seat 5: JJin91 (34987 in chips)=20
Seat 6: Bullets4Rick (32636 in chips)=20
jonnycongo: posts the ante 85
eliozica: posts the ante 85
proletariat5: posts the ante 85
P0tty Mouth: posts the ante 85
JJin91: posts the ante 85
Bullets4Rick: posts the ante 85
eliozica: posts small blind 350
proletariat5: posts big blind 700
*** HOLE CARDS ***
Dealt to JJin91 [Ts Jc]
P0tty Mouth: calls 700
JJin91: folds=20
Bullets4Rick has timed out
Bullets4Rick: folds=20
Bullets4Rick is sitting out
jonnycongo: folds=20
eliozica: raises 1400 to 2100
proletariat5: folds=20
P0tty Mouth: calls 1400
*** FLOP *** [4d Js 4h]
eliozica: bets 5600
P0tty Mouth: folds=20
Uncalled bet (5600) returned to eliozica
eliozica collected 5410 from pot
eliozica: doesn't show hand=20
*** SUMMARY ***
Total pot 5410 | Rake 0=20
Board [4d Js 4h]
Seat 1: jonnycongo (button) folded before Flop (didn't bet)
Seat 2: eliozica (small blind) collected (5410)
Seat 3: proletariat5 (big blind) folded before Flop
Seat 4: P0tty Mouth folded on the Flop
Seat 5: JJin91 folded before Flop (didn't bet)
Seat 6: Bullets4Rick folded before Flop (didn't bet)


*********** # 112 **************
PokerStars Hand #169870580851: Tournament #1622537329, $13.50+$1.50 USD=
 Hold'em No Limit - Level XIII (350/700) - 2017/05/14 15:50:48 ET
Table '1622537329 2' 6-max Seat #2 is the button
Seat 1: jonnycongo (45116 in chips)=20
Seat 2: eliozica (35377 in chips)=20
Seat 3: proletariat5 (48521 in chips)=20
Seat 4: P0tty Mouth (18327 in chips)=20
Seat 5: JJin91 (34902 in chips)=20
Seat 6: Bullets4Rick (32551 in chips) is sitting out
jonnycongo: posts the ante 85
eliozica: posts the ante 85
proletariat5: posts the ante 85
P0tty Mouth: posts the ante 85
JJin91: posts the ante 85
Bullets4Rick: posts the ante 85
proletariat5: posts small blind 350
P0tty Mouth: posts big blind 700
*** HOLE CARDS ***
Dealt to JJin91 [Ad 4s]
JJin91: folds=20
Bullets4Rick: folds=20
jonnycongo: folds=20
Bullets4Rick has returned
eliozica: raises 1400 to 2100
proletariat5: folds=20
P0tty Mouth: folds=20
Uncalled bet (1400) returned to eliozica
eliozica collected 2260 from pot
eliozica: doesn't show hand=20
*** SUMMARY ***
Total pot 2260 | Rake 0=20
Seat 1: jonnycongo folded before Flop (didn't bet)
Seat 2: eliozica (button) collected (2260)
Seat 3: proletariat5 (small blind) folded before Flop
Seat 4: P0tty Mouth (big blind) folded before Flop
Seat 5: JJin91 folded before Flop (didn't bet)
Seat 6: Bullets4Rick folded before Flop (didn't bet)


*********** # 113 **************
PokerStars Hand #169870580912: Tournament #1622537329, $13.50+$1.50 USD=
 Hold'em No Limit - Level XIII (350/700) - 2017/05/14 15:51:06 ET
Table '1622537329 2' 6-max Seat #3 is the button
Seat 1: jonnycongo (45031 in chips)=20
Seat 2: eliozica (36852 in chips)=20
Seat 3: proletariat5 (48086 in chips)=20
Seat 4: P0tty Mouth (17542 in chips)=20
Seat 5: JJin91 (34817 in chips)=20
Seat 6: Bullets4Rick (32466 in chips)=20
jonnycongo: posts the ante 85
eliozica: posts the ante 85
proletariat5: posts the ante 85
P0tty Mouth: posts the ante 85
JJin91: posts the ante 85
Bullets4Rick: posts the ante 85
P0tty Mouth: posts small blind 350
JJin91: posts big blind 700
*** HOLE CARDS ***
Dealt to JJin91 [Ts 4h]
Bullets4Rick: folds=20
jonnycongo: calls 700
eliozica: calls 700
proletariat5: folds=20
P0tty Mouth: raises 2800 to 3500
JJin91: folds=20
jonnycongo: calls 2800
eliozica: folds=20
*** FLOP *** [8c 6h Ad]
P0tty Mouth: bets 3500
jonnycongo: calls 3500
*** TURN *** [8c 6h Ad] [4d]
P0tty Mouth: checks=20
jonnycongo: bets 4200
P0tty Mouth: calls 4200
*** RIVER *** [8c 6h Ad 4d] [2s]
P0tty Mouth: checks=20
jonnycongo: bets 24310
P0tty Mouth said, "KK let me down"
P0tty Mouth: folds=20
Uncalled bet (24310) returned to jonnycongo
jonnycongo collected 24310 from pot
*** SUMMARY ***
Total pot 24310 | Rake 0=20
Board [8c 6h Ad 4d 2s]
Seat 1: jonnycongo collected (24310)
Seat 2: eliozica folded before Flop
Seat 3: proletariat5 (button) folded before Flop (didn't bet)
Seat 4: P0tty Mouth (small blind) folded on the River
Seat 5: JJin91 (big blind) folded before Flop
Seat 6: Bullets4Rick folded before Flop (didn't bet)


*********** # 114 **************
PokerStars Hand #169870581172: Tournament #1622537329, $13.50+$1.50 USD=
 Hold'em No Limit - Level XIV (400/800) - 2017/05/14 15:52:21 ET
Table '1622537329 2' 6-max Seat #4 is the button
Seat 1: jonnycongo (58056 in chips)=20
Seat 2: eliozica (36067 in chips)=20
Seat 3: proletariat5 (48001 in chips)=20
Seat 4: P0tty Mouth (6257 in chips)=20
Seat 5: JJin91 (34032 in chips)=20
Seat 6: Bullets4Rick (32381 in chips)=20
jonnycongo: posts the ante 100
eliozica: posts the ante 100
proletariat5: posts the ante 100
P0tty Mouth: posts the ante 100
JJin91: posts the ante 100
Bullets4Rick: posts the ante 100
JJin91: posts small blind 400
Bullets4Rick: posts big blind 800
*** HOLE CARDS ***
Dealt to JJin91 [5h 5d]
jonnycongo said, "hate that"
jonnycongo: folds=20
eliozica: folds=20
proletariat5: folds=20
P0tty Mouth: calls 800
JJin91: calls 400
Bullets4Rick: checks=20
*** FLOP *** [Ts Tc 9d]
jonnycongo said, "the only card you dont wanna see on the flop lol"
JJin91: checks=20
Bullets4Rick: checks=20
P0tty Mouth said, "yup"
P0tty Mouth: checks=20
*** TURN *** [Ts Tc 9d] [Ah]
JJin91: checks=20
Bullets4Rick: bets 800
P0tty Mouth: folds=20
JJin91: calls 800
*** RIVER *** [Ts Tc 9d Ah] [3d]
JJin91: checks=20
Bullets4Rick: bets 800
JJin91: calls 800
*** SHOW DOWN ***
Bullets4Rick: shows [Ad 3c] (two pair, Aces and Tens)
JJin91: mucks hand=20
Bullets4Rick collected 6200 from pot
*** SUMMARY ***
Total pot 6200 | Rake 0=20
Board [Ts Tc 9d Ah 3d]
Seat 1: jonnycongo folded before Flop (didn't bet)
Seat 2: eliozica folded before Flop (didn't bet)
Seat 3: proletariat5 folded before Flop (didn't bet)
Seat 4: P0tty Mouth (button) folded on the Turn
Seat 5: JJin91 (small blind) mucked [5h 5d]
Seat 6: Bullets4Rick (big blind) showed [Ad 3c] and won (6200) with two=
 pair, Aces and Tens


*********** # 115 **************
PokerStars Hand #169870581322: Tournament #1622537329, $13.50+$1.50 USD=
 Hold'em No Limit - Level XIV (400/800) - 2017/05/14 15:53:06 ET
Table '1622537329 2' 6-max Seat #5 is the button
Seat 1: jonnycongo (57956 in chips)=20
Seat 2: eliozica (35967 in chips)=20
Seat 3: proletariat5 (47901 in chips)=20
Seat 4: P0tty Mouth (5357 in chips)=20
Seat 5: JJin91 (31532 in chips)=20
Seat 6: Bullets4Rick (36081 in chips)=20
jonnycongo: posts the ante 100
eliozica: posts the ante 100
proletariat5: posts the ante 100
P0tty Mouth: posts the ante 100
JJin91: posts the ante 100
Bullets4Rick: posts the ante 100
Bullets4Rick: posts small blind 400
jonnycongo: posts big blind 800
*** HOLE CARDS ***
Dealt to JJin91 [Qd 9c]
eliozica: calls 800
proletariat5: folds=20
P0tty Mouth: folds=20
JJin91: folds=20
Bullets4Rick: calls 400
jonnycongo: checks=20
*** FLOP *** [Qs Kh 3d]
Bullets4Rick: checks=20
jonnycongo: checks=20
eliozica: bets 1600
Bullets4Rick: folds=20
jonnycongo: folds=20
Uncalled bet (1600) returned to eliozica
eliozica collected 3000 from pot
eliozica: doesn't show hand=20
*** SUMMARY ***
Total pot 3000 | Rake 0=20
Board [Qs Kh 3d]
Seat 1: jonnycongo (big blind) folded on the Flop
Seat 2: eliozica collected (3000)
Seat 3: proletariat5 folded before Flop (didn't bet)
Seat 4: P0tty Mouth folded before Flop (didn't bet)
Seat 5: JJin91 (button) folded before Flop (didn't bet)
Seat 6: Bullets4Rick (small blind) folded on the Flop


*********** # 116 **************
PokerStars Hand #169870581411: Tournament #1622537329, $13.50+$1.50 USD=
 Hold'em No Limit - Level XIV (400/800) - 2017/05/14 15:53:33 ET
Table '1622537329 2' 6-max Seat #6 is the button
Seat 1: jonnycongo (57056 in chips)=20
Seat 2: eliozica (38067 in chips)=20
Seat 3: proletariat5 (47801 in chips)=20
Seat 4: P0tty Mouth (5257 in chips)=20
Seat 5: JJin91 (31432 in chips)=20
Seat 6: Bullets4Rick (35181 in chips)=20
jonnycongo: posts the ante 100
eliozica: posts the ante 100
proletariat5: posts the ante 100
P0tty Mouth: posts the ante 100
JJin91: posts the ante 100
Bullets4Rick: posts the ante 100
jonnycongo: posts small blind 400
eliozica: posts big blind 800
*** HOLE CARDS ***
Dealt to JJin91 [5d 7d]
proletariat5: folds=20
P0tty Mouth: folds=20
JJin91: folds=20
Bullets4Rick: calls 800
jonnycongo: calls 400
eliozica: checks=20
*** FLOP *** [5c Qd Ts]
jonnycongo: checks=20
eliozica: checks=20
Bullets4Rick: checks=20
*** TURN *** [5c Qd Ts] [As]
jonnycongo: checks=20
eliozica: checks=20
Bullets4Rick: checks=20
*** RIVER *** [5c Qd Ts As] [2c]
jonnycongo: bets 800
eliozica: folds=20
Bullets4Rick: folds=20
Uncalled bet (800) returned to jonnycongo
jonnycongo collected 3000 from pot
jonnycongo: shows [5s Ah] (two pair, Aces and Fives)
*** SUMMARY ***
Total pot 3000 | Rake 0=20
Board [5c Qd Ts As 2c]
Seat 1: jonnycongo (small blind) collected (3000)
Seat 2: eliozica (big blind) folded on the River
Seat 3: proletariat5 folded before Flop (didn't bet)
Seat 4: P0tty Mouth folded before Flop (didn't bet)
Seat 5: JJin91 folded before Flop (didn't bet)
Seat 6: Bullets4Rick (button) folded on the River


*********** # 117 **************
PokerStars Hand #169870581569: Tournament #1622537329, $13.50+$1.50 USD=
 Hold'em No Limit - Level XIV (400/800) - 2017/05/14 15:54:22 ET
Table '1622537329 2' 6-max Seat #1 is the button
Seat 1: jonnycongo (59156 in chips)=20
Seat 2: eliozica (37167 in chips)=20
Seat 3: proletariat5 (47701 in chips)=20
Seat 4: P0tty Mouth (5157 in chips)=20
Seat 5: JJin91 (31332 in chips)=20
Seat 6: Bullets4Rick (34281 in chips)=20
jonnycongo: posts the ante 100
eliozica: posts the ante 100
proletariat5: posts the ante 100
P0tty Mouth: posts the ante 100
JJin91: posts the ante 100
Bullets4Rick: posts the ante 100
eliozica: posts small blind 400
proletariat5: posts big blind 800
*** HOLE CARDS ***
Dealt to JJin91 [Ks Kc]
P0tty Mouth: calls 800
JJin91: raises 1212 to 2012
Bullets4Rick: folds=20
jonnycongo: folds=20
eliozica: folds=20
proletariat5: folds=20
P0tty Mouth: raises 3045 to 5057 and is all-in
JJin91: calls 3045
*** FLOP *** [5d 8c 2d]
*** TURN *** [5d 8c 2d] [9c]
*** RIVER *** [5d 8c 2d 9c] [Jc]
*** SHOW DOWN ***
P0tty Mouth: shows [Js Qs] (a pair of Jacks)
JJin91: shows [Ks Kc] (a pair of Kings)
P0tty Mouth said, "lol"
JJin91 collected 11914 from pot
P0tty Mouth finished the tournament in 32nd place
*** SUMMARY ***
Total pot 11914 | Rake 0=20
Board [5d 8c 2d 9c Jc]
Seat 1: jonnycongo (button) folded before Flop (didn't bet)
Seat 2: eliozica (small blind) folded before Flop
Seat 3: proletariat5 (big blind) folded before Flop
Seat 4: P0tty Mouth showed [Js Qs] and lost with a pair of Jacks
Seat 5: JJin91 showed [Ks Kc] and won (11914) with a pair of Kings
Seat 6: Bullets4Rick folded before Flop (didn't bet)


*********** # 118 **************
PokerStars Hand #169870581698: Tournament #1622537329, $13.50+$1.50 USD=
 Hold'em No Limit - Level XIV (400/800) - 2017/05/14 15:55:03 ET
Table '1622537329 2' 6-max Seat #2 is the button
Seat 1: jonnycongo (59056 in chips)=20
Seat 2: eliozica (36667 in chips)=20
Seat 3: proletariat5 (46801 in chips)=20
Seat 5: JJin91 (38089 in chips)=20
Seat 6: Bullets4Rick (34181 in chips)=20
jonnycongo: posts the ante 100
eliozica: posts the ante 100
proletariat5: posts the ante 100
JJin91: posts the ante 100
Bullets4Rick: posts the ante 100
proletariat5: posts small blind 400
JJin91: posts big blind 800
*** HOLE CARDS ***
Dealt to JJin91 [Th Ac]
Bullets4Rick: calls 800
jonnycongo: folds=20
eliozica: folds=20
proletariat5: folds=20
JJin91: raises 1241 to 2041
Bullets4Rick has timed out
Bullets4Rick: folds=20
Uncalled bet (1241) returned to JJin91
Bullets4Rick is sitting out
JJin91 collected 2500 from pot
JJin91: doesn't show hand=20
*** SUMMARY ***
Total pot 2500 | Rake 0=20
Seat 1: jonnycongo folded before Flop (didn't bet)
Seat 2: eliozica (button) folded before Flop (didn't bet)
Seat 3: proletariat5 (small blind) folded before Flop
Seat 5: JJin91 (big blind) collected (2500)
Seat 6: Bullets4Rick folded before Flop


*********** # 119 **************
PokerStars Hand #169870582623: Tournament #1622537329, $13.50+$1.50 USD=
 Hold'em No Limit - Level XIV (400/800) - 2017/05/14 16:01:00 ET
Table '1622537329 2' 6-max Seat #3 is the button
Seat 1: jonnycongo (58956 in chips)=20
Seat 2: eliozica (36567 in chips)=20
Seat 3: proletariat5 (46301 in chips)=20
Seat 5: JJin91 (39689 in chips)=20
Seat 6: Bullets4Rick (33281 in chips)=20
jonnycongo: posts the ante 100
eliozica: posts the ante 100
proletariat5: posts the ante 100
JJin91: posts the ante 100
Bullets4Rick: posts the ante 100
JJin91: posts small blind 400
Bullets4Rick: posts big blind 800
*** HOLE CARDS ***
Dealt to JJin91 [Ah 4s]
jonnycongo: folds=20
eliozica: folds=20
proletariat5: folds=20
JJin91: raises 800 to 1600
Bullets4Rick: calls 800
*** FLOP *** [Tc 5c Js]
JJin91: checks=20
Bullets4Rick: checks=20
*** TURN *** [Tc 5c Js] [5h]
JJin91: bets 2109
Bullets4Rick: folds=20
Uncalled bet (2109) returned to JJin91
JJin91 collected 3700 from pot
JJin91: doesn't show hand=20
*** SUMMARY ***
Total pot 3700 | Rake 0=20
Board [Tc 5c Js 5h]
Seat 1: jonnycongo folded before Flop (didn't bet)
Seat 2: eliozica folded before Flop (didn't bet)
Seat 3: proletariat5 (button) folded before Flop (didn't bet)
Seat 5: JJin91 (small blind) collected (3700)
Seat 6: Bullets4Rick (big blind) folded on the Turn


*********** # 120 **************
PokerStars Hand #169870582775: Tournament #1622537329, $13.50+$1.50 USD=
 Hold'em No Limit - Level XIV (400/800) - 2017/05/14 16:01:42 ET
Table '1622537329 2' 6-max Seat #5 is the button
Seat 1: jonnycongo (58856 in chips)=20
Seat 2: eliozica (36467 in chips)=20
Seat 3: proletariat5 (46201 in chips)=20
Seat 5: JJin91 (41689 in chips)=20
Seat 6: Bullets4Rick (31581 in chips)=20
jonnycongo: posts the ante 100
eliozica: posts the ante 100
proletariat5: posts the ante 100
JJin91: posts the ante 100
Bullets4Rick: posts the ante 100
Bullets4Rick: posts small blind 400
jonnycongo: posts big blind 800
*** HOLE CARDS ***
Dealt to JJin91 [2d Jc]
eliozica: raises 800 to 1600
proletariat5: calls 1600
JJin91: folds=20
Bullets4Rick: folds=20
jonnycongo: calls 800
*** FLOP *** [Jd 4d 9h]
jonnycongo: checks=20
eliozica: bets 3200
proletariat5: folds=20
jonnycongo: calls 3200
*** TURN *** [Jd 4d 9h] [Qs]
jonnycongo: checks=20
eliozica: bets 12000
jonnycongo: folds=20
Uncalled bet (12000) returned to eliozica
eliozica collected 12100 from pot
eliozica: doesn't show hand=20
*** SUMMARY ***
Total pot 12100 | Rake 0=20
Board [Jd 4d 9h Qs]
Seat 1: jonnycongo (big blind) folded on the Turn
Seat 2: eliozica collected (12100)
Seat 3: proletariat5 folded on the Flop
Seat 5: JJin91 (button) folded before Flop (didn't bet)
Seat 6: Bullets4Rick (small blind) folded before Flop


*********** # 121 **************
PokerStars Hand #169870582932: Tournament #1622537329, $13.50+$1.50 USD=
 Hold'em No Limit - Level XIV (400/800) - 2017/05/14 16:02:26 ET
Table '1622537329 2' 6-max Seat #6 is the button
Seat 1: jonnycongo (53956 in chips)=20
Seat 2: eliozica (43667 in chips)=20
Seat 3: proletariat5 (44501 in chips)=20
Seat 5: JJin91 (41589 in chips)=20
Seat 6: Bullets4Rick (31081 in chips)=20
jonnycongo: posts the ante 100
eliozica: posts the ante 100
proletariat5: posts the ante 100
JJin91: posts the ante 100
Bullets4Rick: posts the ante 100
jonnycongo: posts small blind 400
eliozica: posts big blind 800
*** HOLE CARDS ***
Dealt to JJin91 [Kd 2d]
proletariat5: folds=20
JJin91: folds=20
Bullets4Rick: folds=20
jonnycongo: folds=20
Uncalled bet (400) returned to eliozica
eliozica collected 1300 from pot
eliozica: doesn't show hand=20
*** SUMMARY ***
Total pot 1300 | Rake 0=20
Seat 1: jonnycongo (small blind) folded before Flop
Seat 2: eliozica (big blind) collected (1300)
Seat 3: proletariat5 folded before Flop (didn't bet)
Seat 5: JJin91 folded before Flop (didn't bet)
Seat 6: Bullets4Rick (button) folded before Flop (didn't bet)


*********** # 122 **************
PokerStars Hand #169870583025: Tournament #1622537329, $13.50+$1.50 USD=
 Hold'em No Limit - Level XIV (400/800) - 2017/05/14 16:02:51 ET
Table '1622537329 2' 6-max Seat #1 is the button
Seat 1: jonnycongo (53456 in chips)=20
Seat 2: eliozica (44467 in chips)=20
Seat 3: proletariat5 (44401 in chips)=20
Seat 5: JJin91 (41489 in chips)=20
Seat 6: Bullets4Rick (30981 in chips)=20
jonnycongo: posts the ante 100
eliozica: posts the ante 100
proletariat5: posts the ante 100
JJin91: posts the ante 100
Bullets4Rick: posts the ante 100
eliozica: posts small blind 400
proletariat5: posts big blind 800
*** HOLE CARDS ***
Dealt to JJin91 [9s 5h]
JJin91: folds=20
Bullets4Rick: folds=20
jonnycongo: folds=20
eliozica: calls 400
proletariat5: checks=20
*** FLOP *** [Tc Kc 4d]
eliozica: bets 1600
proletariat5: calls 1600
*** TURN *** [Tc Kc 4d] [Jc]
eliozica: checks=20
proletariat5: bets 2915
eliozica: folds=20
Uncalled bet (2915) returned to proletariat5
proletariat5 collected 5300 from pot
proletariat5: doesn't show hand=20
*** SUMMARY ***
Total pot 5300 | Rake 0=20
Board [Tc Kc 4d Jc]
Seat 1: jonnycongo (button) folded before Flop (didn't bet)
Seat 2: eliozica (small blind) folded on the Turn
Seat 3: proletariat5 (big blind) collected (5300)
Seat 5: JJin91 folded before Flop (didn't bet)
Seat 6: Bullets4Rick folded before Flop (didn't bet)


*********** # 123 **************
PokerStars Hand #169870583145: Tournament #1622537329, $13.50+$1.50 USD=
 Hold'em No Limit - Level XIV (400/800) - 2017/05/14 16:03:25 ET
Table '1622537329 2' 6-max Seat #2 is the button
Seat 1: jonnycongo (53356 in chips)=20
Seat 2: eliozica (41967 in chips)=20
Seat 3: proletariat5 (47201 in chips)=20
Seat 5: JJin91 (41389 in chips)=20
Seat 6: Bullets4Rick (30881 in chips)=20
jonnycongo: posts the ante 100
eliozica: posts the ante 100
proletariat5: posts the ante 100
JJin91: posts the ante 100
Bullets4Rick: posts the ante 100
proletariat5: posts small blind 400
JJin91: posts big blind 800
*** HOLE CARDS ***
Dealt to JJin91 [Ks 6d]
Bullets4Rick: folds=20
jonnycongo: folds=20
eliozica: raises 2500 to 3300
proletariat5: folds=20
JJin91: folds=20
Uncalled bet (2500) returned to eliozica
eliozica collected 2500 from pot
eliozica: doesn't show hand=20
*** SUMMARY ***
Total pot 2500 | Rake 0=20
Seat 1: jonnycongo folded before Flop (didn't bet)
Seat 2: eliozica (button) collected (2500)
Seat 3: proletariat5 (small blind) folded before Flop
Seat 5: JJin91 (big blind) folded before Flop
Seat 6: Bullets4Rick folded before Flop (didn't bet)


*********** # 124 **************
PokerStars Hand #169870583250: Tournament #1622537329, $13.50+$1.50 USD=
 Hold'em No Limit - Level XIV (400/800) - 2017/05/14 16:03:57 ET
Table '1622537329 2' 6-max Seat #3 is the button
Seat 1: jonnycongo (53256 in chips)=20
Seat 2: eliozica (43567 in chips)=20
Seat 3: proletariat5 (46701 in chips)=20
Seat 5: JJin91 (40489 in chips)=20
Seat 6: Bullets4Rick (30781 in chips)=20
jonnycongo: posts the ante 100
eliozica: posts the ante 100
proletariat5: posts the ante 100
JJin91: posts the ante 100
Bullets4Rick: posts the ante 100
JJin91: posts small blind 400
Bullets4Rick: posts big blind 800
*** HOLE CARDS ***
Dealt to JJin91 [8s 7h]
jonnycongo: folds=20
eliozica: folds=20
proletariat5: folds=20
JJin91: calls 400
Bullets4Rick: raises 1600 to 2400
JJin91: folds=20
Uncalled bet (1600) returned to Bullets4Rick
Bullets4Rick collected 2100 from pot
*** SUMMARY ***
Total pot 2100 | Rake 0=20
Seat 1: jonnycongo folded before Flop (didn't bet)
Seat 2: eliozica folded before Flop (didn't bet)
Seat 3: proletariat5 (button) folded before Flop (didn't bet)
Seat 5: JJin91 (small blind) folded before Flop
Seat 6: Bullets4Rick (big blind) collected (2100)


*********** # 125 **************
PokerStars Hand #169870583354: Tournament #1622537329, $13.50+$1.50 USD=
 Hold'em No Limit - Level XIV (400/800) - 2017/05/14 16:04:29 ET
Table '1622537329 2' 6-max Seat #5 is the button
Seat 1: jonnycongo (53156 in chips)=20
Seat 2: eliozica (43467 in chips)=20
Seat 3: proletariat5 (46601 in chips)=20
Seat 5: JJin91 (39589 in chips)=20
Seat 6: Bullets4Rick (31981 in chips)=20
jonnycongo: posts the ante 100
eliozica: posts the ante 100
proletariat5: posts the ante 100
JJin91: posts the ante 100
Bullets4Rick: posts the ante 100
Bullets4Rick: posts small blind 400
jonnycongo: posts big blind 800
*** HOLE CARDS ***
Dealt to JJin91 [5s Kh]
eliozica: calls 800
proletariat5: calls 800
JJin91: folds=20
Bullets4Rick: calls 400
jonnycongo: checks=20
*** FLOP *** [Ts 5d 5c]
Bullets4Rick: checks=20
jonnycongo: checks=20
eliozica: bets 1600
proletariat5: folds=20
Bullets4Rick: folds=20
jonnycongo: folds=20
Uncalled bet (1600) returned to eliozica
eliozica collected 3700 from pot
eliozica: doesn't show hand=20
*** SUMMARY ***
Total pot 3700 | Rake 0=20
Board [Ts 5d 5c]
Seat 1: jonnycongo (big blind) folded on the Flop
Seat 2: eliozica collected (3700)
Seat 3: proletariat5 folded on the Flop
Seat 5: JJin91 (button) folded before Flop (didn't bet)
Seat 6: Bullets4Rick (small blind) folded on the Flop


*********** # 126 **************
PokerStars Hand #169870583480: Tournament #1622537329, $13.50+$1.50 USD=
 Hold'em No Limit - Level XIV (400/800) - 2017/05/14 16:05:08 ET
Table '1622537329 2' 6-max Seat #6 is the button
Seat 1: jonnycongo (52256 in chips)=20
Seat 2: eliozica (46267 in chips)=20
Seat 3: proletariat5 (45701 in chips)=20
Seat 4: IDonateToYou (20681 in chips)=20
Seat 5: JJin91 (39489 in chips)=20
Seat 6: Bullets4Rick (31081 in chips)=20
jonnycongo: posts the ante 100
eliozica: posts the ante 100
proletariat5: posts the ante 100
IDonateToYou: posts the ante 100
JJin91: posts the ante 100
Bullets4Rick: posts the ante 100
jonnycongo: posts small blind 400
eliozica: posts big blind 800
*** HOLE CARDS ***
Dealt to JJin91 [3d 8s]
proletariat5: folds=20
IDonateToYou: folds=20
JJin91: folds=20
Bullets4Rick: folds=20
jonnycongo: raises 2400 to 3200
eliozica: folds=20
Uncalled bet (2400) returned to jonnycongo
jonnycongo collected 2200 from pot
*** SUMMARY ***
Total pot 2200 | Rake 0=20
Seat 1: jonnycongo (small blind) collected (2200)
Seat 2: eliozica (big blind) folded before Flop
Seat 3: proletariat5 folded before Flop (didn't bet)
Seat 4: IDonateToYou folded before Flop (didn't bet)
Seat 5: JJin91 folded before Flop (didn't bet)
Seat 6: Bullets4Rick (button) folded before Flop (didn't bet)


*********** # 127 **************
PokerStars Hand #169870583600: Tournament #1622537329, $13.50+$1.50 USD=
 Hold'em No Limit - Level XIV (400/800) - 2017/05/14 16:05:42 ET
Table '1622537329 2' 6-max Seat #1 is the button
Seat 1: jonnycongo (53556 in chips)=20
Seat 2: eliozica (45367 in chips)=20
Seat 3: proletariat5 (45601 in chips)=20
Seat 4: IDonateToYou (20581 in chips)=20
Seat 5: JJin91 (39389 in chips)=20
Seat 6: Bullets4Rick (30981 in chips)=20
jonnycongo: posts the ante 100
eliozica: posts the ante 100
proletariat5: posts the ante 100
IDonateToYou: posts the ante 100
JJin91: posts the ante 100
Bullets4Rick: posts the ante 100
eliozica: posts small blind 400
proletariat5: posts big blind 800
*** HOLE CARDS ***
Dealt to JJin91 [Qc 2s]
IDonateToYou: folds=20
JJin91: folds=20
Bullets4Rick: calls 800
jonnycongo: folds=20
eliozica: calls 400
proletariat5: checks=20
*** FLOP *** [9h 7d As]
eliozica: checks=20
proletariat5: checks=20
Bullets4Rick: checks=20
*** TURN *** [9h 7d As] [Th]
eliozica: bets 1600
proletariat5: folds=20
Bullets4Rick: calls 1600
*** RIVER *** [9h 7d As Th] [4d]
eliozica: bets 1600
Bullets4Rick: calls 1600
*** SHOW DOWN ***
eliozica: shows [Kd 9s] (a pair of Nines)
Bullets4Rick: shows [Jc Tc] (a pair of Tens)
Bullets4Rick collected 9400 from pot
*** SUMMARY ***
Total pot 9400 | Rake 0=20
Board [9h 7d As Th 4d]
Seat 1: jonnycongo (button) folded before Flop (didn't bet)
Seat 2: eliozica (small blind) showed [Kd 9s] and lost with a pair of N=
ines
Seat 3: proletariat5 (big blind) folded on the Turn
Seat 4: IDonateToYou folded before Flop (didn't bet)
Seat 5: JJin91 folded before Flop (didn't bet)
Seat 6: Bullets4Rick showed [Jc Tc] and won (9400) with a pair of Tens


*********** # 128 **************
PokerStars Hand #169870583827: Tournament #1622537329, $13.50+$1.50 USD=
 Hold'em No Limit - Level XIV (400/800) - 2017/05/14 16:06:43 ET
Table '1622537329 2' 6-max Seat #2 is the button
Seat 1: jonnycongo (53456 in chips)=20
Seat 2: eliozica (41267 in chips)=20
Seat 3: proletariat5 (44701 in chips)=20
Seat 4: IDonateToYou (20481 in chips)=20
Seat 5: JJin91 (39289 in chips)=20
Seat 6: Bullets4Rick (36281 in chips)=20
jonnycongo: posts the ante 100
eliozica: posts the ante 100
proletariat5: posts the ante 100
IDonateToYou: posts the ante 100
JJin91: posts the ante 100
Bullets4Rick: posts the ante 100
proletariat5: posts small blind 400
IDonateToYou: posts big blind 800
*** HOLE CARDS ***
Dealt to JJin91 [Th 5h]
JJin91: folds=20
Bullets4Rick: folds=20
jonnycongo: folds=20
eliozica: raises 1600 to 2400
proletariat5: calls 2000
IDonateToYou: folds=20
*** FLOP *** [9h 7h Ts]
proletariat5: checks=20
eliozica: bets 4000
proletariat5: calls 4000
*** TURN *** [9h 7h Ts] [6c]
proletariat5: checks=20
eliozica: checks=20
*** RIVER *** [9h 7h Ts 6c] [8c]
proletariat5: checks=20
eliozica: checks=20
*** SHOW DOWN ***
proletariat5: shows [Ad 9d] (a straight, Six to Ten)
eliozica: shows [5c Ah] (a straight, Six to Ten)
proletariat5 collected 7100 from pot
eliozica collected 7100 from pot
*** SUMMARY ***
Total pot 14200 | Rake 0=20
Board [9h 7h Ts 6c 8c]
Seat 1: jonnycongo folded before Flop (didn't bet)
Seat 2: eliozica (button) showed [5c Ah] and won (7100) with a straight=
, Six to Ten
Seat 3: proletariat5 (small blind) showed [Ad 9d] and won (7100) with a=
 straight, Six to Ten
Seat 4: IDonateToYou (big blind) folded before Flop
Seat 5: JJin91 folded before Flop (didn't bet)
Seat 6: Bullets4Rick folded before Flop (didn't bet)


*********** # 129 **************
PokerStars Hand #169870583962: Tournament #1622537329, $13.50+$1.50 USD=
 Hold'em No Limit - Level XIV (400/800) - 2017/05/14 16:07:18 ET
Table '1622537329 2' 6-max Seat #3 is the button
Seat 1: jonnycongo (53356 in chips)=20
Seat 2: eliozica (41867 in chips)=20
Seat 3: proletariat5 (45301 in chips)=20
Seat 4: IDonateToYou (19581 in chips)=20
Seat 5: JJin91 (39189 in chips)=20
Seat 6: Bullets4Rick (36181 in chips)=20
jonnycongo: posts the ante 100
eliozica: posts the ante 100
proletariat5: posts the ante 100
IDonateToYou: posts the ante 100
JJin91: posts the ante 100
Bullets4Rick: posts the ante 100
IDonateToYou: posts small blind 400
JJin91: posts big blind 800
*** HOLE CARDS ***
Dealt to JJin91 [3s 4d]
Bullets4Rick: folds=20
jonnycongo: raises 1600 to 2400
eliozica: folds=20
proletariat5: folds=20
IDonateToYou: folds=20
JJin91: folds=20
Uncalled bet (1600) returned to jonnycongo
jonnycongo collected 2600 from pot
jonnycongo: shows [Kc Ac] (high card Ace)
*** SUMMARY ***
Total pot 2600 | Rake 0=20
Seat 1: jonnycongo collected (2600)
Seat 2: eliozica folded before Flop (didn't bet)
Seat 3: proletariat5 (button) folded before Flop (didn't bet)
Seat 4: IDonateToYou (small blind) folded before Flop
Seat 5: JJin91 (big blind) folded before Flop
Seat 6: Bullets4Rick folded before Flop (didn't bet)


*********** # 130 **************
PokerStars Hand #169870584057: Tournament #1622537329, $13.50+$1.50 USD=
 Hold'em No Limit - Level XV (500/1000) - 2017/05/14 16:07:47 ET
Table '1622537329 2' 6-max Seat #4 is the button
Seat 1: jonnycongo (55056 in chips)=20
Seat 2: eliozica (41767 in chips)=20
Seat 3: proletariat5 (45201 in chips)=20
Seat 4: IDonateToYou (19081 in chips)=20
Seat 5: JJin91 (38289 in chips)=20
Seat 6: Bullets4Rick (36081 in chips)=20
jonnycongo: posts the ante 125
eliozica: posts the ante 125
proletariat5: posts the ante 125
IDonateToYou: posts the ante 125
JJin91: posts the ante 125
Bullets4Rick: posts the ante 125
JJin91: posts small blind 500
Bullets4Rick: posts big blind 1000
*** HOLE CARDS ***
Dealt to JJin91 [9c 6c]
jonnycongo: folds=20
eliozica: folds=20
proletariat5: folds=20
IDonateToYou: raises 1500 to 2500
JJin91: folds=20
Bullets4Rick: folds=20
Uncalled bet (1500) returned to IDonateToYou
IDonateToYou collected 3250 from pot
*** SUMMARY ***
Total pot 3250 | Rake 0=20
Seat 1: jonnycongo folded before Flop (didn't bet)
Seat 2: eliozica folded before Flop (didn't bet)
Seat 3: proletariat5 folded before Flop (didn't bet)
Seat 4: IDonateToYou (button) collected (3250)
Seat 5: JJin91 (small blind) folded before Flop
Seat 6: Bullets4Rick (big blind) folded before Flop


*********** # 131 **************
PokerStars Hand #169870584112: Tournament #1622537329, $13.50+$1.50 USD=
 Hold'em No Limit - Level XV (500/1000) - 2017/05/14 16:08:07 ET
Table '1622537329 2' 6-max Seat #5 is the button
Seat 1: jonnycongo (54931 in chips)=20
Seat 2: eliozica (41642 in chips)=20
Seat 3: proletariat5 (45076 in chips)=20
Seat 4: IDonateToYou (21206 in chips)=20
Seat 5: JJin91 (37664 in chips)=20
Seat 6: Bullets4Rick (34956 in chips)=20
jonnycongo: posts the ante 125
eliozica: posts the ante 125
proletariat5: posts the ante 125
IDonateToYou: posts the ante 125
JJin91: posts the ante 125
Bullets4Rick: posts the ante 125
Bullets4Rick: posts small blind 500
jonnycongo: posts big blind 1000
*** HOLE CARDS ***
Dealt to JJin91 [8d 7d]
eliozica: raises 3250 to 4250
proletariat5: folds=20
IDonateToYou: calls 4250
JJin91: folds=20
Bullets4Rick: folds=20
jonnycongo: folds=20
*** FLOP *** [9s Qc 2c]
eliozica: bets 11000
IDonateToYou: raises 5831 to 16831 and is all-in
eliozica: calls 5831
*** TURN *** [9s Qc 2c] [4c]
*** RIVER *** [9s Qc 2c 4c] [3h]
*** SHOW DOWN ***
eliozica: shows [Jh Jd] (a pair of Jacks)
IDonateToYou: shows [Qd Ah] (a pair of Queens)
IDonateToYou collected 44412 from pot
*** SUMMARY ***
Total pot 44412 | Rake 0=20
Board [9s Qc 2c 4c 3h]
Seat 1: jonnycongo (big blind) folded before Flop
Seat 2: eliozica showed [Jh Jd] and lost with a pair of Jacks
Seat 3: proletariat5 folded before Flop (didn't bet)
Seat 4: IDonateToYou showed [Qd Ah] and won (44412) with a pair of Quee=
ns
Seat 5: JJin91 (button) folded before Flop (didn't bet)
Seat 6: Bullets4Rick (small blind) folded before Flop


*********** # 132 **************
PokerStars Hand #169870584250: Tournament #1622537329, $13.50+$1.50 USD=
 Hold'em No Limit - Level XV (500/1000) - 2017/05/14 16:08:50 ET
Table '1622537329 2' 6-max Seat #6 is the button
Seat 1: jonnycongo (53806 in chips)=20
Seat 2: eliozica (20436 in chips)=20
Seat 3: proletariat5 (44951 in chips)=20
Seat 4: IDonateToYou (44412 in chips)=20
Seat 5: JJin91 (37539 in chips)=20
Seat 6: Bullets4Rick (34331 in chips)=20
jonnycongo: posts the ante 125
eliozica: posts the ante 125
proletariat5: posts the ante 125
IDonateToYou: posts the ante 125
JJin91: posts the ante 125
Bullets4Rick: posts the ante 125
jonnycongo: posts small blind 500
eliozica: posts big blind 1000
*** HOLE CARDS ***
Dealt to JJin91 [2c 4d]
proletariat5: folds=20
IDonateToYou: folds=20
JJin91: folds=20
Bullets4Rick: folds=20
jonnycongo: calls 500
eliozica: raises 19311 to 20311 and is all-in
jonnycongo: folds=20
Uncalled bet (19311) returned to eliozica
eliozica collected 2750 from pot
eliozica: doesn't show hand=20
*** SUMMARY ***
Total pot 2750 | Rake 0=20
Seat 1: jonnycongo (small blind) folded before Flop
Seat 2: eliozica (big blind) collected (2750)
Seat 3: proletariat5 folded before Flop (didn't bet)
Seat 4: IDonateToYou folded before Flop (didn't bet)
Seat 5: JJin91 folded before Flop (didn't bet)
Seat 6: Bullets4Rick (button) folded before Flop (didn't bet)


*********** # 133 **************
PokerStars Hand #169870584347: Tournament #1622537329, $13.50+$1.50 USD=
 Hold'em No Limit - Level XV (500/1000) - 2017/05/14 16:09:17 ET
Table '1622537329 2' 6-max Seat #1 is the button
Seat 1: jonnycongo (52681 in chips)=20
Seat 2: eliozica (22061 in chips)=20
Seat 3: proletariat5 (44826 in chips)=20
Seat 4: IDonateToYou (44287 in chips)=20
Seat 5: JJin91 (37414 in chips)=20
Seat 6: Bullets4Rick (34206 in chips)=20
jonnycongo: posts the ante 125
eliozica: posts the ante 125
proletariat5: posts the ante 125
IDonateToYou: posts the ante 125
JJin91: posts the ante 125
Bullets4Rick: posts the ante 125
eliozica: posts small blind 500
proletariat5: posts big blind 1000
*** HOLE CARDS ***
Dealt to JJin91 [5h 8h]
IDonateToYou: folds=20
JJin91: folds=20
Bullets4Rick: calls 1000
jonnycongo: folds=20
eliozica: calls 500
proletariat5: checks=20
*** FLOP *** [2h 2s 4h]
eliozica: bets 4000
proletariat5: folds=20
Bullets4Rick: folds=20
Uncalled bet (4000) returned to eliozica
eliozica collected 3750 from pot
eliozica: doesn't show hand=20
*** SUMMARY ***
Total pot 3750 | Rake 0=20
Board [2h 2s 4h]
Seat 1: jonnycongo (button) folded before Flop (didn't bet)
Seat 2: eliozica (small blind) collected (3750)
Seat 3: proletariat5 (big blind) folded on the Flop
Seat 4: IDonateToYou folded before Flop (didn't bet)
Seat 5: JJin91 folded before Flop (didn't bet)
Seat 6: Bullets4Rick folded on the Flop


*********** # 134 **************
PokerStars Hand #169870584468: Tournament #1622537329, $13.50+$1.50 USD=
 Hold'em No Limit - Level XV (500/1000) - 2017/05/14 16:09:50 ET
Table '1622537329 2' 6-max Seat #2 is the button
Seat 1: jonnycongo (52556 in chips)=20
Seat 2: eliozica (24686 in chips)=20
Seat 3: proletariat5 (43701 in chips)=20
Seat 4: IDonateToYou (44162 in chips)=20
Seat 5: JJin91 (37289 in chips)=20
Seat 6: Bullets4Rick (33081 in chips)=20
jonnycongo: posts the ante 125
eliozica: posts the ante 125
proletariat5: posts the ante 125
IDonateToYou: posts the ante 125
JJin91: posts the ante 125
Bullets4Rick: posts the ante 125
proletariat5: posts small blind 500
IDonateToYou: posts big blind 1000
*** HOLE CARDS ***
Dealt to JJin91 [Ah 3h]
JJin91: raises 1190 to 2190
Bullets4Rick: folds=20
jonnycongo: folds=20
eliozica: folds=20
proletariat5: folds=20
IDonateToYou: folds=20
Uncalled bet (1190) returned to JJin91
JJin91 collected 3250 from pot
JJin91: doesn't show hand=20
*** SUMMARY ***
Total pot 3250 | Rake 0=20
Seat 1: jonnycongo folded before Flop (didn't bet)
Seat 2: eliozica (button) folded before Flop (didn't bet)
Seat 3: proletariat5 (small blind) folded before Flop
Seat 4: IDonateToYou (big blind) folded before Flop
Seat 5: JJin91 collected (3250)
Seat 6: Bullets4Rick folded before Flop (didn't bet)


*********** # 135 **************
PokerStars Hand #169870584544: Tournament #1622537329, $13.50+$1.50 USD=
 Hold'em No Limit - Level XV (500/1000) - 2017/05/14 16:10:12 ET
Table '1622537329 2' 6-max Seat #3 is the button
Seat 1: jonnycongo (52431 in chips)=20
Seat 2: eliozica (24561 in chips)=20
Seat 3: proletariat5 (43076 in chips)=20
Seat 4: IDonateToYou (43037 in chips)=20
Seat 5: JJin91 (39414 in chips)=20
Seat 6: Bullets4Rick (32956 in chips)=20
jonnycongo: posts the ante 125
eliozica: posts the ante 125
proletariat5: posts the ante 125
IDonateToYou: posts the ante 125
JJin91: posts the ante 125
Bullets4Rick: posts the ante 125
IDonateToYou: posts small blind 500
JJin91: posts big blind 1000
*** HOLE CARDS ***
Dealt to JJin91 [2h 7h]
Bullets4Rick: folds=20
jonnycongo: folds=20
eliozica: raises 2000 to 3000
proletariat5: folds=20
IDonateToYou: folds=20
JJin91: folds=20
Uncalled bet (2000) returned to eliozica
eliozica collected 3250 from pot
eliozica: doesn't show hand=20
*** SUMMARY ***
Total pot 3250 | Rake 0=20
Seat 1: jonnycongo folded before Flop (didn't bet)
Seat 2: eliozica collected (3250)
Seat 3: proletariat5 (button) folded before Flop (didn't bet)
Seat 4: IDonateToYou (small blind) folded before Flop
Seat 5: JJin91 (big blind) folded before Flop
Seat 6: Bullets4Rick folded before Flop (didn't bet)


*********** # 136 **************
PokerStars Hand #169870584631: Tournament #1622537329, $13.50+$1.50 USD=
 Hold'em No Limit - Level XV (500/1000) - 2017/05/14 16:10:40 ET
Table '1622537329 2' 6-max Seat #4 is the button
Seat 1: jonnycongo (52306 in chips)=20
Seat 2: eliozica (26686 in chips)=20
Seat 3: proletariat5 (42951 in chips)=20
Seat 4: IDonateToYou (42412 in chips)=20
Seat 5: JJin91 (38289 in chips)=20
Seat 6: Bullets4Rick (32831 in chips)=20
jonnycongo: posts the ante 125
eliozica: posts the ante 125
proletariat5: posts the ante 125
IDonateToYou: posts the ante 125
JJin91: posts the ante 125
Bullets4Rick: posts the ante 125
JJin91: posts small blind 500
Bullets4Rick: posts big blind 1000
*** HOLE CARDS ***
Dealt to JJin91 [Jd As]
jonnycongo: folds=20
eliozica: folds=20
proletariat5: folds=20
IDonateToYou: folds=20
JJin91: raises 1000 to 2000
Bullets4Rick: calls 1000
*** FLOP *** [5h 3h 8d]
JJin91: checks=20
Bullets4Rick: checks=20
*** TURN *** [5h 3h 8d] [7s]
JJin91: checks=20
Bullets4Rick: checks=20
*** RIVER *** [5h 3h 8d 7s] [Kd]
JJin91: checks=20
Bullets4Rick: bets 1000
JJin91: calls 1000
*** SHOW DOWN ***
Bullets4Rick: shows [Jh Ks] (a pair of Kings)
JJin91: mucks hand=20
Bullets4Rick collected 6750 from pot
*** SUMMARY ***
Total pot 6750 | Rake 0=20
Board [5h 3h 8d 7s Kd]
Seat 1: jonnycongo folded before Flop (didn't bet)
Seat 2: eliozica folded before Flop (didn't bet)
Seat 3: proletariat5 folded before Flop (didn't bet)
Seat 4: IDonateToYou (button) folded before Flop (didn't bet)
Seat 5: JJin91 (small blind) mucked [Jd As]
Seat 6: Bullets4Rick (big blind) showed [Jh Ks] and won (6750) with a p=
air of Kings


*********** # 137 **************
PokerStars Hand #169870584789: Tournament #1622537329, $13.50+$1.50 USD=
 Hold'em No Limit - Level XV (500/1000) - 2017/05/14 16:11:23 ET
Table '1622537329 2' 6-max Seat #5 is the button
Seat 1: jonnycongo (52181 in chips)=20
Seat 2: eliozica (26561 in chips)=20
Seat 3: proletariat5 (42826 in chips)=20
Seat 4: IDonateToYou (42287 in chips)=20
Seat 5: JJin91 (35164 in chips)=20
Seat 6: Bullets4Rick (36456 in chips)=20
jonnycongo: posts the ante 125
eliozica: posts the ante 125
proletariat5: posts the ante 125
IDonateToYou: posts the ante 125
JJin91: posts the ante 125
Bullets4Rick: posts the ante 125
Bullets4Rick: posts small blind 500
jonnycongo: posts big blind 1000
*** HOLE CARDS ***
Dealt to JJin91 [5s 2h]
eliozica: folds=20
proletariat5: folds=20
IDonateToYou: folds=20
JJin91: folds=20
Bullets4Rick: calls 500
jonnycongo: checks=20
*** FLOP *** [6s 5d 7h]
Bullets4Rick: bets 1000
jonnycongo: calls 1000
*** TURN *** [6s 5d 7h] [Ad]
Bullets4Rick: bets 1000
jonnycongo: calls 1000
*** RIVER *** [6s 5d 7h Ad] [7c]
Bullets4Rick: checks=20
jonnycongo: bets 1000
Bullets4Rick: folds=20
Uncalled bet (1000) returned to jonnycongo
jonnycongo collected 6750 from pot
*** SUMMARY ***
Total pot 6750 | Rake 0=20
Board [6s 5d 7h Ad 7c]
Seat 1: jonnycongo (big blind) collected (6750)
Seat 2: eliozica folded before Flop (didn't bet)
Seat 3: proletariat5 folded before Flop (didn't bet)
Seat 4: IDonateToYou folded before Flop (didn't bet)
Seat 5: JJin91 (button) folded before Flop (didn't bet)
Seat 6: Bullets4Rick (small blind) folded on the River


*********** # 138 **************
PokerStars Hand #169870584928: Tournament #1622537329, $13.50+$1.50 USD=
 Hold'em No Limit - Level XV (500/1000) - 2017/05/14 16:12:09 ET
Table '1622537329 2' 6-max Seat #6 is the button
Seat 1: jonnycongo (55806 in chips)=20
Seat 2: eliozica (26436 in chips)=20
Seat 3: proletariat5 (42701 in chips)=20
Seat 4: IDonateToYou (42162 in chips)=20
Seat 5: JJin91 (35039 in chips)=20
Seat 6: Bullets4Rick (33331 in chips)=20
jonnycongo: posts the ante 125
eliozica: posts the ante 125
proletariat5: posts the ante 125
IDonateToYou: posts the ante 125
JJin91: posts the ante 125
Bullets4Rick: posts the ante 125
jonnycongo: posts small blind 500
eliozica: posts big blind 1000
*** HOLE CARDS ***
Dealt to JJin91 [Ts Qc]
proletariat5: folds=20
IDonateToYou: folds=20
JJin91: folds=20
Bullets4Rick: calls 1000
jonnycongo: calls 500
eliozica: raises 25311 to 26311 and is all-in
Bullets4Rick: folds=20
jonnycongo: folds=20
Uncalled bet (25311) returned to eliozica
eliozica collected 3750 from pot
eliozica: doesn't show hand=20
*** SUMMARY ***
Total pot 3750 | Rake 0=20
Seat 1: jonnycongo (small blind) folded before Flop
Seat 2: eliozica (big blind) collected (3750)
Seat 3: proletariat5 folded before Flop (didn't bet)
Seat 4: IDonateToYou folded before Flop (didn't bet)
Seat 5: JJin91 folded before Flop (didn't bet)
Seat 6: Bullets4Rick (button) folded before Flop


*********** # 139 **************
PokerStars Hand #169870585094: Tournament #1622537329, $13.50+$1.50 USD=
 Hold'em No Limit - Level XV (500/1000) - 2017/05/14 16:12:58 ET
Table '1622537329 2' 6-max Seat #1 is the button
Seat 1: jonnycongo (54681 in chips)=20
Seat 2: eliozica (29061 in chips)=20
Seat 3: proletariat5 (42576 in chips)=20
Seat 4: IDonateToYou (42037 in chips)=20
Seat 5: JJin91 (34914 in chips)=20
Seat 6: Bullets4Rick (32206 in chips)=20
jonnycongo: posts the ante 125
eliozica: posts the ante 125
proletariat5: posts the ante 125
IDonateToYou: posts the ante 125
JJin91: posts the ante 125
Bullets4Rick: posts the ante 125
eliozica: posts small blind 500
proletariat5: posts big blind 1000
*** HOLE CARDS ***
Dealt to JJin91 [3h Qh]
IDonateToYou: folds=20
JJin91: folds=20
Bullets4Rick: folds=20
jonnycongo: folds=20
eliozica: calls 500
proletariat5: raises 2110 to 3110
eliozica: folds=20
Uncalled bet (2110) returned to proletariat5
proletariat5 collected 2750 from pot
proletariat5: doesn't show hand=20
*** SUMMARY ***
Total pot 2750 | Rake 0=20
Seat 1: jonnycongo (button) folded before Flop (didn't bet)
Seat 2: eliozica (small blind) folded before Flop
Seat 3: proletariat5 (big blind) collected (2750)
Seat 4: IDonateToYou folded before Flop (didn't bet)
Seat 5: JJin91 folded before Flop (didn't bet)
Seat 6: Bullets4Rick folded before Flop (didn't bet)


*********** # 140 **************
PokerStars Hand #169870585178: Tournament #1622537329, $13.50+$1.50 USD=
 Hold'em No Limit - Level XV (500/1000) - 2017/05/14 16:13:23 ET
Table '1622537329 2' 6-max Seat #2 is the button
Seat 1: jonnycongo (54556 in chips)=20
Seat 2: eliozica (27936 in chips)=20
Seat 3: proletariat5 (44201 in chips)=20
Seat 4: IDonateToYou (41912 in chips)=20
Seat 5: JJin91 (34789 in chips)=20
Seat 6: Bullets4Rick (32081 in chips)=20
jonnycongo: posts the ante 125
eliozica: posts the ante 125
proletariat5: posts the ante 125
IDonateToYou: posts the ante 125
JJin91: posts the ante 125
Bullets4Rick: posts the ante 125
proletariat5: posts small blind 500
IDonateToYou: posts big blind 1000
*** HOLE CARDS ***
Dealt to JJin91 [Qh Ac]
JJin91: raises 1190 to 2190
Bullets4Rick: folds=20
jonnycongo: folds=20
eliozica: folds=20
proletariat5: folds=20
IDonateToYou: folds=20
Uncalled bet (1190) returned to JJin91
JJin91 collected 3250 from pot
JJin91: doesn't show hand=20
*** SUMMARY ***
Total pot 3250 | Rake 0=20
Seat 1: jonnycongo folded before Flop (didn't bet)
Seat 2: eliozica (button) folded before Flop (didn't bet)
Seat 3: proletariat5 (small blind) folded before Flop
Seat 4: IDonateToYou (big blind) folded before Flop
Seat 5: JJin91 collected (3250)
Seat 6: Bullets4Rick folded before Flop (didn't bet)


*********** # 141 **************
PokerStars Hand #169870585215: Tournament #1622537329, $13.50+$1.50 USD=
 Hold'em No Limit - Level XV (500/1000) - 2017/05/14 16:13:38 ET
Table '1622537329 2' 6-max Seat #3 is the button
Seat 1: jonnycongo (54431 in chips)=20
Seat 2: eliozica (27811 in chips)=20
Seat 3: proletariat5 (43576 in chips)=20
Seat 4: IDonateToYou (40787 in chips)=20
Seat 5: JJin91 (36914 in chips)=20
Seat 6: Bullets4Rick (31956 in chips)=20
jonnycongo: posts the ante 125
eliozica: posts the ante 125
proletariat5: posts the ante 125
IDonateToYou: posts the ante 125
JJin91: posts the ante 125
Bullets4Rick: posts the ante 125
IDonateToYou: posts small blind 500
JJin91: posts big blind 1000
*** HOLE CARDS ***
Dealt to JJin91 [3d Kh]
Bullets4Rick: calls 1000
jonnycongo: folds=20
eliozica: calls 1000
proletariat5: folds=20
IDonateToYou: calls 500
JJin91: checks=20
*** FLOP *** [2h 7d 9h]
IDonateToYou: checks=20
JJin91: checks=20
Bullets4Rick: checks=20
eliozica: bets 5000
IDonateToYou: folds=20
JJin91: folds=20
Bullets4Rick: folds=20
Uncalled bet (5000) returned to eliozica
eliozica collected 4750 from pot
eliozica: doesn't show hand=20
*** SUMMARY ***
Total pot 4750 | Rake 0=20
Board [2h 7d 9h]
Seat 1: jonnycongo folded before Flop (didn't bet)
Seat 2: eliozica collected (4750)
Seat 3: proletariat5 (button) folded before Flop (didn't bet)
Seat 4: IDonateToYou (small blind) folded on the Flop
Seat 5: JJin91 (big blind) folded on the Flop
Seat 6: Bullets4Rick folded on the Flop


*********** # 142 **************
PokerStars Hand #169870585359: Tournament #1622537329, $13.50+$1.50 USD=
 Hold'em No Limit - Level XV (500/1000) - 2017/05/14 16:14:20 ET
Table '1622537329 2' 6-max Seat #4 is the button
Seat 1: jonnycongo (54306 in chips)=20
Seat 2: eliozica (31436 in chips)=20
Seat 3: proletariat5 (43451 in chips)=20
Seat 4: IDonateToYou (39662 in chips)=20
Seat 5: JJin91 (35789 in chips)=20
Seat 6: Bullets4Rick (30831 in chips)=20
jonnycongo: posts the ante 125
eliozica: posts the ante 125
proletariat5: posts the ante 125
IDonateToYou: posts the ante 125
JJin91: posts the ante 125
Bullets4Rick: posts the ante 125
JJin91: posts small blind 500
Bullets4Rick: posts big blind 1000
*** HOLE CARDS ***
Dealt to JJin91 [Qs 2d]
jonnycongo: folds=20
eliozica: folds=20
proletariat5: raises 1230 to 2230
IDonateToYou: folds=20
JJin91: folds=20
Bullets4Rick: calls 1230
*** FLOP *** [3c Jd Th]
Bullets4Rick: checks=20
proletariat5: bets 1827
Bullets4Rick: calls 1827
*** TURN *** [3c Jd Th] [Kh]
Bullets4Rick: checks=20
proletariat5: checks=20
*** RIVER *** [3c Jd Th Kh] [Ts]
Bullets4Rick: bets 3000
proletariat5: folds=20
Uncalled bet (3000) returned to Bullets4Rick
Bullets4Rick collected 9364 from pot
*** SUMMARY ***
Total pot 9364 | Rake 0=20
Board [3c Jd Th Kh Ts]
Seat 1: jonnycongo folded before Flop (didn't bet)
Seat 2: eliozica folded before Flop (didn't bet)
Seat 3: proletariat5 folded on the River
Seat 4: IDonateToYou (button) folded before Flop (didn't bet)
Seat 5: JJin91 (small blind) folded before Flop
Seat 6: Bullets4Rick (big blind) collected (9364)


*********** # 143 **************
PokerStars Hand #169870585575: Tournament #1622537329, $13.50+$1.50 USD=
 Hold'em No Limit - Level XV (500/1000) - 2017/05/14 16:15:21 ET
Table '1622537329 2' 6-max Seat #5 is the button
Seat 1: jonnycongo (54181 in chips)=20
Seat 2: eliozica (31311 in chips)=20
Seat 3: proletariat5 (39269 in chips)=20
Seat 5: JJin91 (35164 in chips)=20
Seat 6: Bullets4Rick (36013 in chips)=20
jonnycongo: posts the ante 125
eliozica: posts the ante 125
proletariat5: posts the ante 125
JJin91: posts the ante 125
Bullets4Rick: posts the ante 125
Bullets4Rick: posts small blind 500
jonnycongo: posts big blind 1000
*** HOLE CARDS ***
Dealt to JJin91 [Kc Jd]
eliozica: folds=20
proletariat5: folds=20
JJin91: raises 1190 to 2190
Bullets4Rick: folds=20
jonnycongo: folds=20
Uncalled bet (1190) returned to JJin91
JJin91 collected 3125 from pot
JJin91: doesn't show hand=20
*** SUMMARY ***
Total pot 3125 | Rake 0=20
Seat 1: jonnycongo (big blind) folded before Flop
Seat 2: eliozica folded before Flop (didn't bet)
Seat 3: proletariat5 folded before Flop (didn't bet)
Seat 5: JJin91 (button) collected (3125)
Seat 6: Bullets4Rick (small blind) folded before Flop


*********** # 144 **************
PokerStars Hand #169870585659: Tournament #1622537329, $13.50+$1.50 USD=
 Hold'em No Limit - Level XV (500/1000) - 2017/05/14 16:15:44 ET
Table '1622537329 2' 6-max Seat #6 is the button
Seat 1: jonnycongo (53056 in chips)=20
Seat 2: eliozica (31186 in chips)=20
Seat 3: proletariat5 (39144 in chips)=20
Seat 5: JJin91 (37164 in chips)=20
Seat 6: Bullets4Rick (35388 in chips)=20
jonnycongo: posts the ante 125
eliozica: posts the ante 125
proletariat5: posts the ante 125
JJin91: posts the ante 125
Bullets4Rick: posts the ante 125
jonnycongo: posts small blind 500
eliozica: posts big blind 1000
*** HOLE CARDS ***
Dealt to JJin91 [8h 2c]
proletariat5: folds=20
JJin91: folds=20
Bullets4Rick: calls 1000
jonnycongo: calls 500
eliozica: checks=20
*** FLOP *** [3h 6c Kh]
jonnycongo: checks=20
eliozica: checks=20
Bullets4Rick: checks=20
*** TURN *** [3h 6c Kh] [Ad]
jonnycongo: bets 1000
eliozica: folds=20
Bullets4Rick: folds=20
Uncalled bet (1000) returned to jonnycongo
jonnycongo collected 3625 from pot
*** SUMMARY ***
Total pot 3625 | Rake 0=20
Board [3h 6c Kh Ad]
Seat 1: jonnycongo (small blind) collected (3625)
Seat 2: eliozica (big blind) folded on the Turn
Seat 3: proletariat5 folded before Flop (didn't bet)
Seat 5: JJin91 folded before Flop (didn't bet)
Seat 6: Bullets4Rick (button) folded on the Turn


*********** # 145 **************
PokerStars Hand #169870585790: Tournament #1622537329, $13.50+$1.50 USD=
 Hold'em No Limit - Level XV (500/1000) - 2017/05/14 16:16:25 ET
Table '1622537329 2' 6-max Seat #1 is the button
Seat 1: jonnycongo (55556 in chips)=20
Seat 2: eliozica (30061 in chips)=20
Seat 3: proletariat5 (39019 in chips)=20
Seat 5: JJin91 (37039 in chips)=20
Seat 6: Bullets4Rick (34263 in chips)=20
jonnycongo: posts the ante 125
eliozica: posts the ante 125
proletariat5: posts the ante 125
JJin91: posts the ante 125
Bullets4Rick: posts the ante 125
eliozica: posts small blind 500
proletariat5: posts big blind 1000
*** HOLE CARDS ***
Dealt to JJin91 [5d Kd]
JJin91: folds=20
Bullets4Rick: calls 1000
jonnycongo: raises 2000 to 3000
eliozica: folds=20
proletariat5: folds=20
Bullets4Rick: calls 2000
*** FLOP *** [Qs 4c Qd]
Bullets4Rick: checks=20
jonnycongo: checks=20
*** TURN *** [Qs 4c Qd] [6d]
Bullets4Rick: checks=20
jonnycongo: bets 3000
Bullets4Rick: calls 3000
*** RIVER *** [Qs 4c Qd 6d] [Kh]
Bullets4Rick: checks=20
jonnycongo: checks=20
*** SHOW DOWN ***
Bullets4Rick: shows [Ad 3h] (a pair of Queens)
jonnycongo: shows [Jh Js] (two pair, Queens and Jacks)
jonnycongo collected 14125 from pot
*** SUMMARY ***
Total pot 14125 | Rake 0=20
Board [Qs 4c Qd 6d Kh]
Seat 1: jonnycongo (button) showed [Jh Js] and won (14125) with two pai=
r, Queens and Jacks
Seat 2: eliozica (small blind) folded before Flop
Seat 3: proletariat5 (big blind) folded before Flop
Seat 5: JJin91 folded before Flop (didn't bet)
Seat 6: Bullets4Rick showed [Ad 3h] and lost with a pair of Queens


*********** # 146 **************
PokerStars Hand #169870585965: Tournament #1622537329, $13.50+$1.50 USD=
 Hold'em No Limit - Level XV (500/1000) - 2017/05/14 16:17:16 ET
Table '1622537329 2' 6-max Seat #2 is the button
Seat 1: jonnycongo (63556 in chips)=20
Seat 2: eliozica (29436 in chips)=20
Seat 3: proletariat5 (37894 in chips)=20
Seat 5: JJin91 (36914 in chips)=20
Seat 6: Bullets4Rick (28138 in chips)=20
jonnycongo: posts the ante 125
eliozica: posts the ante 125
proletariat5: posts the ante 125
JJin91: posts the ante 125
Bullets4Rick: posts the ante 125
proletariat5: posts small blind 500
JJin91: posts big blind 1000
*** HOLE CARDS ***
Dealt to JJin91 [6c Kc]
Bullets4Rick: calls 1000
jonnycongo: folds=20
eliozica: folds=20
proletariat5: folds=20
JJin91: checks=20
*** FLOP *** [6d 2h Qd]
JJin91: bets 1781
Bullets4Rick: folds=20
Uncalled bet (1781) returned to JJin91
JJin91 collected 3125 from pot
JJin91: doesn't show hand=20
*** SUMMARY ***
Total pot 3125 | Rake 0=20
Board [6d 2h Qd]
Seat 1: jonnycongo folded before Flop (didn't bet)
Seat 2: eliozica (button) folded before Flop (didn't bet)
Seat 3: proletariat5 (small blind) folded before Flop
Seat 5: JJin91 (big blind) collected (3125)
Seat 6: Bullets4Rick folded on the Flop


*********** # 147 **************
PokerStars Hand #169870586099: Tournament #1622537329, $13.50+$1.50 USD=
 Hold'em No Limit - Level XVI (600/1200) - 2017/05/14 16:17:50 ET
Table '1622537329 2' 6-max Seat #3 is the button
Seat 1: jonnycongo (63431 in chips)=20
Seat 2: eliozica (29311 in chips)=20
Seat 3: proletariat5 (37269 in chips)=20
Seat 5: JJin91 (38914 in chips)=20
Seat 6: Bullets4Rick (27013 in chips)=20
jonnycongo: posts the ante 150
eliozica: posts the ante 150
proletariat5: posts the ante 150
JJin91: posts the ante 150
Bullets4Rick: posts the ante 150
JJin91: posts small blind 600
Bullets4Rick: posts big blind 1200
*** HOLE CARDS ***
Dealt to JJin91 [2h Kc]
jonnycongo: folds=20
eliozica: folds=20
proletariat5: raises 1476 to 2676
JJin91: folds=20
Bullets4Rick: raises 24187 to 26863 and is all-in
proletariat5: folds=20
Uncalled bet (24187) returned to Bullets4Rick
Bullets4Rick collected 6702 from pot
*** SUMMARY ***
Total pot 6702 | Rake 0=20
Seat 1: jonnycongo folded before Flop (didn't bet)
Seat 2: eliozica folded before Flop (didn't bet)
Seat 3: proletariat5 (button) folded before Flop
Seat 5: JJin91 (small blind) folded before Flop
Seat 6: Bullets4Rick (big blind) collected (6702)


*********** # 148 **************
PokerStars Hand #169870586204: Tournament #1622537329, $13.50+$1.50 USD=
 Hold'em No Limit - Level XVI (600/1200) - 2017/05/14 16:18:15 ET
Table '1622537329 2' 6-max Seat #5 is the button
Seat 1: jonnycongo (63281 in chips)=20
Seat 2: eliozica (29161 in chips)=20
Seat 3: proletariat5 (34443 in chips)=20
Seat 5: JJin91 (38164 in chips)=20
Seat 6: Bullets4Rick (30889 in chips)=20
jonnycongo: posts the ante 150
eliozica: posts the ante 150
proletariat5: posts the ante 150
JJin91: posts the ante 150
Bullets4Rick: posts the ante 150
Bullets4Rick: posts small blind 600
jonnycongo: posts big blind 1200
*** HOLE CARDS ***
Dealt to JJin91 [7h 5d]
eliozica: raises 3750 to 4950
proletariat5: folds=20
JJin91: folds=20
Bullets4Rick: folds=20
jonnycongo: calls 3750
*** FLOP *** [Ts 8s 5s]
jonnycongo: checks=20
eliozica: bets 10800
jonnycongo: raises 32850 to 43650
eliozica: calls 13261 and is all-in
Uncalled bet (19589) returned to jonnycongo
*** TURN *** [Ts 8s 5s] [2h]
*** RIVER *** [Ts 8s 5s 2h] [8d]
*** SHOW DOWN ***
jonnycongo: shows [8h 8c] (four of a kind, Eights)
eliozica: shows [As Tc] (two pair, Tens and Eights)
jonnycongo collected 59372 from pot
eliozica finished the tournament in 24th place
*** SUMMARY ***
Total pot 59372 | Rake 0=20
Board [Ts 8s 5s 2h 8d]
Seat 1: jonnycongo (big blind) showed [8h 8c] and won (59372) with four=
 of a kind, Eights
Seat 2: eliozica showed [As Tc] and lost with two pair, Tens and Eights
Seat 3: proletariat5 folded before Flop (didn't bet)
Seat 5: JJin91 (button) folded before Flop (didn't bet)
Seat 6: Bullets4Rick (small blind) folded before Flop


*********** # 149 **************
PokerStars Hand #169870586359: Tournament #1622537329, $13.50+$1.50 USD=
 Hold'em No Limit - Level XVI (600/1200) - 2017/05/14 16:18:55 ET
Table '1622537329 2' 6-max Seat #6 is the button
Seat 1: jonnycongo (93492 in chips)=20
Seat 3: proletariat5 (34293 in chips)=20
Seat 4: JTurbzzz828 (12825 in chips)=20
Seat 5: JJin91 (38014 in chips)=20
Seat 6: Bullets4Rick (30139 in chips)=20
jonnycongo: posts the ante 150
proletariat5: posts the ante 150
JTurbzzz828: posts the ante 150
JJin91: posts the ante 150
Bullets4Rick: posts the ante 150
jonnycongo: posts small blind 600
proletariat5: posts big blind 1200
*** HOLE CARDS ***
Dealt to JJin91 [3c Jc]
JTurbzzz828: raises 11475 to 12675 and is all-in
JJin91: folds=20
Bullets4Rick: folds=20
jonnycongo: folds=20
proletariat5: calls 11475
*** FLOP *** [7s Kc Jh]
*** TURN *** [7s Kc Jh] [Qd]
*** RIVER *** [7s Kc Jh Qd] [Kd]
*** SHOW DOWN ***
proletariat5: shows [Ac Qs] (two pair, Kings and Queens)
JTurbzzz828: shows [8d Ah] (a pair of Kings)
proletariat5 collected 26700 from pot
JTurbzzz828 finished the tournament in 23rd place
*** SUMMARY ***
Total pot 26700 | Rake 0=20
Board [7s Kc Jh Qd Kd]
Seat 1: jonnycongo (small blind) folded before Flop
Seat 3: proletariat5 (big blind) showed [Ac Qs] and won (26700) with tw=
o pair, Kings and Queens
Seat 4: JTurbzzz828 showed [8d Ah] and lost with a pair of Kings
Seat 5: JJin91 folded before Flop (didn't bet)
Seat 6: Bullets4Rick (button) folded before Flop (didn't bet)


*********** # 150 **************
PokerStars Hand #169870586527: Tournament #1622537329, $13.50+$1.50 USD=
 Hold'em No Limit - Level XVI (600/1200) - 2017/05/14 16:19:40 ET
Table '1622537329 2' 6-max Seat #1 is the button
Seat 1: jonnycongo (92742 in chips)=20
Seat 3: proletariat5 (48168 in chips)=20
Seat 5: JJin91 (37864 in chips)=20
Seat 6: Bullets4Rick (29989 in chips)=20
jonnycongo: posts the ante 150
proletariat5: posts the ante 150
JJin91: posts the ante 150
Bullets4Rick: posts the ante 150
proletariat5: posts small blind 600
JJin91: posts big blind 1200
*** HOLE CARDS ***
Dealt to JJin91 [4c 8s]
Bullets4Rick: calls 1200
jonnycongo: folds=20
proletariat5: folds=20
JJin91: checks=20
*** FLOP *** [Ts 4h Qh]
JJin91: checks=20
Bullets4Rick: bets 1200
JJin91: folds=20
Uncalled bet (1200) returned to Bullets4Rick
Bullets4Rick collected 3600 from pot
*** SUMMARY ***
Total pot 3600 | Rake 0=20
Board [Ts 4h Qh]
Seat 1: jonnycongo (button) folded before Flop (didn't bet)
Seat 3: proletariat5 (small blind) folded before Flop
Seat 5: JJin91 (big blind) folded on the Flop
Seat 6: Bullets4Rick collected (3600)


*********** # 151 **************
PokerStars Hand #169870586626: Tournament #1622537329, $13.50+$1.50 USD=
 Hold'em No Limit - Level XVI (600/1200) - 2017/05/14 16:20:10 ET
Table '1622537329 2' 6-max Seat #3 is the button
Seat 1: jonnycongo (92592 in chips)=20
Seat 3: proletariat5 (47418 in chips)=20
Seat 4: Mr. Deguello (104636 in chips) out of hand (moved from another =
table into small blind)
Seat 5: JJin91 (36514 in chips)=20
Seat 6: Bullets4Rick (32239 in chips)=20
jonnycongo: posts the ante 150
proletariat5: posts the ante 150
JJin91: posts the ante 150
Bullets4Rick: posts the ante 150
JJin91: posts small blind 600
Bullets4Rick: posts big blind 1200
*** HOLE CARDS ***
Dealt to JJin91 [7h Kc]
jonnycongo: folds=20
proletariat5: folds=20
JJin91: calls 600
Bullets4Rick: raises 1200 to 2400
JJin91: calls 1200
*** FLOP *** [2d 6s Kh]
JJin91: checks=20
Bullets4Rick: bets 1200
JJin91: calls 1200
*** TURN *** [2d 6s Kh] [7s]
JJin91: checks=20
Bullets4Rick: bets 1200
JJin91: raises 3600 to 4800
Bullets4Rick: calls 3600
*** RIVER *** [2d 6s Kh 7s] [9h]
JJin91: bets 9918
Bullets4Rick: folds=20
Uncalled bet (9918) returned to JJin91
JJin91 collected 17400 from pot
JJin91: doesn't show hand=20
*** SUMMARY ***
Total pot 17400 | Rake 0=20
Board [2d 6s Kh 7s 9h]
Seat 1: jonnycongo folded before Flop (didn't bet)
Seat 3: proletariat5 (button) folded before Flop (didn't bet)
Seat 5: JJin91 (small blind) collected (17400)
Seat 6: Bullets4Rick (big blind) folded on the River


*********** # 152 **************
PokerStars Hand #169870586818: Tournament #1622537329, $13.50+$1.50 USD=
 Hold'em No Limit - Level XVI (600/1200) - 2017/05/14 16:21:08 ET
Table '1622537329 2' 6-max Seat #5 is the button
Seat 1: jonnycongo (92442 in chips)=20
Seat 3: proletariat5 (47268 in chips)=20
Seat 4: Mr. Deguello (104636 in chips)=20
Seat 5: JJin91 (45364 in chips)=20
Seat 6: Bullets4Rick (23689 in chips)=20
jonnycongo: posts the ante 150
proletariat5: posts the ante 150
Mr. Deguello: posts the ante 150
JJin91: posts the ante 150
Bullets4Rick: posts the ante 150
Bullets4Rick: posts small blind 600
jonnycongo: posts big blind 1200
*** HOLE CARDS ***
Dealt to JJin91 [Ks Ts]
proletariat5: raises 1476 to 2676
Mr. Deguello: folds=20
JJin91: folds=20
Bullets4Rick: folds=20
jonnycongo: calls 1476
*** FLOP *** [9c Kc 3h]
jonnycongo: checks=20
proletariat5: bets 2145
jonnycongo: folds=20
Uncalled bet (2145) returned to proletariat5
proletariat5 collected 6702 from pot
proletariat5: doesn't show hand=20
*** SUMMARY ***
Total pot 6702 | Rake 0=20
Board [9c Kc 3h]
Seat 1: jonnycongo (big blind) folded on the Flop
Seat 3: proletariat5 collected (6702)
Seat 4: Mr. Deguello folded before Flop (didn't bet)
Seat 5: JJin91 (button) folded before Flop (didn't bet)
Seat 6: Bullets4Rick (small blind) folded before Flop


*********** # 153 **************
PokerStars Hand #169870586892: Tournament #1622537329, $13.50+$1.50 USD=
 Hold'em No Limit - Level XVI (600/1200) - 2017/05/14 16:21:36 ET
Table '1622537329 2' 6-max Seat #6 is the button
Seat 1: jonnycongo (89616 in chips)=20
Seat 3: proletariat5 (51144 in chips)=20
Seat 4: Mr. Deguello (104486 in chips)=20
Seat 5: JJin91 (45214 in chips)=20
Seat 6: Bullets4Rick (22939 in chips)=20
jonnycongo: posts the ante 150
proletariat5: posts the ante 150
Mr. Deguello: posts the ante 150
JJin91: posts the ante 150
Bullets4Rick: posts the ante 150
jonnycongo: posts small blind 600
proletariat5: posts big blind 1200
*** HOLE CARDS ***
Dealt to JJin91 [Jc 3d]
Mr. Deguello: folds=20
JJin91: folds=20
Bullets4Rick: calls 1200
jonnycongo: calls 600
proletariat5: checks=20
*** FLOP *** [8d 3h Ad]
jonnycongo: checks=20
proletariat5: bets 3002
Bullets4Rick: folds=20
jonnycongo: calls 3002
*** TURN *** [8d 3h Ad] [2d]
jonnycongo: checks=20
proletariat5: bets 3313
jonnycongo: calls 3313
*** RIVER *** [8d 3h Ad 2d] [Tc]
jonnycongo: checks=20
proletariat5: checks=20
*** SHOW DOWN ***
jonnycongo: shows [7d 7h] (a pair of Sevens)
proletariat5: shows [Ts Ac] (two pair, Aces and Tens)
proletariat5 collected 16980 from pot
*** SUMMARY ***
Total pot 16980 | Rake 0=20
Board [8d 3h Ad 2d Tc]
Seat 1: jonnycongo (small blind) showed [7d 7h] and lost with a pair of=
 Sevens
Seat 3: proletariat5 (big blind) showed [Ts Ac] and won (16980) with tw=
o pair, Aces and Tens
Seat 4: Mr. Deguello folded before Flop (didn't bet)
Seat 5: JJin91 folded before Flop (didn't bet)
Seat 6: Bullets4Rick (button) folded on the Flop


*********** # 154 **************
PokerStars Hand #169870587044: Tournament #1622537329, $13.50+$1.50 USD=
 Hold'em No Limit - Level XVI (600/1200) - 2017/05/14 16:22:19 ET
Table '1622537329 2' 6-max Seat #1 is the button
Seat 1: jonnycongo (81951 in chips)=20
Seat 3: proletariat5 (60459 in chips)=20
Seat 4: Mr. Deguello (104336 in chips)=20
Seat 5: JJin91 (45064 in chips)=20
Seat 6: Bullets4Rick (21589 in chips)=20
jonnycongo: posts the ante 150
proletariat5: posts the ante 150
Mr. Deguello: posts the ante 150
JJin91: posts the ante 150
Bullets4Rick: posts the ante 150
proletariat5: posts small blind 600
Mr. Deguello: posts big blind 1200
*** HOLE CARDS ***
Dealt to JJin91 [6h Kc]
JJin91: folds=20
Bullets4Rick: calls 1200
jonnycongo: folds=20
proletariat5: folds=20
Mr. Deguello: checks=20
*** FLOP *** [Ad 9d 4s]
Mr. Deguello: checks=20
Bullets4Rick: bets 1200
Mr. Deguello: folds=20
Uncalled bet (1200) returned to Bullets4Rick
Bullets4Rick collected 3750 from pot
*** SUMMARY ***
Total pot 3750 | Rake 0=20
Board [Ad 9d 4s]
Seat 1: jonnycongo (button) folded before Flop (didn't bet)
Seat 3: proletariat5 (small blind) folded before Flop
Seat 4: Mr. Deguello (big blind) folded on the Flop
Seat 5: JJin91 folded before Flop (didn't bet)
Seat 6: Bullets4Rick collected (3750)


*********** # 155 **************
PokerStars Hand #169870587144: Tournament #1622537329, $13.50+$1.50 USD=
 Hold'em No Limit - Level XVI (600/1200) - 2017/05/14 16:22:50 ET
Table '1622537329 2' 6-max Seat #3 is the button
Seat 1: jonnycongo (81801 in chips)=20
Seat 3: proletariat5 (59709 in chips)=20
Seat 4: Mr. Deguello (102986 in chips)=20
Seat 5: JJin91 (44914 in chips)=20
Seat 6: Bullets4Rick (23989 in chips)=20
jonnycongo: posts the ante 150
proletariat5: posts the ante 150
Mr. Deguello: posts the ante 150
JJin91: posts the ante 150
Bullets4Rick: posts the ante 150
Mr. Deguello: posts small blind 600
JJin91: posts big blind 1200
*** HOLE CARDS ***
Dealt to JJin91 [Qs 2s]
Bullets4Rick: folds=20
jonnycongo: folds=20
proletariat5: raises 1476 to 2676
Mr. Deguello: folds=20
JJin91: calls 1476
*** FLOP *** [9c 4h 8d]
JJin91: checks=20
proletariat5: checks=20
*** TURN *** [9c 4h 8d] [5c]
JJin91: checks=20
proletariat5: checks=20
*** RIVER *** [9c 4h 8d 5c] [Th]
JJin91: checks=20
proletariat5: checks=20
*** SHOW DOWN ***
JJin91: shows [Qs 2s] (high card Queen)
proletariat5: shows [Ad Qd] (high card Ace)
proletariat5 collected 6702 from pot
*** SUMMARY ***
Total pot 6702 | Rake 0=20
Board [9c 4h 8d 5c Th]
Seat 1: jonnycongo folded before Flop (didn't bet)
Seat 3: proletariat5 (button) showed [Ad Qd] and won (6702) with high c=
ard Ace
Seat 4: Mr. Deguello (small blind) folded before Flop
Seat 5: JJin91 (big blind) showed [Qs 2s] and lost with high card Queen
Seat 6: Bullets4Rick folded before Flop (didn't bet)


*********** # 156 **************
PokerStars Hand #169870587264: Tournament #1622537329, $13.50+$1.50 USD=
 Hold'em No Limit - Level XVI (600/1200) - 2017/05/14 16:23:24 ET
Table '1622537329 2' 6-max Seat #4 is the button
Seat 1: jonnycongo (81651 in chips)=20
Seat 3: proletariat5 (63585 in chips)=20
Seat 4: Mr. Deguello (102236 in chips)=20
Seat 5: JJin91 (42088 in chips)=20
Seat 6: Bullets4Rick (23839 in chips)=20
jonnycongo: posts the ante 150
proletariat5: posts the ante 150
Mr. Deguello: posts the ante 150
JJin91: posts the ante 150
Bullets4Rick: posts the ante 150
JJin91: posts small blind 600
Bullets4Rick: posts big blind 1200
*** HOLE CARDS ***
Dealt to JJin91 [9c Jh]
jonnycongo: folds=20
proletariat5: raises 1476 to 2676
Mr. Deguello: folds=20
JJin91: folds=20
Bullets4Rick: calls 1476
*** FLOP *** [Kc Td 5c]
Bullets4Rick: checks=20
proletariat5: bets 4624
Bullets4Rick: folds=20
Uncalled bet (4624) returned to proletariat5
proletariat5 collected 6702 from pot
proletariat5: doesn't show hand=20
*** SUMMARY ***
Total pot 6702 | Rake 0=20
Board [Kc Td 5c]
Seat 1: jonnycongo folded before Flop (didn't bet)
Seat 3: proletariat5 collected (6702)
Seat 4: Mr. Deguello (button) folded before Flop (didn't bet)
Seat 5: JJin91 (small blind) folded before Flop
Seat 6: Bullets4Rick (big blind) folded on the Flop


*********** # 157 **************
PokerStars Hand #169870587369: Tournament #1622537329, $13.50+$1.50 USD=
 Hold'em No Limit - Level XVI (600/1200) - 2017/05/14 16:23:53 ET
Table '1622537329 2' 6-max Seat #5 is the button
Seat 1: jonnycongo (81501 in chips)=20
Seat 3: proletariat5 (67461 in chips)=20
Seat 4: Mr. Deguello (102086 in chips)=20
Seat 5: JJin91 (41338 in chips)=20
Seat 6: Bullets4Rick (21013 in chips)=20
jonnycongo: posts the ante 150
proletariat5: posts the ante 150
Mr. Deguello: posts the ante 150
JJin91: posts the ante 150
Bullets4Rick: posts the ante 150
Bullets4Rick: posts small blind 600
jonnycongo: posts big blind 1200
*** HOLE CARDS ***
Dealt to JJin91 [2c Ts]
proletariat5: folds=20
Mr. Deguello: calls 1200
JJin91: folds=20
Bullets4Rick: calls 600
jonnycongo: checks=20
*** FLOP *** [Kh Qd 6s]
Bullets4Rick: bets 2400
jonnycongo: folds=20
Mr. Deguello: folds=20
Uncalled bet (2400) returned to Bullets4Rick
Bullets4Rick collected 4350 from pot
*** SUMMARY ***
Total pot 4350 | Rake 0=20
Board [Kh Qd 6s]
Seat 1: jonnycongo (big blind) folded on the Flop
Seat 3: proletariat5 folded before Flop (didn't bet)
Seat 4: Mr. Deguello folded on the Flop
Seat 5: JJin91 (button) folded before Flop (didn't bet)
Seat 6: Bullets4Rick (small blind) collected (4350)


*********** # 158 **************
PokerStars Hand #169870587548: Tournament #1622537329, $13.50+$1.50 USD=
 Hold'em No Limit - Level XVI (600/1200) - 2017/05/14 16:24:41 ET
Table '1622537329 2' 6-max Seat #6 is the button
Seat 1: jonnycongo (80151 in chips)=20
Seat 3: proletariat5 (67311 in chips)=20
Seat 4: Mr. Deguello (100736 in chips)=20
Seat 5: JJin91 (41188 in chips)=20
Seat 6: Bullets4Rick (24013 in chips)=20
jonnycongo: posts the ante 150
proletariat5: posts the ante 150
Mr. Deguello: posts the ante 150
JJin91: posts the ante 150
Bullets4Rick: posts the ante 150
jonnycongo: posts small blind 600
proletariat5: posts big blind 1200
*** HOLE CARDS ***
Dealt to JJin91 [6c Jc]
Mr. Deguello: folds=20
JJin91: folds=20
Bullets4Rick: folds=20
jonnycongo: folds=20
Uncalled bet (600) returned to proletariat5
proletariat5 collected 1950 from pot
proletariat5: doesn't show hand=20
*** SUMMARY ***
Total pot 1950 | Rake 0=20
Seat 1: jonnycongo (small blind) folded before Flop
Seat 3: proletariat5 (big blind) collected (1950)
Seat 4: Mr. Deguello folded before Flop (didn't bet)
Seat 5: JJin91 folded before Flop (didn't bet)
Seat 6: Bullets4Rick (button) folded before Flop (didn't bet)


*********** # 159 **************
PokerStars Hand #169870587593: Tournament #1622537329, $13.50+$1.50 USD=
 Hold'em No Limit - Level XVI (600/1200) - 2017/05/14 16:24:53 ET
Table '1622537329 2' 6-max Seat #1 is the button
Seat 1: jonnycongo (79401 in chips)=20
Seat 3: proletariat5 (68511 in chips)=20
Seat 4: Mr. Deguello (100586 in chips)=20
Seat 5: JJin91 (41038 in chips)=20
Seat 6: Bullets4Rick (23863 in chips)=20
jonnycongo: posts the ante 150
proletariat5: posts the ante 150
Mr. Deguello: posts the ante 150
JJin91: posts the ante 150
Bullets4Rick: posts the ante 150
proletariat5: posts small blind 600
Mr. Deguello: posts big blind 1200
*** HOLE CARDS ***
Dealt to JJin91 [Jd Td]
JJin91: raises 1428 to 2628
Bullets4Rick: folds=20
jonnycongo: folds=20
proletariat5: folds=20
Mr. Deguello: calls 1428
*** FLOP *** [Qh 6h 4h]
Mr. Deguello: bets 3600
JJin91: folds=20
Uncalled bet (3600) returned to Mr. Deguello
Mr. Deguello collected 6606 from pot
Mr. Deguello: doesn't show hand=20
*** SUMMARY ***
Total pot 6606 | Rake 0=20
Board [Qh 6h 4h]
Seat 1: jonnycongo (button) folded before Flop (didn't bet)
Seat 3: proletariat5 (small blind) folded before Flop
Seat 4: Mr. Deguello (big blind) collected (6606)
Seat 5: JJin91 folded on the Flop
Seat 6: Bullets4Rick folded before Flop (didn't bet)


*********** # 160 **************
PokerStars Hand #169870587704: Tournament #1622537329, $13.50+$1.50 USD=
 Hold'em No Limit - Level XVI (600/1200) - 2017/05/14 16:25:23 ET
Table '1622537329 2' 6-max Seat #3 is the button
Seat 1: jonnycongo (79251 in chips)=20
Seat 3: proletariat5 (67761 in chips)=20
Seat 4: Mr. Deguello (104414 in chips)=20
Seat 5: JJin91 (38260 in chips)=20
Seat 6: Bullets4Rick (23713 in chips)=20
jonnycongo: posts the ante 150
proletariat5: posts the ante 150
Mr. Deguello: posts the ante 150
JJin91: posts the ante 150
Bullets4Rick: posts the ante 150
Mr. Deguello: posts small blind 600
JJin91: posts big blind 1200
*** HOLE CARDS ***
Dealt to JJin91 [As 8c]
Bullets4Rick: raises 1200 to 2400
jonnycongo: folds=20
proletariat5: folds=20
Mr. Deguello: folds=20
JJin91: calls 1200
*** FLOP *** [7h 9s 8h]
JJin91: checks=20
Bullets4Rick: bets 1200
JJin91: raises 2085 to 3285
Bullets4Rick: raises 17878 to 21163 and is all-in
JJin91: folds=20
Uncalled bet (17878) returned to Bullets4Rick
Bullets4Rick collected 12720 from pot
*** SUMMARY ***
Total pot 12720 | Rake 0=20
Board [7h 9s 8h]
Seat 1: jonnycongo folded before Flop (didn't bet)
Seat 3: proletariat5 (button) folded before Flop (didn't bet)
Seat 4: Mr. Deguello (small blind) folded before Flop
Seat 5: JJin91 (big blind) folded on the Flop
Seat 6: Bullets4Rick collected (12720)


*********** # 161 **************
PokerStars Hand #169870587875: Tournament #1622537329, $13.50+$1.50 USD=
 Hold'em No Limit - Level XVI (600/1200) - 2017/05/14 16:26:06 ET
Table '1622537329 2' 6-max Seat #4 is the button
Seat 1: jonnycongo (79101 in chips)=20
Seat 3: proletariat5 (67611 in chips)=20
Seat 4: Mr. Deguello (103664 in chips)=20
Seat 5: JJin91 (32425 in chips)=20
Seat 6: Bullets4Rick (30598 in chips)=20
jonnycongo: posts the ante 150
proletariat5: posts the ante 150
Mr. Deguello: posts the ante 150
JJin91: posts the ante 150
Bullets4Rick: posts the ante 150
JJin91: posts small blind 600
Bullets4Rick: posts big blind 1200
*** HOLE CARDS ***
Dealt to JJin91 [4d Qh]
jonnycongo: folds=20
proletariat5: folds=20
Mr. Deguello: calls 1200
JJin91: folds=20
Bullets4Rick: checks=20
*** FLOP *** [2h 4s Qd]
Bullets4Rick: checks=20
Mr. Deguello: bets 1200
Bullets4Rick: calls 1200
*** TURN *** [2h 4s Qd] [Jh]
Bullets4Rick: checks=20
Mr. Deguello: checks=20
*** RIVER *** [2h 4s Qd Jh] [2c]
Bullets4Rick: checks=20
Mr. Deguello: bets 6000
Bullets4Rick: folds=20
Uncalled bet (6000) returned to Mr. Deguello
Mr. Deguello collected 6150 from pot
Mr. Deguello: doesn't show hand=20
*** SUMMARY ***
Total pot 6150 | Rake 0=20
Board [2h 4s Qd Jh 2c]
Seat 1: jonnycongo folded before Flop (didn't bet)
Seat 3: proletariat5 folded before Flop (didn't bet)
Seat 4: Mr. Deguello (button) collected (6150)
Seat 5: JJin91 (small blind) folded before Flop
Seat 6: Bullets4Rick (big blind) folded on the River


*********** # 162 **************
PokerStars Hand #169870588044: Tournament #1622537329, $13.50+$1.50 USD=
 Hold'em No Limit - Level XVI (600/1200) - 2017/05/14 16:26:52 ET
Table '1622537329 2' 6-max Seat #5 is the button
Seat 1: jonnycongo (78951 in chips)=20
Seat 3: proletariat5 (67461 in chips)=20
Seat 4: Mr. Deguello (107264 in chips)=20
Seat 5: JJin91 (31675 in chips)=20
Seat 6: Bullets4Rick (28048 in chips)=20
jonnycongo: posts the ante 150
proletariat5: posts the ante 150
Mr. Deguello: posts the ante 150
JJin91: posts the ante 150
Bullets4Rick: posts the ante 150
Bullets4Rick: posts small blind 600
jonnycongo: posts big blind 1200
*** HOLE CARDS ***
Dealt to JJin91 [Js Qc]
proletariat5: folds=20
Mr. Deguello: folds=20
JJin91: raises 1428 to 2628
Bullets4Rick: folds=20
jonnycongo: raises 76173 to 78801 and is all-in
JJin91: folds=20
Uncalled bet (76173) returned to jonnycongo
jonnycongo collected 6606 from pot
*** SUMMARY ***
Total pot 6606 | Rake 0=20
Seat 1: jonnycongo (big blind) collected (6606)
Seat 3: proletariat5 folded before Flop (didn't bet)
Seat 4: Mr. Deguello folded before Flop (didn't bet)
Seat 5: JJin91 (button) folded before Flop
Seat 6: Bullets4Rick (small blind) folded before Flop


*********** # 163 **************
PokerStars Hand #169870588172: Tournament #1622537329, $13.50+$1.50 USD=
 Hold'em No Limit - Level XVI (600/1200) - 2017/05/14 16:27:24 ET
Table '1622537329 2' 6-max Seat #6 is the button
Seat 1: jonnycongo (82779 in chips)=20
Seat 3: proletariat5 (67311 in chips)=20
Seat 4: Mr. Deguello (107114 in chips)=20
Seat 5: JJin91 (28897 in chips)=20
Seat 6: Bullets4Rick (27298 in chips)=20
jonnycongo: posts the ante 150
proletariat5: posts the ante 150
Mr. Deguello: posts the ante 150
JJin91: posts the ante 150
Bullets4Rick: posts the ante 150
jonnycongo: posts small blind 600
proletariat5: posts big blind 1200
*** HOLE CARDS ***
Dealt to JJin91 [3s 7h]
Mr. Deguello: calls 1200
JJin91: folds=20
Bullets4Rick: folds=20
jonnycongo: folds=20
proletariat5: checks=20
*** FLOP *** [2c Jh 6s]
proletariat5: checks=20
Mr. Deguello: bets 3600
proletariat5: folds=20
Uncalled bet (3600) returned to Mr. Deguello
Mr. Deguello collected 3750 from pot
Mr. Deguello: doesn't show hand=20
*** SUMMARY ***
Total pot 3750 | Rake 0=20
Board [2c Jh 6s]
Seat 1: jonnycongo (small blind) folded before Flop
Seat 3: proletariat5 (big blind) folded on the Flop
Seat 4: Mr. Deguello collected (3750)
Seat 5: JJin91 folded before Flop (didn't bet)
Seat 6: Bullets4Rick (button) folded before Flop (didn't bet)


*********** # 164 **************
PokerStars Hand #169870588395: Tournament #1622537329, $13.50+$1.50 USD=
 Hold'em No Limit - Level XVII (700/1400) - 2017/05/14 16:28:31 ET
Table '1622537329 2' 6-max Seat #1 is the button
Seat 1: jonnycongo (82029 in chips)=20
Seat 3: proletariat5 (65961 in chips)=20
Seat 4: Mr. Deguello (109514 in chips)=20
Seat 5: JJin91 (28747 in chips)=20
Seat 6: Bullets4Rick (27148 in chips)=20
jonnycongo: posts the ante 175
proletariat5: posts the ante 175
Mr. Deguello: posts the ante 175
JJin91: posts the ante 175
Bullets4Rick: posts the ante 175
proletariat5: posts small blind 700
Mr. Deguello: posts big blind 1400
*** HOLE CARDS ***
Dealt to JJin91 [Jd 6h]
JJin91: folds=20
Bullets4Rick: folds=20
jonnycongo: folds=20
proletariat5: raises 1722 to 3122
Mr. Deguello: folds=20
Uncalled bet (1722) returned to proletariat5
proletariat5 collected 3675 from pot
proletariat5: doesn't show hand=20
*** SUMMARY ***
Total pot 3675 | Rake 0=20
Seat 1: jonnycongo (button) folded before Flop (didn't bet)
Seat 3: proletariat5 (small blind) collected (3675)
Seat 4: Mr. Deguello (big blind) folded before Flop
Seat 5: JJin91 folded before Flop (didn't bet)
Seat 6: Bullets4Rick folded before Flop (didn't bet)


*********** # 165 **************
PokerStars Hand #169870588812: Tournament #1622537329, $13.50+$1.50 USD=
 Hold'em No Limit - Level XVII (700/1400) - 2017/05/14 16:30:33 ET
Table '1622537329 2' 6-max Seat #3 is the button
Seat 1: jonnycongo (81854 in chips)=20
Seat 2: gdep1979 (178089 in chips)=20
Seat 3: proletariat5 (68061 in chips)=20
Seat 4: Mr. Deguello (107939 in chips)=20
Seat 5: JJin91 (28572 in chips)=20
Seat 6: Bullets4Rick (26973 in chips)=20
jonnycongo: posts the ante 175
gdep1979: posts the ante 175
proletariat5: posts the ante 175
Mr. Deguello: posts the ante 175
JJin91: posts the ante 175
Bullets4Rick: posts the ante 175
Mr. Deguello: posts small blind 700
JJin91: posts big blind 1400
*** HOLE CARDS ***
Dealt to JJin91 [Ah 6h]
Bullets4Rick: folds=20
jonnycongo: folds=20
gdep1979: folds=20
proletariat5: folds=20
Mr. Deguello: folds=20
Uncalled bet (700) returned to JJin91
JJin91 collected 2450 from pot
JJin91: doesn't show hand=20
*** SUMMARY ***
Total pot 2450 | Rake 0=20
Seat 1: jonnycongo folded before Flop (didn't bet)
Seat 2: gdep1979 folded before Flop (didn't bet)
Seat 3: proletariat5 (button) folded before Flop (didn't bet)
Seat 4: Mr. Deguello (small blind) folded before Flop
Seat 5: JJin91 (big blind) collected (2450)
Seat 6: Bullets4Rick folded before Flop (didn't bet)


*********** # 166 **************
PokerStars Hand #169870588902: Tournament #1622537329, $13.50+$1.50 USD=
 Hold'em No Limit - Level XVII (700/1400) - 2017/05/14 16:30:54 ET
Table '1622537329 2' 6-max Seat #4 is the button
Seat 1: jonnycongo (81679 in chips)=20
Seat 2: gdep1979 (177914 in chips)=20
Seat 3: proletariat5 (67886 in chips)=20
Seat 4: Mr. Deguello (107064 in chips)=20
Seat 5: JJin91 (30147 in chips)=20
Seat 6: Bullets4Rick (26798 in chips)=20
jonnycongo: posts the ante 175
gdep1979: posts the ante 175
proletariat5: posts the ante 175
Mr. Deguello: posts the ante 175
JJin91: posts the ante 175
Bullets4Rick: posts the ante 175
JJin91: posts small blind 700
Bullets4Rick: posts big blind 1400
*** HOLE CARDS ***
Dealt to JJin91 [6h Ks]
jonnycongo: folds=20
gdep1979: raises 1400 to 2800
proletariat5: folds=20
Mr. Deguello: folds=20
JJin91: folds=20
Bullets4Rick: calls 1400
*** FLOP *** [2d Ts As]
Bullets4Rick: checks=20
gdep1979: bets 2800
Bullets4Rick: raises 2800 to 5600
gdep1979: calls 2800
*** TURN *** [2d Ts As] [Qc]
Bullets4Rick: bets 1400
gdep1979: raises 4200 to 5600
Bullets4Rick: calls 4200
*** RIVER *** [2d Ts As Qc] [9s]
Bullets4Rick: bets 12623 and is all-in
gdep1979: folds=20
Uncalled bet (12623) returned to Bullets4Rick
Bullets4Rick collected 29750 from pot
*** SUMMARY ***
Total pot 29750 | Rake 0=20
Board [2d Ts As Qc 9s]
Seat 1: jonnycongo folded before Flop (didn't bet)
Seat 2: gdep1979 folded on the River
Seat 3: proletariat5 folded before Flop (didn't bet)
Seat 4: Mr. Deguello (button) folded before Flop (didn't bet)
Seat 5: JJin91 (small blind) folded before Flop
Seat 6: Bullets4Rick (big blind) collected (29750)


*********** # 167 **************
PokerStars Hand #169870589131: Tournament #1622537329, $13.50+$1.50 USD=
 Hold'em No Limit - Level XVII (700/1400) - 2017/05/14 16:31:48 ET
Table '1622537329 2' 6-max Seat #5 is the button
Seat 1: jonnycongo (81504 in chips)=20
Seat 2: gdep1979 (163739 in chips)=20
Seat 3: proletariat5 (67711 in chips)=20
Seat 4: Mr. Deguello (106889 in chips)=20
Seat 5: JJin91 (29272 in chips)=20
Seat 6: Bullets4Rick (42373 in chips)=20
jonnycongo: posts the ante 175
gdep1979: posts the ante 175
proletariat5: posts the ante 175
Mr. Deguello: posts the ante 175
JJin91: posts the ante 175
Bullets4Rick: posts the ante 175
Bullets4Rick: posts small blind 700
jonnycongo: posts big blind 1400
*** HOLE CARDS ***
Dealt to JJin91 [6d 3c]
gdep1979: folds=20
proletariat5: folds=20
Mr. Deguello: raises 1400 to 2800
JJin91: folds=20
Bullets4Rick: folds=20
jonnycongo: calls 1400
*** FLOP *** [4s 9s Th]
jonnycongo: checks=20
Mr. Deguello: bets 4200
jonnycongo: folds=20
Uncalled bet (4200) returned to Mr. Deguello
Mr. Deguello collected 7350 from pot
Mr. Deguello: doesn't show hand=20
*** SUMMARY ***
Total pot 7350 | Rake 0=20
Board [4s 9s Th]
Seat 1: jonnycongo (big blind) folded on the Flop
Seat 2: gdep1979 folded before Flop (didn't bet)
Seat 3: proletariat5 folded before Flop (didn't bet)
Seat 4: Mr. Deguello collected (7350)
Seat 5: JJin91 (button) folded before Flop (didn't bet)
Seat 6: Bullets4Rick (small blind) folded before Flop


*********** # 168 **************
PokerStars Hand #169870589275: Tournament #1622537329, $13.50+$1.50 USD=
 Hold'em No Limit - Level XVII (700/1400) - 2017/05/14 16:32:26 ET
Table '1622537329 2' 6-max Seat #6 is the button
Seat 1: jonnycongo (78529 in chips)=20
Seat 2: gdep1979 (163564 in chips)=20
Seat 4: Mr. Deguello (111264 in chips)=20
Seat 5: JJin91 (29097 in chips)=20
Seat 6: Bullets4Rick (41498 in chips)=20
jonnycongo: posts the ante 175
gdep1979: posts the ante 175
Mr. Deguello: posts the ante 175
JJin91: posts the ante 175
Bullets4Rick: posts the ante 175
jonnycongo: posts small blind 700
gdep1979: posts big blind 1400
*** HOLE CARDS ***
Dealt to JJin91 [Jd 2s]
Mr. Deguello: folds=20
JJin91: folds=20
Bullets4Rick: folds=20
jonnycongo: folds=20
Uncalled bet (700) returned to gdep1979
gdep1979 collected 2275 from pot
gdep1979: doesn't show hand=20
*** SUMMARY ***
Total pot 2275 | Rake 0=20
Seat 1: jonnycongo (small blind) folded before Flop
Seat 2: gdep1979 (big blind) collected (2275)
Seat 4: Mr. Deguello folded before Flop (didn't bet)
Seat 5: JJin91 folded before Flop (didn't bet)
Seat 6: Bullets4Rick (button) folded before Flop (didn't bet)


*********** # 169 **************
PokerStars Hand #169870589322: Tournament #1622537329, $13.50+$1.50 USD=
 Hold'em No Limit - Level XVII (700/1400) - 2017/05/14 16:32:38 ET
Table '1622537329 2' 6-max Seat #1 is the button
Seat 1: jonnycongo (77654 in chips)=20
Seat 2: gdep1979 (164964 in chips)=20
Seat 4: Mr. Deguello (111089 in chips)=20
Seat 5: JJin91 (28922 in chips)=20
Seat 6: Bullets4Rick (41323 in chips)=20
jonnycongo: posts the ante 175
gdep1979: posts the ante 175
Mr. Deguello: posts the ante 175
JJin91: posts the ante 175
Bullets4Rick: posts the ante 175
gdep1979: posts small blind 700
Mr. Deguello: posts big blind 1400
*** HOLE CARDS ***
Dealt to JJin91 [7c Td]
JJin91: folds=20
Bullets4Rick: folds=20
jonnycongo: folds=20
gdep1979: folds=20
Uncalled bet (700) returned to Mr. Deguello
Mr. Deguello collected 2275 from pot
Mr. Deguello: doesn't show hand=20
*** SUMMARY ***
Total pot 2275 | Rake 0=20
Seat 1: jonnycongo (button) folded before Flop (didn't bet)
Seat 2: gdep1979 (small blind) folded before Flop
Seat 4: Mr. Deguello (big blind) collected (2275)
Seat 5: JJin91 folded before Flop (didn't bet)
Seat 6: Bullets4Rick folded before Flop (didn't bet)


*********** # 170 **************
PokerStars Hand #169870589397: Tournament #1622537329, $13.50+$1.50 USD=
 Hold'em No Limit - Level XVII (700/1400) - 2017/05/14 16:33:00 ET
Table '1622537329 2' 6-max Seat #2 is the button
Seat 1: jonnycongo (77479 in chips)=20
Seat 2: gdep1979 (164089 in chips)=20
Seat 4: Mr. Deguello (112489 in chips)=20
Seat 5: JJin91 (28747 in chips)=20
Seat 6: Bullets4Rick (41148 in chips)=20
jonnycongo: posts the ante 175
gdep1979: posts the ante 175
Mr. Deguello: posts the ante 175
JJin91: posts the ante 175
Bullets4Rick: posts the ante 175
Mr. Deguello: posts small blind 700
JJin91: posts big blind 1400
*** HOLE CARDS ***
Dealt to JJin91 [3d 5h]
Bullets4Rick: folds=20
jonnycongo: folds=20
gdep1979: folds=20
Mr. Deguello: raises 1400 to 2800
JJin91: folds=20
Uncalled bet (1400) returned to Mr. Deguello
Mr. Deguello collected 3675 from pot
Mr. Deguello: doesn't show hand=20
*** SUMMARY ***
Total pot 3675 | Rake 0=20
Seat 1: jonnycongo folded before Flop (didn't bet)
Seat 2: gdep1979 (button) folded before Flop (didn't bet)
Seat 4: Mr. Deguello (small blind) collected (3675)
Seat 5: JJin91 (big blind) folded before Flop
Seat 6: Bullets4Rick folded before Flop (didn't bet)


*********** # 171 **************
PokerStars Hand #169870589511: Tournament #1622537329, $13.50+$1.50 USD=
 Hold'em No Limit - Level XVII (700/1400) - 2017/05/14 16:33:32 ET
Table '1622537329 2' 6-max Seat #4 is the button
Seat 1: jonnycongo (77304 in chips)=20
Seat 2: gdep1979 (163914 in chips)=20
Seat 4: Mr. Deguello (114589 in chips)=20
Seat 5: JJin91 (27172 in chips)=20
Seat 6: Bullets4Rick (40973 in chips)=20
jonnycongo: posts the ante 175
gdep1979: posts the ante 175
Mr. Deguello: posts the ante 175
JJin91: posts the ante 175
Bullets4Rick: posts the ante 175
JJin91: posts small blind 700
Bullets4Rick: posts big blind 1400
*** HOLE CARDS ***
Dealt to JJin91 [6h 9d]
jonnycongo: folds=20
gdep1979: folds=20
Mr. Deguello: raises 1400 to 2800
JJin91: folds=20
Bullets4Rick: raises 37998 to 40798 and is all-in
Mr. Deguello: folds=20
Uncalled bet (37998) returned to Bullets4Rick
Bullets4Rick collected 7175 from pot
*** SUMMARY ***
Total pot 7175 | Rake 0=20
Seat 1: jonnycongo folded before Flop (didn't bet)
Seat 2: gdep1979 folded before Flop (didn't bet)
Seat 4: Mr. Deguello (button) folded before Flop
Seat 5: JJin91 (small blind) folded before Flop
Seat 6: Bullets4Rick (big blind) collected (7175)


*********** # 172 **************
PokerStars Hand #169870589640: Tournament #1622537329, $13.50+$1.50 USD=
 Hold'em No Limit - Level XVII (700/1400) - 2017/05/14 16:34:09 ET
Table '1622537329 2' 6-max Seat #5 is the button
Seat 1: jonnycongo (77129 in chips)=20
Seat 2: gdep1979 (163739 in chips)=20
Seat 4: Mr. Deguello (111614 in chips)=20
Seat 5: JJin91 (26297 in chips)=20
Seat 6: Bullets4Rick (45173 in chips)=20
jonnycongo: posts the ante 175
gdep1979: posts the ante 175
Mr. Deguello: posts the ante 175
JJin91: posts the ante 175
Bullets4Rick: posts the ante 175
Bullets4Rick: posts small blind 700
jonnycongo: posts big blind 1400
*** HOLE CARDS ***
Dealt to JJin91 [4s 9c]
gdep1979: folds=20
Mr. Deguello: folds=20
JJin91: folds=20
Bullets4Rick: calls 700
jonnycongo: checks=20
*** FLOP *** [Kh 2s 6h]
Bullets4Rick: checks=20
jonnycongo: checks=20
*** TURN *** [Kh 2s 6h] [Js]
Bullets4Rick: checks=20
jonnycongo: bets 1400
Bullets4Rick: calls 1400
*** RIVER *** [Kh 2s 6h Js] [Ks]
Bullets4Rick: checks=20
jonnycongo: bets 1400
Bullets4Rick: folds=20
Uncalled bet (1400) returned to jonnycongo
jonnycongo collected 6475 from pot
*** SUMMARY ***
Total pot 6475 | Rake 0=20
Board [Kh 2s 6h Js Ks]
Seat 1: jonnycongo (big blind) collected (6475)
Seat 2: gdep1979 folded before Flop (didn't bet)
Seat 4: Mr. Deguello folded before Flop (didn't bet)
Seat 5: JJin91 (button) folded before Flop (didn't bet)
Seat 6: Bullets4Rick (small blind) folded on the River


*********** # 173 **************
PokerStars Hand #169870589831: Tournament #1622537329, $13.50+$1.50 USD=
 Hold'em No Limit - Level XVII (700/1400) - 2017/05/14 16:35:08 ET
Table '1622537329 2' 6-max Seat #6 is the button
Seat 1: jonnycongo (80629 in chips)=20
Seat 2: gdep1979 (163564 in chips)=20
Seat 4: Mr. Deguello (111439 in chips)=20
Seat 5: JJin91 (26122 in chips)=20
Seat 6: Bullets4Rick (42198 in chips)=20
jonnycongo: posts the ante 175
gdep1979: posts the ante 175
Mr. Deguello: posts the ante 175
JJin91: posts the ante 175
Bullets4Rick: posts the ante 175
jonnycongo: posts small blind 700
gdep1979: posts big blind 1400
*** HOLE CARDS ***
Dealt to JJin91 [5c 3c]
Mr. Deguello: calls 1400
JJin91: folds=20
Bullets4Rick: calls 1400
jonnycongo: folds=20
gdep1979: checks=20
*** FLOP *** [8s 8h Td]
gdep1979: checks=20
Mr. Deguello: checks=20
Bullets4Rick: checks=20
*** TURN *** [8s 8h Td] [Jc]
gdep1979: checks=20
Mr. Deguello: bets 2800
Bullets4Rick: folds=20
gdep1979: folds=20
Uncalled bet (2800) returned to Mr. Deguello
Mr. Deguello collected 5775 from pot
Mr. Deguello: doesn't show hand=20
*** SUMMARY ***
Total pot 5775 | Rake 0=20
Board [8s 8h Td Jc]
Seat 1: jonnycongo (small blind) folded before Flop
Seat 2: gdep1979 (big blind) folded on the Turn
Seat 4: Mr. Deguello collected (5775)
Seat 5: JJin91 folded before Flop (didn't bet)
Seat 6: Bullets4Rick (button) folded on the Turn


*********** # 174 **************
PokerStars Hand #169870589984: Tournament #1622537329, $13.50+$1.50 USD=
 Hold'em No Limit - Level XVII (700/1400) - 2017/05/14 16:35:50 ET
Table '1622537329 2' 6-max Seat #1 is the button
Seat 1: jonnycongo (79754 in chips)=20
Seat 2: gdep1979 (161989 in chips)=20
Seat 4: Mr. Deguello (115639 in chips)=20
Seat 5: JJin91 (25947 in chips)=20
Seat 6: Bullets4Rick (40623 in chips)=20
jonnycongo: posts the ante 175
gdep1979: posts the ante 175
Mr. Deguello: posts the ante 175
JJin91: posts the ante 175
Bullets4Rick: posts the ante 175
gdep1979: posts small blind 700
Mr. Deguello: posts big blind 1400
*** HOLE CARDS ***
Dealt to JJin91 [Jc 2s]
JJin91: folds=20
Bullets4Rick: folds=20
jonnycongo: folds=20
gdep1979: folds=20
Uncalled bet (700) returned to Mr. Deguello
Mr. Deguello collected 2275 from pot
Mr. Deguello: doesn't show hand=20
*** SUMMARY ***
Total pot 2275 | Rake 0=20
Seat 1: jonnycongo (button) folded before Flop (didn't bet)
Seat 2: gdep1979 (small blind) folded before Flop
Seat 4: Mr. Deguello (big blind) collected (2275)
Seat 5: JJin91 folded before Flop (didn't bet)
Seat 6: Bullets4Rick folded before Flop (didn't bet)


*********** # 175 **************
PokerStars Hand #169873283945: Tournament #1622537329, $13.50+$1.50 USD=
 Hold'em No Limit - Level XVII (700/1400) - 2017/05/14 16:36:06 ET
Table '1622537329 2' 6-max Seat #2 is the button
Seat 1: jonnycongo (79579 in chips)=20
Seat 2: gdep1979 (161114 in chips)=20
Seat 4: Mr. Deguello (117039 in chips)=20
Seat 5: JJin91 (25772 in chips)=20
Seat 6: Bullets4Rick (40448 in chips)=20
jonnycongo: posts the ante 175
gdep1979: posts the ante 175
Mr. Deguello: posts the ante 175
JJin91: posts the ante 175
Bullets4Rick: posts the ante 175
Mr. Deguello: posts small blind 700
JJin91: posts big blind 1400
*** HOLE CARDS ***
Dealt to JJin91 [5s Th]
Bullets4Rick: calls 1400
jonnycongo: folds=20
gdep1979: folds=20
Mr. Deguello: calls 700
JJin91: checks=20
*** FLOP *** [6d Td Kh]
Mr. Deguello: checks=20
JJin91: bets 2893
Bullets4Rick: folds=20
Mr. Deguello: folds=20
Uncalled bet (2893) returned to JJin91
JJin91 collected 5075 from pot
JJin91: doesn't show hand=20
*** SUMMARY ***
Total pot 5075 | Rake 0=20
Board [6d Td Kh]
Seat 1: jonnycongo folded before Flop (didn't bet)
Seat 2: gdep1979 (button) folded before Flop (didn't bet)
Seat 4: Mr. Deguello (small blind) folded on the Flop
Seat 5: JJin91 (big blind) collected (5075)
Seat 6: Bullets4Rick folded on the Flop


*********** # 176 **************
PokerStars Hand #169873284085: Tournament #1622537329, $13.50+$1.50 USD=
 Hold'em No Limit - Level XVII (700/1400) - 2017/05/14 16:36:46 ET
Table '1622537329 2' 6-max Seat #4 is the button
Seat 1: jonnycongo (79404 in chips)=20
Seat 2: gdep1979 (160939 in chips)=20
Seat 4: Mr. Deguello (115464 in chips)=20
Seat 5: JJin91 (29272 in chips)=20
Seat 6: Bullets4Rick (38873 in chips)=20
jonnycongo: posts the ante 175
gdep1979: posts the ante 175
Mr. Deguello: posts the ante 175
JJin91: posts the ante 175
Bullets4Rick: posts the ante 175
JJin91: posts small blind 700
Bullets4Rick: posts big blind 1400
*** HOLE CARDS ***
Dealt to JJin91 [Qs Qh]
jonnycongo: folds=20
gdep1979: folds=20
Mr. Deguello: calls 1400
JJin91: raises 2800 to 4200
Bullets4Rick: folds=20
Mr. Deguello: calls 2800
*** FLOP *** [5s 2s As]
JJin91: checks=20
Mr. Deguello: checks=20
*** TURN *** [5s 2s As] [7s]
JJin91: bets 6085
Mr. Deguello: folds=20
Uncalled bet (6085) returned to JJin91
JJin91 collected 10675 from pot
JJin91: doesn't show hand=20
*** SUMMARY ***
Total pot 10675 | Rake 0=20
Board [5s 2s As 7s]
Seat 1: jonnycongo folded before Flop (didn't bet)
Seat 2: gdep1979 folded before Flop (didn't bet)
Seat 4: Mr. Deguello (button) folded on the Turn
Seat 5: JJin91 (small blind) collected (10675)
Seat 6: Bullets4Rick (big blind) folded before Flop


*********** # 177 **************
PokerStars Hand #169873284284: Tournament #1622537329, $13.50+$1.50 USD=
 Hold'em No Limit - Level XVII (700/1400) - 2017/05/14 16:37:33 ET
Table '1622537329 2' 6-max Seat #5 is the button
Seat 1: jonnycongo (79229 in chips)=20
Seat 2: gdep1979 (160764 in chips)=20
Seat 4: Mr. Deguello (111089 in chips)=20
Seat 5: JJin91 (35572 in chips)=20
Seat 6: Bullets4Rick (37298 in chips)=20
jonnycongo: posts the ante 175
gdep1979: posts the ante 175
Mr. Deguello: posts the ante 175
JJin91: posts the ante 175
Bullets4Rick: posts the ante 175
Bullets4Rick: posts small blind 700
jonnycongo: posts big blind 1400
*** HOLE CARDS ***
Dealt to JJin91 [2c Ks]
gdep1979: folds=20
Mr. Deguello: raises 1400 to 2800
JJin91: folds=20
Bullets4Rick: folds=20
jonnycongo: folds=20
Uncalled bet (1400) returned to Mr. Deguello
Mr. Deguello collected 4375 from pot
Mr. Deguello: doesn't show hand=20
*** SUMMARY ***
Total pot 4375 | Rake 0=20
Seat 1: jonnycongo (big blind) folded before Flop
Seat 2: gdep1979 folded before Flop (didn't bet)
Seat 4: Mr. Deguello collected (4375)
Seat 5: JJin91 (button) folded before Flop (didn't bet)
Seat 6: Bullets4Rick (small blind) folded before Flop


*********** # 178 **************
PokerStars Hand #169873284389: Tournament #1622537329, $13.50+$1.50 USD=
 Hold'em No Limit - Level XVIII (800/1600) - 2017/05/14 16:37:59 ET
Table '1622537329 2' 6-max Seat #6 is the button
Seat 1: jonnycongo (77654 in chips)=20
Seat 2: gdep1979 (160589 in chips)=20
Seat 4: Mr. Deguello (113889 in chips)=20
Seat 5: JJin91 (35397 in chips)=20
Seat 6: Bullets4Rick (36423 in chips)=20
jonnycongo: posts the ante 200
gdep1979: posts the ante 200
Mr. Deguello: posts the ante 200
JJin91: posts the ante 200
Bullets4Rick: posts the ante 200
jonnycongo: posts small blind 800
gdep1979: posts big blind 1600
*** HOLE CARDS ***
Dealt to JJin91 [8d 8s]
Mr. Deguello: folds=20
JJin91: raises 1904 to 3504
Bullets4Rick: folds=20
jonnycongo: folds=20
gdep1979: folds=20
Uncalled bet (1904) returned to JJin91
JJin91 collected 5000 from pot
JJin91: doesn't show hand=20
*** SUMMARY ***
Total pot 5000 | Rake 0=20
Seat 1: jonnycongo (small blind) folded before Flop
Seat 2: gdep1979 (big blind) folded before Flop
Seat 4: Mr. Deguello folded before Flop (didn't bet)
Seat 5: JJin91 collected (5000)
Seat 6: Bullets4Rick (button) folded before Flop (didn't bet)


*********** # 179 **************
PokerStars Hand #169873284493: Tournament #1622537329, $13.50+$1.50 USD=
 Hold'em No Limit - Level XVIII (800/1600) - 2017/05/14 16:38:25 ET
Table '1622537329 2' 6-max Seat #1 is the button
Seat 1: jonnycongo (76654 in chips)=20
Seat 2: gdep1979 (158789 in chips)=20
Seat 4: Mr. Deguello (113689 in chips)=20
Seat 5: JJin91 (38597 in chips)=20
Seat 6: Bullets4Rick (36223 in chips)=20
jonnycongo: posts the ante 200
gdep1979: posts the ante 200
Mr. Deguello: posts the ante 200
JJin91: posts the ante 200
Bullets4Rick: posts the ante 200
gdep1979: posts small blind 800
Mr. Deguello: posts big blind 1600
*** HOLE CARDS ***
Dealt to JJin91 [Ts Qd]
JJin91: folds=20
Bullets4Rick: folds=20
jonnycongo: raises 3200 to 4800
gdep1979: folds=20
Mr. Deguello: folds=20
Uncalled bet (3200) returned to jonnycongo
jonnycongo collected 5000 from pot
*** SUMMARY ***
Total pot 5000 | Rake 0=20
Seat 1: jonnycongo (button) collected (5000)
Seat 2: gdep1979 (small blind) folded before Flop
Seat 4: Mr. Deguello (big blind) folded before Flop
Seat 5: JJin91 folded before Flop (didn't bet)
Seat 6: Bullets4Rick folded before Flop (didn't bet)


*********** # 180 **************
PokerStars Hand #169873284602: Tournament #1622537329, $13.50+$1.50 USD=
 Hold'em No Limit - Level XVIII (800/1600) - 2017/05/14 16:38:53 ET
Table '1622537329 2' 6-max Seat #2 is the button
Seat 1: jonnycongo (79854 in chips)=20
Seat 2: gdep1979 (157789 in chips)=20
Seat 4: Mr. Deguello (111889 in chips)=20
Seat 5: JJin91 (38397 in chips)=20
Seat 6: Bullets4Rick (36023 in chips)=20
jonnycongo: posts the ante 200
gdep1979: posts the ante 200
Mr. Deguello: posts the ante 200
JJin91: posts the ante 200
Bullets4Rick: posts the ante 200
Mr. Deguello: posts small blind 800
JJin91: posts big blind 1600
*** HOLE CARDS ***
Dealt to JJin91 [4c Ts]
Bullets4Rick: calls 1600
jonnycongo: folds=20
gdep1979: folds=20
Mr. Deguello: raises 1600 to 3200
JJin91: folds=20
Bullets4Rick: calls 1600
*** FLOP *** [As Js 9d]
Mr. Deguello: bets 3200
Bullets4Rick: calls 3200
*** TURN *** [As Js 9d] [5h]
Mr. Deguello: bets 3200
Bullets4Rick: calls 3200
*** RIVER *** [As Js 9d 5h] [Ad]
Mr. Deguello: bets 11200
Bullets4Rick: folds=20
Uncalled bet (11200) returned to Mr. Deguello
Mr. Deguello collected 21800 from pot
Mr. Deguello: doesn't show hand=20
*** SUMMARY ***
Total pot 21800 | Rake 0=20
Board [As Js 9d 5h Ad]
Seat 1: jonnycongo folded before Flop (didn't bet)
Seat 2: gdep1979 (button) folded before Flop (didn't bet)
Seat 4: Mr. Deguello (small blind) collected (21800)
Seat 5: JJin91 (big blind) folded before Flop
Seat 6: Bullets4Rick folded on the River


*********** # 181 **************
PokerStars Hand #169873284842: Tournament #1622537329, $13.50+$1.50 USD=
 Hold'em No Limit - Level XVIII (800/1600) - 2017/05/14 16:40:00 ET
Table '1622537329 2' 6-max Seat #4 is the button
Seat 1: jonnycongo (79654 in chips)=20
Seat 2: gdep1979 (157589 in chips)=20
Seat 4: Mr. Deguello (123889 in chips)=20
Seat 5: JJin91 (36597 in chips)=20
Seat 6: Bullets4Rick (26223 in chips)=20
jonnycongo: posts the ante 200
gdep1979: posts the ante 200
Mr. Deguello: posts the ante 200
JJin91: posts the ante 200
Bullets4Rick: posts the ante 200
JJin91: posts small blind 800
Bullets4Rick: posts big blind 1600
*** HOLE CARDS ***
Dealt to JJin91 [5c Kh]
jonnycongo: folds=20
gdep1979: folds=20
Mr. Deguello: folds=20
JJin91: folds=20
Uncalled bet (800) returned to Bullets4Rick
Bullets4Rick collected 2600 from pot
*** SUMMARY ***
Total pot 2600 | Rake 0=20
Seat 1: jonnycongo folded before Flop (didn't bet)
Seat 2: gdep1979 folded before Flop (didn't bet)
Seat 4: Mr. Deguello (button) folded before Flop (didn't bet)
Seat 5: JJin91 (small blind) folded before Flop
Seat 6: Bullets4Rick (big blind) collected (2600)


*********** # 182 **************
PokerStars Hand #169873284930: Tournament #1622537329, $13.50+$1.50 USD=
 Hold'em No Limit - Level XVIII (800/1600) - 2017/05/14 16:40:25 ET
Table '1622537329 2' 6-max Seat #5 is the button
Seat 1: jonnycongo (79454 in chips)=20
Seat 2: gdep1979 (157389 in chips)=20
Seat 4: Mr. Deguello (123689 in chips)=20
Seat 5: JJin91 (35597 in chips)=20
Seat 6: Bullets4Rick (27823 in chips)=20
jonnycongo: posts the ante 200
gdep1979: posts the ante 200
Mr. Deguello: posts the ante 200
JJin91: posts the ante 200
Bullets4Rick: posts the ante 200
Bullets4Rick: posts small blind 800
jonnycongo: posts big blind 1600
*** HOLE CARDS ***
Dealt to JJin91 [Jc 7c]
gdep1979: folds=20
Mr. Deguello: folds=20
JJin91: raises 1904 to 3504
Bullets4Rick: folds=20
jonnycongo: folds=20
Uncalled bet (1904) returned to JJin91
JJin91 collected 5000 from pot
JJin91: doesn't show hand=20
*** SUMMARY ***
Total pot 5000 | Rake 0=20
Seat 1: jonnycongo (big blind) folded before Flop
Seat 2: gdep1979 folded before Flop (didn't bet)
Seat 4: Mr. Deguello folded before Flop (didn't bet)
Seat 5: JJin91 (button) collected (5000)
Seat 6: Bullets4Rick (small blind) folded before Flop


*********** # 183 **************
PokerStars Hand #169873285024: Tournament #1622537329, $13.50+$1.50 USD=
 Hold'em No Limit - Level XVIII (800/1600) - 2017/05/14 16:40:50 ET
Table '1622537329 2' 6-max Seat #6 is the button
Seat 1: jonnycongo (77654 in chips)=20
Seat 2: gdep1979 (157189 in chips)=20
Seat 4: Mr. Deguello (123489 in chips)=20
Seat 5: JJin91 (38797 in chips)=20
Seat 6: Bullets4Rick (26823 in chips)=20
jonnycongo: posts the ante 200
gdep1979: posts the ante 200
Mr. Deguello: posts the ante 200
JJin91: posts the ante 200
Bullets4Rick: posts the ante 200
jonnycongo: posts small blind 800
gdep1979: posts big blind 1600
*** HOLE CARDS ***
Dealt to JJin91 [4s 4h]
Mr. Deguello: calls 1600
JJin91: calls 1600
Bullets4Rick: folds=20
jonnycongo: folds=20
gdep1979: checks=20
*** FLOP *** [3c Ts Ah]
gdep1979: checks=20
Mr. Deguello: checks=20
JJin91: checks=20
*** TURN *** [3c Ts Ah] [3s]
gdep1979: bets 3200
Mr. Deguello: calls 3200
JJin91: raises 6400 to 9600
gdep1979: calls 6400
Mr. Deguello: folds=20
*** RIVER *** [3c Ts Ah 3s] [5c]
gdep1979: checks=20
JJin91: checks=20
*** SHOW DOWN ***
gdep1979: shows [8d Ad] (two pair, Aces and Threes)
JJin91: mucks hand=20
gdep1979 collected 29000 from pot
*** SUMMARY ***
Total pot 29000 | Rake 0=20
Board [3c Ts Ah 3s 5c]
Seat 1: jonnycongo (small blind) folded before Flop
Seat 2: gdep1979 (big blind) showed [8d Ad] and won (29000) with two pa=
ir, Aces and Threes
Seat 4: Mr. Deguello folded on the Turn
Seat 5: JJin91 mucked [4s 4h]
Seat 6: Bullets4Rick (button) folded before Flop (didn't bet)


*********** # 184 **************
PokerStars Hand #169873285269: Tournament #1622537329, $13.50+$1.50 USD=
 Hold'em No Limit - Level XVIII (800/1600) - 2017/05/14 16:41:50 ET
Table '1622537329 2' 6-max Seat #1 is the button
Seat 1: jonnycongo (76654 in chips)=20
Seat 2: gdep1979 (174789 in chips)=20
Seat 4: Mr. Deguello (118489 in chips)=20
Seat 5: JJin91 (27397 in chips)=20
Seat 6: Bullets4Rick (26623 in chips)=20
jonnycongo: posts the ante 200
gdep1979: posts the ante 200
Mr. Deguello: posts the ante 200
JJin91: posts the ante 200
Bullets4Rick: posts the ante 200
gdep1979: posts small blind 800
Mr. Deguello: posts big blind 1600
*** HOLE CARDS ***
Dealt to JJin91 [Ah 8h]
JJin91: raises 1904 to 3504
Bullets4Rick: folds=20
jonnycongo: folds=20
gdep1979: folds=20
Mr. Deguello: folds=20
Uncalled bet (1904) returned to JJin91
JJin91 collected 5000 from pot
JJin91: doesn't show hand=20
*** SUMMARY ***
Total pot 5000 | Rake 0=20
Seat 1: jonnycongo (button) folded before Flop (didn't bet)
Seat 2: gdep1979 (small blind) folded before Flop
Seat 4: Mr. Deguello (big blind) folded before Flop
Seat 5: JJin91 collected (5000)
Seat 6: Bullets4Rick folded before Flop (didn't bet)


*********** # 185 **************
PokerStars Hand #169873285317: Tournament #1622537329, $13.50+$1.50 USD=
 Hold'em No Limit - Level XVIII (800/1600) - 2017/05/14 16:42:01 ET
Table '1622537329 2' 6-max Seat #2 is the button
Seat 1: jonnycongo (76454 in chips)=20
Seat 2: gdep1979 (173789 in chips)=20
Seat 4: Mr. Deguello (116689 in chips)=20
Seat 5: JJin91 (30597 in chips)=20
Seat 6: Bullets4Rick (26423 in chips)=20
jonnycongo: posts the ante 200
gdep1979: posts the ante 200
Mr. Deguello: posts the ante 200
JJin91: posts the ante 200
Bullets4Rick: posts the ante 200
Mr. Deguello: posts small blind 800
JJin91: posts big blind 1600
*** HOLE CARDS ***
Dealt to JJin91 [3s 7d]
Bullets4Rick: folds=20
jonnycongo: raises 1600 to 3200
gdep1979: folds=20
Mr. Deguello: folds=20
JJin91: folds=20
Uncalled bet (1600) returned to jonnycongo
jonnycongo collected 5000 from pot
*** SUMMARY ***
Total pot 5000 | Rake 0=20
Seat 1: jonnycongo collected (5000)
Seat 2: gdep1979 (button) folded before Flop (didn't bet)
Seat 4: Mr. Deguello (small blind) folded before Flop
Seat 5: JJin91 (big blind) folded before Flop
Seat 6: Bullets4Rick folded before Flop (didn't bet)


*********** # 186 **************
PokerStars Hand #169873285383: Tournament #1622537329, $13.50+$1.50 USD=
 Hold'em No Limit - Level XVIII (800/1600) - 2017/05/14 16:42:19 ET
Table '1622537329 2' 6-max Seat #4 is the button
Seat 1: jonnycongo (79654 in chips)=20
Seat 2: gdep1979 (173589 in chips)=20
Seat 4: Mr. Deguello (115689 in chips)=20
Seat 5: JJin91 (28797 in chips)=20
Seat 6: Bullets4Rick (26223 in chips)=20
jonnycongo: posts the ante 200
gdep1979: posts the ante 200
Mr. Deguello: posts the ante 200
JJin91: posts the ante 200
Bullets4Rick: posts the ante 200
JJin91: posts small blind 800
Bullets4Rick: posts big blind 1600
*** HOLE CARDS ***
Dealt to JJin91 [Qs 5c]
jonnycongo: folds=20
gdep1979: raises 1600 to 3200
Mr. Deguello: calls 3200
JJin91: folds=20
Bullets4Rick: folds=20
*** FLOP *** [2h 8d 3s]
gdep1979: bets 4800
Mr. Deguello: folds=20
Uncalled bet (4800) returned to gdep1979
gdep1979 collected 9800 from pot
gdep1979: doesn't show hand=20
*** SUMMARY ***
Total pot 9800 | Rake 0=20
Board [2h 8d 3s]
Seat 1: jonnycongo folded before Flop (didn't bet)
Seat 2: gdep1979 collected (9800)
Seat 4: Mr. Deguello (button) folded on the Flop
Seat 5: JJin91 (small blind) folded before Flop
Seat 6: Bullets4Rick (big blind) folded before Flop


*********** # 187 **************
PokerStars Hand #169873285474: Tournament #1622537329, $13.50+$1.50 USD=
 Hold'em No Limit - Level XVIII (800/1600) - 2017/05/14 16:42:43 ET
Table '1622537329 2' 6-max Seat #5 is the button
Seat 1: jonnycongo (79454 in chips)=20
Seat 2: gdep1979 (179989 in chips)=20
Seat 4: Mr. Deguello (112289 in chips)=20
Seat 5: JJin91 (27797 in chips)=20
Seat 6: Bullets4Rick (24423 in chips)=20
jonnycongo: posts the ante 200
gdep1979: posts the ante 200
Mr. Deguello: posts the ante 200
JJin91: posts the ante 200
Bullets4Rick: posts the ante 200
Bullets4Rick: posts small blind 800
jonnycongo: posts big blind 1600
*** HOLE CARDS ***
Dealt to JJin91 [9d 7d]
gdep1979: folds=20
Mr. Deguello: folds=20
JJin91: folds=20
Bullets4Rick: calls 800
jonnycongo: checks=20
*** FLOP *** [9s 4s 7s]
Bullets4Rick: bets 1600
jonnycongo: folds=20
Uncalled bet (1600) returned to Bullets4Rick
Bullets4Rick collected 4200 from pot
*** SUMMARY ***
Total pot 4200 | Rake 0=20
Board [9s 4s 7s]
Seat 1: jonnycongo (big blind) folded on the Flop
Seat 2: gdep1979 folded before Flop (didn't bet)
Seat 4: Mr. Deguello folded before Flop (didn't bet)
Seat 5: JJin91 (button) folded before Flop (didn't bet)
Seat 6: Bullets4Rick (small blind) collected (4200)


*********** # 188 **************
PokerStars Hand #169873285577: Tournament #1622537329, $13.50+$1.50 USD=
 Hold'em No Limit - Level XVIII (800/1600) - 2017/05/14 16:43:12 ET
Table '1622537329 2' 6-max Seat #6 is the button
Seat 1: jonnycongo (77654 in chips)=20
Seat 2: gdep1979 (179789 in chips)=20
Seat 4: Mr. Deguello (112089 in chips)=20
Seat 5: JJin91 (27597 in chips)=20
Seat 6: Bullets4Rick (26823 in chips)=20
jonnycongo: posts the ante 200
gdep1979: posts the ante 200
Mr. Deguello: posts the ante 200
JJin91: posts the ante 200
Bullets4Rick: posts the ante 200
jonnycongo: posts small blind 800
gdep1979: posts big blind 1600
*** HOLE CARDS ***
Dealt to JJin91 [4h 7c]
Mr. Deguello: raises 1600 to 3200
JJin91: folds=20
Bullets4Rick: folds=20
jonnycongo: folds=20
gdep1979: raises 4800 to 8000
Mr. Deguello: calls 4800
*** FLOP *** [9s 9d Td]
gdep1979: bets 4800
Mr. Deguello: raises 27200 to 32000
gdep1979: raises 81800 to 113800
Mr. Deguello: calls 71889 and is all-in
Uncalled bet (9911) returned to gdep1979
*** TURN *** [9s 9d Td] [6d]
*** RIVER *** [9s 9d Td 6d] [Ks]
*** SHOW DOWN ***
gdep1979: shows [Ad Ac] (two pair, Aces and Nines)
Mr. Deguello: shows [Tc Jd] (two pair, Tens and Nines)
gdep1979 collected 225578 from pot
Mr. Deguello finished the tournament in 13th place and received $20.88.
*** SUMMARY ***
Total pot 225578 | Rake 0=20
Board [9s 9d Td 6d Ks]
Seat 1: jonnycongo (small blind) folded before Flop
Seat 2: gdep1979 (big blind) showed [Ad Ac] and won (225578) with two p=
air, Aces and Nines
Seat 4: Mr. Deguello showed [Tc Jd] and lost with two pair, Tens and Ni=
nes
Seat 5: JJin91 folded before Flop (didn't bet)
Seat 6: Bullets4Rick (button) folded before Flop (didn't bet)


*********** # 189 **************
PokerStars Hand #169873285972: Tournament #1622537329, $13.50+$1.50 USD=
 Hold'em No Limit - Level XVIII (800/1600) - 2017/05/14 16:44:48 ET
Table '1622537329 8' 6-max Seat #5 is the button
Seat 1: JJin91 (27397 in chips)=20
Seat 2: thanutz001 (89118 in chips)=20
Seat 3: Bullets4Rick (26623 in chips)=20
Seat 4: bpruckowski1 (82072 in chips)=20
Seat 5: proletariat5 (130310 in chips)=20
Seat 6: Mo5391 (178662 in chips)=20
JJin91: posts the ante 200
thanutz001: posts the ante 200
Bullets4Rick: posts the ante 200
bpruckowski1: posts the ante 200
proletariat5: posts the ante 200
Mo5391: posts the ante 200
Mo5391: posts small blind 800
JJin91: posts big blind 1600
*** HOLE CARDS ***
Dealt to JJin91 [4c 8h]
thanutz001: folds=20
Bullets4Rick: folds=20
bpruckowski1: calls 1600
proletariat5: folds=20
Mo5391: raises 1600 to 3200
JJin91: folds=20
bpruckowski1: calls 1600
*** FLOP *** [7s Ad 2s]
Mo5391: bets 1600
bpruckowski1: calls 1600
*** TURN *** [7s Ad 2s] [7c]
Mo5391: checks=20
bpruckowski1: bets 3200
Mo5391: folds=20
Uncalled bet (3200) returned to bpruckowski1
bpruckowski1 collected 12400 from pot
bpruckowski1: doesn't show hand=20
*** SUMMARY ***
Total pot 12400 | Rake 0=20
Board [7s Ad 2s 7c]
Seat 1: JJin91 (big blind) folded before Flop
Seat 2: thanutz001 folded before Flop (didn't bet)
Seat 3: Bullets4Rick folded before Flop (didn't bet)
Seat 4: bpruckowski1 collected (12400)
Seat 5: proletariat5 (button) folded before Flop (didn't bet)
Seat 6: Mo5391 (small blind) folded on the Turn


*********** # 190 **************
PokerStars Hand #169873286106: Tournament #1622537329, $13.50+$1.50 USD=
 Hold'em No Limit - Level XVIII (800/1600) - 2017/05/14 16:45:24 ET
Table '1622537329 8' 6-max Seat #6 is the button
Seat 1: JJin91 (25597 in chips)=20
Seat 2: thanutz001 (88918 in chips)=20
Seat 3: Bullets4Rick (26423 in chips)=20
Seat 4: bpruckowski1 (89472 in chips)=20
Seat 5: proletariat5 (130110 in chips)=20
Seat 6: Mo5391 (173662 in chips)=20
JJin91: posts the ante 200
thanutz001: posts the ante 200
Bullets4Rick: posts the ante 200
bpruckowski1: posts the ante 200
proletariat5: posts the ante 200
Mo5391: posts the ante 200
JJin91: posts small blind 800
thanutz001: posts big blind 1600
*** HOLE CARDS ***
Dealt to JJin91 [7h Jh]
Bullets4Rick: calls 1600
bpruckowski1: folds=20
proletariat5: folds=20
Mo5391: calls 1600
JJin91: calls 800
thanutz001: checks=20
*** FLOP *** [6c Jc 8s]
JJin91: checks=20
thanutz001: checks=20
Bullets4Rick: checks=20
Mo5391: bets 3800
JJin91: raises 19997 to 23797 and is all-in
thanutz001: folds=20
Bullets4Rick: folds=20
Mo5391: calls 19997
*** TURN *** [6c Jc 8s] [9c]
*** RIVER *** [6c Jc 8s 9c] [5c]
*** SHOW DOWN ***
JJin91: shows [7h Jh] (a straight, Five to Nine)
Mo5391: shows [Kc Js] (a flush, King high)
Mo5391 collected 55194 from pot
JJin91 finished the tournament in 10th place and received $34.53.
*** SUMMARY ***
Total pot 55194 | Rake 0=20
Board [6c Jc 8s 9c 5c]
Seat 1: JJin91 (small blind) showed [7h Jh] and lost with a straight, F=
ive to Nine
Seat 2: thanutz001 (big blind) folded on the Flop
Seat 3: Bullets4Rick folded on the Flop
Seat 4: bpruckowski1 folded before Flop (didn't bet)
Seat 5: proletariat5 folded before Flop (didn't bet)
Seat 6: Mo5391 (button) showed [Kc Js] and won (55194) with a flush, Ki=
ng high



If you have any questions, please contact us at "PokerStars Support" <s=
upport@pokerstarsnj.com>


