Transcript for tournament #1648956862 requested by JJin91 (jamiejin91@g=
mail.com)

*********** # 1 **************
PokerStars Hand #171703445326: Tournament #1648956862, $4.55+$0.45 USD =
Hold'em No Limit - Level VI (75/150) - 2017/06/25 21:29:02 ET
Table '1648956862 2' 9-max Seat #3 is the button
Seat 1: Super Donk54 (12120 in chips)=20
Seat 2: rollthedicer (8430 in chips)=20
Seat 3: DaGr8Gatzby (20890 in chips)=20
Seat 4: CHAD9DW (8350 in chips)=20
Seat 6: phillies1158 (10435 in chips)=20
Seat 7: JJin91 (10000 in chips)=20
Seat 8: TrademarkTer (11165 in chips)=20
Seat 9: giant122457 (18640 in chips)=20
Super Donk54: posts the ante 20
rollthedicer: posts the ante 20
DaGr8Gatzby: posts the ante 20
CHAD9DW: posts the ante 20
phillies1158: posts the ante 20
JJin91: posts the ante 20
TrademarkTer: posts the ante 20
giant122457: posts the ante 20
CHAD9DW: posts small blind 75
phillies1158: posts big blind 150
*** HOLE CARDS ***
Dealt to JJin91 [Ad Jd]
JJin91: raises 166 to 316
TrademarkTer: calls 316
giant122457: folds=20
Super Donk54: folds=20
rollthedicer: folds=20
DaGr8Gatzby: folds=20
CHAD9DW: folds=20
phillies1158: calls 166
*** FLOP *** [Ts 8h 6d]
phillies1158: checks=20
JJin91: checks=20
TrademarkTer: checks=20
*** TURN *** [Ts 8h 6d] [7d]
phillies1158: checks=20
JJin91: bets 777
TrademarkTer said, "I think I better uh go all in"
TrademarkTer: raises 10052 to 10829 and is all-in
phillies1158: folds=20
JJin91: calls 8887 and is all-in
Uncalled bet (1165) returned to TrademarkTer
*** RIVER *** [Ts 8h 6d 7d] [Tc]
*** SHOW DOWN ***
JJin91: shows [Ad Jd] (a pair of Tens)
TrademarkTer: shows [9d 8c] (a straight, Six to Ten)
TrademarkTer collected 20511 from pot
JJin91 finished the tournament in 113th place
*** SUMMARY ***
Total pot 20511 | Rake 0=20
Board [Ts 8h 6d 7d Tc]
Seat 1: Super Donk54 folded before Flop (didn't bet)
Seat 2: rollthedicer folded before Flop (didn't bet)
Seat 3: DaGr8Gatzby (button) folded before Flop (didn't bet)
Seat 4: CHAD9DW (small blind) folded before Flop
Seat 6: phillies1158 (big blind) folded on the Turn
Seat 7: JJin91 showed [Ad Jd] and lost with a pair of Tens
Seat 8: TrademarkTer showed [9d 8c] and won (20511) with a straight, Si=
x to Ten
Seat 9: giant122457 folded before Flop (didn't bet)


*********** # 2 **************
PokerStars Hand #171703445900: Tournament #1648956862, $4.55+$0.45 USD =
Hold'em No Limit - Level VII (100/200) - 2017/06/25 21:30:59 ET
Table '1648956862 2' 9-max Seat #6 is the button
Seat 1: Super Donk54 (12080 in chips)=20
Seat 2: rollthedicer (8390 in chips)=20
Seat 3: DaGr8Gatzby (20850 in chips)=20
Seat 4: CHAD9DW (7335 in chips)=20
Seat 6: phillies1158 (10004 in chips)=20
Seat 7: JJin91 (10000 in chips) out of hand (moved from another table i=
nto small blind)
Seat 8: TrademarkTer (22771 in chips)=20
Seat 9: giant122457 (18600 in chips)=20
Super Donk54: posts the ante 25
rollthedicer: posts the ante 25
DaGr8Gatzby: posts the ante 25
CHAD9DW: posts the ante 25
phillies1158: posts the ante 25
TrademarkTer: posts the ante 25
giant122457: posts the ante 25
TrademarkTer: posts small blind 100
giant122457: posts big blind 200
*** HOLE CARDS ***
Super Donk54: raises 200 to 400
rollthedicer: folds=20
DaGr8Gatzby: raises 400 to 800
CHAD9DW: folds=20
phillies1158: folds=20
TrademarkTer: folds=20
giant122457: folds=20
Super Donk54: calls 400
*** FLOP *** [9s 6s 4c]
Super Donk54: checks=20
DaGr8Gatzby: bets 1200
Super Donk54: calls 1200
*** TURN *** [9s 6s 4c] [Tc]
Super Donk54: checks=20
DaGr8Gatzby: checks=20
*** RIVER *** [9s 6s 4c Tc] [9c]
Super Donk54: checks=20
DaGr8Gatzby: checks=20
*** SHOW DOWN ***
Super Donk54: shows [7c 7h] (two pair, Nines and Sevens)
DaGr8Gatzby: shows [Ks Kh] (two pair, Kings and Nines)
DaGr8Gatzby collected 4475 from pot
*** SUMMARY ***
Total pot 4475 | Rake 0=20
Board [9s 6s 4c Tc 9c]
Seat 1: Super Donk54 showed [7c 7h] and lost with two pair, Nines and S=
evens
Seat 2: rollthedicer folded before Flop (didn't bet)
Seat 3: DaGr8Gatzby showed [Ks Kh] and won (4475) with two pair, Kings =
and Nines
Seat 4: CHAD9DW folded before Flop (didn't bet)
Seat 6: phillies1158 (button) folded before Flop (didn't bet)
Seat 8: TrademarkTer (small blind) folded before Flop
Seat 9: giant122457 (big blind) folded before Flop


*********** # 3 **************
PokerStars Hand #171703446096: Tournament #1648956862, $4.55+$0.45 USD =
Hold'em No Limit - Level VII (100/200) - 2017/06/25 21:31:40 ET
Table '1648956862 2' 9-max Seat #8 is the button
Seat 1: Super Donk54 (10055 in chips)=20
Seat 2: rollthedicer (8365 in chips)=20
Seat 3: DaGr8Gatzby (23300 in chips)=20
Seat 4: CHAD9DW (7310 in chips)=20
Seat 6: phillies1158 (9979 in chips)=20
Seat 7: JJin91 (10000 in chips)=20
Seat 8: TrademarkTer (22646 in chips)=20
Seat 9: giant122457 (18375 in chips)=20
Super Donk54: posts the ante 25
rollthedicer: posts the ante 25
DaGr8Gatzby: posts the ante 25
CHAD9DW: posts the ante 25
phillies1158: posts the ante 25
JJin91: posts the ante 25
TrademarkTer: posts the ante 25
giant122457: posts the ante 25
giant122457: posts small blind 100
Super Donk54: posts big blind 200
*** HOLE CARDS ***
Dealt to JJin91 [Jh Td]
rollthedicer: calls 200
DaGr8Gatzby: folds=20
CHAD9DW: folds=20
phillies1158: folds=20
JJin91: folds=20
TrademarkTer: calls 200
giant122457: folds=20
Super Donk54: checks=20
*** FLOP *** [2c 5h Qc]
Super Donk54: bets 200
rollthedicer: calls 200
TrademarkTer said, "I like the bet of 200, but I think I better, uh, go=
 all in"
TrademarkTer: raises 22221 to 22421 and is all-in
Super Donk54: folds=20
rollthedicer: folds=20
Uncalled bet (22221) returned to TrademarkTer
TrademarkTer collected 1500 from pot
*** SUMMARY ***
Total pot 1500 | Rake 0=20
Board [2c 5h Qc]
Seat 1: Super Donk54 (big blind) folded on the Flop
Seat 2: rollthedicer folded on the Flop
Seat 3: DaGr8Gatzby folded before Flop (didn't bet)
Seat 4: CHAD9DW folded before Flop (didn't bet)
Seat 6: phillies1158 folded before Flop (didn't bet)
Seat 7: JJin91 folded before Flop (didn't bet)
Seat 8: TrademarkTer (button) collected (1500)
Seat 9: giant122457 (small blind) folded before Flop


*********** # 4 **************
PokerStars Hand #171703446361: Tournament #1648956862, $4.55+$0.45 USD =
Hold'em No Limit - Level VII (100/200) - 2017/06/25 21:32:42 ET
Table '1648956862 2' 9-max Seat #9 is the button
Seat 1: Super Donk54 (9630 in chips)=20
Seat 2: rollthedicer (7940 in chips)=20
Seat 3: DaGr8Gatzby (23275 in chips)=20
Seat 4: CHAD9DW (7285 in chips)=20
Seat 6: phillies1158 (9954 in chips)=20
Seat 7: JJin91 (9975 in chips)=20
Seat 8: TrademarkTer (23721 in chips)=20
Seat 9: giant122457 (18250 in chips)=20
Super Donk54: posts the ante 25
rollthedicer: posts the ante 25
DaGr8Gatzby: posts the ante 25
CHAD9DW: posts the ante 25
phillies1158: posts the ante 25
JJin91: posts the ante 25
TrademarkTer: posts the ante 25
giant122457: posts the ante 25
Super Donk54: posts small blind 100
rollthedicer: posts big blind 200
*** HOLE CARDS ***
Dealt to JJin91 [5h Qc]
DaGr8Gatzby: folds=20
CHAD9DW: folds=20
Super Donk54 said, "middle pair bet :)"
phillies1158: folds=20
JJin91: folds=20
TrademarkTer: folds=20
giant122457: folds=20
Super Donk54: folds=20
Uncalled bet (100) returned to rollthedicer
rollthedicer collected 400 from pot
rollthedicer: doesn't show hand=20
*** SUMMARY ***
Total pot 400 | Rake 0=20
Seat 1: Super Donk54 (small blind) folded before Flop
Seat 2: rollthedicer (big blind) collected (400)
Seat 3: DaGr8Gatzby folded before Flop (didn't bet)
Seat 4: CHAD9DW folded before Flop (didn't bet)
Seat 6: phillies1158 folded before Flop (didn't bet)
Seat 7: JJin91 folded before Flop (didn't bet)
Seat 8: TrademarkTer folded before Flop (didn't bet)
Seat 9: giant122457 (button) folded before Flop (didn't bet)


*********** # 5 **************
PokerStars Hand #171703446425: Tournament #1648956862, $4.55+$0.45 USD =
Hold'em No Limit - Level VII (100/200) - 2017/06/25 21:32:57 ET
Table '1648956862 2' 9-max Seat #1 is the button
Seat 1: Super Donk54 (9505 in chips)=20
Seat 2: rollthedicer (8215 in chips)=20
Seat 3: DaGr8Gatzby (23250 in chips)=20
Seat 4: CHAD9DW (7260 in chips)=20
Seat 6: phillies1158 (9929 in chips)=20
Seat 7: JJin91 (9950 in chips)=20
Seat 8: TrademarkTer (23696 in chips)=20
Seat 9: giant122457 (18225 in chips)=20
Super Donk54: posts the ante 25
rollthedicer: posts the ante 25
DaGr8Gatzby: posts the ante 25
CHAD9DW: posts the ante 25
phillies1158: posts the ante 25
JJin91: posts the ante 25
TrademarkTer: posts the ante 25
giant122457: posts the ante 25
rollthedicer: posts small blind 100
DaGr8Gatzby: posts big blind 200
*** HOLE CARDS ***
Dealt to JJin91 [Tc 9s]
CHAD9DW: folds=20
phillies1158: folds=20
JJin91: folds=20
TrademarkTer: folds=20
giant122457: folds=20
Super Donk54: folds=20
rollthedicer: calls 100
DaGr8Gatzby: checks=20
*** FLOP *** [Qc 2c Ts]
rollthedicer: checks=20
DaGr8Gatzby: checks=20
*** TURN *** [Qc 2c Ts] [Jd]
TrademarkTer said, "I either had a flush draw or AQ"
rollthedicer: bets 200
DaGr8Gatzby: folds=20
Uncalled bet (200) returned to rollthedicer
rollthedicer collected 600 from pot
rollthedicer: doesn't show hand=20
*** SUMMARY ***
Total pot 600 | Rake 0=20
Board [Qc 2c Ts Jd]
Seat 1: Super Donk54 (button) folded before Flop (didn't bet)
Seat 2: rollthedicer (small blind) collected (600)
Seat 3: DaGr8Gatzby (big blind) folded on the Turn
Seat 4: CHAD9DW folded before Flop (didn't bet)
Seat 6: phillies1158 folded before Flop (didn't bet)
Seat 7: JJin91 folded before Flop (didn't bet)
Seat 8: TrademarkTer folded before Flop (didn't bet)
Seat 9: giant122457 folded before Flop (didn't bet)


*********** # 6 **************
PokerStars Hand #171703446549: Tournament #1648956862, $4.55+$0.45 USD =
Hold'em No Limit - Level VII (100/200) - 2017/06/25 21:33:23 ET
Table '1648956862 2' 9-max Seat #2 is the button
Seat 1: Super Donk54 (9480 in chips)=20
Seat 2: rollthedicer (8590 in chips)=20
Seat 3: DaGr8Gatzby (23025 in chips)=20
Seat 4: CHAD9DW (7235 in chips)=20
Seat 6: phillies1158 (9904 in chips)=20
Seat 7: JJin91 (9925 in chips)=20
Seat 8: TrademarkTer (23671 in chips)=20
Seat 9: giant122457 (18200 in chips)=20
Super Donk54: posts the ante 25
rollthedicer: posts the ante 25
DaGr8Gatzby: posts the ante 25
CHAD9DW: posts the ante 25
phillies1158: posts the ante 25
JJin91: posts the ante 25
TrademarkTer: posts the ante 25
giant122457: posts the ante 25
DaGr8Gatzby: posts small blind 100
CHAD9DW: posts big blind 200
*** HOLE CARDS ***
Dealt to JJin91 [8d Qc]
phillies1158: folds=20
JJin91: folds=20
TrademarkTer: folds=20
giant122457: folds=20
Super Donk54 said, "yeah I'm not following"
Super Donk54: folds=20
rollthedicer: folds=20
DaGr8Gatzby: raises 200 to 400
CHAD9DW: folds=20
Uncalled bet (200) returned to DaGr8Gatzby
DaGr8Gatzby collected 600 from pot
DaGr8Gatzby: doesn't show hand=20
*** SUMMARY ***
Total pot 600 | Rake 0=20
Seat 1: Super Donk54 folded before Flop (didn't bet)
Seat 2: rollthedicer (button) folded before Flop (didn't bet)
Seat 3: DaGr8Gatzby (small blind) collected (600)
Seat 4: CHAD9DW (big blind) folded before Flop
Seat 6: phillies1158 folded before Flop (didn't bet)
Seat 7: JJin91 folded before Flop (didn't bet)
Seat 8: TrademarkTer folded before Flop (didn't bet)
Seat 9: giant122457 folded before Flop (didn't bet)


*********** # 7 **************
PokerStars Hand #171703446661: Tournament #1648956862, $4.55+$0.45 USD =
Hold'em No Limit - Level VII (100/200) - 2017/06/25 21:33:51 ET
Table '1648956862 2' 9-max Seat #3 is the button
Seat 1: Super Donk54 (9455 in chips)=20
Seat 2: rollthedicer (8565 in chips)=20
Seat 3: DaGr8Gatzby (23400 in chips)=20
Seat 4: CHAD9DW (7010 in chips)=20
Seat 5: jones1315 (10000 in chips)=20
Seat 6: phillies1158 (9879 in chips)=20
Seat 7: JJin91 (9900 in chips)=20
Seat 8: TrademarkTer (23646 in chips)=20
Seat 9: giant122457 (18175 in chips)=20
Super Donk54: posts the ante 25
rollthedicer: posts the ante 25
DaGr8Gatzby: posts the ante 25
CHAD9DW: posts the ante 25
jones1315: posts the ante 25
phillies1158: posts the ante 25
JJin91: posts the ante 25
TrademarkTer: posts the ante 25
giant122457: posts the ante 25
CHAD9DW: posts small blind 100
jones1315: posts big blind 200
*** HOLE CARDS ***
Dealt to JJin91 [Js 3c]
phillies1158: folds=20
JJin91: folds=20
TrademarkTer: folds=20
giant122457: folds=20
Super Donk54: folds=20
rollthedicer: folds=20
DaGr8Gatzby: folds=20
CHAD9DW: calls 100
jones1315: checks=20
*** FLOP *** [Ks 4h 2h]
CHAD9DW: checks=20
jones1315: checks=20
*** TURN *** [Ks 4h 2h] [Qc]
CHAD9DW: checks=20
jones1315: checks=20
*** RIVER *** [Ks 4h 2h Qc] [4d]
Super Donk54 said, "or just too many chips"
CHAD9DW: bets 525
jones1315: folds=20
Uncalled bet (525) returned to CHAD9DW
CHAD9DW collected 625 from pot
CHAD9DW: doesn't show hand=20
*** SUMMARY ***
Total pot 625 | Rake 0=20
Board [Ks 4h 2h Qc 4d]
Seat 1: Super Donk54 folded before Flop (didn't bet)
Seat 2: rollthedicer folded before Flop (didn't bet)
Seat 3: DaGr8Gatzby (button) folded before Flop (didn't bet)
Seat 4: CHAD9DW (small blind) collected (625)
Seat 5: jones1315 (big blind) folded on the River
Seat 6: phillies1158 folded before Flop (didn't bet)
Seat 7: JJin91 folded before Flop (didn't bet)
Seat 8: TrademarkTer folded before Flop (didn't bet)
Seat 9: giant122457 folded before Flop (didn't bet)


*********** # 8 **************
PokerStars Hand #171703446835: Tournament #1648956862, $4.55+$0.45 USD =
Hold'em No Limit - Level VII (100/200) - 2017/06/25 21:34:32 ET
Table '1648956862 2' 9-max Seat #4 is the button
Seat 1: Super Donk54 (9430 in chips)=20
Seat 2: rollthedicer (8540 in chips)=20
Seat 3: DaGr8Gatzby (23375 in chips)=20
Seat 4: CHAD9DW (7410 in chips)=20
Seat 5: jones1315 (9775 in chips)=20
Seat 7: JJin91 (9875 in chips)=20
Seat 8: TrademarkTer (23621 in chips)=20
Seat 9: giant122457 (18150 in chips)=20
Super Donk54: posts the ante 25
rollthedicer: posts the ante 25
DaGr8Gatzby: posts the ante 25
CHAD9DW: posts the ante 25
jones1315: posts the ante 25
JJin91: posts the ante 25
TrademarkTer: posts the ante 25
giant122457: posts the ante 25
jones1315: posts small blind 100
JJin91: posts big blind 200
*** HOLE CARDS ***
Dealt to JJin91 [5h Kd]
TrademarkTer: calls 200
giant122457: folds=20
Super Donk54: folds=20
rollthedicer: folds=20
DaGr8Gatzby: folds=20
CHAD9DW: calls 200
jones1315: calls 100
JJin91: checks=20
*** FLOP *** [Ac 6s Th]
jones1315: checks=20
JJin91: checks=20
TrademarkTer: checks=20
CHAD9DW: bets 600
jones1315: calls 600
JJin91: folds=20
TrademarkTer: calls 600
*** TURN *** [Ac 6s Th] [Ad]
jones1315: checks=20
TrademarkTer: checks=20
CHAD9DW: checks=20
*** RIVER *** [Ac 6s Th Ad] [7h]
jones1315: checks=20
TrademarkTer said, "I should bet"
TrademarkTer said, "Let's go something like"
TrademarkTer: bets 2000
CHAD9DW: folds=20
jones1315: folds=20
Uncalled bet (2000) returned to TrademarkTer
TrademarkTer collected 2800 from pot
*** SUMMARY ***
Total pot 2800 | Rake 0=20
Board [Ac 6s Th Ad 7h]
Seat 1: Super Donk54 folded before Flop (didn't bet)
Seat 2: rollthedicer folded before Flop (didn't bet)
Seat 3: DaGr8Gatzby folded before Flop (didn't bet)
Seat 4: CHAD9DW (button) folded on the River
Seat 5: jones1315 (small blind) folded on the River
Seat 7: JJin91 (big blind) folded on the Flop
Seat 8: TrademarkTer collected (2800)
Seat 9: giant122457 folded before Flop (didn't bet)


*********** # 9 **************
PokerStars Hand #171703447315: Tournament #1648956862, $4.55+$0.45 USD =
Hold'em No Limit - Level VIII (125/250) - 2017/06/25 21:36:22 ET
Table '1648956862 2' 9-max Seat #5 is the button
Seat 1: Super Donk54 (9405 in chips)=20
Seat 2: rollthedicer (8515 in chips)=20
Seat 3: DaGr8Gatzby (23350 in chips)=20
Seat 4: CHAD9DW (6585 in chips)=20
Seat 5: jones1315 (8950 in chips)=20
Seat 6: PetFalcon (10000 in chips) out of hand (moved from another tabl=
e into small blind)
Seat 7: JJin91 (9650 in chips)=20
Seat 8: TrademarkTer (25596 in chips)=20
Seat 9: giant122457 (18125 in chips)=20
Super Donk54: posts the ante 30
rollthedicer: posts the ante 30
DaGr8Gatzby: posts the ante 30
CHAD9DW: posts the ante 30
jones1315: posts the ante 30
JJin91: posts the ante 30
TrademarkTer: posts the ante 30
giant122457: posts the ante 30
JJin91: posts small blind 125
TrademarkTer: posts big blind 250
*** HOLE CARDS ***
Dealt to JJin91 [4h 3c]
giant122457: folds=20
Super Donk54: calls 250
rollthedicer: calls 250
DaGr8Gatzby: folds=20
CHAD9DW: calls 250
jones1315: folds=20
JJin91: folds=20
TrademarkTer: checks=20
*** FLOP *** [Qc 2h 5h]
TrademarkTer: checks=20
Super Donk54: bets 1365
rollthedicer: folds=20
CHAD9DW: folds=20
TrademarkTer: folds=20
Uncalled bet (1365) returned to Super Donk54
Super Donk54 collected 1365 from pot
Super Donk54: doesn't show hand=20
*** SUMMARY ***
Total pot 1365 | Rake 0=20
Board [Qc 2h 5h]
Seat 1: Super Donk54 collected (1365)
Seat 2: rollthedicer folded on the Flop
Seat 3: DaGr8Gatzby folded before Flop (didn't bet)
Seat 4: CHAD9DW folded on the Flop
Seat 5: jones1315 (button) folded before Flop (didn't bet)
Seat 7: JJin91 (small blind) folded before Flop
Seat 8: TrademarkTer (big blind) folded on the Flop
Seat 9: giant122457 folded before Flop (didn't bet)


*********** # 10 **************
PokerStars Hand #171703447506: Tournament #1648956862, $4.55+$0.45 USD =
Hold'em No Limit - Level VIII (125/250) - 2017/06/25 21:37:05 ET
Table '1648956862 2' 9-max Seat #7 is the button
Seat 1: Super Donk54 (10490 in chips)=20
Seat 2: rollthedicer (8235 in chips)=20
Seat 3: DaGr8Gatzby (23320 in chips)=20
Seat 4: CHAD9DW (6305 in chips)=20
Seat 5: jones1315 (8920 in chips)=20
Seat 6: PetFalcon (10000 in chips)=20
Seat 7: JJin91 (9495 in chips)=20
Seat 8: TrademarkTer (25316 in chips)=20
Seat 9: giant122457 (18095 in chips)=20
Super Donk54: posts the ante 30
rollthedicer: posts the ante 30
DaGr8Gatzby: posts the ante 30
CHAD9DW: posts the ante 30
jones1315: posts the ante 30
PetFalcon: posts the ante 30
JJin91: posts the ante 30
TrademarkTer: posts the ante 30
giant122457: posts the ante 30
TrademarkTer: posts small blind 125
giant122457: posts big blind 250
*** HOLE CARDS ***
Dealt to JJin91 [Kh Ks]
Super Donk54: folds=20
rollthedicer: folds=20
DaGr8Gatzby: raises 250 to 500
CHAD9DW: folds=20
jones1315: calls 500
PetFalcon: calls 500
JJin91: raises 1734 to 2234
TrademarkTer said, "holey moley jin"
TrademarkTer: calls 2109
giant122457: folds=20
DaGr8Gatzby: folds=20
jones1315: calls 1734
PetFalcon: folds=20
*** FLOP *** [8s 3s Td]
TrademarkTer: checks=20
jones1315: checks=20
JJin91: bets 7231 and is all-in
TrademarkTer: folds=20
jones1315: folds=20
Uncalled bet (7231) returned to JJin91
JJin91 collected 8222 from pot
JJin91: doesn't show hand=20
*** SUMMARY ***
Total pot 8222 | Rake 0=20
Board [8s 3s Td]
Seat 1: Super Donk54 folded before Flop (didn't bet)
Seat 2: rollthedicer folded before Flop (didn't bet)
Seat 3: DaGr8Gatzby folded before Flop
Seat 4: CHAD9DW folded before Flop (didn't bet)
Seat 5: jones1315 folded on the Flop
Seat 6: PetFalcon folded before Flop
Seat 7: JJin91 (button) collected (8222)
Seat 8: TrademarkTer (small blind) folded on the Flop
Seat 9: giant122457 (big blind) folded before Flop


*********** # 11 **************
PokerStars Hand #171703447812: Tournament #1648956862, $4.55+$0.45 USD =
Hold'em No Limit - Level VIII (125/250) - 2017/06/25 21:38:19 ET
Table '1648956862 2' 9-max Seat #8 is the button
Seat 1: Super Donk54 (10460 in chips)=20
Seat 2: rollthedicer (8205 in chips)=20
Seat 3: DaGr8Gatzby (22790 in chips)=20
Seat 4: CHAD9DW (6275 in chips)=20
Seat 5: jones1315 (6656 in chips)=20
Seat 6: PetFalcon (9470 in chips)=20
Seat 7: JJin91 (15453 in chips)=20
Seat 8: TrademarkTer (23052 in chips)=20
Seat 9: giant122457 (17815 in chips)=20
Super Donk54: posts the ante 30
rollthedicer: posts the ante 30
DaGr8Gatzby: posts the ante 30
CHAD9DW: posts the ante 30
jones1315: posts the ante 30
PetFalcon: posts the ante 30
JJin91: posts the ante 30
TrademarkTer: posts the ante 30
giant122457: posts the ante 30
giant122457: posts small blind 125
Super Donk54: posts big blind 250
*** HOLE CARDS ***
Dealt to JJin91 [Kh 3d]
rollthedicer: folds=20
DaGr8Gatzby: folds=20
CHAD9DW: folds=20
jones1315: folds=20
PetFalcon: raises 500 to 750
JJin91: folds=20
TrademarkTer: folds=20
giant122457: calls 625
Super Donk54: folds=20
*** FLOP *** [9h 5d 2d]
giant122457: checks=20
PetFalcon: bets 1250
giant122457: folds=20
Uncalled bet (1250) returned to PetFalcon
PetFalcon collected 2020 from pot
*** SUMMARY ***
Total pot 2020 | Rake 0=20
Board [9h 5d 2d]
Seat 1: Super Donk54 (big blind) folded before Flop
Seat 2: rollthedicer folded before Flop (didn't bet)
Seat 3: DaGr8Gatzby folded before Flop (didn't bet)
Seat 4: CHAD9DW folded before Flop (didn't bet)
Seat 5: jones1315 folded before Flop (didn't bet)
Seat 6: PetFalcon collected (2020)
Seat 7: JJin91 folded before Flop (didn't bet)
Seat 8: TrademarkTer (button) folded before Flop (didn't bet)
Seat 9: giant122457 (small blind) folded on the Flop


*********** # 12 **************
PokerStars Hand #171703448109: Tournament #1648956862, $4.55+$0.45 USD =
Hold'em No Limit - Level VIII (125/250) - 2017/06/25 21:39:29 ET
Table '1648956862 2' 9-max Seat #9 is the button
Seat 1: Super Donk54 (10180 in chips)=20
Seat 3: DaGr8Gatzby (22760 in chips)=20
Seat 4: CHAD9DW (6245 in chips)=20
Seat 5: jones1315 (6626 in chips)=20
Seat 6: PetFalcon (10710 in chips)=20
Seat 7: JJin91 (15423 in chips)=20
Seat 8: TrademarkTer (23022 in chips)=20
Seat 9: giant122457 (17035 in chips)=20
Super Donk54: posts the ante 30
DaGr8Gatzby: posts the ante 30
CHAD9DW: posts the ante 30
jones1315: posts the ante 30
PetFalcon: posts the ante 30
JJin91: posts the ante 30
TrademarkTer: posts the ante 30
giant122457: posts the ante 30
Super Donk54: posts small blind 125
DaGr8Gatzby: posts big blind 250
*** HOLE CARDS ***
Dealt to JJin91 [3c Kh]
CHAD9DW: folds=20
jones1315: folds=20
PetFalcon: folds=20
JJin91: folds=20
TrademarkTer: folds=20
giant122457: folds=20
Super Donk54: raises 740 to 990
DaGr8Gatzby: folds=20
Uncalled bet (740) returned to Super Donk54
Super Donk54 collected 740 from pot
Super Donk54: doesn't show hand=20
*** SUMMARY ***
Total pot 740 | Rake 0=20
Seat 1: Super Donk54 (small blind) collected (740)
Seat 3: DaGr8Gatzby (big blind) folded before Flop
Seat 4: CHAD9DW folded before Flop (didn't bet)
Seat 5: jones1315 folded before Flop (didn't bet)
Seat 6: PetFalcon folded before Flop (didn't bet)
Seat 7: JJin91 folded before Flop (didn't bet)
Seat 8: TrademarkTer folded before Flop (didn't bet)
Seat 9: giant122457 (button) folded before Flop (didn't bet)


*********** # 13 **************
PokerStars Hand #171703448253: Tournament #1648956862, $4.55+$0.45 USD =
Hold'em No Limit - Level VIII (125/250) - 2017/06/25 21:40:04 ET
Table '1648956862 2' 9-max Seat #1 is the button
Seat 1: Super Donk54 (10640 in chips)=20
Seat 2: Robbar211367 (10000 in chips) out of hand (moved from another t=
able into small blind)
Seat 3: DaGr8Gatzby (22480 in chips)=20
Seat 4: CHAD9DW (6215 in chips)=20
Seat 5: jones1315 (6596 in chips)=20
Seat 6: PetFalcon (10680 in chips)=20
Seat 7: JJin91 (15393 in chips)=20
Seat 8: TrademarkTer (22992 in chips)=20
Seat 9: giant122457 (17005 in chips)=20
Super Donk54: posts the ante 30
DaGr8Gatzby: posts the ante 30
CHAD9DW: posts the ante 30
jones1315: posts the ante 30
PetFalcon: posts the ante 30
JJin91: posts the ante 30
TrademarkTer: posts the ante 30
giant122457: posts the ante 30
DaGr8Gatzby: posts small blind 125
CHAD9DW: posts big blind 250
*** HOLE CARDS ***
Dealt to JJin91 [As 5h]
jones1315: folds=20
PetFalcon: raises 425 to 675
JJin91: folds=20
TrademarkTer: calls 675
giant122457: folds=20
Super Donk54: folds=20
DaGr8Gatzby: folds=20
CHAD9DW: raises 1600 to 2275
PetFalcon: folds=20
TrademarkTer said, "fine ill donk it off with ya lad"
TrademarkTer: raises 20687 to 22962 and is all-in
CHAD9DW: calls 3910 and is all-in
Uncalled bet (16777) returned to TrademarkTer
*** FLOP *** [7s 4s Ks]
*** TURN *** [7s 4s Ks] [3c]
*** RIVER *** [7s 4s Ks 3c] [Ac]
*** SHOW DOWN ***
CHAD9DW: shows [Qh Qs] (a pair of Queens)
TrademarkTer: shows [4c 4d] (three of a kind, Fours)
TrademarkTer collected 13410 from pot
CHAD9DW finished the tournament in 107th place
*** SUMMARY ***
Total pot 13410 | Rake 0=20
Board [7s 4s Ks 3c Ac]
Seat 1: Super Donk54 (button) folded before Flop (didn't bet)
Seat 3: DaGr8Gatzby (small blind) folded before Flop
Seat 4: CHAD9DW (big blind) showed [Qh Qs] and lost with a pair of Quee=
ns
Seat 5: jones1315 folded before Flop (didn't bet)
Seat 6: PetFalcon folded before Flop
Seat 7: JJin91 folded before Flop (didn't bet)
Seat 8: TrademarkTer showed [4c 4d] and won (13410) with three of a kin=
d, Fours
Seat 9: giant122457 folded before Flop (didn't bet)


*********** # 14 **************
PokerStars Hand #171703448508: Tournament #1648956862, $4.55+$0.45 USD =
Hold'em No Limit - Level IX (150/300) - 2017/06/25 21:41:02 ET
Table '1648956862 2' 9-max Seat #3 is the button
Seat 1: Super Donk54 (10610 in chips)=20
Seat 2: Robbar211367 (10000 in chips)=20
Seat 3: DaGr8Gatzby (22325 in chips)=20
Seat 5: jones1315 (6566 in chips)=20
Seat 6: PetFalcon (9975 in chips)=20
Seat 7: JJin91 (15363 in chips)=20
Seat 8: TrademarkTer (30187 in chips)=20
Seat 9: giant122457 (16975 in chips)=20
Super Donk54: posts the ante 40
Robbar211367: posts the ante 40
DaGr8Gatzby: posts the ante 40
jones1315: posts the ante 40
PetFalcon: posts the ante 40
JJin91: posts the ante 40
TrademarkTer: posts the ante 40
giant122457: posts the ante 40
jones1315: posts small blind 150
PetFalcon: posts big blind 300
*** HOLE CARDS ***
Dealt to JJin91 [5c Kd]
JJin91: folds=20
TrademarkTer: folds=20
giant122457: calls 300
Super Donk54: folds=20
Robbar211367: folds=20
DaGr8Gatzby: raises 300 to 600
jones1315: calls 450
PetFalcon: calls 300
giant122457: calls 300
*** FLOP *** [Jc 8d 4d]
jones1315: checks=20
Super Donk54 said, "fucking twins"
PetFalcon: checks=20
giant122457: checks=20
DaGr8Gatzby: checks=20
*** TURN *** [Jc 8d 4d] [Kc]
jones1315: checks=20
PetFalcon: checks=20
giant122457: checks=20
DaGr8Gatzby: checks=20
*** RIVER *** [Jc 8d 4d Kc] [5d]
jones1315: bets 900
TrademarkTer said, "im the fun one hes the serious one"
PetFalcon: folds=20
giant122457: folds=20
DaGr8Gatzby: folds=20
Uncalled bet (900) returned to jones1315
jones1315 collected 2720 from pot
jones1315: doesn't show hand=20
*** SUMMARY ***
Total pot 2720 | Rake 0=20
Board [Jc 8d 4d Kc 5d]
Seat 1: Super Donk54 folded before Flop (didn't bet)
Seat 2: Robbar211367 folded before Flop (didn't bet)
Seat 3: DaGr8Gatzby (button) folded on the River
Seat 5: jones1315 (small blind) collected (2720)
Seat 6: PetFalcon (big blind) folded on the River
Seat 7: JJin91 folded before Flop (didn't bet)
Seat 8: TrademarkTer folded before Flop (didn't bet)
Seat 9: giant122457 folded on the River


*********** # 15 **************
PokerStars Hand #171703448840: Tournament #1648956862, $4.55+$0.45 USD =
Hold'em No Limit - Level IX (150/300) - 2017/06/25 21:42:16 ET
Table '1648956862 2' 9-max Seat #5 is the button
Seat 1: Super Donk54 (10570 in chips)=20
Seat 2: Robbar211367 (9960 in chips)=20
Seat 3: DaGr8Gatzby (21685 in chips)=20
Seat 5: jones1315 (8646 in chips)=20
Seat 6: PetFalcon (9335 in chips)=20
Seat 7: JJin91 (15323 in chips)=20
Seat 8: TrademarkTer (30147 in chips)=20
Seat 9: giant122457 (16335 in chips)=20
Super Donk54: posts the ante 40
Robbar211367: posts the ante 40
DaGr8Gatzby: posts the ante 40
jones1315: posts the ante 40
PetFalcon: posts the ante 40
JJin91: posts the ante 40
TrademarkTer: posts the ante 40
giant122457: posts the ante 40
PetFalcon: posts small blind 150
JJin91: posts big blind 300
*** HOLE CARDS ***
Dealt to JJin91 [6c Ac]
TrademarkTer: folds=20
giant122457: calls 300
Super Donk54: calls 300
Robbar211367: calls 300
DaGr8Gatzby: folds=20
jones1315: raises 600 to 900
PetFalcon: folds=20
JJin91: folds=20
giant122457: calls 600
Super Donk54: calls 600
Robbar211367: calls 600
*** FLOP *** [7h 9d 4h]
giant122457: checks=20
Super Donk54: checks=20
Robbar211367: checks=20
jones1315: bets 2100
giant122457: folds=20
Super Donk54: folds=20
Robbar211367: calls 2100
*** TURN *** [7h 9d 4h] [7d]
Robbar211367: checks=20
jones1315: checks=20
*** RIVER *** [7h 9d 4h 7d] [2h]
Robbar211367: checks=20
jones1315: checks=20
*** SHOW DOWN ***
Robbar211367: shows [8c 9c] (two pair, Nines and Sevens)
jones1315: mucks hand=20
Robbar211367 collected 8570 from pot
*** SUMMARY ***
Total pot 8570 | Rake 0=20
Board [7h 9d 4h 7d 2h]
Seat 1: Super Donk54 folded on the Flop
Seat 2: Robbar211367 showed [8c 9c] and won (8570) with two pair, Nines=
 and Sevens
Seat 3: DaGr8Gatzby folded before Flop (didn't bet)
Seat 5: jones1315 (button) mucked [Qd As]
Seat 6: PetFalcon (small blind) folded before Flop
Seat 7: JJin91 (big blind) folded before Flop
Seat 8: TrademarkTer folded before Flop (didn't bet)
Seat 9: giant122457 folded on the Flop


*********** # 16 **************
PokerStars Hand #171703449199: Tournament #1648956862, $4.55+$0.45 USD =
Hold'em No Limit - Level IX (150/300) - 2017/06/25 21:43:40 ET
Table '1648956862 2' 9-max Seat #6 is the button
Seat 2: Robbar211367 (15490 in chips)=20
Seat 3: DaGr8Gatzby (21645 in chips)=20
Seat 4: CHAD9DW (10000 in chips)=20
Seat 5: jones1315 (5606 in chips)=20
Seat 6: PetFalcon (9145 in chips)=20
Seat 7: JJin91 (14983 in chips)=20
Seat 8: TrademarkTer (30107 in chips)=20
Seat 9: giant122457 (15395 in chips)=20
Robbar211367: posts the ante 40
DaGr8Gatzby: posts the ante 40
CHAD9DW: posts the ante 40
jones1315: posts the ante 40
PetFalcon: posts the ante 40
JJin91: posts the ante 40
TrademarkTer: posts the ante 40
giant122457: posts the ante 40
JJin91: posts small blind 150
TrademarkTer: posts big blind 300
*** HOLE CARDS ***
Dealt to JJin91 [5c As]
giant122457: folds=20
Robbar211367: folds=20
DaGr8Gatzby: folds=20
CHAD9DW: raises 450 to 750
jones1315: folds=20
PetFalcon: folds=20
JJin91: folds=20
TrademarkTer said, "I'm gonna repay you from earlier here chadow"
TrademarkTer: raises 29317 to 30067 and is all-in
CHAD9DW: calls 9210 and is all-in
Uncalled bet (20107) returned to TrademarkTer
*** FLOP *** [4d 2s Ad]
*** TURN *** [4d 2s Ad] [8s]
*** RIVER *** [4d 2s Ad 8s] [Kh]
*** SHOW DOWN ***
TrademarkTer: shows [Ac Kd] (two pair, Aces and Kings)
CHAD9DW: shows [Qh Kc] (a pair of Kings)
TrademarkTer collected 20390 from pot
CHAD9DW finished the tournament in 103rd place
*** SUMMARY ***
Total pot 20390 | Rake 0=20
Board [4d 2s Ad 8s Kh]
Seat 2: Robbar211367 folded before Flop (didn't bet)
Seat 3: DaGr8Gatzby folded before Flop (didn't bet)
Seat 4: CHAD9DW showed [Qh Kc] and lost with a pair of Kings
Seat 5: jones1315 folded before Flop (didn't bet)
Seat 6: PetFalcon (button) folded before Flop (didn't bet)
Seat 7: JJin91 (small blind) folded before Flop
Seat 8: TrademarkTer (big blind) showed [Ac Kd] and won (20390) with tw=
o pair, Aces and Kings
Seat 9: giant122457 folded before Flop (didn't bet)


*********** # 17 **************
PokerStars Hand #171703449363: Tournament #1648956862, $4.55+$0.45 USD =
Hold'em No Limit - Level IX (150/300) - 2017/06/25 21:44:19 ET
Table '1648956862 2' 9-max Seat #7 is the button
Seat 2: Robbar211367 (15450 in chips)=20
Seat 3: DaGr8Gatzby (21605 in chips)=20
Seat 5: jones1315 (5566 in chips)=20
Seat 6: PetFalcon (9105 in chips)=20
Seat 7: JJin91 (14793 in chips)=20
Seat 8: TrademarkTer (40497 in chips)=20
Seat 9: giant122457 (15355 in chips)=20
Robbar211367: posts the ante 40
DaGr8Gatzby: posts the ante 40
jones1315: posts the ante 40
PetFalcon: posts the ante 40
JJin91: posts the ante 40
TrademarkTer: posts the ante 40
giant122457: posts the ante 40
TrademarkTer: posts small blind 150
giant122457: posts big blind 300
*** HOLE CARDS ***
Dealt to JJin91 [Kd 3s]
Robbar211367: calls 300
DaGr8Gatzby: folds=20
jones1315: raises 600 to 900
PetFalcon: folds=20
JJin91: folds=20
TrademarkTer: folds=20
giant122457: calls 600
Robbar211367: calls 600
*** FLOP *** [6c 6s 4s]
giant122457: checks=20
Robbar211367: checks=20
jones1315: checks=20
*** TURN *** [6c 6s 4s] [Ah]
giant122457: checks=20
Robbar211367: checks=20
jones1315: checks=20
*** RIVER *** [6c 6s 4s Ah] [Jc]
giant122457: checks=20
Robbar211367: checks=20
jones1315: checks=20
*** SHOW DOWN ***
giant122457: shows [Kh 9h] (a pair of Sixes)
Robbar211367: shows [2h 2s] (two pair, Sixes and Deuces)
jones1315: shows [Qd Js] (two pair, Jacks and Sixes)
jones1315 collected 3130 from pot
*** SUMMARY ***
Total pot 3130 | Rake 0=20
Board [6c 6s 4s Ah Jc]
Seat 2: Robbar211367 showed [2h 2s] and lost with two pair, Sixes and D=
euces
Seat 3: DaGr8Gatzby folded before Flop (didn't bet)
Seat 5: jones1315 showed [Qd Js] and won (3130) with two pair, Jacks an=
d Sixes
Seat 6: PetFalcon folded before Flop (didn't bet)
Seat 7: JJin91 (button) folded before Flop (didn't bet)
Seat 8: TrademarkTer (small blind) folded before Flop
Seat 9: giant122457 (big blind) showed [Kh 9h] and lost with a pair of =
Sixes


*********** # 18 **************
PokerStars Hand #171703449578: Tournament #1648956862, $4.55+$0.45 USD =
Hold'em No Limit - Level IX (150/300) - 2017/06/25 21:45:07 ET
Table '1648956862 2' 9-max Seat #8 is the button
Seat 1: CHAD9DW (10000 in chips)=20
Seat 2: Robbar211367 (14510 in chips)=20
Seat 3: DaGr8Gatzby (21565 in chips)=20
Seat 5: jones1315 (7756 in chips)=20
Seat 6: PetFalcon (9065 in chips)=20
Seat 7: JJin91 (14753 in chips)=20
Seat 8: TrademarkTer (40307 in chips)=20
Seat 9: giant122457 (14415 in chips)=20
CHAD9DW: posts the ante 40
Robbar211367: posts the ante 40
DaGr8Gatzby: posts the ante 40
jones1315: posts the ante 40
PetFalcon: posts the ante 40
JJin91: posts the ante 40
TrademarkTer: posts the ante 40
giant122457: posts the ante 40
giant122457: posts small blind 150
CHAD9DW: posts big blind 300
*** HOLE CARDS ***
Dealt to JJin91 [Td 8h]
Robbar211367: folds=20
DaGr8Gatzby: raises 300 to 600
jones1315: folds=20
PetFalcon: folds=20
JJin91: folds=20
TrademarkTer: folds=20
giant122457: folds=20
CHAD9DW: calls 300
*** FLOP *** [Qs Th 9s]
CHAD9DW: checks=20
DaGr8Gatzby: bets 900
CHAD9DW: calls 900
*** TURN *** [Qs Th 9s] [Ad]
CHAD9DW: checks=20
DaGr8Gatzby: bets 3470
CHAD9DW: folds=20
Uncalled bet (3470) returned to DaGr8Gatzby
DaGr8Gatzby collected 3470 from pot
DaGr8Gatzby: doesn't show hand=20
*** SUMMARY ***
Total pot 3470 | Rake 0=20
Board [Qs Th 9s Ad]
Seat 1: CHAD9DW (big blind) folded on the Turn
Seat 2: Robbar211367 folded before Flop (didn't bet)
Seat 3: DaGr8Gatzby collected (3470)
Seat 5: jones1315 folded before Flop (didn't bet)
Seat 6: PetFalcon folded before Flop (didn't bet)
Seat 7: JJin91 folded before Flop (didn't bet)
Seat 8: TrademarkTer (button) folded before Flop (didn't bet)
Seat 9: giant122457 (small blind) folded before Flop


*********** # 19 **************
PokerStars Hand #171703449738: Tournament #1648956862, $4.55+$0.45 USD =
Hold'em No Limit - Level X (200/400) - 2017/06/25 21:45:42 ET
Table '1648956862 2' 9-max Seat #9 is the button
Seat 1: CHAD9DW (8460 in chips)=20
Seat 2: Robbar211367 (14470 in chips)=20
Seat 3: DaGr8Gatzby (23495 in chips)=20
Seat 5: jones1315 (7716 in chips)=20
Seat 6: PetFalcon (9025 in chips)=20
Seat 7: JJin91 (14713 in chips)=20
Seat 8: TrademarkTer (40267 in chips)=20
Seat 9: giant122457 (14225 in chips)=20
CHAD9DW: posts the ante 50
Robbar211367: posts the ante 50
DaGr8Gatzby: posts the ante 50
jones1315: posts the ante 50
PetFalcon: posts the ante 50
JJin91: posts the ante 50
TrademarkTer: posts the ante 50
giant122457: posts the ante 50
CHAD9DW: posts small blind 200
Robbar211367: posts big blind 400
*** HOLE CARDS ***
Dealt to JJin91 [4h 4s]
DaGr8Gatzby: folds=20
jones1315: folds=20
PetFalcon: folds=20
JJin91: raises 444 to 844
TrademarkTer: folds=20
giant122457: folds=20
CHAD9DW: folds=20
Robbar211367: folds=20
Uncalled bet (444) returned to JJin91
JJin91 collected 1400 from pot
JJin91: doesn't show hand=20
*** SUMMARY ***
Total pot 1400 | Rake 0=20
Seat 1: CHAD9DW (small blind) folded before Flop
Seat 2: Robbar211367 (big blind) folded before Flop
Seat 3: DaGr8Gatzby folded before Flop (didn't bet)
Seat 5: jones1315 folded before Flop (didn't bet)
Seat 6: PetFalcon folded before Flop (didn't bet)
Seat 7: JJin91 collected (1400)
Seat 8: TrademarkTer folded before Flop (didn't bet)
Seat 9: giant122457 (button) folded before Flop (didn't bet)


*********** # 20 **************
PokerStars Hand #171703449863: Tournament #1648956862, $4.55+$0.45 USD =
Hold'em No Limit - Level X (200/400) - 2017/06/25 21:46:07 ET
Table '1648956862 2' 9-max Seat #1 is the button
Seat 1: CHAD9DW (8210 in chips)=20
Seat 2: Robbar211367 (14020 in chips)=20
Seat 3: DaGr8Gatzby (23445 in chips)=20
Seat 5: jones1315 (7666 in chips)=20
Seat 6: PetFalcon (8975 in chips)=20
Seat 7: JJin91 (15663 in chips)=20
Seat 8: TrademarkTer (40217 in chips)=20
Seat 9: giant122457 (14175 in chips)=20
CHAD9DW: posts the ante 50
Robbar211367: posts the ante 50
DaGr8Gatzby: posts the ante 50
jones1315: posts the ante 50
PetFalcon: posts the ante 50
JJin91: posts the ante 50
TrademarkTer: posts the ante 50
giant122457: posts the ante 50
Robbar211367: posts small blind 200
DaGr8Gatzby: posts big blind 400
*** HOLE CARDS ***
Dealt to JJin91 [7s 7c]
jones1315: folds=20
PetFalcon: folds=20
JJin91: raises 444 to 844
TrademarkTer: folds=20
giant122457: folds=20
CHAD9DW: folds=20
Robbar211367: folds=20
DaGr8Gatzby: folds=20
Uncalled bet (444) returned to JJin91
JJin91 collected 1400 from pot
JJin91: doesn't show hand=20
*** SUMMARY ***
Total pot 1400 | Rake 0=20
Seat 1: CHAD9DW (button) folded before Flop (didn't bet)
Seat 2: Robbar211367 (small blind) folded before Flop
Seat 3: DaGr8Gatzby (big blind) folded before Flop
Seat 5: jones1315 folded before Flop (didn't bet)
Seat 6: PetFalcon folded before Flop (didn't bet)
Seat 7: JJin91 collected (1400)
Seat 8: TrademarkTer folded before Flop (didn't bet)
Seat 9: giant122457 folded before Flop (didn't bet)


*********** # 21 **************
PokerStars Hand #171703449990: Tournament #1648956862, $4.55+$0.45 USD =
Hold'em No Limit - Level X (200/400) - 2017/06/25 21:46:35 ET
Table '1648956862 2' 9-max Seat #2 is the button
Seat 1: CHAD9DW (8160 in chips)=20
Seat 2: Robbar211367 (13770 in chips)=20
Seat 3: DaGr8Gatzby (22995 in chips)=20
Seat 5: jones1315 (7616 in chips)=20
Seat 6: PetFalcon (8925 in chips)=20
Seat 7: JJin91 (16613 in chips)=20
Seat 8: TrademarkTer (40167 in chips)=20
Seat 9: giant122457 (14125 in chips)=20
CHAD9DW: posts the ante 50
Robbar211367: posts the ante 50
DaGr8Gatzby: posts the ante 50
jones1315: posts the ante 50
PetFalcon: posts the ante 50
JJin91: posts the ante 50
TrademarkTer: posts the ante 50
giant122457: posts the ante 50
DaGr8Gatzby: posts small blind 200
jones1315: posts big blind 400
*** HOLE CARDS ***
Dealt to JJin91 [Jd 3d]
PetFalcon: folds=20
JJin91: folds=20
TrademarkTer: folds=20
giant122457: folds=20
CHAD9DW: raises 1350 to 1750
Robbar211367: folds=20
DaGr8Gatzby: folds=20
jones1315: calls 1350
*** FLOP *** [6h 2c 2d]
jones1315: checks=20
CHAD9DW: bets 2400
jones1315: raises 3416 to 5816 and is all-in
CHAD9DW: calls 3416
*** TURN *** [6h 2c 2d] [8d]
*** RIVER *** [6h 2c 2d 8d] [Qh]
*** SHOW DOWN ***
jones1315: shows [6c 7c] (two pair, Sixes and Deuces)
CHAD9DW: shows [Jh Jc] (two pair, Jacks and Deuces)
CHAD9DW collected 15732 from pot
jones1315 finished the tournament in 101st place
*** SUMMARY ***
Total pot 15732 | Rake 0=20
Board [6h 2c 2d 8d Qh]
Seat 1: CHAD9DW showed [Jh Jc] and won (15732) with two pair, Jacks and=
 Deuces
Seat 2: Robbar211367 (button) folded before Flop (didn't bet)
Seat 3: DaGr8Gatzby (small blind) folded before Flop
Seat 5: jones1315 (big blind) showed [6c 7c] and lost with two pair, Si=
xes and Deuces
Seat 6: PetFalcon folded before Flop (didn't bet)
Seat 7: JJin91 folded before Flop (didn't bet)
Seat 8: TrademarkTer folded before Flop (didn't bet)
Seat 9: giant122457 folded before Flop (didn't bet)


*********** # 22 **************
PokerStars Hand #171704049897: Tournament #1648956862, $4.55+$0.45 USD =
Hold'em No Limit - Level X (200/400) - 2017/06/25 21:47:22 ET
Table '1648956862 2' 9-max Seat #3 is the button
Seat 1: CHAD9DW (16276 in chips)=20
Seat 2: Robbar211367 (13720 in chips)=20
Seat 3: DaGr8Gatzby (22745 in chips)=20
Seat 6: PetFalcon (8875 in chips)=20
Seat 7: JJin91 (16563 in chips)=20
Seat 8: TrademarkTer (40117 in chips)=20
Seat 9: giant122457 (14075 in chips)=20
CHAD9DW: posts the ante 50
Robbar211367: posts the ante 50
DaGr8Gatzby: posts the ante 50
PetFalcon: posts the ante 50
JJin91: posts the ante 50
TrademarkTer: posts the ante 50
giant122457: posts the ante 50
PetFalcon: posts small blind 200
JJin91: posts big blind 400
*** HOLE CARDS ***
Dealt to JJin91 [2c 4s]
TrademarkTer: folds=20
giant122457: folds=20
CHAD9DW: folds=20
Robbar211367: folds=20
DaGr8Gatzby: folds=20
PetFalcon: calls 200
JJin91: checks=20
*** FLOP *** [9d 4h Ts]
PetFalcon: checks=20
JJin91: checks=20
*** TURN *** [9d 4h Ts] [4c]
PetFalcon: bets 800
JJin91: calls 800
*** RIVER *** [9d 4h Ts 4c] [Kc]
PetFalcon: bets 2400
JJin91: calls 2400
*** SHOW DOWN ***
PetFalcon: shows [6h 5s] (a pair of Fours)
JJin91: shows [2c 4s] (three of a kind, Fours)
JJin91 collected 7550 from pot
*** SUMMARY ***
Total pot 7550 | Rake 0=20
Board [9d 4h Ts 4c Kc]
Seat 1: CHAD9DW folded before Flop (didn't bet)
Seat 2: Robbar211367 folded before Flop (didn't bet)
Seat 3: DaGr8Gatzby (button) folded before Flop (didn't bet)
Seat 6: PetFalcon (small blind) showed [6h 5s] and lost with a pair of =
Fours
Seat 7: JJin91 (big blind) showed [2c 4s] and won (7550) with three of =
a kind, Fours
Seat 8: TrademarkTer folded before Flop (didn't bet)
Seat 9: giant122457 folded before Flop (didn't bet)


*********** # 23 **************
PokerStars Hand #171704080608: Tournament #1648956862, $4.55+$0.45 USD =
Hold'em No Limit - Level X (200/400) - 2017/06/25 21:48:09 ET
Table '1648956862 2' 9-max Seat #6 is the button
Seat 1: CHAD9DW (16226 in chips)=20
Seat 2: Robbar211367 (13670 in chips)=20
Seat 3: DaGr8Gatzby (22695 in chips)=20
Seat 4: p@n1n1NJ (17704 in chips)=20
Seat 6: PetFalcon (5225 in chips)=20
Seat 7: JJin91 (20463 in chips)=20
Seat 8: TrademarkTer (40067 in chips)=20
Seat 9: giant122457 (14025 in chips)=20
CHAD9DW: posts the ante 50
Robbar211367: posts the ante 50
DaGr8Gatzby: posts the ante 50
p@n1n1NJ: posts the ante 50
PetFalcon: posts the ante 50
JJin91: posts the ante 50
TrademarkTer: posts the ante 50
giant122457: posts the ante 50
JJin91: posts small blind 200
TrademarkTer: posts big blind 400
*** HOLE CARDS ***
Dealt to JJin91 [Td Qh]
giant122457: folds=20
CHAD9DW: folds=20
Robbar211367: folds=20
DaGr8Gatzby: folds=20
p@n1n1NJ: raises 400 to 800
PetFalcon: calls 800
JJin91: folds=20
TrademarkTer: folds=20
*** FLOP *** [Qs Jc 2h]
p@n1n1NJ: checks=20
PetFalcon: bets 2600
p@n1n1NJ: folds=20
Uncalled bet (2600) returned to PetFalcon
PetFalcon collected 2600 from pot
PetFalcon: doesn't show hand=20
*** SUMMARY ***
Total pot 2600 | Rake 0=20
Board [Qs Jc 2h]
Seat 1: CHAD9DW folded before Flop (didn't bet)
Seat 2: Robbar211367 folded before Flop (didn't bet)
Seat 3: DaGr8Gatzby folded before Flop (didn't bet)
Seat 4: p@n1n1NJ folded on the Flop
Seat 6: PetFalcon (button) collected (2600)
Seat 7: JJin91 (small blind) folded before Flop
Seat 8: TrademarkTer (big blind) folded before Flop
Seat 9: giant122457 folded before Flop (didn't bet)


*********** # 24 **************
PokerStars Hand #171704080760: Tournament #1648956862, $4.55+$0.45 USD =
Hold'em No Limit - Level X (200/400) - 2017/06/25 21:48:39 ET
Table '1648956862 2' 9-max Seat #7 is the button
Seat 1: CHAD9DW (16176 in chips)=20
Seat 2: Robbar211367 (13620 in chips)=20
Seat 3: DaGr8Gatzby (22645 in chips)=20
Seat 4: p@n1n1NJ (16854 in chips)=20
Seat 6: PetFalcon (6975 in chips)=20
Seat 7: JJin91 (20213 in chips)=20
Seat 8: TrademarkTer (39617 in chips)=20
Seat 9: giant122457 (13975 in chips)=20
CHAD9DW: posts the ante 50
Robbar211367: posts the ante 50
DaGr8Gatzby: posts the ante 50
p@n1n1NJ: posts the ante 50
PetFalcon: posts the ante 50
JJin91: posts the ante 50
TrademarkTer: posts the ante 50
giant122457: posts the ante 50
TrademarkTer: posts small blind 200
giant122457: posts big blind 400
*** HOLE CARDS ***
Dealt to JJin91 [9c Jc]
CHAD9DW: folds=20
Robbar211367: folds=20
DaGr8Gatzby: folds=20
p@n1n1NJ: folds=20
PetFalcon: folds=20
JJin91: raises 444 to 844
TrademarkTer: calls 644
giant122457: folds=20
*** FLOP *** [Qs Qd 8h]
TrademarkTer: checks=20
JJin91: bets 899
TrademarkTer: calls 899
*** TURN *** [Qs Qd 8h] [4c]
TrademarkTer: checks=20
JJin91: checks=20
*** RIVER *** [Qs Qd 8h 4c] [9s]
TrademarkTer: checks=20
JJin91: checks=20
*** SHOW DOWN ***
TrademarkTer: shows [Th Ah] (a pair of Queens)
JJin91: shows [9c Jc] (two pair, Queens and Nines)
JJin91 collected 4286 from pot
*** SUMMARY ***
Total pot 4286 | Rake 0=20
Board [Qs Qd 8h 4c 9s]
Seat 1: CHAD9DW folded before Flop (didn't bet)
Seat 2: Robbar211367 folded before Flop (didn't bet)
Seat 3: DaGr8Gatzby folded before Flop (didn't bet)
Seat 4: p@n1n1NJ folded before Flop (didn't bet)
Seat 6: PetFalcon folded before Flop (didn't bet)
Seat 7: JJin91 (button) showed [9c Jc] and won (4286) with two pair, Qu=
eens and Nines
Seat 8: TrademarkTer (small blind) showed [Th Ah] and lost with a pair =
of Queens
Seat 9: giant122457 (big blind) folded before Flop


*********** # 25 **************
PokerStars Hand #171704081004: Tournament #1648956862, $4.55+$0.45 USD =
Hold'em No Limit - Level X (200/400) - 2017/06/25 21:49:36 ET
Table '1648956862 2' 9-max Seat #8 is the button
Seat 1: CHAD9DW (16126 in chips)=20
Seat 2: Robbar211367 (13570 in chips)=20
Seat 3: DaGr8Gatzby (22595 in chips)=20
Seat 4: p@n1n1NJ (16804 in chips)=20
Seat 6: PetFalcon (6925 in chips)=20
Seat 7: JJin91 (22706 in chips)=20
Seat 8: TrademarkTer (37824 in chips)=20
Seat 9: giant122457 (13525 in chips)=20
CHAD9DW: posts the ante 50
Robbar211367: posts the ante 50
DaGr8Gatzby: posts the ante 50
p@n1n1NJ: posts the ante 50
PetFalcon: posts the ante 50
JJin91: posts the ante 50
TrademarkTer: posts the ante 50
giant122457: posts the ante 50
giant122457: posts small blind 200
CHAD9DW: posts big blind 400
*** HOLE CARDS ***
Dealt to JJin91 [5s Ac]
Robbar211367: folds=20
DaGr8Gatzby: folds=20
p@n1n1NJ: calls 400
PetFalcon: folds=20
JJin91: folds=20
TrademarkTer: folds=20
giant122457: raises 800 to 1200
CHAD9DW: folds=20
p@n1n1NJ: calls 800
*** FLOP *** [8d 2s 7h]
giant122457: bets 400
p@n1n1NJ: calls 400
*** TURN *** [8d 2s 7h] [3c]
giant122457: bets 400
p@n1n1NJ: calls 400
*** RIVER *** [8d 2s 7h 3c] [6c]
giant122457: bets 400
p@n1n1NJ: calls 400
*** SHOW DOWN ***
giant122457: shows [Ad Kh] (high card Ace)
p@n1n1NJ: shows [2d 6d] (two pair, Sixes and Deuces)
p@n1n1NJ collected 5600 from pot
*** SUMMARY ***
Total pot 5600 | Rake 0=20
Board [8d 2s 7h 3c 6c]
Seat 1: CHAD9DW (big blind) folded before Flop
Seat 2: Robbar211367 folded before Flop (didn't bet)
Seat 3: DaGr8Gatzby folded before Flop (didn't bet)
Seat 4: p@n1n1NJ showed [2d 6d] and won (5600) with two pair, Sixes and=
 Deuces
Seat 6: PetFalcon folded before Flop (didn't bet)
Seat 7: JJin91 folded before Flop (didn't bet)
Seat 8: TrademarkTer (button) folded before Flop (didn't bet)
Seat 9: giant122457 (small blind) showed [Ad Kh] and lost with high car=
d Ace


*********** # 26 **************
PokerStars Hand #171704081247: Tournament #1648956862, $4.55+$0.45 USD =
Hold'em No Limit - Level XI (250/500) - 2017/06/25 21:50:25 ET
Table '1648956862 2' 9-max Seat #9 is the button
Seat 1: CHAD9DW (15676 in chips)=20
Seat 2: Robbar211367 (13520 in chips)=20
Seat 3: DaGr8Gatzby (22545 in chips)=20
Seat 4: p@n1n1NJ (19954 in chips)=20
Seat 6: PetFalcon (6875 in chips)=20
Seat 7: JJin91 (22656 in chips)=20
Seat 8: TrademarkTer (37774 in chips)=20
Seat 9: giant122457 (11075 in chips)=20
CHAD9DW: posts the ante 60
Robbar211367: posts the ante 60
DaGr8Gatzby: posts the ante 60
p@n1n1NJ: posts the ante 60
PetFalcon: posts the ante 60
JJin91: posts the ante 60
TrademarkTer: posts the ante 60
giant122457: posts the ante 60
CHAD9DW: posts small blind 250
Robbar211367: posts big blind 500
*** HOLE CARDS ***
Dealt to JJin91 [7d 6d]
DaGr8Gatzby: folds=20
p@n1n1NJ: folds=20
PetFalcon: folds=20
JJin91: raises 555 to 1055
TrademarkTer: folds=20
giant122457: folds=20
CHAD9DW: folds=20
Robbar211367: calls 555
*** FLOP *** [Js 6h 3d]
Robbar211367: checks=20
JJin91: bets 1034
Robbar211367: raises 2012 to 3046
JJin91: folds=20
Uncalled bet (2012) returned to Robbar211367
Robbar211367 collected 4908 from pot
Robbar211367: doesn't show hand=20
*** SUMMARY ***
Total pot 4908 | Rake 0=20
Board [Js 6h 3d]
Seat 1: CHAD9DW (small blind) folded before Flop
Seat 2: Robbar211367 (big blind) collected (4908)
Seat 3: DaGr8Gatzby folded before Flop (didn't bet)
Seat 4: p@n1n1NJ folded before Flop (didn't bet)
Seat 6: PetFalcon folded before Flop (didn't bet)
Seat 7: JJin91 folded on the Flop
Seat 8: TrademarkTer folded before Flop (didn't bet)
Seat 9: giant122457 (button) folded before Flop (didn't bet)


*********** # 27 **************
PokerStars Hand #171704081509: Tournament #1648956862, $4.55+$0.45 USD =
Hold'em No Limit - Level XI (250/500) - 2017/06/25 21:51:20 ET
Table '1648956862 2' 9-max Seat #1 is the button
Seat 1: CHAD9DW (15366 in chips)=20
Seat 2: Robbar211367 (16279 in chips)=20
Seat 4: p@n1n1NJ (19894 in chips)=20
Seat 5: edpokernj123 (9900 in chips)=20
Seat 6: PetFalcon (6815 in chips)=20
Seat 7: JJin91 (20507 in chips)=20
Seat 8: TrademarkTer (37714 in chips)=20
Seat 9: giant122457 (11015 in chips)=20
CHAD9DW: posts the ante 60
Robbar211367: posts the ante 60
p@n1n1NJ: posts the ante 60
edpokernj123: posts the ante 60
PetFalcon: posts the ante 60
JJin91: posts the ante 60
TrademarkTer: posts the ante 60
giant122457: posts the ante 60
Robbar211367: posts small blind 250
p@n1n1NJ: posts big blind 500
*** HOLE CARDS ***
Dealt to JJin91 [Qh 2c]
edpokernj123: folds=20
PetFalcon: folds=20
JJin91: folds=20
TrademarkTer: folds=20
giant122457: folds=20
CHAD9DW: raises 600 to 1100
Robbar211367: folds=20
p@n1n1NJ: raises 1100 to 2200
CHAD9DW: calls 1100
*** FLOP *** [Ah 8d 8s]
p@n1n1NJ: bets 2500
CHAD9DW: folds=20
Uncalled bet (2500) returned to p@n1n1NJ
p@n1n1NJ collected 5130 from pot
p@n1n1NJ: doesn't show hand=20
*** SUMMARY ***
Total pot 5130 | Rake 0=20
Board [Ah 8d 8s]
Seat 1: CHAD9DW (button) folded on the Flop
Seat 2: Robbar211367 (small blind) folded before Flop
Seat 4: p@n1n1NJ (big blind) collected (5130)
Seat 5: edpokernj123 folded before Flop (didn't bet)
Seat 6: PetFalcon folded before Flop (didn't bet)
Seat 7: JJin91 folded before Flop (didn't bet)
Seat 8: TrademarkTer folded before Flop (didn't bet)
Seat 9: giant122457 folded before Flop (didn't bet)


*********** # 28 **************
PokerStars Hand #171704081692: Tournament #1648956862, $4.55+$0.45 USD =
Hold'em No Limit - Level XI (250/500) - 2017/06/25 21:51:55 ET
Table '1648956862 2' 9-max Seat #2 is the button
Seat 1: CHAD9DW (13106 in chips)=20
Seat 2: Robbar211367 (15969 in chips)=20
Seat 4: p@n1n1NJ (22764 in chips)=20
Seat 5: edpokernj123 (9840 in chips)=20
Seat 6: PetFalcon (6755 in chips)=20
Seat 7: JJin91 (20447 in chips)=20
Seat 8: TrademarkTer (37654 in chips)=20
Seat 9: giant122457 (10955 in chips)=20
CHAD9DW: posts the ante 60
Robbar211367: posts the ante 60
p@n1n1NJ: posts the ante 60
edpokernj123: posts the ante 60
PetFalcon: posts the ante 60
JJin91: posts the ante 60
TrademarkTer: posts the ante 60
giant122457: posts the ante 60
p@n1n1NJ: posts small blind 250
edpokernj123: posts big blind 500
*** HOLE CARDS ***
Dealt to JJin91 [2s Ks]
PetFalcon: folds=20
JJin91: folds=20
TrademarkTer: folds=20
giant122457: calls 500
CHAD9DW: folds=20
Robbar211367: folds=20
p@n1n1NJ: calls 250
edpokernj123: checks=20
*** FLOP *** [5s Jc 5d]
p@n1n1NJ: checks=20
edpokernj123: bets 990
giant122457: calls 990
p@n1n1NJ: folds=20
*** TURN *** [5s Jc 5d] [8s]
edpokernj123: bets 1980
giant122457: raises 1980 to 3960
edpokernj123: calls 1980
*** RIVER *** [5s Jc 5d 8s] [8h]
edpokernj123: bets 4330 and is all-in
giant122457: calls 4330
*** SHOW DOWN ***
edpokernj123: shows [Jd 8c] (a full house, Eights full of Jacks)
giant122457: shows [5c 6c] (a full house, Fives full of Eights)
edpokernj123 collected 20540 from pot
*** SUMMARY ***
Total pot 20540 | Rake 0=20
Board [5s Jc 5d 8s 8h]
Seat 1: CHAD9DW folded before Flop (didn't bet)
Seat 2: Robbar211367 (button) folded before Flop (didn't bet)
Seat 4: p@n1n1NJ (small blind) folded on the Flop
Seat 5: edpokernj123 (big blind) showed [Jd 8c] and won (20540) with a =
full house, Eights full of Jacks
Seat 6: PetFalcon folded before Flop (didn't bet)
Seat 7: JJin91 folded before Flop (didn't bet)
Seat 8: TrademarkTer folded before Flop (didn't bet)
Seat 9: giant122457 showed [5c 6c] and lost with a full house, Fives fu=
ll of Eights


*********** # 29 **************
PokerStars Hand #171704082039: Tournament #1648956862, $4.55+$0.45 USD =
Hold'em No Limit - Level XI (250/500) - 2017/06/25 21:53:11 ET
Table '1648956862 2' 9-max Seat #4 is the button
Seat 1: CHAD9DW (13046 in chips)=20
Seat 2: Robbar211367 (15909 in chips)=20
Seat 4: p@n1n1NJ (22204 in chips)=20
Seat 5: edpokernj123 (20540 in chips)=20
Seat 6: PetFalcon (6695 in chips)=20
Seat 7: JJin91 (20387 in chips)=20
Seat 8: TrademarkTer (37594 in chips)=20
Seat 9: giant122457 (1115 in chips)=20
CHAD9DW: posts the ante 60
Robbar211367: posts the ante 60
p@n1n1NJ: posts the ante 60
edpokernj123: posts the ante 60
PetFalcon: posts the ante 60
JJin91: posts the ante 60
TrademarkTer: posts the ante 60
giant122457: posts the ante 60
edpokernj123: posts small blind 250
PetFalcon: posts big blind 500
*** HOLE CARDS ***
Dealt to JJin91 [Qh 6s]
JJin91: folds=20
TrademarkTer: folds=20
giant122457: folds=20
CHAD9DW: folds=20
Robbar211367: folds=20
p@n1n1NJ: raises 500 to 1000
edpokernj123: folds=20
PetFalcon: calls 500
*** FLOP *** [9c Qc 5s]
PetFalcon: checks=20
p@n1n1NJ: bets 1500
PetFalcon: raises 4135 to 5635 and is all-in
p@n1n1NJ: calls 4135
*** TURN *** [9c Qc 5s] [7c]
*** RIVER *** [9c Qc 5s 7c] [3h]
*** SHOW DOWN ***
PetFalcon: shows [9d Jd] (a pair of Nines)
p@n1n1NJ: shows [5d Ks] (a pair of Fives)
PetFalcon collected 14000 from pot
*** SUMMARY ***
Total pot 14000 | Rake 0=20
Board [9c Qc 5s 7c 3h]
Seat 1: CHAD9DW folded before Flop (didn't bet)
Seat 2: Robbar211367 folded before Flop (didn't bet)
Seat 4: p@n1n1NJ (button) showed [5d Ks] and lost with a pair of Fives
Seat 5: edpokernj123 (small blind) folded before Flop
Seat 6: PetFalcon (big blind) showed [9d Jd] and won (14000) with a pai=
r of Nines
Seat 7: JJin91 folded before Flop (didn't bet)
Seat 8: TrademarkTer folded before Flop (didn't bet)
Seat 9: giant122457 folded before Flop (didn't bet)


*********** # 30 **************
PokerStars Hand #171704082206: Tournament #1648956862, $4.55+$0.45 USD =
Hold'em No Limit - Level XI (250/500) - 2017/06/25 21:53:50 ET
Table '1648956862 2' 9-max Seat #5 is the button
Seat 1: CHAD9DW (12986 in chips)=20
Seat 2: Robbar211367 (15849 in chips)=20
Seat 4: p@n1n1NJ (15509 in chips)=20
Seat 5: edpokernj123 (20230 in chips)=20
Seat 6: PetFalcon (14000 in chips)=20
Seat 7: JJin91 (20327 in chips)=20
Seat 8: TrademarkTer (37534 in chips)=20
Seat 9: giant122457 (1055 in chips)=20
CHAD9DW: posts the ante 60
Robbar211367: posts the ante 60
p@n1n1NJ: posts the ante 60
edpokernj123: posts the ante 60
PetFalcon: posts the ante 60
JJin91: posts the ante 60
TrademarkTer: posts the ante 60
giant122457: posts the ante 60
PetFalcon: posts small blind 250
JJin91: posts big blind 500
*** HOLE CARDS ***
Dealt to JJin91 [7d 5h]
TrademarkTer: folds=20
giant122457: raises 495 to 995 and is all-in
CHAD9DW: folds=20
Robbar211367: folds=20
p@n1n1NJ: raises 14454 to 15449 and is all-in
edpokernj123: folds=20
PetFalcon: folds=20
JJin91: folds=20
Uncalled bet (14454) returned to p@n1n1NJ
*** FLOP *** [6h Qc Qs]
*** TURN *** [6h Qc Qs] [3h]
*** RIVER *** [6h Qc Qs 3h] [8d]
*** SHOW DOWN ***
giant122457: shows [Kc 7h] (a pair of Queens)
p@n1n1NJ: shows [4s Ad] (a pair of Queens - Ace kicker)
p@n1n1NJ collected 3220 from pot
giant122457 finished the tournament in 89th place
*** SUMMARY ***
Total pot 3220 | Rake 0=20
Board [6h Qc Qs 3h 8d]
Seat 1: CHAD9DW folded before Flop (didn't bet)
Seat 2: Robbar211367 folded before Flop (didn't bet)
Seat 4: p@n1n1NJ showed [4s Ad] and won (3220) with a pair of Queens
Seat 5: edpokernj123 (button) folded before Flop (didn't bet)
Seat 6: PetFalcon (small blind) folded before Flop
Seat 7: JJin91 (big blind) folded before Flop
Seat 8: TrademarkTer folded before Flop (didn't bet)
Seat 9: giant122457 showed [Kc 7h] and lost with a pair of Queens


*********** # 31 **************
PokerStars Hand #171704082346: Tournament #1648956862, $4.55+$0.45 USD =
Hold'em No Limit - Level XI (250/500) - 2017/06/25 21:54:20 ET
Table '1648956862 2' 9-max Seat #6 is the button
Seat 1: CHAD9DW (12926 in chips)=20
Seat 2: Robbar211367 (15789 in chips)=20
Seat 4: p@n1n1NJ (17674 in chips)=20
Seat 5: edpokernj123 (20170 in chips)=20
Seat 6: PetFalcon (13690 in chips)=20
Seat 7: JJin91 (19767 in chips)=20
Seat 8: TrademarkTer (37474 in chips)=20
CHAD9DW: posts the ante 60
Robbar211367: posts the ante 60
p@n1n1NJ: posts the ante 60
edpokernj123: posts the ante 60
PetFalcon: posts the ante 60
JJin91: posts the ante 60
TrademarkTer: posts the ante 60
JJin91: posts small blind 250
TrademarkTer: posts big blind 500
*** HOLE CARDS ***
Dealt to JJin91 [6s 4s]
CHAD9DW: calls 500
Robbar211367: raises 700 to 1200
p@n1n1NJ: folds=20
edpokernj123: calls 1200
PetFalcon: folds=20
JJin91: folds=20
TrademarkTer said, "many many good flops out there"
TrademarkTer: calls 700
CHAD9DW: calls 700
*** FLOP *** [6c 2s Jc]
TrademarkTer: checks=20
CHAD9DW: bets 3500
Robbar211367: folds=20
edpokernj123: folds=20
TrademarkTer said, "maybe i can finally give some back"
TrademarkTer: raises 32714 to 36214 and is all-in
CHAD9DW: calls 8166 and is all-in
Uncalled bet (24548) returned to TrademarkTer
*** TURN *** [6c 2s Jc] [Jd]
*** RIVER *** [6c 2s Jc Jd] [Ks]
*** SHOW DOWN ***
TrademarkTer: shows [9c Ac] (a pair of Jacks)
CHAD9DW: shows [Jh 8h] (three of a kind, Jacks)
CHAD9DW collected 28802 from pot
*** SUMMARY ***
Total pot 28802 | Rake 0=20
Board [6c 2s Jc Jd Ks]
Seat 1: CHAD9DW showed [Jh 8h] and won (28802) with three of a kind, Ja=
cks
Seat 2: Robbar211367 folded on the Flop
Seat 4: p@n1n1NJ folded before Flop (didn't bet)
Seat 5: edpokernj123 folded on the Flop
Seat 6: PetFalcon (button) folded before Flop (didn't bet)
Seat 7: JJin91 (small blind) folded before Flop
Seat 8: TrademarkTer (big blind) showed [9c Ac] and lost with a pair of=
 Jacks


*********** # 32 **************
PokerStars Hand #171704083774: Tournament #1648956862, $4.55+$0.45 USD =
Hold'em No Limit - Level XII (300/600) - 2017/06/25 22:01:07 ET
Table '1648956862 2' 9-max Seat #7 is the button
Seat 1: CHAD9DW (28802 in chips)=20
Seat 2: Robbar211367 (14529 in chips)=20
Seat 3: 127Wlfhnd (10000 in chips)=20
Seat 4: p@n1n1NJ (17614 in chips)=20
Seat 5: edpokernj123 (18910 in chips)=20
Seat 7: JJin91 (19457 in chips)=20
Seat 8: TrademarkTer (24548 in chips)=20
Seat 9: jayjay8956 (10000 in chips)=20
CHAD9DW: posts the ante 70
Robbar211367: posts the ante 70
127Wlfhnd: posts the ante 70
p@n1n1NJ: posts the ante 70
edpokernj123: posts the ante 70
JJin91: posts the ante 70
TrademarkTer: posts the ante 70
jayjay8956: posts the ante 70
TrademarkTer: posts small blind 300
jayjay8956: posts big blind 600
*** HOLE CARDS ***
Dealt to JJin91 [Th 7c]
CHAD9DW: folds=20
Robbar211367 has timed out
Robbar211367: folds=20
Robbar211367 is sitting out
127Wlfhnd: folds=20
p@n1n1NJ has timed out while disconnected
p@n1n1NJ: folds=20
p@n1n1NJ is sitting out
edpokernj123: folds=20
JJin91: folds=20
jayjay8956 said, "yerrrrrr"
TrademarkTer: raises 23878 to 24478 and is all-in
jayjay8956: folds=20
Uncalled bet (23878) returned to TrademarkTer
TrademarkTer collected 1760 from pot
*** SUMMARY ***
Total pot 1760 | Rake 0=20
Seat 1: CHAD9DW folded before Flop (didn't bet)
Seat 2: Robbar211367 folded before Flop (didn't bet)
Seat 3: 127Wlfhnd folded before Flop (didn't bet)
Seat 4: p@n1n1NJ folded before Flop (didn't bet)
Seat 5: edpokernj123 folded before Flop (didn't bet)
Seat 7: JJin91 (button) folded before Flop (didn't bet)
Seat 8: TrademarkTer (small blind) collected (1760)
Seat 9: jayjay8956 (big blind) folded before Flop


*********** # 33 **************
PokerStars Hand #171704084153: Tournament #1648956862, $4.55+$0.45 USD =
Hold'em No Limit - Level XII (300/600) - 2017/06/25 22:02:30 ET
Table '1648956862 2' 9-max Seat #8 is the button
Seat 1: CHAD9DW (28732 in chips)=20
Seat 2: Robbar211367 (14459 in chips) is sitting out
Seat 3: 127Wlfhnd (9930 in chips)=20
Seat 4: p@n1n1NJ (17544 in chips) is sitting out
Seat 5: edpokernj123 (18840 in chips)=20
Seat 6: chucksaucey (8940 in chips)=20
Seat 7: JJin91 (19387 in chips)=20
Seat 8: TrademarkTer (25638 in chips)=20
Seat 9: jayjay8956 (9330 in chips)=20
CHAD9DW: posts the ante 70
Robbar211367: posts the ante 70
127Wlfhnd: posts the ante 70
p@n1n1NJ: posts the ante 70
edpokernj123: posts the ante 70
chucksaucey: posts the ante 70
JJin91: posts the ante 70
TrademarkTer: posts the ante 70
jayjay8956: posts the ante 70
jayjay8956: posts small blind 300
CHAD9DW: posts big blind 600
*** HOLE CARDS ***
Dealt to JJin91 [2c Ks]
Robbar211367: folds=20
127Wlfhnd: folds=20
p@n1n1NJ: folds=20
edpokernj123: calls 600
chucksaucey: folds=20
JJin91: folds=20
TrademarkTer: folds=20
jayjay8956: calls 300
CHAD9DW: checks=20
*** FLOP *** [Jh Ac Js]
jayjay8956: bets 1215
CHAD9DW: raises 1215 to 2430
Robbar211367 has returned
edpokernj123: folds=20
jayjay8956: calls 1215
*** TURN *** [Jh Ac Js] [8d]
jayjay8956: checks=20
CHAD9DW: checks=20
*** RIVER *** [Jh Ac Js 8d] [2s]
jayjay8956: bets 600
CHAD9DW: calls 600
*** SHOW DOWN ***
jayjay8956: shows [Ah 3c] (two pair, Aces and Jacks)
CHAD9DW: shows [Ad 6s] (two pair, Aces and Jacks)
jayjay8956 collected 4245 from pot
CHAD9DW collected 4245 from pot
*** SUMMARY ***
Total pot 8490 | Rake 0=20
Board [Jh Ac Js 8d 2s]
Seat 1: CHAD9DW (big blind) showed [Ad 6s] and won (4245) with two pair=
, Aces and Jacks
Seat 2: Robbar211367 folded before Flop (didn't bet)
Seat 3: 127Wlfhnd folded before Flop (didn't bet)
Seat 4: p@n1n1NJ folded before Flop (didn't bet)
Seat 5: edpokernj123 folded on the Flop
Seat 6: chucksaucey folded before Flop (didn't bet)
Seat 7: JJin91 folded before Flop (didn't bet)
Seat 8: TrademarkTer (button) folded before Flop (didn't bet)
Seat 9: jayjay8956 (small blind) showed [Ah 3c] and won (4245) with two=
 pair, Aces and Jacks


*********** # 34 **************
PokerStars Hand #171704084409: Tournament #1648956862, $4.55+$0.45 USD =
Hold'em No Limit - Level XII (300/600) - 2017/06/25 22:03:29 ET
Table '1648956862 2' 9-max Seat #9 is the button
Seat 1: CHAD9DW (29277 in chips)=20
Seat 2: Robbar211367 (14389 in chips)=20
Seat 3: 127Wlfhnd (9860 in chips)=20
Seat 4: p@n1n1NJ (17474 in chips) is sitting out
Seat 5: edpokernj123 (18170 in chips)=20
Seat 6: chucksaucey (8870 in chips)=20
Seat 7: JJin91 (19317 in chips)=20
Seat 8: TrademarkTer (25568 in chips)=20
Seat 9: jayjay8956 (9875 in chips)=20
CHAD9DW: posts the ante 70
Robbar211367: posts the ante 70
127Wlfhnd: posts the ante 70
p@n1n1NJ: posts the ante 70
edpokernj123: posts the ante 70
chucksaucey: posts the ante 70
JJin91: posts the ante 70
TrademarkTer: posts the ante 70
jayjay8956: posts the ante 70
CHAD9DW: posts small blind 300
Robbar211367: posts big blind 600
*** HOLE CARDS ***
Dealt to JJin91 [3d Jd]
127Wlfhnd: folds=20
p@n1n1NJ: folds=20
edpokernj123: folds=20
chucksaucey: raises 8200 to 8800 and is all-in
JJin91: folds=20
TrademarkTer: folds=20
jayjay8956: folds=20
CHAD9DW: folds=20
Robbar211367: folds=20
Uncalled bet (8200) returned to chucksaucey
chucksaucey collected 2130 from pot
chucksaucey: doesn't show hand=20
*** SUMMARY ***
Total pot 2130 | Rake 0=20
Seat 1: CHAD9DW (small blind) folded before Flop
Seat 2: Robbar211367 (big blind) folded before Flop
Seat 3: 127Wlfhnd folded before Flop (didn't bet)
Seat 4: p@n1n1NJ folded before Flop (didn't bet)
Seat 5: edpokernj123 folded before Flop (didn't bet)
Seat 6: chucksaucey collected (2130)
Seat 7: JJin91 folded before Flop (didn't bet)
Seat 8: TrademarkTer folded before Flop (didn't bet)
Seat 9: jayjay8956 (button) folded before Flop (didn't bet)


*********** # 35 **************
PokerStars Hand #171704084531: Tournament #1648956862, $4.55+$0.45 USD =
Hold'em No Limit - Level XII (300/600) - 2017/06/25 22:03:55 ET
Table '1648956862 2' 9-max Seat #1 is the button
Seat 1: CHAD9DW (28907 in chips)=20
Seat 2: Robbar211367 (13719 in chips)=20
Seat 3: 127Wlfhnd (9790 in chips)=20
Seat 4: p@n1n1NJ (17404 in chips) is sitting out
Seat 5: edpokernj123 (18100 in chips)=20
Seat 6: chucksaucey (10330 in chips)=20
Seat 7: JJin91 (19247 in chips)=20
Seat 8: TrademarkTer (25498 in chips)=20
Seat 9: jayjay8956 (9805 in chips)=20
CHAD9DW: posts the ante 70
Robbar211367: posts the ante 70
127Wlfhnd: posts the ante 70
p@n1n1NJ: posts the ante 70
edpokernj123: posts the ante 70
chucksaucey: posts the ante 70
JJin91: posts the ante 70
TrademarkTer: posts the ante 70
jayjay8956: posts the ante 70
Robbar211367: posts small blind 300
127Wlfhnd: posts big blind 600
*** HOLE CARDS ***
Dealt to JJin91 [Ah 9d]
p@n1n1NJ: folds=20
edpokernj123: folds=20
chucksaucey: folds=20
JJin91: folds=20
TrademarkTer: folds=20
jayjay8956: raises 600 to 1200
CHAD9DW: folds=20
Robbar211367: folds=20
127Wlfhnd: calls 600
*** FLOP *** [6h 5s 4d]
127Wlfhnd: bets 600
jayjay8956: calls 600
*** TURN *** [6h 5s 4d] [3c]
127Wlfhnd: bets 600
jayjay8956: calls 600
*** RIVER *** [6h 5s 4d 3c] [Jc]
127Wlfhnd: bets 600
jayjay8956: calls 600
*** SHOW DOWN ***
127Wlfhnd: shows [5h Ac] (a pair of Fives)
jayjay8956: shows [Qs Qh] (a pair of Queens)
jayjay8956 collected 6930 from pot
*** SUMMARY ***
Total pot 6930 | Rake 0=20
Board [6h 5s 4d 3c Jc]
Seat 1: CHAD9DW (button) folded before Flop (didn't bet)
Seat 2: Robbar211367 (small blind) folded before Flop
Seat 3: 127Wlfhnd (big blind) showed [5h Ac] and lost with a pair of Fi=
ves
Seat 4: p@n1n1NJ folded before Flop (didn't bet)
Seat 5: edpokernj123 folded before Flop (didn't bet)
Seat 6: chucksaucey folded before Flop (didn't bet)
Seat 7: JJin91 folded before Flop (didn't bet)
Seat 8: TrademarkTer folded before Flop (didn't bet)
Seat 9: jayjay8956 showed [Qs Qh] and won (6930) with a pair of Queens


*********** # 36 **************
PokerStars Hand #171704084702: Tournament #1648956862, $4.55+$0.45 USD =
Hold'em No Limit - Level XII (300/600) - 2017/06/25 22:04:31 ET
Table '1648956862 2' 9-max Seat #2 is the button
Seat 1: CHAD9DW (28837 in chips)=20
Seat 2: Robbar211367 (13349 in chips)=20
Seat 3: 127Wlfhnd (6720 in chips)=20
Seat 4: p@n1n1NJ (17334 in chips) is sitting out
Seat 5: edpokernj123 (18030 in chips)=20
Seat 6: chucksaucey (10260 in chips)=20
Seat 7: JJin91 (19177 in chips)=20
Seat 8: TrademarkTer (25428 in chips)=20
Seat 9: jayjay8956 (13665 in chips)=20
CHAD9DW: posts the ante 70
Robbar211367: posts the ante 70
127Wlfhnd: posts the ante 70
p@n1n1NJ: posts the ante 70
edpokernj123: posts the ante 70
chucksaucey: posts the ante 70
JJin91: posts the ante 70
TrademarkTer: posts the ante 70
jayjay8956: posts the ante 70
127Wlfhnd: posts small blind 300
p@n1n1NJ: posts big blind 600
*** HOLE CARDS ***
Dealt to JJin91 [Ts 7d]
edpokernj123: calls 600
chucksaucey: folds=20
JJin91: folds=20
TrademarkTer: folds=20
jayjay8956: calls 600
CHAD9DW: calls 600
Robbar211367: folds=20
127Wlfhnd: calls 300
p@n1n1NJ: folds=20
*** FLOP *** [9d 5s 8c]
127Wlfhnd: checks=20
edpokernj123: checks=20
jayjay8956: bets 600
CHAD9DW: calls 600
127Wlfhnd: calls 600
edpokernj123: calls 600
*** TURN *** [9d 5s 8c] [9h]
127Wlfhnd: checks=20
edpokernj123: checks=20
jayjay8956: checks=20
CHAD9DW: checks=20
*** RIVER *** [9d 5s 8c 9h] [6s]
127Wlfhnd: bets 600
edpokernj123: folds=20
jayjay8956: folds=20
CHAD9DW: folds=20
Uncalled bet (600) returned to 127Wlfhnd
127Wlfhnd collected 6030 from pot
127Wlfhnd: doesn't show hand=20
*** SUMMARY ***
Total pot 6030 | Rake 0=20
Board [9d 5s 8c 9h 6s]
Seat 1: CHAD9DW folded on the River
Seat 2: Robbar211367 (button) folded before Flop (didn't bet)
Seat 3: 127Wlfhnd (small blind) collected (6030)
Seat 4: p@n1n1NJ (big blind) folded before Flop
Seat 5: edpokernj123 folded on the River
Seat 6: chucksaucey folded before Flop (didn't bet)
Seat 7: JJin91 folded before Flop (didn't bet)
Seat 8: TrademarkTer folded before Flop (didn't bet)
Seat 9: jayjay8956 folded on the River


*********** # 37 **************
PokerStars Hand #171704084926: Tournament #1648956862, $4.55+$0.45 USD =
Hold'em No Limit - Level XII (300/600) - 2017/06/25 22:05:17 ET
Table '1648956862 2' 9-max Seat #3 is the button
Seat 1: CHAD9DW (27567 in chips)=20
Seat 2: Robbar211367 (13279 in chips)=20
Seat 3: 127Wlfhnd (11480 in chips)=20
Seat 4: p@n1n1NJ (16664 in chips) is sitting out
Seat 5: edpokernj123 (16760 in chips)=20
Seat 6: chucksaucey (10190 in chips)=20
Seat 7: JJin91 (19107 in chips)=20
Seat 8: TrademarkTer (25358 in chips)=20
Seat 9: jayjay8956 (12395 in chips)=20
CHAD9DW: posts the ante 70
Robbar211367: posts the ante 70
127Wlfhnd: posts the ante 70
p@n1n1NJ: posts the ante 70
edpokernj123: posts the ante 70
chucksaucey: posts the ante 70
JJin91: posts the ante 70
TrademarkTer: posts the ante 70
jayjay8956: posts the ante 70
p@n1n1NJ: posts small blind 300
edpokernj123: posts big blind 600
*** HOLE CARDS ***
Dealt to JJin91 [3h 6d]
chucksaucey: folds=20
JJin91: folds=20
TrademarkTer: folds=20
jayjay8956: folds=20
CHAD9DW: folds=20
Robbar211367: folds=20
127Wlfhnd: folds=20
p@n1n1NJ: folds=20
Uncalled bet (300) returned to edpokernj123
edpokernj123 collected 1230 from pot
edpokernj123: doesn't show hand=20
*** SUMMARY ***
Total pot 1230 | Rake 0=20
Seat 1: CHAD9DW folded before Flop (didn't bet)
Seat 2: Robbar211367 folded before Flop (didn't bet)
Seat 3: 127Wlfhnd (button) folded before Flop (didn't bet)
Seat 4: p@n1n1NJ (small blind) folded before Flop
Seat 5: edpokernj123 (big blind) collected (1230)
Seat 6: chucksaucey folded before Flop (didn't bet)
Seat 7: JJin91 folded before Flop (didn't bet)
Seat 8: TrademarkTer folded before Flop (didn't bet)
Seat 9: jayjay8956 folded before Flop (didn't bet)


*********** # 38 **************
PokerStars Hand #171704084971: Tournament #1648956862, $4.55+$0.45 USD =
Hold'em No Limit - Level XII (300/600) - 2017/06/25 22:05:26 ET
Table '1648956862 2' 9-max Seat #4 is the button
Seat 1: CHAD9DW (27497 in chips)=20
Seat 2: Robbar211367 (13209 in chips)=20
Seat 3: 127Wlfhnd (11410 in chips)=20
Seat 4: p@n1n1NJ (16294 in chips) is sitting out
Seat 5: edpokernj123 (17620 in chips)=20
Seat 6: chucksaucey (10120 in chips)=20
Seat 7: JJin91 (19037 in chips)=20
Seat 8: TrademarkTer (25288 in chips)=20
Seat 9: jayjay8956 (12325 in chips)=20
CHAD9DW: posts the ante 70
Robbar211367: posts the ante 70
127Wlfhnd: posts the ante 70
p@n1n1NJ: posts the ante 70
edpokernj123: posts the ante 70
chucksaucey: posts the ante 70
JJin91: posts the ante 70
TrademarkTer: posts the ante 70
jayjay8956: posts the ante 70
edpokernj123: posts small blind 300
chucksaucey: posts big blind 600
*** HOLE CARDS ***
Dealt to JJin91 [Ah Jd]
JJin91: raises 666 to 1266
TrademarkTer: folds=20
jayjay8956: folds=20
CHAD9DW: folds=20
Robbar211367: folds=20
127Wlfhnd: folds=20
p@n1n1NJ: folds=20
edpokernj123: folds=20
chucksaucey: calls 666
*** FLOP *** [8h 5h 6d]
chucksaucey: checks=20
JJin91: checks=20
*** TURN *** [8h 5h 6d] [2s]
chucksaucey: bets 8784 and is all-in
JJin91: folds=20
Uncalled bet (8784) returned to chucksaucey
chucksaucey collected 3462 from pot
chucksaucey: doesn't show hand=20
*** SUMMARY ***
Total pot 3462 | Rake 0=20
Board [8h 5h 6d 2s]
Seat 1: CHAD9DW folded before Flop (didn't bet)
Seat 2: Robbar211367 folded before Flop (didn't bet)
Seat 3: 127Wlfhnd folded before Flop (didn't bet)
Seat 4: p@n1n1NJ (button) folded before Flop (didn't bet)
Seat 5: edpokernj123 (small blind) folded before Flop
Seat 6: chucksaucey (big blind) collected (3462)
Seat 7: JJin91 folded on the Turn
Seat 8: TrademarkTer folded before Flop (didn't bet)
Seat 9: jayjay8956 folded before Flop (didn't bet)


*********** # 39 **************
PokerStars Hand #171704085243: Tournament #1648956862, $4.55+$0.45 USD =
Hold'em No Limit - Level XIII (350/700) - 2017/06/25 22:06:24 ET
Table '1648956862 2' 9-max Seat #5 is the button
Seat 1: CHAD9DW (27427 in chips)=20
Seat 2: Robbar211367 (13139 in chips)=20
Seat 3: 127Wlfhnd (11340 in chips)=20
Seat 4: p@n1n1NJ (16224 in chips) is sitting out
Seat 5: edpokernj123 (17250 in chips)=20
Seat 6: chucksaucey (12246 in chips)=20
Seat 7: JJin91 (17701 in chips)=20
Seat 8: TrademarkTer (25218 in chips)=20
Seat 9: jayjay8956 (12255 in chips)=20
CHAD9DW: posts the ante 85
Robbar211367: posts the ante 85
127Wlfhnd: posts the ante 85
p@n1n1NJ: posts the ante 85
edpokernj123: posts the ante 85
chucksaucey: posts the ante 85
JJin91: posts the ante 85
TrademarkTer: posts the ante 85
jayjay8956: posts the ante 85
chucksaucey: posts small blind 350
JJin91: posts big blind 700
*** HOLE CARDS ***
Dealt to JJin91 [5h 9d]
TrademarkTer: folds=20
jayjay8956: folds=20
CHAD9DW: folds=20
Robbar211367: raises 12354 to 13054 and is all-in
127Wlfhnd: calls 11255 and is all-in
p@n1n1NJ: folds=20
edpokernj123: folds=20
chucksaucey: folds=20
JJin91: folds=20
Uncalled bet (1799) returned to Robbar211367
*** FLOP *** [Jh 2c Ts]
*** TURN *** [Jh 2c Ts] [8d]
*** RIVER *** [Jh 2c Ts 8d] [Qh]
*** SHOW DOWN ***
Robbar211367: shows [7c 7h] (a pair of Sevens)
127Wlfhnd: shows [As Qs] (a pair of Queens)
127Wlfhnd collected 24325 from pot
*** SUMMARY ***
Total pot 24325 | Rake 0=20
Board [Jh 2c Ts 8d Qh]
Seat 1: CHAD9DW folded before Flop (didn't bet)
Seat 2: Robbar211367 showed [7c 7h] and lost with a pair of Sevens
Seat 3: 127Wlfhnd showed [As Qs] and won (24325) with a pair of Queens
Seat 4: p@n1n1NJ folded before Flop (didn't bet)
Seat 5: edpokernj123 (button) folded before Flop (didn't bet)
Seat 6: chucksaucey (small blind) folded before Flop
Seat 7: JJin91 (big blind) folded before Flop
Seat 8: TrademarkTer folded before Flop (didn't bet)
Seat 9: jayjay8956 folded before Flop (didn't bet)


*********** # 40 **************
PokerStars Hand #171704085383: Tournament #1648956862, $4.55+$0.45 USD =
Hold'em No Limit - Level XIII (350/700) - 2017/06/25 22:06:54 ET
Table '1648956862 2' 9-max Seat #6 is the button
Seat 1: CHAD9DW (27342 in chips)=20
Seat 2: Robbar211367 (1799 in chips)=20
Seat 3: 127Wlfhnd (24325 in chips)=20
Seat 4: p@n1n1NJ (16139 in chips) is sitting out
Seat 5: edpokernj123 (17165 in chips)=20
Seat 6: chucksaucey (11811 in chips)=20
Seat 7: JJin91 (16916 in chips)=20
Seat 8: TrademarkTer (25133 in chips)=20
Seat 9: jayjay8956 (12170 in chips)=20
CHAD9DW: posts the ante 85
Robbar211367: posts the ante 85
127Wlfhnd: posts the ante 85
p@n1n1NJ: posts the ante 85
edpokernj123: posts the ante 85
chucksaucey: posts the ante 85
JJin91: posts the ante 85
TrademarkTer: posts the ante 85
jayjay8956: posts the ante 85
JJin91: posts small blind 350
TrademarkTer: posts big blind 700
*** HOLE CARDS ***
Dealt to JJin91 [7d 9c]
jayjay8956: folds=20
CHAD9DW: folds=20
Robbar211367: raises 1014 to 1714 and is all-in
127Wlfhnd: calls 1714
p@n1n1NJ: folds=20
edpokernj123: folds=20
chucksaucey: folds=20
JJin91: folds=20
TrademarkTer: calls 1014
*** FLOP *** [2d Ad 4d]
TrademarkTer: checks=20
127Wlfhnd: bets 2800
TrademarkTer: folds [5c 6c]
Uncalled bet (2800) returned to 127Wlfhnd
*** TURN *** [2d Ad 4d] [8d]
*** RIVER *** [2d Ad 4d 8d] [7h]
*** SHOW DOWN ***
Robbar211367: shows [3h As] (a pair of Aces)
127Wlfhnd: shows [Qh Ac] (a pair of Aces - Queen kicker)
127Wlfhnd collected 6257 from pot
Robbar211367 finished the tournament in 67th place
*** SUMMARY ***
Total pot 6257 | Rake 0=20
Board [2d Ad 4d 8d 7h]
Seat 1: CHAD9DW folded before Flop (didn't bet)
Seat 2: Robbar211367 showed [3h As] and lost with a pair of Aces
Seat 3: 127Wlfhnd showed [Qh Ac] and won (6257) with a pair of Aces
Seat 4: p@n1n1NJ folded before Flop (didn't bet)
Seat 5: edpokernj123 folded before Flop (didn't bet)
Seat 6: chucksaucey (button) folded before Flop (didn't bet)
Seat 7: JJin91 (small blind) folded before Flop
Seat 8: TrademarkTer (big blind) folded on the Flop
Seat 9: jayjay8956 folded before Flop (didn't bet)


*********** # 41 **************
PokerStars Hand #171704085589: Tournament #1648956862, $4.55+$0.45 USD =
Hold'em No Limit - Level XIII (350/700) - 2017/06/25 22:07:36 ET
Table '1648956862 2' 9-max Seat #7 is the button
Seat 1: CHAD9DW (27257 in chips)=20
Seat 3: 127Wlfhnd (28783 in chips)=20
Seat 4: p@n1n1NJ (16054 in chips) is sitting out
Seat 5: edpokernj123 (17080 in chips)=20
Seat 6: chucksaucey (11726 in chips)=20
Seat 7: JJin91 (16481 in chips)=20
Seat 8: TrademarkTer (23334 in chips)=20
Seat 9: jayjay8956 (12085 in chips)=20
CHAD9DW: posts the ante 85
127Wlfhnd: posts the ante 85
p@n1n1NJ: posts the ante 85
edpokernj123: posts the ante 85
chucksaucey: posts the ante 85
JJin91: posts the ante 85
TrademarkTer: posts the ante 85
jayjay8956: posts the ante 85
TrademarkTer: posts small blind 350
jayjay8956: posts big blind 700
*** HOLE CARDS ***
Dealt to JJin91 [Ks Ac]
CHAD9DW: folds=20
127Wlfhnd: folds=20
p@n1n1NJ: folds=20
edpokernj123: folds=20
chucksaucey: raises 10941 to 11641 and is all-in
JJin91: raises 4755 to 16396 and is all-in
TrademarkTer: folds=20
jayjay8956: folds=20
Uncalled bet (4755) returned to JJin91
*** FLOP *** [6d Ad Kc]
*** TURN *** [6d Ad Kc] [3s]
TrademarkTer said, "look at dat action"
*** RIVER *** [6d Ad Kc 3s] [3d]
*** SHOW DOWN ***
chucksaucey: shows [Jh As] (two pair, Aces and Threes)
JJin91: shows [Ks Ac] (two pair, Aces and Kings)
JJin91 collected 25012 from pot
chucksaucey finished the tournament in 66th place
*** SUMMARY ***
Total pot 25012 | Rake 0=20
Board [6d Ad Kc 3s 3d]
Seat 1: CHAD9DW folded before Flop (didn't bet)
Seat 3: 127Wlfhnd folded before Flop (didn't bet)
Seat 4: p@n1n1NJ folded before Flop (didn't bet)
Seat 5: edpokernj123 folded before Flop (didn't bet)
Seat 6: chucksaucey showed [Jh As] and lost with two pair, Aces and Thr=
ees
Seat 7: JJin91 (button) showed [Ks Ac] and won (25012) with two pair, A=
ces and Kings
Seat 8: TrademarkTer (small blind) folded before Flop
Seat 9: jayjay8956 (big blind) folded before Flop


*********** # 42 **************
PokerStars Hand #171704085738: Tournament #1648956862, $4.55+$0.45 USD =
Hold'em No Limit - Level XIII (350/700) - 2017/06/25 22:08:06 ET
Table '1648956862 2' 9-max Seat #8 is the button
Seat 1: CHAD9DW (27172 in chips)=20
Seat 3: 127Wlfhnd (28698 in chips)=20
Seat 4: p@n1n1NJ (15969 in chips) is sitting out
Seat 5: edpokernj123 (16995 in chips)=20
Seat 7: JJin91 (29767 in chips)=20
Seat 8: TrademarkTer (22899 in chips)=20
Seat 9: jayjay8956 (11300 in chips)=20
CHAD9DW: posts the ante 85
127Wlfhnd: posts the ante 85
p@n1n1NJ: posts the ante 85
edpokernj123: posts the ante 85
JJin91: posts the ante 85
TrademarkTer: posts the ante 85
jayjay8956: posts the ante 85
jayjay8956: posts small blind 350
CHAD9DW: posts big blind 700
*** HOLE CARDS ***
Dealt to JJin91 [8s Jc]
127Wlfhnd: folds=20
p@n1n1NJ: folds=20
edpokernj123: raises 700 to 1400
JJin91: folds=20
TrademarkTer: calls 1400
jayjay8956: calls 1050
CHAD9DW: calls 700
*** FLOP *** [4h 4d Js]
jayjay8956: checks=20
CHAD9DW: checks=20
edpokernj123: checks=20
TrademarkTer: bets 3098
jayjay8956: folds=20
CHAD9DW: folds=20
edpokernj123: calls 3098
*** TURN *** [4h 4d Js] [6d]
edpokernj123: checks=20
TrademarkTer: bets 6196
edpokernj123: calls 6196
*** RIVER *** [4h 4d Js 6d] [3s]
edpokernj123: checks=20
TrademarkTer: bets 12120 and is all-in
edpokernj123: folds=20
Uncalled bet (12120) returned to TrademarkTer
TrademarkTer collected 24783 from pot
*** SUMMARY ***
Total pot 24783 | Rake 0=20
Board [4h 4d Js 6d 3s]
Seat 1: CHAD9DW (big blind) folded on the Flop
Seat 3: 127Wlfhnd folded before Flop (didn't bet)
Seat 4: p@n1n1NJ folded before Flop (didn't bet)
Seat 5: edpokernj123 folded on the River
Seat 7: JJin91 folded before Flop (didn't bet)
Seat 8: TrademarkTer (button) collected (24783)
Seat 9: jayjay8956 (small blind) folded on the Flop


*********** # 43 **************
PokerStars Hand #171704086107: Tournament #1648956862, $4.55+$0.45 USD =
Hold'em No Limit - Level XIII (350/700) - 2017/06/25 22:09:22 ET
Table '1648956862 2' 9-max Seat #9 is the button
Seat 1: CHAD9DW (25687 in chips)=20
Seat 2: gator856500 (9530 in chips)=20
Seat 3: 127Wlfhnd (28613 in chips)=20
Seat 4: p@n1n1NJ (15884 in chips) is sitting out
Seat 5: edpokernj123 (6216 in chips)=20
Seat 7: JJin91 (29682 in chips)=20
Seat 8: TrademarkTer (36903 in chips)=20
Seat 9: jayjay8956 (9815 in chips)=20
CHAD9DW: posts the ante 85
gator856500: posts the ante 85
127Wlfhnd: posts the ante 85
p@n1n1NJ: posts the ante 85
edpokernj123: posts the ante 85
JJin91: posts the ante 85
TrademarkTer: posts the ante 85
jayjay8956: posts the ante 85
CHAD9DW: posts small blind 350
gator856500: posts big blind 700
*** HOLE CARDS ***
Dealt to JJin91 [9s 8s]
127Wlfhnd: folds=20
p@n1n1NJ: folds=20
edpokernj123: folds=20
JJin91: raises 777 to 1477
TrademarkTer: calls 1477
jayjay8956: folds=20
CHAD9DW: folds=20
gator856500: folds=20
*** FLOP *** [7c 7d Ac]
JJin91: bets 1546
TrademarkTer: calls 1546
*** TURN *** [7c 7d Ac] [3d]
JJin91: checks=20
TrademarkTer: checks=20
*** RIVER *** [7c 7d Ac 3d] [7h]
JJin91: bets 3810
TrademarkTer said, "I do have a boat but I'm not thrilled about paying =
your ace"
TrademarkTer said, "I think Im obligated to though"
TrademarkTer: calls 3810
*** SHOW DOWN ***
JJin91: shows [9s 8s] (three of a kind, Sevens)
TrademarkTer: shows [5h 5c] (a full house, Sevens full of Fives)
TrademarkTer collected 15396 from pot
*** SUMMARY ***
Total pot 15396 | Rake 0=20
Board [7c 7d Ac 3d 7h]
Seat 1: CHAD9DW (small blind) folded before Flop
Seat 2: gator856500 (big blind) folded before Flop
Seat 3: 127Wlfhnd folded before Flop (didn't bet)
Seat 4: p@n1n1NJ folded before Flop (didn't bet)
Seat 5: edpokernj123 folded before Flop (didn't bet)
Seat 7: JJin91 showed [9s 8s] and lost with three of a kind, Sevens
Seat 8: TrademarkTer showed [5h 5c] and won (15396) with a full house, =
Sevens full of Fives
Seat 9: jayjay8956 (button) folded before Flop (didn't bet)


*********** # 44 **************
PokerStars Hand #171704086492: Tournament #1648956862, $4.55+$0.45 USD =
Hold'em No Limit - Level XIII (350/700) - 2017/06/25 22:10:38 ET
Table '1648956862 2' 9-max Seat #1 is the button
Seat 1: CHAD9DW (25252 in chips)=20
Seat 2: gator856500 (8745 in chips)=20
Seat 3: 127Wlfhnd (28528 in chips)=20
Seat 4: p@n1n1NJ (15799 in chips) is sitting out
Seat 5: edpokernj123 (6131 in chips)=20
Seat 7: JJin91 (22764 in chips)=20
Seat 8: TrademarkTer (45381 in chips)=20
Seat 9: jayjay8956 (9730 in chips)=20
CHAD9DW: posts the ante 85
gator856500: posts the ante 85
127Wlfhnd: posts the ante 85
p@n1n1NJ: posts the ante 85
edpokernj123: posts the ante 85
JJin91: posts the ante 85
TrademarkTer: posts the ante 85
jayjay8956: posts the ante 85
gator856500: posts small blind 350
127Wlfhnd: posts big blind 700
*** HOLE CARDS ***
Dealt to JJin91 [8d Js]
p@n1n1NJ: folds=20
TrademarkTer said, "bluffy johaneson!"
edpokernj123: folds=20
JJin91: folds=20
TrademarkTer: folds=20
jayjay8956: calls 700
CHAD9DW: raises 2000 to 2700
gator856500: folds=20
127Wlfhnd: calls 2000
jayjay8956: folds=20
*** FLOP *** [2c 8c Qs]
127Wlfhnd: checks=20
CHAD9DW: bets 2700
127Wlfhnd: folds=20
Uncalled bet (2700) returned to CHAD9DW
CHAD9DW collected 7130 from pot
CHAD9DW: doesn't show hand=20
*** SUMMARY ***
Total pot 7130 | Rake 0=20
Board [2c 8c Qs]
Seat 1: CHAD9DW (button) collected (7130)
Seat 2: gator856500 (small blind) folded before Flop
Seat 3: 127Wlfhnd (big blind) folded on the Flop
Seat 4: p@n1n1NJ folded before Flop (didn't bet)
Seat 5: edpokernj123 folded before Flop (didn't bet)
Seat 7: JJin91 folded before Flop (didn't bet)
Seat 8: TrademarkTer folded before Flop (didn't bet)
Seat 9: jayjay8956 folded before Flop


*********** # 45 **************
PokerStars Hand #171704086751: Tournament #1648956862, $4.55+$0.45 USD =
Hold'em No Limit - Level XIV (400/800) - 2017/06/25 22:11:30 ET
Table '1648956862 2' 9-max Seat #2 is the button
Seat 1: CHAD9DW (29597 in chips)=20
Seat 2: gator856500 (8310 in chips)=20
Seat 3: 127Wlfhnd (25743 in chips)=20
Seat 4: p@n1n1NJ (15714 in chips) is sitting out
Seat 5: edpokernj123 (6046 in chips)=20
Seat 7: JJin91 (22679 in chips)=20
Seat 8: TrademarkTer (45296 in chips)=20
Seat 9: jayjay8956 (8945 in chips)=20
CHAD9DW: posts the ante 100
gator856500: posts the ante 100
127Wlfhnd: posts the ante 100
p@n1n1NJ: posts the ante 100
edpokernj123: posts the ante 100
JJin91: posts the ante 100
TrademarkTer: posts the ante 100
jayjay8956: posts the ante 100
127Wlfhnd: posts small blind 400
p@n1n1NJ: posts big blind 800
*** HOLE CARDS ***
Dealt to JJin91 [Qs Ad]
edpokernj123: folds=20
JJin91: raises 888 to 1688
TrademarkTer: folds=20
jayjay8956: folds=20
CHAD9DW: folds=20
gator856500: folds=20
127Wlfhnd: folds=20
p@n1n1NJ: folds=20
Uncalled bet (888) returned to JJin91
JJin91 collected 2800 from pot
JJin91: doesn't show hand=20
*** SUMMARY ***
Total pot 2800 | Rake 0=20
Seat 1: CHAD9DW folded before Flop (didn't bet)
Seat 2: gator856500 (button) folded before Flop (didn't bet)
Seat 3: 127Wlfhnd (small blind) folded before Flop
Seat 4: p@n1n1NJ (big blind) folded before Flop
Seat 5: edpokernj123 folded before Flop (didn't bet)
Seat 7: JJin91 collected (2800)
Seat 8: TrademarkTer folded before Flop (didn't bet)
Seat 9: jayjay8956 folded before Flop (didn't bet)


*********** # 46 **************
PokerStars Hand #171704086876: Tournament #1648956862, $4.55+$0.45 USD =
Hold'em No Limit - Level XIV (400/800) - 2017/06/25 22:11:56 ET
Table '1648956862 2' 9-max Seat #3 is the button
Seat 1: CHAD9DW (29497 in chips)=20
Seat 2: gator856500 (8210 in chips)=20
Seat 3: 127Wlfhnd (25243 in chips)=20
Seat 4: p@n1n1NJ (14814 in chips) is sitting out
Seat 5: edpokernj123 (5946 in chips)=20
Seat 7: JJin91 (24579 in chips)=20
Seat 8: TrademarkTer (45196 in chips)=20
Seat 9: jayjay8956 (8845 in chips)=20
CHAD9DW: posts the ante 100
gator856500: posts the ante 100
127Wlfhnd: posts the ante 100
p@n1n1NJ: posts the ante 100
edpokernj123: posts the ante 100
JJin91: posts the ante 100
TrademarkTer: posts the ante 100
jayjay8956: posts the ante 100
p@n1n1NJ: posts small blind 400
edpokernj123: posts big blind 800
*** HOLE CARDS ***
Dealt to JJin91 [9c 2h]
JJin91: folds=20
TrademarkTer: calls 800
jayjay8956: calls 800
CHAD9DW: calls 800
gator856500: calls 800
127Wlfhnd: folds=20
p@n1n1NJ: folds=20
edpokernj123: checks=20
*** FLOP *** [3h 6s 6d]
edpokernj123: checks=20
TrademarkTer: checks=20
jayjay8956: bets 2600
CHAD9DW: folds=20
gator856500: folds=20
TrademarkTer said, "jayjay likes the flop!!!!!"
edpokernj123: folds=20
TrademarkTer: folds=20
Uncalled bet (2600) returned to jayjay8956
jayjay8956 collected 5200 from pot
jayjay8956: doesn't show hand=20
*** SUMMARY ***
Total pot 5200 | Rake 0=20
Board [3h 6s 6d]
Seat 1: CHAD9DW folded on the Flop
Seat 2: gator856500 folded on the Flop
Seat 3: 127Wlfhnd (button) folded before Flop (didn't bet)
Seat 4: p@n1n1NJ (small blind) folded before Flop
Seat 5: edpokernj123 (big blind) folded on the Flop
Seat 7: JJin91 folded before Flop (didn't bet)
Seat 8: TrademarkTer folded on the Flop
Seat 9: jayjay8956 collected (5200)


*********** # 47 **************
PokerStars Hand #171704087087: Tournament #1648956862, $4.55+$0.45 USD =
Hold'em No Limit - Level XIV (400/800) - 2017/06/25 22:12:37 ET
Table '1648956862 2' 9-max Seat #4 is the button
Seat 1: CHAD9DW (28597 in chips)=20
Seat 2: gator856500 (7310 in chips)=20
Seat 3: 127Wlfhnd (25143 in chips)=20
Seat 4: p@n1n1NJ (14314 in chips) is sitting out
Seat 5: edpokernj123 (5046 in chips)=20
Seat 6: CrittyJJones (8302 in chips)=20
Seat 7: JJin91 (24479 in chips)=20
Seat 8: TrademarkTer (44296 in chips)=20
Seat 9: jayjay8956 (13145 in chips)=20
CHAD9DW: posts the ante 100
gator856500: posts the ante 100
127Wlfhnd: posts the ante 100
p@n1n1NJ: posts the ante 100
edpokernj123: posts the ante 100
CrittyJJones: posts the ante 100
JJin91: posts the ante 100
TrademarkTer: posts the ante 100
jayjay8956: posts the ante 100
edpokernj123: posts small blind 400
CrittyJJones: posts big blind 800
*** HOLE CARDS ***
Dealt to JJin91 [Qd Th]
JJin91: folds=20
TrademarkTer: folds=20
jayjay8956: calls 800
CHAD9DW: folds=20
gator856500: folds=20
127Wlfhnd: folds=20
p@n1n1NJ: folds=20
edpokernj123: raises 4146 to 4946 and is all-in
CrittyJJones: folds=20
jayjay8956: calls 4146
*** FLOP *** [3h 3c 4s]
*** TURN *** [3h 3c 4s] [8d]
*** RIVER *** [3h 3c 4s 8d] [6c]
*** SHOW DOWN ***
edpokernj123: shows [Ad 5c] (a pair of Threes)
jayjay8956: shows [Qh Ah] (a pair of Threes - Ace+Queen kicker)
jayjay8956 collected 11592 from pot
edpokernj123 finished the tournament in 62nd place
*** SUMMARY ***
Total pot 11592 | Rake 0=20
Board [3h 3c 4s 8d 6c]
Seat 1: CHAD9DW folded before Flop (didn't bet)
Seat 2: gator856500 folded before Flop (didn't bet)
Seat 3: 127Wlfhnd folded before Flop (didn't bet)
Seat 4: p@n1n1NJ (button) folded before Flop (didn't bet)
Seat 5: edpokernj123 (small blind) showed [Ad 5c] and lost with a pair =
of Threes
Seat 6: CrittyJJones (big blind) folded before Flop
Seat 7: JJin91 folded before Flop (didn't bet)
Seat 8: TrademarkTer folded before Flop (didn't bet)
Seat 9: jayjay8956 showed [Qh Ah] and won (11592) with a pair of Threes


*********** # 48 **************
PokerStars Hand #171704087264: Tournament #1648956862, $4.55+$0.45 USD =
Hold'em No Limit - Level XIV (400/800) - 2017/06/25 22:13:11 ET
Table '1648956862 2' 9-max Seat #6 is the button
Seat 1: CHAD9DW (28497 in chips)=20
Seat 2: gator856500 (7210 in chips)=20
Seat 3: 127Wlfhnd (25043 in chips)=20
Seat 4: p@n1n1NJ (14214 in chips) is sitting out
Seat 6: CrittyJJones (7402 in chips)=20
Seat 7: JJin91 (24379 in chips)=20
Seat 8: TrademarkTer (44196 in chips)=20
Seat 9: jayjay8956 (19691 in chips)=20
CHAD9DW: posts the ante 100
gator856500: posts the ante 100
127Wlfhnd: posts the ante 100
p@n1n1NJ: posts the ante 100
CrittyJJones: posts the ante 100
JJin91: posts the ante 100
TrademarkTer: posts the ante 100
jayjay8956: posts the ante 100
JJin91: posts small blind 400
TrademarkTer: posts big blind 800
*** HOLE CARDS ***
Dealt to JJin91 [3d Qh]
jayjay8956: calls 800
CHAD9DW: folds=20
gator856500: folds=20
127Wlfhnd: folds=20
p@n1n1NJ: folds=20
CrittyJJones: folds=20
JJin91: folds=20
TrademarkTer: checks=20
*** FLOP *** [Kd 9c 9s]
TrademarkTer: checks=20
jayjay8956: bets 800
TrademarkTer: calls 800
*** TURN *** [Kd 9c 9s] [6s]
TrademarkTer: checks=20
jayjay8956: checks=20
*** RIVER *** [Kd 9c 9s 6s] [Kh]
TrademarkTer: checks=20
p@n1n1NJ has returned
jayjay8956: bets 800
TrademarkTer: calls 800
*** SHOW DOWN ***
jayjay8956: shows [4h Ad] (two pair, Kings and Nines)
TrademarkTer: shows [Ac 6c] (two pair, Kings and Nines)
TrademarkTer collected 3000 from pot
jayjay8956 collected 3000 from pot
*** SUMMARY ***
Total pot 6000 | Rake 0=20
Board [Kd 9c 9s 6s Kh]
Seat 1: CHAD9DW folded before Flop (didn't bet)
Seat 2: gator856500 folded before Flop (didn't bet)
Seat 3: 127Wlfhnd folded before Flop (didn't bet)
Seat 4: p@n1n1NJ folded before Flop (didn't bet)
Seat 6: CrittyJJones (button) folded before Flop (didn't bet)
Seat 7: JJin91 (small blind) folded before Flop
Seat 8: TrademarkTer (big blind) showed [Ac 6c] and won (3000) with two=
 pair, Kings and Nines
Seat 9: jayjay8956 showed [4h Ad] and won (3000) with two pair, Kings a=
nd Nines


*********** # 49 **************
PokerStars Hand #171704087419: Tournament #1648956862, $4.55+$0.45 USD =
Hold'em No Limit - Level XIV (400/800) - 2017/06/25 22:13:43 ET
Table '1648956862 2' 9-max Seat #7 is the button
Seat 1: CHAD9DW (28397 in chips)=20
Seat 2: gator856500 (7110 in chips)=20
Seat 3: 127Wlfhnd (24943 in chips)=20
Seat 4: p@n1n1NJ (14114 in chips)=20
Seat 6: CrittyJJones (7302 in chips)=20
Seat 7: JJin91 (23879 in chips)=20
Seat 8: TrademarkTer (44696 in chips)=20
Seat 9: jayjay8956 (20191 in chips)=20
CHAD9DW: posts the ante 100
gator856500: posts the ante 100
127Wlfhnd: posts the ante 100
p@n1n1NJ: posts the ante 100
CrittyJJones: posts the ante 100
JJin91: posts the ante 100
TrademarkTer: posts the ante 100
jayjay8956: posts the ante 100
TrademarkTer: posts small blind 400
jayjay8956: posts big blind 800
*** HOLE CARDS ***
Dealt to JJin91 [6s Jh]
CHAD9DW: folds=20
gator856500: folds=20
127Wlfhnd: folds=20
p@n1n1NJ: raises 1600 to 2400
CrittyJJones: folds=20
JJin91: folds=20
TrademarkTer: folds=20
jayjay8956: folds=20
Uncalled bet (1600) returned to p@n1n1NJ
p@n1n1NJ collected 2800 from pot
p@n1n1NJ: doesn't show hand=20
*** SUMMARY ***
Total pot 2800 | Rake 0=20
Seat 1: CHAD9DW folded before Flop (didn't bet)
Seat 2: gator856500 folded before Flop (didn't bet)
Seat 3: 127Wlfhnd folded before Flop (didn't bet)
Seat 4: p@n1n1NJ collected (2800)
Seat 6: CrittyJJones folded before Flop (didn't bet)
Seat 7: JJin91 (button) folded before Flop (didn't bet)
Seat 8: TrademarkTer (small blind) folded before Flop
Seat 9: jayjay8956 (big blind) folded before Flop


*********** # 50 **************
PokerStars Hand #171704087519: Tournament #1648956862, $4.55+$0.45 USD =
Hold'em No Limit - Level XIV (400/800) - 2017/06/25 22:14:03 ET
Table '1648956862 2' 9-max Seat #8 is the button
Seat 1: CHAD9DW (28297 in chips)=20
Seat 2: gator856500 (7010 in chips)=20
Seat 3: 127Wlfhnd (24843 in chips)=20
Seat 4: p@n1n1NJ (16014 in chips)=20
Seat 6: CrittyJJones (7202 in chips)=20
Seat 7: JJin91 (23779 in chips)=20
Seat 8: TrademarkTer (44196 in chips)=20
Seat 9: jayjay8956 (19291 in chips)=20
CHAD9DW: posts the ante 100
gator856500: posts the ante 100
127Wlfhnd: posts the ante 100
p@n1n1NJ: posts the ante 100
CrittyJJones: posts the ante 100
JJin91: posts the ante 100
TrademarkTer: posts the ante 100
jayjay8956: posts the ante 100
jayjay8956: posts small blind 400
CHAD9DW: posts big blind 800
*** HOLE CARDS ***
Dealt to JJin91 [6c 9c]
gator856500: folds=20
127Wlfhnd: folds=20
p@n1n1NJ: calls 800
CrittyJJones: folds=20
JJin91: folds=20
TrademarkTer: calls 800
jayjay8956: calls 400
CHAD9DW: raises 3000 to 3800
p@n1n1NJ: folds=20
TrademarkTer: calls 3000
jayjay8956: folds=20
*** FLOP *** [3h 3d 8d]
CHAD9DW: bets 5800
TrademarkTer said, "if those diamondes were hearts chadow"
TrademarkTer said, "we could play"
TrademarkTer said, "but theyre diamondes"
TrademarkTer said, "so we cant"
TrademarkTer said, "sorry bud"
TrademarkTer: folds=20
Uncalled bet (5800) returned to CHAD9DW
CHAD9DW collected 10000 from pot
*** SUMMARY ***
Total pot 10000 | Rake 0=20
Board [3h 3d 8d]
Seat 1: CHAD9DW (big blind) collected (10000)
Seat 2: gator856500 folded before Flop (didn't bet)
Seat 3: 127Wlfhnd folded before Flop (didn't bet)
Seat 4: p@n1n1NJ folded before Flop
Seat 6: CrittyJJones folded before Flop (didn't bet)
Seat 7: JJin91 folded before Flop (didn't bet)
Seat 8: TrademarkTer (button) folded on the Flop
Seat 9: jayjay8956 (small blind) folded before Flop


*********** # 51 **************
PokerStars Hand #171704087827: Tournament #1648956862, $4.55+$0.45 USD =
Hold'em No Limit - Level XIV (400/800) - 2017/06/25 22:15:06 ET
Table '1648956862 2' 9-max Seat #9 is the button
Seat 1: CHAD9DW (34397 in chips)=20
Seat 2: gator856500 (6910 in chips)=20
Seat 3: 127Wlfhnd (24743 in chips)=20
Seat 4: p@n1n1NJ (15114 in chips)=20
Seat 5: ras41183 (43776 in chips)=20
Seat 6: CrittyJJones (7102 in chips)=20
Seat 7: JJin91 (23679 in chips)=20
Seat 8: TrademarkTer (40296 in chips)=20
Seat 9: jayjay8956 (18391 in chips)=20
CHAD9DW: posts the ante 100
gator856500: posts the ante 100
127Wlfhnd: posts the ante 100
p@n1n1NJ: posts the ante 100
ras41183: posts the ante 100
CrittyJJones: posts the ante 100
JJin91: posts the ante 100
TrademarkTer: posts the ante 100
jayjay8956: posts the ante 100
CHAD9DW: posts small blind 400
gator856500: posts big blind 800
*** HOLE CARDS ***
Dealt to JJin91 [Th Td]
127Wlfhnd: folds=20
p@n1n1NJ: raises 800 to 1600
jayjay8956 said, "and if my mother had balls she'd be my father"
ras41183: calls 1600
CrittyJJones: folds=20
JJin91: calls 1600
TrademarkTer: folds=20
jayjay8956: folds=20
CHAD9DW: folds=20
gator856500: calls 800
*** FLOP *** [Ts 6d 4s]
TrademarkTer said, "shed still be your mother and shed still love you v=
ery much"
gator856500: checks=20
p@n1n1NJ: checks=20
ras41183: bets 1600
JJin91: calls 1600
gator856500: folds=20
p@n1n1NJ: folds=20
*** TURN *** [Ts 6d 4s] [Kc]
ras41183: checks=20
JJin91: bets 8611
ras41183: folds=20
Uncalled bet (8611) returned to JJin91
JJin91 collected 10900 from pot
JJin91: doesn't show hand=20
*** SUMMARY ***
Total pot 10900 | Rake 0=20
Board [Ts 6d 4s Kc]
Seat 1: CHAD9DW (small blind) folded before Flop
Seat 2: gator856500 (big blind) folded on the Flop
Seat 3: 127Wlfhnd folded before Flop (didn't bet)
Seat 4: p@n1n1NJ folded on the Flop
Seat 5: ras41183 folded on the Turn
Seat 6: CrittyJJones folded before Flop (didn't bet)
Seat 7: JJin91 collected (10900)
Seat 8: TrademarkTer folded before Flop (didn't bet)
Seat 9: jayjay8956 (button) folded before Flop (didn't bet)


*********** # 52 **************
PokerStars Hand #171704088123: Tournament #1648956862, $4.55+$0.45 USD =
Hold'em No Limit - Level XV (500/1000) - 2017/06/25 22:16:06 ET
Table '1648956862 2' 9-max Seat #1 is the button
Seat 1: CHAD9DW (33897 in chips)=20
Seat 2: gator856500 (5210 in chips)=20
Seat 3: 127Wlfhnd (24643 in chips)=20
Seat 4: p@n1n1NJ (13414 in chips)=20
Seat 5: ras41183 (40476 in chips)=20
Seat 6: CrittyJJones (7002 in chips)=20
Seat 7: JJin91 (31279 in chips)=20
Seat 8: TrademarkTer (40196 in chips)=20
Seat 9: jayjay8956 (18291 in chips)=20
CHAD9DW: posts the ante 125
gator856500: posts the ante 125
127Wlfhnd: posts the ante 125
p@n1n1NJ: posts the ante 125
ras41183: posts the ante 125
CrittyJJones: posts the ante 125
JJin91: posts the ante 125
TrademarkTer: posts the ante 125
jayjay8956: posts the ante 125
gator856500: posts small blind 500
127Wlfhnd: posts big blind 1000
*** HOLE CARDS ***
Dealt to JJin91 [Ts Js]
p@n1n1NJ: raises 12289 to 13289 and is all-in
ras41183: folds=20
CrittyJJones: folds=20
JJin91: folds=20
TrademarkTer: folds=20
jayjay8956: folds=20
CHAD9DW: folds=20
gator856500: folds=20
127Wlfhnd: folds=20
Uncalled bet (12289) returned to p@n1n1NJ
p@n1n1NJ collected 3625 from pot
p@n1n1NJ: doesn't show hand=20
*** SUMMARY ***
Total pot 3625 | Rake 0=20
Seat 1: CHAD9DW (button) folded before Flop (didn't bet)
Seat 2: gator856500 (small blind) folded before Flop
Seat 3: 127Wlfhnd (big blind) folded before Flop
Seat 4: p@n1n1NJ collected (3625)
Seat 5: ras41183 folded before Flop (didn't bet)
Seat 6: CrittyJJones folded before Flop (didn't bet)
Seat 7: JJin91 folded before Flop (didn't bet)
Seat 8: TrademarkTer folded before Flop (didn't bet)
Seat 9: jayjay8956 folded before Flop (didn't bet)


*********** # 53 **************
PokerStars Hand #171704088403: Tournament #1648956862, $4.55+$0.45 USD =
Hold'em No Limit - Level XV (500/1000) - 2017/06/25 22:17:00 ET
Table '1648956862 2' 9-max Seat #2 is the button
Seat 1: CHAD9DW (33772 in chips)=20
Seat 2: gator856500 (4585 in chips)=20
Seat 3: 127Wlfhnd (23518 in chips)=20
Seat 4: p@n1n1NJ (15914 in chips)=20
Seat 5: ras41183 (40351 in chips)=20
Seat 6: CrittyJJones (6877 in chips)=20
Seat 7: JJin91 (31154 in chips)=20
Seat 8: TrademarkTer (40071 in chips)=20
CHAD9DW: posts the ante 125
gator856500: posts the ante 125
127Wlfhnd: posts the ante 125
p@n1n1NJ: posts the ante 125
ras41183: posts the ante 125
CrittyJJones: posts the ante 125
JJin91: posts the ante 125
TrademarkTer: posts the ante 125
127Wlfhnd: posts small blind 500
p@n1n1NJ: posts big blind 1000
*** HOLE CARDS ***
Dealt to JJin91 [Qs Ts]
ras41183: calls 1000
CrittyJJones: folds=20
JJin91: folds=20
TrademarkTer: folds=20
CHAD9DW: folds=20
gator856500: folds=20
127Wlfhnd: folds=20
p@n1n1NJ: checks=20
*** FLOP *** [4d 7s Kh]
p@n1n1NJ: checks=20
ras41183: checks=20
*** TURN *** [4d 7s Kh] [2c]
p@n1n1NJ: bets 2000
ras41183: folds=20
Uncalled bet (2000) returned to p@n1n1NJ
p@n1n1NJ collected 3500 from pot
p@n1n1NJ: doesn't show hand=20
*** SUMMARY ***
Total pot 3500 | Rake 0=20
Board [4d 7s Kh 2c]
Seat 1: CHAD9DW folded before Flop (didn't bet)
Seat 2: gator856500 (button) folded before Flop (didn't bet)
Seat 3: 127Wlfhnd (small blind) folded before Flop
Seat 4: p@n1n1NJ (big blind) collected (3500)
Seat 5: ras41183 folded on the Turn
Seat 6: CrittyJJones folded before Flop (didn't bet)
Seat 7: JJin91 folded before Flop (didn't bet)
Seat 8: TrademarkTer folded before Flop (didn't bet)


*********** # 54 **************
PokerStars Hand #171704088666: Tournament #1648956862, $4.55+$0.45 USD =
Hold'em No Limit - Level XV (500/1000) - 2017/06/25 22:17:51 ET
Table '1648956862 2' 9-max Seat #3 is the button
Seat 1: CHAD9DW (33647 in chips)=20
Seat 2: gator856500 (4460 in chips)=20
Seat 3: 127Wlfhnd (22893 in chips)=20
Seat 4: p@n1n1NJ (18289 in chips)=20
Seat 5: ras41183 (39226 in chips)=20
Seat 6: CrittyJJones (6752 in chips)=20
Seat 7: JJin91 (31029 in chips)=20
Seat 8: TrademarkTer (39946 in chips)=20
CHAD9DW: posts the ante 125
gator856500: posts the ante 125
127Wlfhnd: posts the ante 125
p@n1n1NJ: posts the ante 125
ras41183: posts the ante 125
CrittyJJones: posts the ante 125
JJin91: posts the ante 125
TrademarkTer: posts the ante 125
p@n1n1NJ: posts small blind 500
ras41183: posts big blind 1000
*** HOLE CARDS ***
Dealt to JJin91 [Ah Qc]
CrittyJJones: folds=20
JJin91: raises 1110 to 2110
TrademarkTer: folds=20
CHAD9DW: folds=20
gator856500: folds=20
127Wlfhnd: calls 2110
p@n1n1NJ: calls 1610
ras41183: calls 1110
*** FLOP *** [7d 3h Kc]
p@n1n1NJ: checks=20
ras41183: checks=20
JJin91: checks=20
127Wlfhnd: checks=20
*** TURN *** [7d 3h Kc] [6s]
p@n1n1NJ: checks=20
ras41183: checks=20
JJin91: checks=20
127Wlfhnd: checks=20
*** RIVER *** [7d 3h Kc 6s] [5d]
p@n1n1NJ: bets 5000
ras41183: calls 5000
JJin91: folds=20
127Wlfhnd: folds=20
*** SHOW DOWN ***
p@n1n1NJ: shows [5s 4c] (a straight, Three to Seven)
ras41183: mucks hand=20
p@n1n1NJ collected 19440 from pot
*** SUMMARY ***
Total pot 19440 | Rake 0=20
Board [7d 3h Kc 6s 5d]
Seat 1: CHAD9DW folded before Flop (didn't bet)
Seat 2: gator856500 folded before Flop (didn't bet)
Seat 3: 127Wlfhnd (button) folded on the River
Seat 4: p@n1n1NJ (small blind) showed [5s 4c] and won (19440) with a st=
raight, Three to Seven
Seat 5: ras41183 (big blind) mucked [7s Qd]
Seat 6: CrittyJJones folded before Flop (didn't bet)
Seat 7: JJin91 folded on the River
Seat 8: TrademarkTer folded before Flop (didn't bet)


*********** # 55 **************
PokerStars Hand #171704089050: Tournament #1648956862, $4.55+$0.45 USD =
Hold'em No Limit - Level XV (500/1000) - 2017/06/25 22:19:08 ET
Table '1648956862 2' 9-max Seat #4 is the button
Seat 1: CHAD9DW (33522 in chips)=20
Seat 2: gator856500 (4335 in chips)=20
Seat 3: 127Wlfhnd (20658 in chips)=20
Seat 4: p@n1n1NJ (30494 in chips)=20
Seat 5: ras41183 (31991 in chips)=20
Seat 6: CrittyJJones (6627 in chips)=20
Seat 7: JJin91 (28794 in chips)=20
Seat 8: TrademarkTer (39821 in chips)=20
CHAD9DW: posts the ante 125
gator856500: posts the ante 125
127Wlfhnd: posts the ante 125
p@n1n1NJ: posts the ante 125
ras41183: posts the ante 125
CrittyJJones: posts the ante 125
JJin91: posts the ante 125
TrademarkTer: posts the ante 125
ras41183: posts small blind 500
CrittyJJones: posts big blind 1000
*** HOLE CARDS ***
Dealt to JJin91 [5d Ah]
JJin91: folds=20
TrademarkTer: folds=20
CHAD9DW: folds=20
gator856500: folds=20
127Wlfhnd: folds=20
p@n1n1NJ: calls 1000
ras41183: calls 500
CrittyJJones: checks=20
*** FLOP *** [9h Jc Kc]
ras41183: checks=20
CrittyJJones: bets 5502 and is all-in
p@n1n1NJ: folds=20
ras41183: folds=20
Uncalled bet (5502) returned to CrittyJJones
CrittyJJones collected 4000 from pot
CrittyJJones: doesn't show hand=20
*** SUMMARY ***
Total pot 4000 | Rake 0=20
Board [9h Jc Kc]
Seat 1: CHAD9DW folded before Flop (didn't bet)
Seat 2: gator856500 folded before Flop (didn't bet)
Seat 3: 127Wlfhnd folded before Flop (didn't bet)
Seat 4: p@n1n1NJ (button) folded on the Flop
Seat 5: ras41183 (small blind) folded on the Flop
Seat 6: CrittyJJones (big blind) collected (4000)
Seat 7: JJin91 folded before Flop (didn't bet)
Seat 8: TrademarkTer folded before Flop (didn't bet)


*********** # 56 **************
PokerStars Hand #171704089290: Tournament #1648956862, $4.55+$0.45 USD =
Hold'em No Limit - Level XV (500/1000) - 2017/06/25 22:19:50 ET
Table '1648956862 2' 9-max Seat #5 is the button
Seat 1: CHAD9DW (33397 in chips)=20
Seat 2: gator856500 (4210 in chips)=20
Seat 3: 127Wlfhnd (20533 in chips)=20
Seat 4: p@n1n1NJ (29369 in chips)=20
Seat 5: ras41183 (30866 in chips)=20
Seat 6: CrittyJJones (9502 in chips)=20
Seat 7: JJin91 (28669 in chips)=20
Seat 8: TrademarkTer (39696 in chips)=20
CHAD9DW: posts the ante 125
gator856500: posts the ante 125
127Wlfhnd: posts the ante 125
p@n1n1NJ: posts the ante 125
ras41183: posts the ante 125
CrittyJJones: posts the ante 125
JJin91: posts the ante 125
TrademarkTer: posts the ante 125
CrittyJJones: posts small blind 500
JJin91: posts big blind 1000
*** HOLE CARDS ***
Dealt to JJin91 [4c 6s]
TrademarkTer: folds=20
CHAD9DW: folds=20
gator856500: calls 1000
127Wlfhnd: calls 1000
p@n1n1NJ: folds=20
ras41183: folds=20
CrittyJJones: folds=20
JJin91: checks=20
*** FLOP *** [Qd Jc 9d]
JJin91: checks=20
gator856500: bets 3085 and is all-in
127Wlfhnd: folds=20
JJin91: folds=20
Uncalled bet (3085) returned to gator856500
gator856500 collected 4500 from pot
gator856500: doesn't show hand=20
*** SUMMARY ***
Total pot 4500 | Rake 0=20
Board [Qd Jc 9d]
Seat 1: CHAD9DW folded before Flop (didn't bet)
Seat 2: gator856500 collected (4500)
Seat 3: 127Wlfhnd folded on the Flop
Seat 4: p@n1n1NJ folded before Flop (didn't bet)
Seat 5: ras41183 (button) folded before Flop (didn't bet)
Seat 6: CrittyJJones (small blind) folded before Flop
Seat 7: JJin91 (big blind) folded on the Flop
Seat 8: TrademarkTer folded before Flop (didn't bet)


*********** # 57 **************
PokerStars Hand #171704089489: Tournament #1648956862, $4.55+$0.45 USD =
Hold'em No Limit - Level XV (500/1000) - 2017/06/25 22:20:26 ET
Table '1648956862 2' 9-max Seat #6 is the button
Seat 1: CHAD9DW (33272 in chips)=20
Seat 2: gator856500 (7585 in chips)=20
Seat 3: 127Wlfhnd (19408 in chips)=20
Seat 4: p@n1n1NJ (29244 in chips)=20
Seat 5: ras41183 (30741 in chips)=20
Seat 6: CrittyJJones (8877 in chips)=20
Seat 7: JJin91 (27544 in chips)=20
Seat 8: TrademarkTer (39571 in chips)=20
CHAD9DW: posts the ante 125
gator856500: posts the ante 125
127Wlfhnd: posts the ante 125
p@n1n1NJ: posts the ante 125
ras41183: posts the ante 125
CrittyJJones: posts the ante 125
JJin91: posts the ante 125
TrademarkTer: posts the ante 125
JJin91: posts small blind 500
TrademarkTer: posts big blind 1000
*** HOLE CARDS ***
Dealt to JJin91 [3c Jh]
CHAD9DW: folds=20
gator856500: folds=20
127Wlfhnd: folds=20
p@n1n1NJ: folds=20
ras41183: folds=20
CrittyJJones: folds=20
JJin91: folds=20
Uncalled bet (500) returned to TrademarkTer
TrademarkTer collected 2000 from pot
*** SUMMARY ***
Total pot 2000 | Rake 0=20
Seat 1: CHAD9DW folded before Flop (didn't bet)
Seat 2: gator856500 folded before Flop (didn't bet)
Seat 3: 127Wlfhnd folded before Flop (didn't bet)
Seat 4: p@n1n1NJ folded before Flop (didn't bet)
Seat 5: ras41183 folded before Flop (didn't bet)
Seat 6: CrittyJJones (button) folded before Flop (didn't bet)
Seat 7: JJin91 (small blind) folded before Flop
Seat 8: TrademarkTer (big blind) collected (2000)


*********** # 58 **************
PokerStars Hand #171704089580: Tournament #1648956862, $4.55+$0.45 USD =
Hold'em No Limit - Level XV (500/1000) - 2017/06/25 22:20:44 ET
Table '1648956862 2' 9-max Seat #7 is the button
Seat 1: CHAD9DW (33147 in chips)=20
Seat 2: gator856500 (7460 in chips)=20
Seat 3: 127Wlfhnd (19283 in chips)=20
Seat 4: p@n1n1NJ (29119 in chips)=20
Seat 5: ras41183 (30616 in chips)=20
Seat 6: CrittyJJones (8752 in chips)=20
Seat 7: JJin91 (26919 in chips)=20
Seat 8: TrademarkTer (40946 in chips)=20
CHAD9DW: posts the ante 125
gator856500: posts the ante 125
127Wlfhnd: posts the ante 125
p@n1n1NJ: posts the ante 125
ras41183: posts the ante 125
CrittyJJones: posts the ante 125
JJin91: posts the ante 125
TrademarkTer: posts the ante 125
TrademarkTer: posts small blind 500
CHAD9DW: posts big blind 1000
*** HOLE CARDS ***
Dealt to JJin91 [As 5d]
gator856500: folds=20
127Wlfhnd: calls 1000
p@n1n1NJ: folds=20
ras41183: calls 1000
CrittyJJones has timed out
CrittyJJones: folds=20
CrittyJJones is sitting out
CrittyJJones has returned
JJin91: raises 2423 to 3423
TrademarkTer said, "no one fold lets play a big family pot"
TrademarkTer: calls 2923
CHAD9DW: raises 20000 to 23423
127Wlfhnd: folds=20
ras41183: folds=20
JJin91: folds=20
TrademarkTer said, "not that big!!!!"
TrademarkTer said, "jin you sonofabitch you!"
TrademarkTer: folds=20
Uncalled bet (20000) returned to CHAD9DW
CHAD9DW collected 13269 from pot
*** SUMMARY ***
Total pot 13269 | Rake 0=20
Seat 1: CHAD9DW (big blind) collected (13269)
Seat 2: gator856500 folded before Flop (didn't bet)
Seat 3: 127Wlfhnd folded before Flop
Seat 4: p@n1n1NJ folded before Flop (didn't bet)
Seat 5: ras41183 folded before Flop
Seat 6: CrittyJJones folded before Flop (didn't bet)
Seat 7: JJin91 (button) folded before Flop
Seat 8: TrademarkTer (small blind) folded before Flop


*********** # 59 **************
PokerStars Hand #171704089931: Tournament #1648956862, $4.55+$0.45 USD =
Hold'em No Limit - Level XVI (600/1200) - 2017/06/25 22:22:05 ET
Table '1648956862 2' 9-max Seat #8 is the button
Seat 1: CHAD9DW (42868 in chips)=20
Seat 2: gator856500 (7335 in chips)=20
Seat 3: 127Wlfhnd (18158 in chips)=20
Seat 4: p@n1n1NJ (28994 in chips)=20
Seat 5: ras41183 (29491 in chips)=20
Seat 6: CrittyJJones (8627 in chips)=20
Seat 7: JJin91 (23371 in chips)=20
Seat 8: TrademarkTer (37398 in chips)=20
CHAD9DW: posts the ante 150
gator856500: posts the ante 150
127Wlfhnd: posts the ante 150
p@n1n1NJ: posts the ante 150
ras41183: posts the ante 150
CrittyJJones: posts the ante 150
JJin91: posts the ante 150
TrademarkTer: posts the ante 150
CHAD9DW: posts small blind 600
gator856500: posts big blind 1200
*** HOLE CARDS ***
Dealt to JJin91 [7c 8s]
ras41183 said, "haha"
127Wlfhnd: calls 1200
p@n1n1NJ: folds=20
ras41183: folds=20
CrittyJJones: folds=20
JJin91: folds=20
TrademarkTer: calls 1200
CHAD9DW: calls 600
gator856500: checks=20
*** FLOP *** [4c Qc 7d]
CHAD9DW: bets 4200
gator856500: folds=20
127Wlfhnd: calls 4200
TrademarkTer: folds=20
*** TURN *** [4c Qc 7d] [9s]
CHAD9DW: bets 11200
127Wlfhnd: raises 1408 to 12608 and is all-in
CHAD9DW: calls 1408
*** RIVER *** [4c Qc 7d 9s] [6c]
*** SHOW DOWN ***
CHAD9DW: shows [Kd Qh] (a pair of Queens)
127Wlfhnd: shows [8c Kc] (a flush, King high)
127Wlfhnd collected 39616 from pot
*** SUMMARY ***
Total pot 39616 | Rake 0=20
Board [4c Qc 7d 9s 6c]
Seat 1: CHAD9DW (small blind) showed [Kd Qh] and lost with a pair of Qu=
eens
Seat 2: gator856500 (big blind) folded on the Flop
Seat 3: 127Wlfhnd showed [8c Kc] and won (39616) with a flush, King high
Seat 4: p@n1n1NJ folded before Flop (didn't bet)
Seat 5: ras41183 folded before Flop (didn't bet)
Seat 6: CrittyJJones folded before Flop (didn't bet)
Seat 7: JJin91 folded before Flop (didn't bet)
Seat 8: TrademarkTer (button) folded on the Flop


*********** # 60 **************
PokerStars Hand #171704935295: Tournament #1648956862, $4.55+$0.45 USD =
Hold'em No Limit - Level XVI (600/1200) - 2017/06/25 22:22:42 ET
Table '1648956862 2' 9-max Seat #1 is the button
Seat 1: CHAD9DW (24710 in chips)=20
Seat 2: gator856500 (5985 in chips)=20
Seat 3: 127Wlfhnd (39616 in chips)=20
Seat 4: p@n1n1NJ (28844 in chips)=20
Seat 5: ras41183 (29341 in chips)=20
Seat 6: CrittyJJones (8477 in chips)=20
Seat 7: JJin91 (23221 in chips)=20
Seat 8: TrademarkTer (36048 in chips)=20
Seat 9: merrrrrd (74678 in chips)=20
CHAD9DW: posts the ante 150
gator856500: posts the ante 150
127Wlfhnd: posts the ante 150
p@n1n1NJ: posts the ante 150
ras41183: posts the ante 150
CrittyJJones: posts the ante 150
JJin91: posts the ante 150
TrademarkTer: posts the ante 150
merrrrrd: posts the ante 150
gator856500: posts small blind 600
127Wlfhnd: posts big blind 1200
*** HOLE CARDS ***
Dealt to JJin91 [Ac 5s]
p@n1n1NJ: raises 1200 to 2400
ras41183: folds=20
CrittyJJones: raises 5927 to 8327 and is all-in
JJin91: folds=20
TrademarkTer: folds=20
merrrrrd: folds=20
CHAD9DW: folds=20
gator856500: folds=20
127Wlfhnd: calls 7127
p@n1n1NJ: calls 5927
*** FLOP *** [8h Jc 6h]
127Wlfhnd: bets 31139 and is all-in
p@n1n1NJ: folds=20
Uncalled bet (31139) returned to 127Wlfhnd
*** TURN *** [8h Jc 6h] [5c]
*** RIVER *** [8h Jc 6h 5c] [Tc]
*** SHOW DOWN ***
127Wlfhnd: shows [9h Qh] (a straight, Eight to Queen)
CrittyJJones: shows [Js As] (a pair of Jacks)
127Wlfhnd collected 26931 from pot
CrittyJJones finished the tournament in 44th place
CrittyJJones [observer] said, "gg gl"
*** SUMMARY ***
Total pot 26931 | Rake 0=20
Board [8h Jc 6h 5c Tc]
Seat 1: CHAD9DW (button) folded before Flop (didn't bet)
Seat 2: gator856500 (small blind) folded before Flop
Seat 3: 127Wlfhnd (big blind) showed [9h Qh] and won (26931) with a str=
aight, Eight to Queen
Seat 4: p@n1n1NJ folded on the Flop
Seat 5: ras41183 folded before Flop (didn't bet)
Seat 6: CrittyJJones showed [Js As] and lost with a pair of Jacks
Seat 7: JJin91 folded before Flop (didn't bet)
Seat 8: TrademarkTer folded before Flop (didn't bet)
Seat 9: merrrrrd folded before Flop (didn't bet)


*********** # 61 **************
PokerStars Hand #171704935413: Tournament #1648956862, $4.55+$0.45 USD =
Hold'em No Limit - Level XVI (600/1200) - 2017/06/25 22:23:09 ET
Table '1648956862 2' 9-max Seat #2 is the button
Seat 1: CHAD9DW (24560 in chips)=20
Seat 2: gator856500 (5235 in chips)=20
Seat 3: 127Wlfhnd (58070 in chips)=20
Seat 4: p@n1n1NJ (20367 in chips)=20
Seat 5: ras41183 (29191 in chips)=20
Seat 7: JJin91 (23071 in chips)=20
Seat 8: TrademarkTer (35898 in chips)=20
Seat 9: merrrrrd (74528 in chips)=20
CHAD9DW: posts the ante 150
gator856500: posts the ante 150
127Wlfhnd: posts the ante 150
p@n1n1NJ: posts the ante 150
ras41183: posts the ante 150
JJin91: posts the ante 150
TrademarkTer: posts the ante 150
merrrrrd: posts the ante 150
127Wlfhnd: posts small blind 600
p@n1n1NJ: posts big blind 1200
*** HOLE CARDS ***
Dealt to JJin91 [4d Js]
ras41183: calls 1200
JJin91: folds=20
TrademarkTer: folds=20
merrrrrd: folds=20
CHAD9DW: folds=20
gator856500: calls 1200
127Wlfhnd: calls 600
p@n1n1NJ: raises 19017 to 20217 and is all-in
ras41183: calls 19017
gator856500: calls 3885 and is all-in
127Wlfhnd: folds=20
*** FLOP *** [9d 8s Qs]
*** TURN *** [9d 8s Qs] [3h]
*** RIVER *** [9d 8s Qs 3h] [7s]
*** SHOW DOWN ***
p@n1n1NJ: shows [Tc Ah] (high card Ace)
ras41183: shows [Jd Ad] (high card Ace - Queen+Jack kicker)
ras41183 collected 30264 from side pot
gator856500: shows [Jc Ks] (high card King)
ras41183 collected 17655 from main pot
p@n1n1NJ finished the tournament in 42nd place
gator856500 finished the tournament in 43rd place
*** SUMMARY ***
Total pot 47919 Main pot 17655. Side pot 30264. | Rake 0=20
Board [9d 8s Qs 3h 7s]
Seat 1: CHAD9DW folded before Flop (didn't bet)
Seat 2: gator856500 (button) showed [Jc Ks] and lost with high card King
Seat 3: 127Wlfhnd (small blind) folded before Flop
Seat 4: p@n1n1NJ (big blind) showed [Tc Ah] and lost with high card Ace
Seat 5: ras41183 showed [Jd Ad] and won (47919) with high card Ace
Seat 7: JJin91 folded before Flop (didn't bet)
Seat 8: TrademarkTer folded before Flop (didn't bet)
Seat 9: merrrrrd folded before Flop (didn't bet)


*********** # 62 **************
PokerStars Hand #171704935551: Tournament #1648956862, $4.55+$0.45 USD =
Hold'em No Limit - Level XVI (600/1200) - 2017/06/25 22:23:41 ET
Table '1648956862 2' 9-max Seat #3 is the button
Seat 1: CHAD9DW (24410 in chips)=20
Seat 2: jayjay8956 (13916 in chips)=20
Seat 3: 127Wlfhnd (56720 in chips)=20
Seat 5: ras41183 (56743 in chips)=20
Seat 7: JJin91 (22921 in chips)=20
Seat 8: TrademarkTer (35748 in chips)=20
Seat 9: merrrrrd (74378 in chips)=20
CHAD9DW: posts the ante 150
jayjay8956: posts the ante 150
127Wlfhnd: posts the ante 150
ras41183: posts the ante 150
JJin91: posts the ante 150
TrademarkTer: posts the ante 150
merrrrrd: posts the ante 150
ras41183: posts small blind 600
JJin91: posts big blind 1200
*** HOLE CARDS ***
Dealt to JJin91 [6c Ts]
TrademarkTer: folds=20
merrrrrd: folds=20
CHAD9DW: folds=20
jayjay8956 said, "im back"
jayjay8956: folds=20
127Wlfhnd: folds=20
ras41183: calls 600
JJin91: checks=20
*** FLOP *** [9h Kc Ah]
ras41183: checks=20
JJin91: checks=20
*** TURN *** [9h Kc Ah] [Qd]
ras41183: checks=20
JJin91: checks=20
*** RIVER *** [9h Kc Ah Qd] [Tc]
ras41183: bets 4800
JJin91: calls 4800
*** SHOW DOWN ***
ras41183: shows [Jd Th] (a straight, Ten to Ace)
JJin91: mucks hand=20
ras41183 collected 13050 from pot
*** SUMMARY ***
Total pot 13050 | Rake 0=20
Board [9h Kc Ah Qd Tc]
Seat 1: CHAD9DW folded before Flop (didn't bet)
Seat 2: jayjay8956 folded before Flop (didn't bet)
Seat 3: 127Wlfhnd (button) folded before Flop (didn't bet)
Seat 5: ras41183 (small blind) showed [Jd Th] and won (13050) with a st=
raight, Ten to Ace
Seat 7: JJin91 (big blind) mucked [6c Ts]
Seat 8: TrademarkTer folded before Flop (didn't bet)
Seat 9: merrrrrd folded before Flop (didn't bet)


*********** # 63 **************
PokerStars Hand #171704935727: Tournament #1648956862, $4.55+$0.45 USD =
Hold'em No Limit - Level XVI (600/1200) - 2017/06/25 22:24:16 ET
Table '1648956862 2' 9-max Seat #5 is the button
Seat 1: CHAD9DW (24260 in chips)=20
Seat 2: jayjay8956 (13766 in chips)=20
Seat 3: 127Wlfhnd (56570 in chips)=20
Seat 4: Al Ricola (35554 in chips)=20
Seat 5: ras41183 (63643 in chips)=20
Seat 7: JJin91 (16771 in chips)=20
Seat 8: TrademarkTer (35598 in chips)=20
Seat 9: merrrrrd (74228 in chips)=20
CHAD9DW: posts the ante 150
jayjay8956: posts the ante 150
127Wlfhnd: posts the ante 150
Al Ricola: posts the ante 150
ras41183: posts the ante 150
JJin91: posts the ante 150
TrademarkTer: posts the ante 150
merrrrrd: posts the ante 150
JJin91: posts small blind 600
TrademarkTer: posts big blind 1200
*** HOLE CARDS ***
Dealt to JJin91 [4d Kd]
merrrrrd: raises 1200 to 2400
CHAD9DW: folds=20
jayjay8956: folds=20
127Wlfhnd: folds=20
Al Ricola: calls 2400
ras41183: calls 2400
JJin91: folds=20
TrademarkTer: calls 1200
*** FLOP *** [4h Ad 7d]
TrademarkTer: checks=20
merrrrrd: checks=20
Al Ricola: checks=20
ras41183: bets 8400
TrademarkTer: folds=20
merrrrrd: folds=20
Al Ricola: folds=20
Uncalled bet (8400) returned to ras41183
ras41183 collected 11400 from pot
ras41183: shows [4c 4s] (three of a kind, Fours)
*** SUMMARY ***
Total pot 11400 | Rake 0=20
Board [4h Ad 7d]
Seat 1: CHAD9DW folded before Flop (didn't bet)
Seat 2: jayjay8956 folded before Flop (didn't bet)
Seat 3: 127Wlfhnd folded before Flop (didn't bet)
Seat 4: Al Ricola folded on the Flop
Seat 5: ras41183 (button) collected (11400)
Seat 7: JJin91 (small blind) folded before Flop
Seat 8: TrademarkTer (big blind) folded on the Flop
Seat 9: merrrrrd folded on the Flop


*********** # 64 **************
PokerStars Hand #171704935949: Tournament #1648956862, $4.55+$0.45 USD =
Hold'em No Limit - Level XVI (600/1200) - 2017/06/25 22:25:07 ET
Table '1648956862 2' 9-max Seat #7 is the button
Seat 1: CHAD9DW (24110 in chips)=20
Seat 2: jayjay8956 (13616 in chips)=20
Seat 3: 127Wlfhnd (56420 in chips)=20
Seat 4: Al Ricola (33004 in chips)=20
Seat 5: ras41183 (72493 in chips)=20
Seat 7: JJin91 (16021 in chips)=20
Seat 8: TrademarkTer (33048 in chips)=20
Seat 9: merrrrrd (71678 in chips)=20
CHAD9DW: posts the ante 150
jayjay8956: posts the ante 150
127Wlfhnd: posts the ante 150
Al Ricola: posts the ante 150
ras41183: posts the ante 150
JJin91: posts the ante 150
TrademarkTer: posts the ante 150
merrrrrd: posts the ante 150
TrademarkTer: posts small blind 600
merrrrrd: posts big blind 1200
*** HOLE CARDS ***
Dealt to JJin91 [7c 2d]
CHAD9DW: raises 2000 to 3200
jayjay8956: folds=20
127Wlfhnd: folds=20
Al Ricola: calls 3200
ras41183: folds=20
JJin91: folds=20
TrademarkTer: calls 2600
merrrrrd: folds=20
*** FLOP *** [Th 5h 3s]
TrademarkTer: checks=20
CHAD9DW: bets 5200
Al Ricola: folds=20
TrademarkTer: folds=20
Uncalled bet (5200) returned to CHAD9DW
CHAD9DW collected 12000 from pot
*** SUMMARY ***
Total pot 12000 | Rake 0=20
Board [Th 5h 3s]
Seat 1: CHAD9DW collected (12000)
Seat 2: jayjay8956 folded before Flop (didn't bet)
Seat 3: 127Wlfhnd folded before Flop (didn't bet)
Seat 4: Al Ricola folded on the Flop
Seat 5: ras41183 folded before Flop (didn't bet)
Seat 7: JJin91 (button) folded before Flop (didn't bet)
Seat 8: TrademarkTer (small blind) folded on the Flop
Seat 9: merrrrrd (big blind) folded before Flop


*********** # 65 **************
PokerStars Hand #171704936101: Tournament #1648956862, $4.55+$0.45 USD =
Hold'em No Limit - Level XVI (600/1200) - 2017/06/25 22:25:39 ET
Table '1648956862 2' 9-max Seat #8 is the button
Seat 1: CHAD9DW (32760 in chips)=20
Seat 2: jayjay8956 (13466 in chips)=20
Seat 3: 127Wlfhnd (56270 in chips)=20
Seat 4: Al Ricola (29654 in chips)=20
Seat 5: ras41183 (72343 in chips)=20
Seat 6: Sir Disney (16964 in chips)=20
Seat 7: JJin91 (15871 in chips)=20
Seat 8: TrademarkTer (29698 in chips)=20
Seat 9: merrrrrd (70328 in chips)=20
CHAD9DW: posts the ante 150
jayjay8956: posts the ante 150
127Wlfhnd: posts the ante 150
Al Ricola: posts the ante 150
ras41183: posts the ante 150
Sir Disney: posts the ante 150
JJin91: posts the ante 150
TrademarkTer: posts the ante 150
merrrrrd: posts the ante 150
merrrrrd: posts small blind 600
CHAD9DW: posts big blind 1200
*** HOLE CARDS ***
Dealt to JJin91 [4c Jc]
jayjay8956: calls 1200
127Wlfhnd: calls 1200
Al Ricola: folds=20
ras41183: folds=20
Sir Disney: folds=20
JJin91: folds=20
TrademarkTer: folds=20
merrrrrd: calls 600
CHAD9DW: checks=20
*** FLOP *** [Ac 7s 3d]
merrrrrd: checks=20
CHAD9DW: checks=20
jayjay8956: bets 3075
127Wlfhnd: raises 12525 to 15600
merrrrrd: folds=20
CHAD9DW: folds=20
jayjay8956: folds=20
Uncalled bet (12525) returned to 127Wlfhnd
127Wlfhnd collected 12300 from pot
127Wlfhnd: doesn't show hand=20
*** SUMMARY ***
Total pot 12300 | Rake 0=20
Board [Ac 7s 3d]
Seat 1: CHAD9DW (big blind) folded on the Flop
Seat 2: jayjay8956 folded on the Flop
Seat 3: 127Wlfhnd collected (12300)
Seat 4: Al Ricola folded before Flop (didn't bet)
Seat 5: ras41183 folded before Flop (didn't bet)
Seat 6: Sir Disney folded before Flop (didn't bet)
Seat 7: JJin91 folded before Flop (didn't bet)
Seat 8: TrademarkTer (button) folded before Flop (didn't bet)
Seat 9: merrrrrd (small blind) folded on the Flop


*********** # 66 **************
PokerStars Hand #171704936328: Tournament #1648956862, $4.55+$0.45 USD =
Hold'em No Limit - Level XVII (700/1400) - 2017/06/25 22:26:33 ET
Table '1648956862 2' 9-max Seat #9 is the button
Seat 1: CHAD9DW (31410 in chips)=20
Seat 2: jayjay8956 (9041 in chips)=20
Seat 3: 127Wlfhnd (64145 in chips)=20
Seat 4: Al Ricola (29504 in chips)=20
Seat 5: ras41183 (72193 in chips)=20
Seat 6: Sir Disney (16814 in chips)=20
Seat 7: JJin91 (15721 in chips)=20
Seat 8: TrademarkTer (29548 in chips)=20
Seat 9: merrrrrd (68978 in chips)=20
CHAD9DW: posts the ante 175
jayjay8956: posts the ante 175
127Wlfhnd: posts the ante 175
Al Ricola: posts the ante 175
ras41183: posts the ante 175
Sir Disney: posts the ante 175
JJin91: posts the ante 175
TrademarkTer: posts the ante 175
merrrrrd: posts the ante 175
CHAD9DW: posts small blind 700
jayjay8956: posts big blind 1400
*** HOLE CARDS ***
Dealt to JJin91 [6s Kd]
127Wlfhnd: folds=20
Al Ricola: folds=20
ras41183: folds=20
Sir Disney: folds=20
JJin91: folds=20
TrademarkTer: calls 1400
merrrrrd: raises 67403 to 68803 and is all-in
CHAD9DW: folds=20
jayjay8956: folds=20
TrademarkTer: folds=20
Uncalled bet (67403) returned to merrrrrd
merrrrrd collected 6475 from pot
*** SUMMARY ***
Total pot 6475 | Rake 0=20
Seat 1: CHAD9DW (small blind) folded before Flop
Seat 2: jayjay8956 (big blind) folded before Flop
Seat 3: 127Wlfhnd folded before Flop (didn't bet)
Seat 4: Al Ricola folded before Flop (didn't bet)
Seat 5: ras41183 folded before Flop (didn't bet)
Seat 6: Sir Disney folded before Flop (didn't bet)
Seat 7: JJin91 folded before Flop (didn't bet)
Seat 8: TrademarkTer folded before Flop
Seat 9: merrrrrd (button) collected (6475)


*********** # 67 **************
PokerStars Hand #171704936460: Tournament #1648956862, $4.55+$0.45 USD =
Hold'em No Limit - Level XVII (700/1400) - 2017/06/25 22:27:03 ET
Table '1648956862 2' 9-max Seat #1 is the button
Seat 1: CHAD9DW (30535 in chips)=20
Seat 2: jayjay8956 (7466 in chips)=20
Seat 3: 127Wlfhnd (63970 in chips)=20
Seat 4: Al Ricola (29329 in chips)=20
Seat 5: ras41183 (72018 in chips)=20
Seat 6: Sir Disney (16639 in chips)=20
Seat 7: JJin91 (15546 in chips)=20
Seat 8: TrademarkTer (27973 in chips)=20
Seat 9: merrrrrd (73878 in chips)=20
CHAD9DW: posts the ante 175
jayjay8956: posts the ante 175
127Wlfhnd: posts the ante 175
Al Ricola: posts the ante 175
ras41183: posts the ante 175
Sir Disney: posts the ante 175
JJin91: posts the ante 175
TrademarkTer: posts the ante 175
merrrrrd: posts the ante 175
jayjay8956: posts small blind 700
127Wlfhnd: posts big blind 1400
*** HOLE CARDS ***
Dealt to JJin91 [Ks Kh]
Al Ricola: folds=20
ras41183: folds=20
Sir Disney: folds=20
JJin91: raises 13971 to 15371 and is all-in
TrademarkTer: folds=20
merrrrrd: folds=20
CHAD9DW: folds=20
jayjay8956: calls 6591 and is all-in
127Wlfhnd: folds=20
Uncalled bet (8080) returned to JJin91
*** FLOP *** [9s Ad 3s]
*** TURN *** [9s Ad 3s] [Jd]
*** RIVER *** [9s Ad 3s Jd] [Th]
*** SHOW DOWN ***
jayjay8956: shows [Tc Ac] (two pair, Aces and Tens)
JJin91: shows [Ks Kh] (a pair of Kings)
jayjay8956 collected 17557 from pot
*** SUMMARY ***
Total pot 17557 | Rake 0=20
Board [9s Ad 3s Jd Th]
Seat 1: CHAD9DW (button) folded before Flop (didn't bet)
Seat 2: jayjay8956 (small blind) showed [Tc Ac] and won (17557) with tw=
o pair, Aces and Tens
Seat 3: 127Wlfhnd (big blind) folded before Flop
Seat 4: Al Ricola folded before Flop (didn't bet)
Seat 5: ras41183 folded before Flop (didn't bet)
Seat 6: Sir Disney folded before Flop (didn't bet)
Seat 7: JJin91 showed [Ks Kh] and lost with a pair of Kings
Seat 8: TrademarkTer folded before Flop (didn't bet)
Seat 9: merrrrrd folded before Flop (didn't bet)


*********** # 68 **************
PokerStars Hand #171704936708: Tournament #1648956862, $4.55+$0.45 USD =
Hold'em No Limit - Level XVII (700/1400) - 2017/06/25 22:27:53 ET
Table '1648956862 2' 9-max Seat #2 is the button
Seat 1: CHAD9DW (30360 in chips)=20
Seat 2: jayjay8956 (17557 in chips)=20
Seat 3: 127Wlfhnd (62395 in chips)=20
Seat 4: Al Ricola (29154 in chips)=20
Seat 5: ras41183 (71843 in chips)=20
Seat 6: Sir Disney (16464 in chips)=20
Seat 7: JJin91 (8080 in chips)=20
Seat 8: TrademarkTer (27798 in chips)=20
Seat 9: merrrrrd (73703 in chips)=20
CHAD9DW: posts the ante 175
jayjay8956: posts the ante 175
127Wlfhnd: posts the ante 175
Al Ricola: posts the ante 175
ras41183: posts the ante 175
Sir Disney: posts the ante 175
JJin91: posts the ante 175
TrademarkTer: posts the ante 175
merrrrrd: posts the ante 175
127Wlfhnd: posts small blind 700
Al Ricola: posts big blind 1400
*** HOLE CARDS ***
Dealt to JJin91 [As Jh]
ras41183: folds=20
Sir Disney: folds=20
JJin91: raises 6505 to 7905 and is all-in
TrademarkTer: folds=20
merrrrrd: folds=20
CHAD9DW: raises 6505 to 14410
jayjay8956: folds=20
127Wlfhnd: folds=20
Al Ricola: folds=20
Uncalled bet (6505) returned to CHAD9DW
*** FLOP *** [2s 5h 3c]
*** TURN *** [2s 5h 3c] [8h]
*** RIVER *** [2s 5h 3c 8h] [8s]
*** SHOW DOWN ***
JJin91: shows [As Jh] (a pair of Eights)
CHAD9DW: shows [Ts Ac] (a pair of Eights - lower kicker)
JJin91 collected 19485 from pot
*** SUMMARY ***
Total pot 19485 | Rake 0=20
Board [2s 5h 3c 8h 8s]
Seat 1: CHAD9DW showed [Ts Ac] and lost with a pair of Eights
Seat 2: jayjay8956 (button) folded before Flop (didn't bet)
Seat 3: 127Wlfhnd (small blind) folded before Flop
Seat 4: Al Ricola (big blind) folded before Flop
Seat 5: ras41183 folded before Flop (didn't bet)
Seat 6: Sir Disney folded before Flop (didn't bet)
Seat 7: JJin91 showed [As Jh] and won (19485) with a pair of Eights
Seat 8: TrademarkTer folded before Flop (didn't bet)
Seat 9: merrrrrd folded before Flop (didn't bet)


*********** # 69 **************
PokerStars Hand #171704936867: Tournament #1648956862, $4.55+$0.45 USD =
Hold'em No Limit - Level XVII (700/1400) - 2017/06/25 22:28:26 ET
Table '1648956862 2' 9-max Seat #3 is the button
Seat 1: CHAD9DW (22280 in chips)=20
Seat 2: jayjay8956 (17382 in chips)=20
Seat 3: 127Wlfhnd (61520 in chips)=20
Seat 4: Al Ricola (27579 in chips)=20
Seat 5: ras41183 (71668 in chips)=20
Seat 6: Sir Disney (16289 in chips)=20
Seat 7: JJin91 (19485 in chips)=20
Seat 8: TrademarkTer (27623 in chips)=20
Seat 9: merrrrrd (73528 in chips)=20
CHAD9DW: posts the ante 175
jayjay8956: posts the ante 175
127Wlfhnd: posts the ante 175
Al Ricola: posts the ante 175
ras41183: posts the ante 175
Sir Disney: posts the ante 175
JJin91: posts the ante 175
TrademarkTer: posts the ante 175
merrrrrd: posts the ante 175
Al Ricola: posts small blind 700
ras41183: posts big blind 1400
*** HOLE CARDS ***
Dealt to JJin91 [Tc 2c]
Sir Disney: folds=20
JJin91: folds=20
TrademarkTer: folds=20
merrrrrd: folds=20
CHAD9DW: folds=20
jayjay8956: folds=20
127Wlfhnd: folds=20
Al Ricola: raises 2800 to 4200
ras41183: folds=20
Uncalled bet (2800) returned to Al Ricola
Al Ricola collected 4375 from pot
Al Ricola: doesn't show hand=20
*** SUMMARY ***
Total pot 4375 | Rake 0=20
Seat 1: CHAD9DW folded before Flop (didn't bet)
Seat 2: jayjay8956 folded before Flop (didn't bet)
Seat 3: 127Wlfhnd (button) folded before Flop (didn't bet)
Seat 4: Al Ricola (small blind) collected (4375)
Seat 5: ras41183 (big blind) folded before Flop
Seat 6: Sir Disney folded before Flop (didn't bet)
Seat 7: JJin91 folded before Flop (didn't bet)
Seat 8: TrademarkTer folded before Flop (didn't bet)
Seat 9: merrrrrd folded before Flop (didn't bet)


*********** # 70 **************
PokerStars Hand #171704937005: Tournament #1648956862, $4.55+$0.45 USD =
Hold'em No Limit - Level XVII (700/1400) - 2017/06/25 22:28:56 ET
Table '1648956862 2' 9-max Seat #4 is the button
Seat 1: CHAD9DW (22105 in chips)=20
Seat 2: jayjay8956 (17207 in chips)=20
Seat 3: 127Wlfhnd (61345 in chips)=20
Seat 4: Al Ricola (30379 in chips)=20
Seat 5: ras41183 (70093 in chips)=20
Seat 6: Sir Disney (16114 in chips)=20
Seat 7: JJin91 (19310 in chips)=20
Seat 8: TrademarkTer (27448 in chips)=20
Seat 9: merrrrrd (73353 in chips)=20
CHAD9DW: posts the ante 175
jayjay8956: posts the ante 175
127Wlfhnd: posts the ante 175
Al Ricola: posts the ante 175
ras41183: posts the ante 175
Sir Disney: posts the ante 175
JJin91: posts the ante 175
TrademarkTer: posts the ante 175
merrrrrd: posts the ante 175
ras41183: posts small blind 700
Sir Disney: posts big blind 1400
*** HOLE CARDS ***
Dealt to JJin91 [2d Qc]
JJin91: folds=20
TrademarkTer: folds=20
merrrrrd: folds=20
CHAD9DW: raises 2400 to 3800
jayjay8956: calls 3800
127Wlfhnd: folds=20
Al Ricola: calls 3800
ras41183: folds=20
Sir Disney: folds=20
*** FLOP *** [Qd Th Ks]
CHAD9DW: checks=20
jayjay8956: checks=20
Al Ricola: bets 5999
CHAD9DW: folds=20
jayjay8956: folds=20
Uncalled bet (5999) returned to Al Ricola
Al Ricola collected 15075 from pot
Al Ricola: doesn't show hand=20
*** SUMMARY ***
Total pot 15075 | Rake 0=20
Board [Qd Th Ks]
Seat 1: CHAD9DW folded on the Flop
Seat 2: jayjay8956 folded on the Flop
Seat 3: 127Wlfhnd folded before Flop (didn't bet)
Seat 4: Al Ricola (button) collected (15075)
Seat 5: ras41183 (small blind) folded before Flop
Seat 6: Sir Disney (big blind) folded before Flop
Seat 7: JJin91 folded before Flop (didn't bet)
Seat 8: TrademarkTer folded before Flop (didn't bet)
Seat 9: merrrrrd folded before Flop (didn't bet)


*********** # 71 **************
PokerStars Hand #171704937369: Tournament #1648956862, $4.55+$0.45 USD =
Hold'em No Limit - Level XVII (700/1400) - 2017/06/25 22:30:11 ET
Table '1648956862 2' 9-max Seat #5 is the button
Seat 1: CHAD9DW (18130 in chips)=20
Seat 2: jayjay8956 (13232 in chips)=20
Seat 3: 127Wlfhnd (61170 in chips)=20
Seat 4: Al Ricola (41479 in chips)=20
Seat 5: ras41183 (69218 in chips)=20
Seat 6: Sir Disney (14539 in chips)=20
Seat 7: JJin91 (19135 in chips)=20
Seat 8: TrademarkTer (27273 in chips)=20
Seat 9: merrrrrd (73178 in chips)=20
CHAD9DW: posts the ante 175
jayjay8956: posts the ante 175
127Wlfhnd: posts the ante 175
Al Ricola: posts the ante 175
ras41183: posts the ante 175
Sir Disney: posts the ante 175
JJin91: posts the ante 175
TrademarkTer: posts the ante 175
merrrrrd: posts the ante 175
Sir Disney: posts small blind 700
JJin91: posts big blind 1400
*** HOLE CARDS ***
Dealt to JJin91 [4h Ah]
TrademarkTer: folds=20
merrrrrd: folds=20
CHAD9DW: folds=20
jayjay8956: folds=20
127Wlfhnd: calls 1400
Al Ricola: folds=20
ras41183: calls 1400
Sir Disney: raises 5600 to 7000
JJin91: folds=20
127Wlfhnd: folds=20
ras41183: calls 5600
*** FLOP *** [7d 2s Qh]
Sir Disney: bets 2800
ras41183: calls 2800
*** TURN *** [7d 2s Qh] [3h]
Sir Disney: checks=20
ras41183: checks=20
*** RIVER *** [7d 2s Qh 3h] [Jh]
Sir Disney: checks=20
ras41183: bets 11200
Sir Disney: calls 4564 and is all-in
Uncalled bet (6636) returned to ras41183
*** SHOW DOWN ***
ras41183: shows [7c Tc] (a pair of Sevens)
Sir Disney: shows [As Ts] (high card Ace)
ras41183 collected 33103 from pot
Sir Disney finished the tournament in 34th place
*** SUMMARY ***
Total pot 33103 | Rake 0=20
Board [7d 2s Qh 3h Jh]
Seat 1: CHAD9DW folded before Flop (didn't bet)
Seat 2: jayjay8956 folded before Flop (didn't bet)
Seat 3: 127Wlfhnd folded before Flop
Seat 4: Al Ricola folded before Flop (didn't bet)
Seat 5: ras41183 (button) showed [7c Tc] and won (33103) with a pair of=
 Sevens
Seat 6: Sir Disney (small blind) showed [As Ts] and lost with high card=
 Ace
Seat 7: JJin91 (big blind) folded before Flop
Seat 8: TrademarkTer folded before Flop (didn't bet)
Seat 9: merrrrrd folded before Flop (didn't bet)


*********** # 72 **************
PokerStars Hand #171704937769: Tournament #1648956862, $4.55+$0.45 USD =
Hold'em No Limit - Level XVIII (800/1600) - 2017/06/25 22:31:35 ET
Table '1648956862 2' 9-max Seat #7 is the button
Seat 1: CHAD9DW (17955 in chips)=20
Seat 2: jayjay8956 (13057 in chips)=20
Seat 3: 127Wlfhnd (59595 in chips)=20
Seat 4: Al Ricola (41304 in chips)=20
Seat 5: ras41183 (87782 in chips)=20
Seat 7: JJin91 (17560 in chips)=20
Seat 8: TrademarkTer (27098 in chips)=20
Seat 9: merrrrrd (73003 in chips)=20
CHAD9DW: posts the ante 200
jayjay8956: posts the ante 200
127Wlfhnd: posts the ante 200
Al Ricola: posts the ante 200
ras41183: posts the ante 200
JJin91: posts the ante 200
TrademarkTer: posts the ante 200
merrrrrd: posts the ante 200
TrademarkTer: posts small blind 800
merrrrrd: posts big blind 1600
*** HOLE CARDS ***
Dealt to JJin91 [6s Jc]
CHAD9DW: folds=20
jayjay8956: folds=20
127Wlfhnd: folds=20
Al Ricola: folds=20
ras41183: folds=20
JJin91: raises 15760 to 17360 and is all-in
TrademarkTer: folds=20
merrrrrd: folds=20
Uncalled bet (15760) returned to JJin91
JJin91 collected 5600 from pot
JJin91: doesn't show hand=20
*** SUMMARY ***
Total pot 5600 | Rake 0=20
Seat 1: CHAD9DW folded before Flop (didn't bet)
Seat 2: jayjay8956 folded before Flop (didn't bet)
Seat 3: 127Wlfhnd folded before Flop (didn't bet)
Seat 4: Al Ricola folded before Flop (didn't bet)
Seat 5: ras41183 folded before Flop (didn't bet)
Seat 7: JJin91 (button) collected (5600)
Seat 8: TrademarkTer (small blind) folded before Flop
Seat 9: merrrrrd (big blind) folded before Flop


*********** # 73 **************
PokerStars Hand #171704937887: Tournament #1648956862, $4.55+$0.45 USD =
Hold'em No Limit - Level XVIII (800/1600) - 2017/06/25 22:32:01 ET
Table '1648956862 2' 9-max Seat #8 is the button
Seat 1: CHAD9DW (17755 in chips)=20
Seat 2: jayjay8956 (12857 in chips)=20
Seat 3: 127Wlfhnd (59395 in chips)=20
Seat 4: Al Ricola (41104 in chips)=20
Seat 5: ras41183 (87582 in chips)=20
Seat 7: JJin91 (21360 in chips)=20
Seat 8: TrademarkTer (26098 in chips)=20
Seat 9: merrrrrd (71203 in chips)=20
CHAD9DW: posts the ante 200
jayjay8956: posts the ante 200
127Wlfhnd: posts the ante 200
Al Ricola: posts the ante 200
ras41183: posts the ante 200
JJin91: posts the ante 200
TrademarkTer: posts the ante 200
merrrrrd: posts the ante 200
merrrrrd: posts small blind 800
CHAD9DW: posts big blind 1600
*** HOLE CARDS ***
Dealt to JJin91 [9d 6s]
jayjay8956: raises 1600 to 3200
127Wlfhnd: folds=20
Al Ricola: folds=20
ras41183: folds=20
JJin91: folds=20
TrademarkTer: folds=20
merrrrrd: folds=20
CHAD9DW: calls 1600
*** FLOP *** [Qh 7d 7h]
CHAD9DW: checks=20
jayjay8956: bets 9457 and is all-in
CHAD9DW: folds=20
Uncalled bet (9457) returned to jayjay8956
jayjay8956 collected 8800 from pot
jayjay8956: doesn't show hand=20
*** SUMMARY ***
Total pot 8800 | Rake 0=20
Board [Qh 7d 7h]
Seat 1: CHAD9DW (big blind) folded on the Flop
Seat 2: jayjay8956 collected (8800)
Seat 3: 127Wlfhnd folded before Flop (didn't bet)
Seat 4: Al Ricola folded before Flop (didn't bet)
Seat 5: ras41183 folded before Flop (didn't bet)
Seat 7: JJin91 folded before Flop (didn't bet)
Seat 8: TrademarkTer (button) folded before Flop (didn't bet)
Seat 9: merrrrrd (small blind) folded before Flop


*********** # 74 **************
PokerStars Hand #171704938035: Tournament #1648956862, $4.55+$0.45 USD =
Hold'em No Limit - Level XVIII (800/1600) - 2017/06/25 22:32:33 ET
Table '1648956862 2' 9-max Seat #9 is the button
Seat 1: CHAD9DW (14355 in chips)=20
Seat 2: jayjay8956 (18257 in chips)=20
Seat 3: 127Wlfhnd (59195 in chips)=20
Seat 4: Al Ricola (40904 in chips)=20
Seat 5: ras41183 (87382 in chips)=20
Seat 7: JJin91 (21160 in chips)=20
Seat 8: TrademarkTer (25898 in chips)=20
Seat 9: merrrrrd (70203 in chips)=20
CHAD9DW: posts the ante 200
jayjay8956: posts the ante 200
127Wlfhnd: posts the ante 200
Al Ricola: posts the ante 200
ras41183: posts the ante 200
JJin91: posts the ante 200
TrademarkTer: posts the ante 200
merrrrrd: posts the ante 200
CHAD9DW: posts small blind 800
jayjay8956: posts big blind 1600
*** HOLE CARDS ***
Dealt to JJin91 [7h 9h]
127Wlfhnd: folds=20
Al Ricola: raises 1600 to 3200
ras41183: folds=20
JJin91: folds=20
TrademarkTer: folds=20
merrrrrd: folds=20
CHAD9DW: folds=20
jayjay8956: folds=20
Uncalled bet (1600) returned to Al Ricola
Al Ricola collected 5600 from pot
Al Ricola: doesn't show hand=20
*** SUMMARY ***
Total pot 5600 | Rake 0=20
Seat 1: CHAD9DW (small blind) folded before Flop
Seat 2: jayjay8956 (big blind) folded before Flop
Seat 3: 127Wlfhnd folded before Flop (didn't bet)
Seat 4: Al Ricola collected (5600)
Seat 5: ras41183 folded before Flop (didn't bet)
Seat 7: JJin91 folded before Flop (didn't bet)
Seat 8: TrademarkTer folded before Flop (didn't bet)
Seat 9: merrrrrd (button) folded before Flop (didn't bet)


*********** # 75 **************
PokerStars Hand #171704938121: Tournament #1648956862, $4.55+$0.45 USD =
Hold'em No Limit - Level XVIII (800/1600) - 2017/06/25 22:32:52 ET
Table '1648956862 2' 9-max Seat #1 is the button
Seat 1: CHAD9DW (13355 in chips)=20
Seat 2: jayjay8956 (16457 in chips)=20
Seat 3: 127Wlfhnd (58995 in chips)=20
Seat 4: Al Ricola (44704 in chips)=20
Seat 5: ras41183 (87182 in chips)=20
Seat 7: JJin91 (20960 in chips)=20
Seat 8: TrademarkTer (25698 in chips)=20
Seat 9: merrrrrd (70003 in chips)=20
CHAD9DW: posts the ante 200
jayjay8956: posts the ante 200
127Wlfhnd: posts the ante 200
Al Ricola: posts the ante 200
ras41183: posts the ante 200
JJin91: posts the ante 200
TrademarkTer: posts the ante 200
merrrrrd: posts the ante 200
jayjay8956: posts small blind 800
127Wlfhnd: posts big blind 1600
*** HOLE CARDS ***
Dealt to JJin91 [Td 3h]
Al Ricola: folds=20
ras41183: folds=20
JJin91: folds=20
TrademarkTer: folds=20
merrrrrd: raises 2400 to 4000
CHAD9DW: folds=20
jayjay8956: folds=20
127Wlfhnd: calls 2400
*** FLOP *** [Jh 7d Kh]
127Wlfhnd: checks=20
merrrrrd: bets 3500
127Wlfhnd: folds=20
Uncalled bet (3500) returned to merrrrrd
merrrrrd collected 10400 from pot
*** SUMMARY ***
Total pot 10400 | Rake 0=20
Board [Jh 7d Kh]
Seat 1: CHAD9DW (button) folded before Flop (didn't bet)
Seat 2: jayjay8956 (small blind) folded before Flop
Seat 3: 127Wlfhnd (big blind) folded on the Flop
Seat 4: Al Ricola folded before Flop (didn't bet)
Seat 5: ras41183 folded before Flop (didn't bet)
Seat 7: JJin91 folded before Flop (didn't bet)
Seat 8: TrademarkTer folded before Flop (didn't bet)
Seat 9: merrrrrd collected (10400)


*********** # 76 **************
PokerStars Hand #171704938270: Tournament #1648956862, $4.55+$0.45 USD =
Hold'em No Limit - Level XVIII (800/1600) - 2017/06/25 22:33:26 ET
Table '1648956862 2' 9-max Seat #2 is the button
Seat 1: CHAD9DW (13155 in chips)=20
Seat 2: jayjay8956 (15457 in chips)=20
Seat 3: 127Wlfhnd (54795 in chips)=20
Seat 4: Al Ricola (44504 in chips)=20
Seat 5: ras41183 (86982 in chips)=20
Seat 7: JJin91 (20760 in chips)=20
Seat 8: TrademarkTer (25498 in chips)=20
Seat 9: merrrrrd (76203 in chips)=20
CHAD9DW: posts the ante 200
jayjay8956: posts the ante 200
127Wlfhnd: posts the ante 200
Al Ricola: posts the ante 200
ras41183: posts the ante 200
JJin91: posts the ante 200
TrademarkTer: posts the ante 200
merrrrrd: posts the ante 200
127Wlfhnd: posts small blind 800
Al Ricola: posts big blind 1600
*** HOLE CARDS ***
Dealt to JJin91 [Kh 9h]
ras41183: folds=20
JJin91: raises 18960 to 20560 and is all-in
TrademarkTer: folds=20
merrrrrd: folds=20
CHAD9DW: folds=20
jayjay8956: folds=20
127Wlfhnd: folds=20
Al Ricola: folds=20
Uncalled bet (18960) returned to JJin91
JJin91 collected 5600 from pot
JJin91: doesn't show hand=20
*** SUMMARY ***
Total pot 5600 | Rake 0=20
Seat 1: CHAD9DW folded before Flop (didn't bet)
Seat 2: jayjay8956 (button) folded before Flop (didn't bet)
Seat 3: 127Wlfhnd (small blind) folded before Flop
Seat 4: Al Ricola (big blind) folded before Flop
Seat 5: ras41183 folded before Flop (didn't bet)
Seat 7: JJin91 collected (5600)
Seat 8: TrademarkTer folded before Flop (didn't bet)
Seat 9: merrrrrd folded before Flop (didn't bet)


*********** # 77 **************
PokerStars Hand #171704938472: Tournament #1648956862, $4.55+$0.45 USD =
Hold'em No Limit - Level XVIII (800/1600) - 2017/06/25 22:34:16 ET
Table '1648956862 2' 9-max Seat #3 is the button
Seat 1: CHAD9DW (12955 in chips)=20
Seat 2: jayjay8956 (15257 in chips)=20
Seat 3: 127Wlfhnd (53795 in chips)=20
Seat 4: Al Ricola (42704 in chips)=20
Seat 5: ras41183 (86782 in chips)=20
Seat 7: JJin91 (24560 in chips)=20
Seat 8: TrademarkTer (25298 in chips)=20
Seat 9: merrrrrd (76003 in chips)=20
CHAD9DW: posts the ante 200
jayjay8956: posts the ante 200
127Wlfhnd: posts the ante 200
Al Ricola: posts the ante 200
ras41183: posts the ante 200
JJin91: posts the ante 200
TrademarkTer: posts the ante 200
merrrrrd: posts the ante 200
Al Ricola: posts small blind 800
ras41183: posts big blind 1600
*** HOLE CARDS ***
Dealt to JJin91 [4h Jc]
JJin91: folds=20
TrademarkTer: folds=20
merrrrrd: folds=20
CHAD9DW: raises 2200 to 3800
jayjay8956: folds=20
127Wlfhnd: folds=20
Al Ricola: folds=20
ras41183: calls 2200
*** FLOP *** [Jd 5c 9d]
ras41183: checks=20
CHAD9DW: bets 8955 and is all-in
ras41183: calls 8955
*** TURN *** [Jd 5c 9d] [8c]
*** RIVER *** [Jd 5c 9d 8c] [Qd]
*** SHOW DOWN ***
ras41183: shows [3d 6d] (a flush, Queen high)
CHAD9DW: shows [6h 6s] (a pair of Sixes)
ras41183 collected 27910 from pot
CHAD9DW finished the tournament in 31st place
*** SUMMARY ***
Total pot 27910 | Rake 0=20
Board [Jd 5c 9d 8c Qd]
Seat 1: CHAD9DW showed [6h 6s] and lost with a pair of Sixes
Seat 2: jayjay8956 folded before Flop (didn't bet)
Seat 3: 127Wlfhnd (button) folded before Flop (didn't bet)
Seat 4: Al Ricola (small blind) folded before Flop
Seat 5: ras41183 (big blind) showed [3d 6d] and won (27910) with a flus=
h, Queen high
Seat 7: JJin91 folded before Flop (didn't bet)
Seat 8: TrademarkTer folded before Flop (didn't bet)
Seat 9: merrrrrd folded before Flop (didn't bet)


*********** # 78 **************
PokerStars Hand #171704938790: Tournament #1648956862, $4.55+$0.45 USD =
Hold'em No Limit - Level XVIII (800/1600) - 2017/06/25 22:35:31 ET
Table '1648956862 2' 9-max Seat #4 is the button
Seat 2: jayjay8956 (15057 in chips)=20
Seat 3: 127Wlfhnd (53595 in chips)=20
Seat 4: Al Ricola (41704 in chips)=20
Seat 5: ras41183 (101737 in chips)=20
Seat 7: JJin91 (24360 in chips)=20
Seat 8: TrademarkTer (25098 in chips)=20
Seat 9: merrrrrd (75803 in chips)=20
jayjay8956: posts the ante 200
127Wlfhnd: posts the ante 200
Al Ricola: posts the ante 200
ras41183: posts the ante 200
JJin91: posts the ante 200
TrademarkTer: posts the ante 200
merrrrrd: posts the ante 200
ras41183: posts small blind 800
JJin91: posts big blind 1600
*** HOLE CARDS ***
Dealt to JJin91 [7d 3d]
TrademarkTer: folds=20
merrrrrd: folds=20
jayjay8956: folds=20
127Wlfhnd: calls 1600
Al Ricola: raises 2399 to 3999
ras41183: folds=20
JJin91: folds=20
127Wlfhnd: calls 2399
*** FLOP *** [Js Ah 3s]
127Wlfhnd: bets 1600
Al Ricola: calls 1600
*** TURN *** [Js Ah 3s] [Ac]
127Wlfhnd: bets 1600
Al Ricola: raises 5600 to 7200
127Wlfhnd: calls 5600
*** RIVER *** [Js Ah 3s Ac] [9s]
127Wlfhnd: bets 1600
Al Ricola: calls 1600
*** SHOW DOWN ***
127Wlfhnd: shows [Kh Th] (a pair of Aces)
Al Ricola: shows [5h Ad] (three of a kind, Aces)
Al Ricola collected 32598 from pot
*** SUMMARY ***
Total pot 32598 | Rake 0=20
Board [Js Ah 3s Ac 9s]
Seat 2: jayjay8956 folded before Flop (didn't bet)
Seat 3: 127Wlfhnd showed [Kh Th] and lost with a pair of Aces
Seat 4: Al Ricola (button) showed [5h Ad] and won (32598) with three of=
 a kind, Aces
Seat 5: ras41183 (small blind) folded before Flop
Seat 7: JJin91 (big blind) folded before Flop
Seat 8: TrademarkTer folded before Flop (didn't bet)
Seat 9: merrrrrd folded before Flop (didn't bet)


*********** # 79 **************
PokerStars Hand #171704939067: Tournament #1648956862, $4.55+$0.45 USD =
Hold'em No Limit - Level XIX (1000/2000) - 2017/06/25 22:36:38 ET
Table '1648956862 2' 9-max Seat #5 is the button
Seat 2: jayjay8956 (14857 in chips)=20
Seat 3: 127Wlfhnd (38996 in chips)=20
Seat 4: Al Ricola (59703 in chips)=20
Seat 5: ras41183 (100737 in chips)=20
Seat 7: JJin91 (22560 in chips)=20
Seat 8: TrademarkTer (24898 in chips)=20
Seat 9: merrrrrd (75603 in chips)=20
jayjay8956: posts the ante 250
127Wlfhnd: posts the ante 250
Al Ricola: posts the ante 250
ras41183: posts the ante 250
JJin91: posts the ante 250
TrademarkTer: posts the ante 250
merrrrrd: posts the ante 250
JJin91: posts small blind 1000
TrademarkTer: posts big blind 2000
*** HOLE CARDS ***
Dealt to JJin91 [4d 5s]
merrrrrd: folds=20
jayjay8956: folds=20
127Wlfhnd: raises 6750 to 8750
Al Ricola: folds=20
ras41183: folds=20
JJin91: folds=20
TrademarkTer: folds=20
Uncalled bet (6750) returned to 127Wlfhnd
127Wlfhnd collected 6750 from pot
127Wlfhnd: doesn't show hand=20
*** SUMMARY ***
Total pot 6750 | Rake 0=20
Seat 2: jayjay8956 folded before Flop (didn't bet)
Seat 3: 127Wlfhnd collected (6750)
Seat 4: Al Ricola folded before Flop (didn't bet)
Seat 5: ras41183 (button) folded before Flop (didn't bet)
Seat 7: JJin91 (small blind) folded before Flop
Seat 8: TrademarkTer (big blind) folded before Flop
Seat 9: merrrrrd folded before Flop (didn't bet)


*********** # 80 **************
PokerStars Hand #171704939203: Tournament #1648956862, $4.55+$0.45 USD =
Hold'em No Limit - Level XIX (1000/2000) - 2017/06/25 22:37:11 ET
Table '1648956862 2' 9-max Seat #7 is the button
Seat 2: jayjay8956 (14607 in chips)=20
Seat 3: 127Wlfhnd (43496 in chips)=20
Seat 4: Al Ricola (59453 in chips)=20
Seat 5: ras41183 (100487 in chips)=20
Seat 7: JJin91 (21310 in chips)=20
Seat 8: TrademarkTer (22648 in chips)=20
Seat 9: merrrrrd (75353 in chips)=20
jayjay8956: posts the ante 250
127Wlfhnd: posts the ante 250
Al Ricola: posts the ante 250
ras41183: posts the ante 250
JJin91: posts the ante 250
TrademarkTer: posts the ante 250
merrrrrd: posts the ante 250
TrademarkTer: posts small blind 1000
merrrrrd: posts big blind 2000
*** HOLE CARDS ***
Dealt to JJin91 [5d 6d]
jayjay8956: folds=20
127Wlfhnd: folds=20
Al Ricola: folds=20
ras41183: folds=20
JJin91: folds=20
TrademarkTer: folds=20
Uncalled bet (1000) returned to merrrrrd
merrrrrd collected 3750 from pot
*** SUMMARY ***
Total pot 3750 | Rake 0=20
Seat 2: jayjay8956 folded before Flop (didn't bet)
Seat 3: 127Wlfhnd folded before Flop (didn't bet)
Seat 4: Al Ricola folded before Flop (didn't bet)
Seat 5: ras41183 folded before Flop (didn't bet)
Seat 7: JJin91 (button) folded before Flop (didn't bet)
Seat 8: TrademarkTer (small blind) folded before Flop
Seat 9: merrrrrd (big blind) collected (3750)


*********** # 81 **************
PokerStars Hand #171704939306: Tournament #1648956862, $4.55+$0.45 USD =
Hold'em No Limit - Level XIX (1000/2000) - 2017/06/25 22:37:35 ET
Table '1648956862 2' 9-max Seat #8 is the button
Seat 2: jayjay8956 (14357 in chips)=20
Seat 3: 127Wlfhnd (43246 in chips)=20
Seat 4: Al Ricola (59203 in chips)=20
Seat 5: ras41183 (100237 in chips)=20
Seat 7: JJin91 (21060 in chips)=20
Seat 8: TrademarkTer (21398 in chips)=20
Seat 9: merrrrrd (77853 in chips)=20
jayjay8956: posts the ante 250
127Wlfhnd: posts the ante 250
Al Ricola: posts the ante 250
ras41183: posts the ante 250
JJin91: posts the ante 250
TrademarkTer: posts the ante 250
merrrrrd: posts the ante 250
merrrrrd: posts small blind 1000
jayjay8956: posts big blind 2000
*** HOLE CARDS ***
Dealt to JJin91 [Js Ad]
127Wlfhnd: folds=20
Al Ricola: folds=20
ras41183: calls 2000
JJin91: raises 18810 to 20810 and is all-in
TrademarkTer: folds=20
merrrrrd: folds=20
jayjay8956: folds=20
ras41183: folds=20
Uncalled bet (18810) returned to JJin91
JJin91 collected 8750 from pot
JJin91: doesn't show hand=20
*** SUMMARY ***
Total pot 8750 | Rake 0=20
Seat 2: jayjay8956 (big blind) folded before Flop
Seat 3: 127Wlfhnd folded before Flop (didn't bet)
Seat 4: Al Ricola folded before Flop (didn't bet)
Seat 5: ras41183 folded before Flop
Seat 7: JJin91 collected (8750)
Seat 8: TrademarkTer (button) folded before Flop (didn't bet)
Seat 9: merrrrrd (small blind) folded before Flop


*********** # 82 **************
PokerStars Hand #171704939585: Tournament #1648956862, $4.55+$0.45 USD =
Hold'em No Limit - Level XIX (1000/2000) - 2017/06/25 22:38:39 ET
Table '1648956862 2' 9-max Seat #9 is the button
Seat 2: jayjay8956 (12107 in chips)=20
Seat 3: 127Wlfhnd (42996 in chips)=20
Seat 4: Al Ricola (58953 in chips)=20
Seat 5: ras41183 (97987 in chips)=20
Seat 7: JJin91 (27560 in chips)=20
Seat 8: TrademarkTer (21148 in chips)=20
Seat 9: merrrrrd (76603 in chips)=20
jayjay8956: posts the ante 250
127Wlfhnd: posts the ante 250
Al Ricola: posts the ante 250
ras41183: posts the ante 250
JJin91: posts the ante 250
TrademarkTer: posts the ante 250
merrrrrd: posts the ante 250
jayjay8956: posts small blind 1000
127Wlfhnd: posts big blind 2000
*** HOLE CARDS ***
Dealt to JJin91 [Ks 3c]
Al Ricola: folds=20
ras41183: calls 2000
JJin91: folds=20
TrademarkTer: folds=20
merrrrrd: folds=20
jayjay8956: raises 9857 to 11857 and is all-in
127Wlfhnd: folds=20
ras41183: folds=20
Uncalled bet (9857) returned to jayjay8956
jayjay8956 collected 7750 from pot
jayjay8956: doesn't show hand=20
*** SUMMARY ***
Total pot 7750 | Rake 0=20
Seat 2: jayjay8956 (small blind) collected (7750)
Seat 3: 127Wlfhnd (big blind) folded before Flop
Seat 4: Al Ricola folded before Flop (didn't bet)
Seat 5: ras41183 folded before Flop
Seat 7: JJin91 folded before Flop (didn't bet)
Seat 8: TrademarkTer folded before Flop (didn't bet)
Seat 9: merrrrrd (button) folded before Flop (didn't bet)


*********** # 83 **************
PokerStars Hand #171704939763: Tournament #1648956862, $4.55+$0.45 USD =
Hold'em No Limit - Level XIX (1000/2000) - 2017/06/25 22:39:18 ET
Table '1648956862 2' 9-max Seat #2 is the button
Seat 2: jayjay8956 (17607 in chips)=20
Seat 3: 127Wlfhnd (40746 in chips)=20
Seat 4: Al Ricola (58703 in chips)=20
Seat 5: ras41183 (95737 in chips)=20
Seat 7: JJin91 (27310 in chips)=20
Seat 8: TrademarkTer (20898 in chips)=20
Seat 9: merrrrrd (76353 in chips)=20
jayjay8956: posts the ante 250
127Wlfhnd: posts the ante 250
Al Ricola: posts the ante 250
ras41183: posts the ante 250
JJin91: posts the ante 250
TrademarkTer: posts the ante 250
merrrrrd: posts the ante 250
127Wlfhnd: posts small blind 1000
Al Ricola: posts big blind 2000
*** HOLE CARDS ***
Dealt to JJin91 [9c Kh]
ras41183: calls 2000
JJin91: folds=20
TrademarkTer: raises 18648 to 20648 and is all-in
merrrrrd: folds=20
jayjay8956: folds=20
127Wlfhnd: folds=20
Al Ricola: folds=20
ras41183: folds=20
Uncalled bet (18648) returned to TrademarkTer
TrademarkTer collected 8750 from pot
*** SUMMARY ***
Total pot 8750 | Rake 0=20
Seat 2: jayjay8956 (button) folded before Flop (didn't bet)
Seat 3: 127Wlfhnd (small blind) folded before Flop
Seat 4: Al Ricola (big blind) folded before Flop
Seat 5: ras41183 folded before Flop
Seat 7: JJin91 folded before Flop (didn't bet)
Seat 8: TrademarkTer collected (8750)
Seat 9: merrrrrd folded before Flop (didn't bet)


*********** # 84 **************
PokerStars Hand #171704939973: Tournament #1648956862, $4.55+$0.45 USD =
Hold'em No Limit - Level XIX (1000/2000) - 2017/06/25 22:39:59 ET
Table '1648956862 2' 9-max Seat #3 is the button
Seat 2: jayjay8956 (17357 in chips)=20
Seat 3: 127Wlfhnd (39496 in chips)=20
Seat 4: Al Ricola (56453 in chips)=20
Seat 5: ras41183 (93487 in chips)=20
Seat 7: JJin91 (27060 in chips)=20
Seat 8: TrademarkTer (27398 in chips)=20
Seat 9: merrrrrd (76103 in chips)=20
jayjay8956: posts the ante 250
127Wlfhnd: posts the ante 250
Al Ricola: posts the ante 250
ras41183: posts the ante 250
JJin91: posts the ante 250
TrademarkTer: posts the ante 250
merrrrrd: posts the ante 250
Al Ricola: posts small blind 1000
ras41183: posts big blind 2000
*** HOLE CARDS ***
Dealt to JJin91 [Qs 2d]
JJin91: folds=20
TrademarkTer: raises 25148 to 27148 and is all-in
merrrrrd: folds=20
jayjay8956: folds=20
127Wlfhnd: folds=20
Al Ricola: folds=20
ras41183: folds=20
Uncalled bet (25148) returned to TrademarkTer
TrademarkTer collected 6750 from pot
*** SUMMARY ***
Total pot 6750 | Rake 0=20
Seat 2: jayjay8956 folded before Flop (didn't bet)
Seat 3: 127Wlfhnd (button) folded before Flop (didn't bet)
Seat 4: Al Ricola (small blind) folded before Flop
Seat 5: ras41183 (big blind) folded before Flop
Seat 7: JJin91 folded before Flop (didn't bet)
Seat 8: TrademarkTer collected (6750)
Seat 9: merrrrrd folded before Flop (didn't bet)


*********** # 85 **************
PokerStars Hand #171705333916: Tournament #1648956862, $4.55+$0.45 USD =
Hold'em No Limit - Level XIX (1000/2000) - 2017/06/25 22:40:29 ET
Table '1648956862 2' 9-max Seat #4 is the button
Seat 1: phillies1158 (38664 in chips)=20
Seat 2: jayjay8956 (17107 in chips)=20
Seat 3: 127Wlfhnd (39246 in chips)=20
Seat 4: Al Ricola (55203 in chips)=20
Seat 5: ras41183 (91237 in chips)=20
Seat 6: Mr_Warlock24 (130705 in chips)=20
Seat 7: JJin91 (26810 in chips)=20
Seat 8: TrademarkTer (31898 in chips)=20
Seat 9: merrrrrd (75853 in chips)=20
phillies1158: posts the ante 250
jayjay8956: posts the ante 250
127Wlfhnd: posts the ante 250
Al Ricola: posts the ante 250
ras41183: posts the ante 250
Mr_Warlock24: posts the ante 250
JJin91: posts the ante 250
TrademarkTer: posts the ante 250
merrrrrd: posts the ante 250
ras41183: posts small blind 1000
Mr_Warlock24: posts big blind 2000
*** HOLE CARDS ***
Dealt to JJin91 [2s 8d]
JJin91: folds=20
TrademarkTer: folds=20
merrrrrd: folds=20
phillies1158: raises 2920 to 4920
jayjay8956: folds=20
127Wlfhnd: folds=20
Al Ricola: folds=20
ras41183: folds=20
Mr_Warlock24: calls 2920
*** FLOP *** [8s 5s Ts]
Mr_Warlock24: checks=20
phillies1158: bets 4451
Mr_Warlock24: folds=20
Uncalled bet (4451) returned to phillies1158
phillies1158 collected 13090 from pot
phillies1158: doesn't show hand=20
*** SUMMARY ***
Total pot 13090 | Rake 0=20
Board [8s 5s Ts]
Seat 1: phillies1158 collected (13090)
Seat 2: jayjay8956 folded before Flop (didn't bet)
Seat 3: 127Wlfhnd folded before Flop (didn't bet)
Seat 4: Al Ricola (button) folded before Flop (didn't bet)
Seat 5: ras41183 (small blind) folded before Flop
Seat 6: Mr_Warlock24 (big blind) folded on the Flop
Seat 7: JJin91 folded before Flop (didn't bet)
Seat 8: TrademarkTer folded before Flop (didn't bet)
Seat 9: merrrrrd folded before Flop (didn't bet)


*********** # 86 **************
PokerStars Hand #171705334095: Tournament #1648956862, $4.55+$0.45 USD =
Hold'em No Limit - Level XX (1250/2500) - 2017/06/25 22:41:10 ET
Table '1648956862 2' 9-max Seat #5 is the button
Seat 1: phillies1158 (46584 in chips)=20
Seat 2: jayjay8956 (16857 in chips)=20
Seat 3: 127Wlfhnd (38996 in chips)=20
Seat 4: Al Ricola (54953 in chips)=20
Seat 5: ras41183 (89987 in chips)=20
Seat 6: Mr_Warlock24 (125535 in chips)=20
Seat 7: JJin91 (26560 in chips)=20
Seat 8: TrademarkTer (31648 in chips)=20
Seat 9: merrrrrd (75603 in chips)=20
phillies1158: posts the ante 325
jayjay8956: posts the ante 325
127Wlfhnd: posts the ante 325
Al Ricola: posts the ante 325
ras41183: posts the ante 325
Mr_Warlock24: posts the ante 325
JJin91: posts the ante 325
TrademarkTer: posts the ante 325
merrrrrd: posts the ante 325
Mr_Warlock24: posts small blind 1250
JJin91: posts big blind 2500
*** HOLE CARDS ***
Dealt to JJin91 [2c 2s]
TrademarkTer: folds=20
merrrrrd: folds=20
phillies1158: folds=20
jayjay8956 has timed out
jayjay8956: folds=20
jayjay8956 is sitting out
127Wlfhnd: calls 2500
jayjay8956 has returned
Al Ricola: folds=20
ras41183: folds=20
Mr_Warlock24: calls 1250
JJin91: raises 23735 to 26235 and is all-in
127Wlfhnd: folds=20
Mr_Warlock24: folds=20
Uncalled bet (23735) returned to JJin91
JJin91 collected 10425 from pot
JJin91: doesn't show hand=20
*** SUMMARY ***
Total pot 10425 | Rake 0=20
Seat 1: phillies1158 folded before Flop (didn't bet)
Seat 2: jayjay8956 folded before Flop (didn't bet)
Seat 3: 127Wlfhnd folded before Flop
Seat 4: Al Ricola folded before Flop (didn't bet)
Seat 5: ras41183 (button) folded before Flop (didn't bet)
Seat 6: Mr_Warlock24 (small blind) folded before Flop
Seat 7: JJin91 (big blind) collected (10425)
Seat 8: TrademarkTer folded before Flop (didn't bet)
Seat 9: merrrrrd folded before Flop (didn't bet)


*********** # 87 **************
PokerStars Hand #171705334288: Tournament #1648956862, $4.55+$0.45 USD =
Hold'em No Limit - Level XX (1250/2500) - 2017/06/25 22:41:54 ET
Table '1648956862 2' 9-max Seat #6 is the button
Seat 1: phillies1158 (46259 in chips)=20
Seat 2: jayjay8956 (16532 in chips)=20
Seat 3: 127Wlfhnd (36171 in chips)=20
Seat 4: Al Ricola (54628 in chips)=20
Seat 5: ras41183 (89662 in chips)=20
Seat 6: Mr_Warlock24 (122710 in chips)=20
Seat 7: JJin91 (34160 in chips)=20
Seat 8: TrademarkTer (31323 in chips)=20
Seat 9: merrrrrd (75278 in chips)=20
phillies1158: posts the ante 325
jayjay8956: posts the ante 325
127Wlfhnd: posts the ante 325
Al Ricola: posts the ante 325
ras41183: posts the ante 325
Mr_Warlock24: posts the ante 325
JJin91: posts the ante 325
TrademarkTer: posts the ante 325
merrrrrd: posts the ante 325
JJin91: posts small blind 1250
TrademarkTer: posts big blind 2500
*** HOLE CARDS ***
Dealt to JJin91 [6c 3s]
merrrrrd: folds=20
phillies1158: folds=20
jayjay8956: raises 13707 to 16207 and is all-in
127Wlfhnd: folds=20
Al Ricola: folds=20
ras41183: folds=20
Mr_Warlock24: folds=20
JJin91: folds=20
TrademarkTer: calls 13707
*** FLOP *** [2d 9h Qh]
*** TURN *** [2d 9h Qh] [8h]
*** RIVER *** [2d 9h Qh 8h] [Kh]
*** SHOW DOWN ***
TrademarkTer: shows [Jh Js] (a flush, King high)
jayjay8956: shows [Th Ts] (a flush, King high - lower cards)
TrademarkTer collected 36589 from pot
jayjay8956 finished the tournament in 27th place
*** SUMMARY ***
Total pot 36589 | Rake 0=20
Board [2d 9h Qh 8h Kh]
Seat 1: phillies1158 folded before Flop (didn't bet)
Seat 2: jayjay8956 showed [Th Ts] and lost with a flush, King high
Seat 3: 127Wlfhnd folded before Flop (didn't bet)
Seat 4: Al Ricola folded before Flop (didn't bet)
Seat 5: ras41183 folded before Flop (didn't bet)
Seat 6: Mr_Warlock24 (button) folded before Flop (didn't bet)
Seat 7: JJin91 (small blind) folded before Flop
Seat 8: TrademarkTer (big blind) showed [Jh Js] and won (36589) with a =
flush, King high
Seat 9: merrrrrd folded before Flop (didn't bet)


*********** # 88 **************
PokerStars Hand #171705334438: Tournament #1648956862, $4.55+$0.45 USD =
Hold'em No Limit - Level XX (1250/2500) - 2017/06/25 22:42:25 ET
Table '1648956862 2' 9-max Seat #7 is the button
Seat 1: phillies1158 (45934 in chips)=20
Seat 3: 127Wlfhnd (35846 in chips)=20
Seat 4: Al Ricola (54303 in chips)=20
Seat 5: ras41183 (89337 in chips)=20
Seat 6: Mr_Warlock24 (122385 in chips)=20
Seat 7: JJin91 (32585 in chips)=20
Seat 8: TrademarkTer (51380 in chips)=20
Seat 9: merrrrrd (74953 in chips)=20
phillies1158: posts the ante 325
127Wlfhnd: posts the ante 325
Al Ricola: posts the ante 325
ras41183: posts the ante 325
Mr_Warlock24: posts the ante 325
JJin91: posts the ante 325
TrademarkTer: posts the ante 325
merrrrrd: posts the ante 325
TrademarkTer: posts small blind 1250
merrrrrd: posts big blind 2500
*** HOLE CARDS ***
Dealt to JJin91 [9d 8h]
phillies1158: folds=20
127Wlfhnd: folds=20
Al Ricola: raises 3299 to 5799
ras41183: folds=20
Mr_Warlock24: folds=20
JJin91: folds=20
TrademarkTer: folds=20
merrrrrd: folds=20
Uncalled bet (3299) returned to Al Ricola
Al Ricola collected 8850 from pot
*** SUMMARY ***
Total pot 8850 | Rake 0=20
Seat 1: phillies1158 folded before Flop (didn't bet)
Seat 3: 127Wlfhnd folded before Flop (didn't bet)
Seat 4: Al Ricola collected (8850)
Seat 5: ras41183 folded before Flop (didn't bet)
Seat 6: Mr_Warlock24 folded before Flop (didn't bet)
Seat 7: JJin91 (button) folded before Flop (didn't bet)
Seat 8: TrademarkTer (small blind) folded before Flop
Seat 9: merrrrrd (big blind) folded before Flop


*********** # 89 **************
PokerStars Hand #171705334549: Tournament #1648956862, $4.55+$0.45 USD =
Hold'em No Limit - Level XX (1250/2500) - 2017/06/25 22:42:53 ET
Table '1648956862 2' 9-max Seat #8 is the button
Seat 1: phillies1158 (45609 in chips)=20
Seat 3: 127Wlfhnd (35521 in chips)=20
Seat 4: Al Ricola (60328 in chips)=20
Seat 5: ras41183 (89012 in chips)=20
Seat 6: Mr_Warlock24 (122060 in chips)=20
Seat 7: JJin91 (32260 in chips)=20
Seat 8: TrademarkTer (49805 in chips)=20
Seat 9: merrrrrd (72128 in chips)=20
phillies1158: posts the ante 325
127Wlfhnd: posts the ante 325
Al Ricola: posts the ante 325
ras41183: posts the ante 325
Mr_Warlock24: posts the ante 325
JJin91: posts the ante 325
TrademarkTer: posts the ante 325
merrrrrd: posts the ante 325
merrrrrd: posts small blind 1250
phillies1158: posts big blind 2500
*** HOLE CARDS ***
Dealt to JJin91 [9s 5c]
127Wlfhnd: folds=20
Al Ricola: folds=20
ras41183: folds=20
Mr_Warlock24: folds=20
JJin91: folds=20
TrademarkTer: calls 2500
merrrrrd: calls 1250
phillies1158: checks=20
*** FLOP *** [3c 3h Kd]
merrrrrd: checks=20
phillies1158: bets 4848
TrademarkTer: raises 4848 to 9696
merrrrrd: folds=20
phillies1158: calls 4848
*** TURN *** [3c 3h Kd] [7d]
phillies1158: checks=20
TrademarkTer: bets 14746
phillies1158: raises 18342 to 33088 and is all-in
TrademarkTer: calls 18342
*** RIVER *** [3c 3h Kd 7d] [7h]
*** SHOW DOWN ***
phillies1158: shows [Ks Tc] (two pair, Kings and Sevens)
TrademarkTer: shows [3d Ad] (a full house, Threes full of Sevens)
TrademarkTer collected 95668 from pot
phillies1158 finished the tournament in 26th place
*** SUMMARY ***
Total pot 95668 | Rake 0=20
Board [3c 3h Kd 7d 7h]
Seat 1: phillies1158 (big blind) showed [Ks Tc] and lost with two pair,=
 Kings and Sevens
Seat 3: 127Wlfhnd folded before Flop (didn't bet)
Seat 4: Al Ricola folded before Flop (didn't bet)
Seat 5: ras41183 folded before Flop (didn't bet)
Seat 6: Mr_Warlock24 folded before Flop (didn't bet)
Seat 7: JJin91 folded before Flop (didn't bet)
Seat 8: TrademarkTer (button) showed [3d Ad] and won (95668) with a ful=
l house, Threes full of Sevens
Seat 9: merrrrrd (small blind) folded on the Flop


*********** # 90 **************
PokerStars Hand #171705334794: Tournament #1648956862, $4.55+$0.45 USD =
Hold'em No Limit - Level XX (1250/2500) - 2017/06/25 22:43:48 ET
Table '1648956862 2' 9-max Seat #9 is the button
Seat 3: 127Wlfhnd (35196 in chips)=20
Seat 4: Al Ricola (60003 in chips)=20
Seat 5: ras41183 (88687 in chips)=20
Seat 6: Mr_Warlock24 (121735 in chips)=20
Seat 7: JJin91 (31935 in chips)=20
Seat 8: TrademarkTer (99864 in chips)=20
Seat 9: merrrrrd (69303 in chips)=20
127Wlfhnd: posts the ante 325
Al Ricola: posts the ante 325
ras41183: posts the ante 325
Mr_Warlock24: posts the ante 325
JJin91: posts the ante 325
TrademarkTer: posts the ante 325
merrrrrd: posts the ante 325
127Wlfhnd: posts small blind 1250
Al Ricola: posts big blind 2500
*** HOLE CARDS ***
Dealt to JJin91 [As Ah]
ras41183: folds=20
Mr_Warlock24: folds=20
JJin91: calls 2500
TrademarkTer: folds=20
merrrrrd: folds=20
127Wlfhnd: calls 1250
Al Ricola: checks=20
*** FLOP *** [8c 6d Js]
127Wlfhnd: checks=20
Al Ricola: checks=20
JJin91: bets 3777
127Wlfhnd: folds=20
Al Ricola: folds=20
Uncalled bet (3777) returned to JJin91
JJin91 collected 9775 from pot
JJin91: doesn't show hand=20
*** SUMMARY ***
Total pot 9775 | Rake 0=20
Board [8c 6d Js]
Seat 3: 127Wlfhnd (small blind) folded on the Flop
Seat 4: Al Ricola (big blind) folded on the Flop
Seat 5: ras41183 folded before Flop (didn't bet)
Seat 6: Mr_Warlock24 folded before Flop (didn't bet)
Seat 7: JJin91 collected (9775)
Seat 8: TrademarkTer folded before Flop (didn't bet)
Seat 9: merrrrrd (button) folded before Flop (didn't bet)


*********** # 91 **************
PokerStars Hand #171705334964: Tournament #1648956862, $4.55+$0.45 USD =
Hold'em No Limit - Level XX (1250/2500) - 2017/06/25 22:44:28 ET
Table '1648956862 2' 9-max Seat #3 is the button
Seat 1: giant122457 (37024 in chips)=20
Seat 3: 127Wlfhnd (32371 in chips)=20
Seat 4: Al Ricola (57178 in chips)=20
Seat 5: ras41183 (88362 in chips)=20
Seat 6: Mr_Warlock24 (121410 in chips)=20
Seat 7: JJin91 (38885 in chips)=20
Seat 8: TrademarkTer (99539 in chips)=20
Seat 9: merrrrrd (68978 in chips)=20
giant122457: posts the ante 325
127Wlfhnd: posts the ante 325
Al Ricola: posts the ante 325
ras41183: posts the ante 325
Mr_Warlock24: posts the ante 325
JJin91: posts the ante 325
TrademarkTer: posts the ante 325
merrrrrd: posts the ante 325
Al Ricola: posts small blind 1250
ras41183: posts big blind 2500
*** HOLE CARDS ***
Dealt to JJin91 [7d Ks]
Mr_Warlock24: raises 2500 to 5000
JJin91: folds=20
TrademarkTer: folds=20
merrrrrd: folds=20
giant122457: calls 5000
127Wlfhnd: folds=20
Al Ricola: calls 3750
ras41183: calls 2500
*** FLOP *** [Kc 9d 5c]
Al Ricola: checks=20
ras41183: checks=20
Mr_Warlock24: checks=20
giant122457: bets 2500
Al Ricola: calls 2500
ras41183: calls 2500
Mr_Warlock24: folds=20
*** TURN *** [Kc 9d 5c] [5d]
Al Ricola: checks=20
ras41183: checks=20
giant122457: checks=20
*** RIVER *** [Kc 9d 5c 5d] [7h]
Al Ricola: bets 7999
ras41183: folds=20
giant122457: folds=20
Uncalled bet (7999) returned to Al Ricola
Al Ricola collected 30100 from pot
*** SUMMARY ***
Total pot 30100 | Rake 0=20
Board [Kc 9d 5c 5d 7h]
Seat 1: giant122457 folded on the River
Seat 3: 127Wlfhnd (button) folded before Flop (didn't bet)
Seat 4: Al Ricola (small blind) collected (30100)
Seat 5: ras41183 (big blind) folded on the River
Seat 6: Mr_Warlock24 folded on the Flop
Seat 7: JJin91 folded before Flop (didn't bet)
Seat 8: TrademarkTer folded before Flop (didn't bet)
Seat 9: merrrrrd folded before Flop (didn't bet)


*********** # 92 **************
PokerStars Hand #171705335269: Tournament #1648956862, $4.55+$0.45 USD =
Hold'em No Limit - Level XX (1250/2500) - 2017/06/25 22:45:37 ET
Table '1648956862 2' 9-max Seat #4 is the button
Seat 1: giant122457 (29199 in chips)=20
Seat 3: 127Wlfhnd (32046 in chips)=20
Seat 4: Al Ricola (79453 in chips)=20
Seat 5: ras41183 (80537 in chips)=20
Seat 6: Mr_Warlock24 (116085 in chips)=20
Seat 7: JJin91 (38560 in chips)=20
Seat 8: TrademarkTer (99214 in chips)=20
Seat 9: merrrrrd (68653 in chips)=20
giant122457: posts the ante 325
127Wlfhnd: posts the ante 325
Al Ricola: posts the ante 325
ras41183: posts the ante 325
Mr_Warlock24: posts the ante 325
JJin91: posts the ante 325
TrademarkTer: posts the ante 325
merrrrrd: posts the ante 325
ras41183: posts small blind 1250
Mr_Warlock24: posts big blind 2500
*** HOLE CARDS ***
Dealt to JJin91 [Ts 2h]
JJin91: folds=20
TrademarkTer: folds=20
merrrrrd: folds=20
giant122457: folds=20
127Wlfhnd: folds=20
Al Ricola: folds=20
ras41183: folds=20
Uncalled bet (1250) returned to Mr_Warlock24
ras41183 is sitting out
Mr_Warlock24 collected 5100 from pot
*** SUMMARY ***
Total pot 5100 | Rake 0=20
Seat 1: giant122457 folded before Flop (didn't bet)
Seat 3: 127Wlfhnd folded before Flop (didn't bet)
Seat 4: Al Ricola (button) folded before Flop (didn't bet)
Seat 5: ras41183 (small blind) folded before Flop
Seat 6: Mr_Warlock24 (big blind) collected (5100)
Seat 7: JJin91 folded before Flop (didn't bet)
Seat 8: TrademarkTer folded before Flop (didn't bet)
Seat 9: merrrrrd folded before Flop (didn't bet)


*********** # 93 **************
PokerStars Hand #171705335385: Tournament #1648956862, $4.55+$0.45 USD =
Hold'em No Limit - Level XXI (1500/3000) - 2017/06/25 22:46:06 ET
Table '1648956862 2' 9-max Seat #5 is the button
Seat 1: giant122457 (28874 in chips)=20
Seat 3: 127Wlfhnd (31721 in chips)=20
Seat 4: Al Ricola (79128 in chips)=20
Seat 5: ras41183 (78962 in chips) is sitting out
Seat 6: Mr_Warlock24 (119610 in chips)=20
Seat 7: JJin91 (38235 in chips)=20
Seat 8: TrademarkTer (98889 in chips)=20
Seat 9: merrrrrd (68328 in chips)=20
giant122457: posts the ante 375
127Wlfhnd: posts the ante 375
Al Ricola: posts the ante 375
ras41183: posts the ante 375
Mr_Warlock24: posts the ante 375
JJin91: posts the ante 375
TrademarkTer: posts the ante 375
merrrrrd: posts the ante 375
Mr_Warlock24: posts small blind 1500
JJin91: posts big blind 3000
*** HOLE CARDS ***
Dealt to JJin91 [4c 4d]
TrademarkTer: folds=20
merrrrrd: folds=20
giant122457: folds=20
127Wlfhnd: calls 3000
Al Ricola: raises 3770 to 6770
ras41183: folds=20
Mr_Warlock24: folds=20
JJin91: folds=20
127Wlfhnd: raises 24576 to 31346 and is all-in
Al Ricola: folds=20
Uncalled bet (24576) returned to 127Wlfhnd
127Wlfhnd collected 21040 from pot
127Wlfhnd: doesn't show hand=20
*** SUMMARY ***
Total pot 21040 | Rake 0=20
Seat 1: giant122457 folded before Flop (didn't bet)
Seat 3: 127Wlfhnd collected (21040)
Seat 4: Al Ricola folded before Flop
Seat 5: ras41183 (button) folded before Flop (didn't bet)
Seat 6: Mr_Warlock24 (small blind) folded before Flop
Seat 7: JJin91 (big blind) folded before Flop
Seat 8: TrademarkTer folded before Flop (didn't bet)
Seat 9: merrrrrd folded before Flop (didn't bet)


*********** # 94 **************
PokerStars Hand #171705335630: Tournament #1648956862, $4.55+$0.45 USD =
Hold'em No Limit - Level XXI (1500/3000) - 2017/06/25 22:47:00 ET
Table '1648956862 2' 9-max Seat #6 is the button
Seat 1: giant122457 (28499 in chips)=20
Seat 3: 127Wlfhnd (45616 in chips)=20
Seat 4: Al Ricola (71983 in chips)=20
Seat 5: ras41183 (78587 in chips) is sitting out
Seat 6: Mr_Warlock24 (117735 in chips)=20
Seat 7: JJin91 (34860 in chips)=20
Seat 8: TrademarkTer (98514 in chips)=20
Seat 9: merrrrrd (67953 in chips)=20
giant122457: posts the ante 375
127Wlfhnd: posts the ante 375
Al Ricola: posts the ante 375
ras41183: posts the ante 375
Mr_Warlock24: posts the ante 375
JJin91: posts the ante 375
TrademarkTer: posts the ante 375
merrrrrd: posts the ante 375
JJin91: posts small blind 1500
TrademarkTer: posts big blind 3000
*** HOLE CARDS ***
Dealt to JJin91 [3d Kc]
merrrrrd: folds=20
giant122457: raises 3000 to 6000
127Wlfhnd: folds=20
Al Ricola: folds=20
ras41183: folds=20
Mr_Warlock24: folds=20
JJin91: folds=20
TrademarkTer: calls 3000
*** FLOP *** [9h Tc As]
TrademarkTer: checks=20
giant122457: bets 3000
TrademarkTer said, "we goin in"
TrademarkTer: raises 89139 to 92139 and is all-in
giant122457: calls 19124 and is all-in
Uncalled bet (70015) returned to TrademarkTer
*** TURN *** [9h Tc As] [2h]
*** RIVER *** [9h Tc As 2h] [Kd]
*** SHOW DOWN ***
TrademarkTer: shows [9d Th] (two pair, Tens and Nines)
giant122457: shows [Jd Ad] (a pair of Aces)
TrademarkTer collected 60748 from pot
giant122457 finished the tournament in 24th place
*** SUMMARY ***
Total pot 60748 | Rake 0=20
Board [9h Tc As 2h Kd]
Seat 1: giant122457 showed [Jd Ad] and lost with a pair of Aces
Seat 3: 127Wlfhnd folded before Flop (didn't bet)
Seat 4: Al Ricola folded before Flop (didn't bet)
Seat 5: ras41183 folded before Flop (didn't bet)
Seat 6: Mr_Warlock24 (button) folded before Flop (didn't bet)
Seat 7: JJin91 (small blind) folded before Flop
Seat 8: TrademarkTer (big blind) showed [9d Th] and won (60748) with tw=
o pair, Tens and Nines
Seat 9: merrrrrd folded before Flop (didn't bet)


*********** # 95 **************
PokerStars Hand #171705335844: Tournament #1648956862, $4.55+$0.45 USD =
Hold'em No Limit - Level XXI (1500/3000) - 2017/06/25 22:47:51 ET
Table '1648956862 2' 9-max Seat #7 is the button
Seat 3: 127Wlfhnd (45241 in chips)=20
Seat 4: Al Ricola (71608 in chips)=20
Seat 5: ras41183 (78212 in chips) is sitting out
Seat 6: Mr_Warlock24 (117360 in chips)=20
Seat 7: JJin91 (32985 in chips)=20
Seat 8: TrademarkTer (130763 in chips)=20
Seat 9: merrrrrd (67578 in chips)=20
127Wlfhnd: posts the ante 375
Al Ricola: posts the ante 375
ras41183: posts the ante 375
Mr_Warlock24: posts the ante 375
JJin91: posts the ante 375
TrademarkTer: posts the ante 375
merrrrrd: posts the ante 375
TrademarkTer: posts small blind 1500
merrrrrd: posts big blind 3000
*** HOLE CARDS ***
Dealt to JJin91 [Kh 4s]
127Wlfhnd: folds=20
Al Ricola: raises 3000 to 6000
ras41183: folds=20
Mr_Warlock24: calls 6000
JJin91: folds=20
TrademarkTer: calls 4500
merrrrrd: calls 3000
*** FLOP *** [3h 4h 8h]
TrademarkTer: checks=20
merrrrrd: checks=20
Al Ricola: bets 6999
Mr_Warlock24: folds=20
TrademarkTer: folds=20
merrrrrd: folds=20
Uncalled bet (6999) returned to Al Ricola
Al Ricola collected 26625 from pot
*** SUMMARY ***
Total pot 26625 | Rake 0=20
Board [3h 4h 8h]
Seat 3: 127Wlfhnd folded before Flop (didn't bet)
Seat 4: Al Ricola collected (26625)
Seat 5: ras41183 folded before Flop (didn't bet)
Seat 6: Mr_Warlock24 folded on the Flop
Seat 7: JJin91 (button) folded before Flop (didn't bet)
Seat 8: TrademarkTer (small blind) folded on the Flop
Seat 9: merrrrrd (big blind) folded on the Flop


*********** # 96 **************
PokerStars Hand #171705336026: Tournament #1648956862, $4.55+$0.45 USD =
Hold'em No Limit - Level XXI (1500/3000) - 2017/06/25 22:48:30 ET
Table '1648956862 2' 9-max Seat #8 is the button
Seat 3: 127Wlfhnd (44866 in chips)=20
Seat 4: Al Ricola (91858 in chips)=20
Seat 5: ras41183 (77837 in chips) is sitting out
Seat 6: Mr_Warlock24 (110985 in chips)=20
Seat 7: JJin91 (32610 in chips)=20
Seat 8: TrademarkTer (124388 in chips)=20
Seat 9: merrrrrd (61203 in chips)=20
127Wlfhnd: posts the ante 375
Al Ricola: posts the ante 375
ras41183: posts the ante 375
Mr_Warlock24: posts the ante 375
JJin91: posts the ante 375
TrademarkTer: posts the ante 375
merrrrrd: posts the ante 375
merrrrrd: posts small blind 1500
127Wlfhnd: posts big blind 3000
*** HOLE CARDS ***
Dealt to JJin91 [Qh Ah]
Al Ricola: folds=20
ras41183: folds=20
Mr_Warlock24: folds=20
JJin91: raises 29235 to 32235 and is all-in
TrademarkTer: folds=20
merrrrrd: folds=20
127Wlfhnd: folds=20
Uncalled bet (29235) returned to JJin91
JJin91 collected 10125 from pot
JJin91: doesn't show hand=20
*** SUMMARY ***
Total pot 10125 | Rake 0=20
Seat 3: 127Wlfhnd (big blind) folded before Flop
Seat 4: Al Ricola folded before Flop (didn't bet)
Seat 5: ras41183 folded before Flop (didn't bet)
Seat 6: Mr_Warlock24 folded before Flop (didn't bet)
Seat 7: JJin91 collected (10125)
Seat 8: TrademarkTer (button) folded before Flop (didn't bet)
Seat 9: merrrrrd (small blind) folded before Flop


*********** # 97 **************
PokerStars Hand #171705336091: Tournament #1648956862, $4.55+$0.45 USD =
Hold'em No Limit - Level XXI (1500/3000) - 2017/06/25 22:48:47 ET
Table '1648956862 2' 9-max Seat #9 is the button
Seat 3: 127Wlfhnd (41491 in chips)=20
Seat 4: Al Ricola (91483 in chips)=20
Seat 5: ras41183 (77462 in chips) is sitting out
Seat 6: Mr_Warlock24 (110610 in chips)=20
Seat 7: JJin91 (39360 in chips)=20
Seat 8: TrademarkTer (124013 in chips)=20
Seat 9: merrrrrd (59328 in chips)=20
127Wlfhnd: posts the ante 375
Al Ricola: posts the ante 375
ras41183: posts the ante 375
Mr_Warlock24: posts the ante 375
JJin91: posts the ante 375
TrademarkTer: posts the ante 375
merrrrrd: posts the ante 375
127Wlfhnd: posts small blind 1500
Al Ricola: posts big blind 3000
*** HOLE CARDS ***
Dealt to JJin91 [Ks Kc]
ras41183: folds=20
Mr_Warlock24: folds=20
ras41183 has returned
JJin91: raises 35985 to 38985 and is all-in
TrademarkTer: folds=20
merrrrrd: folds=20
127Wlfhnd: raises 2131 to 41116 and is all-in
Al Ricola: folds=20
Uncalled bet (2131) returned to 127Wlfhnd
*** FLOP *** [Qh 2s 4d]
*** TURN *** [Qh 2s 4d] [4c]
*** RIVER *** [Qh 2s 4d 4c] [9h]
*** SHOW DOWN ***
127Wlfhnd: shows [Ad Jh] (a pair of Fours)
JJin91: shows [Ks Kc] (two pair, Kings and Fours)
JJin91 collected 83595 from pot
*** SUMMARY ***
Total pot 83595 | Rake 0=20
Board [Qh 2s 4d 4c 9h]
Seat 3: 127Wlfhnd (small blind) showed [Ad Jh] and lost with a pair of =
Fours
Seat 4: Al Ricola (big blind) folded before Flop
Seat 5: ras41183 folded before Flop (didn't bet)
Seat 6: Mr_Warlock24 folded before Flop (didn't bet)
Seat 7: JJin91 showed [Ks Kc] and won (83595) with two pair, Kings and =
Fours
Seat 8: TrademarkTer folded before Flop (didn't bet)
Seat 9: merrrrrd (button) folded before Flop (didn't bet)


*********** # 98 **************
PokerStars Hand #171705336255: Tournament #1648956862, $4.55+$0.45 USD =
Hold'em No Limit - Level XXI (1500/3000) - 2017/06/25 22:49:29 ET
Table '1648956862 2' 9-max Seat #3 is the button
Seat 3: 127Wlfhnd (2131 in chips)=20
Seat 4: Al Ricola (88108 in chips)=20
Seat 5: ras41183 (77087 in chips)=20
Seat 6: Mr_Warlock24 (110235 in chips)=20
Seat 7: JJin91 (83595 in chips)=20
Seat 8: TrademarkTer (123638 in chips)=20
Seat 9: merrrrrd (58953 in chips)=20
127Wlfhnd: posts the ante 375
Al Ricola: posts the ante 375
ras41183: posts the ante 375
Mr_Warlock24: posts the ante 375
JJin91: posts the ante 375
TrademarkTer: posts the ante 375
merrrrrd: posts the ante 375
Al Ricola: posts small blind 1500
ras41183: posts big blind 3000
*** HOLE CARDS ***
Dealt to JJin91 [Jd 7c]
Mr_Warlock24: folds=20
JJin91: folds=20
TrademarkTer: folds=20
merrrrrd: folds=20
127Wlfhnd: calls 1756 and is all-in
Al Ricola: calls 1500
ras41183: checks=20
*** FLOP *** [2h Ks Qc]
Al Ricola: checks=20
ras41183: checks=20
*** TURN *** [2h Ks Qc] [Qd]
Al Ricola: checks=20
ras41183: checks=20
*** RIVER *** [2h Ks Qc Qd] [Kc]
Al Ricola: checks=20
ras41183: checks=20
*** SHOW DOWN ***
Al Ricola: shows [3h 5h] (two pair, Kings and Queens)
ras41183: shows [Tc 9d] (two pair, Kings and Queens - Ten kicker)
ras41183 collected 2488 from side pot
127Wlfhnd: mucks hand=20
ras41183 collected 7893 from main pot
127Wlfhnd finished the tournament in 21st place
*** SUMMARY ***
Total pot 10381 Main pot 7893. Side pot 2488. | Rake 0=20
Board [2h Ks Qc Qd Kc]
Seat 3: 127Wlfhnd (button) mucked [8d 2s]
Seat 4: Al Ricola (small blind) showed [3h 5h] and lost with two pair, =
Kings and Queens
Seat 5: ras41183 (big blind) showed [Tc 9d] and won (10381) with two pa=
ir, Kings and Queens
Seat 6: Mr_Warlock24 folded before Flop (didn't bet)
Seat 7: JJin91 folded before Flop (didn't bet)
Seat 8: TrademarkTer folded before Flop (didn't bet)
Seat 9: merrrrrd folded before Flop (didn't bet)


*********** # 99 **************
PokerStars Hand #171705336412: Tournament #1648956862, $4.55+$0.45 USD =
Hold'em No Limit - Level XXI (1500/3000) - 2017/06/25 22:50:04 ET
Table '1648956862 2' 9-max Seat #4 is the button
Seat 4: Al Ricola (84733 in chips)=20
Seat 5: ras41183 (84093 in chips)=20
Seat 6: Mr_Warlock24 (109860 in chips)=20
Seat 7: JJin91 (83220 in chips)=20
Seat 8: TrademarkTer (123263 in chips)=20
Seat 9: merrrrrd (58578 in chips)=20
Al Ricola: posts the ante 375
ras41183: posts the ante 375
Mr_Warlock24: posts the ante 375
JJin91: posts the ante 375
TrademarkTer: posts the ante 375
merrrrrd: posts the ante 375
ras41183: posts small blind 1500
Mr_Warlock24: posts big blind 3000
*** HOLE CARDS ***
Dealt to JJin91 [5s 3c]
JJin91: folds=20
TrademarkTer: folds=20
merrrrrd: folds=20
Al Ricola: folds=20
ras41183: calls 1500
Mr_Warlock24: raises 6000 to 9000
ras41183: calls 6000
*** FLOP *** [9d 9h 6h]
ras41183: checks=20
Mr_Warlock24: bets 6683
ras41183: calls 6683
*** TURN *** [9d 9h 6h] [Js]
ras41183: checks=20
Mr_Warlock24: checks=20
*** RIVER *** [9d 9h 6h Js] [8h]
ras41183: checks=20
Mr_Warlock24: checks=20
*** SHOW DOWN ***
ras41183: shows [Ts 8d] (two pair, Nines and Eights)
Mr_Warlock24: mucks hand=20
ras41183 collected 33616 from pot
*** SUMMARY ***
Total pot 33616 | Rake 0=20
Board [9d 9h 6h Js 8h]
Seat 4: Al Ricola (button) folded before Flop (didn't bet)
Seat 5: ras41183 (small blind) showed [Ts 8d] and won (33616) with two =
pair, Nines and Eights
Seat 6: Mr_Warlock24 (big blind) mucked [Ad Kc]
Seat 7: JJin91 folded before Flop (didn't bet)
Seat 8: TrademarkTer folded before Flop (didn't bet)
Seat 9: merrrrrd folded before Flop (didn't bet)


*********** # 100 **************
PokerStars Hand #171705336670: Tournament #1648956862, $4.55+$0.45 USD =
Hold'em No Limit - Level XXII (2000/4000) - 2017/06/25 22:51:06 ET
Table '1648956862 2' 9-max Seat #5 is the button
Seat 4: Al Ricola (84358 in chips)=20
Seat 5: ras41183 (101651 in chips)=20
Seat 6: Mr_Warlock24 (93802 in chips)=20
Seat 7: JJin91 (82845 in chips)=20
Seat 8: TrademarkTer (122888 in chips)=20
Seat 9: merrrrrd (58203 in chips)=20
Al Ricola: posts the ante 500
ras41183: posts the ante 500
Mr_Warlock24: posts the ante 500
JJin91: posts the ante 500
TrademarkTer: posts the ante 500
merrrrrd: posts the ante 500
Mr_Warlock24: posts small blind 2000
JJin91: posts big blind 4000
*** HOLE CARDS ***
Dealt to JJin91 [Ac Jh]
TrademarkTer: folds=20
merrrrrd: folds=20
Al Ricola: folds=20
ras41183: folds=20
Mr_Warlock24: calls 2000
JJin91: checks=20
*** FLOP *** [Ks 4h Jd]
Mr_Warlock24: bets 4000
JJin91: calls 4000
*** TURN *** [Ks 4h Jd] [Qd]
Mr_Warlock24: bets 6270
JJin91: calls 6270
*** RIVER *** [Ks 4h Jd Qd] [7c]
Mr_Warlock24: bets 10408
JJin91: folds=20
Uncalled bet (10408) returned to Mr_Warlock24
Mr_Warlock24 collected 31540 from pot
*** SUMMARY ***
Total pot 31540 | Rake 0=20
Board [Ks 4h Jd Qd 7c]
Seat 4: Al Ricola folded before Flop (didn't bet)
Seat 5: ras41183 (button) folded before Flop (didn't bet)
Seat 6: Mr_Warlock24 (small blind) collected (31540)
Seat 7: JJin91 (big blind) folded on the River
Seat 8: TrademarkTer folded before Flop (didn't bet)
Seat 9: merrrrrd folded before Flop (didn't bet)


*********** # 101 **************
PokerStars Hand #171705337038: Tournament #1648956862, $4.55+$0.45 USD =
Hold'em No Limit - Level XXII (2000/4000) - 2017/06/25 22:52:43 ET
Table '1648956862 2' 9-max Seat #6 is the button
Seat 4: Al Ricola (83858 in chips)=20
Seat 5: ras41183 (101151 in chips)=20
Seat 6: Mr_Warlock24 (110572 in chips)=20
Seat 7: JJin91 (68075 in chips)=20
Seat 8: TrademarkTer (122388 in chips)=20
Seat 9: merrrrrd (57703 in chips)=20
Al Ricola: posts the ante 500
ras41183: posts the ante 500
Mr_Warlock24: posts the ante 500
JJin91: posts the ante 500
TrademarkTer: posts the ante 500
merrrrrd: posts the ante 500
JJin91: posts small blind 2000
TrademarkTer: posts big blind 4000
*** HOLE CARDS ***
Dealt to JJin91 [Ah 4d]
merrrrrd: folds=20
Al Ricola: folds=20
ras41183: folds=20
Mr_Warlock24: raises 4000 to 8000
JJin91: raises 59575 to 67575 and is all-in
TrademarkTer: folds=20
Mr_Warlock24: folds=20
Uncalled bet (59575) returned to JJin91
JJin91 collected 23000 from pot
JJin91: doesn't show hand=20
*** SUMMARY ***
Total pot 23000 | Rake 0=20
Seat 4: Al Ricola folded before Flop (didn't bet)
Seat 5: ras41183 folded before Flop (didn't bet)
Seat 6: Mr_Warlock24 (button) folded before Flop
Seat 7: JJin91 (small blind) collected (23000)
Seat 8: TrademarkTer (big blind) folded before Flop
Seat 9: merrrrrd folded before Flop (didn't bet)


*********** # 102 **************
PokerStars Hand #171705337169: Tournament #1648956862, $4.55+$0.45 USD =
Hold'em No Limit - Level XXII (2000/4000) - 2017/06/25 22:53:15 ET
Table '1648956862 2' 9-max Seat #7 is the button
Seat 4: Al Ricola (83358 in chips)=20
Seat 5: ras41183 (100651 in chips)=20
Seat 6: Mr_Warlock24 (102072 in chips)=20
Seat 7: JJin91 (82575 in chips)=20
Seat 8: TrademarkTer (117888 in chips)=20
Seat 9: merrrrrd (57203 in chips)=20
Al Ricola: posts the ante 500
ras41183: posts the ante 500
Mr_Warlock24: posts the ante 500
JJin91: posts the ante 500
TrademarkTer: posts the ante 500
merrrrrd: posts the ante 500
TrademarkTer: posts small blind 2000
merrrrrd: posts big blind 4000
*** HOLE CARDS ***
Dealt to JJin91 [9s Ah]
Al Ricola: folds=20
ras41183: folds=20
Mr_Warlock24: folds=20
JJin91: raises 78075 to 82075 and is all-in
TrademarkTer: folds=20
merrrrrd: folds=20
Uncalled bet (78075) returned to JJin91
JJin91 collected 13000 from pot
JJin91: doesn't show hand=20
*** SUMMARY ***
Total pot 13000 | Rake 0=20
Seat 4: Al Ricola folded before Flop (didn't bet)
Seat 5: ras41183 folded before Flop (didn't bet)
Seat 6: Mr_Warlock24 folded before Flop (didn't bet)
Seat 7: JJin91 (button) collected (13000)
Seat 8: TrademarkTer (small blind) folded before Flop
Seat 9: merrrrrd (big blind) folded before Flop


*********** # 103 **************
PokerStars Hand #171705337329: Tournament #1648956862, $4.55+$0.45 USD =
Hold'em No Limit - Level XXII (2000/4000) - 2017/06/25 22:53:53 ET
Table '1648956862 2' 9-max Seat #8 is the button
Seat 4: Al Ricola (82858 in chips)=20
Seat 5: ras41183 (100151 in chips)=20
Seat 6: Mr_Warlock24 (101572 in chips)=20
Seat 7: JJin91 (91075 in chips)=20
Seat 8: TrademarkTer (115388 in chips)=20
Seat 9: merrrrrd (52703 in chips)=20
Al Ricola: posts the ante 500
ras41183: posts the ante 500
Mr_Warlock24: posts the ante 500
JJin91: posts the ante 500
TrademarkTer: posts the ante 500
merrrrrd: posts the ante 500
merrrrrd: posts small blind 2000
Al Ricola: posts big blind 4000
*** HOLE CARDS ***
Dealt to JJin91 [Jc 8h]
ras41183: folds=20
Mr_Warlock24: folds=20
Mr_Warlock24 is sitting out
JJin91: folds=20
TrademarkTer: folds=20
merrrrrd: raises 48203 to 52203 and is all-in
Al Ricola: folds=20
Uncalled bet (48203) returned to merrrrrd
merrrrrd collected 11000 from pot
merrrrrd: doesn't show hand=20
*** SUMMARY ***
Total pot 11000 | Rake 0=20
Seat 4: Al Ricola (big blind) folded before Flop
Seat 5: ras41183 folded before Flop (didn't bet)
Seat 6: Mr_Warlock24 folded before Flop (didn't bet)
Seat 7: JJin91 folded before Flop (didn't bet)
Seat 8: TrademarkTer (button) folded before Flop (didn't bet)
Seat 9: merrrrrd (small blind) collected (11000)


*********** # 104 **************
PokerStars Hand #171705337579: Tournament #1648956862, $4.55+$0.45 USD =
Hold'em No Limit - Level XXII (2000/4000) - 2017/06/25 22:54:52 ET
Table '1648956862 2' 9-max Seat #9 is the button
Seat 4: Al Ricola (78358 in chips)=20
Seat 5: ras41183 (99651 in chips)=20
Seat 6: Mr_Warlock24 (101072 in chips) is sitting out
Seat 7: JJin91 (90575 in chips)=20
Seat 8: TrademarkTer (114888 in chips)=20
Seat 9: merrrrrd (59203 in chips)=20
Al Ricola: posts the ante 500
ras41183: posts the ante 500
Mr_Warlock24: posts the ante 500
JJin91: posts the ante 500
TrademarkTer: posts the ante 500
merrrrrd: posts the ante 500
Al Ricola: posts small blind 2000
ras41183: posts big blind 4000
*** HOLE CARDS ***
Dealt to JJin91 [5c Qc]
Mr_Warlock24: folds=20
Mr_Warlock24 has returned
JJin91: folds=20
TrademarkTer: folds=20
merrrrrd: folds=20
Al Ricola: folds=20
Uncalled bet (2000) returned to ras41183
ras41183 collected 7000 from pot
*** SUMMARY ***
Total pot 7000 | Rake 0=20
Seat 4: Al Ricola (small blind) folded before Flop
Seat 5: ras41183 (big blind) collected (7000)
Seat 6: Mr_Warlock24 folded before Flop (didn't bet)
Seat 7: JJin91 folded before Flop (didn't bet)
Seat 8: TrademarkTer folded before Flop (didn't bet)
Seat 9: merrrrrd (button) folded before Flop (didn't bet)


*********** # 105 **************
PokerStars Hand #171705338413: Tournament #1648956862, $4.55+$0.45 USD =
Hold'em No Limit - Level XXII (2000/4000) - 2017/06/25 23:00:23 ET
Table '1648956862 2' 9-max Seat #4 is the button
Seat 4: Al Ricola (75858 in chips)=20
Seat 5: ras41183 (104151 in chips)=20
Seat 6: Mr_Warlock24 (100572 in chips)=20
Seat 7: JJin91 (90075 in chips)=20
Seat 8: TrademarkTer (114388 in chips)=20
Seat 9: merrrrrd (58703 in chips)=20
Al Ricola: posts the ante 500
ras41183: posts the ante 500
Mr_Warlock24: posts the ante 500
JJin91: posts the ante 500
TrademarkTer: posts the ante 500
merrrrrd: posts the ante 500
ras41183: posts small blind 2000
Mr_Warlock24: posts big blind 4000
*** HOLE CARDS ***
Dealt to JJin91 [3d Js]
JJin91: folds=20
TrademarkTer: raises 4000 to 8000
merrrrrd: folds=20
Al Ricola: folds=20
ras41183: folds=20
Mr_Warlock24: raises 4000 to 12000
TrademarkTer: calls 4000
*** FLOP *** [Qs Td 8s]
Mr_Warlock24: checks=20
TrademarkTer: checks=20
*** TURN *** [Qs Td 8s] [Ah]
Mr_Warlock24: checks=20
TrademarkTer: checks=20
*** RIVER *** [Qs Td 8s Ah] [9h]
Mr_Warlock24: bets 16000
TrademarkTer: folds=20
Uncalled bet (16000) returned to Mr_Warlock24
Mr_Warlock24 collected 29000 from pot
Mr_Warlock24: doesn't show hand=20
*** SUMMARY ***
Total pot 29000 | Rake 0=20
Board [Qs Td 8s Ah 9h]
Seat 4: Al Ricola (button) folded before Flop (didn't bet)
Seat 5: ras41183 (small blind) folded before Flop
Seat 6: Mr_Warlock24 (big blind) collected (29000)
Seat 7: JJin91 folded before Flop (didn't bet)
Seat 8: TrademarkTer folded on the River
Seat 9: merrrrrd folded before Flop (didn't bet)


*********** # 106 **************
PokerStars Hand #171705338847: Tournament #1648956862, $4.55+$0.45 USD =
Hold'em No Limit - Level XXIII (2500/5000) - 2017/06/25 23:02:32 ET
Table '1648956862 2' 9-max Seat #5 is the button
Seat 4: Al Ricola (75358 in chips)=20
Seat 5: ras41183 (101651 in chips)=20
Seat 6: Mr_Warlock24 (117072 in chips)=20
Seat 7: JJin91 (89575 in chips)=20
Seat 8: TrademarkTer (101888 in chips)=20
Seat 9: merrrrrd (58203 in chips)=20
Al Ricola: posts the ante 625
ras41183: posts the ante 625
Mr_Warlock24: posts the ante 625
JJin91: posts the ante 625
TrademarkTer: posts the ante 625
merrrrrd: posts the ante 625
Mr_Warlock24: posts small blind 2500
JJin91: posts big blind 5000
*** HOLE CARDS ***
Dealt to JJin91 [Qh Tc]
TrademarkTer: calls 5000
merrrrrd: folds=20
Al Ricola: calls 5000
ras41183: folds=20
Mr_Warlock24: raises 35000 to 40000
JJin91: folds=20
TrademarkTer: folds=20
Al Ricola: folds=20
Uncalled bet (35000) returned to Mr_Warlock24
Mr_Warlock24 collected 23750 from pot
Mr_Warlock24: doesn't show hand=20
*** SUMMARY ***
Total pot 23750 | Rake 0=20
Seat 4: Al Ricola folded before Flop
Seat 5: ras41183 (button) folded before Flop (didn't bet)
Seat 6: Mr_Warlock24 (small blind) collected (23750)
Seat 7: JJin91 (big blind) folded before Flop
Seat 8: TrademarkTer folded before Flop
Seat 9: merrrrrd folded before Flop (didn't bet)


*********** # 107 **************
PokerStars Hand #171705339060: Tournament #1648956862, $4.55+$0.45 USD =
Hold'em No Limit - Level XXIII (2500/5000) - 2017/06/25 23:03:33 ET
Table '1648956862 2' 9-max Seat #6 is the button
Seat 4: Al Ricola (69733 in chips)=20
Seat 5: ras41183 (101026 in chips)=20
Seat 6: Mr_Warlock24 (135197 in chips)=20
Seat 7: JJin91 (83950 in chips)=20
Seat 8: TrademarkTer (96263 in chips)=20
Seat 9: merrrrrd (57578 in chips)=20
Al Ricola: posts the ante 625
ras41183: posts the ante 625
Mr_Warlock24: posts the ante 625
JJin91: posts the ante 625
TrademarkTer: posts the ante 625
merrrrrd: posts the ante 625
JJin91: posts small blind 2500
TrademarkTer: posts big blind 5000
*** HOLE CARDS ***
Dealt to JJin91 [6h 8h]
merrrrrd: raises 51953 to 56953 and is all-in
Al Ricola: folds=20
ras41183: folds=20
Mr_Warlock24: folds=20
JJin91: folds=20
TrademarkTer: folds=20
Uncalled bet (51953) returned to merrrrrd
merrrrrd collected 16250 from pot
merrrrrd: doesn't show hand=20
*** SUMMARY ***
Total pot 16250 | Rake 0=20
Seat 4: Al Ricola folded before Flop (didn't bet)
Seat 5: ras41183 folded before Flop (didn't bet)
Seat 6: Mr_Warlock24 (button) folded before Flop (didn't bet)
Seat 7: JJin91 (small blind) folded before Flop
Seat 8: TrademarkTer (big blind) folded before Flop
Seat 9: merrrrrd collected (16250)


*********** # 108 **************
PokerStars Hand #171705339224: Tournament #1648956862, $4.55+$0.45 USD =
Hold'em No Limit - Level XXIII (2500/5000) - 2017/06/25 23:04:15 ET
Table '1648956862 2' 9-max Seat #7 is the button
Seat 1: nick.f96 (6805 in chips)=20
Seat 2: MarkySharky3 (79290 in chips)=20
Seat 3: Cnote27red06 (58044 in chips)=20
Seat 4: Al Ricola (69108 in chips)=20
Seat 5: ras41183 (100401 in chips)=20
Seat 6: Mr_Warlock24 (134572 in chips)=20
Seat 7: JJin91 (80825 in chips)=20
Seat 8: TrademarkTer (90638 in chips)=20
Seat 9: merrrrrd (68203 in chips)=20
nick.f96: posts the ante 625
MarkySharky3: posts the ante 625
Cnote27red06: posts the ante 625
Al Ricola: posts the ante 625
ras41183: posts the ante 625
Mr_Warlock24: posts the ante 625
JJin91: posts the ante 625
TrademarkTer: posts the ante 625
merrrrrd: posts the ante 625
TrademarkTer: posts small blind 2500
merrrrrd: posts big blind 5000
*** HOLE CARDS ***
Dealt to JJin91 [3c 7s]
nick.f96: folds=20
MarkySharky3: folds=20
Cnote27red06: folds=20
Al Ricola: folds=20
ras41183: calls 5000
Mr_Warlock24: folds=20
JJin91: folds=20
TrademarkTer: folds=20
merrrrrd: checks=20
*** FLOP *** [4c As 9s]
merrrrrd: checks=20
ras41183: bets 5000
merrrrrd: folds=20
Uncalled bet (5000) returned to ras41183
ras41183 collected 18125 from pot
*** SUMMARY ***
Total pot 18125 | Rake 0=20
Board [4c As 9s]
Seat 1: nick.f96 folded before Flop (didn't bet)
Seat 2: MarkySharky3 folded before Flop (didn't bet)
Seat 3: Cnote27red06 folded before Flop (didn't bet)
Seat 4: Al Ricola folded before Flop (didn't bet)
Seat 5: ras41183 collected (18125)
Seat 6: Mr_Warlock24 folded before Flop (didn't bet)
Seat 7: JJin91 (button) folded before Flop (didn't bet)
Seat 8: TrademarkTer (small blind) folded before Flop
Seat 9: merrrrrd (big blind) folded on the Flop


*********** # 109 **************
PokerStars Hand #171705339402: Tournament #1648956862, $4.55+$0.45 USD =
Hold'em No Limit - Level XXIII (2500/5000) - 2017/06/25 23:05:04 ET
Table '1648956862 2' 9-max Seat #8 is the button
Seat 1: nick.f96 (6180 in chips)=20
Seat 2: MarkySharky3 (78665 in chips)=20
Seat 3: Cnote27red06 (57419 in chips)=20
Seat 4: Al Ricola (68483 in chips)=20
Seat 5: ras41183 (112901 in chips)=20
Seat 6: Mr_Warlock24 (133947 in chips)=20
Seat 7: JJin91 (80200 in chips)=20
Seat 8: TrademarkTer (87513 in chips)=20
Seat 9: merrrrrd (62578 in chips)=20
nick.f96: posts the ante 625
MarkySharky3: posts the ante 625
Cnote27red06: posts the ante 625
Al Ricola: posts the ante 625
ras41183: posts the ante 625
Mr_Warlock24: posts the ante 625
JJin91: posts the ante 625
TrademarkTer: posts the ante 625
merrrrrd: posts the ante 625
merrrrrd: posts small blind 2500
nick.f96: posts big blind 5000
*** HOLE CARDS ***
Dealt to JJin91 [5d 5h]
MarkySharky3: folds=20
Cnote27red06: calls 5000
Al Ricola: folds=20
ras41183: folds=20
Mr_Warlock24: folds=20
JJin91: raises 74575 to 79575 and is all-in
TrademarkTer: folds=20
merrrrrd: folds=20
nick.f96: calls 555 and is all-in
Cnote27red06: folds=20
Uncalled bet (74020) returned to JJin91
*** FLOP *** [3c 2d Jd]
*** TURN *** [3c 2d Jd] [Th]
*** RIVER *** [3c 2d Jd Th] [2c]
*** SHOW DOWN ***
nick.f96: shows [Jh Kd] (two pair, Jacks and Deuces)
JJin91: shows [5d 5h] (two pair, Fives and Deuces)
nick.f96 collected 24235 from pot
*** SUMMARY ***
Total pot 24235 | Rake 0=20
Board [3c 2d Jd Th 2c]
Seat 1: nick.f96 (big blind) showed [Jh Kd] and won (24235) with two pa=
ir, Jacks and Deuces
Seat 2: MarkySharky3 folded before Flop (didn't bet)
Seat 3: Cnote27red06 folded before Flop
Seat 4: Al Ricola folded before Flop (didn't bet)
Seat 5: ras41183 folded before Flop (didn't bet)
Seat 6: Mr_Warlock24 folded before Flop (didn't bet)
Seat 7: JJin91 showed [5d 5h] and lost with two pair, Fives and Deuces
Seat 8: TrademarkTer (button) folded before Flop (didn't bet)
Seat 9: merrrrrd (small blind) folded before Flop


*********** # 110 **************
PokerStars Hand #171705339587: Tournament #1648956862, $4.55+$0.45 USD =
Hold'em No Limit - Level XXIII (2500/5000) - 2017/06/25 23:05:57 ET
Table '1648956862 2' 9-max Seat #9 is the button
Seat 1: nick.f96 (24235 in chips)=20
Seat 2: MarkySharky3 (78040 in chips)=20
Seat 3: Cnote27red06 (51794 in chips)=20
Seat 4: Al Ricola (67858 in chips)=20
Seat 5: ras41183 (112276 in chips)=20
Seat 6: Mr_Warlock24 (133322 in chips)=20
Seat 7: JJin91 (74020 in chips)=20
Seat 8: TrademarkTer (86888 in chips)=20
Seat 9: merrrrrd (59453 in chips)=20
nick.f96: posts the ante 625
MarkySharky3: posts the ante 625
Cnote27red06: posts the ante 625
Al Ricola: posts the ante 625
ras41183: posts the ante 625
Mr_Warlock24: posts the ante 625
JJin91: posts the ante 625
TrademarkTer: posts the ante 625
merrrrrd: posts the ante 625
nick.f96: posts small blind 2500
MarkySharky3: posts big blind 5000
*** HOLE CARDS ***
Dealt to JJin91 [As 2h]
Cnote27red06 said, "ha"
Cnote27red06: folds=20
Al Ricola: folds=20
ras41183: folds=20
Mr_Warlock24: folds=20
JJin91: folds=20
TrademarkTer: folds=20
merrrrrd: raises 53828 to 58828 and is all-in
nick.f96: calls 21110 and is all-in
MarkySharky3: calls 53828
*** FLOP *** [Ah Jd 4h]
*** TURN *** [Ah Jd 4h] [Jh]
*** RIVER *** [Ah Jd 4h Jh] [3c]
*** SHOW DOWN ***
MarkySharky3: shows [Jc Kh] (three of a kind, Jacks)
merrrrrd: shows [Ac 9c] (two pair, Aces and Jacks)
MarkySharky3 collected 70436 from side pot
nick.f96: shows [Qh Kd] (a pair of Jacks)
MarkySharky3 collected 76455 from main pot
merrrrrd finished the tournament in 17th place and received $11.28.
nick.f96 finished the tournament in 18th place and received $11.28.
*** SUMMARY ***
Total pot 146891 Main pot 76455. Side pot 70436. | Rake 0=20
Board [Ah Jd 4h Jh 3c]
Seat 1: nick.f96 (small blind) showed [Qh Kd] and lost with a pair of J=
acks
Seat 2: MarkySharky3 (big blind) showed [Jc Kh] and won (146891) with t=
hree of a kind, Jacks
Seat 3: Cnote27red06 folded before Flop (didn't bet)
Seat 4: Al Ricola folded before Flop (didn't bet)
Seat 5: ras41183 folded before Flop (didn't bet)
Seat 6: Mr_Warlock24 folded before Flop (didn't bet)
Seat 7: JJin91 folded before Flop (didn't bet)
Seat 8: TrademarkTer folded before Flop (didn't bet)
Seat 9: merrrrrd (button) showed [Ac 9c] and lost with two pair, Aces a=
nd Jacks


*********** # 111 **************
PokerStars Hand #171705339792: Tournament #1648956862, $4.55+$0.45 USD =
Hold'em No Limit - Level XXIV (3000/6000) - 2017/06/25 23:06:55 ET
Table '1648956862 2' 9-max Seat #2 is the button
Seat 2: MarkySharky3 (165478 in chips)=20
Seat 3: Cnote27red06 (51169 in chips)=20
Seat 4: Al Ricola (67233 in chips)=20
Seat 5: ras41183 (111651 in chips)=20
Seat 6: Mr_Warlock24 (132697 in chips)=20
Seat 7: JJin91 (73395 in chips)=20
Seat 8: TrademarkTer (86263 in chips)=20
MarkySharky3: posts the ante 750
Cnote27red06: posts the ante 750
Al Ricola: posts the ante 750
ras41183: posts the ante 750
Mr_Warlock24: posts the ante 750
JJin91: posts the ante 750
TrademarkTer: posts the ante 750
Cnote27red06: posts small blind 3000
Al Ricola: posts big blind 6000
*** HOLE CARDS ***
Dealt to JJin91 [5h 6d]
Al Ricola said, "wp"
ras41183: folds=20
merrrrrd [observer] said, "youre so bad"
Mr_Warlock24: raises 6000 to 12000
JJin91: folds=20
TrademarkTer: folds=20
MarkySharky3: folds=20
Cnote27red06: folds=20
MarkySharky3 said, "ty"
Al Ricola: folds=20
Uncalled bet (6000) returned to Mr_Warlock24
Mr_Warlock24 collected 20250 from pot
Mr_Warlock24: doesn't show hand=20
*** SUMMARY ***
Total pot 20250 | Rake 0=20
Seat 2: MarkySharky3 (button) folded before Flop (didn't bet)
Seat 3: Cnote27red06 (small blind) folded before Flop
Seat 4: Al Ricola (big blind) folded before Flop
Seat 5: ras41183 folded before Flop (didn't bet)
Seat 6: Mr_Warlock24 collected (20250)
Seat 7: JJin91 folded before Flop (didn't bet)
Seat 8: TrademarkTer folded before Flop (didn't bet)


*********** # 112 **************
PokerStars Hand #171705339901: Tournament #1648956862, $4.55+$0.45 USD =
Hold'em No Limit - Level XXIV (3000/6000) - 2017/06/25 23:07:21 ET
Table '1648956862 2' 9-max Seat #3 is the button
Seat 1: TY4thechips1 (16630 in chips)=20
Seat 2: MarkySharky3 (164728 in chips)=20
Seat 3: Cnote27red06 (47419 in chips)=20
Seat 4: Al Ricola (60483 in chips)=20
Seat 5: ras41183 (110901 in chips)=20
Seat 6: Mr_Warlock24 (146197 in chips)=20
Seat 7: JJin91 (72645 in chips)=20
Seat 8: TrademarkTer (85513 in chips)=20
TY4thechips1: posts the ante 750
MarkySharky3: posts the ante 750
Cnote27red06: posts the ante 750
Al Ricola: posts the ante 750
ras41183: posts the ante 750
Mr_Warlock24: posts the ante 750
JJin91: posts the ante 750
TrademarkTer: posts the ante 750
Al Ricola: posts small blind 3000
ras41183: posts big blind 6000
*** HOLE CARDS ***
Dealt to JJin91 [8d 5d]
TrademarkTer said, "markysharky woot woot woot marky sharky woot woot w=
oot"
Mr_Warlock24: raises 6000 to 12000
JJin91: folds=20
TrademarkTer: folds=20
TY4thechips1: folds=20
MarkySharky3: folds=20
Cnote27red06: raises 12000 to 24000
Al Ricola: folds=20
ras41183: folds=20
Mr_Warlock24: raises 102000 to 126000
Cnote27red06: calls 22669 and is all-in
Uncalled bet (79331) returned to Mr_Warlock24
*** FLOP *** [2s Ac Ts]
*** TURN *** [2s Ac Ts] [9c]
*** RIVER *** [2s Ac Ts 9c] [9d]
*** SHOW DOWN ***
Mr_Warlock24: shows [Ad Td] (two pair, Aces and Tens)
Cnote27red06: shows [Js Jd] (two pair, Jacks and Nines)
Mr_Warlock24 collected 108338 from pot
Cnote27red06 finished the tournament in 16th place and received $11.28.
*** SUMMARY ***
Total pot 108338 | Rake 0=20
Board [2s Ac Ts 9c 9d]
Seat 1: TY4thechips1 folded before Flop (didn't bet)
Seat 2: MarkySharky3 folded before Flop (didn't bet)
Seat 3: Cnote27red06 (button) showed [Js Jd] and lost with two pair, Ja=
cks and Nines
Seat 4: Al Ricola (small blind) folded before Flop
Seat 5: ras41183 (big blind) folded before Flop
Seat 6: Mr_Warlock24 showed [Ad Td] and won (108338) with two pair, Ace=
s and Tens
Seat 7: JJin91 folded before Flop (didn't bet)
Seat 8: TrademarkTer folded before Flop (didn't bet)


*********** # 113 **************
PokerStars Hand #171705339999: Tournament #1648956862, $4.55+$0.45 USD =
Hold'em No Limit - Level XXIV (3000/6000) - 2017/06/25 23:07:53 ET
Table '1648956862 2' 9-max Seat #4 is the button
Seat 1: TY4thechips1 (15880 in chips)=20
Seat 2: MarkySharky3 (163978 in chips)=20
Seat 4: Al Ricola (56733 in chips)=20
Seat 5: ras41183 (104151 in chips)=20
Seat 6: Mr_Warlock24 (207116 in chips)=20
Seat 7: JJin91 (71895 in chips)=20
Seat 8: TrademarkTer (84763 in chips)=20
TY4thechips1: posts the ante 750
MarkySharky3: posts the ante 750
Al Ricola: posts the ante 750
ras41183: posts the ante 750
Mr_Warlock24: posts the ante 750
JJin91: posts the ante 750
TrademarkTer: posts the ante 750
ras41183: posts small blind 3000
Mr_Warlock24: posts big blind 6000
*** HOLE CARDS ***
Dealt to JJin91 [3d As]
JJin91: folds=20
TrademarkTer: folds=20
TY4thechips1: folds=20
MarkySharky3: folds=20
Al Ricola: folds=20
ras41183: calls 3000
Mr_Warlock24: checks=20
*** FLOP *** [2h 4c 6h]
ras41183: checks=20
Mr_Warlock24: bets 6000
ras41183: calls 6000
*** TURN *** [2h 4c 6h] [8d]
ras41183: checks=20
Mr_Warlock24: checks=20
*** RIVER *** [2h 4c 6h 8d] [8s]
ras41183: checks=20
Mr_Warlock24: checks=20
*** SHOW DOWN ***
ras41183: shows [Kh Js] (a pair of Eights)
Mr_Warlock24: shows [Jd 4h] (two pair, Eights and Fours)
Mr_Warlock24 collected 29250 from pot
*** SUMMARY ***
Total pot 29250 | Rake 0=20
Board [2h 4c 6h 8d 8s]
Seat 1: TY4thechips1 folded before Flop (didn't bet)
Seat 2: MarkySharky3 folded before Flop (didn't bet)
Seat 4: Al Ricola (button) folded before Flop (didn't bet)
Seat 5: ras41183 (small blind) showed [Kh Js] and lost with a pair of E=
ights
Seat 6: Mr_Warlock24 (big blind) showed [Jd 4h] and won (29250) with tw=
o pair, Eights and Fours
Seat 7: JJin91 folded before Flop (didn't bet)
Seat 8: TrademarkTer folded before Flop (didn't bet)


*********** # 114 **************
PokerStars Hand #171705818707: Tournament #1648956862, $4.55+$0.45 USD =
Hold'em No Limit - Level XXIV (3000/6000) - 2017/06/25 23:08:20 ET
Table '1648956862 2' 9-max Seat #5 is the button
Seat 1: TY4thechips1 (15130 in chips)=20
Seat 2: MarkySharky3 (163228 in chips)=20
Seat 4: Al Ricola (55983 in chips)=20
Seat 5: ras41183 (91401 in chips)=20
Seat 6: Mr_Warlock24 (223616 in chips)=20
Seat 7: JJin91 (71145 in chips)=20
Seat 8: TrademarkTer (84013 in chips)=20
TY4thechips1: posts the ante 750
MarkySharky3: posts the ante 750
Al Ricola: posts the ante 750
ras41183: posts the ante 750
Mr_Warlock24: posts the ante 750
JJin91: posts the ante 750
TrademarkTer: posts the ante 750
Mr_Warlock24: posts small blind 3000
JJin91: posts big blind 6000
*** HOLE CARDS ***
Dealt to JJin91 [3c Qd]
TrademarkTer: folds=20
TY4thechips1: folds=20
MarkySharky3: raises 6600 to 12600
Al Ricola: folds=20
ras41183: raises 78051 to 90651 and is all-in
Mr_Warlock24: folds=20
JJin91: folds=20
MarkySharky3: folds=20
Uncalled bet (78051) returned to ras41183
ras41183 collected 39450 from pot
*** SUMMARY ***
Total pot 39450 | Rake 0=20
Seat 1: TY4thechips1 folded before Flop (didn't bet)
Seat 2: MarkySharky3 folded before Flop
Seat 4: Al Ricola folded before Flop (didn't bet)
Seat 5: ras41183 (button) collected (39450)
Seat 6: Mr_Warlock24 (small blind) folded before Flop
Seat 7: JJin91 (big blind) folded before Flop
Seat 8: TrademarkTer folded before Flop (didn't bet)


*********** # 115 **************
PokerStars Hand #171705818805: Tournament #1648956862, $4.55+$0.45 USD =
Hold'em No Limit - Level XXIV (3000/6000) - 2017/06/25 23:08:48 ET
Table '1648956862 2' 9-max Seat #6 is the button
Seat 1: TY4thechips1 (14380 in chips)=20
Seat 2: MarkySharky3 (149878 in chips)=20
Seat 4: Al Ricola (55233 in chips)=20
Seat 5: ras41183 (117501 in chips)=20
Seat 6: Mr_Warlock24 (219866 in chips)=20
Seat 7: JJin91 (64395 in chips)=20
Seat 8: TrademarkTer (83263 in chips)=20
TY4thechips1: posts the ante 750
MarkySharky3: posts the ante 750
Al Ricola: posts the ante 750
ras41183: posts the ante 750
Mr_Warlock24: posts the ante 750
JJin91: posts the ante 750
TrademarkTer: posts the ante 750
JJin91: posts small blind 3000
TrademarkTer: posts big blind 6000
*** HOLE CARDS ***
Dealt to JJin91 [7c 2c]
TY4thechips1: folds=20
MarkySharky3: folds=20
Al Ricola: raises 48483 to 54483 and is all-in
ras41183: folds=20
Mr_Warlock24: folds=20
JJin91: folds=20
TrademarkTer: folds=20
Uncalled bet (48483) returned to Al Ricola
Al Ricola collected 20250 from pot
*** SUMMARY ***
Total pot 20250 | Rake 0=20
Seat 1: TY4thechips1 folded before Flop (didn't bet)
Seat 2: MarkySharky3 folded before Flop (didn't bet)
Seat 4: Al Ricola collected (20250)
Seat 5: ras41183 folded before Flop (didn't bet)
Seat 6: Mr_Warlock24 (button) folded before Flop (didn't bet)
Seat 7: JJin91 (small blind) folded before Flop
Seat 8: TrademarkTer (big blind) folded before Flop


*********** # 116 **************
PokerStars Hand #171705818943: Tournament #1648956862, $4.55+$0.45 USD =
Hold'em No Limit - Level XXIV (3000/6000) - 2017/06/25 23:09:26 ET
Table '1648956862 2' 9-max Seat #7 is the button
Seat 1: TY4thechips1 (13630 in chips)=20
Seat 2: MarkySharky3 (149128 in chips)=20
Seat 4: Al Ricola (68733 in chips)=20
Seat 5: ras41183 (116751 in chips)=20
Seat 6: Mr_Warlock24 (219116 in chips)=20
Seat 7: JJin91 (60645 in chips)=20
Seat 8: TrademarkTer (76513 in chips)=20
TY4thechips1: posts the ante 750
MarkySharky3: posts the ante 750
Al Ricola: posts the ante 750
ras41183: posts the ante 750
Mr_Warlock24: posts the ante 750
JJin91: posts the ante 750
TrademarkTer: posts the ante 750
TrademarkTer: posts small blind 3000
TY4thechips1: posts big blind 6000
*** HOLE CARDS ***
Dealt to JJin91 [7d 5d]
MarkySharky3: raises 6600 to 12600
Al Ricola: raises 55383 to 67983 and is all-in
ras41183: folds=20
Mr_Warlock24: folds=20
JJin91: folds=20
TrademarkTer: folds=20
TY4thechips1: calls 6880 and is all-in
MarkySharky3: folds=20
Uncalled bet (55103) returned to Al Ricola
*** FLOP *** [8c Ac 5s]
*** TURN *** [8c Ac 5s] [Kd]
*** RIVER *** [8c Ac 5s Kd] [6s]
*** SHOW DOWN ***
TY4thechips1: shows [2s 2h] (a pair of Deuces)
Al Ricola: shows [As 7h] (a pair of Aces)
Al Ricola collected 46610 from pot
TY4thechips1 finished the tournament in 14th place and received $11.83.
*** SUMMARY ***
Total pot 46610 | Rake 0=20
Board [8c Ac 5s Kd 6s]
Seat 1: TY4thechips1 (big blind) showed [2s 2h] and lost with a pair of=
 Deuces
Seat 2: MarkySharky3 folded before Flop
Seat 4: Al Ricola showed [As 7h] and won (46610) with a pair of Aces
Seat 5: ras41183 folded before Flop (didn't bet)
Seat 6: Mr_Warlock24 folded before Flop (didn't bet)
Seat 7: JJin91 (button) folded before Flop (didn't bet)
Seat 8: TrademarkTer (small blind) folded before Flop


*********** # 117 **************
PokerStars Hand #171705819099: Tournament #1648956862, $4.55+$0.45 USD =
Hold'em No Limit - Level XXIV (3000/6000) - 2017/06/25 23:10:09 ET
Table '1648956862 2' 9-max Seat #8 is the button
Seat 2: MarkySharky3 (135778 in chips)=20
Seat 4: Al Ricola (101713 in chips)=20
Seat 5: ras41183 (116001 in chips)=20
Seat 6: Mr_Warlock24 (218366 in chips)=20
Seat 7: JJin91 (59895 in chips)=20
Seat 8: TrademarkTer (72763 in chips)=20
MarkySharky3: posts the ante 750
Al Ricola: posts the ante 750
ras41183: posts the ante 750
Mr_Warlock24: posts the ante 750
JJin91: posts the ante 750
TrademarkTer: posts the ante 750
MarkySharky3: posts small blind 3000
Al Ricola: posts big blind 6000
*** HOLE CARDS ***
Dealt to JJin91 [3c 7d]
ras41183: raises 24000 to 30000
Mr_Warlock24: folds=20
JJin91: folds=20
TrademarkTer: folds=20
MarkySharky3: folds=20
Al Ricola: folds=20
Uncalled bet (24000) returned to ras41183
ras41183 collected 19500 from pot
*** SUMMARY ***
Total pot 19500 | Rake 0=20
Seat 2: MarkySharky3 (small blind) folded before Flop
Seat 4: Al Ricola (big blind) folded before Flop
Seat 5: ras41183 collected (19500)
Seat 6: Mr_Warlock24 folded before Flop (didn't bet)
Seat 7: JJin91 folded before Flop (didn't bet)
Seat 8: TrademarkTer (button) folded before Flop (didn't bet)


*********** # 118 **************
PokerStars Hand #171705819283: Tournament #1648956862, $4.55+$0.45 USD =
Hold'em No Limit - Level XXIV (3000/6000) - 2017/06/25 23:11:04 ET
Table '1648956862 2' 9-max Seat #2 is the button
Seat 2: MarkySharky3 (132028 in chips)=20
Seat 4: Al Ricola (94963 in chips)=20
Seat 5: ras41183 (128751 in chips)=20
Seat 6: Mr_Warlock24 (217616 in chips)=20
Seat 7: JJin91 (59145 in chips)=20
Seat 8: TrademarkTer (72013 in chips)=20
MarkySharky3: posts the ante 750
Al Ricola: posts the ante 750
ras41183: posts the ante 750
Mr_Warlock24: posts the ante 750
JJin91: posts the ante 750
TrademarkTer: posts the ante 750
Al Ricola: posts small blind 3000
ras41183: posts big blind 6000
*** HOLE CARDS ***
Dealt to JJin91 [7s 2d]
Mr_Warlock24: folds=20
JJin91: folds=20
TrademarkTer: folds=20
MarkySharky3: folds=20
Al Ricola: folds=20
Uncalled bet (3000) returned to ras41183
ras41183 collected 10500 from pot
*** SUMMARY ***
Total pot 10500 | Rake 0=20
Seat 2: MarkySharky3 (button) folded before Flop (didn't bet)
Seat 4: Al Ricola (small blind) folded before Flop
Seat 5: ras41183 (big blind) collected (10500)
Seat 6: Mr_Warlock24 folded before Flop (didn't bet)
Seat 7: JJin91 folded before Flop (didn't bet)
Seat 8: TrademarkTer folded before Flop (didn't bet)


*********** # 119 **************
PokerStars Hand #171705819358: Tournament #1648956862, $4.55+$0.45 USD =
Hold'em No Limit - Level XXV (3500/7000) - 2017/06/25 23:11:24 ET
Table '1648956862 2' 9-max Seat #4 is the button
Seat 2: MarkySharky3 (131278 in chips)=20
Seat 4: Al Ricola (91213 in chips)=20
Seat 5: ras41183 (135501 in chips)=20
Seat 6: Mr_Warlock24 (216866 in chips)=20
Seat 7: JJin91 (58395 in chips)=20
Seat 8: TrademarkTer (71263 in chips)=20
MarkySharky3: posts the ante 875
Al Ricola: posts the ante 875
ras41183: posts the ante 875
Mr_Warlock24: posts the ante 875
JJin91: posts the ante 875
TrademarkTer: posts the ante 875
ras41183: posts small blind 3500
Mr_Warlock24: posts big blind 7000
*** HOLE CARDS ***
Dealt to JJin91 [Ad 4h]
JJin91: raises 50520 to 57520 and is all-in
TrademarkTer: raises 12868 to 70388 and is all-in
MarkySharky3: folds=20
Al Ricola: folds=20
ras41183: folds=20
Mr_Warlock24: folds=20
Uncalled bet (12868) returned to TrademarkTer
*** FLOP *** [5s 8d 3c]
*** TURN *** [5s 8d 3c] [4d]
*** RIVER *** [5s 8d 3c 4d] [Jc]
*** SHOW DOWN ***
JJin91: shows [Ad 4h] (a pair of Fours)
TrademarkTer: shows [8s 8c] (three of a kind, Eights)
TrademarkTer collected 130790 from pot
JJin91 finished the tournament in 13th place and received $11.83.
*** SUMMARY ***
Total pot 130790 | Rake 0=20
Board [5s 8d 3c 4d Jc]
Seat 2: MarkySharky3 folded before Flop (didn't bet)
Seat 4: Al Ricola (button) folded before Flop (didn't bet)
Seat 5: ras41183 (small blind) folded before Flop
Seat 6: Mr_Warlock24 (big blind) folded before Flop
Seat 7: JJin91 showed [Ad 4h] and lost with a pair of Fours
Seat 8: TrademarkTer showed [8s 8c] and won (130790) with three of a ki=
nd, Eights



If you have any questions, please contact us at "PokerStars Support" <s=
upport@pokerstarsnj.com>


