Transcript for tournament #1648956629 requested by JJin91 (jamiejin91@g=
mail.com)

*********** # 1 **************
PokerStars Hand #171478925243: Tournament #1648956629, $18.20+$1.80 USD=
 Hold'em No Limit - Level III (40/80) - 2017/06/20 19:25:47 ET
Table '1648956629 3' 9-max Seat #7 is the button
Seat 1: vincent329 (8620 in chips)=20
Seat 2: SneakyPete85 (11508 in chips)=20
Seat 3: JJin91 (10000 in chips)=20
Seat 4: MoeHawk101 (32504 in chips)=20
Seat 5: BCinNY (9449 in chips)=20
Seat 6: TGfor3 (10000 in chips)=20
Seat 7: failboat1231 (9880 in chips)=20
Seat 8: Decklyn71 (9980 in chips)=20
Seat 9: T1111111111M (8739 in chips)=20
Decklyn71: posts small blind 40
T1111111111M: posts big blind 80
*** HOLE CARDS ***
Dealt to JJin91 [2h 5c]
vincent329: raises 80 to 160
SneakyPete85: folds=20
JJin91: folds=20
MoeHawk101: folds=20
BCinNY: folds=20
TGfor3: folds=20
failboat1231: raises 240 to 400
Decklyn71: folds=20
T1111111111M: folds=20
vincent329: calls 240
*** FLOP *** [6s 3h Tc]
vincent329: checks=20
failboat1231: bets 500
vincent329: calls 500
*** TURN *** [6s 3h Tc] [7h]
vincent329: checks=20
failboat1231: checks=20
*** RIVER *** [6s 3h Tc 7h] [2d]
vincent329: bets 1120
failboat1231: calls 1120
*** SHOW DOWN ***
vincent329: shows [Kh Qs] (high card King)
failboat1231: shows [8d 8c] (a pair of Eights)
failboat1231 collected 4160 from pot
*** SUMMARY ***
Total pot 4160 | Rake 0=20
Board [6s 3h Tc 7h 2d]
Seat 1: vincent329 showed [Kh Qs] and lost with high card King
Seat 2: SneakyPete85 folded before Flop (didn't bet)
Seat 3: JJin91 folded before Flop (didn't bet)
Seat 4: MoeHawk101 folded before Flop (didn't bet)
Seat 5: BCinNY folded before Flop (didn't bet)
Seat 6: TGfor3 folded before Flop (didn't bet)
Seat 7: failboat1231 (button) showed [8d 8c] and won (4160) with a pair=
 of Eights
Seat 8: Decklyn71 (small blind) folded before Flop
Seat 9: T1111111111M (big blind) folded before Flop


*********** # 2 **************
PokerStars Hand #171478925431: Tournament #1648956629, $18.20+$1.80 USD=
 Hold'em No Limit - Level III (40/80) - 2017/06/20 19:26:40 ET
Table '1648956629 3' 9-max Seat #8 is the button
Seat 1: vincent329 (6600 in chips)=20
Seat 2: SneakyPete85 (11508 in chips)=20
Seat 3: JJin91 (10000 in chips)=20
Seat 4: MoeHawk101 (32504 in chips)=20
Seat 5: BCinNY (9449 in chips)=20
Seat 6: TGfor3 (10000 in chips)=20
Seat 7: failboat1231 (12020 in chips)=20
Seat 8: Decklyn71 (9940 in chips)=20
Seat 9: T1111111111M (8659 in chips)=20
T1111111111M: posts small blind 40
vincent329: posts big blind 80
*** HOLE CARDS ***
Dealt to JJin91 [4c 3c]
SneakyPete85: raises 160 to 240
JJin91: folds=20
MoeHawk101: folds=20
BCinNY: folds=20
TGfor3: folds=20
failboat1231: folds=20
Decklyn71: calls 240
T1111111111M: folds=20
vincent329: calls 160
*** FLOP *** [Qs 4d 9h]
vincent329: checks=20
SneakyPete85: bets 380
Decklyn71: folds=20
vincent329: folds=20
Uncalled bet (380) returned to SneakyPete85
SneakyPete85 collected 760 from pot
SneakyPete85: doesn't show hand=20
*** SUMMARY ***
Total pot 760 | Rake 0=20
Board [Qs 4d 9h]
Seat 1: vincent329 (big blind) folded on the Flop
Seat 2: SneakyPete85 collected (760)
Seat 3: JJin91 folded before Flop (didn't bet)
Seat 4: MoeHawk101 folded before Flop (didn't bet)
Seat 5: BCinNY folded before Flop (didn't bet)
Seat 6: TGfor3 folded before Flop (didn't bet)
Seat 7: failboat1231 folded before Flop (didn't bet)
Seat 8: Decklyn71 (button) folded on the Flop
Seat 9: T1111111111M (small blind) folded before Flop


*********** # 3 **************
PokerStars Hand #171478925554: Tournament #1648956629, $18.20+$1.80 USD=
 Hold'em No Limit - Level III (40/80) - 2017/06/20 19:27:18 ET
Table '1648956629 3' 9-max Seat #9 is the button
Seat 1: vincent329 (6360 in chips)=20
Seat 2: SneakyPete85 (12028 in chips)=20
Seat 3: JJin91 (10000 in chips)=20
Seat 4: MoeHawk101 (32504 in chips)=20
Seat 5: BCinNY (9449 in chips)=20
Seat 6: TGfor3 (10000 in chips)=20
Seat 7: failboat1231 (12020 in chips)=20
Seat 8: Decklyn71 (9700 in chips)=20
Seat 9: T1111111111M (8619 in chips)=20
vincent329: posts small blind 40
SneakyPete85: posts big blind 80
*** HOLE CARDS ***
Dealt to JJin91 [4s 9h]
JJin91: folds=20
MoeHawk101: calls 80
BCinNY: folds=20
TGfor3: folds=20
failboat1231: folds=20
Decklyn71: folds=20
T1111111111M: folds=20
vincent329: calls 40
SneakyPete85: checks=20
*** FLOP *** [As 6c 6d]
vincent329: bets 240
SneakyPete85: folds=20
MoeHawk101: folds=20
Uncalled bet (240) returned to vincent329
vincent329 collected 240 from pot
*** SUMMARY ***
Total pot 240 | Rake 0=20
Board [As 6c 6d]
Seat 1: vincent329 (small blind) collected (240)
Seat 2: SneakyPete85 (big blind) folded on the Flop
Seat 3: JJin91 folded before Flop (didn't bet)
Seat 4: MoeHawk101 folded on the Flop
Seat 5: BCinNY folded before Flop (didn't bet)
Seat 6: TGfor3 folded before Flop (didn't bet)
Seat 7: failboat1231 folded before Flop (didn't bet)
Seat 8: Decklyn71 folded before Flop (didn't bet)
Seat 9: T1111111111M (button) folded before Flop (didn't bet)


*********** # 4 **************
PokerStars Hand #171478925671: Tournament #1648956629, $18.20+$1.80 USD=
 Hold'em No Limit - Level III (40/80) - 2017/06/20 19:27:50 ET
Table '1648956629 3' 9-max Seat #1 is the button
Seat 1: vincent329 (6520 in chips)=20
Seat 2: SneakyPete85 (11948 in chips)=20
Seat 3: JJin91 (10000 in chips)=20
Seat 4: MoeHawk101 (32424 in chips)=20
Seat 5: BCinNY (9449 in chips)=20
Seat 6: TGfor3 (10000 in chips)=20
Seat 7: failboat1231 (12020 in chips)=20
Seat 8: Decklyn71 (9700 in chips)=20
Seat 9: T1111111111M (8619 in chips)=20
SneakyPete85: posts small blind 40
JJin91: posts big blind 80
*** HOLE CARDS ***
Dealt to JJin91 [Kc 2h]
MoeHawk101: folds=20
BCinNY: folds=20
TGfor3: folds=20
failboat1231: folds=20
Decklyn71: folds=20
T1111111111M: folds=20
vincent329: folds=20
SneakyPete85: folds=20
Uncalled bet (40) returned to JJin91
JJin91 collected 80 from pot
JJin91: doesn't show hand=20
*** SUMMARY ***
Total pot 80 | Rake 0=20
Seat 1: vincent329 (button) folded before Flop (didn't bet)
Seat 2: SneakyPete85 (small blind) folded before Flop
Seat 3: JJin91 (big blind) collected (80)
Seat 4: MoeHawk101 folded before Flop (didn't bet)
Seat 5: BCinNY folded before Flop (didn't bet)
Seat 6: TGfor3 folded before Flop (didn't bet)
Seat 7: failboat1231 folded before Flop (didn't bet)
Seat 8: Decklyn71 folded before Flop (didn't bet)
Seat 9: T1111111111M folded before Flop (didn't bet)


*********** # 5 **************
PokerStars Hand #171478925762: Tournament #1648956629, $18.20+$1.80 USD=
 Hold'em No Limit - Level III (40/80) - 2017/06/20 19:28:15 ET
Table '1648956629 3' 9-max Seat #2 is the button
Seat 1: vincent329 (6520 in chips)=20
Seat 2: SneakyPete85 (11908 in chips)=20
Seat 3: JJin91 (10040 in chips)=20
Seat 4: MoeHawk101 (32424 in chips)=20
Seat 5: BCinNY (9449 in chips)=20
Seat 6: TGfor3 (10000 in chips)=20
Seat 7: failboat1231 (12020 in chips)=20
Seat 8: Decklyn71 (9700 in chips)=20
Seat 9: T1111111111M (8619 in chips)=20
JJin91: posts small blind 40
MoeHawk101: posts big blind 80
*** HOLE CARDS ***
Dealt to JJin91 [4c 2s]
BCinNY: folds=20
TGfor3: folds=20
failboat1231: folds=20
Decklyn71: folds=20
T1111111111M: raises 160 to 240
vincent329: calls 240
SneakyPete85: folds=20
JJin91: folds=20
MoeHawk101: calls 160
*** FLOP *** [Ac 5d 2d]
MoeHawk101: checks=20
T1111111111M: checks=20
vincent329: bets 380
MoeHawk101: calls 380
T1111111111M: folds=20
*** TURN *** [Ac 5d 2d] [3c]
MoeHawk101: checks=20
vincent329: checks=20
*** RIVER *** [Ac 5d 2d 3c] [4h]
MoeHawk101: bets 2800
vincent329: calls 2800
*** SHOW DOWN ***
MoeHawk101: shows [6h 6d] (a straight, Deuce to Six)
vincent329: mucks hand=20
MoeHawk101 collected 7120 from pot
*** SUMMARY ***
Total pot 7120 | Rake 0=20
Board [Ac 5d 2d 3c 4h]
Seat 1: vincent329 mucked [7h Qd]
Seat 2: SneakyPete85 (button) folded before Flop (didn't bet)
Seat 3: JJin91 (small blind) folded before Flop
Seat 4: MoeHawk101 (big blind) showed [6h 6d] and won (7120) with a str=
aight, Deuce to Six
Seat 5: BCinNY folded before Flop (didn't bet)
Seat 6: TGfor3 folded before Flop (didn't bet)
Seat 7: failboat1231 folded before Flop (didn't bet)
Seat 8: Decklyn71 folded before Flop (didn't bet)
Seat 9: T1111111111M folded on the Flop


*********** # 6 **************
PokerStars Hand #171478925935: Tournament #1648956629, $18.20+$1.80 USD=
 Hold'em No Limit - Level III (40/80) - 2017/06/20 19:29:08 ET
Table '1648956629 3' 9-max Seat #3 is the button
Seat 1: vincent329 (3100 in chips)=20
Seat 2: SneakyPete85 (11908 in chips)=20
Seat 3: JJin91 (10000 in chips)=20
Seat 4: MoeHawk101 (36124 in chips)=20
Seat 5: BCinNY (9449 in chips)=20
Seat 6: TGfor3 (10000 in chips)=20
Seat 7: failboat1231 (12020 in chips)=20
Seat 8: Decklyn71 (9700 in chips)=20
Seat 9: T1111111111M (8379 in chips)=20
MoeHawk101: posts small blind 40
BCinNY: posts big blind 80
*** HOLE CARDS ***
Dealt to JJin91 [6c Ad]
TGfor3: folds=20
failboat1231: folds=20
Decklyn71: folds=20
T1111111111M: folds=20
vincent329: raises 80 to 160
SneakyPete85: folds=20
JJin91: calls 160
MoeHawk101: folds=20
BCinNY: folds=20
*** FLOP *** [Jc Qd Th]
vincent329: bets 220
JJin91: folds=20
Uncalled bet (220) returned to vincent329
vincent329 collected 440 from pot
*** SUMMARY ***
Total pot 440 | Rake 0=20
Board [Jc Qd Th]
Seat 1: vincent329 collected (440)
Seat 2: SneakyPete85 folded before Flop (didn't bet)
Seat 3: JJin91 (button) folded on the Flop
Seat 4: MoeHawk101 (small blind) folded before Flop
Seat 5: BCinNY (big blind) folded before Flop
Seat 6: TGfor3 folded before Flop (didn't bet)
Seat 7: failboat1231 folded before Flop (didn't bet)
Seat 8: Decklyn71 folded before Flop (didn't bet)
Seat 9: T1111111111M folded before Flop (didn't bet)


*********** # 7 **************
PokerStars Hand #171478926109: Tournament #1648956629, $18.20+$1.80 USD=
 Hold'em No Limit - Level III (40/80) - 2017/06/20 19:29:56 ET
Table '1648956629 3' 9-max Seat #4 is the button
Seat 1: vincent329 (3380 in chips)=20
Seat 2: SneakyPete85 (11908 in chips)=20
Seat 3: JJin91 (9840 in chips)=20
Seat 4: MoeHawk101 (36084 in chips)=20
Seat 5: BCinNY (9369 in chips)=20
Seat 6: TGfor3 (10000 in chips)=20
Seat 7: failboat1231 (12020 in chips)=20
Seat 8: Decklyn71 (9700 in chips)=20
Seat 9: T1111111111M (8379 in chips)=20
BCinNY: posts small blind 40
TGfor3: posts big blind 80
*** HOLE CARDS ***
Dealt to JJin91 [9s 7s]
failboat1231: folds=20
Decklyn71: folds=20
T1111111111M: raises 160 to 240
vincent329: folds=20
SneakyPete85: folds=20
JJin91: folds=20
MoeHawk101: folds=20
BCinNY: folds=20
TGfor3: folds=20
Uncalled bet (160) returned to T1111111111M
T1111111111M collected 200 from pot
T1111111111M: doesn't show hand=20
*** SUMMARY ***
Total pot 200 | Rake 0=20
Seat 1: vincent329 folded before Flop (didn't bet)
Seat 2: SneakyPete85 folded before Flop (didn't bet)
Seat 3: JJin91 folded before Flop (didn't bet)
Seat 4: MoeHawk101 (button) folded before Flop (didn't bet)
Seat 5: BCinNY (small blind) folded before Flop
Seat 6: TGfor3 (big blind) folded before Flop
Seat 7: failboat1231 folded before Flop (didn't bet)
Seat 8: Decklyn71 folded before Flop (didn't bet)
Seat 9: T1111111111M collected (200)


*********** # 8 **************
PokerStars Hand #171478926242: Tournament #1648956629, $18.20+$1.80 USD=
 Hold'em No Limit - Level IV (50/100) - 2017/06/20 19:30:30 ET
Table '1648956629 3' 9-max Seat #5 is the button
Seat 1: vincent329 (3380 in chips)=20
Seat 2: SneakyPete85 (11908 in chips)=20
Seat 3: JJin91 (9840 in chips)=20
Seat 4: MoeHawk101 (36084 in chips)=20
Seat 5: BCinNY (9329 in chips)=20
Seat 6: TGfor3 (9920 in chips)=20
Seat 7: failboat1231 (12020 in chips)=20
Seat 8: Decklyn71 (9700 in chips)=20
Seat 9: T1111111111M (8499 in chips)=20
vincent329: posts the ante 10
SneakyPete85: posts the ante 10
JJin91: posts the ante 10
MoeHawk101: posts the ante 10
BCinNY: posts the ante 10
TGfor3: posts the ante 10
failboat1231: posts the ante 10
Decklyn71: posts the ante 10
T1111111111M: posts the ante 10
TGfor3: posts small blind 50
failboat1231: posts big blind 100
*** HOLE CARDS ***
Dealt to JJin91 [Ks 9h]
Decklyn71: folds=20
T1111111111M: folds=20
vincent329: raises 100 to 200
SneakyPete85: folds=20
JJin91: folds=20
MoeHawk101: folds=20
BCinNY: folds=20
TGfor3: folds=20
failboat1231: folds=20
Uncalled bet (100) returned to vincent329
vincent329 collected 340 from pot
*** SUMMARY ***
Total pot 340 | Rake 0=20
Seat 1: vincent329 collected (340)
Seat 2: SneakyPete85 folded before Flop (didn't bet)
Seat 3: JJin91 folded before Flop (didn't bet)
Seat 4: MoeHawk101 folded before Flop (didn't bet)
Seat 5: BCinNY (button) folded before Flop (didn't bet)
Seat 6: TGfor3 (small blind) folded before Flop
Seat 7: failboat1231 (big blind) folded before Flop
Seat 8: Decklyn71 folded before Flop (didn't bet)
Seat 9: T1111111111M folded before Flop (didn't bet)


*********** # 9 **************
PokerStars Hand #171478926409: Tournament #1648956629, $18.20+$1.80 USD=
 Hold'em No Limit - Level IV (50/100) - 2017/06/20 19:31:16 ET
Table '1648956629 2' 9-max Seat #5 is the button
Seat 1: MM9955 (17393 in chips)=20
Seat 2: BinkEquity (9660 in chips)=20
Seat 3: JJin91 (9830 in chips)=20
Seat 4: hannahw5187 (12355 in chips)=20
Seat 5: Going2Ship (12161 in chips)=20
Seat 6: Deuxexmachen (10285 in chips)=20
Seat 8: justcuz77 (19076 in chips)=20
Seat 9: fatulence (7780 in chips)=20
MM9955: posts the ante 10
BinkEquity: posts the ante 10
JJin91: posts the ante 10
hannahw5187: posts the ante 10
Going2Ship: posts the ante 10
Deuxexmachen: posts the ante 10
justcuz77: posts the ante 10
fatulence: posts the ante 10
Deuxexmachen: posts small blind 50
justcuz77: posts big blind 100
*** HOLE CARDS ***
Dealt to JJin91 [8s 6s]
fatulence: folds=20
MM9955: calls 100
BinkEquity: folds=20
JJin91: folds=20
hannahw5187: raises 430 to 530
Going2Ship: calls 530
Deuxexmachen: folds=20
justcuz77: calls 430
MM9955: calls 430
*** FLOP *** [Jc Kh Qc]
justcuz77: bets 1600
MM9955: folds=20
hannahw5187: calls 1600
Going2Ship: raises 1700 to 3300
justcuz77: raises 15236 to 18536 and is all-in
hannahw5187: calls 10215 and is all-in
Going2Ship: calls 8321 and is all-in
Uncalled bet (6721) returned to justcuz77
*** TURN *** [Jc Kh Qc] [6d]
*** RIVER *** [Jc Kh Qc 6d] [3c]
*** SHOW DOWN ***
justcuz77: shows [9c Th] (a straight, Nine to King)
hannahw5187: shows [Ks As] (a pair of Kings)
justcuz77 collected 388 from side pot
Going2Ship: shows [Td Ad] (a straight, Ten to Ace)
Going2Ship collected 37113 from main pot
hannahw5187 finished the tournament in 91st place
*** SUMMARY ***
Total pot 37501 Main pot 37113. Side pot 388. | Rake 0=20
Board [Jc Kh Qc 6d 3c]
Seat 1: MM9955 folded on the Flop
Seat 2: BinkEquity folded before Flop (didn't bet)
Seat 3: JJin91 folded before Flop (didn't bet)
Seat 4: hannahw5187 showed [Ks As] and lost with a pair of Kings
Seat 5: Going2Ship (button) showed [Td Ad] and won (37113) with a strai=
ght, Ten to Ace
Seat 6: Deuxexmachen (small blind) folded before Flop
Seat 8: justcuz77 (big blind) showed [9c Th] and won (388) with a strai=
ght, Nine to King
Seat 9: fatulence folded before Flop (didn't bet)


*********** # 10 **************
PokerStars Hand #171478926650: Tournament #1648956629, $18.20+$1.80 USD=
 Hold'em No Limit - Level IV (50/100) - 2017/06/20 19:32:23 ET
Table '1648956629 2' 9-max Seat #6 is the button
Seat 1: MM9955 (16853 in chips)=20
Seat 2: BinkEquity (9650 in chips)=20
Seat 3: JJin91 (9820 in chips)=20
Seat 5: Going2Ship (37113 in chips)=20
Seat 6: Deuxexmachen (10225 in chips)=20
Seat 7: NightHawk475 (10000 in chips) out of hand (moved from another t=
able into small blind)
Seat 8: justcuz77 (7109 in chips)=20
MM9955: posts the ante 10
BinkEquity: posts the ante 10
JJin91: posts the ante 10
Going2Ship: posts the ante 10
Deuxexmachen: posts the ante 10
justcuz77: posts the ante 10
justcuz77: posts small blind 50
MM9955: posts big blind 100
*** HOLE CARDS ***
Dealt to JJin91 [2s 7h]
BinkEquity: folds=20
JJin91: folds=20
Going2Ship: folds=20
Deuxexmachen: raises 200 to 300
justcuz77: folds=20
MM9955: calls 200
*** FLOP *** [Ts 7s Ac]
MM9955: checks=20
Deuxexmachen: bets 355
MM9955: calls 355
*** TURN *** [Ts 7s Ac] [3s]
MM9955: checks=20
Deuxexmachen: checks=20
*** RIVER *** [Ts 7s Ac 3s] [Th]
MM9955: checks=20
Deuxexmachen: checks=20
*** SHOW DOWN ***
MM9955: shows [Ah 9d] (two pair, Aces and Tens)
Deuxexmachen: mucks hand=20
MM9955 collected 1420 from pot
*** SUMMARY ***
Total pot 1420 | Rake 0=20
Board [Ts 7s Ac 3s Th]
Seat 1: MM9955 (big blind) showed [Ah 9d] and won (1420) with two pair,=
 Aces and Tens
Seat 2: BinkEquity folded before Flop (didn't bet)
Seat 3: JJin91 folded before Flop (didn't bet)
Seat 5: Going2Ship folded before Flop (didn't bet)
Seat 6: Deuxexmachen (button) mucked [7c 8s]
Seat 8: justcuz77 (small blind) folded before Flop


*********** # 11 **************
PokerStars Hand #171478926826: Tournament #1648956629, $18.20+$1.80 USD=
 Hold'em No Limit - Level IV (50/100) - 2017/06/20 19:33:12 ET
Table '1648956629 2' 9-max Seat #8 is the button
Seat 1: MM9955 (17608 in chips)=20
Seat 2: BinkEquity (9640 in chips)=20
Seat 3: JJin91 (9810 in chips)=20
Seat 4: hannahw5187 (10000 in chips)=20
Seat 5: Going2Ship (37103 in chips)=20
Seat 6: Deuxexmachen (9560 in chips)=20
Seat 7: NightHawk475 (10000 in chips)=20
Seat 8: justcuz77 (7049 in chips)=20
MM9955: posts the ante 10
BinkEquity: posts the ante 10
JJin91: posts the ante 10
hannahw5187: posts the ante 10
Going2Ship: posts the ante 10
Deuxexmachen: posts the ante 10
NightHawk475: posts the ante 10
justcuz77: posts the ante 10
MM9955: posts small blind 50
BinkEquity: posts big blind 100
*** HOLE CARDS ***
Dealt to JJin91 [4h 6s]
JJin91: folds=20
hannahw5187: folds=20
Going2Ship: folds=20
Deuxexmachen: folds=20
NightHawk475: folds=20
justcuz77: folds=20
MM9955: raises 200 to 300
BinkEquity: folds=20
Uncalled bet (200) returned to MM9955
MM9955 collected 280 from pot
*** SUMMARY ***
Total pot 280 | Rake 0=20
Seat 1: MM9955 (small blind) collected (280)
Seat 2: BinkEquity (big blind) folded before Flop
Seat 3: JJin91 folded before Flop (didn't bet)
Seat 4: hannahw5187 folded before Flop (didn't bet)
Seat 5: Going2Ship folded before Flop (didn't bet)
Seat 6: Deuxexmachen folded before Flop (didn't bet)
Seat 7: NightHawk475 folded before Flop (didn't bet)
Seat 8: justcuz77 (button) folded before Flop (didn't bet)


*********** # 12 **************
PokerStars Hand #171478926916: Tournament #1648956629, $18.20+$1.80 USD=
 Hold'em No Limit - Level IV (50/100) - 2017/06/20 19:33:36 ET
Table '1648956629 2' 9-max Seat #1 is the button
Seat 1: MM9955 (17778 in chips)=20
Seat 2: BinkEquity (9530 in chips)=20
Seat 3: JJin91 (9800 in chips)=20
Seat 4: hannahw5187 (9990 in chips)=20
Seat 5: Going2Ship (37093 in chips)=20
Seat 6: Deuxexmachen (9550 in chips)=20
Seat 7: NightHawk475 (9990 in chips)=20
Seat 8: justcuz77 (7039 in chips)=20
MM9955: posts the ante 10
BinkEquity: posts the ante 10
JJin91: posts the ante 10
hannahw5187: posts the ante 10
Going2Ship: posts the ante 10
Deuxexmachen: posts the ante 10
NightHawk475: posts the ante 10
justcuz77: posts the ante 10
BinkEquity: posts small blind 50
JJin91: posts big blind 100
*** HOLE CARDS ***
Dealt to JJin91 [Kc 8c]
hannahw5187: folds=20
Going2Ship: folds=20
Deuxexmachen: folds=20
NightHawk475: folds=20
justcuz77: folds=20
MM9955: folds=20
BinkEquity: folds=20
Uncalled bet (50) returned to JJin91
JJin91 collected 180 from pot
JJin91: doesn't show hand=20
*** SUMMARY ***
Total pot 180 | Rake 0=20
Seat 1: MM9955 (button) folded before Flop (didn't bet)
Seat 2: BinkEquity (small blind) folded before Flop
Seat 3: JJin91 (big blind) collected (180)
Seat 4: hannahw5187 folded before Flop (didn't bet)
Seat 5: Going2Ship folded before Flop (didn't bet)
Seat 6: Deuxexmachen folded before Flop (didn't bet)
Seat 7: NightHawk475 folded before Flop (didn't bet)
Seat 8: justcuz77 folded before Flop (didn't bet)


*********** # 13 **************
PokerStars Hand #171478927005: Tournament #1648956629, $18.20+$1.80 USD=
 Hold'em No Limit - Level IV (50/100) - 2017/06/20 19:34:00 ET
Table '1648956629 2' 9-max Seat #2 is the button
Seat 1: MM9955 (17768 in chips)=20
Seat 2: BinkEquity (9470 in chips)=20
Seat 3: JJin91 (9920 in chips)=20
Seat 4: hannahw5187 (9980 in chips)=20
Seat 5: Going2Ship (37083 in chips)=20
Seat 6: Deuxexmachen (9540 in chips)=20
Seat 7: NightHawk475 (9980 in chips)=20
Seat 8: justcuz77 (7029 in chips)=20
MM9955: posts the ante 10
BinkEquity: posts the ante 10
JJin91: posts the ante 10
hannahw5187: posts the ante 10
Going2Ship: posts the ante 10
Deuxexmachen: posts the ante 10
NightHawk475: posts the ante 10
justcuz77: posts the ante 10
JJin91: posts small blind 50
hannahw5187: posts big blind 100
*** HOLE CARDS ***
Dealt to JJin91 [Jd Qs]
Going2Ship: folds=20
Deuxexmachen: folds=20
NightHawk475: raises 150 to 250
justcuz77: calls 250
MM9955: calls 250
BinkEquity: folds=20
JJin91: folds=20
hannahw5187: folds=20
*** FLOP *** [Ad 2h 2c]
NightHawk475: bets 461
justcuz77: folds=20
MM9955: folds=20
Uncalled bet (461) returned to NightHawk475
NightHawk475 collected 980 from pot
NightHawk475: doesn't show hand=20
*** SUMMARY ***
Total pot 980 | Rake 0=20
Board [Ad 2h 2c]
Seat 1: MM9955 folded on the Flop
Seat 2: BinkEquity (button) folded before Flop (didn't bet)
Seat 3: JJin91 (small blind) folded before Flop
Seat 4: hannahw5187 (big blind) folded before Flop
Seat 5: Going2Ship folded before Flop (didn't bet)
Seat 6: Deuxexmachen folded before Flop (didn't bet)
Seat 7: NightHawk475 collected (980)
Seat 8: justcuz77 folded on the Flop


*********** # 14 **************
PokerStars Hand #171478927155: Tournament #1648956629, $18.20+$1.80 USD=
 Hold'em No Limit - Level IV (50/100) - 2017/06/20 19:34:40 ET
Table '1648956629 2' 9-max Seat #3 is the button
Seat 1: MM9955 (17508 in chips)=20
Seat 2: BinkEquity (9460 in chips)=20
Seat 3: JJin91 (9860 in chips)=20
Seat 4: hannahw5187 (9870 in chips)=20
Seat 5: Going2Ship (37073 in chips)=20
Seat 6: Deuxexmachen (9530 in chips)=20
Seat 7: NightHawk475 (10700 in chips)=20
Seat 8: justcuz77 (6769 in chips)=20
MM9955: posts the ante 10
BinkEquity: posts the ante 10
JJin91: posts the ante 10
hannahw5187: posts the ante 10
Going2Ship: posts the ante 10
Deuxexmachen: posts the ante 10
NightHawk475: posts the ante 10
justcuz77: posts the ante 10
hannahw5187: posts small blind 50
Going2Ship: posts big blind 100
*** HOLE CARDS ***
Dealt to JJin91 [Js 4s]
Deuxexmachen: folds=20
NightHawk475: folds=20
justcuz77: calls 100
MM9955: folds=20
BinkEquity: raises 177 to 277
JJin91: folds=20
hannahw5187: folds=20
Going2Ship: folds=20
justcuz77: calls 177
*** FLOP *** [8c Qd 9c]
justcuz77: checks=20
BinkEquity: checks=20
*** TURN *** [8c Qd 9c] [Qs]
justcuz77: checks=20
BinkEquity: bets 376
justcuz77: folds=20
Uncalled bet (376) returned to BinkEquity
BinkEquity collected 784 from pot
*** SUMMARY ***
Total pot 784 | Rake 0=20
Board [8c Qd 9c Qs]
Seat 1: MM9955 folded before Flop (didn't bet)
Seat 2: BinkEquity collected (784)
Seat 3: JJin91 (button) folded before Flop (didn't bet)
Seat 4: hannahw5187 (small blind) folded before Flop
Seat 5: Going2Ship (big blind) folded before Flop
Seat 6: Deuxexmachen folded before Flop (didn't bet)
Seat 7: NightHawk475 folded before Flop (didn't bet)
Seat 8: justcuz77 folded on the Turn


*********** # 15 **************
PokerStars Hand #171478927327: Tournament #1648956629, $18.20+$1.80 USD=
 Hold'em No Limit - Level IV (50/100) - 2017/06/20 19:35:24 ET
Table '1648956629 2' 9-max Seat #4 is the button
Seat 1: MM9955 (17498 in chips)=20
Seat 2: BinkEquity (9957 in chips)=20
Seat 3: JJin91 (9850 in chips)=20
Seat 4: hannahw5187 (9810 in chips)=20
Seat 5: Going2Ship (36963 in chips)=20
Seat 6: Deuxexmachen (9520 in chips)=20
Seat 7: NightHawk475 (10690 in chips)=20
Seat 8: justcuz77 (6482 in chips)=20
MM9955: posts the ante 10
BinkEquity: posts the ante 10
JJin91: posts the ante 10
hannahw5187: posts the ante 10
Going2Ship: posts the ante 10
Deuxexmachen: posts the ante 10
NightHawk475: posts the ante 10
justcuz77: posts the ante 10
Going2Ship: posts small blind 50
Deuxexmachen: posts big blind 100
*** HOLE CARDS ***
Dealt to JJin91 [4c 7s]
NightHawk475: folds=20
justcuz77: calls 100
MM9955: calls 100
BinkEquity: folds=20
JJin91: folds=20
hannahw5187: folds=20
Going2Ship: folds=20
Deuxexmachen: checks=20
*** FLOP *** [Js 8s 8h]
Deuxexmachen: checks=20
justcuz77: checks=20
MM9955: checks=20
*** TURN *** [Js 8s 8h] [Tc]
Deuxexmachen: bets 215
justcuz77: raises 285 to 500
MM9955: folds=20
Deuxexmachen: raises 715 to 1215
justcuz77: calls 715
*** RIVER *** [Js 8s 8h Tc] [2s]
Deuxexmachen: bets 1430
justcuz77: calls 1430
*** SHOW DOWN ***
Deuxexmachen: shows [8c 6d] (three of a kind, Eights)
justcuz77: shows [9d 8d] (three of a kind, Eights)
Deuxexmachen collected 2860 from pot
justcuz77 collected 2860 from pot
*** SUMMARY ***
Total pot 5720 | Rake 0=20
Board [Js 8s 8h Tc 2s]
Seat 1: MM9955 folded on the Turn
Seat 2: BinkEquity folded before Flop (didn't bet)
Seat 3: JJin91 folded before Flop (didn't bet)
Seat 4: hannahw5187 (button) folded before Flop (didn't bet)
Seat 5: Going2Ship (small blind) folded before Flop
Seat 6: Deuxexmachen (big blind) showed [8c 6d] and won (2860) with thr=
ee of a kind, Eights
Seat 7: NightHawk475 folded before Flop (didn't bet)
Seat 8: justcuz77 showed [9d 8d] and won (2860) with three of a kind, E=
ights


*********** # 16 **************
PokerStars Hand #171478927592: Tournament #1648956629, $18.20+$1.80 USD=
 Hold'em No Limit - Level IV (50/100) - 2017/06/20 19:36:34 ET
Table '1648956629 2' 9-max Seat #5 is the button
Seat 1: MM9955 (17388 in chips)=20
Seat 2: BinkEquity (9947 in chips)=20
Seat 3: JJin91 (9840 in chips)=20
Seat 4: hannahw5187 (9800 in chips)=20
Seat 5: Going2Ship (36903 in chips)=20
Seat 6: Deuxexmachen (9625 in chips)=20
Seat 7: NightHawk475 (10680 in chips)=20
Seat 8: justcuz77 (6587 in chips)=20
MM9955: posts the ante 10
BinkEquity: posts the ante 10
JJin91: posts the ante 10
hannahw5187: posts the ante 10
Going2Ship: posts the ante 10
Deuxexmachen: posts the ante 10
NightHawk475: posts the ante 10
justcuz77: posts the ante 10
Deuxexmachen: posts small blind 50
NightHawk475: posts big blind 100
*** HOLE CARDS ***
Dealt to JJin91 [8s 3h]
justcuz77: calls 100
MM9955: calls 100
BinkEquity: folds=20
JJin91: folds=20
hannahw5187: folds=20
Going2Ship: raises 300 to 400
Deuxexmachen: folds=20
NightHawk475: raises 1000 to 1400
justcuz77: calls 1300
MM9955: folds=20
Going2Ship: raises 35493 to 36893 and is all-in
NightHawk475: calls 9270 and is all-in
justcuz77: calls 5177 and is all-in
Uncalled bet (26223) returned to Going2Ship
*** FLOP *** [9h 2c Th]
*** TURN *** [9h 2c Th] [4h]
*** RIVER *** [9h 2c Th 4h] [Kc]
*** SHOW DOWN ***
NightHawk475: shows [Ac Ah] (a pair of Aces)
Going2Ship: shows [As Ks] (a pair of Kings)
NightHawk475 collected 8186 from side pot
justcuz77: shows [7s 6s] (high card King)
NightHawk475 collected 19961 from main pot
justcuz77 finished the tournament in 90th place
*** SUMMARY ***
Total pot 28147 Main pot 19961. Side pot 8186. | Rake 0=20
Board [9h 2c Th 4h Kc]
Seat 1: MM9955 folded before Flop
Seat 2: BinkEquity folded before Flop (didn't bet)
Seat 3: JJin91 folded before Flop (didn't bet)
Seat 4: hannahw5187 folded before Flop (didn't bet)
Seat 5: Going2Ship (button) showed [As Ks] and lost with a pair of Kings
Seat 6: Deuxexmachen (small blind) folded before Flop
Seat 7: NightHawk475 (big blind) showed [Ac Ah] and won (28147) with a =
pair of Aces
Seat 8: justcuz77 showed [7s 6s] and lost with high card King


*********** # 17 **************
PokerStars Hand #171478927913: Tournament #1648956629, $18.20+$1.80 USD=
 Hold'em No Limit - Level IV (50/100) - 2017/06/20 19:37:57 ET
Table '1648956629 2' 9-max Seat #6 is the button
Seat 1: MM9955 (17278 in chips)=20
Seat 2: BinkEquity (9937 in chips)=20
Seat 3: JJin91 (9830 in chips)=20
Seat 4: hannahw5187 (9790 in chips)=20
Seat 5: Going2Ship (26223 in chips)=20
Seat 6: Deuxexmachen (9565 in chips)=20
Seat 7: NightHawk475 (28147 in chips)=20
MM9955: posts the ante 10
BinkEquity: posts the ante 10
JJin91: posts the ante 10
hannahw5187: posts the ante 10
Going2Ship: posts the ante 10
Deuxexmachen: posts the ante 10
NightHawk475: posts the ante 10
NightHawk475: posts small blind 50
MM9955: posts big blind 100
*** HOLE CARDS ***
Dealt to JJin91 [6s 2s]
BinkEquity: folds=20
JJin91: folds=20
hannahw5187: calls 100
Going2Ship: folds=20
Deuxexmachen: calls 100
NightHawk475: calls 50
MM9955: checks=20
*** FLOP *** [4c 9c 4h]
NightHawk475: checks=20
MM9955: checks=20
hannahw5187: checks=20
Deuxexmachen: bets 235
NightHawk475: raises 536 to 771
MM9955: raises 1124 to 1895
hannahw5187: folds=20
Deuxexmachen: raises 7560 to 9455 and is all-in
NightHawk475: raises 18582 to 28037 and is all-in
MM9955: calls 15273 and is all-in
Uncalled bet (10869) returned to NightHawk475
*** TURN *** [4c 9c 4h] [Ks]
*** RIVER *** [4c 9c 4h Ks] [2d]
*** SHOW DOWN ***
NightHawk475: shows [Ac 2c] (two pair, Fours and Deuces)
MM9955: shows [Ad 4s] (three of a kind, Fours)
MM9955 collected 15426 from side pot
Deuxexmachen: shows [Kd 4d] (a full house, Fours full of Kings)
Deuxexmachen collected 28835 from main pot
*** SUMMARY ***
Total pot 44261 Main pot 28835. Side pot 15426. | Rake 0=20
Board [4c 9c 4h Ks 2d]
Seat 1: MM9955 (big blind) showed [Ad 4s] and won (15426) with three of=
 a kind, Fours
Seat 2: BinkEquity folded before Flop (didn't bet)
Seat 3: JJin91 folded before Flop (didn't bet)
Seat 4: hannahw5187 folded on the Flop
Seat 5: Going2Ship folded before Flop (didn't bet)
Seat 6: Deuxexmachen (button) showed [Kd 4d] and won (28835) with a ful=
l house, Fours full of Kings
Seat 7: NightHawk475 (small blind) showed [Ac 2c] and lost with two pai=
r, Fours and Deuces


*********** # 18 **************
PokerStars Hand #171478928387: Tournament #1648956629, $18.20+$1.80 USD=
 Hold'em No Limit - Level V (60/120) - 2017/06/20 19:40:11 ET
Table '1648956629 2' 9-max Seat #7 is the button
Seat 1: MM9955 (15426 in chips)=20
Seat 2: BinkEquity (9927 in chips)=20
Seat 3: JJin91 (9820 in chips)=20
Seat 4: hannahw5187 (9680 in chips)=20
Seat 5: Going2Ship (26213 in chips)=20
Seat 6: Deuxexmachen (28835 in chips)=20
Seat 7: NightHawk475 (10869 in chips)=20
Seat 8: vincent329 (7590 in chips) out of hand (moved from another tabl=
e into small blind)
MM9955: posts the ante 15
BinkEquity: posts the ante 15
JJin91: posts the ante 15
hannahw5187: posts the ante 15
Going2Ship: posts the ante 15
Deuxexmachen: posts the ante 15
NightHawk475: posts the ante 15
MM9955: posts small blind 60
BinkEquity: posts big blind 120
*** HOLE CARDS ***
Dealt to JJin91 [5c Qd]
JJin91: folds=20
hannahw5187: folds=20
Going2Ship: folds=20
Deuxexmachen: folds=20
NightHawk475: folds=20
MM9955: folds=20
Uncalled bet (60) returned to BinkEquity
BinkEquity collected 225 from pot
*** SUMMARY ***
Total pot 225 | Rake 0=20
Seat 1: MM9955 (small blind) folded before Flop
Seat 2: BinkEquity (big blind) collected (225)
Seat 3: JJin91 folded before Flop (didn't bet)
Seat 4: hannahw5187 folded before Flop (didn't bet)
Seat 5: Going2Ship folded before Flop (didn't bet)
Seat 6: Deuxexmachen folded before Flop (didn't bet)
Seat 7: NightHawk475 (button) folded before Flop (didn't bet)


*********** # 19 **************
PokerStars Hand #171478928462: Tournament #1648956629, $18.20+$1.80 USD=
 Hold'em No Limit - Level V (60/120) - 2017/06/20 19:40:34 ET
Table '1648956629 2' 9-max Seat #1 is the button
Seat 1: MM9955 (15351 in chips)=20
Seat 2: BinkEquity (10077 in chips)=20
Seat 3: JJin91 (9805 in chips)=20
Seat 4: hannahw5187 (9665 in chips)=20
Seat 5: Going2Ship (26198 in chips)=20
Seat 6: Deuxexmachen (28820 in chips)=20
Seat 7: NightHawk475 (10854 in chips)=20
Seat 8: vincent329 (7590 in chips)=20
MM9955: posts the ante 15
BinkEquity: posts the ante 15
JJin91: posts the ante 15
hannahw5187: posts the ante 15
Going2Ship: posts the ante 15
Deuxexmachen: posts the ante 15
NightHawk475: posts the ante 15
vincent329: posts the ante 15
BinkEquity: posts small blind 60
JJin91: posts big blind 120
*** HOLE CARDS ***
Dealt to JJin91 [3s 6h]
hannahw5187: calls 120
Going2Ship: folds=20
Deuxexmachen: folds=20
NightHawk475: calls 120
vincent329: calls 120
MM9955: folds=20
BinkEquity: folds=20
JJin91: checks=20
*** FLOP *** [4s Kh 7h]
JJin91: checks=20
hannahw5187: bets 330
NightHawk475: folds=20
vincent329: folds=20
JJin91: folds=20
Uncalled bet (330) returned to hannahw5187
hannahw5187 collected 660 from pot
hannahw5187: doesn't show hand=20
*** SUMMARY ***
Total pot 660 | Rake 0=20
Board [4s Kh 7h]
Seat 1: MM9955 (button) folded before Flop (didn't bet)
Seat 2: BinkEquity (small blind) folded before Flop
Seat 3: JJin91 (big blind) folded on the Flop
Seat 4: hannahw5187 collected (660)
Seat 5: Going2Ship folded before Flop (didn't bet)
Seat 6: Deuxexmachen folded before Flop (didn't bet)
Seat 7: NightHawk475 folded on the Flop
Seat 8: vincent329 folded on the Flop


*********** # 20 **************
PokerStars Hand #171478928598: Tournament #1648956629, $18.20+$1.80 USD=
 Hold'em No Limit - Level V (60/120) - 2017/06/20 19:41:14 ET
Table '1648956629 2' 9-max Seat #2 is the button
Seat 1: MM9955 (15336 in chips)=20
Seat 2: BinkEquity (10002 in chips)=20
Seat 3: JJin91 (9670 in chips)=20
Seat 4: hannahw5187 (10190 in chips)=20
Seat 5: Going2Ship (26183 in chips)=20
Seat 6: Deuxexmachen (28805 in chips)=20
Seat 7: NightHawk475 (10719 in chips)=20
Seat 8: vincent329 (7455 in chips)=20
MM9955: posts the ante 15
BinkEquity: posts the ante 15
JJin91: posts the ante 15
hannahw5187: posts the ante 15
Going2Ship: posts the ante 15
Deuxexmachen: posts the ante 15
NightHawk475: posts the ante 15
vincent329: posts the ante 15
JJin91: posts small blind 60
hannahw5187: posts big blind 120
*** HOLE CARDS ***
Dealt to JJin91 [Th 4s]
Going2Ship: folds=20
Deuxexmachen: raises 240 to 360
NightHawk475: folds=20
vincent329: folds=20
MM9955: folds=20
BinkEquity: folds=20
JJin91: folds=20
hannahw5187: calls 240
*** FLOP *** [As 5s 8h]
hannahw5187: checks=20
Deuxexmachen: bets 450
hannahw5187: calls 450
*** TURN *** [As 5s 8h] [8d]
hannahw5187: checks=20
Deuxexmachen: bets 900
hannahw5187: raises 8465 to 9365 and is all-in
Deuxexmachen: calls 8465
*** RIVER *** [As 5s 8h 8d] [6d]
*** SHOW DOWN ***
hannahw5187: shows [2c Ac] (two pair, Aces and Eights)
Deuxexmachen: shows [9c 8c] (three of a kind, Eights)
Deuxexmachen collected 20530 from pot
hannahw5187 finished the tournament in 86th place
*** SUMMARY ***
Total pot 20530 | Rake 0=20
Board [As 5s 8h 8d 6d]
Seat 1: MM9955 folded before Flop (didn't bet)
Seat 2: BinkEquity (button) folded before Flop (didn't bet)
Seat 3: JJin91 (small blind) folded before Flop
Seat 4: hannahw5187 (big blind) showed [2c Ac] and lost with two pair, =
Aces and Eights
Seat 5: Going2Ship folded before Flop (didn't bet)
Seat 6: Deuxexmachen showed [9c 8c] and won (20530) with three of a kin=
d, Eights
Seat 7: NightHawk475 folded before Flop (didn't bet)
Seat 8: vincent329 folded before Flop (didn't bet)


*********** # 21 **************
PokerStars Hand #171478928781: Tournament #1648956629, $18.20+$1.80 USD=
 Hold'em No Limit - Level V (60/120) - 2017/06/20 19:42:09 ET
Table '1648956629 2' 9-max Seat #3 is the button
Seat 1: MM9955 (15321 in chips)=20
Seat 2: BinkEquity (9987 in chips)=20
Seat 3: JJin91 (9595 in chips)=20
Seat 5: Going2Ship (26168 in chips)=20
Seat 6: Deuxexmachen (39145 in chips)=20
Seat 7: NightHawk475 (10704 in chips)=20
Seat 8: vincent329 (7440 in chips)=20
MM9955: posts the ante 15
BinkEquity: posts the ante 15
JJin91: posts the ante 15
Going2Ship: posts the ante 15
Deuxexmachen: posts the ante 15
NightHawk475: posts the ante 15
vincent329: posts the ante 15
Going2Ship: posts small blind 60
Deuxexmachen: posts big blind 120
*** HOLE CARDS ***
Dealt to JJin91 [Td Kd]
NightHawk475: folds=20
vincent329: folds=20
MM9955: folds=20
BinkEquity: folds=20
JJin91: raises 135 to 255
Going2Ship: folds=20
Deuxexmachen: calls 135
*** FLOP *** [2s 7s 3s]
Deuxexmachen: checks=20
JJin91: checks=20
*** TURN *** [2s 7s 3s] [Ah]
Deuxexmachen: checks=20
JJin91: bets 366
Deuxexmachen: folds=20
Uncalled bet (366) returned to JJin91
JJin91 collected 675 from pot
JJin91: doesn't show hand=20
*** SUMMARY ***
Total pot 675 | Rake 0=20
Board [2s 7s 3s Ah]
Seat 1: MM9955 folded before Flop (didn't bet)
Seat 2: BinkEquity folded before Flop (didn't bet)
Seat 3: JJin91 (button) collected (675)
Seat 5: Going2Ship (small blind) folded before Flop
Seat 6: Deuxexmachen (big blind) folded on the Turn
Seat 7: NightHawk475 folded before Flop (didn't bet)
Seat 8: vincent329 folded before Flop (didn't bet)


*********** # 22 **************
PokerStars Hand #171478928995: Tournament #1648956629, $18.20+$1.80 USD=
 Hold'em No Limit - Level V (60/120) - 2017/06/20 19:43:08 ET
Table '1648956629 2' 9-max Seat #5 is the button
Seat 1: MM9955 (15306 in chips)=20
Seat 2: BinkEquity (9972 in chips)=20
Seat 3: JJin91 (10000 in chips)=20
Seat 5: Going2Ship (26093 in chips)=20
Seat 6: Deuxexmachen (38875 in chips)=20
Seat 7: NightHawk475 (10689 in chips)=20
Seat 8: vincent329 (7425 in chips)=20
MM9955: posts the ante 15
BinkEquity: posts the ante 15
JJin91: posts the ante 15
Going2Ship: posts the ante 15
Deuxexmachen: posts the ante 15
NightHawk475: posts the ante 15
vincent329: posts the ante 15
Deuxexmachen: posts small blind 60
NightHawk475: posts big blind 120
*** HOLE CARDS ***
Dealt to JJin91 [7h 4h]
vincent329: folds=20
MM9955: folds=20
BinkEquity: raises 147 to 267
JJin91: folds=20
Going2Ship: folds=20
Deuxexmachen: folds=20
NightHawk475: folds=20
Uncalled bet (147) returned to BinkEquity
BinkEquity collected 405 from pot
*** SUMMARY ***
Total pot 405 | Rake 0=20
Seat 1: MM9955 folded before Flop (didn't bet)
Seat 2: BinkEquity collected (405)
Seat 3: JJin91 folded before Flop (didn't bet)
Seat 5: Going2Ship (button) folded before Flop (didn't bet)
Seat 6: Deuxexmachen (small blind) folded before Flop
Seat 7: NightHawk475 (big blind) folded before Flop
Seat 8: vincent329 folded before Flop (didn't bet)


*********** # 23 **************
PokerStars Hand #171478929081: Tournament #1648956629, $18.20+$1.80 USD=
 Hold'em No Limit - Level V (60/120) - 2017/06/20 19:43:33 ET
Table '1648956629 2' 9-max Seat #6 is the button
Seat 1: MM9955 (15291 in chips)=20
Seat 2: BinkEquity (10242 in chips)=20
Seat 3: JJin91 (9985 in chips)=20
Seat 5: Going2Ship (26078 in chips)=20
Seat 6: Deuxexmachen (38800 in chips)=20
Seat 7: NightHawk475 (10554 in chips)=20
Seat 8: vincent329 (7410 in chips)=20
MM9955: posts the ante 15
BinkEquity: posts the ante 15
JJin91: posts the ante 15
Going2Ship: posts the ante 15
Deuxexmachen: posts the ante 15
NightHawk475: posts the ante 15
vincent329: posts the ante 15
NightHawk475: posts small blind 60
vincent329: posts big blind 120
*** HOLE CARDS ***
Dealt to JJin91 [8s 9s]
MM9955: folds=20
BinkEquity: folds=20
JJin91: raises 135 to 255
Going2Ship: folds=20
Deuxexmachen: raises 520 to 775
NightHawk475: folds=20
vincent329: folds=20
JJin91: folds=20
Uncalled bet (520) returned to Deuxexmachen
Deuxexmachen collected 795 from pot
Deuxexmachen: doesn't show hand=20
*** SUMMARY ***
Total pot 795 | Rake 0=20
Seat 1: MM9955 folded before Flop (didn't bet)
Seat 2: BinkEquity folded before Flop (didn't bet)
Seat 3: JJin91 folded before Flop
Seat 5: Going2Ship folded before Flop (didn't bet)
Seat 6: Deuxexmachen (button) collected (795)
Seat 7: NightHawk475 (small blind) folded before Flop
Seat 8: vincent329 (big blind) folded before Flop


*********** # 24 **************
PokerStars Hand #171478929233: Tournament #1648956629, $18.20+$1.80 USD=
 Hold'em No Limit - Level V (60/120) - 2017/06/20 19:44:13 ET
Table '1648956629 2' 9-max Seat #7 is the button
Seat 1: MM9955 (15276 in chips)=20
Seat 2: BinkEquity (10227 in chips)=20
Seat 3: JJin91 (9715 in chips)=20
Seat 5: Going2Ship (26063 in chips)=20
Seat 6: Deuxexmachen (39325 in chips)=20
Seat 7: NightHawk475 (10479 in chips)=20
Seat 8: vincent329 (7275 in chips)=20
MM9955: posts the ante 15
BinkEquity: posts the ante 15
JJin91: posts the ante 15
Going2Ship: posts the ante 15
Deuxexmachen: posts the ante 15
NightHawk475: posts the ante 15
vincent329: posts the ante 15
vincent329: posts small blind 60
MM9955: posts big blind 120
*** HOLE CARDS ***
Dealt to JJin91 [Jd Qd]
BinkEquity: folds=20
JJin91: folds=20
Going2Ship: folds=20
Deuxexmachen: folds=20
NightHawk475: raises 156 to 276
vincent329: calls 216
MM9955: calls 156
*** FLOP *** [2c Ks 7c]
vincent329: bets 467
MM9955: folds=20
NightHawk475: calls 467
*** TURN *** [2c Ks 7c] [9h]
vincent329: bets 600
NightHawk475: calls 600
*** RIVER *** [2c Ks 7c 9h] [3s]
vincent329: checks=20
NightHawk475: bets 720
vincent329: folds=20
Uncalled bet (720) returned to NightHawk475
NightHawk475 collected 3067 from pot
NightHawk475: doesn't show hand=20
*** SUMMARY ***
Total pot 3067 | Rake 0=20
Board [2c Ks 7c 9h 3s]
Seat 1: MM9955 (big blind) folded on the Flop
Seat 2: BinkEquity folded before Flop (didn't bet)
Seat 3: JJin91 folded before Flop (didn't bet)
Seat 5: Going2Ship folded before Flop (didn't bet)
Seat 6: Deuxexmachen folded before Flop (didn't bet)
Seat 7: NightHawk475 (button) collected (3067)
Seat 8: vincent329 (small blind) folded on the River


*********** # 25 **************
PokerStars Hand #171478929476: Tournament #1648956629, $18.20+$1.80 USD=
 Hold'em No Limit - Level V (60/120) - 2017/06/20 19:45:21 ET
Table '1648956629 2' 9-max Seat #8 is the button
Seat 1: MM9955 (14985 in chips)=20
Seat 2: BinkEquity (10212 in chips)=20
Seat 3: JJin91 (9700 in chips)=20
Seat 5: Going2Ship (26048 in chips)=20
Seat 6: Deuxexmachen (39310 in chips)=20
Seat 7: NightHawk475 (12188 in chips)=20
Seat 8: vincent329 (5917 in chips)=20
MM9955: posts the ante 15
BinkEquity: posts the ante 15
JJin91: posts the ante 15
Going2Ship: posts the ante 15
Deuxexmachen: posts the ante 15
NightHawk475: posts the ante 15
vincent329: posts the ante 15
MM9955: posts small blind 60
BinkEquity: posts big blind 120
*** HOLE CARDS ***
Dealt to JJin91 [8c Th]
JJin91: folds=20
Going2Ship: folds=20
Deuxexmachen: folds=20
NightHawk475: raises 156 to 276
vincent329: folds=20
MM9955: folds=20
BinkEquity: folds=20
Uncalled bet (156) returned to NightHawk475
NightHawk475 collected 405 from pot
NightHawk475: doesn't show hand=20
*** SUMMARY ***
Total pot 405 | Rake 0=20
Seat 1: MM9955 (small blind) folded before Flop
Seat 2: BinkEquity (big blind) folded before Flop
Seat 3: JJin91 folded before Flop (didn't bet)
Seat 5: Going2Ship folded before Flop (didn't bet)
Seat 6: Deuxexmachen folded before Flop (didn't bet)
Seat 7: NightHawk475 collected (405)
Seat 8: vincent329 (button) folded before Flop (didn't bet)


*********** # 26 **************
PokerStars Hand #171478929631: Tournament #1648956629, $18.20+$1.80 USD=
 Hold'em No Limit - Level V (60/120) - 2017/06/20 19:46:06 ET
Table '1648956629 2' 9-max Seat #1 is the button
Seat 1: MM9955 (14910 in chips)=20
Seat 2: BinkEquity (10077 in chips)=20
Seat 3: JJin91 (9685 in chips)=20
Seat 5: Going2Ship (26033 in chips)=20
Seat 6: Deuxexmachen (39295 in chips)=20
Seat 7: NightHawk475 (12458 in chips)=20
Seat 8: vincent329 (5902 in chips)=20
MM9955: posts the ante 15
BinkEquity: posts the ante 15
JJin91: posts the ante 15
Going2Ship: posts the ante 15
Deuxexmachen: posts the ante 15
NightHawk475: posts the ante 15
vincent329: posts the ante 15
BinkEquity: posts small blind 60
JJin91: posts big blind 120
*** HOLE CARDS ***
Dealt to JJin91 [Th 6d]
Going2Ship: raises 180 to 300
Deuxexmachen: folds=20
NightHawk475: calls 300
vincent329: calls 300
MM9955: folds=20
BinkEquity: calls 240
JJin91: folds=20
*** FLOP *** [4s Kc Ts]
BinkEquity: checks=20
Going2Ship: bets 480
NightHawk475: calls 480
vincent329: calls 480
BinkEquity: folds=20
*** TURN *** [4s Kc Ts] [Ks]
Going2Ship: checks=20
NightHawk475: checks=20
vincent329: bets 960
Going2Ship: raises 1440 to 2400
NightHawk475: raises 9263 to 11663 and is all-in
vincent329: folds=20
Going2Ship: calls 9263
*** RIVER *** [4s Kc Ts Ks] [6c]
*** SHOW DOWN ***
Going2Ship: shows [Qc Kh] (three of a kind, Kings)
NightHawk475: shows [9s Js] (a flush, King high)
NightHawk475 collected 27151 from pot
*** SUMMARY ***
Total pot 27151 | Rake 0=20
Board [4s Kc Ts Ks 6c]
Seat 1: MM9955 (button) folded before Flop (didn't bet)
Seat 2: BinkEquity (small blind) folded on the Flop
Seat 3: JJin91 (big blind) folded before Flop
Seat 5: Going2Ship showed [Qc Kh] and lost with three of a kind, Kings
Seat 6: Deuxexmachen folded before Flop (didn't bet)
Seat 7: NightHawk475 showed [9s Js] and won (27151) with a flush, King =
high
Seat 8: vincent329 folded on the Turn


*********** # 27 **************
PokerStars Hand #171478929905: Tournament #1648956629, $18.20+$1.80 USD=
 Hold'em No Limit - Level V (60/120) - 2017/06/20 19:47:24 ET
Table '1648956629 2' 9-max Seat #2 is the button
Seat 1: MM9955 (14895 in chips)=20
Seat 2: BinkEquity (9762 in chips)=20
Seat 3: JJin91 (9550 in chips)=20
Seat 5: Going2Ship (13575 in chips)=20
Seat 6: Deuxexmachen (39280 in chips)=20
Seat 7: NightHawk475 (27151 in chips)=20
Seat 8: vincent329 (4147 in chips)=20
MM9955: posts the ante 15
BinkEquity: posts the ante 15
JJin91: posts the ante 15
Going2Ship: posts the ante 15
Deuxexmachen: posts the ante 15
NightHawk475: posts the ante 15
vincent329: posts the ante 15
JJin91: posts small blind 60
Going2Ship: posts big blind 120
*** HOLE CARDS ***
Dealt to JJin91 [7c 7h]
Deuxexmachen: folds=20
NightHawk475: folds=20
vincent329: calls 120
MM9955: folds=20
BinkEquity: folds=20
JJin91: raises 242 to 362
Going2Ship: folds=20
vincent329: calls 242
*** FLOP *** [Kd Tc 6d]
JJin91: bets 326
vincent329: calls 326
*** TURN *** [Kd Tc 6d] [Qh]
JJin91: checks=20
vincent329: bets 3444 and is all-in
JJin91: folds=20
Uncalled bet (3444) returned to vincent329
vincent329 collected 1601 from pot
*** SUMMARY ***
Total pot 1601 | Rake 0=20
Board [Kd Tc 6d Qh]
Seat 1: MM9955 folded before Flop (didn't bet)
Seat 2: BinkEquity (button) folded before Flop (didn't bet)
Seat 3: JJin91 (small blind) folded on the Turn
Seat 5: Going2Ship (big blind) folded before Flop
Seat 6: Deuxexmachen folded before Flop (didn't bet)
Seat 7: NightHawk475 folded before Flop (didn't bet)
Seat 8: vincent329 collected (1601)


*********** # 28 **************
PokerStars Hand #171480988885: Tournament #1648956629, $18.20+$1.80 USD=
 Hold'em No Limit - Level V (60/120) - 2017/06/20 19:48:13 ET
Table '1648956629 2' 9-max Seat #3 is the button
Seat 1: MM9955 (14880 in chips)=20
Seat 2: BinkEquity (9747 in chips)=20
Seat 3: JJin91 (8847 in chips)=20
Seat 5: Going2Ship (13440 in chips)=20
Seat 6: Deuxexmachen (39265 in chips)=20
Seat 7: NightHawk475 (27136 in chips)=20
Seat 8: vincent329 (5045 in chips)=20
MM9955: posts the ante 15
BinkEquity: posts the ante 15
JJin91: posts the ante 15
Going2Ship: posts the ante 15
Deuxexmachen: posts the ante 15
NightHawk475: posts the ante 15
vincent329: posts the ante 15
Going2Ship: posts small blind 60
Deuxexmachen: posts big blind 120
*** HOLE CARDS ***
Dealt to JJin91 [3d Qh]
NightHawk475: folds=20
vincent329: calls 120
MM9955: folds=20
BinkEquity: folds=20
JJin91: folds=20
Going2Ship: folds=20
Deuxexmachen: checks=20
*** FLOP *** [Kc Jc 7d]
Deuxexmachen: checks=20
vincent329: bets 405
Deuxexmachen: folds=20
Uncalled bet (405) returned to vincent329
vincent329 collected 405 from pot
*** SUMMARY ***
Total pot 405 | Rake 0=20
Board [Kc Jc 7d]
Seat 1: MM9955 folded before Flop (didn't bet)
Seat 2: BinkEquity folded before Flop (didn't bet)
Seat 3: JJin91 (button) folded before Flop (didn't bet)
Seat 5: Going2Ship (small blind) folded before Flop
Seat 6: Deuxexmachen (big blind) folded on the Flop
Seat 7: NightHawk475 folded before Flop (didn't bet)
Seat 8: vincent329 collected (405)


*********** # 29 **************
PokerStars Hand #171480989010: Tournament #1648956629, $18.20+$1.80 USD=
 Hold'em No Limit - Level V (60/120) - 2017/06/20 19:48:47 ET
Table '1648956629 2' 9-max Seat #5 is the button
Seat 1: MM9955 (14865 in chips)=20
Seat 2: BinkEquity (9732 in chips)=20
Seat 3: JJin91 (8832 in chips)=20
Seat 5: Going2Ship (13365 in chips)=20
Seat 6: Deuxexmachen (39130 in chips)=20
Seat 7: NightHawk475 (27121 in chips)=20
Seat 8: vincent329 (5315 in chips)=20
MM9955: posts the ante 15
BinkEquity: posts the ante 15
JJin91: posts the ante 15
Going2Ship: posts the ante 15
Deuxexmachen: posts the ante 15
NightHawk475: posts the ante 15
vincent329: posts the ante 15
Deuxexmachen: posts small blind 60
NightHawk475: posts big blind 120
*** HOLE CARDS ***
Dealt to JJin91 [Th 2c]
vincent329: raises 120 to 240
MM9955: folds=20
BinkEquity: raises 480 to 720
JJin91: folds=20
Going2Ship: folds=20
Deuxexmachen: folds=20
NightHawk475: folds=20
vincent329: calls 480
*** FLOP *** [Qs Ts Kh]
vincent329: checks=20
BinkEquity: checks=20
*** TURN *** [Qs Ts Kh] [3c]
vincent329: bets 863
BinkEquity: calls 863
*** RIVER *** [Qs Ts Kh 3c] [Td]
vincent329: bets 3717 and is all-in
BinkEquity: folds=20
Uncalled bet (3717) returned to vincent329
vincent329 collected 3451 from pot
*** SUMMARY ***
Total pot 3451 | Rake 0=20
Board [Qs Ts Kh 3c Td]
Seat 1: MM9955 folded before Flop (didn't bet)
Seat 2: BinkEquity folded on the River
Seat 3: JJin91 folded before Flop (didn't bet)
Seat 5: Going2Ship (button) folded before Flop (didn't bet)
Seat 6: Deuxexmachen (small blind) folded before Flop
Seat 7: NightHawk475 (big blind) folded before Flop
Seat 8: vincent329 collected (3451)


*********** # 30 **************
PokerStars Hand #171480989223: Tournament #1648956629, $18.20+$1.80 USD=
 Hold'em No Limit - Level V (60/120) - 2017/06/20 19:49:37 ET
Table '1648956629 2' 9-max Seat #6 is the button
Seat 1: MM9955 (14850 in chips)=20
Seat 2: BinkEquity (8134 in chips)=20
Seat 3: JJin91 (8817 in chips)=20
Seat 5: Going2Ship (13350 in chips)=20
Seat 6: Deuxexmachen (39055 in chips)=20
Seat 7: NightHawk475 (26986 in chips)=20
Seat 8: vincent329 (7168 in chips)=20
MM9955: posts the ante 15
BinkEquity: posts the ante 15
JJin91: posts the ante 15
Going2Ship: posts the ante 15
Deuxexmachen: posts the ante 15
NightHawk475: posts the ante 15
vincent329: posts the ante 15
NightHawk475: posts small blind 60
vincent329: posts big blind 120
*** HOLE CARDS ***
Dealt to JJin91 [2h 4c]
MM9955: calls 120
BinkEquity: folds=20
JJin91: folds=20
Going2Ship: folds=20
Deuxexmachen: folds=20
NightHawk475: calls 60
vincent329: checks=20
*** FLOP *** [9c 6d Qc]
NightHawk475: checks=20
vincent329: bets 465
MM9955: folds=20
NightHawk475: calls 465
*** TURN *** [9c 6d Qc] [6s]
NightHawk475: checks=20
vincent329: checks=20
*** RIVER *** [9c 6d Qc 6s] [2c]
NightHawk475: checks=20
vincent329: bets 720
NightHawk475: calls 720
*** SHOW DOWN ***
vincent329: shows [2s 9s] (two pair, Nines and Sixes)
NightHawk475: shows [7h Qh] (two pair, Queens and Sixes)
NightHawk475 collected 2835 from pot
*** SUMMARY ***
Total pot 2835 | Rake 0=20
Board [9c 6d Qc 6s 2c]
Seat 1: MM9955 folded on the Flop
Seat 2: BinkEquity folded before Flop (didn't bet)
Seat 3: JJin91 folded before Flop (didn't bet)
Seat 5: Going2Ship folded before Flop (didn't bet)
Seat 6: Deuxexmachen (button) folded before Flop (didn't bet)
Seat 7: NightHawk475 (small blind) showed [7h Qh] and won (2835) with t=
wo pair, Queens and Sixes
Seat 8: vincent329 (big blind) showed [2s 9s] and lost with two pair, N=
ines and Sixes


*********** # 31 **************
PokerStars Hand #171480989502: Tournament #1648956629, $18.20+$1.80 USD=
 Hold'em No Limit - Level VI (75/150) - 2017/06/20 19:50:44 ET
Table '1648956629 2' 9-max Seat #7 is the button
Seat 1: MM9955 (14715 in chips)=20
Seat 2: BinkEquity (8119 in chips)=20
Seat 3: JJin91 (8802 in chips)=20
Seat 5: Going2Ship (13335 in chips)=20
Seat 6: Deuxexmachen (39040 in chips)=20
Seat 7: NightHawk475 (28501 in chips)=20
Seat 8: vincent329 (5848 in chips)=20
MM9955: posts the ante 20
BinkEquity: posts the ante 20
JJin91: posts the ante 20
Going2Ship: posts the ante 20
Deuxexmachen: posts the ante 20
NightHawk475: posts the ante 20
vincent329: posts the ante 20
vincent329: posts small blind 75
MM9955: posts big blind 150
*** HOLE CARDS ***
Dealt to JJin91 [Qd 4s]
BinkEquity: folds=20
JJin91: folds=20
Going2Ship: folds=20
Deuxexmachen: raises 300 to 450
NightHawk475: raises 650 to 1100
vincent329: folds=20
MM9955: calls 950
Deuxexmachen: calls 650
*** FLOP *** [2c 4h Tc]
MM9955: checks=20
Deuxexmachen: checks=20
NightHawk475: bets 1880
MM9955: folds=20
Deuxexmachen: folds=20
Uncalled bet (1880) returned to NightHawk475
NightHawk475 collected 3515 from pot
NightHawk475: doesn't show hand=20
*** SUMMARY ***
Total pot 3515 | Rake 0=20
Board [2c 4h Tc]
Seat 1: MM9955 (big blind) folded on the Flop
Seat 2: BinkEquity folded before Flop (didn't bet)
Seat 3: JJin91 folded before Flop (didn't bet)
Seat 5: Going2Ship folded before Flop (didn't bet)
Seat 6: Deuxexmachen folded on the Flop
Seat 7: NightHawk475 (button) collected (3515)
Seat 8: vincent329 (small blind) folded before Flop


*********** # 32 **************
PokerStars Hand #171480989742: Tournament #1648956629, $18.20+$1.80 USD=
 Hold'em No Limit - Level VI (75/150) - 2017/06/20 19:51:46 ET
Table '1648956629 2' 9-max Seat #8 is the button
Seat 1: MM9955 (13595 in chips)=20
Seat 2: BinkEquity (8099 in chips)=20
Seat 3: JJin91 (8782 in chips)=20
Seat 5: Going2Ship (13315 in chips)=20
Seat 6: Deuxexmachen (37920 in chips)=20
Seat 7: NightHawk475 (30896 in chips)=20
Seat 8: vincent329 (5753 in chips)=20
MM9955: posts the ante 20
BinkEquity: posts the ante 20
JJin91: posts the ante 20
Going2Ship: posts the ante 20
Deuxexmachen: posts the ante 20
NightHawk475: posts the ante 20
vincent329: posts the ante 20
MM9955: posts small blind 75
BinkEquity: posts big blind 150
*** HOLE CARDS ***
Dealt to JJin91 [9h Kc]
JJin91: folds=20
Going2Ship: folds=20
Deuxexmachen: raises 300 to 450
NightHawk475: calls 450
vincent329: raises 1050 to 1500
MM9955: folds=20
BinkEquity: folds=20
Deuxexmachen: folds=20
NightHawk475: calls 1050
*** FLOP *** [2h Ac 8d]
NightHawk475: checks=20
vincent329: bets 4233 and is all-in
NightHawk475: folds=20
Uncalled bet (4233) returned to vincent329
vincent329 collected 3815 from pot
*** SUMMARY ***
Total pot 3815 | Rake 0=20
Board [2h Ac 8d]
Seat 1: MM9955 (small blind) folded before Flop
Seat 2: BinkEquity (big blind) folded before Flop
Seat 3: JJin91 folded before Flop (didn't bet)
Seat 5: Going2Ship folded before Flop (didn't bet)
Seat 6: Deuxexmachen folded before Flop
Seat 7: NightHawk475 folded on the Flop
Seat 8: vincent329 (button) collected (3815)


*********** # 33 **************
PokerStars Hand #171480989986: Tournament #1648956629, $18.20+$1.80 USD=
 Hold'em No Limit - Level VI (75/150) - 2017/06/20 19:52:51 ET
Table '1648956629 2' 9-max Seat #1 is the button
Seat 1: MM9955 (13500 in chips)=20
Seat 2: BinkEquity (7929 in chips)=20
Seat 3: JJin91 (8762 in chips)=20
Seat 5: Going2Ship (13295 in chips)=20
Seat 6: Deuxexmachen (37450 in chips)=20
Seat 7: NightHawk475 (29376 in chips)=20
Seat 8: vincent329 (8048 in chips)=20
MM9955: posts the ante 20
BinkEquity: posts the ante 20
JJin91: posts the ante 20
Going2Ship: posts the ante 20
Deuxexmachen: posts the ante 20
NightHawk475: posts the ante 20
vincent329: posts the ante 20
BinkEquity: posts small blind 75
JJin91: posts big blind 150
*** HOLE CARDS ***
Dealt to JJin91 [9s 8c]
Going2Ship: folds=20
Deuxexmachen: folds=20
NightHawk475: raises 195 to 345
vincent329: folds=20
MM9955: calls 345
BinkEquity: folds=20
JJin91: calls 195
*** FLOP *** [5s 4d 4s]
JJin91: checks=20
NightHawk475: checks=20
MM9955: checks=20
*** TURN *** [5s 4d 4s] [Kc]
JJin91: checks=20
NightHawk475: bets 399
MM9955: folds=20
JJin91: folds=20
Uncalled bet (399) returned to NightHawk475
NightHawk475 collected 1250 from pot
NightHawk475: doesn't show hand=20
*** SUMMARY ***
Total pot 1250 | Rake 0=20
Board [5s 4d 4s Kc]
Seat 1: MM9955 (button) folded on the Turn
Seat 2: BinkEquity (small blind) folded before Flop
Seat 3: JJin91 (big blind) folded on the Turn
Seat 5: Going2Ship folded before Flop (didn't bet)
Seat 6: Deuxexmachen folded before Flop (didn't bet)
Seat 7: NightHawk475 collected (1250)
Seat 8: vincent329 folded before Flop (didn't bet)


*********** # 34 **************
PokerStars Hand #171481319088: Tournament #1648956629, $18.20+$1.80 USD=
 Hold'em No Limit - Level VI (75/150) - 2017/06/20 19:54:04 ET
Table '1648956629 2' 9-max Seat #2 is the button
Seat 1: MM9955 (13135 in chips)=20
Seat 2: BinkEquity (7834 in chips)=20
Seat 3: JJin91 (8397 in chips)=20
Seat 5: Going2Ship (13275 in chips)=20
Seat 6: Deuxexmachen (37430 in chips)=20
Seat 7: NightHawk475 (30261 in chips)=20
Seat 8: vincent329 (8028 in chips)=20
MM9955: posts the ante 20
BinkEquity: posts the ante 20
JJin91: posts the ante 20
Going2Ship: posts the ante 20
Deuxexmachen: posts the ante 20
NightHawk475: posts the ante 20
vincent329: posts the ante 20
JJin91: posts small blind 75
Going2Ship: posts big blind 150
*** HOLE CARDS ***
Dealt to JJin91 [2d 4s]
Deuxexmachen: folds=20
NightHawk475: folds=20
vincent329: calls 150
MM9955: folds=20
BinkEquity: calls 150
JJin91: folds=20
Going2Ship: checks=20
*** FLOP *** [5s 8c Th]
Going2Ship: checks=20
vincent329: bets 665
BinkEquity: folds=20
Going2Ship: folds=20
Uncalled bet (665) returned to vincent329
vincent329 collected 665 from pot
*** SUMMARY ***
Total pot 665 | Rake 0=20
Board [5s 8c Th]
Seat 1: MM9955 folded before Flop (didn't bet)
Seat 2: BinkEquity (button) folded on the Flop
Seat 3: JJin91 (small blind) folded before Flop
Seat 5: Going2Ship (big blind) folded on the Flop
Seat 6: Deuxexmachen folded before Flop (didn't bet)
Seat 7: NightHawk475 folded before Flop (didn't bet)
Seat 8: vincent329 collected (665)


*********** # 35 **************
PokerStars Hand #171481319241: Tournament #1648956629, $18.20+$1.80 USD=
 Hold'em No Limit - Level VI (75/150) - 2017/06/20 19:54:43 ET
Table '1648956629 2' 9-max Seat #3 is the button
Seat 1: MM9955 (13115 in chips)=20
Seat 2: BinkEquity (7664 in chips)=20
Seat 3: JJin91 (8302 in chips)=20
Seat 5: Going2Ship (13105 in chips)=20
Seat 6: Deuxexmachen (37410 in chips)=20
Seat 7: NightHawk475 (30241 in chips)=20
Seat 8: vincent329 (8523 in chips)=20
MM9955: posts the ante 20
BinkEquity: posts the ante 20
JJin91: posts the ante 20
Going2Ship: posts the ante 20
Deuxexmachen: posts the ante 20
NightHawk475: posts the ante 20
vincent329: posts the ante 20
Going2Ship: posts small blind 75
Deuxexmachen: posts big blind 150
*** HOLE CARDS ***
Dealt to JJin91 [3h 8s]
NightHawk475: folds=20
vincent329: raises 150 to 300
MM9955: calls 300
BinkEquity: folds=20
JJin91: folds=20
Going2Ship: folds=20
Deuxexmachen: folds=20
*** FLOP *** [Qc Kd 4h]
vincent329: checks=20
MM9955: checks=20
*** TURN *** [Qc Kd 4h] [7d]
vincent329: bets 483
MM9955: folds=20
Uncalled bet (483) returned to vincent329
vincent329 collected 965 from pot
*** SUMMARY ***
Total pot 965 | Rake 0=20
Board [Qc Kd 4h 7d]
Seat 1: MM9955 folded on the Turn
Seat 2: BinkEquity folded before Flop (didn't bet)
Seat 3: JJin91 (button) folded before Flop (didn't bet)
Seat 5: Going2Ship (small blind) folded before Flop
Seat 6: Deuxexmachen (big blind) folded before Flop
Seat 7: NightHawk475 folded before Flop (didn't bet)
Seat 8: vincent329 collected (965)


*********** # 36 **************
PokerStars Hand #171481679482: Tournament #1648956629, $18.20+$1.80 USD=
 Hold'em No Limit - Level VI (75/150) - 2017/06/20 20:00:33 ET
Table '1648956629 2' 9-max Seat #5 is the button
Seat 1: MM9955 (12795 in chips)=20
Seat 2: BinkEquity (7644 in chips)=20
Seat 3: JJin91 (8282 in chips)=20
Seat 4: SapofPine (10000 in chips)=20
Seat 5: Going2Ship (13010 in chips)=20
Seat 6: Deuxexmachen (37240 in chips)=20
Seat 7: NightHawk475 (30221 in chips)=20
Seat 8: vincent329 (9168 in chips)=20
MM9955: posts the ante 20
BinkEquity: posts the ante 20
JJin91: posts the ante 20
SapofPine: posts the ante 20
Going2Ship: posts the ante 20
Deuxexmachen: posts the ante 20
NightHawk475: posts the ante 20
vincent329: posts the ante 20
Deuxexmachen: posts small blind 75
NightHawk475: posts big blind 150
*** HOLE CARDS ***
Dealt to JJin91 [5s 5c]
vincent329: raises 150 to 300
MM9955: folds=20
BinkEquity: folds=20
JJin91: calls 300
SapofPine: folds=20
Going2Ship: folds=20
Deuxexmachen: folds=20
NightHawk475: folds=20
*** FLOP *** [2h Qd 5d]
vincent329: bets 985
JJin91: calls 985
*** TURN *** [2h Qd 5d] [Ks]
vincent329: checks=20
JJin91: bets 1911
vincent329: folds=20
Uncalled bet (1911) returned to JJin91
JJin91 collected 2955 from pot
JJin91: doesn't show hand=20
*** SUMMARY ***
Total pot 2955 | Rake 0=20
Board [2h Qd 5d Ks]
Seat 1: MM9955 folded before Flop (didn't bet)
Seat 2: BinkEquity folded before Flop (didn't bet)
Seat 3: JJin91 collected (2955)
Seat 4: SapofPine folded before Flop (didn't bet)
Seat 5: Going2Ship (button) folded before Flop (didn't bet)
Seat 6: Deuxexmachen (small blind) folded before Flop
Seat 7: NightHawk475 (big blind) folded before Flop
Seat 8: vincent329 folded on the Turn


*********** # 37 **************
PokerStars Hand #171481679769: Tournament #1648956629, $18.20+$1.80 USD=
 Hold'em No Limit - Level VI (75/150) - 2017/06/20 20:01:44 ET
Table '1648956629 2' 9-max Seat #6 is the button
Seat 1: MM9955 (12775 in chips)=20
Seat 2: BinkEquity (7624 in chips)=20
Seat 3: JJin91 (9932 in chips)=20
Seat 4: SapofPine (9980 in chips)=20
Seat 5: Going2Ship (12990 in chips)=20
Seat 6: Deuxexmachen (37145 in chips)=20
Seat 7: NightHawk475 (30051 in chips)=20
Seat 8: vincent329 (7863 in chips)=20
MM9955: posts the ante 20
BinkEquity: posts the ante 20
JJin91: posts the ante 20
SapofPine: posts the ante 20
Going2Ship: posts the ante 20
Deuxexmachen: posts the ante 20
NightHawk475: posts the ante 20
vincent329: posts the ante 20
NightHawk475: posts small blind 75
vincent329: posts big blind 150
*** HOLE CARDS ***
Dealt to JJin91 [Ah 3d]
MM9955: folds=20
BinkEquity: folds=20
JJin91: folds=20
SapofPine: folds=20
Going2Ship: raises 280 to 430
Deuxexmachen: folds=20
NightHawk475: folds=20
vincent329: folds=20
Uncalled bet (280) returned to Going2Ship
Going2Ship collected 535 from pot
Going2Ship: doesn't show hand=20
*** SUMMARY ***
Total pot 535 | Rake 0=20
Seat 1: MM9955 folded before Flop (didn't bet)
Seat 2: BinkEquity folded before Flop (didn't bet)
Seat 3: JJin91 folded before Flop (didn't bet)
Seat 4: SapofPine folded before Flop (didn't bet)
Seat 5: Going2Ship collected (535)
Seat 6: Deuxexmachen (button) folded before Flop (didn't bet)
Seat 7: NightHawk475 (small blind) folded before Flop
Seat 8: vincent329 (big blind) folded before Flop


*********** # 38 **************
PokerStars Hand #171481679880: Tournament #1648956629, $18.20+$1.80 USD=
 Hold'em No Limit - Level VI (75/150) - 2017/06/20 20:02:14 ET
Table '1648956629 2' 9-max Seat #7 is the button
Seat 1: MM9955 (12755 in chips)=20
Seat 2: BinkEquity (7604 in chips)=20
Seat 3: JJin91 (9912 in chips)=20
Seat 4: SapofPine (9960 in chips)=20
Seat 5: Going2Ship (13355 in chips)=20
Seat 6: Deuxexmachen (37125 in chips)=20
Seat 7: NightHawk475 (29956 in chips)=20
Seat 8: vincent329 (7693 in chips)=20
MM9955: posts the ante 20
BinkEquity: posts the ante 20
JJin91: posts the ante 20
SapofPine: posts the ante 20
Going2Ship: posts the ante 20
Deuxexmachen: posts the ante 20
NightHawk475: posts the ante 20
vincent329: posts the ante 20
vincent329: posts small blind 75
MM9955: posts big blind 150
*** HOLE CARDS ***
Dealt to JJin91 [5h 7d]
BinkEquity: folds=20
JJin91: folds=20
SapofPine: folds=20
Going2Ship: folds=20
Deuxexmachen: folds=20
NightHawk475: raises 226 to 376
vincent329: calls 301
MM9955: calls 226
*** FLOP *** [3c Qh 2d]
vincent329: checks=20
MM9955: checks=20
NightHawk475: bets 450
vincent329: calls 450
MM9955: calls 450
*** TURN *** [3c Qh 2d] [8h]
vincent329: checks=20
MM9955: checks=20
NightHawk475: bets 1000
vincent329: folds=20
MM9955: calls 1000
*** RIVER *** [3c Qh 2d 8h] [Ts]
MM9955: checks=20
NightHawk475: bets 2420
MM9955: folds=20
Uncalled bet (2420) returned to NightHawk475
NightHawk475 collected 4638 from pot
*** SUMMARY ***
Total pot 4638 | Rake 0=20
Board [3c Qh 2d 8h Ts]
Seat 1: MM9955 (big blind) folded on the River
Seat 2: BinkEquity folded before Flop (didn't bet)
Seat 3: JJin91 folded before Flop (didn't bet)
Seat 4: SapofPine folded before Flop (didn't bet)
Seat 5: Going2Ship folded before Flop (didn't bet)
Seat 6: Deuxexmachen folded before Flop (didn't bet)
Seat 7: NightHawk475 (button) collected (4638)
Seat 8: vincent329 (small blind) folded on the Turn


*********** # 39 **************
PokerStars Hand #171481972018: Tournament #1648956629, $18.20+$1.80 USD=
 Hold'em No Limit - Level VI (75/150) - 2017/06/20 20:03:41 ET
Table '1648956629 2' 9-max Seat #8 is the button
Seat 1: MM9955 (10909 in chips)=20
Seat 2: BinkEquity (7584 in chips)=20
Seat 3: JJin91 (9892 in chips)=20
Seat 4: SapofPine (9940 in chips)=20
Seat 5: Going2Ship (13335 in chips)=20
Seat 6: Deuxexmachen (37105 in chips)=20
Seat 7: NightHawk475 (32748 in chips)=20
Seat 8: vincent329 (6847 in chips)=20
MM9955: posts the ante 20
BinkEquity: posts the ante 20
JJin91: posts the ante 20
SapofPine: posts the ante 20
Going2Ship: posts the ante 20
Deuxexmachen: posts the ante 20
NightHawk475: posts the ante 20
vincent329: posts the ante 20
MM9955: posts small blind 75
BinkEquity: posts big blind 150
*** HOLE CARDS ***
Dealt to JJin91 [4s Ac]
JJin91: folds=20
SapofPine: folds=20
Going2Ship: folds=20
Deuxexmachen: folds=20
NightHawk475: folds=20
vincent329: folds=20
MM9955: raises 300 to 450
BinkEquity: calls 300
*** FLOP *** [7d 2s Ah]
MM9955: bets 530
BinkEquity: folds=20
Uncalled bet (530) returned to MM9955
MM9955 collected 1060 from pot
*** SUMMARY ***
Total pot 1060 | Rake 0=20
Board [7d 2s Ah]
Seat 1: MM9955 (small blind) collected (1060)
Seat 2: BinkEquity (big blind) folded on the Flop
Seat 3: JJin91 folded before Flop (didn't bet)
Seat 4: SapofPine folded before Flop (didn't bet)
Seat 5: Going2Ship folded before Flop (didn't bet)
Seat 6: Deuxexmachen folded before Flop (didn't bet)
Seat 7: NightHawk475 folded before Flop (didn't bet)
Seat 8: vincent329 (button) folded before Flop (didn't bet)


*********** # 40 **************
PokerStars Hand #171481972175: Tournament #1648956629, $18.20+$1.80 USD=
 Hold'em No Limit - Level VI (75/150) - 2017/06/20 20:04:20 ET
Table '1648956629 2' 9-max Seat #1 is the button
Seat 1: MM9955 (11499 in chips)=20
Seat 2: BinkEquity (7114 in chips)=20
Seat 3: JJin91 (9872 in chips)=20
Seat 4: SapofPine (9920 in chips)=20
Seat 5: Going2Ship (13315 in chips)=20
Seat 6: Deuxexmachen (37085 in chips)=20
Seat 7: NightHawk475 (32728 in chips)=20
Seat 8: vincent329 (6827 in chips)=20
MM9955: posts the ante 20
BinkEquity: posts the ante 20
JJin91: posts the ante 20
SapofPine: posts the ante 20
Going2Ship: posts the ante 20
Deuxexmachen: posts the ante 20
NightHawk475: posts the ante 20
vincent329: posts the ante 20
BinkEquity: posts small blind 75
JJin91: posts big blind 150
*** HOLE CARDS ***
Dealt to JJin91 [5c 8s]
SapofPine: folds=20
Going2Ship: raises 270 to 420
Deuxexmachen: folds=20
NightHawk475: folds=20
vincent329: calls 420
MM9955: folds=20
BinkEquity: folds=20
JJin91: folds=20
*** FLOP *** [5d 3c 7c]
Going2Ship: checks=20
vincent329: checks=20
*** TURN *** [5d 3c 7c] [4h]
Going2Ship: bets 600
vincent329: raises 600 to 1200
Going2Ship: raises 1200 to 2400
vincent329: raises 3987 to 6387 and is all-in
Going2Ship: calls 3987
*** RIVER *** [5d 3c 7c 4h] [Kd]
*** SHOW DOWN ***
Going2Ship: shows [Qc Qh] (a pair of Queens)
vincent329: shows [6s 9s] (a straight, Three to Seven)
vincent329 collected 13999 from pot
*** SUMMARY ***
Total pot 13999 | Rake 0=20
Board [5d 3c 7c 4h Kd]
Seat 1: MM9955 (button) folded before Flop (didn't bet)
Seat 2: BinkEquity (small blind) folded before Flop
Seat 3: JJin91 (big blind) folded before Flop
Seat 4: SapofPine folded before Flop (didn't bet)
Seat 5: Going2Ship showed [Qc Qh] and lost with a pair of Queens
Seat 6: Deuxexmachen folded before Flop (didn't bet)
Seat 7: NightHawk475 folded before Flop (didn't bet)
Seat 8: vincent329 showed [6s 9s] and won (13999) with a straight, Thre=
e to Seven


*********** # 41 **************
PokerStars Hand #171481972372: Tournament #1648956629, $18.20+$1.80 USD=
 Hold'em No Limit - Level VI (75/150) - 2017/06/20 20:05:13 ET
Table '1648956629 2' 9-max Seat #2 is the button
Seat 1: MM9955 (11479 in chips)=20
Seat 2: BinkEquity (7019 in chips)=20
Seat 3: JJin91 (9702 in chips)=20
Seat 4: SapofPine (9900 in chips)=20
Seat 5: Going2Ship (6488 in chips)=20
Seat 6: Deuxexmachen (37065 in chips)=20
Seat 7: NightHawk475 (32708 in chips)=20
Seat 8: vincent329 (13999 in chips)=20
MM9955: posts the ante 20
BinkEquity: posts the ante 20
JJin91: posts the ante 20
SapofPine: posts the ante 20
Going2Ship: posts the ante 20
Deuxexmachen: posts the ante 20
NightHawk475: posts the ante 20
vincent329: posts the ante 20
JJin91: posts small blind 75
SapofPine: posts big blind 150
*** HOLE CARDS ***
Dealt to JJin91 [6s Kc]
Going2Ship: raises 300 to 450
Deuxexmachen: folds=20
NightHawk475: folds=20
vincent329: folds=20
MM9955: folds=20
BinkEquity: folds=20
JJin91: folds=20
SapofPine: folds=20
Uncalled bet (300) returned to Going2Ship
Going2Ship collected 535 from pot
Going2Ship: doesn't show hand=20
*** SUMMARY ***
Total pot 535 | Rake 0=20
Seat 1: MM9955 folded before Flop (didn't bet)
Seat 2: BinkEquity (button) folded before Flop (didn't bet)
Seat 3: JJin91 (small blind) folded before Flop
Seat 4: SapofPine (big blind) folded before Flop
Seat 5: Going2Ship collected (535)
Seat 6: Deuxexmachen folded before Flop (didn't bet)
Seat 7: NightHawk475 folded before Flop (didn't bet)
Seat 8: vincent329 folded before Flop (didn't bet)


*********** # 42 **************
PokerStars Hand #171481972542: Tournament #1648956629, $18.20+$1.80 USD=
 Hold'em No Limit - Level VII (100/200) - 2017/06/20 20:05:55 ET
Table '1648956629 2' 9-max Seat #3 is the button
Seat 1: MM9955 (11459 in chips)=20
Seat 2: BinkEquity (6999 in chips)=20
Seat 3: JJin91 (9607 in chips)=20
Seat 4: SapofPine (9730 in chips)=20
Seat 5: Going2Ship (6853 in chips)=20
Seat 6: Deuxexmachen (37045 in chips)=20
Seat 7: NightHawk475 (32688 in chips)=20
Seat 8: vincent329 (13979 in chips)=20
MM9955: posts the ante 25
BinkEquity: posts the ante 25
JJin91: posts the ante 25
SapofPine: posts the ante 25
Going2Ship: posts the ante 25
Deuxexmachen: posts the ante 25
NightHawk475: posts the ante 25
vincent329: posts the ante 25
SapofPine: posts small blind 100
Going2Ship: posts big blind 200
*** HOLE CARDS ***
Dealt to JJin91 [3s 2h]
Deuxexmachen: folds=20
NightHawk475: folds=20
vincent329: raises 200 to 400
MM9955: folds=20
BinkEquity: folds=20
JJin91: raises 200 to 600
SapofPine: folds=20
Going2Ship: folds=20
vincent329: calls 200
*** FLOP *** [Th 2c 6s]
vincent329: checks=20
JJin91: checks=20
*** TURN *** [Th 2c 6s] [Ah]
vincent329: bets 1700
JJin91: folds=20
Uncalled bet (1700) returned to vincent329
vincent329 collected 1700 from pot
*** SUMMARY ***
Total pot 1700 | Rake 0=20
Board [Th 2c 6s Ah]
Seat 1: MM9955 folded before Flop (didn't bet)
Seat 2: BinkEquity folded before Flop (didn't bet)
Seat 3: JJin91 (button) folded on the Turn
Seat 4: SapofPine (small blind) folded before Flop
Seat 5: Going2Ship (big blind) folded before Flop
Seat 6: Deuxexmachen folded before Flop (didn't bet)
Seat 7: NightHawk475 folded before Flop (didn't bet)
Seat 8: vincent329 collected (1700)


*********** # 43 **************
PokerStars Hand #171481972722: Tournament #1648956629, $18.20+$1.80 USD=
 Hold'em No Limit - Level VII (100/200) - 2017/06/20 20:06:42 ET
Table '1648956629 2' 9-max Seat #4 is the button
Seat 1: MM9955 (11434 in chips)=20
Seat 2: BinkEquity (6974 in chips)=20
Seat 3: JJin91 (8982 in chips)=20
Seat 4: SapofPine (9605 in chips)=20
Seat 5: Going2Ship (6628 in chips)=20
Seat 6: Deuxexmachen (37020 in chips)=20
Seat 7: NightHawk475 (32663 in chips)=20
Seat 8: vincent329 (15054 in chips)=20
MM9955: posts the ante 25
BinkEquity: posts the ante 25
JJin91: posts the ante 25
SapofPine: posts the ante 25
Going2Ship: posts the ante 25
Deuxexmachen: posts the ante 25
NightHawk475: posts the ante 25
vincent329: posts the ante 25
Going2Ship: posts small blind 100
Deuxexmachen: posts big blind 200
*** HOLE CARDS ***
Dealt to JJin91 [7s 3h]
NightHawk475: folds=20
vincent329: calls 200
MM9955: folds=20
BinkEquity: folds=20
JJin91: folds=20
SapofPine: folds=20
Going2Ship: raises 800 to 1000
Deuxexmachen: folds=20
vincent329: folds=20
Uncalled bet (800) returned to Going2Ship
Going2Ship collected 800 from pot
Going2Ship: doesn't show hand=20
*** SUMMARY ***
Total pot 800 | Rake 0=20
Seat 1: MM9955 folded before Flop (didn't bet)
Seat 2: BinkEquity folded before Flop (didn't bet)
Seat 3: JJin91 folded before Flop (didn't bet)
Seat 4: SapofPine (button) folded before Flop (didn't bet)
Seat 5: Going2Ship (small blind) collected (800)
Seat 6: Deuxexmachen (big blind) folded before Flop
Seat 7: NightHawk475 folded before Flop (didn't bet)
Seat 8: vincent329 folded before Flop


*********** # 44 **************
PokerStars Hand #171481972818: Tournament #1648956629, $18.20+$1.80 USD=
 Hold'em No Limit - Level VII (100/200) - 2017/06/20 20:07:04 ET
Table '1648956629 2' 9-max Seat #5 is the button
Seat 1: MM9955 (11409 in chips)=20
Seat 2: BinkEquity (6949 in chips)=20
Seat 3: JJin91 (8957 in chips)=20
Seat 4: SapofPine (9580 in chips)=20
Seat 5: Going2Ship (7203 in chips)=20
Seat 6: Deuxexmachen (36795 in chips)=20
Seat 7: NightHawk475 (32638 in chips)=20
Seat 8: vincent329 (14829 in chips)=20
MM9955: posts the ante 25
BinkEquity: posts the ante 25
JJin91: posts the ante 25
SapofPine: posts the ante 25
Going2Ship: posts the ante 25
Deuxexmachen: posts the ante 25
NightHawk475: posts the ante 25
vincent329: posts the ante 25
Deuxexmachen: posts small blind 100
NightHawk475: posts big blind 200
*** HOLE CARDS ***
Dealt to JJin91 [6s 3d]
vincent329: folds=20
MM9955: calls 200
BinkEquity: folds=20
JJin91: folds=20
SapofPine: raises 400 to 600
Going2Ship: folds=20
Deuxexmachen: raises 2200 to 2800
NightHawk475: folds=20
MM9955: folds=20
SapofPine: folds=20
Uncalled bet (2200) returned to Deuxexmachen
Deuxexmachen collected 1800 from pot
Deuxexmachen: doesn't show hand=20
*** SUMMARY ***
Total pot 1800 | Rake 0=20
Seat 1: MM9955 folded before Flop
Seat 2: BinkEquity folded before Flop (didn't bet)
Seat 3: JJin91 folded before Flop (didn't bet)
Seat 4: SapofPine folded before Flop
Seat 5: Going2Ship (button) folded before Flop (didn't bet)
Seat 6: Deuxexmachen (small blind) collected (1800)
Seat 7: NightHawk475 (big blind) folded before Flop
Seat 8: vincent329 folded before Flop (didn't bet)


*********** # 45 **************
PokerStars Hand #171481973093: Tournament #1648956629, $18.20+$1.80 USD=
 Hold'em No Limit - Level VII (100/200) - 2017/06/20 20:08:07 ET
Table '1648956629 2' 9-max Seat #6 is the button
Seat 1: MM9955 (11184 in chips)=20
Seat 2: BinkEquity (6924 in chips)=20
Seat 3: JJin91 (8932 in chips)=20
Seat 4: SapofPine (8955 in chips)=20
Seat 5: Going2Ship (7178 in chips)=20
Seat 6: Deuxexmachen (37970 in chips)=20
Seat 7: NightHawk475 (32413 in chips)=20
Seat 8: vincent329 (14804 in chips)=20
Seat 9: Scooby-D0O (10000 in chips)=20
MM9955: posts the ante 25
BinkEquity: posts the ante 25
JJin91: posts the ante 25
SapofPine: posts the ante 25
Going2Ship: posts the ante 25
Deuxexmachen: posts the ante 25
NightHawk475: posts the ante 25
vincent329: posts the ante 25
Scooby-D0O: posts the ante 25
NightHawk475: posts small blind 100
vincent329: posts big blind 200
*** HOLE CARDS ***
Dealt to JJin91 [5h 9h]
Scooby-D0O: folds=20
MM9955: folds=20
BinkEquity: raises 354 to 554
JJin91: folds=20
SapofPine: folds=20
Going2Ship: folds=20
Deuxexmachen: folds=20
NightHawk475: folds=20
vincent329: calls 354
*** FLOP *** [Th 7s Ac]
vincent329: checks=20
BinkEquity: bets 479
vincent329: folds=20
Uncalled bet (479) returned to BinkEquity
BinkEquity collected 1433 from pot
*** SUMMARY ***
Total pot 1433 | Rake 0=20
Board [Th 7s Ac]
Seat 1: MM9955 folded before Flop (didn't bet)
Seat 2: BinkEquity collected (1433)
Seat 3: JJin91 folded before Flop (didn't bet)
Seat 4: SapofPine folded before Flop (didn't bet)
Seat 5: Going2Ship folded before Flop (didn't bet)
Seat 6: Deuxexmachen (button) folded before Flop (didn't bet)
Seat 7: NightHawk475 (small blind) folded before Flop
Seat 8: vincent329 (big blind) folded on the Flop
Seat 9: Scooby-D0O folded before Flop (didn't bet)


*********** # 46 **************
PokerStars Hand #171481973301: Tournament #1648956629, $18.20+$1.80 USD=
 Hold'em No Limit - Level VII (100/200) - 2017/06/20 20:08:58 ET
Table '1648956629 2' 9-max Seat #7 is the button
Seat 1: MM9955 (11159 in chips)=20
Seat 2: BinkEquity (7778 in chips)=20
Seat 3: JJin91 (8907 in chips)=20
Seat 4: SapofPine (8930 in chips)=20
Seat 5: Going2Ship (7153 in chips)=20
Seat 6: Deuxexmachen (37945 in chips)=20
Seat 7: NightHawk475 (32288 in chips)=20
Seat 8: vincent329 (14225 in chips)=20
Seat 9: Scooby-D0O (9975 in chips)=20
MM9955: posts the ante 25
BinkEquity: posts the ante 25
JJin91: posts the ante 25
SapofPine: posts the ante 25
Going2Ship: posts the ante 25
Deuxexmachen: posts the ante 25
NightHawk475: posts the ante 25
vincent329: posts the ante 25
Scooby-D0O: posts the ante 25
vincent329: posts small blind 100
Scooby-D0O: posts big blind 200
*** HOLE CARDS ***
Dealt to JJin91 [Jh Ad]
MM9955: folds=20
BinkEquity: folds=20
JJin91: raises 275 to 475
SapofPine: folds=20
Going2Ship: folds=20
Deuxexmachen: folds=20
NightHawk475: folds=20
vincent329: folds=20
Scooby-D0O: folds=20
Uncalled bet (275) returned to JJin91
JJin91 collected 725 from pot
JJin91: doesn't show hand=20
*** SUMMARY ***
Total pot 725 | Rake 0=20
Seat 1: MM9955 folded before Flop (didn't bet)
Seat 2: BinkEquity folded before Flop (didn't bet)
Seat 3: JJin91 collected (725)
Seat 4: SapofPine folded before Flop (didn't bet)
Seat 5: Going2Ship folded before Flop (didn't bet)
Seat 6: Deuxexmachen folded before Flop (didn't bet)
Seat 7: NightHawk475 (button) folded before Flop (didn't bet)
Seat 8: vincent329 (small blind) folded before Flop
Seat 9: Scooby-D0O (big blind) folded before Flop


*********** # 47 **************
PokerStars Hand #171481973421: Tournament #1648956629, $18.20+$1.80 USD=
 Hold'em No Limit - Level VII (100/200) - 2017/06/20 20:09:28 ET
Table '1648956629 2' 9-max Seat #8 is the button
Seat 1: MM9955 (11134 in chips)=20
Seat 2: BinkEquity (7753 in chips)=20
Seat 3: JJin91 (9407 in chips)=20
Seat 4: SapofPine (8905 in chips)=20
Seat 5: Going2Ship (7128 in chips)=20
Seat 6: Deuxexmachen (37920 in chips)=20
Seat 7: NightHawk475 (32263 in chips)=20
Seat 8: vincent329 (14100 in chips)=20
Seat 9: Scooby-D0O (9750 in chips)=20
MM9955: posts the ante 25
BinkEquity: posts the ante 25
JJin91: posts the ante 25
SapofPine: posts the ante 25
Going2Ship: posts the ante 25
Deuxexmachen: posts the ante 25
NightHawk475: posts the ante 25
vincent329: posts the ante 25
Scooby-D0O: posts the ante 25
Scooby-D0O: posts small blind 100
MM9955: posts big blind 200
*** HOLE CARDS ***
Dealt to JJin91 [3h 5c]
BinkEquity: folds=20
JJin91: folds=20
SapofPine: folds=20
Going2Ship: folds=20
Deuxexmachen: raises 400 to 600
NightHawk475: folds=20
vincent329: calls 600
Scooby-D0O: calls 500
MM9955: calls 400
*** FLOP *** [2s 5s 2d]
Scooby-D0O: checks=20
MM9955: bets 1000
Deuxexmachen: raises 2313 to 3313
vincent329: folds=20
Scooby-D0O: folds=20
NightHawk475 is sitting out
MM9955: raises 7196 to 10509 and is all-in
Deuxexmachen: calls 7196
*** TURN *** [2s 5s 2d] [8h]
*** RIVER *** [2s 5s 2d 8h] [Js]
*** SHOW DOWN ***
MM9955: shows [4h 4c] (two pair, Fours and Deuces)
Deuxexmachen: shows [As Ad] (two pair, Aces and Deuces)
Deuxexmachen collected 23643 from pot
MM9955 finished the tournament in 80th place
*** SUMMARY ***
Total pot 23643 | Rake 0=20
Board [2s 5s 2d 8h Js]
Seat 1: MM9955 (big blind) showed [4h 4c] and lost with two pair, Fours=
 and Deuces
Seat 2: BinkEquity folded before Flop (didn't bet)
Seat 3: JJin91 folded before Flop (didn't bet)
Seat 4: SapofPine folded before Flop (didn't bet)
Seat 5: Going2Ship folded before Flop (didn't bet)
Seat 6: Deuxexmachen showed [As Ad] and won (23643) with two pair, Aces=
 and Deuces
Seat 7: NightHawk475 folded before Flop (didn't bet)
Seat 8: vincent329 (button) folded on the Flop
Seat 9: Scooby-D0O (small blind) folded on the Flop


*********** # 48 **************
PokerStars Hand #171481973740: Tournament #1648956629, $18.20+$1.80 USD=
 Hold'em No Limit - Level VII (100/200) - 2017/06/20 20:10:43 ET
Table '1648956629 2' 9-max Seat #9 is the button
Seat 2: BinkEquity (7728 in chips)=20
Seat 3: JJin91 (9382 in chips)=20
Seat 4: SapofPine (8880 in chips)=20
Seat 5: Going2Ship (7103 in chips)=20
Seat 6: Deuxexmachen (50429 in chips)=20
Seat 7: NightHawk475 (32238 in chips) is sitting out
Seat 8: vincent329 (13475 in chips)=20
Seat 9: Scooby-D0O (9125 in chips)=20
BinkEquity: posts the ante 25
JJin91: posts the ante 25
SapofPine: posts the ante 25
Going2Ship: posts the ante 25
Deuxexmachen: posts the ante 25
NightHawk475: posts the ante 25
vincent329: posts the ante 25
Scooby-D0O: posts the ante 25
BinkEquity: posts small blind 100
JJin91: posts big blind 200
*** HOLE CARDS ***
Dealt to JJin91 [2h Ah]
SapofPine: folds=20
Going2Ship: folds=20
Deuxexmachen: folds=20
NightHawk475: folds=20
vincent329: raises 200 to 400
Scooby-D0O: folds=20
BinkEquity: folds=20
JJin91: calls 200
*** FLOP *** [8c 5s 8s]
JJin91: checks=20
vincent329: bets 1100
JJin91: calls 1100
*** TURN *** [8c 5s 8s] [Qs]
JJin91: checks=20
vincent329: checks=20
*** RIVER *** [8c 5s 8s Qs] [Js]
JJin91: bets 1130
NightHawk475 has returned
vincent329: raises 1130 to 2260
JJin91: folds=20
Uncalled bet (1130) returned to vincent329
vincent329 collected 5560 from pot
*** SUMMARY ***
Total pot 5560 | Rake 0=20
Board [8c 5s 8s Qs Js]
Seat 2: BinkEquity (small blind) folded before Flop
Seat 3: JJin91 (big blind) folded on the River
Seat 4: SapofPine folded before Flop (didn't bet)
Seat 5: Going2Ship folded before Flop (didn't bet)
Seat 6: Deuxexmachen folded before Flop (didn't bet)
Seat 7: NightHawk475 folded before Flop (didn't bet)
Seat 8: vincent329 collected (5560)
Seat 9: Scooby-D0O (button) folded before Flop (didn't bet)


*********** # 49 **************
PokerStars Hand #171481974063: Tournament #1648956629, $18.20+$1.80 USD=
 Hold'em No Limit - Level VII (100/200) - 2017/06/20 20:12:02 ET
Table '1648956629 2' 9-max Seat #2 is the button
Seat 2: BinkEquity (7603 in chips)=20
Seat 3: JJin91 (6727 in chips)=20
Seat 4: SapofPine (8855 in chips)=20
Seat 5: Going2Ship (7078 in chips)=20
Seat 6: Deuxexmachen (50404 in chips)=20
Seat 7: NightHawk475 (32213 in chips)=20
Seat 8: vincent329 (16380 in chips)=20
Seat 9: Scooby-D0O (9100 in chips)=20
BinkEquity: posts the ante 25
JJin91: posts the ante 25
SapofPine: posts the ante 25
Going2Ship: posts the ante 25
Deuxexmachen: posts the ante 25
NightHawk475: posts the ante 25
vincent329: posts the ante 25
Scooby-D0O: posts the ante 25
JJin91: posts small blind 100
SapofPine: posts big blind 200
*** HOLE CARDS ***
Dealt to JJin91 [8d Jd]
Going2Ship: raises 200 to 400
Deuxexmachen: calls 400
NightHawk475: folds=20
vincent329: folds=20
Scooby-D0O: calls 400
BinkEquity: calls 400
JJin91: calls 300
SapofPine: folds=20
*** FLOP *** [Ad 3s 5d]
JJin91: checks=20
Going2Ship: checks=20
Deuxexmachen: checks=20
Scooby-D0O: checks=20
BinkEquity: bets 1608
JJin91: raises 4694 to 6302 and is all-in
Going2Ship: folds=20
Deuxexmachen: folds=20
Scooby-D0O: folds=20
BinkEquity: calls 4694
*** TURN *** [Ad 3s 5d] [7c]
*** RIVER *** [Ad 3s 5d 7c] [4d]
*** SHOW DOWN ***
JJin91: shows [8d Jd] (a flush, Ace high)
BinkEquity: shows [Ah 9h] (a pair of Aces)
JJin91 collected 15004 from pot
*** SUMMARY ***
Total pot 15004 | Rake 0=20
Board [Ad 3s 5d 7c 4d]
Seat 2: BinkEquity (button) showed [Ah 9h] and lost with a pair of Aces
Seat 3: JJin91 (small blind) showed [8d Jd] and won (15004) with a flus=
h, Ace high
Seat 4: SapofPine (big blind) folded before Flop
Seat 5: Going2Ship folded on the Flop
Seat 6: Deuxexmachen folded on the Flop
Seat 7: NightHawk475 folded before Flop (didn't bet)
Seat 8: vincent329 folded before Flop (didn't bet)
Seat 9: Scooby-D0O folded on the Flop


*********** # 50 **************
PokerStars Hand #171481974389: Tournament #1648956629, $18.20+$1.80 USD=
 Hold'em No Limit - Level VII (100/200) - 2017/06/20 20:13:20 ET
Table '1648956629 2' 9-max Seat #3 is the button
Seat 2: BinkEquity (876 in chips)=20
Seat 3: JJin91 (15004 in chips)=20
Seat 4: SapofPine (8630 in chips)=20
Seat 5: Going2Ship (6653 in chips)=20
Seat 6: Deuxexmachen (49979 in chips)=20
Seat 7: NightHawk475 (32188 in chips)=20
Seat 8: vincent329 (16355 in chips)=20
Seat 9: Scooby-D0O (8675 in chips)=20
BinkEquity: posts the ante 25
JJin91: posts the ante 25
SapofPine: posts the ante 25
Going2Ship: posts the ante 25
Deuxexmachen: posts the ante 25
NightHawk475: posts the ante 25
vincent329: posts the ante 25
Scooby-D0O: posts the ante 25
SapofPine: posts small blind 100
Going2Ship: posts big blind 200
*** HOLE CARDS ***
Dealt to JJin91 [9h Qh]
Deuxexmachen: folds=20
NightHawk475: folds=20
vincent329: folds=20
Scooby-D0O: folds=20
BinkEquity: folds=20
JJin91: raises 277 to 477
SapofPine: folds=20
Going2Ship: folds=20
Uncalled bet (277) returned to JJin91
JJin91 collected 700 from pot
JJin91: doesn't show hand=20
*** SUMMARY ***
Total pot 700 | Rake 0=20
Seat 2: BinkEquity folded before Flop (didn't bet)
Seat 3: JJin91 (button) collected (700)
Seat 4: SapofPine (small blind) folded before Flop
Seat 5: Going2Ship (big blind) folded before Flop
Seat 6: Deuxexmachen folded before Flop (didn't bet)
Seat 7: NightHawk475 folded before Flop (didn't bet)
Seat 8: vincent329 folded before Flop (didn't bet)
Seat 9: Scooby-D0O folded before Flop (didn't bet)


*********** # 51 **************
PokerStars Hand #171481974520: Tournament #1648956629, $18.20+$1.80 USD=
 Hold'em No Limit - Level VII (100/200) - 2017/06/20 20:13:50 ET
Table '1648956629 2' 9-max Seat #4 is the button
Seat 1: VagColeSlaw (10000 in chips)=20
Seat 2: BinkEquity (851 in chips)=20
Seat 3: JJin91 (15479 in chips)=20
Seat 4: SapofPine (8505 in chips)=20
Seat 5: Going2Ship (6428 in chips)=20
Seat 6: Deuxexmachen (49954 in chips)=20
Seat 7: NightHawk475 (32163 in chips)=20
Seat 8: vincent329 (16330 in chips)=20
Seat 9: Scooby-D0O (8650 in chips)=20
VagColeSlaw: posts the ante 25
BinkEquity: posts the ante 25
JJin91: posts the ante 25
SapofPine: posts the ante 25
Going2Ship: posts the ante 25
Deuxexmachen: posts the ante 25
NightHawk475: posts the ante 25
vincent329: posts the ante 25
Scooby-D0O: posts the ante 25
Going2Ship: posts small blind 100
Deuxexmachen: posts big blind 200
*** HOLE CARDS ***
Dealt to JJin91 [Kc 3s]
NightHawk475: folds=20
vincent329: calls 200
Scooby-D0O: folds=20
VagColeSlaw: calls 200
BinkEquity: folds=20
JJin91: folds=20
SapofPine: folds=20
Going2Ship: folds=20
Deuxexmachen: checks=20
*** FLOP *** [9c 5s 5h]
Deuxexmachen: checks=20
vincent329: bets 925
VagColeSlaw: calls 925
Deuxexmachen: folds=20
*** TURN *** [9c 5s 5h] [6s]
vincent329: bets 800
VagColeSlaw: raises 800 to 1600
vincent329: calls 800
*** RIVER *** [9c 5s 5h 6s] [2h]
vincent329: checks=20
VagColeSlaw: bets 7250 and is all-in
vincent329: folds=20
Uncalled bet (7250) returned to VagColeSlaw
VagColeSlaw collected 5975 from pot
VagColeSlaw: doesn't show hand=20
*** SUMMARY ***
Total pot 5975 | Rake 0=20
Board [9c 5s 5h 6s 2h]
Seat 1: VagColeSlaw collected (5975)
Seat 2: BinkEquity folded before Flop (didn't bet)
Seat 3: JJin91 folded before Flop (didn't bet)
Seat 4: SapofPine (button) folded before Flop (didn't bet)
Seat 5: Going2Ship (small blind) folded before Flop
Seat 6: Deuxexmachen (big blind) folded on the Flop
Seat 7: NightHawk475 folded before Flop (didn't bet)
Seat 8: vincent329 folded on the River
Seat 9: Scooby-D0O folded before Flop (didn't bet)


*********** # 52 **************
PokerStars Hand #171481974752: Tournament #1648956629, $18.20+$1.80 USD=
 Hold'em No Limit - Level VII (100/200) - 2017/06/20 20:14:47 ET
Table '1648956629 2' 9-max Seat #5 is the button
Seat 1: VagColeSlaw (13225 in chips)=20
Seat 2: BinkEquity (826 in chips)=20
Seat 3: JJin91 (15454 in chips)=20
Seat 4: SapofPine (8480 in chips)=20
Seat 5: Going2Ship (6303 in chips)=20
Seat 6: Deuxexmachen (49729 in chips)=20
Seat 7: NightHawk475 (32138 in chips)=20
Seat 8: vincent329 (13580 in chips)=20
Seat 9: Scooby-D0O (8625 in chips)=20
VagColeSlaw: posts the ante 25
BinkEquity: posts the ante 25
JJin91: posts the ante 25
SapofPine: posts the ante 25
Going2Ship: posts the ante 25
Deuxexmachen: posts the ante 25
NightHawk475: posts the ante 25
vincent329: posts the ante 25
Scooby-D0O: posts the ante 25
Deuxexmachen: posts small blind 100
NightHawk475: posts big blind 200
*** HOLE CARDS ***
Dealt to JJin91 [4c 9c]
vincent329: folds=20
Scooby-D0O: raises 300 to 500
VagColeSlaw: folds=20
BinkEquity: folds=20
JJin91: folds=20
SapofPine: folds=20
Going2Ship: folds=20
Deuxexmachen: folds=20
NightHawk475: calls 300
*** FLOP *** [9d Qd Tc]
NightHawk475: checks=20
Scooby-D0O: bets 583
NightHawk475: raises 1420 to 2003
Scooby-D0O: folds=20
Uncalled bet (1420) returned to NightHawk475
NightHawk475 collected 2491 from pot
NightHawk475: doesn't show hand=20
*** SUMMARY ***
Total pot 2491 | Rake 0=20
Board [9d Qd Tc]
Seat 1: VagColeSlaw folded before Flop (didn't bet)
Seat 2: BinkEquity folded before Flop (didn't bet)
Seat 3: JJin91 folded before Flop (didn't bet)
Seat 4: SapofPine folded before Flop (didn't bet)
Seat 5: Going2Ship (button) folded before Flop (didn't bet)
Seat 6: Deuxexmachen (small blind) folded before Flop
Seat 7: NightHawk475 (big blind) collected (2491)
Seat 8: vincent329 folded before Flop (didn't bet)
Seat 9: Scooby-D0O folded on the Flop


*********** # 53 **************
PokerStars Hand #171481975142: Tournament #1648956629, $18.20+$1.80 USD=
 Hold'em No Limit - Level VIII (125/250) - 2017/06/20 20:16:27 ET
Table '1648956629 2' 9-max Seat #6 is the button
Seat 1: VagColeSlaw (13200 in chips)=20
Seat 2: BinkEquity (801 in chips)=20
Seat 3: JJin91 (15429 in chips)=20
Seat 4: SapofPine (8455 in chips)=20
Seat 5: Going2Ship (6278 in chips)=20
Seat 6: Deuxexmachen (49604 in chips)=20
Seat 7: NightHawk475 (33521 in chips)=20
Seat 8: vincent329 (13555 in chips)=20
VagColeSlaw: posts the ante 30
BinkEquity: posts the ante 30
JJin91: posts the ante 30
SapofPine: posts the ante 30
Going2Ship: posts the ante 30
Deuxexmachen: posts the ante 30
NightHawk475: posts the ante 30
vincent329: posts the ante 30
NightHawk475: posts small blind 125
vincent329: posts big blind 250
*** HOLE CARDS ***
Dealt to JJin91 [8h 7d]
VagColeSlaw: raises 250 to 500
BinkEquity: raises 271 to 771 and is all-in
JJin91: folds=20
SapofPine: folds=20
Going2Ship: folds=20
Deuxexmachen: folds=20
NightHawk475: folds=20
vincent329: calls 521
VagColeSlaw: raises 12399 to 13170 and is all-in
vincent329: folds=20
Uncalled bet (12399) returned to VagColeSlaw
*** FLOP *** [Kc 5c Qs]
*** TURN *** [Kc 5c Qs] [Jh]
*** RIVER *** [Kc 5c Qs Jh] [Qc]
*** SHOW DOWN ***
VagColeSlaw: shows [Jd Js] (a full house, Jacks full of Queens)
BinkEquity: shows [Qd 9s] (three of a kind, Queens)
VagColeSlaw collected 2678 from pot
BinkEquity finished the tournament in 74th place
*** SUMMARY ***
Total pot 2678 | Rake 0=20
Board [Kc 5c Qs Jh Qc]
Seat 1: VagColeSlaw showed [Jd Js] and won (2678) with a full house, Ja=
cks full of Queens
Seat 2: BinkEquity showed [Qd 9s] and lost with three of a kind, Queens
Seat 3: JJin91 folded before Flop (didn't bet)
Seat 4: SapofPine folded before Flop (didn't bet)
Seat 5: Going2Ship folded before Flop (didn't bet)
Seat 6: Deuxexmachen (button) folded before Flop (didn't bet)
Seat 7: NightHawk475 (small blind) folded before Flop
Seat 8: vincent329 (big blind) folded before Flop


*********** # 54 **************
PokerStars Hand #171481975308: Tournament #1648956629, $18.20+$1.80 USD=
 Hold'em No Limit - Level VIII (125/250) - 2017/06/20 20:17:11 ET
Table '1648956629 2' 9-max Seat #7 is the button
Seat 1: VagColeSlaw (15077 in chips)=20
Seat 3: JJin91 (15399 in chips)=20
Seat 4: SapofPine (8425 in chips)=20
Seat 5: Going2Ship (6248 in chips)=20
Seat 6: Deuxexmachen (49574 in chips)=20
Seat 7: NightHawk475 (33366 in chips)=20
Seat 8: vincent329 (12754 in chips)=20
VagColeSlaw: posts the ante 30
JJin91: posts the ante 30
SapofPine: posts the ante 30
Going2Ship: posts the ante 30
Deuxexmachen: posts the ante 30
NightHawk475: posts the ante 30
vincent329: posts the ante 30
vincent329: posts small blind 125
VagColeSlaw: posts big blind 250
*** HOLE CARDS ***
Dealt to JJin91 [Kd 8s]
JJin91: folds=20
SapofPine: folds=20
Going2Ship: folds=20
Deuxexmachen: folds=20
NightHawk475: folds=20
vincent329: raises 250 to 500
VagColeSlaw: folds=20
Uncalled bet (250) returned to vincent329
vincent329 collected 710 from pot
*** SUMMARY ***
Total pot 710 | Rake 0=20
Seat 1: VagColeSlaw (big blind) folded before Flop
Seat 3: JJin91 folded before Flop (didn't bet)
Seat 4: SapofPine folded before Flop (didn't bet)
Seat 5: Going2Ship folded before Flop (didn't bet)
Seat 6: Deuxexmachen folded before Flop (didn't bet)
Seat 7: NightHawk475 (button) folded before Flop (didn't bet)
Seat 8: vincent329 (small blind) collected (710)


*********** # 55 **************
PokerStars Hand #171481975439: Tournament #1648956629, $18.20+$1.80 USD=
 Hold'em No Limit - Level VIII (125/250) - 2017/06/20 20:17:46 ET
Table '1648956629 2' 9-max Seat #8 is the button
Seat 1: VagColeSlaw (14797 in chips)=20
Seat 3: JJin91 (15369 in chips)=20
Seat 4: SapofPine (8395 in chips)=20
Seat 5: Going2Ship (6218 in chips)=20
Seat 6: Deuxexmachen (49544 in chips)=20
Seat 7: NightHawk475 (33336 in chips)=20
Seat 8: vincent329 (13184 in chips)=20
Seat 9: y3nk_ (2977 in chips) out of hand (moved from another table int=
o small blind)
VagColeSlaw: posts the ante 30
JJin91: posts the ante 30
SapofPine: posts the ante 30
Going2Ship: posts the ante 30
Deuxexmachen: posts the ante 30
NightHawk475: posts the ante 30
vincent329: posts the ante 30
VagColeSlaw: posts small blind 125
JJin91: posts big blind 250
*** HOLE CARDS ***
Dealt to JJin91 [Ac Jh]
SapofPine: folds=20
Going2Ship: folds=20
Deuxexmachen: folds=20
NightHawk475: raises 325 to 575
vincent329: calls 575
VagColeSlaw: folds=20
JJin91: calls 325
*** FLOP *** [2c 6h 7h]
JJin91: checks=20
NightHawk475: bets 968
vincent329: calls 968
JJin91: calls 968
*** TURN *** [2c 6h 7h] [8h]
JJin91: checks=20
NightHawk475: bets 2829
vincent329: calls 2829
JJin91: folds=20
*** RIVER *** [2c 6h 7h 8h] [Qh]
NightHawk475: checks=20
vincent329: bets 2250
NightHawk475: calls 2250
*** SHOW DOWN ***
vincent329: shows [Qs Ah] (a flush, Ace high)
NightHawk475: mucks hand=20
vincent329 collected 15122 from pot
*** SUMMARY ***
Total pot 15122 | Rake 0=20
Board [2c 6h 7h 8h Qh]
Seat 1: VagColeSlaw (small blind) folded before Flop
Seat 3: JJin91 (big blind) folded on the Turn
Seat 4: SapofPine folded before Flop (didn't bet)
Seat 5: Going2Ship folded before Flop (didn't bet)
Seat 6: Deuxexmachen folded before Flop (didn't bet)
Seat 7: NightHawk475 mucked [As Th]
Seat 8: vincent329 (button) showed [Qs Ah] and won (15122) with a flush=
, Ace high


*********** # 56 **************
PokerStars Hand #171481975802: Tournament #1648956629, $18.20+$1.80 USD=
 Hold'em No Limit - Level VIII (125/250) - 2017/06/20 20:19:17 ET
Table '1648956629 2' 9-max Seat #1 is the button
Seat 1: VagColeSlaw (14642 in chips)=20
Seat 2: Mr Hero76 (10000 in chips) out of hand (moved from another tabl=
e into small blind)
Seat 3: JJin91 (13796 in chips)=20
Seat 4: SapofPine (8365 in chips)=20
Seat 5: Going2Ship (6188 in chips)=20
Seat 6: Deuxexmachen (49514 in chips)=20
Seat 7: NightHawk475 (26684 in chips)=20
Seat 8: vincent329 (21654 in chips)=20
Seat 9: y3nk_ (2977 in chips)=20
VagColeSlaw: posts the ante 30
JJin91: posts the ante 30
SapofPine: posts the ante 30
Going2Ship: posts the ante 30
Deuxexmachen: posts the ante 30
NightHawk475: posts the ante 30
vincent329: posts the ante 30
y3nk_: posts the ante 30
JJin91: posts small blind 125
SapofPine: posts big blind 250
*** HOLE CARDS ***
Dealt to JJin91 [2c 3c]
Going2Ship: folds=20
Deuxexmachen: folds=20
NightHawk475: folds=20
vincent329: calls 250
y3nk_: folds=20
VagColeSlaw: raises 500 to 750
JJin91: folds=20
SapofPine: folds=20
vincent329: calls 500
*** FLOP *** [4d Ad 4c]
vincent329: checks=20
VagColeSlaw: bets 1250
vincent329: folds=20
Uncalled bet (1250) returned to VagColeSlaw
VagColeSlaw collected 2115 from pot
VagColeSlaw: doesn't show hand=20
*** SUMMARY ***
Total pot 2115 | Rake 0=20
Board [4d Ad 4c]
Seat 1: VagColeSlaw (button) collected (2115)
Seat 3: JJin91 (small blind) folded before Flop
Seat 4: SapofPine (big blind) folded before Flop
Seat 5: Going2Ship folded before Flop (didn't bet)
Seat 6: Deuxexmachen folded before Flop (didn't bet)
Seat 7: NightHawk475 folded before Flop (didn't bet)
Seat 8: vincent329 folded on the Flop
Seat 9: y3nk_ folded before Flop (didn't bet)


*********** # 57 **************
PokerStars Hand #171481975983: Tournament #1648956629, $18.20+$1.80 USD=
 Hold'em No Limit - Level VIII (125/250) - 2017/06/20 20:19:58 ET
Table '1648956629 2' 9-max Seat #3 is the button
Seat 1: VagColeSlaw (15977 in chips)=20
Seat 2: Mr Hero76 (10000 in chips)=20
Seat 3: JJin91 (13641 in chips)=20
Seat 4: SapofPine (8085 in chips)=20
Seat 5: Going2Ship (6158 in chips)=20
Seat 6: Deuxexmachen (49484 in chips)=20
Seat 7: NightHawk475 (26654 in chips)=20
Seat 8: vincent329 (20874 in chips)=20
Seat 9: y3nk_ (2947 in chips)=20
VagColeSlaw: posts the ante 30
Mr Hero76: posts the ante 30
JJin91: posts the ante 30
SapofPine: posts the ante 30
Going2Ship: posts the ante 30
Deuxexmachen: posts the ante 30
NightHawk475: posts the ante 30
vincent329: posts the ante 30
y3nk_: posts the ante 30
SapofPine: posts small blind 125
Going2Ship: posts big blind 250
*** HOLE CARDS ***
Dealt to JJin91 [Th 7s]
Deuxexmachen: folds=20
NightHawk475: folds=20
vincent329: raises 500 to 750
y3nk_: folds=20
VagColeSlaw: folds=20
Mr Hero76: folds=20
JJin91: folds=20
SapofPine: folds=20
Going2Ship: folds=20
Uncalled bet (500) returned to vincent329
vincent329 collected 895 from pot
*** SUMMARY ***
Total pot 895 | Rake 0=20
Seat 1: VagColeSlaw folded before Flop (didn't bet)
Seat 2: Mr Hero76 folded before Flop (didn't bet)
Seat 3: JJin91 (button) folded before Flop (didn't bet)
Seat 4: SapofPine (small blind) folded before Flop
Seat 5: Going2Ship (big blind) folded before Flop
Seat 6: Deuxexmachen folded before Flop (didn't bet)
Seat 7: NightHawk475 folded before Flop (didn't bet)
Seat 8: vincent329 collected (895)
Seat 9: y3nk_ folded before Flop (didn't bet)


*********** # 58 **************
PokerStars Hand #171481976142: Tournament #1648956629, $18.20+$1.80 USD=
 Hold'em No Limit - Level VIII (125/250) - 2017/06/20 20:20:38 ET
Table '1648956629 2' 9-max Seat #4 is the button
Seat 1: VagColeSlaw (15947 in chips)=20
Seat 2: Mr Hero76 (9970 in chips)=20
Seat 3: JJin91 (13611 in chips)=20
Seat 4: SapofPine (7930 in chips)=20
Seat 5: Going2Ship (5878 in chips)=20
Seat 6: Deuxexmachen (49454 in chips)=20
Seat 7: NightHawk475 (26624 in chips)=20
Seat 8: vincent329 (21489 in chips)=20
Seat 9: y3nk_ (2917 in chips)=20
VagColeSlaw: posts the ante 30
Mr Hero76: posts the ante 30
JJin91: posts the ante 30
SapofPine: posts the ante 30
Going2Ship: posts the ante 30
Deuxexmachen: posts the ante 30
NightHawk475: posts the ante 30
vincent329: posts the ante 30
y3nk_: posts the ante 30
Going2Ship: posts small blind 125
Deuxexmachen: posts big blind 250
*** HOLE CARDS ***
Dealt to JJin91 [6c 7h]
NightHawk475: folds=20
vincent329: calls 250
y3nk_: folds=20
VagColeSlaw: folds=20
Mr Hero76: folds=20
JJin91: folds=20
SapofPine: folds=20
Going2Ship: folds=20
Deuxexmachen: checks=20
*** FLOP *** [4s Ts 8d]
Deuxexmachen: checks=20
vincent329: bets 448
Deuxexmachen: folds=20
Uncalled bet (448) returned to vincent329
vincent329 collected 895 from pot
*** SUMMARY ***
Total pot 895 | Rake 0=20
Board [4s Ts 8d]
Seat 1: VagColeSlaw folded before Flop (didn't bet)
Seat 2: Mr Hero76 folded before Flop (didn't bet)
Seat 3: JJin91 folded before Flop (didn't bet)
Seat 4: SapofPine (button) folded before Flop (didn't bet)
Seat 5: Going2Ship (small blind) folded before Flop
Seat 6: Deuxexmachen (big blind) folded on the Flop
Seat 7: NightHawk475 folded before Flop (didn't bet)
Seat 8: vincent329 collected (895)
Seat 9: y3nk_ folded before Flop (didn't bet)


*********** # 59 **************
PokerStars Hand #171481976355: Tournament #1648956629, $18.20+$1.80 USD=
 Hold'em No Limit - Level VIII (125/250) - 2017/06/20 20:21:25 ET
Table '1648956629 2' 9-max Seat #5 is the button
Seat 1: VagColeSlaw (15917 in chips)=20
Seat 2: Mr Hero76 (9940 in chips)=20
Seat 3: JJin91 (13581 in chips)=20
Seat 4: SapofPine (7900 in chips)=20
Seat 5: Going2Ship (5723 in chips)=20
Seat 6: Deuxexmachen (49174 in chips)=20
Seat 7: NightHawk475 (26594 in chips)=20
Seat 8: vincent329 (22104 in chips)=20
Seat 9: y3nk_ (2887 in chips)=20
VagColeSlaw: posts the ante 30
Mr Hero76: posts the ante 30
JJin91: posts the ante 30
SapofPine: posts the ante 30
Going2Ship: posts the ante 30
Deuxexmachen: posts the ante 30
NightHawk475: posts the ante 30
vincent329: posts the ante 30
y3nk_: posts the ante 30
Deuxexmachen: posts small blind 125
NightHawk475: posts big blind 250
*** HOLE CARDS ***
Dealt to JJin91 [5c 5s]
vincent329: raises 250 to 500
y3nk_: folds=20
VagColeSlaw: folds=20
Mr Hero76: folds=20
JJin91: raises 1366 to 1866
SapofPine: folds=20
Going2Ship: folds=20
Deuxexmachen: raises 4752 to 6618
NightHawk475: folds=20
vincent329: folds=20
JJin91: folds=20
Uncalled bet (4752) returned to Deuxexmachen
Deuxexmachen collected 4752 from pot
Deuxexmachen: doesn't show hand=20
*** SUMMARY ***
Total pot 4752 | Rake 0=20
Seat 1: VagColeSlaw folded before Flop (didn't bet)
Seat 2: Mr Hero76 folded before Flop (didn't bet)
Seat 3: JJin91 folded before Flop
Seat 4: SapofPine folded before Flop (didn't bet)
Seat 5: Going2Ship (button) folded before Flop (didn't bet)
Seat 6: Deuxexmachen (small blind) collected (4752)
Seat 7: NightHawk475 (big blind) folded before Flop
Seat 8: vincent329 folded before Flop
Seat 9: y3nk_ folded before Flop (didn't bet)


*********** # 60 **************
PokerStars Hand #171481976536: Tournament #1648956629, $18.20+$1.80 USD=
 Hold'em No Limit - Level VIII (125/250) - 2017/06/20 20:22:11 ET
Table '1648956629 2' 9-max Seat #6 is the button
Seat 1: VagColeSlaw (15887 in chips)=20
Seat 2: Mr Hero76 (9910 in chips)=20
Seat 3: JJin91 (11685 in chips)=20
Seat 4: SapofPine (7870 in chips)=20
Seat 5: Going2Ship (5693 in chips)=20
Seat 6: Deuxexmachen (52030 in chips)=20
Seat 7: NightHawk475 (26314 in chips)=20
Seat 8: vincent329 (21574 in chips)=20
Seat 9: y3nk_ (2857 in chips)=20
VagColeSlaw: posts the ante 30
Mr Hero76: posts the ante 30
JJin91: posts the ante 30
SapofPine: posts the ante 30
Going2Ship: posts the ante 30
Deuxexmachen: posts the ante 30
NightHawk475: posts the ante 30
vincent329: posts the ante 30
y3nk_: posts the ante 30
NightHawk475: posts small blind 125
vincent329: posts big blind 250
*** HOLE CARDS ***
Dealt to JJin91 [6d 9h]
y3nk_: raises 2577 to 2827 and is all-in
VagColeSlaw: folds=20
Mr Hero76: folds=20
JJin91: folds=20
SapofPine: folds=20
Going2Ship: folds=20
Deuxexmachen: folds=20
NightHawk475: folds=20
vincent329: folds=20
Uncalled bet (2577) returned to y3nk_
y3nk_ collected 895 from pot
*** SUMMARY ***
Total pot 895 | Rake 0=20
Seat 1: VagColeSlaw folded before Flop (didn't bet)
Seat 2: Mr Hero76 folded before Flop (didn't bet)
Seat 3: JJin91 folded before Flop (didn't bet)
Seat 4: SapofPine folded before Flop (didn't bet)
Seat 5: Going2Ship folded before Flop (didn't bet)
Seat 6: Deuxexmachen (button) folded before Flop (didn't bet)
Seat 7: NightHawk475 (small blind) folded before Flop
Seat 8: vincent329 (big blind) folded before Flop
Seat 9: y3nk_ collected (895)


*********** # 61 **************
PokerStars Hand #171481976668: Tournament #1648956629, $18.20+$1.80 USD=
 Hold'em No Limit - Level VIII (125/250) - 2017/06/20 20:22:39 ET
Table '1648956629 2' 9-max Seat #7 is the button
Seat 1: VagColeSlaw (15857 in chips)=20
Seat 2: Mr Hero76 (9880 in chips)=20
Seat 3: JJin91 (11655 in chips)=20
Seat 4: SapofPine (7840 in chips)=20
Seat 5: Going2Ship (5663 in chips)=20
Seat 6: Deuxexmachen (52000 in chips)=20
Seat 7: NightHawk475 (26159 in chips)=20
Seat 8: vincent329 (21294 in chips)=20
VagColeSlaw: posts the ante 30
Mr Hero76: posts the ante 30
JJin91: posts the ante 30
SapofPine: posts the ante 30
Going2Ship: posts the ante 30
Deuxexmachen: posts the ante 30
NightHawk475: posts the ante 30
vincent329: posts the ante 30
vincent329: posts small blind 125
VagColeSlaw: posts big blind 250
*** HOLE CARDS ***
Dealt to JJin91 [3d Ts]
Mr Hero76: raises 250 to 500
JJin91: folds=20
SapofPine: folds=20
Going2Ship: folds=20
Deuxexmachen: folds=20
NightHawk475: folds=20
vincent329: calls 375
VagColeSlaw is disconnected=20
VagColeSlaw is connected=20
VagColeSlaw: folds=20
*** FLOP *** [7s 9d 4h]
vincent329: checks=20
Mr Hero76: bets 745
vincent329: calls 745
*** TURN *** [7s 9d 4h] [Td]
vincent329: checks=20
Mr Hero76: checks=20
*** RIVER *** [7s 9d 4h Td] [Jd]
vincent329: bets 1490
Mr Hero76: calls 1490
*** SHOW DOWN ***
vincent329: shows [Th 3h] (a pair of Tens)
Mr Hero76: shows [Ac Ah] (a pair of Aces)
Mr Hero76 collected 5960 from pot
*** SUMMARY ***
Total pot 5960 | Rake 0=20
Board [7s 9d 4h Td Jd]
Seat 1: VagColeSlaw (big blind) folded before Flop
Seat 2: Mr Hero76 showed [Ac Ah] and won (5960) with a pair of Aces
Seat 3: JJin91 folded before Flop (didn't bet)
Seat 4: SapofPine folded before Flop (didn't bet)
Seat 5: Going2Ship folded before Flop (didn't bet)
Seat 6: Deuxexmachen folded before Flop (didn't bet)
Seat 7: NightHawk475 (button) folded before Flop (didn't bet)
Seat 8: vincent329 (small blind) showed [Th 3h] and lost with a pair of=
 Tens


*********** # 62 **************
PokerStars Hand #171481976921: Tournament #1648956629, $18.20+$1.80 USD=
 Hold'em No Limit - Level VIII (125/250) - 2017/06/20 20:23:40 ET
Table '1648956629 2' 9-max Seat #8 is the button
Seat 1: VagColeSlaw (15577 in chips)=20
Seat 2: Mr Hero76 (13075 in chips)=20
Seat 3: JJin91 (11625 in chips)=20
Seat 4: SapofPine (7810 in chips)=20
Seat 5: Going2Ship (5633 in chips)=20
Seat 6: Deuxexmachen (51970 in chips)=20
Seat 7: NightHawk475 (26129 in chips)=20
Seat 8: vincent329 (18529 in chips)=20
VagColeSlaw: posts the ante 30
Mr Hero76: posts the ante 30
JJin91: posts the ante 30
SapofPine: posts the ante 30
Going2Ship: posts the ante 30
Deuxexmachen: posts the ante 30
NightHawk475: posts the ante 30
vincent329: posts the ante 30
VagColeSlaw: posts small blind 125
Mr Hero76: posts big blind 250
*** HOLE CARDS ***
Dealt to JJin91 [4d 7s]
JJin91: folds=20
SapofPine: folds=20
Going2Ship: folds=20
Deuxexmachen: folds=20
NightHawk475: raises 325 to 575
vincent329: calls 575
VagColeSlaw: folds=20
Mr Hero76: calls 325
*** FLOP *** [8d 8c 4c]
Mr Hero76: checks=20
NightHawk475: checks=20
vincent329: checks=20
*** TURN *** [8d 8c 4c] [2h]
Mr Hero76: checks=20
NightHawk475: bets 666
vincent329: calls 666
Mr Hero76: folds=20
*** RIVER *** [8d 8c 4c 2h] [7h]
NightHawk475: bets 1000
vincent329: raises 2000 to 3000
NightHawk475: calls 2000
*** SHOW DOWN ***
vincent329: shows [Js Kc] (a pair of Eights)
NightHawk475: shows [8s Ac] (three of a kind, Eights)
NightHawk475 collected 9422 from pot
*** SUMMARY ***
Total pot 9422 | Rake 0=20
Board [8d 8c 4c 2h 7h]
Seat 1: VagColeSlaw (small blind) folded before Flop
Seat 2: Mr Hero76 (big blind) folded on the Turn
Seat 3: JJin91 folded before Flop (didn't bet)
Seat 4: SapofPine folded before Flop (didn't bet)
Seat 5: Going2Ship folded before Flop (didn't bet)
Seat 6: Deuxexmachen folded before Flop (didn't bet)
Seat 7: NightHawk475 showed [8s Ac] and won (9422) with three of a kind=
, Eights
Seat 8: vincent329 (button) showed [Js Kc] and lost with a pair of Eigh=
ts


*********** # 63 **************
PokerStars Hand #171481977313: Tournament #1648956629, $18.20+$1.80 USD=
 Hold'em No Limit - Level VIII (125/250) - 2017/06/20 20:25:21 ET
Table '1648956629 2' 9-max Seat #1 is the button
Seat 1: VagColeSlaw (15422 in chips)=20
Seat 2: Mr Hero76 (12470 in chips)=20
Seat 3: JJin91 (11595 in chips)=20
Seat 4: SapofPine (7780 in chips)=20
Seat 5: Going2Ship (5603 in chips)=20
Seat 6: Deuxexmachen (51940 in chips)=20
Seat 7: NightHawk475 (31280 in chips)=20
Seat 8: vincent329 (14258 in chips)=20
VagColeSlaw: posts the ante 30
Mr Hero76: posts the ante 30
JJin91: posts the ante 30
SapofPine: posts the ante 30
Going2Ship: posts the ante 30
Deuxexmachen: posts the ante 30
NightHawk475: posts the ante 30
vincent329: posts the ante 30
Mr Hero76: posts small blind 125
JJin91: posts big blind 250
*** HOLE CARDS ***
Dealt to JJin91 [4d 9s]
SapofPine: folds=20
Going2Ship: folds=20
Deuxexmachen: folds=20
NightHawk475: folds=20
vincent329: calls 250
VagColeSlaw: folds=20
Mr Hero76: calls 125
JJin91: checks=20
*** FLOP *** [Ad 3d Tc]
Mr Hero76: checks=20
JJin91: checks=20
vincent329: checks=20
*** TURN *** [Ad 3d Tc] [Kd]
Mr Hero76: checks=20
JJin91: bets 622
vincent329: raises 622 to 1244
Mr Hero76: folds=20
JJin91: calls 622
*** RIVER *** [Ad 3d Tc Kd] [4s]
JJin91: checks=20
vincent329: bets 1750
JJin91: folds=20
Uncalled bet (1750) returned to vincent329
vincent329 collected 3478 from pot
*** SUMMARY ***
Total pot 3478 | Rake 0=20
Board [Ad 3d Tc Kd 4s]
Seat 1: VagColeSlaw (button) folded before Flop (didn't bet)
Seat 2: Mr Hero76 (small blind) folded on the Turn
Seat 3: JJin91 (big blind) folded on the River
Seat 4: SapofPine folded before Flop (didn't bet)
Seat 5: Going2Ship folded before Flop (didn't bet)
Seat 6: Deuxexmachen folded before Flop (didn't bet)
Seat 7: NightHawk475 folded before Flop (didn't bet)
Seat 8: vincent329 collected (3478)


*********** # 64 **************
PokerStars Hand #171481977681: Tournament #1648956629, $18.20+$1.80 USD=
 Hold'em No Limit - Level IX (150/300) - 2017/06/20 20:26:59 ET
Table '1648956629 2' 9-max Seat #2 is the button
Seat 1: VagColeSlaw (15392 in chips)=20
Seat 2: Mr Hero76 (12190 in chips)=20
Seat 3: JJin91 (10071 in chips)=20
Seat 4: SapofPine (7750 in chips)=20
Seat 5: Going2Ship (5573 in chips)=20
Seat 6: Deuxexmachen (51910 in chips)=20
Seat 7: NightHawk475 (31250 in chips)=20
Seat 8: vincent329 (16212 in chips)=20
VagColeSlaw: posts the ante 40
Mr Hero76: posts the ante 40
JJin91: posts the ante 40
SapofPine: posts the ante 40
Going2Ship: posts the ante 40
Deuxexmachen: posts the ante 40
NightHawk475: posts the ante 40
vincent329: posts the ante 40
JJin91: posts small blind 150
SapofPine: posts big blind 300
*** HOLE CARDS ***
Dealt to JJin91 [3c 5d]
Going2Ship: folds=20
Deuxexmachen: folds=20
NightHawk475: folds=20
vincent329: calls 300
VagColeSlaw: folds=20
Mr Hero76: folds=20
JJin91: folds=20
SapofPine: checks=20
*** FLOP *** [5h Tc 6c]
SapofPine: checks=20
vincent329: bets 535
SapofPine: folds=20
Uncalled bet (535) returned to vincent329
vincent329 collected 1070 from pot
*** SUMMARY ***
Total pot 1070 | Rake 0=20
Board [5h Tc 6c]
Seat 1: VagColeSlaw folded before Flop (didn't bet)
Seat 2: Mr Hero76 (button) folded before Flop (didn't bet)
Seat 3: JJin91 (small blind) folded before Flop
Seat 4: SapofPine (big blind) folded on the Flop
Seat 5: Going2Ship folded before Flop (didn't bet)
Seat 6: Deuxexmachen folded before Flop (didn't bet)
Seat 7: NightHawk475 folded before Flop (didn't bet)
Seat 8: vincent329 collected (1070)


*********** # 65 **************
PokerStars Hand #171481977902: Tournament #1648956629, $18.20+$1.80 USD=
 Hold'em No Limit - Level IX (150/300) - 2017/06/20 20:27:53 ET
Table '1648956629 2' 9-max Seat #3 is the button
Seat 1: VagColeSlaw (15352 in chips)=20
Seat 2: Mr Hero76 (12150 in chips)=20
Seat 3: JJin91 (9881 in chips)=20
Seat 4: SapofPine (7410 in chips)=20
Seat 5: Going2Ship (5533 in chips)=20
Seat 6: Deuxexmachen (51870 in chips)=20
Seat 7: NightHawk475 (31210 in chips)=20
Seat 8: vincent329 (16942 in chips)=20
VagColeSlaw: posts the ante 40
Mr Hero76: posts the ante 40
JJin91: posts the ante 40
SapofPine: posts the ante 40
Going2Ship: posts the ante 40
Deuxexmachen: posts the ante 40
NightHawk475: posts the ante 40
vincent329: posts the ante 40
SapofPine: posts small blind 150
Going2Ship: posts big blind 300
*** HOLE CARDS ***
Dealt to JJin91 [Ah 4c]
Deuxexmachen: raises 600 to 900
NightHawk475: folds=20
vincent329: calls 900
VagColeSlaw: calls 900
Mr Hero76: folds=20
JJin91: folds=20
SapofPine: calls 750
Going2Ship: calls 600
*** FLOP *** [6d Jc 7c]
SapofPine: bets 3278
Going2Ship: folds=20
Deuxexmachen: raises 5688 to 8966
vincent329: calls 8966
VagColeSlaw: folds=20
SapofPine: calls 3192 and is all-in
*** TURN *** [6d Jc 7c] [Td]
Deuxexmachen: bets 14611
vincent329: calls 7036 and is all-in
Uncalled bet (7575) returned to Deuxexmachen
*** RIVER *** [6d Jc 7c Td] [Ad]
*** SHOW DOWN ***
Deuxexmachen: shows [7h 6h] (two pair, Sevens and Sixes)
vincent329: shows [Jh As] (two pair, Aces and Jacks)
vincent329 collected 19064 from side pot
SapofPine: shows [3d 4d] (a flush, Ace high)
SapofPine collected 24230 from main pot
*** SUMMARY ***
Total pot 43294 Main pot 24230. Side pot 19064. | Rake 0=20
Board [6d Jc 7c Td Ad]
Seat 1: VagColeSlaw folded on the Flop
Seat 2: Mr Hero76 folded before Flop (didn't bet)
Seat 3: JJin91 (button) folded before Flop (didn't bet)
Seat 4: SapofPine (small blind) showed [3d 4d] and won (24230) with a f=
lush, Ace high
Seat 5: Going2Ship (big blind) folded on the Flop
Seat 6: Deuxexmachen showed [7h 6h] and lost with two pair, Sevens and =
Sixes
Seat 7: NightHawk475 folded before Flop (didn't bet)
Seat 8: vincent329 showed [Jh As] and won (19064) with two pair, Aces a=
nd Jacks


*********** # 66 **************
PokerStars Hand #171481978317: Tournament #1648956629, $18.20+$1.80 USD=
 Hold'em No Limit - Level IX (150/300) - 2017/06/20 20:29:33 ET
Table '1648956629 2' 9-max Seat #4 is the button
Seat 1: VagColeSlaw (14412 in chips)=20
Seat 2: Mr Hero76 (12110 in chips)=20
Seat 3: JJin91 (9841 in chips)=20
Seat 4: SapofPine (24230 in chips)=20
Seat 5: Going2Ship (4593 in chips)=20
Seat 6: Deuxexmachen (34928 in chips)=20
Seat 7: NightHawk475 (31170 in chips)=20
Seat 8: vincent329 (19064 in chips)=20
VagColeSlaw: posts the ante 40
Mr Hero76: posts the ante 40
JJin91: posts the ante 40
SapofPine: posts the ante 40
Going2Ship: posts the ante 40
Deuxexmachen: posts the ante 40
NightHawk475: posts the ante 40
vincent329: posts the ante 40
Going2Ship: posts small blind 150
Deuxexmachen: posts big blind 300
*** HOLE CARDS ***
Dealt to JJin91 [2d Ts]
NightHawk475: raises 327 to 627
vincent329: calls 627
VagColeSlaw: folds=20
Mr Hero76: calls 627
JJin91: folds=20
SapofPine: folds=20
Going2Ship: folds=20
Deuxexmachen: folds=20
*** FLOP *** [4d 9d 6d]
NightHawk475: bets 1246
vincent329: calls 1246
SapofPine said, "lmao thought i was open ended"
Mr Hero76: folds=20
*** TURN *** [4d 9d 6d] [7c]
NightHawk475: bets 3900
vincent329: calls 3900
*** RIVER *** [4d 9d 6d 7c] [Kd]
NightHawk475: bets 1200
vincent329: raises 1800 to 3000
NightHawk475: calls 1800
*** SHOW DOWN ***
vincent329: shows [7s Ad] (a flush, Ace high)
NightHawk475: mucks hand=20
vincent329 collected 18943 from pot
*** SUMMARY ***
Total pot 18943 | Rake 0=20
Board [4d 9d 6d 7c Kd]
Seat 1: VagColeSlaw folded before Flop (didn't bet)
Seat 2: Mr Hero76 folded on the Flop
Seat 3: JJin91 folded before Flop (didn't bet)
Seat 4: SapofPine (button) folded before Flop (didn't bet)
Seat 5: Going2Ship (small blind) folded before Flop
Seat 6: Deuxexmachen (big blind) folded before Flop
Seat 7: NightHawk475 mucked [9c 9s]
Seat 8: vincent329 showed [7s Ad] and won (18943) with a flush, Ace high


*********** # 67 **************
PokerStars Hand #171481978644: Tournament #1648956629, $18.20+$1.80 USD=
 Hold'em No Limit - Level IX (150/300) - 2017/06/20 20:30:50 ET
Table '1648956629 2' 9-max Seat #5 is the button
Seat 1: VagColeSlaw (14372 in chips)=20
Seat 2: Mr Hero76 (11443 in chips)=20
Seat 3: JJin91 (9801 in chips)=20
Seat 4: SapofPine (24190 in chips)=20
Seat 5: Going2Ship (4403 in chips)=20
Seat 6: Deuxexmachen (34588 in chips)=20
Seat 7: NightHawk475 (22357 in chips)=20
Seat 8: vincent329 (29194 in chips)=20
VagColeSlaw: posts the ante 40
Mr Hero76: posts the ante 40
JJin91: posts the ante 40
SapofPine: posts the ante 40
Going2Ship: posts the ante 40
Deuxexmachen: posts the ante 40
NightHawk475: posts the ante 40
vincent329: posts the ante 40
Deuxexmachen: posts small blind 150
NightHawk475: posts big blind 300
*** HOLE CARDS ***
Dealt to JJin91 [8c 3d]
vincent329: calls 300
VagColeSlaw: folds=20
Mr Hero76: raises 1370 to 1670
JJin91: folds=20
SapofPine: folds=20
Going2Ship: folds=20
Deuxexmachen: folds=20
NightHawk475: folds=20
vincent329: folds=20
Uncalled bet (1370) returned to Mr Hero76
Mr Hero76 collected 1370 from pot
Mr Hero76: doesn't show hand=20
*** SUMMARY ***
Total pot 1370 | Rake 0=20
Seat 1: VagColeSlaw folded before Flop (didn't bet)
Seat 2: Mr Hero76 collected (1370)
Seat 3: JJin91 folded before Flop (didn't bet)
Seat 4: SapofPine folded before Flop (didn't bet)
Seat 5: Going2Ship (button) folded before Flop (didn't bet)
Seat 6: Deuxexmachen (small blind) folded before Flop
Seat 7: NightHawk475 (big blind) folded before Flop
Seat 8: vincent329 folded before Flop


*********** # 68 **************
PokerStars Hand #171481978842: Tournament #1648956629, $18.20+$1.80 USD=
 Hold'em No Limit - Level IX (150/300) - 2017/06/20 20:31:35 ET
Table '1648956629 2' 9-max Seat #6 is the button
Seat 1: VagColeSlaw (14332 in chips)=20
Seat 2: Mr Hero76 (12473 in chips)=20
Seat 3: JJin91 (9761 in chips)=20
Seat 4: SapofPine (24150 in chips)=20
Seat 5: Going2Ship (4363 in chips)=20
Seat 6: Deuxexmachen (34398 in chips)=20
Seat 7: NightHawk475 (22017 in chips)=20
Seat 8: vincent329 (28854 in chips)=20
VagColeSlaw: posts the ante 40
Mr Hero76: posts the ante 40
JJin91: posts the ante 40
SapofPine: posts the ante 40
Going2Ship: posts the ante 40
Deuxexmachen: posts the ante 40
NightHawk475: posts the ante 40
vincent329: posts the ante 40
NightHawk475: posts small blind 150
vincent329: posts big blind 300
*** HOLE CARDS ***
Dealt to JJin91 [4h 9h]
VagColeSlaw: folds=20
Mr Hero76: folds=20
JJin91: folds=20
SapofPine: folds=20
Going2Ship: folds=20
Deuxexmachen: raises 600 to 900
NightHawk475: folds=20
vincent329: calls 600
*** FLOP *** [Ad 6s 2d]
vincent329: checks=20
Deuxexmachen: bets 1135
vincent329: folds=20
Uncalled bet (1135) returned to Deuxexmachen
Deuxexmachen collected 2270 from pot
Deuxexmachen: doesn't show hand=20
*** SUMMARY ***
Total pot 2270 | Rake 0=20
Board [Ad 6s 2d]
Seat 1: VagColeSlaw folded before Flop (didn't bet)
Seat 2: Mr Hero76 folded before Flop (didn't bet)
Seat 3: JJin91 folded before Flop (didn't bet)
Seat 4: SapofPine folded before Flop (didn't bet)
Seat 5: Going2Ship folded before Flop (didn't bet)
Seat 6: Deuxexmachen (button) collected (2270)
Seat 7: NightHawk475 (small blind) folded before Flop
Seat 8: vincent329 (big blind) folded on the Flop


*********** # 69 **************
PokerStars Hand #171481979013: Tournament #1648956629, $18.20+$1.80 USD=
 Hold'em No Limit - Level IX (150/300) - 2017/06/20 20:32:16 ET
Table '1648956629 2' 9-max Seat #7 is the button
Seat 1: VagColeSlaw (14292 in chips)=20
Seat 2: Mr Hero76 (12433 in chips)=20
Seat 3: JJin91 (9721 in chips)=20
Seat 4: SapofPine (24110 in chips)=20
Seat 5: Going2Ship (4323 in chips)=20
Seat 6: Deuxexmachen (35728 in chips)=20
Seat 7: NightHawk475 (21827 in chips)=20
Seat 8: vincent329 (27914 in chips)=20
VagColeSlaw: posts the ante 40
Mr Hero76: posts the ante 40
JJin91: posts the ante 40
SapofPine: posts the ante 40
Going2Ship: posts the ante 40
Deuxexmachen: posts the ante 40
NightHawk475: posts the ante 40
vincent329: posts the ante 40
vincent329: posts small blind 150
VagColeSlaw: posts big blind 300
*** HOLE CARDS ***
Dealt to JJin91 [6c 8s]
Mr Hero76: folds=20
JJin91: folds=20
SapofPine: folds=20
Going2Ship: folds=20
Deuxexmachen: raises 600 to 900
NightHawk475: folds=20
vincent329: folds=20
VagColeSlaw: folds=20
Uncalled bet (600) returned to Deuxexmachen
Deuxexmachen collected 1070 from pot
Deuxexmachen: doesn't show hand=20
*** SUMMARY ***
Total pot 1070 | Rake 0=20
Seat 1: VagColeSlaw (big blind) folded before Flop
Seat 2: Mr Hero76 folded before Flop (didn't bet)
Seat 3: JJin91 folded before Flop (didn't bet)
Seat 4: SapofPine folded before Flop (didn't bet)
Seat 5: Going2Ship folded before Flop (didn't bet)
Seat 6: Deuxexmachen collected (1070)
Seat 7: NightHawk475 (button) folded before Flop (didn't bet)
Seat 8: vincent329 (small blind) folded before Flop


*********** # 70 **************
PokerStars Hand #171481979152: Tournament #1648956629, $18.20+$1.80 USD=
 Hold'em No Limit - Level IX (150/300) - 2017/06/20 20:32:52 ET
Table '1648956629 2' 9-max Seat #8 is the button
Seat 1: VagColeSlaw (13952 in chips)=20
Seat 2: Mr Hero76 (12393 in chips)=20
Seat 3: JJin91 (9681 in chips)=20
Seat 4: SapofPine (24070 in chips)=20
Seat 5: Going2Ship (4283 in chips)=20
Seat 6: Deuxexmachen (36458 in chips)=20
Seat 7: NightHawk475 (21787 in chips)=20
Seat 8: vincent329 (27724 in chips)=20
VagColeSlaw: posts the ante 40
Mr Hero76: posts the ante 40
JJin91: posts the ante 40
SapofPine: posts the ante 40
Going2Ship: posts the ante 40
Deuxexmachen: posts the ante 40
NightHawk475: posts the ante 40
vincent329: posts the ante 40
VagColeSlaw: posts small blind 150
Mr Hero76: posts big blind 300
*** HOLE CARDS ***
Dealt to JJin91 [Ks 3d]
JJin91: folds=20
SapofPine: folds=20
Going2Ship: folds=20
Deuxexmachen: folds=20
NightHawk475: raises 390 to 690
vincent329: calls 690
VagColeSlaw: folds=20
Mr Hero76: folds=20
*** FLOP *** [Td 8d Ac]
NightHawk475: bets 1011
vincent329: calls 1011
*** TURN *** [Td 8d Ac] [2d]
NightHawk475: bets 2420
vincent329: calls 2420
*** RIVER *** [Td 8d Ac 2d] [2h]
NightHawk475: checks=20
vincent329: checks=20
*** SHOW DOWN ***
NightHawk475: shows [6h Ad] (two pair, Aces and Deuces)
vincent329: mucks hand=20
NightHawk475 collected 9012 from pot
*** SUMMARY ***
Total pot 9012 | Rake 0=20
Board [Td 8d Ac 2d 2h]
Seat 1: VagColeSlaw (small blind) folded before Flop
Seat 2: Mr Hero76 (big blind) folded before Flop
Seat 3: JJin91 folded before Flop (didn't bet)
Seat 4: SapofPine folded before Flop (didn't bet)
Seat 5: Going2Ship folded before Flop (didn't bet)
Seat 6: Deuxexmachen folded before Flop (didn't bet)
Seat 7: NightHawk475 showed [6h Ad] and won (9012) with two pair, Aces =
and Deuces
Seat 8: vincent329 (button) mucked [Qc Qh]


*********** # 71 **************
PokerStars Hand #171481979351: Tournament #1648956629, $18.20+$1.80 USD=
 Hold'em No Limit - Level IX (150/300) - 2017/06/20 20:33:43 ET
Table '1648956629 2' 9-max Seat #1 is the button
Seat 1: VagColeSlaw (13762 in chips)=20
Seat 2: Mr Hero76 (12053 in chips)=20
Seat 3: JJin91 (9641 in chips)=20
Seat 4: SapofPine (24030 in chips)=20
Seat 5: Going2Ship (4243 in chips)=20
Seat 6: Deuxexmachen (36418 in chips)=20
Seat 7: NightHawk475 (26638 in chips)=20
Seat 8: vincent329 (23563 in chips)=20
VagColeSlaw: posts the ante 40
Mr Hero76: posts the ante 40
JJin91: posts the ante 40
SapofPine: posts the ante 40
Going2Ship: posts the ante 40
Deuxexmachen: posts the ante 40
NightHawk475: posts the ante 40
vincent329: posts the ante 40
Mr Hero76: posts small blind 150
JJin91: posts big blind 300
*** HOLE CARDS ***
Dealt to JJin91 [4d 2h]
SapofPine: folds=20
Going2Ship: folds=20
Deuxexmachen: folds=20
NightHawk475: raises 390 to 690
vincent329: calls 690
VagColeSlaw is connected=20
VagColeSlaw: folds=20
Mr Hero76: folds=20
JJin91: folds=20
*** FLOP *** [Qh 9d Ks]
NightHawk475: bets 1420
vincent329: folds=20
Uncalled bet (1420) returned to NightHawk475
NightHawk475 collected 2150 from pot
*** SUMMARY ***
Total pot 2150 | Rake 0=20
Board [Qh 9d Ks]
Seat 1: VagColeSlaw (button) folded before Flop (didn't bet)
Seat 2: Mr Hero76 (small blind) folded before Flop
Seat 3: JJin91 (big blind) folded before Flop
Seat 4: SapofPine folded before Flop (didn't bet)
Seat 5: Going2Ship folded before Flop (didn't bet)
Seat 6: Deuxexmachen folded before Flop (didn't bet)
Seat 7: NightHawk475 collected (2150)
Seat 8: vincent329 folded on the Flop


*********** # 72 **************
PokerStars Hand #171481979665: Tournament #1648956629, $18.20+$1.80 USD=
 Hold'em No Limit - Level IX (150/300) - 2017/06/20 20:34:51 ET
Table '1648956629 2' 9-max Seat #2 is the button
Seat 1: VagColeSlaw (13722 in chips)=20
Seat 2: Mr Hero76 (11863 in chips)=20
Seat 3: JJin91 (9301 in chips)=20
Seat 4: SapofPine (23990 in chips)=20
Seat 5: Going2Ship (4203 in chips)=20
Seat 6: Deuxexmachen (36378 in chips)=20
Seat 8: vincent329 (22833 in chips)=20
VagColeSlaw: posts the ante 40
Mr Hero76: posts the ante 40
JJin91: posts the ante 40
SapofPine: posts the ante 40
Going2Ship: posts the ante 40
Deuxexmachen: posts the ante 40
vincent329: posts the ante 40
JJin91: posts small blind 150
SapofPine: posts big blind 300
*** HOLE CARDS ***
Dealt to JJin91 [Th Ks]
Going2Ship: folds=20
Deuxexmachen: folds=20
vincent329: folds=20
VagColeSlaw: raises 300 to 600
Mr Hero76: folds=20
JJin91: calls 450
SapofPine: folds=20
*** FLOP *** [Ad Jc Ac]
JJin91: checks=20
VagColeSlaw: bets 900
JJin91: folds=20
Uncalled bet (900) returned to VagColeSlaw
VagColeSlaw collected 1780 from pot
VagColeSlaw: doesn't show hand=20
*** SUMMARY ***
Total pot 1780 | Rake 0=20
Board [Ad Jc Ac]
Seat 1: VagColeSlaw collected (1780)
Seat 2: Mr Hero76 (button) folded before Flop (didn't bet)
Seat 3: JJin91 (small blind) folded on the Flop
Seat 4: SapofPine (big blind) folded before Flop
Seat 5: Going2Ship folded before Flop (didn't bet)
Seat 6: Deuxexmachen folded before Flop (didn't bet)
Seat 8: vincent329 folded before Flop (didn't bet)


*********** # 73 **************
PokerStars Hand #171481979811: Tournament #1648956629, $18.20+$1.80 USD=
 Hold'em No Limit - Level IX (150/300) - 2017/06/20 20:35:20 ET
Table '1648956629 2' 9-max Seat #3 is the button
Seat 1: VagColeSlaw (14862 in chips)=20
Seat 2: Mr Hero76 (11823 in chips)=20
Seat 3: JJin91 (8661 in chips)=20
Seat 4: SapofPine (23650 in chips)=20
Seat 5: Going2Ship (4163 in chips)=20
Seat 6: Deuxexmachen (36338 in chips)=20
Seat 8: vincent329 (22793 in chips)=20
VagColeSlaw: posts the ante 40
Mr Hero76: posts the ante 40
JJin91: posts the ante 40
SapofPine: posts the ante 40
Going2Ship: posts the ante 40
Deuxexmachen: posts the ante 40
vincent329: posts the ante 40
SapofPine: posts small blind 150
Going2Ship: posts big blind 300
*** HOLE CARDS ***
Dealt to JJin91 [3s 7h]
Deuxexmachen: folds=20
vincent329: folds=20
VagColeSlaw: folds=20
Mr Hero76: folds=20
JJin91: raises 420 to 720
SapofPine: folds=20
Going2Ship: folds=20
Uncalled bet (420) returned to JJin91
JJin91 collected 1030 from pot
JJin91: doesn't show hand=20
*** SUMMARY ***
Total pot 1030 | Rake 0=20
Seat 1: VagColeSlaw folded before Flop (didn't bet)
Seat 2: Mr Hero76 folded before Flop (didn't bet)
Seat 3: JJin91 (button) collected (1030)
Seat 4: SapofPine (small blind) folded before Flop
Seat 5: Going2Ship (big blind) folded before Flop
Seat 6: Deuxexmachen folded before Flop (didn't bet)
Seat 8: vincent329 folded before Flop (didn't bet)


*********** # 74 **************
PokerStars Hand #171483897531: Tournament #1648956629, $18.20+$1.80 USD=
 Hold'em No Limit - Level X (200/400) - 2017/06/20 20:36:06 ET
Table '1648956629 2' 9-max Seat #4 is the button
Seat 1: VagColeSlaw (14822 in chips)=20
Seat 2: Mr Hero76 (11783 in chips)=20
Seat 3: JJin91 (9351 in chips)=20
Seat 4: SapofPine (23460 in chips)=20
Seat 5: Going2Ship (3823 in chips)=20
Seat 6: Deuxexmachen (36298 in chips)=20
Seat 8: vincent329 (22753 in chips)=20
Seat 9: proletariat5 (10000 in chips)=20
VagColeSlaw: posts the ante 50
Mr Hero76: posts the ante 50
JJin91: posts the ante 50
SapofPine: posts the ante 50
Going2Ship: posts the ante 50
Deuxexmachen: posts the ante 50
vincent329: posts the ante 50
proletariat5: posts the ante 50
Going2Ship: posts small blind 200
Deuxexmachen: posts big blind 400
*** HOLE CARDS ***
Dealt to JJin91 [Js 7s]
vincent329: raises 400 to 800
proletariat5: folds=20
VagColeSlaw: folds=20
Mr Hero76: calls 800
JJin91: folds=20
SapofPine: calls 800
Going2Ship: raises 2973 to 3773 and is all-in
Deuxexmachen: folds=20
vincent329: calls 2973
Mr Hero76: folds=20
SapofPine: calls 2973
*** FLOP *** [3s 9h 7c]
vincent329: checks=20
SapofPine: bets 5297
vincent329: folds=20
Uncalled bet (5297) returned to SapofPine
*** TURN *** [3s 9h 7c] [As]
*** RIVER *** [3s 9h 7c As] [6c]
*** SHOW DOWN ***
Going2Ship: shows [Qd Ah] (a pair of Aces)
SapofPine: shows [4c 3c] (a pair of Threes)
Going2Ship collected 12919 from pot
*** SUMMARY ***
Total pot 12919 | Rake 0=20
Board [3s 9h 7c As 6c]
Seat 1: VagColeSlaw folded before Flop (didn't bet)
Seat 2: Mr Hero76 folded before Flop
Seat 3: JJin91 folded before Flop (didn't bet)
Seat 4: SapofPine (button) showed [4c 3c] and lost with a pair of Threes
Seat 5: Going2Ship (small blind) showed [Qd Ah] and won (12919) with a =
pair of Aces
Seat 6: Deuxexmachen (big blind) folded before Flop
Seat 8: vincent329 folded on the Flop
Seat 9: proletariat5 folded before Flop (didn't bet)


*********** # 75 **************
PokerStars Hand #171483897869: Tournament #1648956629, $18.20+$1.80 USD=
 Hold'em No Limit - Level X (200/400) - 2017/06/20 20:37:21 ET
Table '1648956629 2' 9-max Seat #5 is the button
Seat 1: VagColeSlaw (14772 in chips)=20
Seat 2: Mr Hero76 (10933 in chips)=20
Seat 3: JJin91 (9301 in chips)=20
Seat 4: SapofPine (19637 in chips)=20
Seat 5: Going2Ship (12919 in chips)=20
Seat 6: Deuxexmachen (35848 in chips)=20
Seat 8: vincent329 (18930 in chips)=20
Seat 9: proletariat5 (9950 in chips)=20
VagColeSlaw: posts the ante 50
Mr Hero76: posts the ante 50
JJin91: posts the ante 50
SapofPine: posts the ante 50
Going2Ship: posts the ante 50
Deuxexmachen: posts the ante 50
vincent329: posts the ante 50
proletariat5: posts the ante 50
Deuxexmachen: posts small blind 200
vincent329: posts big blind 400
*** HOLE CARDS ***
Dealt to JJin91 [Jc 4s]
proletariat5: folds=20
VagColeSlaw: folds=20
Mr Hero76: folds=20
JJin91: folds=20
SapofPine: raises 596 to 996
Going2Ship: folds=20
Deuxexmachen: folds=20
vincent329: calls 596
*** FLOP *** [7c 4h Qs]
vincent329: checks=20
SapofPine: bets 1063
vincent329: calls 1063
*** TURN *** [7c 4h Qs] [Ks]
vincent329: checks=20
SapofPine: bets 1934
vincent329: raises 1934 to 3868
SapofPine: folds=20
Uncalled bet (1934) returned to vincent329
vincent329 collected 8586 from pot
*** SUMMARY ***
Total pot 8586 | Rake 0=20
Board [7c 4h Qs Ks]
Seat 1: VagColeSlaw folded before Flop (didn't bet)
Seat 2: Mr Hero76 folded before Flop (didn't bet)
Seat 3: JJin91 folded before Flop (didn't bet)
Seat 4: SapofPine folded on the Turn
Seat 5: Going2Ship (button) folded before Flop (didn't bet)
Seat 6: Deuxexmachen (small blind) folded before Flop
Seat 8: vincent329 (big blind) collected (8586)
Seat 9: proletariat5 folded before Flop (didn't bet)


*********** # 76 **************
PokerStars Hand #171483898205: Tournament #1648956629, $18.20+$1.80 USD=
 Hold'em No Limit - Level X (200/400) - 2017/06/20 20:38:45 ET
Table '1648956629 2' 9-max Seat #6 is the button
Seat 1: VagColeSlaw (14722 in chips)=20
Seat 2: Mr Hero76 (10883 in chips)=20
Seat 3: JJin91 (9251 in chips)=20
Seat 4: SapofPine (15594 in chips)=20
Seat 5: Going2Ship (12869 in chips)=20
Seat 6: Deuxexmachen (35598 in chips)=20
Seat 8: vincent329 (23473 in chips)=20
Seat 9: proletariat5 (9900 in chips)=20
VagColeSlaw: posts the ante 50
Mr Hero76: posts the ante 50
JJin91: posts the ante 50
SapofPine: posts the ante 50
Going2Ship: posts the ante 50
Deuxexmachen: posts the ante 50
vincent329: posts the ante 50
proletariat5: posts the ante 50
vincent329: posts small blind 200
proletariat5: posts big blind 400
*** HOLE CARDS ***
Dealt to JJin91 [6c 4d]
VagColeSlaw: folds=20
Mr Hero76: folds=20
JJin91: folds=20
SapofPine: raises 596 to 996
Going2Ship: folds=20
Deuxexmachen: folds=20
vincent329: raises 596 to 1592
proletariat5: folds=20
SapofPine: raises 3208 to 4800
vincent329: calls 3208
*** FLOP *** [Ad 6h 7s]
vincent329: checks=20
SapofPine: bets 3600
vincent329: calls 3600
*** TURN *** [Ad 6h 7s] [Jh]
vincent329: checks=20
SapofPine: checks=20
*** RIVER *** [Ad 6h 7s Jh] [4h]
vincent329: bets 15023 and is all-in
SapofPine: calls 7144 and is all-in
Uncalled bet (7879) returned to vincent329
*** SHOW DOWN ***
vincent329: shows [Ks Kd] (a pair of Kings)
SapofPine: shows [7d 7c] (three of a kind, Sevens)
SapofPine collected 31888 from pot
*** SUMMARY ***
Total pot 31888 | Rake 0=20
Board [Ad 6h 7s Jh 4h]
Seat 1: VagColeSlaw folded before Flop (didn't bet)
Seat 2: Mr Hero76 folded before Flop (didn't bet)
Seat 3: JJin91 folded before Flop (didn't bet)
Seat 4: SapofPine showed [7d 7c] and won (31888) with three of a kind, =
Sevens
Seat 5: Going2Ship folded before Flop (didn't bet)
Seat 6: Deuxexmachen (button) folded before Flop (didn't bet)
Seat 8: vincent329 (small blind) showed [Ks Kd] and lost with a pair of=
 Kings
Seat 9: proletariat5 (big blind) folded before Flop


*********** # 77 **************
PokerStars Hand #171483898518: Tournament #1648956629, $18.20+$1.80 USD=
 Hold'em No Limit - Level X (200/400) - 2017/06/20 20:39:58 ET
Table '1648956629 2' 9-max Seat #8 is the button
Seat 1: VagColeSlaw (14672 in chips)=20
Seat 2: Mr Hero76 (10833 in chips)=20
Seat 3: JJin91 (9201 in chips)=20
Seat 4: SapofPine (31888 in chips)=20
Seat 5: Going2Ship (12819 in chips)=20
Seat 6: Deuxexmachen (35548 in chips)=20
Seat 8: vincent329 (7879 in chips)=20
Seat 9: proletariat5 (9450 in chips)=20
VagColeSlaw: posts the ante 50
Mr Hero76: posts the ante 50
JJin91: posts the ante 50
SapofPine: posts the ante 50
Going2Ship: posts the ante 50
Deuxexmachen: posts the ante 50
vincent329: posts the ante 50
proletariat5: posts the ante 50
proletariat5: posts small blind 200
VagColeSlaw: posts big blind 400
*** HOLE CARDS ***
Dealt to JJin91 [6h 7c]
Mr Hero76: raises 800 to 1200
JJin91: folds=20
SapofPine: folds=20
Going2Ship: folds=20
Deuxexmachen: folds=20
vincent329: raises 6629 to 7829 and is all-in
proletariat5: folds=20
VagColeSlaw: raises 6793 to 14622 and is all-in
Mr Hero76: folds=20
Uncalled bet (6793) returned to VagColeSlaw
*** FLOP *** [7d Qc 6c]
*** TURN *** [7d Qc 6c] [6s]
*** RIVER *** [7d Qc 6c 6s] [7h]
*** SHOW DOWN ***
VagColeSlaw: shows [Ad Kh] (two pair, Sevens and Sixes)
vincent329: shows [Jc As] (two pair, Sevens and Sixes)
VagColeSlaw collected 8729 from pot
vincent329 collected 8729 from pot
*** SUMMARY ***
Total pot 17458 | Rake 0=20
Board [7d Qc 6c 6s 7h]
Seat 1: VagColeSlaw (big blind) showed [Ad Kh] and won (8729) with two =
pair, Sevens and Sixes
Seat 2: Mr Hero76 folded before Flop
Seat 3: JJin91 folded before Flop (didn't bet)
Seat 4: SapofPine folded before Flop (didn't bet)
Seat 5: Going2Ship folded before Flop (didn't bet)
Seat 6: Deuxexmachen folded before Flop (didn't bet)
Seat 8: vincent329 (button) showed [Jc As] and won (8729) with two pair=
, Sevens and Sixes
Seat 9: proletariat5 (small blind) folded before Flop


*********** # 78 **************
PokerStars Hand #171483898710: Tournament #1648956629, $18.20+$1.80 USD=
 Hold'em No Limit - Level X (200/400) - 2017/06/20 20:40:42 ET
Table '1648956629 2' 9-max Seat #9 is the button
Seat 1: VagColeSlaw (15522 in chips)=20
Seat 2: Mr Hero76 (9583 in chips)=20
Seat 3: JJin91 (9151 in chips)=20
Seat 4: SapofPine (31838 in chips)=20
Seat 5: Going2Ship (12769 in chips)=20
Seat 6: Deuxexmachen (35498 in chips)=20
Seat 8: vincent329 (8729 in chips)=20
Seat 9: proletariat5 (9200 in chips)=20
VagColeSlaw: posts the ante 50
Mr Hero76: posts the ante 50
JJin91: posts the ante 50
SapofPine: posts the ante 50
Going2Ship: posts the ante 50
Deuxexmachen: posts the ante 50
vincent329: posts the ante 50
proletariat5: posts the ante 50
VagColeSlaw: posts small blind 200
Mr Hero76: posts big blind 400
*** HOLE CARDS ***
Dealt to JJin91 [Kh 8c]
JJin91: folds=20
SapofPine: folds=20
Going2Ship: folds=20
Deuxexmachen: folds=20
vincent329: calls 400
proletariat5: raises 752 to 1152
VagColeSlaw: folds=20
Mr Hero76: folds=20
vincent329: calls 752
*** FLOP *** [7c 5h Qs]
vincent329: checks=20
proletariat5: bets 1337
vincent329: raises 1863 to 3200
proletariat5: folds=20
Uncalled bet (1863) returned to vincent329
vincent329 collected 5978 from pot
*** SUMMARY ***
Total pot 5978 | Rake 0=20
Board [7c 5h Qs]
Seat 1: VagColeSlaw (small blind) folded before Flop
Seat 2: Mr Hero76 (big blind) folded before Flop
Seat 3: JJin91 folded before Flop (didn't bet)
Seat 4: SapofPine folded before Flop (didn't bet)
Seat 5: Going2Ship folded before Flop (didn't bet)
Seat 6: Deuxexmachen folded before Flop (didn't bet)
Seat 8: vincent329 collected (5978)
Seat 9: proletariat5 (button) folded on the Flop


*********** # 79 **************
PokerStars Hand #171483898898: Tournament #1648956629, $18.20+$1.80 USD=
 Hold'em No Limit - Level X (200/400) - 2017/06/20 20:41:25 ET
Table '1648956629 2' 9-max Seat #1 is the button
Seat 1: VagColeSlaw (15272 in chips)=20
Seat 2: Mr Hero76 (9133 in chips)=20
Seat 3: JJin91 (9101 in chips)=20
Seat 4: SapofPine (31788 in chips)=20
Seat 5: Going2Ship (12719 in chips)=20
Seat 6: Deuxexmachen (35448 in chips)=20
Seat 8: vincent329 (12168 in chips)=20
Seat 9: proletariat5 (6661 in chips)=20
VagColeSlaw: posts the ante 50
Mr Hero76: posts the ante 50
JJin91: posts the ante 50
SapofPine: posts the ante 50
Going2Ship: posts the ante 50
Deuxexmachen: posts the ante 50
vincent329: posts the ante 50
proletariat5: posts the ante 50
Mr Hero76: posts small blind 200
JJin91: posts big blind 400
*** HOLE CARDS ***
Dealt to JJin91 [9d Kd]
SapofPine: folds=20
Going2Ship: folds=20
Deuxexmachen: raises 800 to 1200
vincent329: folds=20
proletariat5: folds=20
VagColeSlaw: folds=20
Mr Hero76: folds=20
JJin91: calls 800
*** FLOP *** [4s 3h 9s]
JJin91: checks=20
Deuxexmachen: bets 1500
JJin91: calls 1500
*** TURN *** [4s 3h 9s] [5s]
JJin91: checks=20
Deuxexmachen: checks=20
*** RIVER *** [4s 3h 9s 5s] [Ts]
JJin91: checks=20
Deuxexmachen: bets 6400
JJin91: folds=20
Uncalled bet (6400) returned to Deuxexmachen
Deuxexmachen collected 6000 from pot
Deuxexmachen: doesn't show hand=20
*** SUMMARY ***
Total pot 6000 | Rake 0=20
Board [4s 3h 9s 5s Ts]
Seat 1: VagColeSlaw (button) folded before Flop (didn't bet)
Seat 2: Mr Hero76 (small blind) folded before Flop
Seat 3: JJin91 (big blind) folded on the River
Seat 4: SapofPine folded before Flop (didn't bet)
Seat 5: Going2Ship folded before Flop (didn't bet)
Seat 6: Deuxexmachen collected (6000)
Seat 8: vincent329 folded before Flop (didn't bet)
Seat 9: proletariat5 folded before Flop (didn't bet)


*********** # 80 **************
PokerStars Hand #171483899311: Tournament #1648956629, $18.20+$1.80 USD=
 Hold'em No Limit - Level X (200/400) - 2017/06/20 20:43:06 ET
Table '1648956629 2' 9-max Seat #2 is the button
Seat 1: VagColeSlaw (15222 in chips)=20
Seat 2: Mr Hero76 (8883 in chips)=20
Seat 3: JJin91 (6351 in chips)=20
Seat 4: SapofPine (31738 in chips)=20
Seat 5: Going2Ship (12669 in chips)=20
Seat 6: Deuxexmachen (38698 in chips)=20
Seat 8: vincent329 (12118 in chips)=20
Seat 9: proletariat5 (6611 in chips)=20
VagColeSlaw: posts the ante 50
Mr Hero76: posts the ante 50
JJin91: posts the ante 50
SapofPine: posts the ante 50
Going2Ship: posts the ante 50
Deuxexmachen: posts the ante 50
vincent329: posts the ante 50
proletariat5: posts the ante 50
JJin91: posts small blind 200
SapofPine: posts big blind 400
*** HOLE CARDS ***
Dealt to JJin91 [8h Ks]
Going2Ship: folds=20
Deuxexmachen: folds=20
vincent329: folds=20
proletariat5: folds=20
VagColeSlaw: folds=20
Mr Hero76: raises 8433 to 8833 and is all-in
JJin91: folds=20
SapofPine: folds=20
Uncalled bet (8433) returned to Mr Hero76
Mr Hero76 collected 1400 from pot
Mr Hero76: doesn't show hand=20
*** SUMMARY ***
Total pot 1400 | Rake 0=20
Seat 1: VagColeSlaw folded before Flop (didn't bet)
Seat 2: Mr Hero76 (button) collected (1400)
Seat 3: JJin91 (small blind) folded before Flop
Seat 4: SapofPine (big blind) folded before Flop
Seat 5: Going2Ship folded before Flop (didn't bet)
Seat 6: Deuxexmachen folded before Flop (didn't bet)
Seat 8: vincent329 folded before Flop (didn't bet)
Seat 9: proletariat5 folded before Flop (didn't bet)


*********** # 81 **************
PokerStars Hand #171483899438: Tournament #1648956629, $18.20+$1.80 USD=
 Hold'em No Limit - Level X (200/400) - 2017/06/20 20:43:35 ET
Table '1648956629 2' 9-max Seat #3 is the button
Seat 1: VagColeSlaw (15172 in chips)=20
Seat 2: Mr Hero76 (9833 in chips)=20
Seat 3: JJin91 (6101 in chips)=20
Seat 4: SapofPine (31288 in chips)=20
Seat 5: Going2Ship (12619 in chips)=20
Seat 6: Deuxexmachen (38648 in chips)=20
Seat 8: vincent329 (12068 in chips)=20
Seat 9: proletariat5 (6561 in chips)=20
VagColeSlaw: posts the ante 50
Mr Hero76: posts the ante 50
JJin91: posts the ante 50
SapofPine: posts the ante 50
Going2Ship: posts the ante 50
Deuxexmachen: posts the ante 50
vincent329: posts the ante 50
proletariat5: posts the ante 50
SapofPine: posts small blind 200
Going2Ship: posts big blind 400
*** HOLE CARDS ***
Dealt to JJin91 [Ks 6c]
Deuxexmachen: folds=20
vincent329: folds=20
proletariat5: folds=20
VagColeSlaw: folds=20
Mr Hero76: raises 800 to 1200
JJin91: raises 4851 to 6051 and is all-in
SapofPine: raises 25187 to 31238 and is all-in
Going2Ship: folds=20
Mr Hero76: folds=20
Uncalled bet (25187) returned to SapofPine
*** FLOP *** [7h 9c Td]
*** TURN *** [7h 9c Td] [8h]
*** RIVER *** [7h 9c Td 8h] [Qd]
*** SHOW DOWN ***
SapofPine: shows [Kd Kc] (a pair of Kings)
JJin91: shows [Ks 6c] (a straight, Six to Ten)
JJin91 collected 14102 from pot
*** SUMMARY ***
Total pot 14102 | Rake 0=20
Board [7h 9c Td 8h Qd]
Seat 1: VagColeSlaw folded before Flop (didn't bet)
Seat 2: Mr Hero76 folded before Flop
Seat 3: JJin91 (button) showed [Ks 6c] and won (14102) with a straight,=
 Six to Ten
Seat 4: SapofPine (small blind) showed [Kd Kc] and lost with a pair of =
Kings
Seat 5: Going2Ship (big blind) folded before Flop
Seat 6: Deuxexmachen folded before Flop (didn't bet)
Seat 8: vincent329 folded before Flop (didn't bet)
Seat 9: proletariat5 folded before Flop (didn't bet)


*********** # 82 **************
PokerStars Hand #171483899634: Tournament #1648956629, $18.20+$1.80 USD=
 Hold'em No Limit - Level X (200/400) - 2017/06/20 20:44:24 ET
Table '1648956629 2' 9-max Seat #4 is the button
Seat 1: VagColeSlaw (15122 in chips)=20
Seat 2: Mr Hero76 (8583 in chips)=20
Seat 3: JJin91 (14102 in chips)=20
Seat 4: SapofPine (25187 in chips)=20
Seat 5: Going2Ship (12169 in chips)=20
Seat 6: Deuxexmachen (38598 in chips)=20
Seat 8: vincent329 (12018 in chips)=20
Seat 9: proletariat5 (6511 in chips)=20
VagColeSlaw: posts the ante 50
Mr Hero76: posts the ante 50
JJin91: posts the ante 50
SapofPine: posts the ante 50
Going2Ship: posts the ante 50
Deuxexmachen: posts the ante 50
vincent329: posts the ante 50
proletariat5: posts the ante 50
Going2Ship: posts small blind 200
Deuxexmachen: posts big blind 400
*** HOLE CARDS ***
Dealt to JJin91 [Jh Ac]
vincent329: folds=20
proletariat5: folds=20
VagColeSlaw: raises 400 to 800
Mr Hero76: folds=20
JJin91: calls 800
SapofPine: folds=20
Going2Ship: folds=20
Deuxexmachen: folds=20
*** FLOP *** [6d Th 9s]
VagColeSlaw: bets 1200
JJin91: calls 1200
*** TURN *** [6d Th 9s] [8h]
VagColeSlaw: checks=20
JJin91: bets 3366
VagColeSlaw: raises 3366 to 6732
JJin91: raises 5320 to 12052 and is all-in
VagColeSlaw: calls 5320
*** RIVER *** [6d Th 9s 8h] [7c]
*** SHOW DOWN ***
VagColeSlaw: shows [Ah 7h] (a straight, Six to Ten)
JJin91: shows [Jh Ac] (a straight, Seven to Jack)
JJin91 collected 29104 from pot
*** SUMMARY ***
Total pot 29104 | Rake 0=20
Board [6d Th 9s 8h 7c]
Seat 1: VagColeSlaw showed [Ah 7h] and lost with a straight, Six to Ten
Seat 2: Mr Hero76 folded before Flop (didn't bet)
Seat 3: JJin91 showed [Jh Ac] and won (29104) with a straight, Seven to=
 Jack
Seat 4: SapofPine (button) folded before Flop (didn't bet)
Seat 5: Going2Ship (small blind) folded before Flop
Seat 6: Deuxexmachen (big blind) folded before Flop
Seat 8: vincent329 folded before Flop (didn't bet)
Seat 9: proletariat5 folded before Flop (didn't bet)


*********** # 83 **************
PokerStars Hand #171484423994: Tournament #1648956629, $18.20+$1.80 USD=
 Hold'em No Limit - Level XI (250/500) - 2017/06/20 20:46:39 ET
Table '1648956629 2' 9-max Seat #5 is the button
Seat 1: VagColeSlaw (1020 in chips)=20
Seat 2: Mr Hero76 (8533 in chips)=20
Seat 3: JJin91 (29104 in chips)=20
Seat 4: SapofPine (25137 in chips)=20
Seat 5: Going2Ship (11919 in chips)=20
Seat 6: Deuxexmachen (38148 in chips)=20
Seat 8: vincent329 (11968 in chips)=20
Seat 9: proletariat5 (6461 in chips)=20
VagColeSlaw: posts the ante 60
Mr Hero76: posts the ante 60
JJin91: posts the ante 60
SapofPine: posts the ante 60
Going2Ship: posts the ante 60
Deuxexmachen: posts the ante 60
vincent329: posts the ante 60
proletariat5: posts the ante 60
Deuxexmachen: posts small blind 250
vincent329: posts big blind 500
*** HOLE CARDS ***
Dealt to JJin91 [Ad 9h]
VagColeSlaw said, "wow"
proletariat5: folds=20
VagColeSlaw: folds=20
Mr Hero76: folds=20
JJin91: raises 711 to 1211
SapofPine: folds=20
Going2Ship: folds=20
Deuxexmachen: calls 961
vincent329: calls 711
*** FLOP *** [Kd Kh 6h]
Deuxexmachen: checks=20
vincent329: checks=20
JJin91: checks=20
*** TURN *** [Kd Kh 6h] [6s]
Deuxexmachen: checks=20
vincent329: checks=20
JJin91: bets 1222
Deuxexmachen: folds=20
vincent329: folds=20
Uncalled bet (1222) returned to JJin91
JJin91 collected 4113 from pot
JJin91: doesn't show hand=20
*** SUMMARY ***
Total pot 4113 | Rake 0=20
Board [Kd Kh 6h 6s]
Seat 1: VagColeSlaw folded before Flop (didn't bet)
Seat 2: Mr Hero76 folded before Flop (didn't bet)
Seat 3: JJin91 collected (4113)
Seat 4: SapofPine folded before Flop (didn't bet)
Seat 5: Going2Ship (button) folded before Flop (didn't bet)
Seat 6: Deuxexmachen (small blind) folded on the Turn
Seat 8: vincent329 (big blind) folded on the Turn
Seat 9: proletariat5 folded before Flop (didn't bet)


*********** # 84 **************
PokerStars Hand #171484424362: Tournament #1648956629, $18.20+$1.80 USD=
 Hold'em No Limit - Level XI (250/500) - 2017/06/20 20:48:12 ET
Table '1648956629 2' 9-max Seat #6 is the button
Seat 1: VagColeSlaw (960 in chips)=20
Seat 2: Mr Hero76 (8473 in chips)=20
Seat 3: JJin91 (31946 in chips)=20
Seat 4: SapofPine (25077 in chips)=20
Seat 5: Going2Ship (11859 in chips)=20
Seat 6: Deuxexmachen (36877 in chips)=20
Seat 8: vincent329 (10697 in chips)=20
Seat 9: proletariat5 (6401 in chips)=20
VagColeSlaw: posts the ante 60
Mr Hero76: posts the ante 60
JJin91: posts the ante 60
SapofPine: posts the ante 60
Going2Ship: posts the ante 60
Deuxexmachen: posts the ante 60
vincent329: posts the ante 60
proletariat5: posts the ante 60
vincent329: posts small blind 250
proletariat5: posts big blind 500
*** HOLE CARDS ***
Dealt to JJin91 [Jc 3s]
VagColeSlaw: raises 400 to 900 and is all-in
Mr Hero76: folds=20
JJin91: folds=20
SapofPine: folds=20
Going2Ship: folds=20
Deuxexmachen: raises 1100 to 2000
vincent329: folds=20
proletariat5: folds=20
Uncalled bet (1100) returned to Deuxexmachen
*** FLOP *** [Ah Qc Ks]
*** TURN *** [Ah Qc Ks] [Qs]
*** RIVER *** [Ah Qc Ks Qs] [8d]
*** SHOW DOWN ***
VagColeSlaw: shows [Ad 2h] (two pair, Aces and Queens)
Deuxexmachen: shows [Kh Kc] (a full house, Kings full of Queens)
Deuxexmachen collected 3030 from pot
VagColeSlaw finished the tournament in 54th place
*** SUMMARY ***
Total pot 3030 | Rake 0=20
Board [Ah Qc Ks Qs 8d]
Seat 1: VagColeSlaw showed [Ad 2h] and lost with two pair, Aces and Que=
ens
Seat 2: Mr Hero76 folded before Flop (didn't bet)
Seat 3: JJin91 folded before Flop (didn't bet)
Seat 4: SapofPine folded before Flop (didn't bet)
Seat 5: Going2Ship folded before Flop (didn't bet)
Seat 6: Deuxexmachen (button) showed [Kh Kc] and won (3030) with a full=
 house, Kings full of Queens
Seat 8: vincent329 (small blind) folded before Flop
Seat 9: proletariat5 (big blind) folded before Flop


*********** # 85 **************
PokerStars Hand #171484424499: Tournament #1648956629, $18.20+$1.80 USD=
 Hold'em No Limit - Level XI (250/500) - 2017/06/20 20:48:46 ET
Table '1648956629 2' 9-max Seat #8 is the button
Seat 2: Mr Hero76 (8413 in chips)=20
Seat 3: JJin91 (31886 in chips)=20
Seat 4: SapofPine (25017 in chips)=20
Seat 5: Going2Ship (11799 in chips)=20
Seat 6: Deuxexmachen (38947 in chips)=20
Seat 8: vincent329 (10387 in chips)=20
Seat 9: proletariat5 (5841 in chips)=20
Mr Hero76: posts the ante 60
JJin91: posts the ante 60
SapofPine: posts the ante 60
Going2Ship: posts the ante 60
Deuxexmachen: posts the ante 60
vincent329: posts the ante 60
proletariat5: posts the ante 60
proletariat5: posts small blind 250
Mr Hero76: posts big blind 500
*** HOLE CARDS ***
Dealt to JJin91 [5h 9c]
JJin91: folds=20
SapofPine: raises 745 to 1245
Going2Ship: folds=20
Deuxexmachen: folds=20
vincent329: folds=20
proletariat5: folds=20
Mr Hero76: calls 745
*** FLOP *** [2h Th 2s]
Mr Hero76: checks=20
SapofPine: checks=20
*** TURN *** [2h Th 2s] [Jc]
Mr Hero76: checks=20
SapofPine: bets 1296
Mr Hero76: folds=20
Uncalled bet (1296) returned to SapofPine
SapofPine collected 3160 from pot
*** SUMMARY ***
Total pot 3160 | Rake 0=20
Board [2h Th 2s Jc]
Seat 2: Mr Hero76 (big blind) folded on the Turn
Seat 3: JJin91 folded before Flop (didn't bet)
Seat 4: SapofPine collected (3160)
Seat 5: Going2Ship folded before Flop (didn't bet)
Seat 6: Deuxexmachen folded before Flop (didn't bet)
Seat 8: vincent329 (button) folded before Flop (didn't bet)
Seat 9: proletariat5 (small blind) folded before Flop


*********** # 86 **************
PokerStars Hand #171484424683: Tournament #1648956629, $18.20+$1.80 USD=
 Hold'em No Limit - Level XI (250/500) - 2017/06/20 20:49:32 ET
Table '1648956629 2' 9-max Seat #9 is the button
Seat 2: Mr Hero76 (7108 in chips)=20
Seat 3: JJin91 (31826 in chips)=20
Seat 4: SapofPine (26872 in chips)=20
Seat 5: Going2Ship (11739 in chips)=20
Seat 6: Deuxexmachen (38887 in chips)=20
Seat 8: vincent329 (10327 in chips)=20
Seat 9: proletariat5 (5531 in chips)=20
Mr Hero76: posts the ante 60
JJin91: posts the ante 60
SapofPine: posts the ante 60
Going2Ship: posts the ante 60
Deuxexmachen: posts the ante 60
vincent329: posts the ante 60
proletariat5: posts the ante 60
Mr Hero76: posts small blind 250
JJin91: posts big blind 500
*** HOLE CARDS ***
Dealt to JJin91 [Ks 2s]
SapofPine: folds=20
Going2Ship: folds=20
Deuxexmachen: folds=20
vincent329: calls 500
proletariat5: folds=20
Mr Hero76: folds=20
JJin91: checks=20
*** FLOP *** [7d Kd Jc]
JJin91: bets 500
vincent329: raises 500 to 1000
JJin91: calls 500
*** TURN *** [7d Kd Jc] [4d]
JJin91: checks=20
vincent329: bets 1500
JJin91: folds=20
Uncalled bet (1500) returned to vincent329
vincent329 collected 3670 from pot
*** SUMMARY ***
Total pot 3670 | Rake 0=20
Board [7d Kd Jc 4d]
Seat 2: Mr Hero76 (small blind) folded before Flop
Seat 3: JJin91 (big blind) folded on the Turn
Seat 4: SapofPine folded before Flop (didn't bet)
Seat 5: Going2Ship folded before Flop (didn't bet)
Seat 6: Deuxexmachen folded before Flop (didn't bet)
Seat 8: vincent329 collected (3670)
Seat 9: proletariat5 (button) folded before Flop (didn't bet)


*********** # 87 **************
PokerStars Hand #171484424919: Tournament #1648956629, $18.20+$1.80 USD=
 Hold'em No Limit - Level XI (250/500) - 2017/06/20 20:50:26 ET
Table '1648956629 2' 9-max Seat #2 is the button
Seat 2: Mr Hero76 (6798 in chips)=20
Seat 3: JJin91 (30266 in chips)=20
Seat 4: SapofPine (26812 in chips)=20
Seat 5: Going2Ship (11679 in chips)=20
Seat 6: Deuxexmachen (38827 in chips)=20
Seat 8: vincent329 (12437 in chips)=20
Seat 9: proletariat5 (5471 in chips)=20
Mr Hero76: posts the ante 60
JJin91: posts the ante 60
SapofPine: posts the ante 60
Going2Ship: posts the ante 60
Deuxexmachen: posts the ante 60
vincent329: posts the ante 60
proletariat5: posts the ante 60
JJin91: posts small blind 250
SapofPine: posts big blind 500
*** HOLE CARDS ***
Dealt to JJin91 [Qs Ts]
Going2Ship: folds=20
Deuxexmachen: raises 755 to 1255
vincent329: folds=20
proletariat5: folds=20
Mr Hero76: folds=20
JJin91: calls 1005
SapofPine: calls 755
*** FLOP *** [3c Qc 3s]
JJin91: checks=20
SapofPine: checks=20
Deuxexmachen: bets 2093
JJin91: calls 2093
SapofPine: folds=20
*** TURN *** [3c Qc 3s] [8h]
JJin91: checks=20
Deuxexmachen: bets 4186
JJin91: calls 4186
*** RIVER *** [3c Qc 3s 8h] [3d]
JJin91: checks=20
Deuxexmachen: checks=20
*** SHOW DOWN ***
JJin91: shows [Qs Ts] (a full house, Threes full of Queens)
Deuxexmachen: mucks hand=20
JJin91 collected 16743 from pot
*** SUMMARY ***
Total pot 16743 | Rake 0=20
Board [3c Qc 3s 8h 3d]
Seat 2: Mr Hero76 (button) folded before Flop (didn't bet)
Seat 3: JJin91 (small blind) showed [Qs Ts] and won (16743) with a full=
 house, Threes full of Queens
Seat 4: SapofPine (big blind) folded on the Flop
Seat 5: Going2Ship folded before Flop (didn't bet)
Seat 6: Deuxexmachen mucked [Ad 4d]
Seat 8: vincent329 folded before Flop (didn't bet)
Seat 9: proletariat5 folded before Flop (didn't bet)


*********** # 88 **************
PokerStars Hand #171484425221: Tournament #1648956629, $18.20+$1.80 USD=
 Hold'em No Limit - Level XI (250/500) - 2017/06/20 20:51:38 ET
Table '1648956629 2' 9-max Seat #3 is the button
Seat 2: Mr Hero76 (6738 in chips)=20
Seat 3: JJin91 (39415 in chips)=20
Seat 4: SapofPine (25497 in chips)=20
Seat 5: Going2Ship (11619 in chips)=20
Seat 6: Deuxexmachen (31233 in chips)=20
Seat 8: vincent329 (12377 in chips)=20
Seat 9: proletariat5 (5411 in chips)=20
Mr Hero76: posts the ante 60
JJin91: posts the ante 60
SapofPine: posts the ante 60
Going2Ship: posts the ante 60
Deuxexmachen: posts the ante 60
vincent329: posts the ante 60
proletariat5: posts the ante 60
SapofPine: posts small blind 250
Going2Ship: posts big blind 500
*** HOLE CARDS ***
Dealt to JJin91 [5h As]
Deuxexmachen: folds=20
vincent329: folds=20
proletariat5: folds=20
Mr Hero76: folds=20
JJin91: raises 711 to 1211
SapofPine: folds=20
Going2Ship: folds=20
Uncalled bet (711) returned to JJin91
JJin91 collected 1670 from pot
JJin91: doesn't show hand=20
*** SUMMARY ***
Total pot 1670 | Rake 0=20
Seat 2: Mr Hero76 folded before Flop (didn't bet)
Seat 3: JJin91 (button) collected (1670)
Seat 4: SapofPine (small blind) folded before Flop
Seat 5: Going2Ship (big blind) folded before Flop
Seat 6: Deuxexmachen folded before Flop (didn't bet)
Seat 8: vincent329 folded before Flop (didn't bet)
Seat 9: proletariat5 folded before Flop (didn't bet)


*********** # 89 **************
PokerStars Hand #171484425362: Tournament #1648956629, $18.20+$1.80 USD=
 Hold'em No Limit - Level XI (250/500) - 2017/06/20 20:52:09 ET
Table '1648956629 2' 9-max Seat #4 is the button
Seat 2: Mr Hero76 (6678 in chips)=20
Seat 3: JJin91 (40525 in chips)=20
Seat 4: SapofPine (25187 in chips)=20
Seat 5: Going2Ship (11059 in chips)=20
Seat 6: Deuxexmachen (31173 in chips)=20
Seat 8: vincent329 (12317 in chips)=20
Seat 9: proletariat5 (5351 in chips)=20
Mr Hero76: posts the ante 60
JJin91: posts the ante 60
SapofPine: posts the ante 60
Going2Ship: posts the ante 60
Deuxexmachen: posts the ante 60
vincent329: posts the ante 60
proletariat5: posts the ante 60
Going2Ship: posts small blind 250
Deuxexmachen: posts big blind 500
*** HOLE CARDS ***
Dealt to JJin91 [7h Qh]
vincent329: folds=20
proletariat5: folds=20
Mr Hero76: folds=20
JJin91: folds=20
SapofPine: folds=20
Going2Ship: calls 250
Deuxexmachen: raises 1000 to 1500
Going2Ship: folds=20
Uncalled bet (1000) returned to Deuxexmachen
Deuxexmachen collected 1420 from pot
Deuxexmachen: doesn't show hand=20
*** SUMMARY ***
Total pot 1420 | Rake 0=20
Seat 2: Mr Hero76 folded before Flop (didn't bet)
Seat 3: JJin91 folded before Flop (didn't bet)
Seat 4: SapofPine (button) folded before Flop (didn't bet)
Seat 5: Going2Ship (small blind) folded before Flop
Seat 6: Deuxexmachen (big blind) collected (1420)
Seat 8: vincent329 folded before Flop (didn't bet)
Seat 9: proletariat5 folded before Flop (didn't bet)


*********** # 90 **************
PokerStars Hand #171484425514: Tournament #1648956629, $18.20+$1.80 USD=
 Hold'em No Limit - Level XI (250/500) - 2017/06/20 20:52:47 ET
Table '1648956629 2' 9-max Seat #5 is the button
Seat 2: Mr Hero76 (6618 in chips)=20
Seat 3: JJin91 (40465 in chips)=20
Seat 4: SapofPine (25127 in chips)=20
Seat 5: Going2Ship (10499 in chips)=20
Seat 6: Deuxexmachen (32033 in chips)=20
Seat 8: vincent329 (12257 in chips)=20
Seat 9: proletariat5 (5291 in chips)=20
Mr Hero76: posts the ante 60
JJin91: posts the ante 60
SapofPine: posts the ante 60
Going2Ship: posts the ante 60
Deuxexmachen: posts the ante 60
vincent329: posts the ante 60
proletariat5: posts the ante 60
Deuxexmachen: posts small blind 250
vincent329: posts big blind 500
*** HOLE CARDS ***
Dealt to JJin91 [5h 7d]
proletariat5: folds=20
Mr Hero76: raises 6058 to 6558 and is all-in
JJin91: folds=20
SapofPine: folds=20
Going2Ship: folds=20
Deuxexmachen: folds=20
vincent329: folds=20
Uncalled bet (6058) returned to Mr Hero76
Mr Hero76 collected 1670 from pot
Mr Hero76: doesn't show hand=20
*** SUMMARY ***
Total pot 1670 | Rake 0=20
Seat 2: Mr Hero76 collected (1670)
Seat 3: JJin91 folded before Flop (didn't bet)
Seat 4: SapofPine folded before Flop (didn't bet)
Seat 5: Going2Ship (button) folded before Flop (didn't bet)
Seat 6: Deuxexmachen (small blind) folded before Flop
Seat 8: vincent329 (big blind) folded before Flop
Seat 9: proletariat5 folded before Flop (didn't bet)


*********** # 91 **************
PokerStars Hand #171484425608: Tournament #1648956629, $18.20+$1.80 USD=
 Hold'em No Limit - Level XI (250/500) - 2017/06/20 20:53:09 ET
Table '1648956629 2' 9-max Seat #6 is the button
Seat 2: Mr Hero76 (7728 in chips)=20
Seat 3: JJin91 (40405 in chips)=20
Seat 4: SapofPine (25067 in chips)=20
Seat 5: Going2Ship (10439 in chips)=20
Seat 6: Deuxexmachen (31723 in chips)=20
Seat 8: vincent329 (11697 in chips)=20
Seat 9: proletariat5 (5231 in chips)=20
Mr Hero76: posts the ante 60
JJin91: posts the ante 60
SapofPine: posts the ante 60
Going2Ship: posts the ante 60
Deuxexmachen: posts the ante 60
vincent329: posts the ante 60
proletariat5: posts the ante 60
vincent329: posts small blind 250
proletariat5: posts big blind 500
*** HOLE CARDS ***
Dealt to JJin91 [Ad 6h]
Mr Hero76: folds=20
JJin91: folds=20
SapofPine: folds=20
Going2Ship: folds=20
Deuxexmachen: folds=20
vincent329: calls 250
proletariat5: checks=20
*** FLOP *** [5d 9h Th]
vincent329: bets 1420
proletariat5: folds=20
Uncalled bet (1420) returned to vincent329
vincent329 collected 1420 from pot
*** SUMMARY ***
Total pot 1420 | Rake 0=20
Board [5d 9h Th]
Seat 2: Mr Hero76 folded before Flop (didn't bet)
Seat 3: JJin91 folded before Flop (didn't bet)
Seat 4: SapofPine folded before Flop (didn't bet)
Seat 5: Going2Ship folded before Flop (didn't bet)
Seat 6: Deuxexmachen (button) folded before Flop (didn't bet)
Seat 8: vincent329 (small blind) collected (1420)
Seat 9: proletariat5 (big blind) folded on the Flop


*********** # 92 **************
PokerStars Hand #171484425773: Tournament #1648956629, $18.20+$1.80 USD=
 Hold'em No Limit - Level XI (250/500) - 2017/06/20 20:53:49 ET
Table '1648956629 2' 9-max Seat #8 is the button
Seat 2: Mr Hero76 (7668 in chips)=20
Seat 3: JJin91 (40345 in chips)=20
Seat 4: SapofPine (25007 in chips)=20
Seat 5: Going2Ship (10379 in chips)=20
Seat 6: Deuxexmachen (31663 in chips)=20
Seat 8: vincent329 (12557 in chips)=20
Seat 9: proletariat5 (4671 in chips)=20
Mr Hero76: posts the ante 60
JJin91: posts the ante 60
SapofPine: posts the ante 60
Going2Ship: posts the ante 60
Deuxexmachen: posts the ante 60
vincent329: posts the ante 60
proletariat5: posts the ante 60
proletariat5: posts small blind 250
Mr Hero76: posts big blind 500
*** HOLE CARDS ***
Dealt to JJin91 [4c 7c]
JJin91: folds=20
SapofPine: folds=20
Going2Ship: folds=20
Deuxexmachen: raises 755 to 1255
vincent329: folds=20
proletariat5: folds=20
Mr Hero76: folds=20
Uncalled bet (755) returned to Deuxexmachen
Deuxexmachen collected 1670 from pot
Deuxexmachen: doesn't show hand=20
*** SUMMARY ***
Total pot 1670 | Rake 0=20
Seat 2: Mr Hero76 (big blind) folded before Flop
Seat 3: JJin91 folded before Flop (didn't bet)
Seat 4: SapofPine folded before Flop (didn't bet)
Seat 5: Going2Ship folded before Flop (didn't bet)
Seat 6: Deuxexmachen collected (1670)
Seat 8: vincent329 (button) folded before Flop (didn't bet)
Seat 9: proletariat5 (small blind) folded before Flop


*********** # 93 **************
PokerStars Hand #171484425888: Tournament #1648956629, $18.20+$1.80 USD=
 Hold'em No Limit - Level XI (250/500) - 2017/06/20 20:54:20 ET
Table '1648956629 2' 9-max Seat #9 is the button
Seat 2: Mr Hero76 (7108 in chips)=20
Seat 3: JJin91 (40285 in chips)=20
Seat 4: SapofPine (24947 in chips)=20
Seat 5: Going2Ship (10319 in chips)=20
Seat 6: Deuxexmachen (32773 in chips)=20
Seat 8: vincent329 (12497 in chips)=20
Seat 9: proletariat5 (4361 in chips)=20
Mr Hero76: posts the ante 60
JJin91: posts the ante 60
SapofPine: posts the ante 60
Going2Ship: posts the ante 60
Deuxexmachen: posts the ante 60
vincent329: posts the ante 60
proletariat5: posts the ante 60
Mr Hero76: posts small blind 250
JJin91: posts big blind 500
*** HOLE CARDS ***
Dealt to JJin91 [Th 4c]
SapofPine: folds=20
Going2Ship: raises 500 to 1000
Deuxexmachen: folds=20
vincent329: raises 1000 to 2000
proletariat5: folds=20
Mr Hero76: folds=20
JJin91: folds=20
Going2Ship: raises 8259 to 10259 and is all-in
vincent329: calls 8259
*** FLOP *** [8c Jd Kd]
*** TURN *** [8c Jd Kd] [9h]
*** RIVER *** [8c Jd Kd 9h] [Qc]
*** SHOW DOWN ***
Going2Ship: shows [9c 9s] (three of a kind, Nines)
vincent329: shows [Ah Ks] (a pair of Kings)
Going2Ship collected 21688 from pot
*** SUMMARY ***
Total pot 21688 | Rake 0=20
Board [8c Jd Kd 9h Qc]
Seat 2: Mr Hero76 (small blind) folded before Flop
Seat 3: JJin91 (big blind) folded before Flop
Seat 4: SapofPine folded before Flop (didn't bet)
Seat 5: Going2Ship showed [9c 9s] and won (21688) with three of a kind,=
 Nines
Seat 6: Deuxexmachen folded before Flop (didn't bet)
Seat 8: vincent329 showed [Ah Ks] and lost with a pair of Kings
Seat 9: proletariat5 (button) folded before Flop (didn't bet)


*********** # 94 **************
PokerStars Hand #171484427278: Tournament #1648956629, $18.20+$1.80 USD=
 Hold'em No Limit - Level XI (250/500) - 2017/06/20 21:00:49 ET
Table '1648956629 2' 9-max Seat #2 is the button
Seat 1: FizzEdJohn (10000 in chips)=20
Seat 2: Mr Hero76 (6798 in chips)=20
Seat 3: JJin91 (39725 in chips)=20
Seat 4: SapofPine (24887 in chips)=20
Seat 5: Going2Ship (21688 in chips)=20
Seat 6: Deuxexmachen (32713 in chips)=20
Seat 7: Labba609 (10000 in chips)=20
Seat 8: vincent329 (2178 in chips)=20
Seat 9: proletariat5 (4301 in chips)=20
FizzEdJohn: posts the ante 60
Mr Hero76: posts the ante 60
JJin91: posts the ante 60
SapofPine: posts the ante 60
Going2Ship: posts the ante 60
Deuxexmachen: posts the ante 60
Labba609: posts the ante 60
vincent329: posts the ante 60
proletariat5: posts the ante 60
JJin91: posts small blind 250
SapofPine: posts big blind 500
*** HOLE CARDS ***
Dealt to JJin91 [Th Jh]
Going2Ship: folds=20
Deuxexmachen: folds=20
Labba609: folds=20
vincent329: raises 1618 to 2118 and is all-in
proletariat5: folds=20
FizzEdJohn: folds=20
Mr Hero76: folds=20
JJin91: folds=20
SapofPine: folds=20
Uncalled bet (1618) returned to vincent329
vincent329 collected 1790 from pot
*** SUMMARY ***
Total pot 1790 | Rake 0=20
Seat 1: FizzEdJohn folded before Flop (didn't bet)
Seat 2: Mr Hero76 (button) folded before Flop (didn't bet)
Seat 3: JJin91 (small blind) folded before Flop
Seat 4: SapofPine (big blind) folded before Flop
Seat 5: Going2Ship folded before Flop (didn't bet)
Seat 6: Deuxexmachen folded before Flop (didn't bet)
Seat 7: Labba609 folded before Flop (didn't bet)
Seat 8: vincent329 collected (1790)
Seat 9: proletariat5 folded before Flop (didn't bet)


*********** # 95 **************
PokerStars Hand #171484427477: Tournament #1648956629, $18.20+$1.80 USD=
 Hold'em No Limit - Level XII (300/600) - 2017/06/20 21:01:40 ET
Table '1648956629 2' 9-max Seat #3 is the button
Seat 1: FizzEdJohn (9940 in chips)=20
Seat 2: Mr Hero76 (6738 in chips)=20
Seat 3: JJin91 (39415 in chips)=20
Seat 4: SapofPine (24327 in chips)=20
Seat 5: Going2Ship (21628 in chips)=20
Seat 6: Deuxexmachen (32653 in chips)=20
Seat 7: Labba609 (9940 in chips)=20
Seat 8: vincent329 (3408 in chips)=20
Seat 9: proletariat5 (4241 in chips)=20
FizzEdJohn: posts the ante 70
Mr Hero76: posts the ante 70
JJin91: posts the ante 70
SapofPine: posts the ante 70
Going2Ship: posts the ante 70
Deuxexmachen: posts the ante 70
Labba609: posts the ante 70
vincent329: posts the ante 70
proletariat5: posts the ante 70
SapofPine: posts small blind 300
Going2Ship: posts big blind 600
*** HOLE CARDS ***
Dealt to JJin91 [9s 7s]
Deuxexmachen: folds=20
Labba609: folds=20
vincent329: calls 600
proletariat5: folds=20
FizzEdJohn: raises 9270 to 9870 and is all-in
Mr Hero76: calls 6668 and is all-in
JJin91: folds=20
SapofPine: folds=20
Going2Ship: folds=20
vincent329: calls 2738 and is all-in
Uncalled bet (3202) returned to FizzEdJohn
*** FLOP *** [Kc 4h 7h]
*** TURN *** [Kc 4h 7h] [Th]
*** RIVER *** [Kc 4h 7h Th] [2c]
*** SHOW DOWN ***
FizzEdJohn: shows [Td Tc] (three of a kind, Tens)
Mr Hero76: shows [Qd Qs] (a pair of Queens)
FizzEdJohn collected 6660 from side pot
vincent329: shows [9c 8h] (high card King)
FizzEdJohn collected 11544 from main pot
Mr Hero76 finished the tournament in 49th place
vincent329 finished the tournament in 50th place
*** SUMMARY ***
Total pot 18204 Main pot 11544. Side pot 6660. | Rake 0=20
Board [Kc 4h 7h Th 2c]
Seat 1: FizzEdJohn showed [Td Tc] and won (18204) with three of a kind,=
 Tens
Seat 2: Mr Hero76 showed [Qd Qs] and lost with a pair of Queens
Seat 3: JJin91 (button) folded before Flop (didn't bet)
Seat 4: SapofPine (small blind) folded before Flop
Seat 5: Going2Ship (big blind) folded before Flop
Seat 6: Deuxexmachen folded before Flop (didn't bet)
Seat 7: Labba609 folded before Flop (didn't bet)
Seat 8: vincent329 showed [9c 8h] and lost with high card King
Seat 9: proletariat5 folded before Flop (didn't bet)


*********** # 96 **************
PokerStars Hand #171484427684: Tournament #1648956629, $18.20+$1.80 USD=
 Hold'em No Limit - Level XII (300/600) - 2017/06/20 21:02:28 ET
Table '1648956629 2' 9-max Seat #4 is the button
Seat 1: FizzEdJohn (21406 in chips)=20
Seat 3: JJin91 (39345 in chips)=20
Seat 4: SapofPine (23957 in chips)=20
Seat 5: Going2Ship (20958 in chips)=20
Seat 6: Deuxexmachen (32583 in chips)=20
Seat 7: Labba609 (9870 in chips)=20
Seat 9: proletariat5 (4171 in chips)=20
FizzEdJohn: posts the ante 70
JJin91: posts the ante 70
SapofPine: posts the ante 70
Going2Ship: posts the ante 70
Deuxexmachen: posts the ante 70
Labba609: posts the ante 70
proletariat5: posts the ante 70
Going2Ship: posts small blind 300
Deuxexmachen: posts big blind 600
*** HOLE CARDS ***
Dealt to JJin91 [6d Th]
Labba609: folds=20
proletariat5: raises 3501 to 4101 and is all-in
FizzEdJohn: folds=20
JJin91: folds=20
SapofPine: folds=20
Going2Ship: folds=20
Deuxexmachen: folds=20
Uncalled bet (3501) returned to proletariat5
proletariat5 collected 1990 from pot
proletariat5: doesn't show hand=20
*** SUMMARY ***
Total pot 1990 | Rake 0=20
Seat 1: FizzEdJohn folded before Flop (didn't bet)
Seat 3: JJin91 folded before Flop (didn't bet)
Seat 4: SapofPine (button) folded before Flop (didn't bet)
Seat 5: Going2Ship (small blind) folded before Flop
Seat 6: Deuxexmachen (big blind) folded before Flop
Seat 7: Labba609 folded before Flop (didn't bet)
Seat 9: proletariat5 collected (1990)


*********** # 97 **************
PokerStars Hand #171484427839: Tournament #1648956629, $18.20+$1.80 USD=
 Hold'em No Limit - Level XII (300/600) - 2017/06/20 21:03:07 ET
Table '1648956629 2' 9-max Seat #5 is the button
Seat 1: FizzEdJohn (21336 in chips)=20
Seat 3: JJin91 (39275 in chips)=20
Seat 4: SapofPine (23887 in chips)=20
Seat 5: Going2Ship (20588 in chips)=20
Seat 6: Deuxexmachen (31913 in chips)=20
Seat 7: Labba609 (9800 in chips)=20
Seat 8: MeatballG10 (14259 in chips)=20
Seat 9: proletariat5 (5491 in chips)=20
FizzEdJohn: posts the ante 70
JJin91: posts the ante 70
SapofPine: posts the ante 70
Going2Ship: posts the ante 70
Deuxexmachen: posts the ante 70
Labba609: posts the ante 70
MeatballG10: posts the ante 70
proletariat5: posts the ante 70
Deuxexmachen: posts small blind 300
Labba609: posts big blind 600
*** HOLE CARDS ***
Dealt to JJin91 [Qs 2s]
MeatballG10: folds=20
proletariat5: folds=20
FizzEdJohn: raises 690 to 1290
JJin91: folds=20
SapofPine: folds=20
Going2Ship: folds=20
Deuxexmachen: calls 990
Labba609: folds=20
*** FLOP *** [Qh 9c 3s]
Deuxexmachen: checks=20
FizzEdJohn: bets 1500
Deuxexmachen: folds=20
Uncalled bet (1500) returned to FizzEdJohn
FizzEdJohn collected 3740 from pot
FizzEdJohn: doesn't show hand=20
*** SUMMARY ***
Total pot 3740 | Rake 0=20
Board [Qh 9c 3s]
Seat 1: FizzEdJohn collected (3740)
Seat 3: JJin91 folded before Flop (didn't bet)
Seat 4: SapofPine folded before Flop (didn't bet)
Seat 5: Going2Ship (button) folded before Flop (didn't bet)
Seat 6: Deuxexmachen (small blind) folded on the Flop
Seat 7: Labba609 (big blind) folded before Flop
Seat 8: MeatballG10 folded before Flop (didn't bet)
Seat 9: proletariat5 folded before Flop (didn't bet)


*********** # 98 **************
PokerStars Hand #171484428169: Tournament #1648956629, $18.20+$1.80 USD=
 Hold'em No Limit - Level XII (300/600) - 2017/06/20 21:04:18 ET
Table '1648956629 2' 9-max Seat #6 is the button
Seat 1: FizzEdJohn (23716 in chips)=20
Seat 2: cl1ckinbtns (7630 in chips)=20
Seat 3: JJin91 (39205 in chips)=20
Seat 4: SapofPine (23817 in chips)=20
Seat 5: Going2Ship (20518 in chips)=20
Seat 6: Deuxexmachen (30553 in chips)=20
Seat 7: Labba609 (9130 in chips)=20
Seat 8: MeatballG10 (14189 in chips)=20
Seat 9: proletariat5 (5421 in chips)=20
FizzEdJohn: posts the ante 70
cl1ckinbtns: posts the ante 70
JJin91: posts the ante 70
SapofPine: posts the ante 70
Going2Ship: posts the ante 70
Deuxexmachen: posts the ante 70
Labba609: posts the ante 70
MeatballG10: posts the ante 70
proletariat5: posts the ante 70
Labba609: posts small blind 300
MeatballG10: posts big blind 600
*** HOLE CARDS ***
Dealt to JJin91 [Qh Js]
proletariat5: folds=20
FizzEdJohn: folds=20
cl1ckinbtns: folds=20
JJin91: folds=20
SapofPine: folds=20
Going2Ship: raises 750 to 1350
Deuxexmachen: raises 3230 to 4580
Labba609: folds=20
MeatballG10: folds=20
Going2Ship: folds=20
Uncalled bet (3230) returned to Deuxexmachen
Deuxexmachen collected 4230 from pot
Deuxexmachen: doesn't show hand=20
*** SUMMARY ***
Total pot 4230 | Rake 0=20
Seat 1: FizzEdJohn folded before Flop (didn't bet)
Seat 2: cl1ckinbtns folded before Flop (didn't bet)
Seat 3: JJin91 folded before Flop (didn't bet)
Seat 4: SapofPine folded before Flop (didn't bet)
Seat 5: Going2Ship folded before Flop
Seat 6: Deuxexmachen (button) collected (4230)
Seat 7: Labba609 (small blind) folded before Flop
Seat 8: MeatballG10 (big blind) folded before Flop
Seat 9: proletariat5 folded before Flop (didn't bet)


*********** # 99 **************
PokerStars Hand #171484428353: Tournament #1648956629, $18.20+$1.80 USD=
 Hold'em No Limit - Level XII (300/600) - 2017/06/20 21:04:57 ET
Table '1648956629 2' 9-max Seat #7 is the button
Seat 1: FizzEdJohn (23646 in chips)=20
Seat 2: cl1ckinbtns (7560 in chips)=20
Seat 3: JJin91 (39135 in chips)=20
Seat 4: SapofPine (23747 in chips)=20
Seat 5: Going2Ship (19098 in chips)=20
Seat 6: Deuxexmachen (33363 in chips)=20
Seat 7: Labba609 (8760 in chips)=20
Seat 8: MeatballG10 (13519 in chips)=20
Seat 9: proletariat5 (5351 in chips)=20
FizzEdJohn: posts the ante 70
cl1ckinbtns: posts the ante 70
JJin91: posts the ante 70
SapofPine: posts the ante 70
Going2Ship: posts the ante 70
Deuxexmachen: posts the ante 70
Labba609: posts the ante 70
MeatballG10: posts the ante 70
proletariat5: posts the ante 70
MeatballG10: posts small blind 300
proletariat5: posts big blind 600
*** HOLE CARDS ***
Dealt to JJin91 [2h As]
FizzEdJohn: folds=20
cl1ckinbtns: raises 6890 to 7490 and is all-in
JJin91: folds=20
SapofPine: folds=20
Going2Ship: folds=20
Deuxexmachen: folds=20
Labba609: folds=20
MeatballG10: folds=20
proletariat5: calls 4681 and is all-in
Uncalled bet (2209) returned to cl1ckinbtns
*** FLOP *** [8c 2c 3c]
*** TURN *** [8c 2c 3c] [Ah]
*** RIVER *** [8c 2c 3c Ah] [Td]
*** SHOW DOWN ***
proletariat5: shows [Ad Ac] (three of a kind, Aces)
cl1ckinbtns: shows [9d 9s] (a pair of Nines)
proletariat5 collected 11492 from pot
*** SUMMARY ***
Total pot 11492 | Rake 0=20
Board [8c 2c 3c Ah Td]
Seat 1: FizzEdJohn folded before Flop (didn't bet)
Seat 2: cl1ckinbtns showed [9d 9s] and lost with a pair of Nines
Seat 3: JJin91 folded before Flop (didn't bet)
Seat 4: SapofPine folded before Flop (didn't bet)
Seat 5: Going2Ship folded before Flop (didn't bet)
Seat 6: Deuxexmachen folded before Flop (didn't bet)
Seat 7: Labba609 (button) folded before Flop (didn't bet)
Seat 8: MeatballG10 (small blind) folded before Flop
Seat 9: proletariat5 (big blind) showed [Ad Ac] and won (11492) with th=
ree of a kind, Aces


*********** # 100 **************
PokerStars Hand #171484428525: Tournament #1648956629, $18.20+$1.80 USD=
 Hold'em No Limit - Level XII (300/600) - 2017/06/20 21:05:33 ET
Table '1648956629 2' 9-max Seat #8 is the button
Seat 1: FizzEdJohn (23576 in chips)=20
Seat 2: cl1ckinbtns (2209 in chips)=20
Seat 3: JJin91 (39065 in chips)=20
Seat 4: SapofPine (23677 in chips)=20
Seat 5: Going2Ship (19028 in chips)=20
Seat 6: Deuxexmachen (33293 in chips)=20
Seat 7: Labba609 (8690 in chips)=20
Seat 8: MeatballG10 (13149 in chips)=20
Seat 9: proletariat5 (11492 in chips)=20
FizzEdJohn: posts the ante 70
cl1ckinbtns: posts the ante 70
JJin91: posts the ante 70
SapofPine: posts the ante 70
Going2Ship: posts the ante 70
Deuxexmachen: posts the ante 70
Labba609: posts the ante 70
MeatballG10: posts the ante 70
proletariat5: posts the ante 70
proletariat5: posts small blind 300
FizzEdJohn: posts big blind 600
*** HOLE CARDS ***
Dealt to JJin91 [6s Td]
cl1ckinbtns: folds=20
JJin91: folds=20
SapofPine: folds=20
Going2Ship: folds=20
Deuxexmachen: folds=20
Labba609: raises 8020 to 8620 and is all-in
MeatballG10: folds=20
proletariat5: folds=20
FizzEdJohn: folds=20
Uncalled bet (8020) returned to Labba609
Labba609 collected 2130 from pot
Labba609: doesn't show hand=20
*** SUMMARY ***
Total pot 2130 | Rake 0=20
Seat 1: FizzEdJohn (big blind) folded before Flop
Seat 2: cl1ckinbtns folded before Flop (didn't bet)
Seat 3: JJin91 folded before Flop (didn't bet)
Seat 4: SapofPine folded before Flop (didn't bet)
Seat 5: Going2Ship folded before Flop (didn't bet)
Seat 6: Deuxexmachen folded before Flop (didn't bet)
Seat 7: Labba609 collected (2130)
Seat 8: MeatballG10 (button) folded before Flop (didn't bet)
Seat 9: proletariat5 (small blind) folded before Flop


*********** # 101 **************
PokerStars Hand #171484428700: Tournament #1648956629, $18.20+$1.80 USD=
 Hold'em No Limit - Level XII (300/600) - 2017/06/20 21:06:08 ET
Table '1648956629 2' 9-max Seat #9 is the button
Seat 1: FizzEdJohn (22906 in chips)=20
Seat 2: cl1ckinbtns (2139 in chips)=20
Seat 3: JJin91 (38995 in chips)=20
Seat 4: SapofPine (23607 in chips)=20
Seat 5: Going2Ship (18958 in chips)=20
Seat 6: Deuxexmachen (33223 in chips)=20
Seat 7: Labba609 (10150 in chips)=20
Seat 8: MeatballG10 (13079 in chips)=20
Seat 9: proletariat5 (11122 in chips)=20
FizzEdJohn: posts the ante 70
cl1ckinbtns: posts the ante 70
JJin91: posts the ante 70
SapofPine: posts the ante 70
Going2Ship: posts the ante 70
Deuxexmachen: posts the ante 70
Labba609: posts the ante 70
MeatballG10: posts the ante 70
proletariat5: posts the ante 70
FizzEdJohn: posts small blind 300
cl1ckinbtns: posts big blind 600
*** HOLE CARDS ***
Dealt to JJin91 [9d Qh]
JJin91: folds=20
SapofPine: folds=20
JJin91 is sitting out
Going2Ship: folds=20
Deuxexmachen: folds=20
Labba609: folds=20
MeatballG10: raises 12409 to 13009 and is all-in
proletariat5: folds=20
FizzEdJohn: folds=20
cl1ckinbtns: folds=20
Uncalled bet (12409) returned to MeatballG10
MeatballG10 collected 2130 from pot
MeatballG10: doesn't show hand=20
*** SUMMARY ***
Total pot 2130 | Rake 0=20
Seat 1: FizzEdJohn (small blind) folded before Flop
Seat 2: cl1ckinbtns (big blind) folded before Flop
Seat 3: JJin91 folded before Flop (didn't bet)
Seat 4: SapofPine folded before Flop (didn't bet)
Seat 5: Going2Ship folded before Flop (didn't bet)
Seat 6: Deuxexmachen folded before Flop (didn't bet)
Seat 7: Labba609 folded before Flop (didn't bet)
Seat 8: MeatballG10 collected (2130)
Seat 9: proletariat5 (button) folded before Flop (didn't bet)


*********** # 102 **************
PokerStars Hand #171484428817: Tournament #1648956629, $18.20+$1.80 USD=
 Hold'em No Limit - Level XII (300/600) - 2017/06/20 21:06:34 ET
Table '1648956629 2' 9-max Seat #1 is the button
Seat 1: FizzEdJohn (22536 in chips)=20
Seat 2: cl1ckinbtns (1469 in chips)=20
Seat 3: JJin91 (38925 in chips) is sitting out
Seat 4: SapofPine (23537 in chips)=20
Seat 5: Going2Ship (18888 in chips)=20
Seat 6: Deuxexmachen (33153 in chips)=20
Seat 7: Labba609 (10080 in chips)=20
Seat 8: MeatballG10 (14539 in chips)=20
Seat 9: proletariat5 (11052 in chips)=20
FizzEdJohn: posts the ante 70
cl1ckinbtns: posts the ante 70
JJin91: posts the ante 70
SapofPine: posts the ante 70
Going2Ship: posts the ante 70
Deuxexmachen: posts the ante 70
Labba609: posts the ante 70
MeatballG10: posts the ante 70
proletariat5: posts the ante 70
cl1ckinbtns: posts small blind 300
JJin91: posts big blind 600
*** HOLE CARDS ***
Dealt to JJin91 [Kh 3d]
SapofPine: folds=20
JJin91 has returned
Going2Ship: folds=20
Deuxexmachen: folds=20
Labba609: folds=20
MeatballG10: folds=20
proletariat5: folds=20
FizzEdJohn: folds=20
cl1ckinbtns: raises 799 to 1399 and is all-in
JJin91: calls 799
*** FLOP *** [8s Jh Ts]
*** TURN *** [8s Jh Ts] [9c]
*** RIVER *** [8s Jh Ts 9c] [Qc]
*** SHOW DOWN ***
cl1ckinbtns: shows [6c Ad] (a straight, Eight to Queen)
JJin91: shows [Kh 3d] (a straight, Nine to King)
cl1ckinbtns is sitting out
JJin91 collected 3428 from pot
cl1ckinbtns finished the tournament in 43rd place
*** SUMMARY ***
Total pot 3428 | Rake 0=20
Board [8s Jh Ts 9c Qc]
Seat 1: FizzEdJohn (button) folded before Flop (didn't bet)
Seat 2: cl1ckinbtns (small blind) showed [6c Ad] and lost with a straig=
ht, Eight to Queen
Seat 3: JJin91 (big blind) showed [Kh 3d] and won (3428) with a straigh=
t, Nine to King
Seat 4: SapofPine folded before Flop (didn't bet)
Seat 5: Going2Ship folded before Flop (didn't bet)
Seat 6: Deuxexmachen folded before Flop (didn't bet)
Seat 7: Labba609 folded before Flop (didn't bet)
Seat 8: MeatballG10 folded before Flop (didn't bet)
Seat 9: proletariat5 folded before Flop (didn't bet)


*********** # 103 **************
PokerStars Hand #171484429022: Tournament #1648956629, $18.20+$1.80 USD=
 Hold'em No Limit - Level XII (300/600) - 2017/06/20 21:07:18 ET
Table '1648956629 2' 9-max Seat #3 is the button
Seat 1: FizzEdJohn (22466 in chips)=20
Seat 3: JJin91 (40884 in chips)=20
Seat 4: SapofPine (23467 in chips)=20
Seat 5: Going2Ship (18818 in chips)=20
Seat 6: Deuxexmachen (33083 in chips)=20
Seat 7: Labba609 (10010 in chips)=20
Seat 8: MeatballG10 (14469 in chips)=20
Seat 9: proletariat5 (10982 in chips)=20
FizzEdJohn: posts the ante 70
JJin91: posts the ante 70
SapofPine: posts the ante 70
Going2Ship: posts the ante 70
Deuxexmachen: posts the ante 70
Labba609: posts the ante 70
MeatballG10: posts the ante 70
proletariat5: posts the ante 70
SapofPine: posts small blind 300
Going2Ship: posts big blind 600
*** HOLE CARDS ***
Dealt to JJin91 [5d 5h]
Deuxexmachen: folds=20
Labba609: folds=20
MeatballG10: folds=20
proletariat5: folds=20
FizzEdJohn: folds=20
JJin91: raises 942 to 1542
SapofPine: folds=20
Going2Ship: raises 2058 to 3600
JJin91: calls 2058
*** FLOP *** [9c 4d Qh]
Going2Ship: checks=20
JJin91: bets 2982
Going2Ship: folds=20
Uncalled bet (2982) returned to JJin91
JJin91 collected 8060 from pot
JJin91: doesn't show hand=20
*** SUMMARY ***
Total pot 8060 | Rake 0=20
Board [9c 4d Qh]
Seat 1: FizzEdJohn folded before Flop (didn't bet)
Seat 3: JJin91 (button) collected (8060)
Seat 4: SapofPine (small blind) folded before Flop
Seat 5: Going2Ship (big blind) folded on the Flop
Seat 6: Deuxexmachen folded before Flop (didn't bet)
Seat 7: Labba609 folded before Flop (didn't bet)
Seat 8: MeatballG10 folded before Flop (didn't bet)
Seat 9: proletariat5 folded before Flop (didn't bet)


*********** # 104 **************
PokerStars Hand #171484429223: Tournament #1648956629, $18.20+$1.80 USD=
 Hold'em No Limit - Level XII (300/600) - 2017/06/20 21:08:00 ET
Table '1648956629 2' 9-max Seat #4 is the button
Seat 1: FizzEdJohn (22396 in chips)=20
Seat 3: JJin91 (45274 in chips)=20
Seat 4: SapofPine (23097 in chips)=20
Seat 5: Going2Ship (15148 in chips)=20
Seat 6: Deuxexmachen (33013 in chips)=20
Seat 7: Labba609 (9940 in chips)=20
Seat 8: MeatballG10 (14399 in chips)=20
Seat 9: proletariat5 (10912 in chips)=20
FizzEdJohn: posts the ante 70
JJin91: posts the ante 70
SapofPine: posts the ante 70
Going2Ship: posts the ante 70
Deuxexmachen: posts the ante 70
Labba609: posts the ante 70
MeatballG10: posts the ante 70
proletariat5: posts the ante 70
Going2Ship: posts small blind 300
Deuxexmachen: posts big blind 600
*** HOLE CARDS ***
Dealt to JJin91 [6h 8s]
Labba609: folds=20
MeatballG10: folds=20
proletariat5: folds=20
FizzEdJohn: raises 690 to 1290
JJin91: folds=20
SapofPine: folds=20
Going2Ship: folds=20
Deuxexmachen: folds=20
Uncalled bet (690) returned to FizzEdJohn
FizzEdJohn collected 2060 from pot
FizzEdJohn: doesn't show hand=20
*** SUMMARY ***
Total pot 2060 | Rake 0=20
Seat 1: FizzEdJohn collected (2060)
Seat 3: JJin91 folded before Flop (didn't bet)
Seat 4: SapofPine (button) folded before Flop (didn't bet)
Seat 5: Going2Ship (small blind) folded before Flop
Seat 6: Deuxexmachen (big blind) folded before Flop
Seat 7: Labba609 folded before Flop (didn't bet)
Seat 8: MeatballG10 folded before Flop (didn't bet)
Seat 9: proletariat5 folded before Flop (didn't bet)


*********** # 105 **************
PokerStars Hand #171484429367: Tournament #1648956629, $18.20+$1.80 USD=
 Hold'em No Limit - Level XII (300/600) - 2017/06/20 21:08:29 ET
Table '1648956629 2' 9-max Seat #5 is the button
Seat 1: FizzEdJohn (23786 in chips)=20
Seat 3: JJin91 (45204 in chips)=20
Seat 4: SapofPine (23027 in chips)=20
Seat 5: Going2Ship (14778 in chips)=20
Seat 6: Deuxexmachen (32343 in chips)=20
Seat 7: Labba609 (9870 in chips)=20
Seat 8: MeatballG10 (14329 in chips)=20
Seat 9: proletariat5 (10842 in chips)=20
FizzEdJohn: posts the ante 70
JJin91: posts the ante 70
SapofPine: posts the ante 70
Going2Ship: posts the ante 70
Deuxexmachen: posts the ante 70
Labba609: posts the ante 70
MeatballG10: posts the ante 70
proletariat5: posts the ante 70
Deuxexmachen: posts small blind 300
Labba609: posts big blind 600
*** HOLE CARDS ***
Dealt to JJin91 [8d 2h]
MeatballG10: raises 900 to 1500
proletariat5: folds=20
FizzEdJohn: folds=20
JJin91: folds=20
SapofPine: folds=20
Going2Ship: folds=20
Deuxexmachen: folds=20
Labba609: folds=20
Uncalled bet (900) returned to MeatballG10
MeatballG10 collected 2060 from pot
MeatballG10: doesn't show hand=20
*** SUMMARY ***
Total pot 2060 | Rake 0=20
Seat 1: FizzEdJohn folded before Flop (didn't bet)
Seat 3: JJin91 folded before Flop (didn't bet)
Seat 4: SapofPine folded before Flop (didn't bet)
Seat 5: Going2Ship (button) folded before Flop (didn't bet)
Seat 6: Deuxexmachen (small blind) folded before Flop
Seat 7: Labba609 (big blind) folded before Flop
Seat 8: MeatballG10 collected (2060)
Seat 9: proletariat5 folded before Flop (didn't bet)


*********** # 106 **************
PokerStars Hand #171484429469: Tournament #1648956629, $18.20+$1.80 USD=
 Hold'em No Limit - Level XII (300/600) - 2017/06/20 21:08:51 ET
Table '1648956629 2' 9-max Seat #6 is the button
Seat 1: FizzEdJohn (23716 in chips)=20
Seat 3: JJin91 (45134 in chips)=20
Seat 4: SapofPine (22957 in chips)=20
Seat 5: Going2Ship (14708 in chips)=20
Seat 6: Deuxexmachen (31973 in chips)=20
Seat 7: Labba609 (9200 in chips)=20
Seat 8: MeatballG10 (15719 in chips)=20
Seat 9: proletariat5 (10772 in chips)=20
FizzEdJohn: posts the ante 70
JJin91: posts the ante 70
SapofPine: posts the ante 70
Going2Ship: posts the ante 70
Deuxexmachen: posts the ante 70
Labba609: posts the ante 70
MeatballG10: posts the ante 70
proletariat5: posts the ante 70
Labba609: posts small blind 300
MeatballG10: posts big blind 600
*** HOLE CARDS ***
Dealt to JJin91 [4d Qc]
proletariat5: folds=20
FizzEdJohn: raises 690 to 1290
JJin91: folds=20
SapofPine: calls 1290
Going2Ship: folds=20
Deuxexmachen: folds=20
Labba609: folds=20
MeatballG10: calls 690
*** FLOP *** [6h Jc Kd]
MeatballG10: checks=20
FizzEdJohn: checks=20
SapofPine: checks=20
*** TURN *** [6h Jc Kd] [6s]
MeatballG10: checks=20
FizzEdJohn: checks=20
SapofPine: bets 1939
MeatballG10: folds=20
FizzEdJohn: calls 1939
*** RIVER *** [6h Jc Kd 6s] [Ac]
FizzEdJohn: checks=20
SapofPine: checks=20
*** SHOW DOWN ***
FizzEdJohn: shows [9d 9h] (two pair, Nines and Sixes)
SapofPine: mucks hand=20
FizzEdJohn collected 8608 from pot
*** SUMMARY ***
Total pot 8608 | Rake 0=20
Board [6h Jc Kd 6s Ac]
Seat 1: FizzEdJohn showed [9d 9h] and won (8608) with two pair, Nines a=
nd Sixes
Seat 3: JJin91 folded before Flop (didn't bet)
Seat 4: SapofPine mucked [7s 7h]
Seat 5: Going2Ship folded before Flop (didn't bet)
Seat 6: Deuxexmachen (button) folded before Flop (didn't bet)
Seat 7: Labba609 (small blind) folded before Flop
Seat 8: MeatballG10 (big blind) folded on the Turn
Seat 9: proletariat5 folded before Flop (didn't bet)


*********** # 107 **************
PokerStars Hand #171484429829: Tournament #1648956629, $18.20+$1.80 USD=
 Hold'em No Limit - Level XII (300/600) - 2017/06/20 21:10:12 ET
Table '1648956629 2' 9-max Seat #7 is the button
Seat 1: FizzEdJohn (29025 in chips)=20
Seat 3: JJin91 (45064 in chips)=20
Seat 4: SapofPine (19658 in chips)=20
Seat 5: Going2Ship (14638 in chips)=20
Seat 6: Deuxexmachen (31903 in chips)=20
Seat 7: Labba609 (8830 in chips)=20
Seat 8: MeatballG10 (14359 in chips)=20
Seat 9: proletariat5 (10702 in chips)=20
FizzEdJohn: posts the ante 70
JJin91: posts the ante 70
SapofPine: posts the ante 70
Going2Ship: posts the ante 70
Deuxexmachen: posts the ante 70
Labba609: posts the ante 70
MeatballG10: posts the ante 70
proletariat5: posts the ante 70
MeatballG10: posts small blind 300
proletariat5: posts big blind 600
*** HOLE CARDS ***
Dealt to JJin91 [Ks 2h]
FizzEdJohn: raises 690 to 1290
JJin91: folds=20
SapofPine: calls 1290
Going2Ship: folds=20
Deuxexmachen: folds=20
Labba609: folds=20
MeatballG10: folds=20
proletariat5: folds=20
*** FLOP *** [9d 4d Td]
FizzEdJohn: checks=20
SapofPine: checks=20
*** TURN *** [9d 4d Td] [6d]
FizzEdJohn: checks=20
SapofPine: bets 1656
FizzEdJohn: calls 1656
*** RIVER *** [9d 4d Td 6d] [7s]
FizzEdJohn: checks=20
SapofPine: bets 4999
FizzEdJohn: folds=20
Uncalled bet (4999) returned to SapofPine
SapofPine collected 7352 from pot
*** SUMMARY ***
Total pot 7352 | Rake 0=20
Board [9d 4d Td 6d 7s]
Seat 1: FizzEdJohn folded on the River
Seat 3: JJin91 folded before Flop (didn't bet)
Seat 4: SapofPine collected (7352)
Seat 5: Going2Ship folded before Flop (didn't bet)
Seat 6: Deuxexmachen folded before Flop (didn't bet)
Seat 7: Labba609 (button) folded before Flop (didn't bet)
Seat 8: MeatballG10 (small blind) folded before Flop
Seat 9: proletariat5 (big blind) folded before Flop


*********** # 108 **************
PokerStars Hand #171485620576: Tournament #1648956629, $18.20+$1.80 USD=
 Hold'em No Limit - Level XIII (350/700) - 2017/06/20 21:12:07 ET
Table '1648956629 2' 9-max Seat #8 is the button
Seat 1: FizzEdJohn (26009 in chips)=20
Seat 3: JJin91 (44994 in chips)=20
Seat 4: SapofPine (23994 in chips)=20
Seat 5: Going2Ship (14568 in chips)=20
Seat 6: Deuxexmachen (31833 in chips)=20
Seat 7: Labba609 (8760 in chips)=20
Seat 8: MeatballG10 (13989 in chips)=20
Seat 9: proletariat5 (10032 in chips)=20
FizzEdJohn: posts the ante 85
JJin91: posts the ante 85
SapofPine: posts the ante 85
Going2Ship: posts the ante 85
Deuxexmachen: posts the ante 85
Labba609: posts the ante 85
MeatballG10: posts the ante 85
proletariat5: posts the ante 85
proletariat5: posts small blind 350
FizzEdJohn: posts big blind 700
*** HOLE CARDS ***
Dealt to JJin91 [6d Th]
JJin91: folds=20
SapofPine: raises 1043 to 1743
Going2Ship: folds=20
Deuxexmachen: folds=20
Labba609: folds=20
MeatballG10: folds=20
proletariat5: folds=20
FizzEdJohn: folds=20
Uncalled bet (1043) returned to SapofPine
SapofPine collected 2430 from pot
*** SUMMARY ***
Total pot 2430 | Rake 0=20
Seat 1: FizzEdJohn (big blind) folded before Flop
Seat 3: JJin91 folded before Flop (didn't bet)
Seat 4: SapofPine collected (2430)
Seat 5: Going2Ship folded before Flop (didn't bet)
Seat 6: Deuxexmachen folded before Flop (didn't bet)
Seat 7: Labba609 folded before Flop (didn't bet)
Seat 8: MeatballG10 (button) folded before Flop (didn't bet)
Seat 9: proletariat5 (small blind) folded before Flop


*********** # 109 **************
PokerStars Hand #171485620705: Tournament #1648956629, $18.20+$1.80 USD=
 Hold'em No Limit - Level XIII (350/700) - 2017/06/20 21:12:31 ET
Table '1648956629 2' 9-max Seat #9 is the button
Seat 1: FizzEdJohn (25224 in chips)=20
Seat 3: JJin91 (44909 in chips)=20
Seat 4: SapofPine (25639 in chips)=20
Seat 5: Going2Ship (14483 in chips)=20
Seat 6: Deuxexmachen (31748 in chips)=20
Seat 7: Labba609 (8675 in chips)=20
Seat 8: MeatballG10 (13904 in chips)=20
Seat 9: proletariat5 (9597 in chips)=20
FizzEdJohn: posts the ante 85
JJin91: posts the ante 85
SapofPine: posts the ante 85
Going2Ship: posts the ante 85
Deuxexmachen: posts the ante 85
Labba609: posts the ante 85
MeatballG10: posts the ante 85
proletariat5: posts the ante 85
FizzEdJohn: posts small blind 350
JJin91: posts big blind 700
*** HOLE CARDS ***
Dealt to JJin91 [As 2c]
SapofPine: folds=20
Going2Ship: folds=20
Deuxexmachen: folds=20
Labba609: folds=20
MeatballG10: folds=20
proletariat5: folds=20
FizzEdJohn: raises 1050 to 1750
JJin91: calls 1050
*** FLOP *** [3d 8d 3c]
FizzEdJohn: bets 1463
JJin91: calls 1463
*** TURN *** [3d 8d 3c] [4s]
FizzEdJohn has timed out
FizzEdJohn: checks=20
JJin91: bets 2829
FizzEdJohn: folds=20
Uncalled bet (2829) returned to JJin91
JJin91 collected 7106 from pot
JJin91: doesn't show hand=20
*** SUMMARY ***
Total pot 7106 | Rake 0=20
Board [3d 8d 3c 4s]
Seat 1: FizzEdJohn (small blind) folded on the Turn
Seat 3: JJin91 (big blind) collected (7106)
Seat 4: SapofPine folded before Flop (didn't bet)
Seat 5: Going2Ship folded before Flop (didn't bet)
Seat 6: Deuxexmachen folded before Flop (didn't bet)
Seat 7: Labba609 folded before Flop (didn't bet)
Seat 8: MeatballG10 folded before Flop (didn't bet)
Seat 9: proletariat5 (button) folded before Flop (didn't bet)


*********** # 110 **************
PokerStars Hand #171485621093: Tournament #1648956629, $18.20+$1.80 USD=
 Hold'em No Limit - Level XIII (350/700) - 2017/06/20 21:14:02 ET
Table '1648956629 2' 9-max Seat #1 is the button
Seat 1: FizzEdJohn (21926 in chips)=20
Seat 3: JJin91 (48717 in chips)=20
Seat 4: SapofPine (25554 in chips)=20
Seat 5: Going2Ship (14398 in chips)=20
Seat 6: Deuxexmachen (31663 in chips)=20
Seat 7: Labba609 (8590 in chips)=20
Seat 8: MeatballG10 (13819 in chips)=20
Seat 9: proletariat5 (9512 in chips)=20
FizzEdJohn: posts the ante 85
JJin91: posts the ante 85
SapofPine: posts the ante 85
Going2Ship: posts the ante 85
Deuxexmachen: posts the ante 85
Labba609: posts the ante 85
MeatballG10: posts the ante 85
proletariat5: posts the ante 85
JJin91: posts small blind 350
SapofPine: posts big blind 700
*** HOLE CARDS ***
Dealt to JJin91 [5s Ks]
Going2Ship: raises 700 to 1400
Deuxexmachen: folds=20
Labba609: folds=20
MeatballG10: folds=20
proletariat5: folds=20
FizzEdJohn: folds=20
JJin91: folds=20
SapofPine: folds=20
Uncalled bet (700) returned to Going2Ship
Going2Ship collected 2430 from pot
Going2Ship: doesn't show hand=20
*** SUMMARY ***
Total pot 2430 | Rake 0=20
Seat 1: FizzEdJohn (button) folded before Flop (didn't bet)
Seat 3: JJin91 (small blind) folded before Flop
Seat 4: SapofPine (big blind) folded before Flop
Seat 5: Going2Ship collected (2430)
Seat 6: Deuxexmachen folded before Flop (didn't bet)
Seat 7: Labba609 folded before Flop (didn't bet)
Seat 8: MeatballG10 folded before Flop (didn't bet)
Seat 9: proletariat5 folded before Flop (didn't bet)


*********** # 111 **************
PokerStars Hand #171485621226: Tournament #1648956629, $18.20+$1.80 USD=
 Hold'em No Limit - Level XIII (350/700) - 2017/06/20 21:14:32 ET
Table '1648956629 2' 9-max Seat #3 is the button
Seat 1: FizzEdJohn (21841 in chips)=20
Seat 3: JJin91 (48282 in chips)=20
Seat 4: SapofPine (24769 in chips)=20
Seat 5: Going2Ship (16043 in chips)=20
Seat 6: Deuxexmachen (31578 in chips)=20
Seat 7: Labba609 (8505 in chips)=20
Seat 8: MeatballG10 (13734 in chips)=20
Seat 9: proletariat5 (9427 in chips)=20
FizzEdJohn: posts the ante 85
JJin91: posts the ante 85
SapofPine: posts the ante 85
Going2Ship: posts the ante 85
Deuxexmachen: posts the ante 85
Labba609: posts the ante 85
MeatballG10: posts the ante 85
proletariat5: posts the ante 85
SapofPine: posts small blind 350
Going2Ship: posts big blind 700
*** HOLE CARDS ***
Dealt to JJin91 [3s Jh]
Deuxexmachen: folds=20
Labba609: folds=20
MeatballG10: calls 700
proletariat5: folds=20
FizzEdJohn: folds=20
JJin91: folds=20
SapofPine: folds=20
Going2Ship: checks=20
*** FLOP *** [8s 4d 3d]
Going2Ship: checks=20
MeatballG10: checks=20
*** TURN *** [8s 4d 3d] [Kh]
Going2Ship: checks=20
MeatballG10: bets 1122
Going2Ship: folds=20
Uncalled bet (1122) returned to MeatballG10
MeatballG10 collected 2430 from pot
MeatballG10: doesn't show hand=20
*** SUMMARY ***
Total pot 2430 | Rake 0=20
Board [8s 4d 3d Kh]
Seat 1: FizzEdJohn folded before Flop (didn't bet)
Seat 3: JJin91 (button) folded before Flop (didn't bet)
Seat 4: SapofPine (small blind) folded before Flop
Seat 5: Going2Ship (big blind) folded on the Turn
Seat 6: Deuxexmachen folded before Flop (didn't bet)
Seat 7: Labba609 folded before Flop (didn't bet)
Seat 8: MeatballG10 collected (2430)
Seat 9: proletariat5 folded before Flop (didn't bet)


*********** # 112 **************
PokerStars Hand #171485621391: Tournament #1648956629, $18.20+$1.80 USD=
 Hold'em No Limit - Level XIII (350/700) - 2017/06/20 21:15:13 ET
Table '1648956629 2' 9-max Seat #4 is the button
Seat 1: FizzEdJohn (21756 in chips)=20
Seat 3: JJin91 (48197 in chips)=20
Seat 4: SapofPine (24334 in chips)=20
Seat 5: Going2Ship (15258 in chips)=20
Seat 6: Deuxexmachen (31493 in chips)=20
Seat 7: Labba609 (8420 in chips)=20
Seat 8: MeatballG10 (15379 in chips)=20
Seat 9: proletariat5 (9342 in chips)=20
FizzEdJohn: posts the ante 85
JJin91: posts the ante 85
SapofPine: posts the ante 85
Going2Ship: posts the ante 85
Deuxexmachen: posts the ante 85
Labba609: posts the ante 85
MeatballG10: posts the ante 85
proletariat5: posts the ante 85
Going2Ship: posts small blind 350
Deuxexmachen: posts big blind 700
*** HOLE CARDS ***
Dealt to JJin91 [Tc 3d]
Labba609: raises 7635 to 8335 and is all-in
MeatballG10: folds=20
proletariat5: folds=20
FizzEdJohn: calls 8335
JJin91: folds=20
SapofPine: raises 15914 to 24249 and is all-in
Going2Ship: folds=20
Deuxexmachen: folds=20
FizzEdJohn: calls 13336 and is all-in
Uncalled bet (2578) returned to SapofPine
*** FLOP *** [3s 7d Kc]
*** TURN *** [3s 7d Kc] [8d]
*** RIVER *** [3s 7d Kc 8d] [Js]
*** SHOW DOWN ***
FizzEdJohn: shows [Qd Qc] (a pair of Queens)
SapofPine: shows [Td Ts] (a pair of Tens)
FizzEdJohn collected 26672 from side pot
Labba609: shows [As Ks] (a pair of Kings)
Labba609 collected 26735 from main pot
*** SUMMARY ***
Total pot 53407 Main pot 26735. Side pot 26672. | Rake 0=20
Board [3s 7d Kc 8d Js]
Seat 1: FizzEdJohn showed [Qd Qc] and won (26672) with a pair of Queens
Seat 3: JJin91 folded before Flop (didn't bet)
Seat 4: SapofPine (button) showed [Td Ts] and lost with a pair of Tens
Seat 5: Going2Ship (small blind) folded before Flop
Seat 6: Deuxexmachen (big blind) folded before Flop
Seat 7: Labba609 showed [As Ks] and won (26735) with a pair of Kings
Seat 8: MeatballG10 folded before Flop (didn't bet)
Seat 9: proletariat5 folded before Flop (didn't bet)


*********** # 113 **************
PokerStars Hand #171485621562: Tournament #1648956629, $18.20+$1.80 USD=
 Hold'em No Limit - Level XIII (350/700) - 2017/06/20 21:15:52 ET
Table '1648956629 2' 9-max Seat #5 is the button
Seat 1: FizzEdJohn (26672 in chips)=20
Seat 3: JJin91 (48112 in chips)=20
Seat 4: SapofPine (2578 in chips)=20
Seat 5: Going2Ship (14823 in chips)=20
Seat 6: Deuxexmachen (30708 in chips)=20
Seat 7: Labba609 (26735 in chips)=20
Seat 8: MeatballG10 (15294 in chips)=20
Seat 9: proletariat5 (9257 in chips)=20
FizzEdJohn: posts the ante 85
JJin91: posts the ante 85
SapofPine: posts the ante 85
Going2Ship: posts the ante 85
Deuxexmachen: posts the ante 85
Labba609: posts the ante 85
MeatballG10: posts the ante 85
proletariat5: posts the ante 85
Deuxexmachen: posts small blind 350
Labba609: posts big blind 700
*** HOLE CARDS ***
Dealt to JJin91 [Td Kc]
MeatballG10: calls 700
proletariat5: folds=20
FizzEdJohn: raises 1499 to 2199
JJin91: folds=20
SapofPine: raises 294 to 2493 and is all-in
Going2Ship: folds=20
Deuxexmachen: folds=20
Labba609: folds=20
MeatballG10: calls 1793
FizzEdJohn: calls 294
*** FLOP *** [Ts 4s Ah]
MeatballG10: checks=20
FizzEdJohn: checks=20
*** TURN *** [Ts 4s Ah] [7d]
MeatballG10: checks=20
FizzEdJohn has timed out
FizzEdJohn: checks=20
*** RIVER *** [Ts 4s Ah 7d] [Jc]
MeatballG10: checks=20
FizzEdJohn has timed out
FizzEdJohn: checks=20
*** SHOW DOWN ***
MeatballG10: shows [Qh Js] (a pair of Jacks)
FizzEdJohn: shows [Qd Qs] (a pair of Queens)
SapofPine: shows [7c 7s] (three of a kind, Sevens)
SapofPine collected 9209 from pot
*** SUMMARY ***
Total pot 9209 | Rake 0=20
Board [Ts 4s Ah 7d Jc]
Seat 1: FizzEdJohn showed [Qd Qs] and lost with a pair of Queens
Seat 3: JJin91 folded before Flop (didn't bet)
Seat 4: SapofPine showed [7c 7s] and won (9209) with three of a kind, S=
evens
Seat 5: Going2Ship (button) folded before Flop (didn't bet)
Seat 6: Deuxexmachen (small blind) folded before Flop
Seat 7: Labba609 (big blind) folded before Flop
Seat 8: MeatballG10 showed [Qh Js] and lost with a pair of Jacks
Seat 9: proletariat5 folded before Flop (didn't bet)


*********** # 114 **************
PokerStars Hand #171485622121: Tournament #1648956629, $18.20+$1.80 USD=
 Hold'em No Limit - Level XIII (350/700) - 2017/06/20 21:17:52 ET
Table '1648956629 2' 9-max Seat #6 is the button
Seat 1: FizzEdJohn (24094 in chips)=20
Seat 2: bulibasav (36870 in chips)=20
Seat 3: JJin91 (48027 in chips)=20
Seat 4: SapofPine (9209 in chips)=20
Seat 5: Going2Ship (14738 in chips)=20
Seat 6: Deuxexmachen (30273 in chips)=20
Seat 7: Labba609 (25950 in chips)=20
Seat 8: MeatballG10 (12716 in chips)=20
Seat 9: proletariat5 (9172 in chips)=20
FizzEdJohn: posts the ante 85
bulibasav: posts the ante 85
JJin91: posts the ante 85
SapofPine: posts the ante 85
Going2Ship: posts the ante 85
Deuxexmachen: posts the ante 85
Labba609: posts the ante 85
MeatballG10: posts the ante 85
proletariat5: posts the ante 85
Labba609: posts small blind 350
MeatballG10: posts big blind 700
*** HOLE CARDS ***
Dealt to JJin91 [9d 6h]
proletariat5: folds=20
FizzEdJohn: raises 805 to 1505
bulibasav: folds=20
JJin91: folds=20
SapofPine: folds=20
Going2Ship: folds=20
Deuxexmachen: folds=20
Labba609: folds=20
MeatballG10: raises 11126 to 12631 and is all-in
FizzEdJohn: folds=20
Uncalled bet (11126) returned to MeatballG10
MeatballG10 collected 4125 from pot
MeatballG10: doesn't show hand=20
*** SUMMARY ***
Total pot 4125 | Rake 0=20
Seat 1: FizzEdJohn folded before Flop
Seat 2: bulibasav folded before Flop (didn't bet)
Seat 3: JJin91 folded before Flop (didn't bet)
Seat 4: SapofPine folded before Flop (didn't bet)
Seat 5: Going2Ship folded before Flop (didn't bet)
Seat 6: Deuxexmachen (button) folded before Flop (didn't bet)
Seat 7: Labba609 (small blind) folded before Flop
Seat 8: MeatballG10 (big blind) collected (4125)
Seat 9: proletariat5 folded before Flop (didn't bet)


*********** # 115 **************
PokerStars Hand #171485622343: Tournament #1648956629, $18.20+$1.80 USD=
 Hold'em No Limit - Level XIII (350/700) - 2017/06/20 21:18:39 ET
Table '1648956629 2' 9-max Seat #7 is the button
Seat 1: FizzEdJohn (22504 in chips)=20
Seat 2: bulibasav (36785 in chips)=20
Seat 3: JJin91 (47942 in chips)=20
Seat 4: SapofPine (9124 in chips)=20
Seat 5: Going2Ship (14653 in chips)=20
Seat 6: Deuxexmachen (30188 in chips)=20
Seat 7: Labba609 (25515 in chips)=20
Seat 8: MeatballG10 (15251 in chips)=20
Seat 9: proletariat5 (9087 in chips)=20
FizzEdJohn: posts the ante 85
bulibasav: posts the ante 85
JJin91: posts the ante 85
SapofPine: posts the ante 85
Going2Ship: posts the ante 85
Deuxexmachen: posts the ante 85
Labba609: posts the ante 85
MeatballG10: posts the ante 85
proletariat5: posts the ante 85
MeatballG10: posts small blind 350
proletariat5: posts big blind 700
*** HOLE CARDS ***
Dealt to JJin91 [5d 7d]
FizzEdJohn: folds=20
bulibasav: folds=20
JJin91: folds=20
SapofPine: folds=20
Going2Ship: folds=20
Deuxexmachen: raises 1175 to 1875
Labba609: folds=20
MeatballG10: folds=20
proletariat5: folds=20
Uncalled bet (1175) returned to Deuxexmachen
Deuxexmachen collected 2515 from pot
Deuxexmachen: doesn't show hand=20
*** SUMMARY ***
Total pot 2515 | Rake 0=20
Seat 1: FizzEdJohn folded before Flop (didn't bet)
Seat 2: bulibasav folded before Flop (didn't bet)
Seat 3: JJin91 folded before Flop (didn't bet)
Seat 4: SapofPine folded before Flop (didn't bet)
Seat 5: Going2Ship folded before Flop (didn't bet)
Seat 6: Deuxexmachen collected (2515)
Seat 7: Labba609 (button) folded before Flop (didn't bet)
Seat 8: MeatballG10 (small blind) folded before Flop
Seat 9: proletariat5 (big blind) folded before Flop


*********** # 116 **************
PokerStars Hand #171485622511: Tournament #1648956629, $18.20+$1.80 USD=
 Hold'em No Limit - Level XIII (350/700) - 2017/06/20 21:19:19 ET
Table '1648956629 2' 9-max Seat #8 is the button
Seat 1: FizzEdJohn (22419 in chips)=20
Seat 2: bulibasav (36700 in chips)=20
Seat 3: JJin91 (47857 in chips)=20
Seat 4: SapofPine (9039 in chips)=20
Seat 5: Going2Ship (14568 in chips)=20
Seat 6: Deuxexmachen (31918 in chips)=20
Seat 7: Labba609 (25430 in chips)=20
Seat 8: MeatballG10 (14816 in chips)=20
Seat 9: proletariat5 (8302 in chips)=20
FizzEdJohn: posts the ante 85
bulibasav: posts the ante 85
JJin91: posts the ante 85
SapofPine: posts the ante 85
Going2Ship: posts the ante 85
Deuxexmachen: posts the ante 85
Labba609: posts the ante 85
MeatballG10: posts the ante 85
proletariat5: posts the ante 85
proletariat5: posts small blind 350
FizzEdJohn: posts big blind 700
*** HOLE CARDS ***
Dealt to JJin91 [9c 6h]
bulibasav: folds=20
JJin91: folds=20
SapofPine: folds=20
Going2Ship: folds=20
Deuxexmachen: folds=20
Labba609: raises 1050 to 1750
MeatballG10: raises 12981 to 14731 and is all-in
proletariat5: folds=20
FizzEdJohn: folds=20
Labba609: folds=20
Uncalled bet (12981) returned to MeatballG10
MeatballG10 collected 5315 from pot
MeatballG10: doesn't show hand=20
*** SUMMARY ***
Total pot 5315 | Rake 0=20
Seat 1: FizzEdJohn (big blind) folded before Flop
Seat 2: bulibasav folded before Flop (didn't bet)
Seat 3: JJin91 folded before Flop (didn't bet)
Seat 4: SapofPine folded before Flop (didn't bet)
Seat 5: Going2Ship folded before Flop (didn't bet)
Seat 6: Deuxexmachen folded before Flop (didn't bet)
Seat 7: Labba609 folded before Flop
Seat 8: MeatballG10 (button) collected (5315)
Seat 9: proletariat5 (small blind) folded before Flop


*********** # 117 **************
PokerStars Hand #171485622608: Tournament #1648956629, $18.20+$1.80 USD=
 Hold'em No Limit - Level XIII (350/700) - 2017/06/20 21:19:42 ET
Table '1648956629 2' 9-max Seat #9 is the button
Seat 1: FizzEdJohn (21634 in chips)=20
Seat 2: bulibasav (36615 in chips)=20
Seat 3: JJin91 (47772 in chips)=20
Seat 4: SapofPine (8954 in chips)=20
Seat 5: Going2Ship (14483 in chips)=20
Seat 6: Deuxexmachen (31833 in chips)=20
Seat 7: Labba609 (23595 in chips)=20
Seat 8: MeatballG10 (18296 in chips)=20
Seat 9: proletariat5 (7867 in chips)=20
FizzEdJohn: posts the ante 85
bulibasav: posts the ante 85
JJin91: posts the ante 85
SapofPine: posts the ante 85
Going2Ship: posts the ante 85
Deuxexmachen: posts the ante 85
Labba609: posts the ante 85
MeatballG10: posts the ante 85
proletariat5: posts the ante 85
FizzEdJohn: posts small blind 350
bulibasav: posts big blind 700
*** HOLE CARDS ***
Dealt to JJin91 [4s 3s]
JJin91: folds=20
SapofPine: folds=20
Going2Ship: folds=20
Deuxexmachen: raises 1175 to 1875
Labba609: calls 1875
MeatballG10: folds=20
proletariat5: folds=20
FizzEdJohn: folds=20
bulibasav: folds=20
*** FLOP *** [4h Jh 8d]
Deuxexmachen: bets 2783
Labba609: folds=20
Uncalled bet (2783) returned to Deuxexmachen
Deuxexmachen collected 5565 from pot
Deuxexmachen: doesn't show hand=20
*** SUMMARY ***
Total pot 5565 | Rake 0=20
Board [4h Jh 8d]
Seat 1: FizzEdJohn (small blind) folded before Flop
Seat 2: bulibasav (big blind) folded before Flop
Seat 3: JJin91 folded before Flop (didn't bet)
Seat 4: SapofPine folded before Flop (didn't bet)
Seat 5: Going2Ship folded before Flop (didn't bet)
Seat 6: Deuxexmachen collected (5565)
Seat 7: Labba609 folded on the Flop
Seat 8: MeatballG10 folded before Flop (didn't bet)
Seat 9: proletariat5 (button) folded before Flop (didn't bet)


*********** # 118 **************
PokerStars Hand #171485622798: Tournament #1648956629, $18.20+$1.80 USD=
 Hold'em No Limit - Level XIII (350/700) - 2017/06/20 21:20:26 ET
Table '1648956629 2' 9-max Seat #1 is the button
Seat 1: FizzEdJohn (21199 in chips)=20
Seat 2: bulibasav (35830 in chips)=20
Seat 3: JJin91 (47687 in chips)=20
Seat 4: SapofPine (8869 in chips)=20
Seat 5: Going2Ship (14398 in chips)=20
Seat 6: Deuxexmachen (35438 in chips)=20
Seat 7: Labba609 (21635 in chips)=20
Seat 8: MeatballG10 (18211 in chips)=20
Seat 9: proletariat5 (7782 in chips)=20
FizzEdJohn: posts the ante 85
bulibasav: posts the ante 85
JJin91: posts the ante 85
SapofPine: posts the ante 85
Going2Ship: posts the ante 85
Deuxexmachen: posts the ante 85
Labba609: posts the ante 85
MeatballG10: posts the ante 85
proletariat5: posts the ante 85
bulibasav: posts small blind 350
JJin91: posts big blind 700
*** HOLE CARDS ***
Dealt to JJin91 [Qh 8c]
SapofPine: folds=20
Going2Ship: folds=20
Deuxexmachen: raises 1175 to 1875
Labba609: folds=20
MeatballG10: raises 16251 to 18126 and is all-in
proletariat5: folds=20
FizzEdJohn: folds=20
bulibasav: folds=20
JJin91: folds=20
Deuxexmachen: folds=20
Uncalled bet (16251) returned to MeatballG10
MeatballG10 collected 5565 from pot
MeatballG10: doesn't show hand=20
*** SUMMARY ***
Total pot 5565 | Rake 0=20
Seat 1: FizzEdJohn (button) folded before Flop (didn't bet)
Seat 2: bulibasav (small blind) folded before Flop
Seat 3: JJin91 (big blind) folded before Flop
Seat 4: SapofPine folded before Flop (didn't bet)
Seat 5: Going2Ship folded before Flop (didn't bet)
Seat 6: Deuxexmachen folded before Flop
Seat 7: Labba609 folded before Flop (didn't bet)
Seat 8: MeatballG10 collected (5565)
Seat 9: proletariat5 folded before Flop (didn't bet)


*********** # 119 **************
PokerStars Hand #171485623015: Tournament #1648956629, $18.20+$1.80 USD=
 Hold'em No Limit - Level XIII (350/700) - 2017/06/20 21:21:11 ET
Table '1648956629 2' 9-max Seat #2 is the button
Seat 1: FizzEdJohn (21114 in chips)=20
Seat 2: bulibasav (35395 in chips)=20
Seat 3: JJin91 (46902 in chips)=20
Seat 4: SapofPine (8784 in chips)=20
Seat 5: Going2Ship (14313 in chips)=20
Seat 6: Deuxexmachen (33478 in chips)=20
Seat 7: Labba609 (21550 in chips)=20
Seat 8: MeatballG10 (21816 in chips)=20
Seat 9: proletariat5 (7697 in chips)=20
FizzEdJohn: posts the ante 85
bulibasav: posts the ante 85
JJin91: posts the ante 85
SapofPine: posts the ante 85
Going2Ship: posts the ante 85
Deuxexmachen: posts the ante 85
Labba609: posts the ante 85
MeatballG10: posts the ante 85
proletariat5: posts the ante 85
JJin91: posts small blind 350
SapofPine: posts big blind 700
*** HOLE CARDS ***
Dealt to JJin91 [Js Qc]
Going2Ship: folds=20
Deuxexmachen: folds=20
Labba609: folds=20
MeatballG10: folds=20
proletariat5: folds=20
FizzEdJohn: folds=20
bulibasav: raises 1050 to 1750
JJin91: folds=20
SapofPine: folds=20
Uncalled bet (1050) returned to bulibasav
bulibasav collected 2515 from pot
bulibasav: doesn't show hand=20
*** SUMMARY ***
Total pot 2515 | Rake 0=20
Seat 1: FizzEdJohn folded before Flop (didn't bet)
Seat 2: bulibasav (button) collected (2515)
Seat 3: JJin91 (small blind) folded before Flop
Seat 4: SapofPine (big blind) folded before Flop
Seat 5: Going2Ship folded before Flop (didn't bet)
Seat 6: Deuxexmachen folded before Flop (didn't bet)
Seat 7: Labba609 folded before Flop (didn't bet)
Seat 8: MeatballG10 folded before Flop (didn't bet)
Seat 9: proletariat5 folded before Flop (didn't bet)


*********** # 120 **************
PokerStars Hand #171485623238: Tournament #1648956629, $18.20+$1.80 USD=
 Hold'em No Limit - Level XIV (400/800) - 2017/06/20 21:21:59 ET
Table '1648956629 2' 9-max Seat #3 is the button
Seat 1: FizzEdJohn (21029 in chips)=20
Seat 2: bulibasav (37125 in chips)=20
Seat 3: JJin91 (46467 in chips)=20
Seat 4: SapofPine (7999 in chips)=20
Seat 5: Going2Ship (14228 in chips)=20
Seat 6: Deuxexmachen (33393 in chips)=20
Seat 7: Labba609 (21465 in chips)=20
Seat 8: MeatballG10 (21731 in chips)=20
Seat 9: proletariat5 (7612 in chips)=20
FizzEdJohn: posts the ante 100
bulibasav: posts the ante 100
JJin91: posts the ante 100
SapofPine: posts the ante 100
Going2Ship: posts the ante 100
Deuxexmachen: posts the ante 100
Labba609: posts the ante 100
MeatballG10: posts the ante 100
proletariat5: posts the ante 100
SapofPine: posts small blind 400
Going2Ship: posts big blind 800
*** HOLE CARDS ***
Dealt to JJin91 [9h Ah]
Deuxexmachen: folds=20
Labba609: folds=20
MeatballG10: folds=20
proletariat5: folds=20
FizzEdJohn: raises 920 to 1720
bulibasav: folds=20
JJin91: calls 1720
SapofPine: folds=20
Going2Ship: calls 920
*** FLOP *** [2c 4h 2d]
Going2Ship: checks=20
FizzEdJohn has timed out
FizzEdJohn: checks=20
JJin91: checks=20
*** TURN *** [2c 4h 2d] [Ts]
Going2Ship: checks=20
FizzEdJohn: bets 2261
JJin91: calls 2261
Going2Ship: folds=20
*** RIVER *** [2c 4h 2d Ts] [Jc]
FizzEdJohn: checks=20
JJin91: checks=20
*** SHOW DOWN ***
FizzEdJohn: shows [Qd Th] (two pair, Tens and Deuces)
JJin91: mucks hand=20
FizzEdJohn collected 10982 from pot
*** SUMMARY ***
Total pot 10982 | Rake 0=20
Board [2c 4h 2d Ts Jc]
Seat 1: FizzEdJohn showed [Qd Th] and won (10982) with two pair, Tens a=
nd Deuces
Seat 2: bulibasav folded before Flop (didn't bet)
Seat 3: JJin91 (button) mucked [9h Ah]
Seat 4: SapofPine (small blind) folded before Flop
Seat 5: Going2Ship (big blind) folded on the Turn
Seat 6: Deuxexmachen folded before Flop (didn't bet)
Seat 7: Labba609 folded before Flop (didn't bet)
Seat 8: MeatballG10 folded before Flop (didn't bet)
Seat 9: proletariat5 folded before Flop (didn't bet)


*********** # 121 **************
PokerStars Hand #171485623589: Tournament #1648956629, $18.20+$1.80 USD=
 Hold'em No Limit - Level XIV (400/800) - 2017/06/20 21:23:19 ET
Table '1648956629 2' 9-max Seat #4 is the button
Seat 1: FizzEdJohn (27930 in chips)=20
Seat 2: bulibasav (37025 in chips)=20
Seat 3: JJin91 (42386 in chips)=20
Seat 4: SapofPine (7499 in chips)=20
Seat 5: Going2Ship (12408 in chips)=20
Seat 6: Deuxexmachen (33293 in chips)=20
Seat 7: Labba609 (21365 in chips)=20
Seat 9: proletariat5 (7512 in chips)=20
FizzEdJohn: posts the ante 100
bulibasav: posts the ante 100
JJin91: posts the ante 100
SapofPine: posts the ante 100
Going2Ship: posts the ante 100
Deuxexmachen: posts the ante 100
Labba609: posts the ante 100
proletariat5: posts the ante 100
Going2Ship: posts small blind 400
Deuxexmachen: posts big blind 800
*** HOLE CARDS ***
Dealt to JJin91 [7d Th]
Labba609: folds=20
proletariat5: folds=20
FizzEdJohn: raises 920 to 1720
bulibasav: folds=20
JJin91: folds=20
SapofPine: folds=20
Going2Ship: folds=20
Deuxexmachen: folds=20
Uncalled bet (920) returned to FizzEdJohn
FizzEdJohn collected 2800 from pot
FizzEdJohn: doesn't show hand=20
*** SUMMARY ***
Total pot 2800 | Rake 0=20
Seat 1: FizzEdJohn collected (2800)
Seat 2: bulibasav folded before Flop (didn't bet)
Seat 3: JJin91 folded before Flop (didn't bet)
Seat 4: SapofPine (button) folded before Flop (didn't bet)
Seat 5: Going2Ship (small blind) folded before Flop
Seat 6: Deuxexmachen (big blind) folded before Flop
Seat 7: Labba609 folded before Flop (didn't bet)
Seat 9: proletariat5 folded before Flop (didn't bet)


*********** # 122 **************
PokerStars Hand #171485623709: Tournament #1648956629, $18.20+$1.80 USD=
 Hold'em No Limit - Level XIV (400/800) - 2017/06/20 21:23:44 ET
Table '1648956629 2' 9-max Seat #5 is the button
Seat 1: FizzEdJohn (29830 in chips)=20
Seat 2: bulibasav (36925 in chips)=20
Seat 3: JJin91 (42286 in chips)=20
Seat 4: SapofPine (7399 in chips)=20
Seat 5: Going2Ship (11908 in chips)=20
Seat 6: Deuxexmachen (32393 in chips)=20
Seat 7: Labba609 (21265 in chips)=20
Seat 9: proletariat5 (7412 in chips)=20
FizzEdJohn: posts the ante 100
bulibasav: posts the ante 100
JJin91: posts the ante 100
SapofPine: posts the ante 100
Going2Ship: posts the ante 100
Deuxexmachen: posts the ante 100
Labba609: posts the ante 100
proletariat5: posts the ante 100
Deuxexmachen: posts small blind 400
Labba609: posts big blind 800
*** HOLE CARDS ***
Dealt to JJin91 [2d 7s]
proletariat5: raises 6512 to 7312 and is all-in
FizzEdJohn: calls 7312
bulibasav: folds=20
JJin91: folds=20
SapofPine: folds=20
Going2Ship: folds=20
Deuxexmachen: folds=20
Labba609: folds=20
*** FLOP *** [Ac 5s Qs]
*** TURN *** [Ac 5s Qs] [Tc]
*** RIVER *** [Ac 5s Qs Tc] [5h]
*** SHOW DOWN ***
proletariat5: shows [Qd Qc] (a full house, Queens full of Fives)
FizzEdJohn: shows [Jh Js] (two pair, Jacks and Fives)
proletariat5 collected 16624 from pot
*** SUMMARY ***
Total pot 16624 | Rake 0=20
Board [Ac 5s Qs Tc 5h]
Seat 1: FizzEdJohn showed [Jh Js] and lost with two pair, Jacks and Fiv=
es
Seat 2: bulibasav folded before Flop (didn't bet)
Seat 3: JJin91 folded before Flop (didn't bet)
Seat 4: SapofPine folded before Flop (didn't bet)
Seat 5: Going2Ship (button) folded before Flop (didn't bet)
Seat 6: Deuxexmachen (small blind) folded before Flop
Seat 7: Labba609 (big blind) folded before Flop
Seat 9: proletariat5 showed [Qd Qc] and won (16624) with a full house, =
Queens full of Fives


*********** # 123 **************
PokerStars Hand #171485623861: Tournament #1648956629, $18.20+$1.80 USD=
 Hold'em No Limit - Level XIV (400/800) - 2017/06/20 21:24:17 ET
Table '1648956629 2' 9-max Seat #6 is the button
Seat 1: FizzEdJohn (22418 in chips)=20
Seat 2: bulibasav (36825 in chips)=20
Seat 3: JJin91 (42186 in chips)=20
Seat 4: SapofPine (7299 in chips)=20
Seat 5: Going2Ship (11808 in chips)=20
Seat 6: Deuxexmachen (31893 in chips)=20
Seat 7: Labba609 (20365 in chips)=20
Seat 9: proletariat5 (16624 in chips)=20
FizzEdJohn: posts the ante 100
bulibasav: posts the ante 100
JJin91: posts the ante 100
SapofPine: posts the ante 100
Going2Ship: posts the ante 100
Deuxexmachen: posts the ante 100
Labba609: posts the ante 100
proletariat5: posts the ante 100
Labba609: posts small blind 400
proletariat5: posts big blind 800
*** HOLE CARDS ***
Dealt to JJin91 [7s 3d]
FizzEdJohn: folds=20
bulibasav: folds=20
JJin91: folds=20
SapofPine: folds=20
Going2Ship: folds=20
Deuxexmachen: folds=20
Labba609: raises 1200 to 2000
proletariat5: folds=20
Uncalled bet (1200) returned to Labba609
Labba609 collected 2400 from pot
Labba609: doesn't show hand=20
*** SUMMARY ***
Total pot 2400 | Rake 0=20
Seat 1: FizzEdJohn folded before Flop (didn't bet)
Seat 2: bulibasav folded before Flop (didn't bet)
Seat 3: JJin91 folded before Flop (didn't bet)
Seat 4: SapofPine folded before Flop (didn't bet)
Seat 5: Going2Ship folded before Flop (didn't bet)
Seat 6: Deuxexmachen (button) folded before Flop (didn't bet)
Seat 7: Labba609 (small blind) collected (2400)
Seat 9: proletariat5 (big blind) folded before Flop


*********** # 124 **************
PokerStars Hand #171485624069: Tournament #1648956629, $18.20+$1.80 USD=
 Hold'em No Limit - Level XIV (400/800) - 2017/06/20 21:25:01 ET
Table '1648956629 2' 9-max Seat #7 is the button
Seat 1: FizzEdJohn (22318 in chips)=20
Seat 2: bulibasav (36725 in chips)=20
Seat 3: JJin91 (42086 in chips)=20
Seat 4: SapofPine (7199 in chips)=20
Seat 5: Going2Ship (11708 in chips)=20
Seat 6: Deuxexmachen (31793 in chips)=20
Seat 7: Labba609 (21865 in chips)=20
Seat 9: proletariat5 (15724 in chips)=20
FizzEdJohn: posts the ante 100
bulibasav: posts the ante 100
JJin91: posts the ante 100
SapofPine: posts the ante 100
Going2Ship: posts the ante 100
Deuxexmachen: posts the ante 100
Labba609: posts the ante 100
proletariat5: posts the ante 100
proletariat5: posts small blind 400
FizzEdJohn: posts big blind 800
*** HOLE CARDS ***
Dealt to JJin91 [Jh 4s]
bulibasav: folds=20
JJin91: folds=20
SapofPine: folds=20
Going2Ship: raises 10808 to 11608 and is all-in
Deuxexmachen: folds=20
Labba609: folds=20
proletariat5: folds=20
FizzEdJohn: folds=20
Uncalled bet (10808) returned to Going2Ship
Going2Ship collected 2800 from pot
Going2Ship: doesn't show hand=20
*** SUMMARY ***
Total pot 2800 | Rake 0=20
Seat 1: FizzEdJohn (big blind) folded before Flop
Seat 2: bulibasav folded before Flop (didn't bet)
Seat 3: JJin91 folded before Flop (didn't bet)
Seat 4: SapofPine folded before Flop (didn't bet)
Seat 5: Going2Ship collected (2800)
Seat 6: Deuxexmachen folded before Flop (didn't bet)
Seat 7: Labba609 (button) folded before Flop (didn't bet)
Seat 9: proletariat5 (small blind) folded before Flop


*********** # 125 **************
PokerStars Hand #171485624184: Tournament #1648956629, $18.20+$1.80 USD=
 Hold'em No Limit - Level XIV (400/800) - 2017/06/20 21:25:26 ET
Table '1648956629 2' 9-max Seat #9 is the button
Seat 1: FizzEdJohn (21418 in chips)=20
Seat 2: bulibasav (36625 in chips)=20
Seat 3: JJin91 (41986 in chips)=20
Seat 4: SapofPine (7099 in chips)=20
Seat 5: Going2Ship (13608 in chips)=20
Seat 6: Deuxexmachen (31693 in chips)=20
Seat 7: Labba609 (21765 in chips)=20
Seat 9: proletariat5 (15224 in chips)=20
FizzEdJohn: posts the ante 100
bulibasav: posts the ante 100
JJin91: posts the ante 100
SapofPine: posts the ante 100
Going2Ship: posts the ante 100
Deuxexmachen: posts the ante 100
Labba609: posts the ante 100
proletariat5: posts the ante 100
FizzEdJohn: posts small blind 400
bulibasav: posts big blind 800
*** HOLE CARDS ***
Dealt to JJin91 [6s 4d]
JJin91: folds=20
SapofPine: folds=20
Going2Ship: folds=20
Deuxexmachen: folds=20
Labba609: folds=20
proletariat5: raises 984 to 1784
FizzEdJohn: calls 1384
bulibasav: folds=20
*** FLOP *** [Kh 5s 8h]
FizzEdJohn has timed out
FizzEdJohn: checks=20
proletariat5: bets 1654
FizzEdJohn: calls 1654
*** TURN *** [Kh 5s 8h] [Ac]
FizzEdJohn: checks=20
proletariat5: checks=20
*** RIVER *** [Kh 5s 8h Ac] [Qh]
FizzEdJohn: bets 4662
proletariat5: calls 4662
*** SHOW DOWN ***
FizzEdJohn: shows [Qc Kc] (two pair, Kings and Queens)
proletariat5: mucks hand=20
FizzEdJohn collected 17800 from pot
*** SUMMARY ***
Total pot 17800 | Rake 0=20
Board [Kh 5s 8h Ac Qh]
Seat 1: FizzEdJohn (small blind) showed [Qc Kc] and won (17800) with tw=
o pair, Kings and Queens
Seat 2: bulibasav (big blind) folded before Flop
Seat 3: JJin91 folded before Flop (didn't bet)
Seat 4: SapofPine folded before Flop (didn't bet)
Seat 5: Going2Ship folded before Flop (didn't bet)
Seat 6: Deuxexmachen folded before Flop (didn't bet)
Seat 7: Labba609 folded before Flop (didn't bet)
Seat 9: proletariat5 (button) mucked [2h As]


*********** # 126 **************
PokerStars Hand #171485624638: Tournament #1648956629, $18.20+$1.80 USD=
 Hold'em No Limit - Level XIV (400/800) - 2017/06/20 21:27:06 ET
Table '1648956629 2' 9-max Seat #1 is the button
Seat 1: FizzEdJohn (31018 in chips)=20
Seat 2: bulibasav (35725 in chips)=20
Seat 3: JJin91 (41886 in chips)=20
Seat 5: Going2Ship (13508 in chips)=20
Seat 6: Deuxexmachen (31593 in chips)=20
Seat 7: Labba609 (21665 in chips)=20
Seat 9: proletariat5 (7024 in chips)=20
FizzEdJohn: posts the ante 100
bulibasav: posts the ante 100
JJin91: posts the ante 100
Going2Ship: posts the ante 100
Deuxexmachen: posts the ante 100
Labba609: posts the ante 100
proletariat5: posts the ante 100
bulibasav: posts small blind 400
JJin91: posts big blind 800
*** HOLE CARDS ***
Dealt to JJin91 [8h 9c]
Going2Ship: folds=20
Deuxexmachen: raises 1199 to 1999
Labba609: folds=20
proletariat5: folds=20
FizzEdJohn: folds=20
bulibasav: folds=20
JJin91: folds=20
Uncalled bet (1199) returned to Deuxexmachen
Deuxexmachen collected 2700 from pot
Deuxexmachen: doesn't show hand=20
*** SUMMARY ***
Total pot 2700 | Rake 0=20
Seat 1: FizzEdJohn (button) folded before Flop (didn't bet)
Seat 2: bulibasav (small blind) folded before Flop
Seat 3: JJin91 (big blind) folded before Flop
Seat 5: Going2Ship folded before Flop (didn't bet)
Seat 6: Deuxexmachen collected (2700)
Seat 7: Labba609 folded before Flop (didn't bet)
Seat 9: proletariat5 folded before Flop (didn't bet)


*********** # 127 **************
PokerStars Hand #171485624769: Tournament #1648956629, $18.20+$1.80 USD=
 Hold'em No Limit - Level XIV (400/800) - 2017/06/20 21:27:36 ET
Table '1648956629 2' 9-max Seat #2 is the button
Seat 1: FizzEdJohn (30918 in chips)=20
Seat 2: bulibasav (35225 in chips)=20
Seat 3: JJin91 (40986 in chips)=20
Seat 5: Going2Ship (13408 in chips)=20
Seat 6: Deuxexmachen (33393 in chips)=20
Seat 7: Labba609 (21565 in chips)=20
Seat 9: proletariat5 (6924 in chips)=20
FizzEdJohn: posts the ante 100
bulibasav: posts the ante 100
JJin91: posts the ante 100
Going2Ship: posts the ante 100
Deuxexmachen: posts the ante 100
Labba609: posts the ante 100
proletariat5: posts the ante 100
JJin91: posts small blind 400
Going2Ship: posts big blind 800
*** HOLE CARDS ***
Dealt to JJin91 [2s 9h]
Deuxexmachen: folds=20
Labba609: folds=20
proletariat5: folds=20
FizzEdJohn: folds=20
bulibasav: folds=20
JJin91: folds=20
Uncalled bet (400) returned to Going2Ship
Going2Ship collected 1500 from pot
Going2Ship: doesn't show hand=20
*** SUMMARY ***
Total pot 1500 | Rake 0=20
Seat 1: FizzEdJohn folded before Flop (didn't bet)
Seat 2: bulibasav (button) folded before Flop (didn't bet)
Seat 3: JJin91 (small blind) folded before Flop
Seat 5: Going2Ship (big blind) collected (1500)
Seat 6: Deuxexmachen folded before Flop (didn't bet)
Seat 7: Labba609 folded before Flop (didn't bet)
Seat 9: proletariat5 folded before Flop (didn't bet)


*********** # 128 **************
PokerStars Hand #171485624833: Tournament #1648956629, $18.20+$1.80 USD=
 Hold'em No Limit - Level XIV (400/800) - 2017/06/20 21:27:51 ET
Table '1648956629 2' 9-max Seat #3 is the button
Seat 1: FizzEdJohn (30818 in chips)=20
Seat 2: bulibasav (35125 in chips)=20
Seat 3: JJin91 (40486 in chips)=20
Seat 5: Going2Ship (14408 in chips)=20
Seat 6: Deuxexmachen (33293 in chips)=20
Seat 7: Labba609 (21465 in chips)=20
Seat 9: proletariat5 (6824 in chips)=20
FizzEdJohn: posts the ante 100
bulibasav: posts the ante 100
JJin91: posts the ante 100
Going2Ship: posts the ante 100
Deuxexmachen: posts the ante 100
Labba609: posts the ante 100
proletariat5: posts the ante 100
Going2Ship: posts small blind 400
Deuxexmachen: posts big blind 800
*** HOLE CARDS ***
Dealt to JJin91 [9c 8h]
Labba609: raises 1200 to 2000
proletariat5: folds=20
FizzEdJohn: folds=20
bulibasav: folds=20
JJin91: folds=20
Going2Ship: folds=20
Deuxexmachen: folds=20
Uncalled bet (1200) returned to Labba609
Labba609 collected 2700 from pot
Labba609: doesn't show hand=20
*** SUMMARY ***
Total pot 2700 | Rake 0=20
Seat 1: FizzEdJohn folded before Flop (didn't bet)
Seat 2: bulibasav folded before Flop (didn't bet)
Seat 3: JJin91 (button) folded before Flop (didn't bet)
Seat 5: Going2Ship (small blind) folded before Flop
Seat 6: Deuxexmachen (big blind) folded before Flop
Seat 7: Labba609 collected (2700)
Seat 9: proletariat5 folded before Flop (didn't bet)


*********** # 129 **************
PokerStars Hand #171485624958: Tournament #1648956629, $18.20+$1.80 USD=
 Hold'em No Limit - Level XIV (400/800) - 2017/06/20 21:28:19 ET
Table '1648956629 2' 9-max Seat #5 is the button
Seat 1: FizzEdJohn (30718 in chips)=20
Seat 2: bulibasav (35025 in chips)=20
Seat 3: JJin91 (40386 in chips)=20
Seat 5: Going2Ship (13908 in chips)=20
Seat 6: Deuxexmachen (32393 in chips)=20
Seat 7: Labba609 (23265 in chips)=20
Seat 9: proletariat5 (6724 in chips)=20
FizzEdJohn: posts the ante 100
bulibasav: posts the ante 100
JJin91: posts the ante 100
Going2Ship: posts the ante 100
Deuxexmachen: posts the ante 100
Labba609: posts the ante 100
proletariat5: posts the ante 100
Deuxexmachen: posts small blind 400
Labba609: posts big blind 800
*** HOLE CARDS ***
Dealt to JJin91 [Kh Ad]
proletariat5: folds=20
FizzEdJohn: raises 920 to 1720
bulibasav: folds=20
JJin91: raises 2802 to 4522
Going2Ship: folds=20
Deuxexmachen: folds=20
Labba609: folds=20
FizzEdJohn: folds=20
Uncalled bet (2802) returned to JJin91
JJin91 collected 5340 from pot
JJin91: doesn't show hand=20
*** SUMMARY ***
Total pot 5340 | Rake 0=20
Seat 1: FizzEdJohn folded before Flop
Seat 2: bulibasav folded before Flop (didn't bet)
Seat 3: JJin91 collected (5340)
Seat 5: Going2Ship (button) folded before Flop (didn't bet)
Seat 6: Deuxexmachen (small blind) folded before Flop
Seat 7: Labba609 (big blind) folded before Flop
Seat 9: proletariat5 folded before Flop (didn't bet)


*********** # 130 **************
PokerStars Hand #171485625180: Tournament #1648956629, $18.20+$1.80 USD=
 Hold'em No Limit - Level XIV (400/800) - 2017/06/20 21:29:09 ET
Table '1648956629 2' 9-max Seat #6 is the button
Seat 1: FizzEdJohn (28898 in chips)=20
Seat 2: bulibasav (34925 in chips)=20
Seat 3: JJin91 (43906 in chips)=20
Seat 5: Going2Ship (13808 in chips)=20
Seat 6: Deuxexmachen (31893 in chips)=20
Seat 7: Labba609 (22365 in chips)=20
Seat 9: proletariat5 (6624 in chips)=20
FizzEdJohn: posts the ante 100
bulibasav: posts the ante 100
JJin91: posts the ante 100
Going2Ship: posts the ante 100
Deuxexmachen: posts the ante 100
Labba609: posts the ante 100
proletariat5: posts the ante 100
Labba609: posts small blind 400
proletariat5: posts big blind 800
*** HOLE CARDS ***
Dealt to JJin91 [4c 9c]
FizzEdJohn has timed out
FizzEdJohn: folds=20
FizzEdJohn is sitting out
bulibasav: folds=20
JJin91: folds=20
FizzEdJohn has returned
Going2Ship: folds=20
Deuxexmachen: folds=20
Labba609: folds=20
Uncalled bet (400) returned to proletariat5
proletariat5 collected 1500 from pot
proletariat5: doesn't show hand=20
*** SUMMARY ***
Total pot 1500 | Rake 0=20
Seat 1: FizzEdJohn folded before Flop (didn't bet)
Seat 2: bulibasav folded before Flop (didn't bet)
Seat 3: JJin91 folded before Flop (didn't bet)
Seat 5: Going2Ship folded before Flop (didn't bet)
Seat 6: Deuxexmachen (button) folded before Flop (didn't bet)
Seat 7: Labba609 (small blind) folded before Flop
Seat 9: proletariat5 (big blind) collected (1500)


*********** # 131 **************
PokerStars Hand #171485625323: Tournament #1648956629, $18.20+$1.80 USD=
 Hold'em No Limit - Level XIV (400/800) - 2017/06/20 21:29:43 ET
Table '1648956629 2' 9-max Seat #7 is the button
Seat 1: FizzEdJohn (28798 in chips)=20
Seat 2: bulibasav (34825 in chips)=20
Seat 3: JJin91 (43806 in chips)=20
Seat 5: Going2Ship (13708 in chips)=20
Seat 6: Deuxexmachen (31793 in chips)=20
Seat 7: Labba609 (21865 in chips)=20
Seat 9: proletariat5 (7624 in chips)=20
FizzEdJohn: posts the ante 100
bulibasav: posts the ante 100
JJin91: posts the ante 100
Going2Ship: posts the ante 100
Deuxexmachen: posts the ante 100
Labba609: posts the ante 100
proletariat5: posts the ante 100
proletariat5: posts small blind 400
FizzEdJohn: posts big blind 800
*** HOLE CARDS ***
Dealt to JJin91 [2h 8c]
bulibasav: raises 1200 to 2000
JJin91: folds=20
Going2Ship: folds=20
Deuxexmachen: folds=20
Labba609: folds=20
proletariat5: folds=20
FizzEdJohn: folds=20
Uncalled bet (1200) returned to bulibasav
bulibasav collected 2700 from pot
bulibasav: doesn't show hand=20
*** SUMMARY ***
Total pot 2700 | Rake 0=20
Seat 1: FizzEdJohn (big blind) folded before Flop
Seat 2: bulibasav collected (2700)
Seat 3: JJin91 folded before Flop (didn't bet)
Seat 5: Going2Ship folded before Flop (didn't bet)
Seat 6: Deuxexmachen folded before Flop (didn't bet)
Seat 7: Labba609 (button) folded before Flop (didn't bet)
Seat 9: proletariat5 (small blind) folded before Flop


*********** # 132 **************
PokerStars Hand #171485625510: Tournament #1648956629, $18.20+$1.80 USD=
 Hold'em No Limit - Level XIV (400/800) - 2017/06/20 21:30:21 ET
Table '1648956629 2' 9-max Seat #9 is the button
Seat 1: FizzEdJohn (27898 in chips)=20
Seat 2: bulibasav (36625 in chips)=20
Seat 3: JJin91 (43706 in chips)=20
Seat 5: Going2Ship (13608 in chips)=20
Seat 6: Deuxexmachen (31693 in chips)=20
Seat 7: Labba609 (21765 in chips)=20
Seat 9: proletariat5 (7124 in chips)=20
FizzEdJohn: posts the ante 100
bulibasav: posts the ante 100
JJin91: posts the ante 100
Going2Ship: posts the ante 100
Deuxexmachen: posts the ante 100
Labba609: posts the ante 100
proletariat5: posts the ante 100
FizzEdJohn: posts small blind 400
bulibasav: posts big blind 800
*** HOLE CARDS ***
Dealt to JJin91 [9s 9h]
JJin91: raises 952 to 1752
Going2Ship: folds=20
Deuxexmachen: folds=20
Labba609: folds=20
proletariat5: raises 5272 to 7024 and is all-in
FizzEdJohn: folds=20
bulibasav: folds=20
JJin91: calls 5272
*** FLOP *** [3d Td 7c]
*** TURN *** [3d Td 7c] [9d]
*** RIVER *** [3d Td 7c 9d] [5c]
*** SHOW DOWN ***
JJin91: shows [9s 9h] (three of a kind, Nines)
proletariat5: shows [Qc Qd] (a pair of Queens)
JJin91 collected 15948 from pot
proletariat5 finished the tournament in 28th place
*** SUMMARY ***
Total pot 15948 | Rake 0=20
Board [3d Td 7c 9d 5c]
Seat 1: FizzEdJohn (small blind) folded before Flop
Seat 2: bulibasav (big blind) folded before Flop
Seat 3: JJin91 showed [9s 9h] and won (15948) with three of a kind, Nin=
es
Seat 5: Going2Ship folded before Flop (didn't bet)
Seat 6: Deuxexmachen folded before Flop (didn't bet)
Seat 7: Labba609 folded before Flop (didn't bet)
Seat 9: proletariat5 (button) showed [Qc Qd] and lost with a pair of Qu=
eens


*********** # 133 **************
PokerStars Hand #171485625731: Tournament #1648956629, $18.20+$1.80 USD=
 Hold'em No Limit - Level XIV (400/800) - 2017/06/20 21:31:07 ET
Table '1648956629 6' 9-max Seat #9 is the button
Seat 1: FizzEdJohn (27398 in chips) out of hand (moved from another tab=
le into small blind)
Seat 2: MeatballG10 (15231 in chips)=20
Seat 3: kpadalei24 (9047 in chips)=20
Seat 4: LOLiBluffed (16684 in chips)=20
Seat 5: TrumpsDong (31143 in chips)=20
Seat 6: bigpond12 (151079 in chips)=20
Seat 7: JJin91 (52530 in chips)=20
Seat 8: zBeanHeaDz (49191 in chips)=20
Seat 9: DebOCNJ (13918 in chips)=20
MeatballG10: posts the ante 100
kpadalei24: posts the ante 100
LOLiBluffed: posts the ante 100
TrumpsDong: posts the ante 100
bigpond12: posts the ante 100
JJin91: posts the ante 100
zBeanHeaDz: posts the ante 100
DebOCNJ: posts the ante 100
MeatballG10: posts small blind 400
kpadalei24: posts big blind 800
*** HOLE CARDS ***
Dealt to JJin91 [8d Kc]
LOLiBluffed: folds=20
TrumpsDong: folds=20
bigpond12: calls 800
JJin91: folds=20
zBeanHeaDz: raises 1992 to 2792
DebOCNJ: folds=20
MeatballG10: folds=20
kpadalei24: raises 6155 to 8947 and is all-in
bigpond12: folds=20
zBeanHeaDz: calls 6155
*** FLOP *** [8h Ad Kh]
*** TURN *** [8h Ad Kh] [Ts]
*** RIVER *** [8h Ad Kh Ts] [Ks]
*** SHOW DOWN ***
kpadalei24: shows [Ac Jc] (two pair, Aces and Kings)
zBeanHeaDz: shows [Jd Ah] (two pair, Aces and Kings)
kpadalei24 collected 9947 from pot
zBeanHeaDz collected 9947 from pot
*** SUMMARY ***
Total pot 19894 | Rake 0=20
Board [8h Ad Kh Ts Ks]
Seat 2: MeatballG10 (small blind) folded before Flop
Seat 3: kpadalei24 (big blind) showed [Ac Jc] and won (9947) with two p=
air, Aces and Kings
Seat 4: LOLiBluffed folded before Flop (didn't bet)
Seat 5: TrumpsDong folded before Flop (didn't bet)
Seat 6: bigpond12 folded before Flop
Seat 7: JJin91 folded before Flop (didn't bet)
Seat 8: zBeanHeaDz showed [Jd Ah] and won (9947) with two pair, Aces an=
d Kings
Seat 9: DebOCNJ (button) folded before Flop (didn't bet)


*********** # 134 **************
PokerStars Hand #171485625927: Tournament #1648956629, $18.20+$1.80 USD=
 Hold'em No Limit - Level XV (500/1000) - 2017/06/20 21:31:46 ET
Table '1648956629 6' 9-max Seat #2 is the button
Seat 1: FizzEdJohn (27398 in chips)=20
Seat 2: MeatballG10 (14731 in chips)=20
Seat 3: kpadalei24 (9947 in chips)=20
Seat 4: LOLiBluffed (16584 in chips)=20
Seat 5: TrumpsDong (31043 in chips)=20
Seat 6: bigpond12 (150179 in chips)=20
Seat 7: JJin91 (52430 in chips)=20
Seat 8: zBeanHeaDz (50091 in chips)=20
Seat 9: DebOCNJ (13818 in chips)=20
FizzEdJohn: posts the ante 125
MeatballG10: posts the ante 125
kpadalei24: posts the ante 125
LOLiBluffed: posts the ante 125
TrumpsDong: posts the ante 125
bigpond12: posts the ante 125
JJin91: posts the ante 125
zBeanHeaDz: posts the ante 125
DebOCNJ: posts the ante 125
kpadalei24: posts small blind 500
LOLiBluffed: posts big blind 1000
*** HOLE CARDS ***
Dealt to JJin91 [Qs 7c]
TrumpsDong: folds=20
bigpond12: folds=20
JJin91: folds=20
zBeanHeaDz: folds=20
DebOCNJ: folds=20
FizzEdJohn: raises 1000 to 2000
MeatballG10: raises 12606 to 14606 and is all-in
kpadalei24: folds=20
LOLiBluffed: folds=20
FizzEdJohn: folds=20
Uncalled bet (12606) returned to MeatballG10
MeatballG10 collected 6625 from pot
*** SUMMARY ***
Total pot 6625 | Rake 0=20
Seat 1: FizzEdJohn folded before Flop
Seat 2: MeatballG10 (button) collected (6625)
Seat 3: kpadalei24 (small blind) folded before Flop
Seat 4: LOLiBluffed (big blind) folded before Flop
Seat 5: TrumpsDong folded before Flop (didn't bet)
Seat 6: bigpond12 folded before Flop (didn't bet)
Seat 7: JJin91 folded before Flop (didn't bet)
Seat 8: zBeanHeaDz folded before Flop (didn't bet)
Seat 9: DebOCNJ folded before Flop (didn't bet)


*********** # 135 **************
PokerStars Hand #171485626116: Tournament #1648956629, $18.20+$1.80 USD=
 Hold'em No Limit - Level XV (500/1000) - 2017/06/20 21:32:28 ET
Table '1648956629 6' 9-max Seat #3 is the button
Seat 1: FizzEdJohn (25273 in chips)=20
Seat 2: MeatballG10 (19231 in chips)=20
Seat 3: kpadalei24 (9322 in chips)=20
Seat 4: LOLiBluffed (15459 in chips)=20
Seat 5: TrumpsDong (30918 in chips)=20
Seat 6: bigpond12 (150054 in chips)=20
Seat 7: JJin91 (52305 in chips)=20
Seat 8: zBeanHeaDz (49966 in chips)=20
Seat 9: DebOCNJ (13693 in chips)=20
FizzEdJohn: posts the ante 125
MeatballG10: posts the ante 125
kpadalei24: posts the ante 125
LOLiBluffed: posts the ante 125
TrumpsDong: posts the ante 125
bigpond12: posts the ante 125
JJin91: posts the ante 125
zBeanHeaDz: posts the ante 125
DebOCNJ: posts the ante 125
LOLiBluffed: posts small blind 500
TrumpsDong: posts big blind 1000
*** HOLE CARDS ***
Dealt to JJin91 [Ad Ah]
bigpond12: raises 2000 to 3000
JJin91: raises 4333 to 7333
zBeanHeaDz: folds=20
DebOCNJ: folds=20
FizzEdJohn: folds=20
MeatballG10: folds=20
kpadalei24: folds=20
LOLiBluffed: folds=20
TrumpsDong: folds=20
bigpond12: calls 4333
*** FLOP *** [As 9c Td]
bigpond12: checks=20
JJin91: bets 6398
bigpond12: folds=20
Uncalled bet (6398) returned to JJin91
JJin91 collected 17291 from pot
JJin91: doesn't show hand=20
*** SUMMARY ***
Total pot 17291 | Rake 0=20
Board [As 9c Td]
Seat 1: FizzEdJohn folded before Flop (didn't bet)
Seat 2: MeatballG10 folded before Flop (didn't bet)
Seat 3: kpadalei24 (button) folded before Flop (didn't bet)
Seat 4: LOLiBluffed (small blind) folded before Flop
Seat 5: TrumpsDong (big blind) folded before Flop
Seat 6: bigpond12 folded on the Flop
Seat 7: JJin91 collected (17291)
Seat 8: zBeanHeaDz folded before Flop (didn't bet)
Seat 9: DebOCNJ folded before Flop (didn't bet)


*********** # 136 **************
PokerStars Hand #171485626396: Tournament #1648956629, $18.20+$1.80 USD=
 Hold'em No Limit - Level XV (500/1000) - 2017/06/20 21:33:23 ET
Table '1648956629 6' 9-max Seat #4 is the button
Seat 1: FizzEdJohn (25148 in chips)=20
Seat 2: MeatballG10 (19106 in chips)=20
Seat 3: kpadalei24 (9197 in chips)=20
Seat 4: LOLiBluffed (14834 in chips)=20
Seat 5: TrumpsDong (29793 in chips)=20
Seat 6: bigpond12 (142596 in chips)=20
Seat 7: JJin91 (62138 in chips)=20
Seat 8: zBeanHeaDz (49841 in chips)=20
Seat 9: DebOCNJ (13568 in chips)=20
FizzEdJohn: posts the ante 125
MeatballG10: posts the ante 125
kpadalei24: posts the ante 125
LOLiBluffed: posts the ante 125
TrumpsDong: posts the ante 125
bigpond12: posts the ante 125
JJin91: posts the ante 125
zBeanHeaDz: posts the ante 125
DebOCNJ: posts the ante 125
TrumpsDong: posts small blind 500
bigpond12: posts big blind 1000
*** HOLE CARDS ***
Dealt to JJin91 [5d 9s]
JJin91: folds=20
zBeanHeaDz: raises 1400 to 2400
DebOCNJ: folds=20
FizzEdJohn: folds=20
MeatballG10: folds=20
kpadalei24: folds=20
LOLiBluffed: folds=20
TrumpsDong: folds=20
bigpond12: calls 1400
*** FLOP *** [Qc 4s 3h]
bigpond12: checks=20
zBeanHeaDz: bets 3148
bigpond12: folds=20
Uncalled bet (3148) returned to zBeanHeaDz
zBeanHeaDz collected 6425 from pot
*** SUMMARY ***
Total pot 6425 | Rake 0=20
Board [Qc 4s 3h]
Seat 1: FizzEdJohn folded before Flop (didn't bet)
Seat 2: MeatballG10 folded before Flop (didn't bet)
Seat 3: kpadalei24 folded before Flop (didn't bet)
Seat 4: LOLiBluffed (button) folded before Flop (didn't bet)
Seat 5: TrumpsDong (small blind) folded before Flop
Seat 6: bigpond12 (big blind) folded on the Flop
Seat 7: JJin91 folded before Flop (didn't bet)
Seat 8: zBeanHeaDz collected (6425)
Seat 9: DebOCNJ folded before Flop (didn't bet)


*********** # 137 **************
PokerStars Hand #171485626617: Tournament #1648956629, $18.20+$1.80 USD=
 Hold'em No Limit - Level XV (500/1000) - 2017/06/20 21:34:07 ET
Table '1648956629 6' 9-max Seat #5 is the button
Seat 1: FizzEdJohn (25023 in chips)=20
Seat 2: MeatballG10 (18981 in chips)=20
Seat 3: kpadalei24 (9072 in chips)=20
Seat 4: LOLiBluffed (14709 in chips)=20
Seat 5: TrumpsDong (29168 in chips)=20
Seat 6: bigpond12 (140071 in chips)=20
Seat 7: JJin91 (62013 in chips)=20
Seat 9: DebOCNJ (13443 in chips)=20
FizzEdJohn: posts the ante 125
MeatballG10: posts the ante 125
kpadalei24: posts the ante 125
LOLiBluffed: posts the ante 125
TrumpsDong: posts the ante 125
bigpond12: posts the ante 125
JJin91: posts the ante 125
DebOCNJ: posts the ante 125
bigpond12: posts small blind 500
JJin91: posts big blind 1000
*** HOLE CARDS ***
Dealt to JJin91 [5s Qc]
DebOCNJ: folds=20
FizzEdJohn: folds=20
MeatballG10: folds=20
kpadalei24: raises 7947 to 8947 and is all-in
LOLiBluffed: folds=20
TrumpsDong: folds=20
bigpond12: folds=20
JJin91: folds=20
Uncalled bet (7947) returned to kpadalei24
kpadalei24 collected 3500 from pot
kpadalei24: doesn't show hand=20
*** SUMMARY ***
Total pot 3500 | Rake 0=20
Seat 1: FizzEdJohn folded before Flop (didn't bet)
Seat 2: MeatballG10 folded before Flop (didn't bet)
Seat 3: kpadalei24 collected (3500)
Seat 4: LOLiBluffed folded before Flop (didn't bet)
Seat 5: TrumpsDong (button) folded before Flop (didn't bet)
Seat 6: bigpond12 (small blind) folded before Flop
Seat 7: JJin91 (big blind) folded before Flop
Seat 9: DebOCNJ folded before Flop (didn't bet)


*********** # 138 **************
PokerStars Hand #171485626749: Tournament #1648956629, $18.20+$1.80 USD=
 Hold'em No Limit - Level XV (500/1000) - 2017/06/20 21:34:34 ET
Table '1648956629 6' 9-max Seat #6 is the button
Seat 1: FizzEdJohn (24898 in chips)=20
Seat 2: MeatballG10 (18856 in chips)=20
Seat 3: kpadalei24 (11447 in chips)=20
Seat 4: LOLiBluffed (14584 in chips)=20
Seat 5: TrumpsDong (29043 in chips)=20
Seat 6: bigpond12 (139446 in chips)=20
Seat 7: JJin91 (60888 in chips)=20
Seat 9: DebOCNJ (13318 in chips)=20
FizzEdJohn: posts the ante 125
MeatballG10: posts the ante 125
kpadalei24: posts the ante 125
LOLiBluffed: posts the ante 125
TrumpsDong: posts the ante 125
bigpond12: posts the ante 125
JJin91: posts the ante 125
DebOCNJ: posts the ante 125
JJin91: posts small blind 500
DebOCNJ: posts big blind 1000
*** HOLE CARDS ***
Dealt to JJin91 [9h 3h]
FizzEdJohn: folds=20
MeatballG10: raises 17731 to 18731 and is all-in
kpadalei24: folds=20
LOLiBluffed: folds=20
TrumpsDong: raises 10187 to 28918 and is all-in
bigpond12: folds=20
JJin91: folds=20
DebOCNJ: folds=20
Uncalled bet (10187) returned to TrumpsDong
*** FLOP *** [Kc 2c Jh]
*** TURN *** [Kc 2c Jh] [As]
*** RIVER *** [Kc 2c Jh As] [9c]
*** SHOW DOWN ***
MeatballG10: shows [Ah Ks] (two pair, Aces and Kings)
TrumpsDong: shows [Ac Kd] (two pair, Aces and Kings)
MeatballG10 collected 19981 from pot
TrumpsDong collected 19981 from pot
*** SUMMARY ***
Total pot 39962 | Rake 0=20
Board [Kc 2c Jh As 9c]
Seat 1: FizzEdJohn folded before Flop (didn't bet)
Seat 2: MeatballG10 showed [Ah Ks] and won (19981) with two pair, Aces =
and Kings
Seat 3: kpadalei24 folded before Flop (didn't bet)
Seat 4: LOLiBluffed folded before Flop (didn't bet)
Seat 5: TrumpsDong showed [Ac Kd] and won (19981) with two pair, Aces a=
nd Kings
Seat 6: bigpond12 (button) folded before Flop (didn't bet)
Seat 7: JJin91 (small blind) folded before Flop
Seat 9: DebOCNJ (big blind) folded before Flop


*********** # 139 **************
PokerStars Hand #171485626938: Tournament #1648956629, $18.20+$1.80 USD=
 Hold'em No Limit - Level XV (500/1000) - 2017/06/20 21:35:14 ET
Table '1648956629 6' 9-max Seat #7 is the button
Seat 1: FizzEdJohn (24773 in chips)=20
Seat 2: MeatballG10 (19981 in chips)=20
Seat 3: kpadalei24 (11322 in chips)=20
Seat 4: LOLiBluffed (14459 in chips)=20
Seat 5: TrumpsDong (30168 in chips)=20
Seat 6: bigpond12 (139321 in chips)=20
Seat 7: JJin91 (60263 in chips)=20
Seat 9: DebOCNJ (12193 in chips)=20
FizzEdJohn: posts the ante 125
MeatballG10: posts the ante 125
kpadalei24: posts the ante 125
LOLiBluffed: posts the ante 125
TrumpsDong: posts the ante 125
bigpond12: posts the ante 125
JJin91: posts the ante 125
DebOCNJ: posts the ante 125
DebOCNJ: posts small blind 500
FizzEdJohn: posts big blind 1000
*** HOLE CARDS ***
Dealt to JJin91 [Kh 6h]
MeatballG10: folds=20
kpadalei24: folds=20
LOLiBluffed: folds=20
TrumpsDong: folds=20
bigpond12: raises 2000 to 3000
JJin91: folds=20
DebOCNJ: folds=20
FizzEdJohn: folds=20
Uncalled bet (2000) returned to bigpond12
bigpond12 collected 3500 from pot
bigpond12: doesn't show hand=20
*** SUMMARY ***
Total pot 3500 | Rake 0=20
Seat 1: FizzEdJohn (big blind) folded before Flop
Seat 2: MeatballG10 folded before Flop (didn't bet)
Seat 3: kpadalei24 folded before Flop (didn't bet)
Seat 4: LOLiBluffed folded before Flop (didn't bet)
Seat 5: TrumpsDong folded before Flop (didn't bet)
Seat 6: bigpond12 collected (3500)
Seat 7: JJin91 (button) folded before Flop (didn't bet)
Seat 9: DebOCNJ (small blind) folded before Flop


*********** # 140 **************
PokerStars Hand #171485627134: Tournament #1648956629, $18.20+$1.80 USD=
 Hold'em No Limit - Level XV (500/1000) - 2017/06/20 21:36:02 ET
Table '1648956629 6' 9-max Seat #9 is the button
Seat 1: FizzEdJohn (23648 in chips)=20
Seat 2: MeatballG10 (19856 in chips)=20
Seat 3: kpadalei24 (11197 in chips)=20
Seat 4: LOLiBluffed (14334 in chips)=20
Seat 5: TrumpsDong (30043 in chips)=20
Seat 6: bigpond12 (141696 in chips)=20
Seat 7: JJin91 (60138 in chips)=20
Seat 9: DebOCNJ (11568 in chips)=20
FizzEdJohn: posts the ante 125
MeatballG10: posts the ante 125
kpadalei24: posts the ante 125
LOLiBluffed: posts the ante 125
TrumpsDong: posts the ante 125
bigpond12: posts the ante 125
JJin91: posts the ante 125
DebOCNJ: posts the ante 125
FizzEdJohn: posts small blind 500
MeatballG10: posts big blind 1000
*** HOLE CARDS ***
Dealt to JJin91 [2c 5d]
kpadalei24: folds=20
LOLiBluffed: folds=20
TrumpsDong: raises 1250 to 2250
bigpond12: calls 2250
JJin91: folds=20
DebOCNJ: folds=20
FizzEdJohn: raises 21273 to 23523 and is all-in
MeatballG10: folds=20
TrumpsDong: folds=20
bigpond12: calls 21273
*** FLOP *** [3s As 6h]
*** TURN *** [3s As 6h] [9s]
*** RIVER *** [3s As 6h 9s] [Qd]
*** SHOW DOWN ***
FizzEdJohn: shows [Kh Jh] (high card Ace)
bigpond12: shows [3d Ad] (two pair, Aces and Threes)
bigpond12 collected 51296 from pot
FizzEdJohn finished the tournament in 24th place
*** SUMMARY ***
Total pot 51296 | Rake 0=20
Board [3s As 6h 9s Qd]
Seat 1: FizzEdJohn (small blind) showed [Kh Jh] and lost with high card=
 Ace
Seat 2: MeatballG10 (big blind) folded before Flop
Seat 3: kpadalei24 folded before Flop (didn't bet)
Seat 4: LOLiBluffed folded before Flop (didn't bet)
Seat 5: TrumpsDong folded before Flop
Seat 6: bigpond12 showed [3d Ad] and won (51296) with two pair, Aces an=
d Threes
Seat 7: JJin91 folded before Flop (didn't bet)
Seat 9: DebOCNJ (button) folded before Flop (didn't bet)


*********** # 141 **************
PokerStars Hand #171485627351: Tournament #1648956629, $18.20+$1.80 USD=
 Hold'em No Limit - Level XV (500/1000) - 2017/06/20 21:36:52 ET
Table '1648956629 6' 9-max Seat #2 is the button
Seat 2: MeatballG10 (18731 in chips)=20
Seat 3: kpadalei24 (11072 in chips)=20
Seat 4: LOLiBluffed (14209 in chips)=20
Seat 5: TrumpsDong (27668 in chips)=20
Seat 6: bigpond12 (169344 in chips)=20
Seat 7: JJin91 (60013 in chips)=20
Seat 9: DebOCNJ (11443 in chips)=20
MeatballG10: posts the ante 125
kpadalei24: posts the ante 125
LOLiBluffed: posts the ante 125
TrumpsDong: posts the ante 125
bigpond12: posts the ante 125
JJin91: posts the ante 125
DebOCNJ: posts the ante 125
kpadalei24: posts small blind 500
LOLiBluffed: posts big blind 1000
*** HOLE CARDS ***
Dealt to JJin91 [Jh Kd]
TrumpsDong: folds=20
bigpond12: folds=20
JJin91: folds=20
DebOCNJ: raises 2000 to 3000
MeatballG10: folds=20
kpadalei24: folds=20
LOLiBluffed: folds=20
Uncalled bet (2000) returned to DebOCNJ
DebOCNJ collected 3375 from pot
DebOCNJ: doesn't show hand=20
*** SUMMARY ***
Total pot 3375 | Rake 0=20
Seat 2: MeatballG10 (button) folded before Flop (didn't bet)
Seat 3: kpadalei24 (small blind) folded before Flop
Seat 4: LOLiBluffed (big blind) folded before Flop
Seat 5: TrumpsDong folded before Flop (didn't bet)
Seat 6: bigpond12 folded before Flop (didn't bet)
Seat 7: JJin91 folded before Flop (didn't bet)
Seat 9: DebOCNJ collected (3375)


*********** # 142 **************
PokerStars Hand #171485627597: Tournament #1648956629, $18.20+$1.80 USD=
 Hold'em No Limit - Level XV (500/1000) - 2017/06/20 21:37:50 ET
Table '1648956629 6' 9-max Seat #3 is the button
Seat 2: MeatballG10 (18606 in chips)=20
Seat 3: kpadalei24 (10447 in chips)=20
Seat 4: LOLiBluffed (13084 in chips)=20
Seat 5: TrumpsDong (27543 in chips)=20
Seat 6: bigpond12 (169219 in chips)=20
Seat 7: JJin91 (59888 in chips)=20
Seat 9: DebOCNJ (13693 in chips)=20
MeatballG10: posts the ante 125
kpadalei24: posts the ante 125
LOLiBluffed: posts the ante 125
TrumpsDong: posts the ante 125
bigpond12: posts the ante 125
JJin91: posts the ante 125
DebOCNJ: posts the ante 125
LOLiBluffed: posts small blind 500
TrumpsDong: posts big blind 1000
*** HOLE CARDS ***
Dealt to JJin91 [Kd 7s]
bigpond12: raises 2000 to 3000
JJin91: folds=20
DebOCNJ: folds=20
MeatballG10: folds=20
kpadalei24: folds=20
LOLiBluffed: folds=20
TrumpsDong: folds=20
Uncalled bet (2000) returned to bigpond12
bigpond12 collected 3375 from pot
bigpond12: doesn't show hand=20
*** SUMMARY ***
Total pot 3375 | Rake 0=20
Seat 2: MeatballG10 folded before Flop (didn't bet)
Seat 3: kpadalei24 (button) folded before Flop (didn't bet)
Seat 4: LOLiBluffed (small blind) folded before Flop
Seat 5: TrumpsDong (big blind) folded before Flop
Seat 6: bigpond12 collected (3375)
Seat 7: JJin91 folded before Flop (didn't bet)
Seat 9: DebOCNJ folded before Flop (didn't bet)


*********** # 143 **************
PokerStars Hand #171485627727: Tournament #1648956629, $18.20+$1.80 USD=
 Hold'em No Limit - Level XV (500/1000) - 2017/06/20 21:38:18 ET
Table '1648956629 6' 9-max Seat #4 is the button
Seat 2: MeatballG10 (18481 in chips)=20
Seat 3: kpadalei24 (10322 in chips)=20
Seat 4: LOLiBluffed (12459 in chips)=20
Seat 5: TrumpsDong (26418 in chips)=20
Seat 6: bigpond12 (171469 in chips)=20
Seat 7: JJin91 (59763 in chips)=20
Seat 9: DebOCNJ (13568 in chips)=20
MeatballG10: posts the ante 125
kpadalei24: posts the ante 125
LOLiBluffed: posts the ante 125
TrumpsDong: posts the ante 125
bigpond12: posts the ante 125
JJin91: posts the ante 125
DebOCNJ: posts the ante 125
TrumpsDong: posts small blind 500
bigpond12: posts big blind 1000
*** HOLE CARDS ***
Dealt to JJin91 [7c Qd]
JJin91: folds=20
DebOCNJ: folds=20
MeatballG10: folds=20
kpadalei24: folds=20
LOLiBluffed: folds=20
TrumpsDong: folds=20
Uncalled bet (500) returned to bigpond12
bigpond12 collected 1875 from pot
bigpond12: doesn't show hand=20
*** SUMMARY ***
Total pot 1875 | Rake 0=20
Seat 2: MeatballG10 folded before Flop (didn't bet)
Seat 3: kpadalei24 folded before Flop (didn't bet)
Seat 4: LOLiBluffed (button) folded before Flop (didn't bet)
Seat 5: TrumpsDong (small blind) folded before Flop
Seat 6: bigpond12 (big blind) collected (1875)
Seat 7: JJin91 folded before Flop (didn't bet)
Seat 9: DebOCNJ folded before Flop (didn't bet)


*********** # 144 **************
PokerStars Hand #171485627834: Tournament #1648956629, $18.20+$1.80 USD=
 Hold'em No Limit - Level XV (500/1000) - 2017/06/20 21:38:44 ET
Table '1648956629 6' 9-max Seat #5 is the button
Seat 2: MeatballG10 (18356 in chips)=20
Seat 3: kpadalei24 (10197 in chips)=20
Seat 4: LOLiBluffed (12334 in chips)=20
Seat 5: TrumpsDong (25793 in chips)=20
Seat 6: bigpond12 (172719 in chips)=20
Seat 7: JJin91 (59638 in chips)=20
Seat 9: DebOCNJ (13443 in chips)=20
MeatballG10: posts the ante 125
kpadalei24: posts the ante 125
LOLiBluffed: posts the ante 125
TrumpsDong: posts the ante 125
bigpond12: posts the ante 125
JJin91: posts the ante 125
DebOCNJ: posts the ante 125
bigpond12: posts small blind 500
JJin91: posts big blind 1000
*** HOLE CARDS ***
Dealt to JJin91 [6h Th]
DebOCNJ: folds=20
MeatballG10: folds=20
kpadalei24: folds=20
LOLiBluffed: folds=20
TrumpsDong: folds=20
bigpond12 has timed out
bigpond12: folds=20
Uncalled bet (500) returned to JJin91
bigpond12 is sitting out
JJin91 collected 1875 from pot
JJin91: doesn't show hand=20
*** SUMMARY ***
Total pot 1875 | Rake 0=20
Seat 2: MeatballG10 folded before Flop (didn't bet)
Seat 3: kpadalei24 folded before Flop (didn't bet)
Seat 4: LOLiBluffed folded before Flop (didn't bet)
Seat 5: TrumpsDong (button) folded before Flop (didn't bet)
Seat 6: bigpond12 (small blind) folded before Flop
Seat 7: JJin91 (big blind) collected (1875)
Seat 9: DebOCNJ folded before Flop (didn't bet)


*********** # 145 **************
PokerStars Hand #171485628032: Tournament #1648956629, $18.20+$1.80 USD=
 Hold'em No Limit - Level XV (500/1000) - 2017/06/20 21:39:31 ET
Table '1648956629 6' 9-max Seat #6 is the button
Seat 2: MeatballG10 (18231 in chips)=20
Seat 3: kpadalei24 (10072 in chips)=20
Seat 4: LOLiBluffed (12209 in chips)=20
Seat 5: TrumpsDong (25668 in chips)=20
Seat 6: bigpond12 (172094 in chips) is sitting out
Seat 7: JJin91 (60888 in chips)=20
Seat 9: DebOCNJ (13318 in chips)=20
MeatballG10: posts the ante 125
kpadalei24: posts the ante 125
LOLiBluffed: posts the ante 125
TrumpsDong: posts the ante 125
bigpond12: posts the ante 125
JJin91: posts the ante 125
DebOCNJ: posts the ante 125
JJin91: posts small blind 500
DebOCNJ: posts big blind 1000
*** HOLE CARDS ***
Dealt to JJin91 [As 3c]
MeatballG10: folds=20
kpadalei24: folds=20
LOLiBluffed: folds=20
TrumpsDong: folds=20
bigpond12: folds=20
JJin91: raises 59763 to 60763 and is all-in
DebOCNJ: calls 12193 and is all-in
Uncalled bet (47570) returned to JJin91
*** FLOP *** [8h 2s 4s]
*** TURN *** [8h 2s 4s] [2d]
*** RIVER *** [8h 2s 4s 2d] [8s]
*** SHOW DOWN ***
JJin91: shows [As 3c] (two pair, Eights and Deuces)
DebOCNJ: shows [Ah 6s] (two pair, Eights and Deuces)
JJin91 collected 13631 from pot
DebOCNJ collected 13630 from pot
*** SUMMARY ***
Total pot 27261 | Rake 0=20
Board [8h 2s 4s 2d 8s]
Seat 2: MeatballG10 folded before Flop (didn't bet)
Seat 3: kpadalei24 folded before Flop (didn't bet)
Seat 4: LOLiBluffed folded before Flop (didn't bet)
Seat 5: TrumpsDong folded before Flop (didn't bet)
Seat 6: bigpond12 (button) folded before Flop (didn't bet)
Seat 7: JJin91 (small blind) showed [As 3c] and won (13631) with two pa=
ir, Eights and Deuces
Seat 9: DebOCNJ (big blind) showed [Ah 6s] and won (13630) with two pai=
r, Eights and Deuces


*********** # 146 **************
PokerStars Hand #171485628186: Tournament #1648956629, $18.20+$1.80 USD=
 Hold'em No Limit - Level XV (500/1000) - 2017/06/20 21:40:07 ET
Table '1648956629 6' 9-max Seat #7 is the button
Seat 2: MeatballG10 (18106 in chips)=20
Seat 3: kpadalei24 (9947 in chips)=20
Seat 4: LOLiBluffed (12084 in chips)=20
Seat 5: TrumpsDong (25543 in chips)=20
Seat 6: bigpond12 (171969 in chips) is sitting out
Seat 7: JJin91 (61201 in chips)=20
Seat 9: DebOCNJ (13630 in chips)=20
MeatballG10: posts the ante 125
kpadalei24: posts the ante 125
LOLiBluffed: posts the ante 125
TrumpsDong: posts the ante 125
bigpond12: posts the ante 125
JJin91: posts the ante 125
DebOCNJ: posts the ante 125
DebOCNJ: posts small blind 500
MeatballG10: posts big blind 1000
*** HOLE CARDS ***
Dealt to JJin91 [6c 7h]
kpadalei24: raises 8822 to 9822 and is all-in
LOLiBluffed: folds=20
TrumpsDong: folds=20
bigpond12: folds=20
JJin91: folds=20
DebOCNJ: folds=20
MeatballG10: folds=20
Uncalled bet (8822) returned to kpadalei24
kpadalei24 collected 3375 from pot
kpadalei24: doesn't show hand=20
*** SUMMARY ***
Total pot 3375 | Rake 0=20
Seat 2: MeatballG10 (big blind) folded before Flop
Seat 3: kpadalei24 collected (3375)
Seat 4: LOLiBluffed folded before Flop (didn't bet)
Seat 5: TrumpsDong folded before Flop (didn't bet)
Seat 6: bigpond12 folded before Flop (didn't bet)
Seat 7: JJin91 (button) folded before Flop (didn't bet)
Seat 9: DebOCNJ (small blind) folded before Flop


*********** # 147 **************
PokerStars Hand #171485628283: Tournament #1648956629, $18.20+$1.80 USD=
 Hold'em No Limit - Level XV (500/1000) - 2017/06/20 21:40:29 ET
Table '1648956629 6' 9-max Seat #9 is the button
Seat 2: MeatballG10 (16981 in chips)=20
Seat 3: kpadalei24 (12197 in chips)=20
Seat 4: LOLiBluffed (11959 in chips)=20
Seat 5: TrumpsDong (25418 in chips)=20
Seat 6: bigpond12 (171844 in chips) is sitting out
Seat 7: JJin91 (61076 in chips)=20
Seat 9: DebOCNJ (13005 in chips)=20
MeatballG10: posts the ante 125
kpadalei24: posts the ante 125
LOLiBluffed: posts the ante 125
TrumpsDong: posts the ante 125
bigpond12: posts the ante 125
JJin91: posts the ante 125
DebOCNJ: posts the ante 125
MeatballG10: posts small blind 500
kpadalei24: posts big blind 1000
*** HOLE CARDS ***
Dealt to JJin91 [3d 9c]
LOLiBluffed: folds=20
TrumpsDong: folds=20
bigpond12: folds=20
JJin91: folds=20
DebOCNJ: folds=20
MeatballG10: raises 15856 to 16856 and is all-in
kpadalei24: folds=20
Uncalled bet (15856) returned to MeatballG10
MeatballG10 collected 2875 from pot
MeatballG10: doesn't show hand=20
*** SUMMARY ***
Total pot 2875 | Rake 0=20
Seat 2: MeatballG10 (small blind) collected (2875)
Seat 3: kpadalei24 (big blind) folded before Flop
Seat 4: LOLiBluffed folded before Flop (didn't bet)
Seat 5: TrumpsDong folded before Flop (didn't bet)
Seat 6: bigpond12 folded before Flop (didn't bet)
Seat 7: JJin91 folded before Flop (didn't bet)
Seat 9: DebOCNJ (button) folded before Flop (didn't bet)


*********** # 148 **************
PokerStars Hand #171485628374: Tournament #1648956629, $18.20+$1.80 USD=
 Hold'em No Limit - Level XV (500/1000) - 2017/06/20 21:40:50 ET
Table '1648956629 6' 9-max Seat #2 is the button
Seat 2: MeatballG10 (18731 in chips)=20
Seat 3: kpadalei24 (11072 in chips)=20
Seat 4: LOLiBluffed (11834 in chips)=20
Seat 5: TrumpsDong (25293 in chips)=20
Seat 6: bigpond12 (171719 in chips) is sitting out
Seat 7: JJin91 (60951 in chips)=20
Seat 9: DebOCNJ (12880 in chips)=20
MeatballG10: posts the ante 125
kpadalei24: posts the ante 125
LOLiBluffed: posts the ante 125
TrumpsDong: posts the ante 125
bigpond12: posts the ante 125
JJin91: posts the ante 125
DebOCNJ: posts the ante 125
kpadalei24: posts small blind 500
LOLiBluffed: posts big blind 1000
*** HOLE CARDS ***
Dealt to JJin91 [Js Jc]
TrumpsDong: folds=20
bigpond12: folds=20
JJin91: raises 59826 to 60826 and is all-in
DebOCNJ: folds=20
MeatballG10: folds=20
kpadalei24: calls 10447 and is all-in
LOLiBluffed: folds=20
Uncalled bet (49879) returned to JJin91
*** FLOP *** [4s 9d 5c]
*** TURN *** [4s 9d 5c] [Tc]
*** RIVER *** [4s 9d 5c Tc] [Kd]
*** SHOW DOWN ***
kpadalei24: shows [Ah Jh] (high card Ace)
JJin91: shows [Js Jc] (a pair of Jacks)
JJin91 collected 23769 from pot
kpadalei24 finished the tournament in 21st place
*** SUMMARY ***
Total pot 23769 | Rake 0=20
Board [4s 9d 5c Tc Kd]
Seat 2: MeatballG10 (button) folded before Flop (didn't bet)
Seat 3: kpadalei24 (small blind) showed [Ah Jh] and lost with high card=
 Ace
Seat 4: LOLiBluffed (big blind) folded before Flop
Seat 5: TrumpsDong folded before Flop (didn't bet)
Seat 6: bigpond12 folded before Flop (didn't bet)
Seat 7: JJin91 showed [Js Jc] and won (23769) with a pair of Jacks
Seat 9: DebOCNJ folded before Flop (didn't bet)


*********** # 149 **************
PokerStars Hand #171485628629: Tournament #1648956629, $18.20+$1.80 USD=
 Hold'em No Limit - Level XVI (600/1200) - 2017/06/20 21:41:43 ET
Table '1648956629 6' 9-max Seat #4 is the button
Seat 2: MeatballG10 (18606 in chips)=20
Seat 4: LOLiBluffed (10709 in chips)=20
Seat 5: TrumpsDong (25168 in chips)=20
Seat 6: bigpond12 (171594 in chips) is sitting out
Seat 7: JJin91 (73648 in chips)=20
Seat 9: DebOCNJ (12755 in chips)=20
MeatballG10: posts the ante 150
LOLiBluffed: posts the ante 150
TrumpsDong: posts the ante 150
bigpond12: posts the ante 150
JJin91: posts the ante 150
DebOCNJ: posts the ante 150
TrumpsDong: posts small blind 600
bigpond12: posts big blind 1200
*** HOLE CARDS ***
Dealt to JJin91 [9c 6d]
JJin91: folds=20
DebOCNJ: folds=20
MeatballG10: folds=20
LOLiBluffed: raises 9359 to 10559 and is all-in
TrumpsDong: folds=20
bigpond12: folds=20
Uncalled bet (9359) returned to LOLiBluffed
LOLiBluffed collected 3900 from pot
LOLiBluffed: doesn't show hand=20
*** SUMMARY ***
Total pot 3900 | Rake 0=20
Seat 2: MeatballG10 folded before Flop (didn't bet)
Seat 4: LOLiBluffed (button) collected (3900)
Seat 5: TrumpsDong (small blind) folded before Flop
Seat 6: bigpond12 (big blind) folded before Flop
Seat 7: JJin91 folded before Flop (didn't bet)
Seat 9: DebOCNJ folded before Flop (didn't bet)


*********** # 150 **************
PokerStars Hand #171485628696: Tournament #1648956629, $18.20+$1.80 USD=
 Hold'em No Limit - Level XVI (600/1200) - 2017/06/20 21:42:00 ET
Table '1648956629 6' 9-max Seat #5 is the button
Seat 2: MeatballG10 (18456 in chips)=20
Seat 4: LOLiBluffed (13259 in chips)=20
Seat 5: TrumpsDong (24418 in chips)=20
Seat 6: bigpond12 (170244 in chips) is sitting out
Seat 7: JJin91 (73498 in chips)=20
Seat 9: DebOCNJ (12605 in chips)=20
MeatballG10: posts the ante 150
LOLiBluffed: posts the ante 150
TrumpsDong: posts the ante 150
bigpond12: posts the ante 150
JJin91: posts the ante 150
DebOCNJ: posts the ante 150
bigpond12: posts small blind 600
JJin91: posts big blind 1200
*** HOLE CARDS ***
Dealt to JJin91 [4c 7s]
DebOCNJ: folds=20
MeatballG10: raises 17106 to 18306 and is all-in
LOLiBluffed: folds=20
TrumpsDong: folds=20
bigpond12: folds=20
JJin91: folds=20
Uncalled bet (17106) returned to MeatballG10
MeatballG10 collected 3900 from pot
MeatballG10: doesn't show hand=20
*** SUMMARY ***
Total pot 3900 | Rake 0=20
Seat 2: MeatballG10 collected (3900)
Seat 4: LOLiBluffed folded before Flop (didn't bet)
Seat 5: TrumpsDong (button) folded before Flop (didn't bet)
Seat 6: bigpond12 (small blind) folded before Flop
Seat 7: JJin91 (big blind) folded before Flop
Seat 9: DebOCNJ folded before Flop (didn't bet)


*********** # 151 **************
PokerStars Hand #171485628839: Tournament #1648956629, $18.20+$1.80 USD=
 Hold'em No Limit - Level XVI (600/1200) - 2017/06/20 21:42:28 ET
Table '1648956629 6' 9-max Seat #6 is the button
Seat 2: MeatballG10 (21006 in chips)=20
Seat 4: LOLiBluffed (13109 in chips)=20
Seat 5: TrumpsDong (24268 in chips)=20
Seat 6: bigpond12 (169494 in chips) is sitting out
Seat 7: JJin91 (72148 in chips)=20
Seat 9: DebOCNJ (12455 in chips)=20
MeatballG10: posts the ante 150
LOLiBluffed: posts the ante 150
TrumpsDong: posts the ante 150
bigpond12: posts the ante 150
JJin91: posts the ante 150
DebOCNJ: posts the ante 150
JJin91: posts small blind 600
DebOCNJ: posts big blind 1200
*** HOLE CARDS ***
Dealt to JJin91 [Td Kc]
MeatballG10: folds=20
LOLiBluffed: folds=20
TrumpsDong: folds=20
bigpond12: folds=20
JJin91: raises 70798 to 71998 and is all-in
DebOCNJ: folds=20
Uncalled bet (70798) returned to JJin91
JJin91 collected 3300 from pot
JJin91: doesn't show hand=20
*** SUMMARY ***
Total pot 3300 | Rake 0=20
Seat 2: MeatballG10 folded before Flop (didn't bet)
Seat 4: LOLiBluffed folded before Flop (didn't bet)
Seat 5: TrumpsDong folded before Flop (didn't bet)
Seat 6: bigpond12 (button) folded before Flop (didn't bet)
Seat 7: JJin91 (small blind) collected (3300)
Seat 9: DebOCNJ (big blind) folded before Flop


*********** # 152 **************
PokerStars Hand #171485628949: Tournament #1648956629, $18.20+$1.80 USD=
 Hold'em No Limit - Level XVI (600/1200) - 2017/06/20 21:42:50 ET
Table '1648956629 6' 9-max Seat #7 is the button
Seat 2: MeatballG10 (20856 in chips)=20
Seat 4: LOLiBluffed (12959 in chips)=20
Seat 5: TrumpsDong (24118 in chips)=20
Seat 6: bigpond12 (169344 in chips) is sitting out
Seat 7: JJin91 (74098 in chips)=20
Seat 9: DebOCNJ (11105 in chips)=20
MeatballG10: posts the ante 150
LOLiBluffed: posts the ante 150
TrumpsDong: posts the ante 150
bigpond12: posts the ante 150
JJin91: posts the ante 150
DebOCNJ: posts the ante 150
DebOCNJ: posts small blind 600
MeatballG10: posts big blind 1200
*** HOLE CARDS ***
Dealt to JJin91 [2h Ts]
LOLiBluffed: folds=20
TrumpsDong: raises 22768 to 23968 and is all-in
bigpond12: folds=20
JJin91: folds=20
DebOCNJ: folds=20
MeatballG10: calls 19506 and is all-in
Uncalled bet (3262) returned to TrumpsDong
*** FLOP *** [Jd 7s Jh]
*** TURN *** [Jd 7s Jh] [8s]
*** RIVER *** [Jd 7s Jh 8s] [4d]
*** SHOW DOWN ***
MeatballG10: shows [9d 9c] (two pair, Jacks and Nines)
TrumpsDong: shows [5c 5h] (two pair, Jacks and Fives)
MeatballG10 collected 42912 from pot
*** SUMMARY ***
Total pot 42912 | Rake 0=20
Board [Jd 7s Jh 8s 4d]
Seat 2: MeatballG10 (big blind) showed [9d 9c] and won (42912) with two=
 pair, Jacks and Nines
Seat 4: LOLiBluffed folded before Flop (didn't bet)
Seat 5: TrumpsDong showed [5c 5h] and lost with two pair, Jacks and Fiv=
es
Seat 6: bigpond12 folded before Flop (didn't bet)
Seat 7: JJin91 (button) folded before Flop (didn't bet)
Seat 9: DebOCNJ (small blind) folded before Flop


*********** # 153 **************
PokerStars Hand #171485629107: Tournament #1648956629, $18.20+$1.80 USD=
 Hold'em No Limit - Level XVI (600/1200) - 2017/06/20 21:43:25 ET
Table '1648956629 6' 9-max Seat #9 is the button
Seat 2: MeatballG10 (42912 in chips)=20
Seat 4: LOLiBluffed (12809 in chips)=20
Seat 5: TrumpsDong (3262 in chips)=20
Seat 6: bigpond12 (169194 in chips) is sitting out
Seat 7: JJin91 (73948 in chips)=20
Seat 9: DebOCNJ (10355 in chips)=20
MeatballG10: posts the ante 150
LOLiBluffed: posts the ante 150
TrumpsDong: posts the ante 150
bigpond12: posts the ante 150
JJin91: posts the ante 150
DebOCNJ: posts the ante 150
MeatballG10: posts small blind 600
LOLiBluffed: posts big blind 1200
*** HOLE CARDS ***
Dealt to JJin91 [8h 5s]
TrumpsDong: raises 1912 to 3112 and is all-in
bigpond12: folds=20
JJin91: folds=20
DebOCNJ: folds=20
MeatballG10: raises 12488 to 15600
LOLiBluffed: folds=20
Uncalled bet (12488) returned to MeatballG10
*** FLOP *** [4c 3h Td]
*** TURN *** [4c 3h Td] [Tc]
*** RIVER *** [4c 3h Td Tc] [4h]
*** SHOW DOWN ***
MeatballG10: shows [Qs Qh] (two pair, Queens and Tens)
TrumpsDong: shows [4s 7s] (a full house, Fours full of Tens)
TrumpsDong collected 8324 from pot
*** SUMMARY ***
Total pot 8324 | Rake 0=20
Board [4c 3h Td Tc 4h]
Seat 2: MeatballG10 (small blind) showed [Qs Qh] and lost with two pair=
, Queens and Tens
Seat 4: LOLiBluffed (big blind) folded before Flop
Seat 5: TrumpsDong showed [4s 7s] and won (8324) with a full house, Fou=
rs full of Tens
Seat 6: bigpond12 folded before Flop (didn't bet)
Seat 7: JJin91 folded before Flop (didn't bet)
Seat 9: DebOCNJ (button) folded before Flop (didn't bet)


*********** # 154 **************
PokerStars Hand #171485629226: Tournament #1648956629, $18.20+$1.80 USD=
 Hold'em No Limit - Level XVI (600/1200) - 2017/06/20 21:43:50 ET
Table '1648956629 6' 9-max Seat #2 is the button
Seat 2: MeatballG10 (39650 in chips)=20
Seat 4: LOLiBluffed (11459 in chips)=20
Seat 5: TrumpsDong (8324 in chips)=20
Seat 6: bigpond12 (169044 in chips) is sitting out
Seat 7: JJin91 (73798 in chips)=20
Seat 9: DebOCNJ (10205 in chips)=20
MeatballG10: posts the ante 150
LOLiBluffed: posts the ante 150
TrumpsDong: posts the ante 150
bigpond12: posts the ante 150
JJin91: posts the ante 150
DebOCNJ: posts the ante 150
LOLiBluffed: posts small blind 600
TrumpsDong: posts big blind 1200
*** HOLE CARDS ***
Dealt to JJin91 [7h 6c]
bigpond12: folds=20
JJin91: folds=20
DebOCNJ: folds=20
MeatballG10: raises 38300 to 39500 and is all-in
LOLiBluffed: folds=20
TrumpsDong: calls 6974 and is all-in
Uncalled bet (31326) returned to MeatballG10
*** FLOP *** [Ks 5s 4h]
*** TURN *** [Ks 5s 4h] [5d]
*** RIVER *** [Ks 5s 4h 5d] [6s]
*** SHOW DOWN ***
TrumpsDong: shows [3s 3h] (two pair, Fives and Threes)
MeatballG10: shows [Qc Ad] (a pair of Fives)
TrumpsDong collected 17848 from pot
*** SUMMARY ***
Total pot 17848 | Rake 0=20
Board [Ks 5s 4h 5d 6s]
Seat 2: MeatballG10 (button) showed [Qc Ad] and lost with a pair of Fiv=
es
Seat 4: LOLiBluffed (small blind) folded before Flop
Seat 5: TrumpsDong (big blind) showed [3s 3h] and won (17848) with two =
pair, Fives and Threes
Seat 6: bigpond12 folded before Flop (didn't bet)
Seat 7: JJin91 folded before Flop (didn't bet)
Seat 9: DebOCNJ folded before Flop (didn't bet)


*********** # 155 **************
PokerStars Hand #171485629376: Tournament #1648956629, $18.20+$1.80 USD=
 Hold'em No Limit - Level XVI (600/1200) - 2017/06/20 21:44:23 ET
Table '1648956629 6' 9-max Seat #4 is the button
Seat 2: MeatballG10 (31326 in chips)=20
Seat 4: LOLiBluffed (10709 in chips)=20
Seat 5: TrumpsDong (17848 in chips)=20
Seat 6: bigpond12 (168894 in chips) is sitting out
Seat 7: JJin91 (73648 in chips)=20
Seat 9: DebOCNJ (10055 in chips)=20
MeatballG10: posts the ante 150
LOLiBluffed: posts the ante 150
TrumpsDong: posts the ante 150
bigpond12: posts the ante 150
JJin91: posts the ante 150
DebOCNJ: posts the ante 150
TrumpsDong: posts small blind 600
bigpond12: posts big blind 1200
*** HOLE CARDS ***
Dealt to JJin91 [9c 7h]
JJin91: folds=20
MeatballG10 said, "So Sick..."
DebOCNJ: raises 8705 to 9905 and is all-in
MeatballG10: folds=20
LOLiBluffed: folds=20
TrumpsDong: folds=20
bigpond12: folds=20
Uncalled bet (8705) returned to DebOCNJ
DebOCNJ collected 3900 from pot
DebOCNJ: doesn't show hand=20
*** SUMMARY ***
Total pot 3900 | Rake 0=20
Seat 2: MeatballG10 folded before Flop (didn't bet)
Seat 4: LOLiBluffed (button) folded before Flop (didn't bet)
Seat 5: TrumpsDong (small blind) folded before Flop
Seat 6: bigpond12 (big blind) folded before Flop
Seat 7: JJin91 folded before Flop (didn't bet)
Seat 9: DebOCNJ collected (3900)


*********** # 156 **************
PokerStars Hand #171485629439: Tournament #1648956629, $18.20+$1.80 USD=
 Hold'em No Limit - Level XVI (600/1200) - 2017/06/20 21:44:38 ET
Table '1648956629 6' 9-max Seat #5 is the button
Seat 2: MeatballG10 (31176 in chips)=20
Seat 4: LOLiBluffed (10559 in chips)=20
Seat 5: TrumpsDong (17098 in chips)=20
Seat 6: bigpond12 (167544 in chips) is sitting out
Seat 7: JJin91 (73498 in chips)=20
Seat 9: DebOCNJ (12605 in chips)=20
MeatballG10: posts the ante 150
LOLiBluffed: posts the ante 150
TrumpsDong: posts the ante 150
bigpond12: posts the ante 150
JJin91: posts the ante 150
DebOCNJ: posts the ante 150
bigpond12: posts small blind 600
JJin91: posts big blind 1200
*** HOLE CARDS ***
Dealt to JJin91 [3d Qs]
DebOCNJ: folds=20
MeatballG10: raises 1800 to 3000
LOLiBluffed: folds=20
TrumpsDong: raises 13948 to 16948 and is all-in
bigpond12: folds=20
JJin91: folds=20
MeatballG10: calls 13948
*** FLOP *** [2c 3h 8s]
*** TURN *** [2c 3h 8s] [Kd]
*** RIVER *** [2c 3h 8s Kd] [7h]
*** SHOW DOWN ***
MeatballG10: shows [6d 6h] (a pair of Sixes)
TrumpsDong: shows [9h 9d] (a pair of Nines)
TrumpsDong collected 36596 from pot
*** SUMMARY ***
Total pot 36596 | Rake 0=20
Board [2c 3h 8s Kd 7h]
Seat 2: MeatballG10 showed [6d 6h] and lost with a pair of Sixes
Seat 4: LOLiBluffed folded before Flop (didn't bet)
Seat 5: TrumpsDong (button) showed [9h 9d] and won (36596) with a pair =
of Nines
Seat 6: bigpond12 (small blind) folded before Flop
Seat 7: JJin91 (big blind) folded before Flop
Seat 9: DebOCNJ folded before Flop (didn't bet)


*********** # 157 **************
PokerStars Hand #171485629572: Tournament #1648956629, $18.20+$1.80 USD=
 Hold'em No Limit - Level XVI (600/1200) - 2017/06/20 21:45:08 ET
Table '1648956629 6' 9-max Seat #6 is the button
Seat 2: MeatballG10 (14078 in chips)=20
Seat 4: LOLiBluffed (10409 in chips)=20
Seat 5: TrumpsDong (36596 in chips)=20
Seat 6: bigpond12 (166794 in chips) is sitting out
Seat 7: JJin91 (72148 in chips)=20
Seat 9: DebOCNJ (12455 in chips)=20
MeatballG10: posts the ante 150
LOLiBluffed: posts the ante 150
TrumpsDong: posts the ante 150
bigpond12: posts the ante 150
JJin91: posts the ante 150
DebOCNJ: posts the ante 150
JJin91: posts small blind 600
DebOCNJ: posts big blind 1200
*** HOLE CARDS ***
Dealt to JJin91 [Qs 4h]
MeatballG10: raises 12728 to 13928 and is all-in
LOLiBluffed: folds=20
TrumpsDong: folds=20
bigpond12: folds=20
JJin91: folds=20
DebOCNJ: folds=20
Uncalled bet (12728) returned to MeatballG10
MeatballG10 collected 3900 from pot
MeatballG10: doesn't show hand=20
*** SUMMARY ***
Total pot 3900 | Rake 0=20
Seat 2: MeatballG10 collected (3900)
Seat 4: LOLiBluffed folded before Flop (didn't bet)
Seat 5: TrumpsDong folded before Flop (didn't bet)
Seat 6: bigpond12 (button) folded before Flop (didn't bet)
Seat 7: JJin91 (small blind) folded before Flop
Seat 9: DebOCNJ (big blind) folded before Flop


*********** # 158 **************
PokerStars Hand #171485629699: Tournament #1648956629, $18.20+$1.80 USD=
 Hold'em No Limit - Level XVI (600/1200) - 2017/06/20 21:45:38 ET
Table '1648956629 6' 9-max Seat #7 is the button
Seat 2: MeatballG10 (16628 in chips)=20
Seat 4: LOLiBluffed (10259 in chips)=20
Seat 5: TrumpsDong (36446 in chips)=20
Seat 6: bigpond12 (166644 in chips) is sitting out
Seat 7: JJin91 (71398 in chips)=20
Seat 9: DebOCNJ (11105 in chips)=20
MeatballG10: posts the ante 150
LOLiBluffed: posts the ante 150
TrumpsDong: posts the ante 150
bigpond12: posts the ante 150
JJin91: posts the ante 150
DebOCNJ: posts the ante 150
DebOCNJ: posts small blind 600
MeatballG10: posts big blind 1200
*** HOLE CARDS ***
Dealt to JJin91 [3h 8h]
LOLiBluffed: folds=20
TrumpsDong: folds=20
bigpond12: folds=20
JJin91: folds=20
DebOCNJ: folds=20
Uncalled bet (600) returned to MeatballG10
MeatballG10 collected 2100 from pot
*** SUMMARY ***
Total pot 2100 | Rake 0=20
Seat 2: MeatballG10 (big blind) collected (2100)
Seat 4: LOLiBluffed folded before Flop (didn't bet)
Seat 5: TrumpsDong folded before Flop (didn't bet)
Seat 6: bigpond12 folded before Flop (didn't bet)
Seat 7: JJin91 (button) folded before Flop (didn't bet)
Seat 9: DebOCNJ (small blind) folded before Flop


*********** # 159 **************
PokerStars Hand #171485629769: Tournament #1648956629, $18.20+$1.80 USD=
 Hold'em No Limit - Level XVI (600/1200) - 2017/06/20 21:45:54 ET
Table '1648956629 6' 9-max Seat #9 is the button
Seat 2: MeatballG10 (17978 in chips)=20
Seat 4: LOLiBluffed (10109 in chips)=20
Seat 5: TrumpsDong (36296 in chips)=20
Seat 6: bigpond12 (166494 in chips) is sitting out
Seat 7: JJin91 (71248 in chips)=20
Seat 9: DebOCNJ (10355 in chips)=20
MeatballG10: posts the ante 150
LOLiBluffed: posts the ante 150
TrumpsDong: posts the ante 150
bigpond12: posts the ante 150
JJin91: posts the ante 150
DebOCNJ: posts the ante 150
MeatballG10: posts small blind 600
LOLiBluffed: posts big blind 1200
*** HOLE CARDS ***
Dealt to JJin91 [Ah Jc]
TrumpsDong: folds=20
bigpond12: folds=20
JJin91: raises 69898 to 71098 and is all-in
DebOCNJ: folds=20
MeatballG10: folds=20
LOLiBluffed: folds=20
Uncalled bet (69898) returned to JJin91
JJin91 collected 3900 from pot
JJin91: doesn't show hand=20
*** SUMMARY ***
Total pot 3900 | Rake 0=20
Seat 2: MeatballG10 (small blind) folded before Flop
Seat 4: LOLiBluffed (big blind) folded before Flop
Seat 5: TrumpsDong folded before Flop (didn't bet)
Seat 6: bigpond12 folded before Flop (didn't bet)
Seat 7: JJin91 collected (3900)
Seat 9: DebOCNJ (button) folded before Flop (didn't bet)


*********** # 160 **************
PokerStars Hand #171485629848: Tournament #1648956629, $18.20+$1.80 USD=
 Hold'em No Limit - Level XVI (600/1200) - 2017/06/20 21:46:10 ET
Table '1648956629 6' 9-max Seat #2 is the button
Seat 2: MeatballG10 (17228 in chips)=20
Seat 4: LOLiBluffed (8759 in chips)=20
Seat 5: TrumpsDong (36146 in chips)=20
Seat 6: bigpond12 (166344 in chips) is sitting out
Seat 7: JJin91 (73798 in chips)=20
Seat 9: DebOCNJ (10205 in chips)=20
MeatballG10: posts the ante 150
LOLiBluffed: posts the ante 150
TrumpsDong: posts the ante 150
bigpond12: posts the ante 150
JJin91: posts the ante 150
DebOCNJ: posts the ante 150
LOLiBluffed: posts small blind 600
TrumpsDong: posts big blind 1200
*** HOLE CARDS ***
Dealt to JJin91 [6h 8h]
bigpond12: folds=20
JJin91: folds=20
DebOCNJ: raises 8855 to 10055 and is all-in
MeatballG10: raises 7023 to 17078 and is all-in
LOLiBluffed: folds=20
TrumpsDong: folds=20
Uncalled bet (7023) returned to MeatballG10
*** FLOP *** [3c 4h 9c]
*** TURN *** [3c 4h 9c] [7c]
*** RIVER *** [3c 4h 9c 7c] [5h]
*** SHOW DOWN ***
DebOCNJ: shows [Th Ah] (high card Ace)
MeatballG10: shows [Ks Jd] (high card King)
DebOCNJ collected 22810 from pot
*** SUMMARY ***
Total pot 22810 | Rake 0=20
Board [3c 4h 9c 7c 5h]
Seat 2: MeatballG10 (button) showed [Ks Jd] and lost with high card King
Seat 4: LOLiBluffed (small blind) folded before Flop
Seat 5: TrumpsDong (big blind) folded before Flop
Seat 6: bigpond12 folded before Flop (didn't bet)
Seat 7: JJin91 folded before Flop (didn't bet)
Seat 9: DebOCNJ showed [Th Ah] and won (22810) with high card Ace


*********** # 161 **************
PokerStars Hand #171485629979: Tournament #1648956629, $18.20+$1.80 USD=
 Hold'em No Limit - Level XVI (600/1200) - 2017/06/20 21:46:41 ET
Table '1648956629 6' 9-max Seat #4 is the button
Seat 2: MeatballG10 (7023 in chips)=20
Seat 4: LOLiBluffed (8009 in chips)=20
Seat 5: TrumpsDong (34796 in chips)=20
Seat 6: bigpond12 (166194 in chips) is sitting out
Seat 7: JJin91 (73648 in chips)=20
Seat 9: DebOCNJ (22810 in chips)=20
MeatballG10: posts the ante 150
LOLiBluffed: posts the ante 150
TrumpsDong: posts the ante 150
bigpond12: posts the ante 150
JJin91: posts the ante 150
DebOCNJ: posts the ante 150
TrumpsDong: posts small blind 600
bigpond12: posts big blind 1200
*** HOLE CARDS ***
Dealt to JJin91 [Qd 6s]
JJin91: folds=20
DebOCNJ: folds=20
MeatballG10: folds=20
LOLiBluffed: raises 6659 to 7859 and is all-in
TrumpsDong: raises 26787 to 34646 and is all-in
bigpond12: folds=20
Uncalled bet (26787) returned to TrumpsDong
*** FLOP *** [Ac Ad 9s]
*** TURN *** [Ac Ad 9s] [9c]
*** RIVER *** [Ac Ad 9s 9c] [Ts]
*** SHOW DOWN ***
TrumpsDong: shows [Ah Jc] (a full house, Aces full of Nines)
LOLiBluffed: shows [7h Qh] (two pair, Aces and Nines)
LOLiBluffed is sitting out
TrumpsDong collected 17818 from pot
LOLiBluffed finished the tournament in 20th place
*** SUMMARY ***
Total pot 17818 | Rake 0=20
Board [Ac Ad 9s 9c Ts]
Seat 2: MeatballG10 folded before Flop (didn't bet)
Seat 4: LOLiBluffed (button) showed [7h Qh] and lost with two pair, Ace=
s and Nines
Seat 5: TrumpsDong (small blind) showed [Ah Jc] and won (17818) with a =
full house, Aces full of Nines
Seat 6: bigpond12 (big blind) folded before Flop
Seat 7: JJin91 folded before Flop (didn't bet)
Seat 9: DebOCNJ folded before Flop (didn't bet)


*********** # 162 **************
PokerStars Hand #171487183090: Tournament #1648956629, $18.20+$1.80 USD=
 Hold'em No Limit - Level XVI (600/1200) - 2017/06/20 21:47:05 ET
Table '1648956629 6' 9-max Seat #5 is the button
Seat 2: MeatballG10 (6873 in chips)=20
Seat 5: TrumpsDong (44605 in chips)=20
Seat 6: bigpond12 (164844 in chips) is sitting out
Seat 7: JJin91 (73498 in chips)=20
Seat 9: DebOCNJ (22660 in chips)=20
MeatballG10: posts the ante 150
TrumpsDong: posts the ante 150
bigpond12: posts the ante 150
JJin91: posts the ante 150
DebOCNJ: posts the ante 150
bigpond12: posts small blind 600
JJin91: posts big blind 1200
*** HOLE CARDS ***
Dealt to JJin91 [3h 4d]
DebOCNJ: raises 3750 to 4950
MeatballG10: folds=20
TrumpsDong: folds=20
bigpond12: folds=20
JJin91: folds=20
Uncalled bet (3750) returned to DebOCNJ
DebOCNJ collected 3750 from pot
DebOCNJ: doesn't show hand=20
*** SUMMARY ***
Total pot 3750 | Rake 0=20
Seat 2: MeatballG10 folded before Flop (didn't bet)
Seat 5: TrumpsDong (button) folded before Flop (didn't bet)
Seat 6: bigpond12 (small blind) folded before Flop
Seat 7: JJin91 (big blind) folded before Flop
Seat 9: DebOCNJ collected (3750)


*********** # 163 **************
PokerStars Hand #171487183191: Tournament #1648956629, $18.20+$1.80 USD=
 Hold'em No Limit - Level XVI (600/1200) - 2017/06/20 21:47:25 ET
Table '1648956629 6' 9-max Seat #6 is the button
Seat 2: MeatballG10 (6723 in chips)=20
Seat 5: TrumpsDong (44455 in chips)=20
Seat 6: bigpond12 (164094 in chips) is sitting out
Seat 7: JJin91 (72148 in chips)=20
Seat 8: Deuxexmachen (36043 in chips)=20
Seat 9: DebOCNJ (25060 in chips)=20
MeatballG10: posts the ante 150
TrumpsDong: posts the ante 150
bigpond12: posts the ante 150
JJin91: posts the ante 150
Deuxexmachen: posts the ante 150
DebOCNJ: posts the ante 150
JJin91: posts small blind 600
Deuxexmachen: posts big blind 1200
*** HOLE CARDS ***
Dealt to JJin91 [Qc 7d]
DebOCNJ: folds=20
MeatballG10: raises 5373 to 6573 and is all-in
TrumpsDong: folds=20
bigpond12: folds=20
JJin91: folds=20
Deuxexmachen: folds=20
Uncalled bet (5373) returned to MeatballG10
MeatballG10 collected 3900 from pot
MeatballG10: doesn't show hand=20
*** SUMMARY ***
Total pot 3900 | Rake 0=20
Seat 2: MeatballG10 collected (3900)
Seat 5: TrumpsDong folded before Flop (didn't bet)
Seat 6: bigpond12 (button) folded before Flop (didn't bet)
Seat 7: JJin91 (small blind) folded before Flop
Seat 8: Deuxexmachen (big blind) folded before Flop
Seat 9: DebOCNJ folded before Flop (didn't bet)


*********** # 164 **************
PokerStars Hand #171487183287: Tournament #1648956629, $18.20+$1.80 USD=
 Hold'em No Limit - Level XVI (600/1200) - 2017/06/20 21:47:47 ET
Table '1648956629 6' 9-max Seat #7 is the button
Seat 2: MeatballG10 (9273 in chips)=20
Seat 5: TrumpsDong (44305 in chips)=20
Seat 6: bigpond12 (163944 in chips) is sitting out
Seat 7: JJin91 (71398 in chips)=20
Seat 8: Deuxexmachen (34693 in chips)=20
Seat 9: DebOCNJ (24910 in chips)=20
MeatballG10: posts the ante 150
TrumpsDong: posts the ante 150
bigpond12: posts the ante 150
JJin91: posts the ante 150
Deuxexmachen: posts the ante 150
DebOCNJ: posts the ante 150
Deuxexmachen: posts small blind 600
DebOCNJ: posts big blind 1200
*** HOLE CARDS ***
Dealt to JJin91 [Qh 9c]
MeatballG10: folds=20
TrumpsDong: raises 1800 to 3000
bigpond12: folds=20
JJin91: folds=20
Deuxexmachen: folds=20
DebOCNJ: folds=20
Uncalled bet (1800) returned to TrumpsDong
TrumpsDong collected 3900 from pot
TrumpsDong: doesn't show hand=20
*** SUMMARY ***
Total pot 3900 | Rake 0=20
Seat 2: MeatballG10 folded before Flop (didn't bet)
Seat 5: TrumpsDong collected (3900)
Seat 6: bigpond12 folded before Flop (didn't bet)
Seat 7: JJin91 (button) folded before Flop (didn't bet)
Seat 8: Deuxexmachen (small blind) folded before Flop
Seat 9: DebOCNJ (big blind) folded before Flop


*********** # 165 **************
PokerStars Hand #171487183398: Tournament #1648956629, $18.20+$1.80 USD=
 Hold'em No Limit - Level XVI (600/1200) - 2017/06/20 21:48:13 ET
Table '1648956629 6' 9-max Seat #8 is the button
Seat 2: MeatballG10 (9123 in chips)=20
Seat 5: TrumpsDong (46855 in chips)=20
Seat 6: bigpond12 (163794 in chips) is sitting out
Seat 7: JJin91 (71248 in chips)=20
Seat 8: Deuxexmachen (33943 in chips)=20
Seat 9: DebOCNJ (23560 in chips)=20
MeatballG10: posts the ante 150
TrumpsDong: posts the ante 150
bigpond12: posts the ante 150
JJin91: posts the ante 150
Deuxexmachen: posts the ante 150
DebOCNJ: posts the ante 150
DebOCNJ: posts small blind 600
MeatballG10: posts big blind 1200
*** HOLE CARDS ***
Dealt to JJin91 [Jc Qh]
TrumpsDong: folds=20
bigpond12: folds=20
JJin91: raises 1884 to 3084
Deuxexmachen: folds=20
DebOCNJ: folds=20
MeatballG10: raises 5889 to 8973 and is all-in
JJin91: calls 5889
*** FLOP *** [Th 5s 9s]
*** TURN *** [Th 5s 9s] [3d]
*** RIVER *** [Th 5s 9s 3d] [6d]
*** SHOW DOWN ***
MeatballG10: shows [Kc Ac] (high card Ace)
JJin91: shows [Jc Qh] (high card Queen)
MeatballG10 collected 19446 from pot
*** SUMMARY ***
Total pot 19446 | Rake 0=20
Board [Th 5s 9s 3d 6d]
Seat 2: MeatballG10 (big blind) showed [Kc Ac] and won (19446) with hig=
h card Ace
Seat 5: TrumpsDong folded before Flop (didn't bet)
Seat 6: bigpond12 folded before Flop (didn't bet)
Seat 7: JJin91 showed [Jc Qh] and lost with high card Queen
Seat 8: Deuxexmachen (button) folded before Flop (didn't bet)
Seat 9: DebOCNJ (small blind) folded before Flop


*********** # 166 **************
PokerStars Hand #171487183544: Tournament #1648956629, $18.20+$1.80 USD=
 Hold'em No Limit - Level XVI (600/1200) - 2017/06/20 21:48:48 ET
Table '1648956629 6' 9-max Seat #9 is the button
Seat 2: MeatballG10 (19446 in chips)=20
Seat 5: TrumpsDong (46705 in chips)=20
Seat 6: bigpond12 (163644 in chips) is sitting out
Seat 7: JJin91 (62125 in chips)=20
Seat 8: Deuxexmachen (33793 in chips)=20
Seat 9: DebOCNJ (22810 in chips)=20
MeatballG10: posts the ante 150
TrumpsDong: posts the ante 150
bigpond12: posts the ante 150
JJin91: posts the ante 150
Deuxexmachen: posts the ante 150
DebOCNJ: posts the ante 150
MeatballG10: posts small blind 600
TrumpsDong: posts big blind 1200
*** HOLE CARDS ***
Dealt to JJin91 [5h Kd]
bigpond12: folds=20
JJin91: folds=20
Deuxexmachen: folds=20
DebOCNJ: folds=20
MeatballG10: raises 18096 to 19296 and is all-in
TrumpsDong: folds=20
Uncalled bet (18096) returned to MeatballG10
MeatballG10 collected 3300 from pot
MeatballG10: doesn't show hand=20
*** SUMMARY ***
Total pot 3300 | Rake 0=20
Seat 2: MeatballG10 (small blind) collected (3300)
Seat 5: TrumpsDong (big blind) folded before Flop
Seat 6: bigpond12 folded before Flop (didn't bet)
Seat 7: JJin91 folded before Flop (didn't bet)
Seat 8: Deuxexmachen folded before Flop (didn't bet)
Seat 9: DebOCNJ (button) folded before Flop (didn't bet)


*********** # 167 **************
PokerStars Hand #171487183624: Tournament #1648956629, $18.20+$1.80 USD=
 Hold'em No Limit - Level XVI (600/1200) - 2017/06/20 21:49:07 ET
Table '1648956629 6' 9-max Seat #2 is the button
Seat 2: MeatballG10 (21396 in chips)=20
Seat 5: TrumpsDong (45355 in chips)=20
Seat 6: bigpond12 (163494 in chips) is sitting out
Seat 7: JJin91 (61975 in chips)=20
Seat 8: Deuxexmachen (33643 in chips)=20
Seat 9: DebOCNJ (22660 in chips)=20
MeatballG10: posts the ante 150
TrumpsDong: posts the ante 150
bigpond12: posts the ante 150
JJin91: posts the ante 150
Deuxexmachen: posts the ante 150
DebOCNJ: posts the ante 150
TrumpsDong: posts small blind 600
bigpond12: posts big blind 1200
*** HOLE CARDS ***
Dealt to JJin91 [3s Ad]
JJin91: folds=20
Deuxexmachen: folds=20
DebOCNJ: folds=20
MeatballG10: folds=20
TrumpsDong: raises 1200 to 2400
bigpond12: folds=20
Uncalled bet (1200) returned to TrumpsDong
TrumpsDong collected 3300 from pot
TrumpsDong: doesn't show hand=20
*** SUMMARY ***
Total pot 3300 | Rake 0=20
Seat 2: MeatballG10 (button) folded before Flop (didn't bet)
Seat 5: TrumpsDong (small blind) collected (3300)
Seat 6: bigpond12 (big blind) folded before Flop
Seat 7: JJin91 folded before Flop (didn't bet)
Seat 8: Deuxexmachen folded before Flop (didn't bet)
Seat 9: DebOCNJ folded before Flop (didn't bet)


*********** # 168 **************
PokerStars Hand #171487183724: Tournament #1648956629, $18.20+$1.80 USD=
 Hold'em No Limit - Level XVI (600/1200) - 2017/06/20 21:49:30 ET
Table '1648956629 6' 9-max Seat #5 is the button
Seat 2: MeatballG10 (21246 in chips)=20
Seat 5: TrumpsDong (47305 in chips)=20
Seat 6: bigpond12 (162144 in chips) is sitting out
Seat 7: JJin91 (61825 in chips)=20
Seat 8: Deuxexmachen (33493 in chips)=20
Seat 9: DebOCNJ (22510 in chips)=20
MeatballG10: posts the ante 150
TrumpsDong: posts the ante 150
bigpond12: posts the ante 150
JJin91: posts the ante 150
Deuxexmachen: posts the ante 150
DebOCNJ: posts the ante 150
bigpond12: posts small blind 600
JJin91: posts big blind 1200
*** HOLE CARDS ***
Dealt to JJin91 [As Qs]
Deuxexmachen: folds=20
DebOCNJ: folds=20
MeatballG10: folds=20
TrumpsDong: folds=20
bigpond12: folds=20
Uncalled bet (600) returned to JJin91
JJin91 collected 2100 from pot
JJin91: doesn't show hand=20
*** SUMMARY ***
Total pot 2100 | Rake 0=20
Seat 2: MeatballG10 folded before Flop (didn't bet)
Seat 5: TrumpsDong (button) folded before Flop (didn't bet)
Seat 6: bigpond12 (small blind) folded before Flop
Seat 7: JJin91 (big blind) collected (2100)
Seat 8: Deuxexmachen folded before Flop (didn't bet)
Seat 9: DebOCNJ folded before Flop (didn't bet)


*********** # 169 **************
PokerStars Hand #171487183808: Tournament #1648956629, $18.20+$1.80 USD=
 Hold'em No Limit - Level XVI (600/1200) - 2017/06/20 21:49:48 ET
Table '1648956629 6' 9-max Seat #6 is the button
Seat 2: MeatballG10 (21096 in chips)=20
Seat 5: TrumpsDong (47155 in chips)=20
Seat 6: bigpond12 (161394 in chips) is sitting out
Seat 7: JJin91 (63175 in chips)=20
Seat 8: Deuxexmachen (33343 in chips)=20
Seat 9: DebOCNJ (22360 in chips)=20
MeatballG10: posts the ante 150
TrumpsDong: posts the ante 150
bigpond12: posts the ante 150
JJin91: posts the ante 150
Deuxexmachen: posts the ante 150
DebOCNJ: posts the ante 150
JJin91: posts small blind 600
Deuxexmachen: posts big blind 1200
*** HOLE CARDS ***
Dealt to JJin91 [8s Jd]
DebOCNJ: folds=20
MeatballG10: raises 1800 to 3000
TrumpsDong: folds=20
bigpond12: folds=20
JJin91: folds=20
Deuxexmachen: folds=20
Uncalled bet (1800) returned to MeatballG10
MeatballG10 collected 3900 from pot
MeatballG10: doesn't show hand=20
*** SUMMARY ***
Total pot 3900 | Rake 0=20
Seat 2: MeatballG10 collected (3900)
Seat 5: TrumpsDong folded before Flop (didn't bet)
Seat 6: bigpond12 (button) folded before Flop (didn't bet)
Seat 7: JJin91 (small blind) folded before Flop
Seat 8: Deuxexmachen (big blind) folded before Flop
Seat 9: DebOCNJ folded before Flop (didn't bet)


*********** # 170 **************
PokerStars Hand #171487183880: Tournament #1648956629, $18.20+$1.80 USD=
 Hold'em No Limit - Level XVI (600/1200) - 2017/06/20 21:50:05 ET
Table '1648956629 6' 9-max Seat #7 is the button
Seat 2: MeatballG10 (23646 in chips)=20
Seat 5: TrumpsDong (47005 in chips)=20
Seat 6: bigpond12 (161244 in chips) is sitting out
Seat 7: JJin91 (62425 in chips)=20
Seat 8: Deuxexmachen (31993 in chips)=20
Seat 9: DebOCNJ (22210 in chips)=20
MeatballG10: posts the ante 150
TrumpsDong: posts the ante 150
bigpond12: posts the ante 150
JJin91: posts the ante 150
Deuxexmachen: posts the ante 150
DebOCNJ: posts the ante 150
Deuxexmachen: posts small blind 600
DebOCNJ: posts big blind 1200
*** HOLE CARDS ***
Dealt to JJin91 [5d 5c]
MeatballG10: raises 22296 to 23496 and is all-in
TrumpsDong: folds=20
bigpond12: folds=20
JJin91: folds=20
Deuxexmachen: folds=20
DebOCNJ: folds=20
Uncalled bet (22296) returned to MeatballG10
MeatballG10 collected 3900 from pot
MeatballG10: doesn't show hand=20
*** SUMMARY ***
Total pot 3900 | Rake 0=20
Seat 2: MeatballG10 collected (3900)
Seat 5: TrumpsDong folded before Flop (didn't bet)
Seat 6: bigpond12 folded before Flop (didn't bet)
Seat 7: JJin91 (button) folded before Flop (didn't bet)
Seat 8: Deuxexmachen (small blind) folded before Flop
Seat 9: DebOCNJ (big blind) folded before Flop


*********** # 171 **************
PokerStars Hand #171487184021: Tournament #1648956629, $18.20+$1.80 USD=
 Hold'em No Limit - Level XVI (600/1200) - 2017/06/20 21:50:36 ET
Table '1648956629 6' 9-max Seat #8 is the button
Seat 2: MeatballG10 (26196 in chips)=20
Seat 5: TrumpsDong (46855 in chips)=20
Seat 6: bigpond12 (161094 in chips) is sitting out
Seat 7: JJin91 (62275 in chips)=20
Seat 8: Deuxexmachen (31243 in chips)=20
Seat 9: DebOCNJ (20860 in chips)=20
MeatballG10: posts the ante 150
TrumpsDong: posts the ante 150
bigpond12: posts the ante 150
JJin91: posts the ante 150
Deuxexmachen: posts the ante 150
DebOCNJ: posts the ante 150
DebOCNJ: posts small blind 600
MeatballG10: posts big blind 1200
*** HOLE CARDS ***
Dealt to JJin91 [7d 6s]
TrumpsDong: folds=20
bigpond12: folds=20
JJin91: folds=20
Deuxexmachen: raises 1575 to 2775
DebOCNJ: folds=20
MeatballG10: calls 1575
*** FLOP *** [9d 4s 2s]
MeatballG10: checks=20
Deuxexmachen: bets 3525
MeatballG10: folds=20
Uncalled bet (3525) returned to Deuxexmachen
Deuxexmachen collected 7050 from pot
Deuxexmachen: doesn't show hand=20
*** SUMMARY ***
Total pot 7050 | Rake 0=20
Board [9d 4s 2s]
Seat 2: MeatballG10 (big blind) folded on the Flop
Seat 5: TrumpsDong folded before Flop (didn't bet)
Seat 6: bigpond12 folded before Flop (didn't bet)
Seat 7: JJin91 folded before Flop (didn't bet)
Seat 8: Deuxexmachen (button) collected (7050)
Seat 9: DebOCNJ (small blind) folded before Flop


*********** # 172 **************
PokerStars Hand #171487184131: Tournament #1648956629, $18.20+$1.80 USD=
 Hold'em No Limit - Level XVI (600/1200) - 2017/06/20 21:51:05 ET
Table '1648956629 6' 9-max Seat #9 is the button
Seat 1: bulibasav (19125 in chips) out of hand (moved from another tabl=
e into small blind)
Seat 2: MeatballG10 (23271 in chips)=20
Seat 3: GUUUULP (29132 in chips)=20
Seat 4: TGfor3 (70346 in chips)=20
Seat 5: TrumpsDong (46705 in chips)=20
Seat 6: bigpond12 (160944 in chips) is sitting out
Seat 7: JJin91 (62125 in chips)=20
Seat 8: Deuxexmachen (35368 in chips)=20
Seat 9: DebOCNJ (20110 in chips)=20
MeatballG10: posts the ante 150
GUUUULP: posts the ante 150
TGfor3: posts the ante 150
TrumpsDong: posts the ante 150
bigpond12: posts the ante 150
JJin91: posts the ante 150
Deuxexmachen: posts the ante 150
DebOCNJ: posts the ante 150
MeatballG10: posts small blind 600
GUUUULP: posts big blind 1200
*** HOLE CARDS ***
Dealt to JJin91 [6c Ad]
TGfor3: folds=20
TrumpsDong: folds=20
bigpond12: folds=20
JJin91: folds=20
Deuxexmachen: raises 1575 to 2775
DebOCNJ: folds=20
MeatballG10: folds=20
GUUUULP: folds=20
Uncalled bet (1575) returned to Deuxexmachen
Deuxexmachen collected 4200 from pot
Deuxexmachen: doesn't show hand=20
*** SUMMARY ***
Total pot 4200 | Rake 0=20
Seat 2: MeatballG10 (small blind) folded before Flop
Seat 3: GUUUULP (big blind) folded before Flop
Seat 4: TGfor3 folded before Flop (didn't bet)
Seat 5: TrumpsDong folded before Flop (didn't bet)
Seat 6: bigpond12 folded before Flop (didn't bet)
Seat 7: JJin91 folded before Flop (didn't bet)
Seat 8: Deuxexmachen collected (4200)
Seat 9: DebOCNJ (button) folded before Flop (didn't bet)


*********** # 173 **************
PokerStars Hand #171487184306: Tournament #1648956629, $18.20+$1.80 USD=
 Hold'em No Limit - Level XVII (700/1400) - 2017/06/20 21:51:45 ET
Table '1648956629 6' 9-max Seat #2 is the button
Seat 1: bulibasav (19125 in chips)=20
Seat 2: MeatballG10 (22521 in chips)=20
Seat 3: GUUUULP (27782 in chips)=20
Seat 4: TGfor3 (70196 in chips)=20
Seat 5: TrumpsDong (46555 in chips)=20
Seat 6: bigpond12 (160794 in chips) is sitting out
Seat 7: JJin91 (61975 in chips)=20
Seat 8: Deuxexmachen (38218 in chips)=20
Seat 9: DebOCNJ (19960 in chips)=20
bulibasav: posts the ante 175
MeatballG10: posts the ante 175
GUUUULP: posts the ante 175
TGfor3: posts the ante 175
TrumpsDong: posts the ante 175
bigpond12: posts the ante 175
JJin91: posts the ante 175
Deuxexmachen: posts the ante 175
DebOCNJ: posts the ante 175
GUUUULP: posts small blind 700
TGfor3: posts big blind 1400
*** HOLE CARDS ***
Dealt to JJin91 [Qd Ad]
TrumpsDong: folds=20
bigpond12: folds=20
JJin91: raises 1666 to 3066
Deuxexmachen: folds=20
DebOCNJ: folds=20
bulibasav: folds=20
MeatballG10: folds=20
GUUUULP: folds=20
TGfor3: calls 1666
*** FLOP *** [Qh 7s 4h]
TGfor3: checks=20
JJin91: bets 4792
TGfor3: calls 4792
*** TURN *** [Qh 7s 4h] [7d]
TGfor3: checks=20
JJin91: checks=20
*** RIVER *** [Qh 7s 4h 7d] [Kd]
TGfor3: checks=20
JJin91: checks=20
*** SHOW DOWN ***
TGfor3: shows [As Qc] (two pair, Queens and Sevens)
JJin91: shows [Qd Ad] (two pair, Queens and Sevens)
TGfor3 collected 8996 from pot
JJin91 collected 8995 from pot
*** SUMMARY ***
Total pot 17991 | Rake 0=20
Board [Qh 7s 4h 7d Kd]
Seat 1: bulibasav folded before Flop (didn't bet)
Seat 2: MeatballG10 (button) folded before Flop (didn't bet)
Seat 3: GUUUULP (small blind) folded before Flop
Seat 4: TGfor3 (big blind) showed [As Qc] and won (8996) with two pair,=
 Queens and Sevens
Seat 5: TrumpsDong folded before Flop (didn't bet)
Seat 6: bigpond12 folded before Flop (didn't bet)
Seat 7: JJin91 showed [Qd Ad] and won (8995) with two pair, Queens and =
Sevens
Seat 8: Deuxexmachen folded before Flop (didn't bet)
Seat 9: DebOCNJ folded before Flop (didn't bet)


*********** # 174 **************
PokerStars Hand #171487184801: Tournament #1648956629, $18.20+$1.80 USD=
 Hold'em No Limit - Level XVII (700/1400) - 2017/06/20 21:53:33 ET
Table '1648956629 6' 9-max Seat #3 is the button
Seat 1: bulibasav (18950 in chips)=20
Seat 2: MeatballG10 (22346 in chips)=20
Seat 3: GUUUULP (26907 in chips)=20
Seat 4: TGfor3 (71159 in chips)=20
Seat 5: TrumpsDong (46380 in chips)=20
Seat 6: bigpond12 (160619 in chips) is sitting out
Seat 7: JJin91 (62937 in chips)=20
Seat 9: DebOCNJ (19785 in chips)=20
bulibasav: posts the ante 175
MeatballG10: posts the ante 175
GUUUULP: posts the ante 175
TGfor3: posts the ante 175
TrumpsDong: posts the ante 175
bigpond12: posts the ante 175
JJin91: posts the ante 175
DebOCNJ: posts the ante 175
TGfor3: posts small blind 700
TrumpsDong: posts big blind 1400
*** HOLE CARDS ***
Dealt to JJin91 [Ks 4h]
bigpond12: folds=20
JJin91: folds=20
DebOCNJ: folds=20
bulibasav: folds=20
MeatballG10: folds=20
bigpond12 is disconnected=20
GUUUULP: folds=20
TGfor3: folds=20
Uncalled bet (700) returned to TrumpsDong
TrumpsDong collected 2800 from pot
TrumpsDong: doesn't show hand=20
*** SUMMARY ***
Total pot 2800 | Rake 0=20
Seat 1: bulibasav folded before Flop (didn't bet)
Seat 2: MeatballG10 folded before Flop (didn't bet)
Seat 3: GUUUULP (button) folded before Flop (didn't bet)
Seat 4: TGfor3 (small blind) folded before Flop
Seat 5: TrumpsDong (big blind) collected (2800)
Seat 6: bigpond12 folded before Flop (didn't bet)
Seat 7: JJin91 folded before Flop (didn't bet)
Seat 9: DebOCNJ folded before Flop (didn't bet)


*********** # 175 **************
PokerStars Hand #171487185009: Tournament #1648956629, $18.20+$1.80 USD=
 Hold'em No Limit - Level XVII (700/1400) - 2017/06/20 21:54:23 ET
Table '1648956629 6' 9-max Seat #4 is the button
Seat 1: bulibasav (18775 in chips)=20
Seat 2: MeatballG10 (22171 in chips)=20
Seat 3: GUUUULP (26732 in chips)=20
Seat 4: TGfor3 (70284 in chips)=20
Seat 5: TrumpsDong (48305 in chips)=20
Seat 6: bigpond12 (160444 in chips) is sitting out
Seat 7: JJin91 (62762 in chips)=20
Seat 9: DebOCNJ (19610 in chips)=20
bulibasav: posts the ante 175
MeatballG10: posts the ante 175
GUUUULP: posts the ante 175
TGfor3: posts the ante 175
TrumpsDong: posts the ante 175
bigpond12: posts the ante 175
JJin91: posts the ante 175
DebOCNJ: posts the ante 175
TrumpsDong: posts small blind 700
bigpond12: posts big blind 1400
*** HOLE CARDS ***
Dealt to JJin91 [8s 5h]
JJin91: folds=20
DebOCNJ: folds=20
bulibasav: folds=20
MeatballG10: folds=20
GUUUULP: folds=20
TGfor3: raises 1400 to 2800
TrumpsDong: folds=20
bigpond12: folds=20
Uncalled bet (1400) returned to TGfor3
TGfor3 collected 4900 from pot
TGfor3: doesn't show hand=20
*** SUMMARY ***
Total pot 4900 | Rake 0=20
Seat 1: bulibasav folded before Flop (didn't bet)
Seat 2: MeatballG10 folded before Flop (didn't bet)
Seat 3: GUUUULP folded before Flop (didn't bet)
Seat 4: TGfor3 (button) collected (4900)
Seat 5: TrumpsDong (small blind) folded before Flop
Seat 6: bigpond12 (big blind) folded before Flop
Seat 7: JJin91 folded before Flop (didn't bet)
Seat 9: DebOCNJ folded before Flop (didn't bet)


*********** # 176 **************
PokerStars Hand #171487185111: Tournament #1648956629, $18.20+$1.80 USD=
 Hold'em No Limit - Level XVII (700/1400) - 2017/06/20 21:54:45 ET
Table '1648956629 6' 9-max Seat #5 is the button
Seat 1: bulibasav (18600 in chips)=20
Seat 2: MeatballG10 (21996 in chips)=20
Seat 3: GUUUULP (26557 in chips)=20
Seat 4: TGfor3 (73609 in chips)=20
Seat 5: TrumpsDong (47430 in chips)=20
Seat 6: bigpond12 (158869 in chips) is sitting out
Seat 7: JJin91 (62587 in chips)=20
Seat 9: DebOCNJ (19435 in chips)=20
bulibasav: posts the ante 175
MeatballG10: posts the ante 175
GUUUULP: posts the ante 175
TGfor3: posts the ante 175
TrumpsDong: posts the ante 175
bigpond12: posts the ante 175
JJin91: posts the ante 175
DebOCNJ: posts the ante 175
bigpond12: posts small blind 700
JJin91: posts big blind 1400
*** HOLE CARDS ***
Dealt to JJin91 [5c Kc]
DebOCNJ: folds=20
bulibasav: folds=20
MeatballG10: folds=20
GUUUULP: folds=20
TGfor3: folds=20
TrumpsDong: raises 1800 to 3200
bigpond12: folds=20
JJin91: calls 1800
*** FLOP *** [Jc Ac Kh]
JJin91: checks=20
TrumpsDong: checks=20
*** TURN *** [Jc Ac Kh] [6c]
bigpond12 has returned
JJin91: checks=20
TrumpsDong: bets 3100
JJin91: calls 3100
*** RIVER *** [Jc Ac Kh 6c] [6s]
JJin91: bets 11700
TrumpsDong: folds=20
Uncalled bet (11700) returned to JJin91
JJin91 collected 14700 from pot
JJin91: doesn't show hand=20
*** SUMMARY ***
Total pot 14700 | Rake 0=20
Board [Jc Ac Kh 6c 6s]
Seat 1: bulibasav folded before Flop (didn't bet)
Seat 2: MeatballG10 folded before Flop (didn't bet)
Seat 3: GUUUULP folded before Flop (didn't bet)
Seat 4: TGfor3 folded before Flop (didn't bet)
Seat 5: TrumpsDong (button) folded on the River
Seat 6: bigpond12 (small blind) folded before Flop
Seat 7: JJin91 (big blind) collected (14700)
Seat 9: DebOCNJ folded before Flop (didn't bet)


*********** # 177 **************
PokerStars Hand #171487186517: Tournament #1648956629, $18.20+$1.80 USD=
 Hold'em No Limit - Level XVII (700/1400) - 2017/06/20 22:01:18 ET
Table '1648956629 6' 9-max Seat #6 is the button
Seat 1: bulibasav (18425 in chips)=20
Seat 2: MeatballG10 (21821 in chips)=20
Seat 3: GUUUULP (26382 in chips)=20
Seat 4: TGfor3 (73434 in chips)=20
Seat 5: TrumpsDong (40955 in chips)=20
Seat 6: bigpond12 (157994 in chips)=20
Seat 7: JJin91 (70812 in chips)=20
Seat 9: DebOCNJ (19260 in chips)=20
bulibasav: posts the ante 175
MeatballG10: posts the ante 175
GUUUULP: posts the ante 175
TGfor3: posts the ante 175
TrumpsDong: posts the ante 175
bigpond12: posts the ante 175
JJin91: posts the ante 175
DebOCNJ: posts the ante 175
JJin91: posts small blind 700
DebOCNJ: posts big blind 1400
*** HOLE CARDS ***
Dealt to JJin91 [Js 6d]
bulibasav: folds=20
MeatballG10: folds=20
GUUUULP: folds=20
TGfor3: folds=20
TrumpsDong: folds=20
bigpond12: folds=20
JJin91: raises 69237 to 70637 and is all-in
DebOCNJ: folds=20
Uncalled bet (69237) returned to JJin91
JJin91 collected 4200 from pot
JJin91: doesn't show hand=20
*** SUMMARY ***
Total pot 4200 | Rake 0=20
Seat 1: bulibasav folded before Flop (didn't bet)
Seat 2: MeatballG10 folded before Flop (didn't bet)
Seat 3: GUUUULP folded before Flop (didn't bet)
Seat 4: TGfor3 folded before Flop (didn't bet)
Seat 5: TrumpsDong folded before Flop (didn't bet)
Seat 6: bigpond12 (button) folded before Flop (didn't bet)
Seat 7: JJin91 (small blind) collected (4200)
Seat 9: DebOCNJ (big blind) folded before Flop


*********** # 178 **************
PokerStars Hand #171487186909: Tournament #1648956629, $18.20+$1.80 USD=
 Hold'em No Limit - Level XVII (700/1400) - 2017/06/20 22:02:47 ET
Table '1648956629 6' 9-max Seat #7 is the button
Seat 1: bulibasav (18250 in chips)=20
Seat 2: MeatballG10 (21646 in chips)=20
Seat 3: GUUUULP (26207 in chips)=20
Seat 4: TGfor3 (73259 in chips)=20
Seat 5: TrumpsDong (40780 in chips)=20
Seat 6: bigpond12 (157819 in chips)=20
Seat 7: JJin91 (73437 in chips)=20
Seat 9: DebOCNJ (17685 in chips)=20
bulibasav: posts the ante 175
MeatballG10: posts the ante 175
GUUUULP: posts the ante 175
TGfor3: posts the ante 175
TrumpsDong: posts the ante 175
bigpond12: posts the ante 175
JJin91: posts the ante 175
DebOCNJ: posts the ante 175
DebOCNJ: posts small blind 700
bulibasav: posts big blind 1400
*** HOLE CARDS ***
Dealt to JJin91 [Qs 2c]
MeatballG10: folds=20
GUUUULP: folds=20
TGfor3: folds=20
TrumpsDong: folds=20
bigpond12: calls 1400
JJin91: folds=20
DebOCNJ: folds=20
bulibasav: checks=20
*** FLOP *** [Kd 9h 8h]
bulibasav: checks=20
bigpond12: bets 2800
bulibasav: calls 2800
*** TURN *** [Kd 9h 8h] [5d]
bulibasav: checks=20
bigpond12: checks=20
*** RIVER *** [Kd 9h 8h 5d] [5c]
bulibasav: checks=20
bigpond12: checks=20
*** SHOW DOWN ***
bulibasav: shows [Tc Ah] (a pair of Fives)
bigpond12: mucks hand=20
bulibasav collected 10500 from pot
*** SUMMARY ***
Total pot 10500 | Rake 0=20
Board [Kd 9h 8h 5d 5c]
Seat 1: bulibasav (big blind) showed [Tc Ah] and won (10500) with a pai=
r of Fives
Seat 2: MeatballG10 folded before Flop (didn't bet)
Seat 3: GUUUULP folded before Flop (didn't bet)
Seat 4: TGfor3 folded before Flop (didn't bet)
Seat 5: TrumpsDong folded before Flop (didn't bet)
Seat 6: bigpond12 mucked [Ad 6h]
Seat 7: JJin91 (button) folded before Flop (didn't bet)
Seat 9: DebOCNJ (small blind) folded before Flop


*********** # 179 **************
PokerStars Hand #171487187189: Tournament #1648956629, $18.20+$1.80 USD=
 Hold'em No Limit - Level XVII (700/1400) - 2017/06/20 22:03:46 ET
Table '1648956629 6' 9-max Seat #9 is the button
Seat 1: bulibasav (24375 in chips)=20
Seat 2: MeatballG10 (21471 in chips)=20
Seat 3: GUUUULP (26032 in chips)=20
Seat 4: TGfor3 (73084 in chips)=20
Seat 5: TrumpsDong (40605 in chips)=20
Seat 6: bigpond12 (153444 in chips)=20
Seat 7: JJin91 (73262 in chips)=20
Seat 9: DebOCNJ (16810 in chips)=20
bulibasav: posts the ante 175
MeatballG10: posts the ante 175
GUUUULP: posts the ante 175
TGfor3: posts the ante 175
TrumpsDong: posts the ante 175
bigpond12: posts the ante 175
JJin91: posts the ante 175
DebOCNJ: posts the ante 175
bulibasav: posts small blind 700
MeatballG10: posts big blind 1400
*** HOLE CARDS ***
Dealt to JJin91 [Jd 9d]
GUUUULP: folds=20
TGfor3: folds=20
TrumpsDong: raises 1800 to 3200
bigpond12: raises 1800 to 5000
JJin91: folds=20
DebOCNJ: folds=20
bulibasav: folds=20
MeatballG10: folds=20
TrumpsDong: calls 1800
*** FLOP *** [5d Ts 4h]
TrumpsDong: checks=20
bigpond12: bets 6750
TrumpsDong: folds=20
Uncalled bet (6750) returned to bigpond12
bigpond12 collected 13500 from pot
bigpond12: doesn't show hand=20
*** SUMMARY ***
Total pot 13500 | Rake 0=20
Board [5d Ts 4h]
Seat 1: bulibasav (small blind) folded before Flop
Seat 2: MeatballG10 (big blind) folded before Flop
Seat 3: GUUUULP folded before Flop (didn't bet)
Seat 4: TGfor3 folded before Flop (didn't bet)
Seat 5: TrumpsDong folded on the Flop
Seat 6: bigpond12 collected (13500)
Seat 7: JJin91 folded before Flop (didn't bet)
Seat 9: DebOCNJ (button) folded before Flop (didn't bet)


*********** # 180 **************
PokerStars Hand #171487187414: Tournament #1648956629, $18.20+$1.80 USD=
 Hold'em No Limit - Level XVII (700/1400) - 2017/06/20 22:04:36 ET
Table '1648956629 6' 9-max Seat #1 is the button
Seat 1: bulibasav (23500 in chips)=20
Seat 2: MeatballG10 (19896 in chips)=20
Seat 3: GUUUULP (25857 in chips)=20
Seat 4: TGfor3 (72909 in chips)=20
Seat 5: TrumpsDong (35430 in chips)=20
Seat 6: bigpond12 (161769 in chips)=20
Seat 7: JJin91 (73087 in chips)=20
Seat 9: DebOCNJ (16635 in chips)=20
bulibasav: posts the ante 175
MeatballG10: posts the ante 175
GUUUULP: posts the ante 175
TGfor3: posts the ante 175
TrumpsDong: posts the ante 175
bigpond12: posts the ante 175
JJin91: posts the ante 175
DebOCNJ: posts the ante 175
MeatballG10: posts small blind 700
GUUUULP: posts big blind 1400
*** HOLE CARDS ***
Dealt to JJin91 [8h 7s]
TGfor3: raises 1400 to 2800
TrumpsDong: calls 2800
bigpond12: folds=20
JJin91: folds=20
DebOCNJ: folds=20
bulibasav: folds=20
MeatballG10: folds=20
GUUUULP: folds=20
*** FLOP *** [5d Tc 2h]
TGfor3: bets 4200
TrumpsDong: calls 4200
*** TURN *** [5d Tc 2h] [4h]
TGfor3: bets 8400
TrumpsDong: folds=20
Uncalled bet (8400) returned to TGfor3
TGfor3 collected 17500 from pot
TGfor3: doesn't show hand=20
*** SUMMARY ***
Total pot 17500 | Rake 0=20
Board [5d Tc 2h 4h]
Seat 1: bulibasav (button) folded before Flop (didn't bet)
Seat 2: MeatballG10 (small blind) folded before Flop
Seat 3: GUUUULP (big blind) folded before Flop
Seat 4: TGfor3 collected (17500)
Seat 5: TrumpsDong folded on the Turn
Seat 6: bigpond12 folded before Flop (didn't bet)
Seat 7: JJin91 folded before Flop (didn't bet)
Seat 9: DebOCNJ folded before Flop (didn't bet)


*********** # 181 **************
PokerStars Hand #171487187680: Tournament #1648956629, $18.20+$1.80 USD=
 Hold'em No Limit - Level XVII (700/1400) - 2017/06/20 22:05:37 ET
Table '1648956629 6' 9-max Seat #2 is the button
Seat 1: bulibasav (23325 in chips)=20
Seat 2: MeatballG10 (19021 in chips)=20
Seat 3: GUUUULP (24282 in chips)=20
Seat 4: TGfor3 (83234 in chips)=20
Seat 5: TrumpsDong (28255 in chips)=20
Seat 6: bigpond12 (161594 in chips)=20
Seat 7: JJin91 (72912 in chips)=20
Seat 9: DebOCNJ (16460 in chips)=20
bulibasav: posts the ante 175
MeatballG10: posts the ante 175
GUUUULP: posts the ante 175
TGfor3: posts the ante 175
TrumpsDong: posts the ante 175
bigpond12: posts the ante 175
JJin91: posts the ante 175
DebOCNJ: posts the ante 175
GUUUULP: posts small blind 700
TGfor3: posts big blind 1400
*** HOLE CARDS ***
Dealt to JJin91 [As Tc]
TrumpsDong: folds=20
bigpond12: calls 1400
JJin91: calls 1400
DebOCNJ: calls 1400
bulibasav: folds=20
MeatballG10: raises 17446 to 18846 and is all-in
GUUUULP: folds=20
TGfor3: folds=20
bigpond12: folds=20
JJin91: calls 17446
DebOCNJ: folds=20
*** FLOP *** [8s 9h 7c]
*** TURN *** [8s 9h 7c] [4s]
*** RIVER *** [8s 9h 7c 4s] [Th]
*** SHOW DOWN ***
JJin91: shows [As Tc] (a pair of Tens)
MeatballG10: shows [Qh Ad] (high card Ace)
JJin91 collected 43992 from pot
MeatballG10 finished the tournament in 16th place
*** SUMMARY ***
Total pot 43992 | Rake 0=20
Board [8s 9h 7c 4s Th]
Seat 1: bulibasav folded before Flop (didn't bet)
Seat 2: MeatballG10 (button) showed [Qh Ad] and lost with high card Ace
Seat 3: GUUUULP (small blind) folded before Flop
Seat 4: TGfor3 (big blind) folded before Flop
Seat 5: TrumpsDong folded before Flop (didn't bet)
Seat 6: bigpond12 folded before Flop
Seat 7: JJin91 showed [As Tc] and won (43992) with a pair of Tens
Seat 9: DebOCNJ folded before Flop


*********** # 182 **************
PokerStars Hand #171487188154: Tournament #1648956629, $18.20+$1.80 USD=
 Hold'em No Limit - Level XVII (700/1400) - 2017/06/20 22:07:18 ET
Table '1648956629 6' 9-max Seat #3 is the button
Seat 1: bulibasav (23150 in chips)=20
Seat 3: GUUUULP (23407 in chips)=20
Seat 4: TGfor3 (81659 in chips)=20
Seat 5: TrumpsDong (28080 in chips)=20
Seat 6: bigpond12 (160019 in chips)=20
Seat 7: JJin91 (97883 in chips)=20
Seat 9: DebOCNJ (14885 in chips)=20
bulibasav: posts the ante 175
GUUUULP: posts the ante 175
TGfor3: posts the ante 175
TrumpsDong: posts the ante 175
bigpond12: posts the ante 175
JJin91: posts the ante 175
DebOCNJ: posts the ante 175
TGfor3: posts small blind 700
TrumpsDong: posts big blind 1400
*** HOLE CARDS ***
Dealt to JJin91 [9h Jd]
bigpond12: folds=20
JJin91: folds=20
DebOCNJ: folds=20
bulibasav: folds=20
GUUUULP: folds=20
TGfor3: folds=20
Uncalled bet (700) returned to TrumpsDong
TrumpsDong collected 2625 from pot
TrumpsDong: doesn't show hand=20
*** SUMMARY ***
Total pot 2625 | Rake 0=20
Seat 1: bulibasav folded before Flop (didn't bet)
Seat 3: GUUUULP (button) folded before Flop (didn't bet)
Seat 4: TGfor3 (small blind) folded before Flop
Seat 5: TrumpsDong (big blind) collected (2625)
Seat 6: bigpond12 folded before Flop (didn't bet)
Seat 7: JJin91 folded before Flop (didn't bet)
Seat 9: DebOCNJ folded before Flop (didn't bet)


*********** # 183 **************
PokerStars Hand #171487188273: Tournament #1648956629, $18.20+$1.80 USD=
 Hold'em No Limit - Level XVIII (800/1600) - 2017/06/20 22:07:41 ET
Table '1648956629 6' 9-max Seat #4 is the button
Seat 1: bulibasav (22975 in chips)=20
Seat 3: GUUUULP (23232 in chips)=20
Seat 4: TGfor3 (80784 in chips)=20
Seat 5: TrumpsDong (29830 in chips)=20
Seat 6: bigpond12 (159844 in chips)=20
Seat 7: JJin91 (97708 in chips)=20
Seat 9: DebOCNJ (14710 in chips)=20
bulibasav: posts the ante 200
GUUUULP: posts the ante 200
TGfor3: posts the ante 200
TrumpsDong: posts the ante 200
bigpond12: posts the ante 200
JJin91: posts the ante 200
DebOCNJ: posts the ante 200
TrumpsDong: posts small blind 800
bigpond12: posts big blind 1600
*** HOLE CARDS ***
Dealt to JJin91 [Jd Qd]
JJin91: raises 2512 to 4112
DebOCNJ: folds=20
bulibasav: folds=20
GUUUULP: folds=20
TGfor3: folds=20
TrumpsDong: folds=20
bigpond12: folds=20
Uncalled bet (2512) returned to JJin91
JJin91 collected 5400 from pot
JJin91: doesn't show hand=20
*** SUMMARY ***
Total pot 5400 | Rake 0=20
Seat 1: bulibasav folded before Flop (didn't bet)
Seat 3: GUUUULP folded before Flop (didn't bet)
Seat 4: TGfor3 (button) folded before Flop (didn't bet)
Seat 5: TrumpsDong (small blind) folded before Flop
Seat 6: bigpond12 (big blind) folded before Flop
Seat 7: JJin91 collected (5400)
Seat 9: DebOCNJ folded before Flop (didn't bet)


*********** # 184 **************
PokerStars Hand #171487188364: Tournament #1648956629, $18.20+$1.80 USD=
 Hold'em No Limit - Level XVIII (800/1600) - 2017/06/20 22:08:01 ET
Table '1648956629 6' 9-max Seat #5 is the button
Seat 1: bulibasav (22775 in chips)=20
Seat 3: GUUUULP (23032 in chips)=20
Seat 4: TGfor3 (80584 in chips)=20
Seat 5: TrumpsDong (28830 in chips)=20
Seat 6: bigpond12 (158044 in chips)=20
Seat 7: JJin91 (101308 in chips)=20
Seat 9: DebOCNJ (14510 in chips)=20
bulibasav: posts the ante 200
GUUUULP: posts the ante 200
TGfor3: posts the ante 200
TrumpsDong: posts the ante 200
bigpond12: posts the ante 200
JJin91: posts the ante 200
DebOCNJ: posts the ante 200
bigpond12: posts small blind 800
JJin91: posts big blind 1600
*** HOLE CARDS ***
Dealt to JJin91 [9s 9d]
DebOCNJ: folds=20
bulibasav: folds=20
GUUUULP: folds=20
TGfor3: folds=20
TrumpsDong: folds=20
bigpond12: folds=20
Uncalled bet (800) returned to JJin91
JJin91 collected 3000 from pot
JJin91: doesn't show hand=20
*** SUMMARY ***
Total pot 3000 | Rake 0=20
Seat 1: bulibasav folded before Flop (didn't bet)
Seat 3: GUUUULP folded before Flop (didn't bet)
Seat 4: TGfor3 folded before Flop (didn't bet)
Seat 5: TrumpsDong (button) folded before Flop (didn't bet)
Seat 6: bigpond12 (small blind) folded before Flop
Seat 7: JJin91 (big blind) collected (3000)
Seat 9: DebOCNJ folded before Flop (didn't bet)


*********** # 185 **************
PokerStars Hand #171487188460: Tournament #1648956629, $18.20+$1.80 USD=
 Hold'em No Limit - Level XVIII (800/1600) - 2017/06/20 22:08:21 ET
Table '1648956629 6' 9-max Seat #6 is the button
Seat 1: bulibasav (22575 in chips)=20
Seat 3: GUUUULP (22832 in chips)=20
Seat 4: TGfor3 (80384 in chips)=20
Seat 5: TrumpsDong (28630 in chips)=20
Seat 6: bigpond12 (157044 in chips)=20
Seat 7: JJin91 (103308 in chips)=20
Seat 9: DebOCNJ (14310 in chips)=20
bulibasav: posts the ante 200
GUUUULP: posts the ante 200
TGfor3: posts the ante 200
TrumpsDong: posts the ante 200
bigpond12: posts the ante 200
JJin91: posts the ante 200
DebOCNJ: posts the ante 200
JJin91: posts small blind 800
DebOCNJ: posts big blind 1600
*** HOLE CARDS ***
Dealt to JJin91 [Kc 2c]
bulibasav: folds=20
GUUUULP: folds=20
TGfor3: raises 1600 to 3200
TrumpsDong: folds=20
bigpond12: folds=20
JJin91: calls 2400
DebOCNJ: folds=20
*** FLOP *** [Ad 3c 7h]
JJin91: checks=20
TGfor3: bets 4800
JJin91: folds=20
Uncalled bet (4800) returned to TGfor3
TGfor3 collected 9400 from pot
TGfor3: doesn't show hand=20
*** SUMMARY ***
Total pot 9400 | Rake 0=20
Board [Ad 3c 7h]
Seat 1: bulibasav folded before Flop (didn't bet)
Seat 3: GUUUULP folded before Flop (didn't bet)
Seat 4: TGfor3 collected (9400)
Seat 5: TrumpsDong folded before Flop (didn't bet)
Seat 6: bigpond12 (button) folded before Flop (didn't bet)
Seat 7: JJin91 (small blind) folded on the Flop
Seat 9: DebOCNJ (big blind) folded before Flop


*********** # 186 **************
PokerStars Hand #171487188647: Tournament #1648956629, $18.20+$1.80 USD=
 Hold'em No Limit - Level XVIII (800/1600) - 2017/06/20 22:08:57 ET
Table '1648956629 6' 9-max Seat #7 is the button
Seat 1: bulibasav (22375 in chips)=20
Seat 3: GUUUULP (22632 in chips)=20
Seat 4: TGfor3 (86384 in chips)=20
Seat 5: TrumpsDong (28430 in chips)=20
Seat 6: bigpond12 (156844 in chips)=20
Seat 7: JJin91 (99908 in chips)=20
Seat 9: DebOCNJ (12510 in chips)=20
bulibasav: posts the ante 200
GUUUULP: posts the ante 200
TGfor3: posts the ante 200
TrumpsDong: posts the ante 200
bigpond12: posts the ante 200
JJin91: posts the ante 200
DebOCNJ: posts the ante 200
DebOCNJ: posts small blind 800
bulibasav: posts big blind 1600
*** HOLE CARDS ***
Dealt to JJin91 [Kd 4s]
GUUUULP: raises 20832 to 22432 and is all-in
TGfor3: folds=20
TrumpsDong: folds=20
bigpond12: folds=20
JJin91: folds=20
DebOCNJ: folds=20
bulibasav: folds=20
Uncalled bet (20832) returned to GUUUULP
GUUUULP collected 5400 from pot
*** SUMMARY ***
Total pot 5400 | Rake 0=20
Seat 1: bulibasav (big blind) folded before Flop
Seat 3: GUUUULP collected (5400)
Seat 4: TGfor3 folded before Flop (didn't bet)
Seat 5: TrumpsDong folded before Flop (didn't bet)
Seat 6: bigpond12 folded before Flop (didn't bet)
Seat 7: JJin91 (button) folded before Flop (didn't bet)
Seat 9: DebOCNJ (small blind) folded before Flop


*********** # 187 **************
PokerStars Hand #171487188760: Tournament #1648956629, $18.20+$1.80 USD=
 Hold'em No Limit - Level XVIII (800/1600) - 2017/06/20 22:09:20 ET
Table '1648956629 6' 9-max Seat #9 is the button
Seat 1: bulibasav (20575 in chips)=20
Seat 3: GUUUULP (26232 in chips)=20
Seat 4: TGfor3 (86184 in chips)=20
Seat 5: TrumpsDong (28230 in chips)=20
Seat 6: bigpond12 (156644 in chips)=20
Seat 7: JJin91 (99708 in chips)=20
Seat 9: DebOCNJ (11510 in chips)=20
bulibasav: posts the ante 200
GUUUULP: posts the ante 200
TGfor3: posts the ante 200
TrumpsDong: posts the ante 200
bigpond12: posts the ante 200
JJin91: posts the ante 200
DebOCNJ: posts the ante 200
bulibasav: posts small blind 800
GUUUULP: posts big blind 1600
*** HOLE CARDS ***
Dealt to JJin91 [4h Ac]
TGfor3: folds=20
TrumpsDong: folds=20
bigpond12: folds=20
JJin91: raises 97908 to 99508 and is all-in
DebOCNJ: calls 11310 and is all-in
bulibasav: folds=20
GUUUULP: folds=20
Uncalled bet (88198) returned to JJin91
*** FLOP *** [9c 7c Jc]
*** TURN *** [9c 7c Jc] [5c]
*** RIVER *** [9c 7c Jc 5c] [2h]
*** SHOW DOWN ***
JJin91: shows [4h Ac] (a flush, Ace high)
DebOCNJ: shows [3s 3c] (a flush, Jack high)
JJin91 collected 26420 from pot
DebOCNJ finished the tournament in 14th place and received $36.69.
*** SUMMARY ***
Total pot 26420 | Rake 0=20
Board [9c 7c Jc 5c 2h]
Seat 1: bulibasav (small blind) folded before Flop
Seat 3: GUUUULP (big blind) folded before Flop
Seat 4: TGfor3 folded before Flop (didn't bet)
Seat 5: TrumpsDong folded before Flop (didn't bet)
Seat 6: bigpond12 folded before Flop (didn't bet)
Seat 7: JJin91 showed [4h Ac] and won (26420) with a flush, Ace high
Seat 9: DebOCNJ (button) showed [3s 3c] and lost with a flush, Jack high


*********** # 188 **************
PokerStars Hand #171487188911: Tournament #1648956629, $18.20+$1.80 USD=
 Hold'em No Limit - Level XVIII (800/1600) - 2017/06/20 22:09:48 ET
Table '1648956629 6' 9-max Seat #1 is the button
Seat 1: bulibasav (19575 in chips)=20
Seat 3: GUUUULP (24432 in chips)=20
Seat 4: TGfor3 (85984 in chips)=20
Seat 5: TrumpsDong (28030 in chips)=20
Seat 6: bigpond12 (156444 in chips)=20
Seat 7: JJin91 (114618 in chips)=20
bulibasav: posts the ante 200
GUUUULP: posts the ante 200
TGfor3: posts the ante 200
TrumpsDong: posts the ante 200
bigpond12: posts the ante 200
JJin91: posts the ante 200
GUUUULP: posts small blind 800
TGfor3: posts big blind 1600
*** HOLE CARDS ***
Dealt to JJin91 [9h 6c]
TrumpsDong: folds=20
bigpond12: folds=20
JJin91: folds=20
bulibasav: folds=20
GUUUULP: raises 22632 to 24232 and is all-in
TGfor3: folds=20
Uncalled bet (22632) returned to GUUUULP
GUUUULP collected 4400 from pot
GUUUULP: doesn't show hand=20
*** SUMMARY ***
Total pot 4400 | Rake 0=20
Seat 1: bulibasav (button) folded before Flop (didn't bet)
Seat 3: GUUUULP (small blind) collected (4400)
Seat 4: TGfor3 (big blind) folded before Flop
Seat 5: TrumpsDong folded before Flop (didn't bet)
Seat 6: bigpond12 folded before Flop (didn't bet)
Seat 7: JJin91 folded before Flop (didn't bet)


*********** # 189 **************
PokerStars Hand #171487189010: Tournament #1648956629, $18.20+$1.80 USD=
 Hold'em No Limit - Level XVIII (800/1600) - 2017/06/20 22:10:08 ET
Table '1648956629 6' 9-max Seat #3 is the button
Seat 1: bulibasav (19375 in chips)=20
Seat 3: GUUUULP (27032 in chips)=20
Seat 4: TGfor3 (84184 in chips)=20
Seat 5: TrumpsDong (27830 in chips)=20
Seat 6: bigpond12 (156244 in chips)=20
Seat 7: JJin91 (114418 in chips)=20
bulibasav: posts the ante 200
GUUUULP: posts the ante 200
TGfor3: posts the ante 200
TrumpsDong: posts the ante 200
bigpond12: posts the ante 200
JJin91: posts the ante 200
TGfor3: posts small blind 800
TrumpsDong: posts big blind 1600
*** HOLE CARDS ***
Dealt to JJin91 [8h 8c]
bigpond12: folds=20
JJin91: raises 2512 to 4112
bulibasav: folds=20
GUUUULP: folds=20
TGfor3: folds=20
TrumpsDong: folds=20
Uncalled bet (2512) returned to JJin91
JJin91 collected 5200 from pot
JJin91: doesn't show hand=20
*** SUMMARY ***
Total pot 5200 | Rake 0=20
Seat 1: bulibasav folded before Flop (didn't bet)
Seat 3: GUUUULP (button) folded before Flop (didn't bet)
Seat 4: TGfor3 (small blind) folded before Flop
Seat 5: TrumpsDong (big blind) folded before Flop
Seat 6: bigpond12 folded before Flop (didn't bet)
Seat 7: JJin91 collected (5200)


*********** # 190 **************
PokerStars Hand #171487189192: Tournament #1648956629, $18.20+$1.80 USD=
 Hold'em No Limit - Level XVIII (800/1600) - 2017/06/20 22:10:42 ET
Table '1648956629 6' 9-max Seat #4 is the button
Seat 1: bulibasav (19175 in chips)=20
Seat 3: GUUUULP (26832 in chips)=20
Seat 4: TGfor3 (83184 in chips)=20
Seat 5: TrumpsDong (26030 in chips)=20
Seat 6: bigpond12 (156044 in chips)=20
Seat 7: JJin91 (117818 in chips)=20
bulibasav: posts the ante 200
GUUUULP: posts the ante 200
TGfor3: posts the ante 200
TrumpsDong: posts the ante 200
bigpond12: posts the ante 200
JJin91: posts the ante 200
TrumpsDong: posts small blind 800
bigpond12: posts big blind 1600
*** HOLE CARDS ***
Dealt to JJin91 [8c Kd]
JJin91: folds=20
bulibasav: folds=20
GUUUULP: folds=20
TGfor3: folds=20
TrumpsDong: folds=20
Uncalled bet (800) returned to bigpond12
bigpond12 collected 2800 from pot
bigpond12: doesn't show hand=20
*** SUMMARY ***
Total pot 2800 | Rake 0=20
Seat 1: bulibasav folded before Flop (didn't bet)
Seat 3: GUUUULP folded before Flop (didn't bet)
Seat 4: TGfor3 (button) folded before Flop (didn't bet)
Seat 5: TrumpsDong (small blind) folded before Flop
Seat 6: bigpond12 (big blind) collected (2800)
Seat 7: JJin91 folded before Flop (didn't bet)


*********** # 191 **************
PokerStars Hand #171487189254: Tournament #1648956629, $18.20+$1.80 USD=
 Hold'em No Limit - Level XVIII (800/1600) - 2017/06/20 22:10:56 ET
Table '1648956629 6' 9-max Seat #5 is the button
Seat 1: bulibasav (18975 in chips)=20
Seat 3: GUUUULP (26632 in chips)=20
Seat 4: TGfor3 (82984 in chips)=20
Seat 5: TrumpsDong (25030 in chips)=20
Seat 6: bigpond12 (157844 in chips)=20
Seat 7: JJin91 (117618 in chips)=20
bulibasav: posts the ante 200
GUUUULP: posts the ante 200
TGfor3: posts the ante 200
TrumpsDong: posts the ante 200
bigpond12: posts the ante 200
JJin91: posts the ante 200
bigpond12: posts small blind 800
JJin91: posts big blind 1600
*** HOLE CARDS ***
Dealt to JJin91 [Qh Qc]
bulibasav: folds=20
GUUUULP: raises 24832 to 26432 and is all-in
TGfor3: raises 56352 to 82784 and is all-in
TrumpsDong: folds=20
bigpond12: folds=20
JJin91: folds=20
Uncalled bet (56352) returned to TGfor3
*** FLOP *** [Jh 8s 3d]
*** TURN *** [Jh 8s 3d] [Kc]
*** RIVER *** [Jh 8s 3d Kc] [Jd]
*** SHOW DOWN ***
GUUUULP: shows [Jc Js] (four of a kind, Jacks)
TGfor3: shows [7s 7d] (two pair, Jacks and Sevens)
GUUUULP collected 56464 from pot
*** SUMMARY ***
Total pot 56464 | Rake 0=20
Board [Jh 8s 3d Kc Jd]
Seat 1: bulibasav folded before Flop (didn't bet)
Seat 3: GUUUULP showed [Jc Js] and won (56464) with four of a kind, Jac=
ks
Seat 4: TGfor3 showed [7s 7d] and lost with two pair, Jacks and Sevens
Seat 5: TrumpsDong (button) folded before Flop (didn't bet)
Seat 6: bigpond12 (small blind) folded before Flop
Seat 7: JJin91 (big blind) folded before Flop


*********** # 192 **************
PokerStars Hand #171487189450: Tournament #1648956629, $18.20+$1.80 USD=
 Hold'em No Limit - Level XVIII (800/1600) - 2017/06/20 22:11:38 ET
Table '1648956629 6' 9-max Seat #6 is the button
Seat 1: bulibasav (18775 in chips)=20
Seat 3: GUUUULP (56464 in chips)=20
Seat 4: TGfor3 (56352 in chips)=20
Seat 5: TrumpsDong (24830 in chips)=20
Seat 6: bigpond12 (156844 in chips)=20
Seat 7: JJin91 (115818 in chips)=20
bulibasav: posts the ante 200
GUUUULP: posts the ante 200
TGfor3: posts the ante 200
TrumpsDong: posts the ante 200
bigpond12: posts the ante 200
JJin91: posts the ante 200
JJin91: posts small blind 800
bulibasav: posts big blind 1600
*** HOLE CARDS ***
Dealt to JJin91 [2c Jc]
GUUUULP: folds=20
TGfor3: raises 54552 to 56152 and is all-in
TrumpsDong: folds=20
bigpond12: folds=20
JJin91: folds=20
bulibasav: folds=20
Uncalled bet (54552) returned to TGfor3
TGfor3 collected 5200 from pot
TGfor3: doesn't show hand=20
*** SUMMARY ***
Total pot 5200 | Rake 0=20
Seat 1: bulibasav (big blind) folded before Flop
Seat 3: GUUUULP folded before Flop (didn't bet)
Seat 4: TGfor3 collected (5200)
Seat 5: TrumpsDong folded before Flop (didn't bet)
Seat 6: bigpond12 (button) folded before Flop (didn't bet)
Seat 7: JJin91 (small blind) folded before Flop


*********** # 193 **************
PokerStars Hand #171487189617: Tournament #1648956629, $18.20+$1.80 USD=
 Hold'em No Limit - Level XVIII (800/1600) - 2017/06/20 22:12:12 ET
Table '1648956629 6' 9-max Seat #7 is the button
Seat 1: bulibasav (16975 in chips)=20
Seat 3: GUUUULP (56264 in chips)=20
Seat 4: TGfor3 (59752 in chips)=20
Seat 5: TrumpsDong (24630 in chips)=20
Seat 6: bigpond12 (156644 in chips)=20
Seat 7: JJin91 (114818 in chips)=20
bulibasav: posts the ante 200
GUUUULP: posts the ante 200
TGfor3: posts the ante 200
TrumpsDong: posts the ante 200
bigpond12: posts the ante 200
JJin91: posts the ante 200
bulibasav: posts small blind 800
GUUUULP: posts big blind 1600
*** HOLE CARDS ***
Dealt to JJin91 [3s 6d]
TGfor3: folds=20
TrumpsDong: folds=20
bigpond12: folds=20
JJin91: folds=20
bulibasav: raises 15175 to 16775 and is all-in
GUUUULP: calls 15175
*** FLOP *** [3c 8h 7s]
*** TURN *** [3c 8h 7s] [Qd]
*** RIVER *** [3c 8h 7s Qd] [8s]
*** SHOW DOWN ***
bulibasav: shows [Kd As] (a pair of Eights)
GUUUULP: shows [6s Ad] (a pair of Eights - lower kicker)
bulibasav collected 34750 from pot
*** SUMMARY ***
Total pot 34750 | Rake 0=20
Board [3c 8h 7s Qd 8s]
Seat 1: bulibasav (small blind) showed [Kd As] and won (34750) with a p=
air of Eights
Seat 3: GUUUULP (big blind) showed [6s Ad] and lost with a pair of Eigh=
ts
Seat 4: TGfor3 folded before Flop (didn't bet)
Seat 5: TrumpsDong folded before Flop (didn't bet)
Seat 6: bigpond12 folded before Flop (didn't bet)
Seat 7: JJin91 (button) folded before Flop (didn't bet)


*********** # 194 **************
PokerStars Hand #171487189746: Tournament #1648956629, $18.20+$1.80 USD=
 Hold'em No Limit - Level XVIII (800/1600) - 2017/06/20 22:12:35 ET
Table '1648956629 6' 9-max Seat #1 is the button
Seat 1: bulibasav (34750 in chips)=20
Seat 3: GUUUULP (39289 in chips)=20
Seat 4: TGfor3 (59552 in chips)=20
Seat 5: TrumpsDong (24430 in chips)=20
Seat 6: bigpond12 (156444 in chips)=20
Seat 7: JJin91 (114618 in chips)=20
bulibasav: posts the ante 200
GUUUULP: posts the ante 200
TGfor3: posts the ante 200
TrumpsDong: posts the ante 200
bigpond12: posts the ante 200
JJin91: posts the ante 200
GUUUULP: posts small blind 800
TGfor3: posts big blind 1600
*** HOLE CARDS ***
Dealt to JJin91 [Td 7h]
TrumpsDong: raises 2400 to 4000
bigpond12: folds=20
JJin91: folds=20
bulibasav: folds=20
GUUUULP: folds=20
TGfor3: calls 2400
*** FLOP *** [Qs 8c Th]
TGfor3: checks=20
TrumpsDong: bets 4000
TGfor3: folds=20
Uncalled bet (4000) returned to TrumpsDong
TrumpsDong collected 10000 from pot
TrumpsDong: doesn't show hand=20
*** SUMMARY ***
Total pot 10000 | Rake 0=20
Board [Qs 8c Th]
Seat 1: bulibasav (button) folded before Flop (didn't bet)
Seat 3: GUUUULP (small blind) folded before Flop
Seat 4: TGfor3 (big blind) folded on the Flop
Seat 5: TrumpsDong collected (10000)
Seat 6: bigpond12 folded before Flop (didn't bet)
Seat 7: JJin91 folded before Flop (didn't bet)


*********** # 195 **************
PokerStars Hand #171487189943: Tournament #1648956629, $18.20+$1.80 USD=
 Hold'em No Limit - Level XVIII (800/1600) - 2017/06/20 22:13:10 ET
Table '1648956629 6' 9-max Seat #3 is the button
Seat 1: bulibasav (34550 in chips)=20
Seat 3: GUUUULP (38289 in chips)=20
Seat 4: TGfor3 (55352 in chips)=20
Seat 5: TrumpsDong (30230 in chips)=20
Seat 6: bigpond12 (156244 in chips)=20
Seat 7: JJin91 (114418 in chips)=20
bulibasav: posts the ante 200
GUUUULP: posts the ante 200
TGfor3: posts the ante 200
TrumpsDong: posts the ante 200
bigpond12: posts the ante 200
JJin91: posts the ante 200
TGfor3: posts small blind 800
TrumpsDong: posts big blind 1600
*** HOLE CARDS ***
Dealt to JJin91 [5h As]
bigpond12: raises 1600 to 3200
JJin91: folds=20
bulibasav: raises 31150 to 34350 and is all-in
GUUUULP: folds=20
TGfor3: folds=20
TrumpsDong: folds=20
bigpond12: folds=20
Uncalled bet (31150) returned to bulibasav
bulibasav collected 10000 from pot
bulibasav: doesn't show hand=20
*** SUMMARY ***
Total pot 10000 | Rake 0=20
Seat 1: bulibasav collected (10000)
Seat 3: GUUUULP (button) folded before Flop (didn't bet)
Seat 4: TGfor3 (small blind) folded before Flop
Seat 5: TrumpsDong (big blind) folded before Flop
Seat 6: bigpond12 folded before Flop
Seat 7: JJin91 folded before Flop (didn't bet)


*********** # 196 **************
PokerStars Hand #171488030456: Tournament #1648956629, $18.20+$1.80 USD=
 Hold'em No Limit - Level XVIII (800/1600) - 2017/06/20 22:13:57 ET
Table '1648956629 6' 9-max Seat #4 is the button
Seat 1: bulibasav (41150 in chips)=20
Seat 3: GUUUULP (38089 in chips)=20
Seat 4: TGfor3 (54352 in chips)=20
Seat 5: TrumpsDong (28430 in chips)=20
Seat 6: bigpond12 (152844 in chips)=20
Seat 7: JJin91 (114218 in chips)=20
bulibasav: posts the ante 200
GUUUULP: posts the ante 200
TGfor3: posts the ante 200
TrumpsDong: posts the ante 200
bigpond12: posts the ante 200
JJin91: posts the ante 200
TrumpsDong: posts small blind 800
bigpond12: posts big blind 1600
*** HOLE CARDS ***
Dealt to JJin91 [Jd 5c]
JJin91: folds=20
bulibasav: folds=20
GUUUULP: folds=20
TGfor3: folds=20
TrumpsDong: folds=20
Uncalled bet (800) returned to bigpond12
bigpond12 collected 2800 from pot
bigpond12: doesn't show hand=20
*** SUMMARY ***
Total pot 2800 | Rake 0=20
Seat 1: bulibasav folded before Flop (didn't bet)
Seat 3: GUUUULP folded before Flop (didn't bet)
Seat 4: TGfor3 (button) folded before Flop (didn't bet)
Seat 5: TrumpsDong (small blind) folded before Flop
Seat 6: bigpond12 (big blind) collected (2800)
Seat 7: JJin91 folded before Flop (didn't bet)


*********** # 197 **************
PokerStars Hand #171488030521: Tournament #1648956629, $18.20+$1.80 USD=
 Hold'em No Limit - Level XVIII (800/1600) - 2017/06/20 22:14:11 ET
Table '1648956629 6' 9-max Seat #5 is the button
Seat 1: bulibasav (40950 in chips)=20
Seat 3: GUUUULP (37889 in chips)=20
Seat 4: TGfor3 (54152 in chips)=20
Seat 5: TrumpsDong (27430 in chips)=20
Seat 6: bigpond12 (154644 in chips)=20
Seat 7: JJin91 (114018 in chips)=20
bulibasav: posts the ante 200
GUUUULP: posts the ante 200
TGfor3: posts the ante 200
TrumpsDong: posts the ante 200
bigpond12: posts the ante 200
JJin91: posts the ante 200
bigpond12: posts small blind 800
JJin91: posts big blind 1600
*** HOLE CARDS ***
Dealt to JJin91 [Js 7s]
bulibasav: folds=20
GUUUULP: folds=20
TGfor3: folds=20
TrumpsDong: folds=20
bigpond12: calls 800
JJin91: checks=20
*** FLOP *** [Qh Qs Ks]
bigpond12: bets 1600
JJin91: calls 1600
*** TURN *** [Qh Qs Ks] [Qc]
bigpond12: checks=20
JJin91: bets 2812
bigpond12: folds=20
Uncalled bet (2812) returned to JJin91
JJin91 collected 7600 from pot
JJin91: doesn't show hand=20
*** SUMMARY ***
Total pot 7600 | Rake 0=20
Board [Qh Qs Ks Qc]
Seat 1: bulibasav folded before Flop (didn't bet)
Seat 3: GUUUULP folded before Flop (didn't bet)
Seat 4: TGfor3 folded before Flop (didn't bet)
Seat 5: TrumpsDong (button) folded before Flop (didn't bet)
Seat 6: bigpond12 (small blind) folded on the Turn
Seat 7: JJin91 (big blind) collected (7600)


*********** # 198 **************
PokerStars Hand #171488030671: Tournament #1648956629, $18.20+$1.80 USD=
 Hold'em No Limit - Level XVIII (800/1600) - 2017/06/20 22:14:44 ET
Table '1648956629 6' 9-max Seat #6 is the button
Seat 1: bulibasav (40750 in chips)=20
Seat 3: GUUUULP (37689 in chips)=20
Seat 4: TGfor3 (53952 in chips)=20
Seat 5: TrumpsDong (27230 in chips)=20
Seat 6: bigpond12 (151244 in chips)=20
Seat 7: JJin91 (118218 in chips)=20
bulibasav: posts the ante 200
GUUUULP: posts the ante 200
TGfor3: posts the ante 200
TrumpsDong: posts the ante 200
bigpond12: posts the ante 200
JJin91: posts the ante 200
JJin91: posts small blind 800
bulibasav: posts big blind 1600
*** HOLE CARDS ***
Dealt to JJin91 [Ac 4c]
GUUUULP: folds=20
TGfor3: folds=20
TrumpsDong: folds=20
bigpond12: folds=20
JJin91: raises 2512 to 4112
bulibasav: folds=20
Uncalled bet (2512) returned to JJin91
JJin91 collected 4400 from pot
JJin91: doesn't show hand=20
*** SUMMARY ***
Total pot 4400 | Rake 0=20
Seat 1: bulibasav (big blind) folded before Flop
Seat 3: GUUUULP folded before Flop (didn't bet)
Seat 4: TGfor3 folded before Flop (didn't bet)
Seat 5: TrumpsDong folded before Flop (didn't bet)
Seat 6: bigpond12 (button) folded before Flop (didn't bet)
Seat 7: JJin91 (small blind) collected (4400)


*********** # 199 **************
PokerStars Hand #171488030785: Tournament #1648956629, $18.20+$1.80 USD=
 Hold'em No Limit - Level XVIII (800/1600) - 2017/06/20 22:15:12 ET
Table '1648956629 6' 9-max Seat #7 is the button
Seat 1: bulibasav (38950 in chips)=20
Seat 3: GUUUULP (37489 in chips)=20
Seat 4: TGfor3 (53752 in chips)=20
Seat 5: TrumpsDong (27030 in chips)=20
Seat 6: bigpond12 (151044 in chips)=20
Seat 7: JJin91 (120818 in chips)=20
bulibasav: posts the ante 200
GUUUULP: posts the ante 200
TGfor3: posts the ante 200
TrumpsDong: posts the ante 200
bigpond12: posts the ante 200
JJin91: posts the ante 200
bulibasav: posts small blind 800
GUUUULP: posts big blind 1600
*** HOLE CARDS ***
Dealt to JJin91 [Kc Qh]
TGfor3: folds=20
TrumpsDong: folds=20
bigpond12: calls 1600
JJin91: raises 2533 to 4133
bulibasav: folds=20
GUUUULP: folds=20
bigpond12: calls 2533
*** FLOP *** [3s 9s Jc]
bigpond12: checks=20
JJin91: checks=20
*** TURN *** [3s 9s Jc] [2h]
bigpond12: bets 11200
JJin91: folds=20
Uncalled bet (11200) returned to bigpond12
bigpond12 collected 11866 from pot
bigpond12: doesn't show hand=20
*** SUMMARY ***
Total pot 11866 | Rake 0=20
Board [3s 9s Jc 2h]
Seat 1: bulibasav (small blind) folded before Flop
Seat 3: GUUUULP (big blind) folded before Flop
Seat 4: TGfor3 folded before Flop (didn't bet)
Seat 5: TrumpsDong folded before Flop (didn't bet)
Seat 6: bigpond12 collected (11866)
Seat 7: JJin91 (button) folded on the Turn


*********** # 200 **************
PokerStars Hand #171488031003: Tournament #1648956629, $18.20+$1.80 USD=
 Hold'em No Limit - Level XVIII (800/1600) - 2017/06/20 22:15:55 ET
Table '1648956629 6' 9-max Seat #1 is the button
Seat 1: bulibasav (37950 in chips)=20
Seat 3: GUUUULP (35689 in chips)=20
Seat 4: TGfor3 (53552 in chips)=20
Seat 5: TrumpsDong (26830 in chips)=20
Seat 6: bigpond12 (158577 in chips)=20
Seat 7: JJin91 (116485 in chips)=20
bulibasav: posts the ante 200
GUUUULP: posts the ante 200
TGfor3: posts the ante 200
TrumpsDong: posts the ante 200
bigpond12: posts the ante 200
JJin91: posts the ante 200
GUUUULP: posts small blind 800
TGfor3: posts big blind 1600
*** HOLE CARDS ***
Dealt to JJin91 [9h 6s]
TrumpsDong: folds=20
bigpond12: calls 1600
JJin91: folds=20
bulibasav: folds=20
GUUUULP: calls 800
TGfor3: checks=20
*** FLOP *** [2s 9d Qh]
GUUUULP: checks=20
TGfor3: checks=20
bigpond12: bets 6400
GUUUULP: folds=20
TGfor3: calls 6400
*** TURN *** [2s 9d Qh] [4s]
TGfor3: checks=20
bigpond12: checks=20
*** RIVER *** [2s 9d Qh 4s] [2d]
TGfor3: bets 13160
bigpond12: calls 13160
*** SHOW DOWN ***
TGfor3: shows [Td Jd] (a pair of Deuces)
bigpond12: shows [3h 3s] (two pair, Threes and Deuces)
bigpond12 collected 45120 from pot
*** SUMMARY ***
Total pot 45120 | Rake 0=20
Board [2s 9d Qh 4s 2d]
Seat 1: bulibasav (button) folded before Flop (didn't bet)
Seat 3: GUUUULP (small blind) folded on the Flop
Seat 4: TGfor3 (big blind) showed [Td Jd] and lost with a pair of Deuces
Seat 5: TrumpsDong folded before Flop (didn't bet)
Seat 6: bigpond12 showed [3h 3s] and won (45120) with two pair, Threes =
and Deuces
Seat 7: JJin91 folded before Flop (didn't bet)


*********** # 201 **************
PokerStars Hand #171488031278: Tournament #1648956629, $18.20+$1.80 USD=
 Hold'em No Limit - Level XVIII (800/1600) - 2017/06/20 22:16:53 ET
Table '1648956629 6' 9-max Seat #3 is the button
Seat 1: bulibasav (37750 in chips)=20
Seat 3: GUUUULP (33889 in chips)=20
Seat 4: TGfor3 (32192 in chips)=20
Seat 5: TrumpsDong (26630 in chips)=20
Seat 6: bigpond12 (182337 in chips)=20
Seat 7: JJin91 (116285 in chips)=20
bulibasav: posts the ante 200
GUUUULP: posts the ante 200
TGfor3: posts the ante 200
TrumpsDong: posts the ante 200
bigpond12: posts the ante 200
JJin91: posts the ante 200
TGfor3: posts small blind 800
TrumpsDong: posts big blind 1600
*** HOLE CARDS ***
Dealt to JJin91 [Jd 4d]
bigpond12: calls 1600
JJin91: folds=20
bulibasav: folds=20
GUUUULP: folds=20
TGfor3: folds=20
TrumpsDong: checks=20
*** FLOP *** [Th 9h As]
TrumpsDong: checks=20
bigpond12: bets 3200
TrumpsDong: folds=20
Uncalled bet (3200) returned to bigpond12
bigpond12 collected 5200 from pot
bigpond12: doesn't show hand=20
*** SUMMARY ***
Total pot 5200 | Rake 0=20
Board [Th 9h As]
Seat 1: bulibasav folded before Flop (didn't bet)
Seat 3: GUUUULP (button) folded before Flop (didn't bet)
Seat 4: TGfor3 (small blind) folded before Flop
Seat 5: TrumpsDong (big blind) folded on the Flop
Seat 6: bigpond12 collected (5200)
Seat 7: JJin91 folded before Flop (didn't bet)


*********** # 202 **************
PokerStars Hand #171488031459: Tournament #1648956629, $18.20+$1.80 USD=
 Hold'em No Limit - Level XIX (1000/2000) - 2017/06/20 22:17:34 ET
Table '1648956629 6' 9-max Seat #4 is the button
Seat 1: bulibasav (37550 in chips)=20
Seat 3: GUUUULP (33689 in chips)=20
Seat 4: TGfor3 (31192 in chips)=20
Seat 5: TrumpsDong (24830 in chips)=20
Seat 6: bigpond12 (185737 in chips)=20
Seat 7: JJin91 (116085 in chips)=20
bulibasav: posts the ante 250
GUUUULP: posts the ante 250
TGfor3: posts the ante 250
TrumpsDong: posts the ante 250
bigpond12: posts the ante 250
JJin91: posts the ante 250
TrumpsDong: posts small blind 1000
bigpond12: posts big blind 2000
*** HOLE CARDS ***
Dealt to JJin91 [Kh 2c]
JJin91: folds=20
bulibasav: folds=20
GUUUULP: raises 31439 to 33439 and is all-in
TGfor3: folds=20
TrumpsDong: folds=20
bigpond12: folds=20
Uncalled bet (31439) returned to GUUUULP
GUUUULP collected 6500 from pot
*** SUMMARY ***
Total pot 6500 | Rake 0=20
Seat 1: bulibasav folded before Flop (didn't bet)
Seat 3: GUUUULP collected (6500)
Seat 4: TGfor3 (button) folded before Flop (didn't bet)
Seat 5: TrumpsDong (small blind) folded before Flop
Seat 6: bigpond12 (big blind) folded before Flop
Seat 7: JJin91 folded before Flop (didn't bet)


*********** # 203 **************
PokerStars Hand #171488031522: Tournament #1648956629, $18.20+$1.80 USD=
 Hold'em No Limit - Level XIX (1000/2000) - 2017/06/20 22:17:48 ET
Table '1648956629 6' 9-max Seat #5 is the button
Seat 1: bulibasav (37300 in chips)=20
Seat 3: GUUUULP (37939 in chips)=20
Seat 4: TGfor3 (30942 in chips)=20
Seat 5: TrumpsDong (23580 in chips)=20
Seat 6: bigpond12 (183487 in chips)=20
Seat 7: JJin91 (115835 in chips)=20
bulibasav: posts the ante 250
GUUUULP: posts the ante 250
TGfor3: posts the ante 250
TrumpsDong: posts the ante 250
bigpond12: posts the ante 250
JJin91: posts the ante 250
bigpond12: posts small blind 1000
JJin91: posts big blind 2000
*** HOLE CARDS ***
Dealt to JJin91 [8h 5h]
bulibasav: calls 2000
GUUUULP: folds=20
TGfor3: folds=20
TrumpsDong: folds=20
bigpond12: folds=20
JJin91: raises 113585 to 115585 and is all-in
bulibasav: folds=20
Uncalled bet (113585) returned to JJin91
JJin91 collected 6500 from pot
JJin91: doesn't show hand=20
*** SUMMARY ***
Total pot 6500 | Rake 0=20
Seat 1: bulibasav folded before Flop
Seat 3: GUUUULP folded before Flop (didn't bet)
Seat 4: TGfor3 folded before Flop (didn't bet)
Seat 5: TrumpsDong (button) folded before Flop (didn't bet)
Seat 6: bigpond12 (small blind) folded before Flop
Seat 7: JJin91 (big blind) collected (6500)


*********** # 204 **************
PokerStars Hand #171488031707: Tournament #1648956629, $18.20+$1.80 USD=
 Hold'em No Limit - Level XIX (1000/2000) - 2017/06/20 22:18:28 ET
Table '1648956629 6' 9-max Seat #6 is the button
Seat 1: bulibasav (35050 in chips)=20
Seat 3: GUUUULP (37689 in chips)=20
Seat 4: TGfor3 (30692 in chips)=20
Seat 5: TrumpsDong (23330 in chips)=20
Seat 6: bigpond12 (182237 in chips)=20
Seat 7: JJin91 (120085 in chips)=20
bulibasav: posts the ante 250
GUUUULP: posts the ante 250
TGfor3: posts the ante 250
TrumpsDong: posts the ante 250
bigpond12: posts the ante 250
JJin91: posts the ante 250
JJin91: posts small blind 1000
bulibasav: posts big blind 2000
*** HOLE CARDS ***
Dealt to JJin91 [7d Ks]
GUUUULP: folds=20
TGfor3: folds=20
TrumpsDong: folds=20
bigpond12 has timed out
bigpond12: folds=20
bigpond12 is sitting out
JJin91: raises 117835 to 119835 and is all-in
bulibasav: folds=20
Uncalled bet (117835) returned to JJin91
JJin91 collected 5500 from pot
JJin91: doesn't show hand=20
*** SUMMARY ***
Total pot 5500 | Rake 0=20
Seat 1: bulibasav (big blind) folded before Flop
Seat 3: GUUUULP folded before Flop (didn't bet)
Seat 4: TGfor3 folded before Flop (didn't bet)
Seat 5: TrumpsDong folded before Flop (didn't bet)
Seat 6: bigpond12 (button) folded before Flop (didn't bet)
Seat 7: JJin91 (small blind) collected (5500)


*********** # 205 **************
PokerStars Hand #171488031967: Tournament #1648956629, $18.20+$1.80 USD=
 Hold'em No Limit - Level XIX (1000/2000) - 2017/06/20 22:19:20 ET
Table '1648956629 6' 9-max Seat #7 is the button
Seat 1: bulibasav (32800 in chips)=20
Seat 3: GUUUULP (37439 in chips)=20
Seat 4: TGfor3 (30442 in chips)=20
Seat 5: TrumpsDong (23080 in chips)=20
Seat 6: bigpond12 (181987 in chips) is sitting out
Seat 7: JJin91 (123335 in chips)=20
bulibasav: posts the ante 250
GUUUULP: posts the ante 250
TGfor3: posts the ante 250
TrumpsDong: posts the ante 250
bigpond12: posts the ante 250
JJin91: posts the ante 250
bulibasav: posts small blind 1000
GUUUULP: posts big blind 2000
*** HOLE CARDS ***
Dealt to JJin91 [2h Qh]
TGfor3: folds=20
TrumpsDong: folds=20
bigpond12: folds=20
JJin91: folds=20
bulibasav: folds=20
Uncalled bet (1000) returned to GUUUULP
GUUUULP collected 3500 from pot
*** SUMMARY ***
Total pot 3500 | Rake 0=20
Seat 1: bulibasav (small blind) folded before Flop
Seat 3: GUUUULP (big blind) collected (3500)
Seat 4: TGfor3 folded before Flop (didn't bet)
Seat 5: TrumpsDong folded before Flop (didn't bet)
Seat 6: bigpond12 folded before Flop (didn't bet)
Seat 7: JJin91 (button) folded before Flop (didn't bet)


*********** # 206 **************
PokerStars Hand #171488032065: Tournament #1648956629, $18.20+$1.80 USD=
 Hold'em No Limit - Level XIX (1000/2000) - 2017/06/20 22:19:41 ET
Table '1648956629 6' 9-max Seat #1 is the button
Seat 1: bulibasav (31550 in chips)=20
Seat 3: GUUUULP (39689 in chips)=20
Seat 4: TGfor3 (30192 in chips)=20
Seat 5: TrumpsDong (22830 in chips)=20
Seat 6: bigpond12 (181737 in chips) is sitting out
Seat 7: JJin91 (123085 in chips)=20
bulibasav: posts the ante 250
GUUUULP: posts the ante 250
TGfor3: posts the ante 250
TrumpsDong: posts the ante 250
bigpond12: posts the ante 250
JJin91: posts the ante 250
GUUUULP: posts small blind 1000
TGfor3: posts big blind 2000
*** HOLE CARDS ***
Dealt to JJin91 [4s 5h]
TrumpsDong: folds=20
bigpond12: folds=20
JJin91: folds=20
bulibasav: folds=20
GUUUULP: raises 37439 to 39439 and is all-in
TGfor3: folds=20
Uncalled bet (37439) returned to GUUUULP
GUUUULP collected 5500 from pot
GUUUULP: doesn't show hand=20
*** SUMMARY ***
Total pot 5500 | Rake 0=20
Seat 1: bulibasav (button) folded before Flop (didn't bet)
Seat 3: GUUUULP (small blind) collected (5500)
Seat 4: TGfor3 (big blind) folded before Flop
Seat 5: TrumpsDong folded before Flop (didn't bet)
Seat 6: bigpond12 folded before Flop (didn't bet)
Seat 7: JJin91 folded before Flop (didn't bet)


*********** # 207 **************
PokerStars Hand #171488032237: Tournament #1648956629, $18.20+$1.80 USD=
 Hold'em No Limit - Level XIX (1000/2000) - 2017/06/20 22:20:16 ET
Table '1648956629 6' 9-max Seat #3 is the button
Seat 1: bulibasav (31300 in chips)=20
Seat 3: GUUUULP (42939 in chips)=20
Seat 4: TGfor3 (27942 in chips)=20
Seat 5: TrumpsDong (22580 in chips)=20
Seat 6: bigpond12 (181487 in chips) is sitting out
Seat 7: JJin91 (122835 in chips)=20
bulibasav: posts the ante 250
GUUUULP: posts the ante 250
TGfor3: posts the ante 250
TrumpsDong: posts the ante 250
bigpond12: posts the ante 250
JJin91: posts the ante 250
TGfor3: posts small blind 1000
TrumpsDong: posts big blind 2000
*** HOLE CARDS ***
Dealt to JJin91 [Ah 7d]
bigpond12: folds=20
JJin91: raises 2380 to 4380
bulibasav: folds=20
GUUUULP: raises 38309 to 42689 and is all-in
TGfor3: folds=20
TrumpsDong: folds=20
JJin91: folds=20
Uncalled bet (38309) returned to GUUUULP
GUUUULP collected 13260 from pot
*** SUMMARY ***
Total pot 13260 | Rake 0=20
Seat 1: bulibasav folded before Flop (didn't bet)
Seat 3: GUUUULP (button) collected (13260)
Seat 4: TGfor3 (small blind) folded before Flop
Seat 5: TrumpsDong (big blind) folded before Flop
Seat 6: bigpond12 folded before Flop (didn't bet)
Seat 7: JJin91 folded before Flop


*********** # 208 **************
PokerStars Hand #171488032379: Tournament #1648956629, $18.20+$1.80 USD=
 Hold'em No Limit - Level XIX (1000/2000) - 2017/06/20 22:20:46 ET
Table '1648956629 6' 9-max Seat #4 is the button
Seat 1: bulibasav (31050 in chips)=20
Seat 3: GUUUULP (51569 in chips)=20
Seat 4: TGfor3 (26692 in chips)=20
Seat 5: TrumpsDong (20330 in chips)=20
Seat 6: bigpond12 (181237 in chips) is sitting out
Seat 7: JJin91 (118205 in chips)=20
bulibasav: posts the ante 250
GUUUULP: posts the ante 250
TGfor3: posts the ante 250
TrumpsDong: posts the ante 250
bigpond12: posts the ante 250
JJin91: posts the ante 250
TrumpsDong: posts small blind 1000
bigpond12: posts big blind 2000
*** HOLE CARDS ***
Dealt to JJin91 [4d 4s]
JJin91: raises 3140 to 5140
bulibasav: folds=20
bigpond12 has returned
GUUUULP: folds=20
TGfor3: folds=20
TrumpsDong: folds=20
bigpond12: calls 3140
*** FLOP *** [5h Ah Kc]
bigpond12: checks=20
JJin91: bets 4729
bigpond12: calls 4729
*** TURN *** [5h Ah Kc] [As]
bigpond12: checks=20
JJin91: checks=20
*** RIVER *** [5h Ah Kc As] [2h]
bigpond12: checks=20
JJin91: checks=20
*** SHOW DOWN ***
bigpond12: shows [6d 5s] (two pair, Aces and Fives)
JJin91: mucks hand=20
bigpond12 collected 22238 from pot
*** SUMMARY ***
Total pot 22238 | Rake 0=20
Board [5h Ah Kc As 2h]
Seat 1: bulibasav folded before Flop (didn't bet)
Seat 3: GUUUULP folded before Flop (didn't bet)
Seat 4: TGfor3 (button) folded before Flop (didn't bet)
Seat 5: TrumpsDong (small blind) folded before Flop
Seat 6: bigpond12 (big blind) showed [6d 5s] and won (22238) with two p=
air, Aces and Fives
Seat 7: JJin91 mucked [4d 4s]


*********** # 209 **************
PokerStars Hand #171488032666: Tournament #1648956629, $18.20+$1.80 USD=
 Hold'em No Limit - Level XIX (1000/2000) - 2017/06/20 22:21:41 ET
Table '1648956629 6' 9-max Seat #5 is the button
Seat 1: bulibasav (30800 in chips)=20
Seat 3: GUUUULP (51319 in chips)=20
Seat 4: TGfor3 (26442 in chips)=20
Seat 5: TrumpsDong (19080 in chips)=20
Seat 6: bigpond12 (193356 in chips)=20
Seat 7: JJin91 (108086 in chips)=20
bulibasav: posts the ante 250
GUUUULP: posts the ante 250
TGfor3: posts the ante 250
TrumpsDong: posts the ante 250
bigpond12: posts the ante 250
JJin91: posts the ante 250
bigpond12: posts small blind 1000
JJin91: posts big blind 2000
*** HOLE CARDS ***
Dealt to JJin91 [4c 2h]
bulibasav: folds=20
GUUUULP: raises 2420 to 4420
TGfor3: folds=20
TrumpsDong: folds=20
bigpond12: folds=20
JJin91: folds=20
Uncalled bet (2420) returned to GUUUULP
GUUUULP collected 6500 from pot
*** SUMMARY ***
Total pot 6500 | Rake 0=20
Seat 1: bulibasav folded before Flop (didn't bet)
Seat 3: GUUUULP collected (6500)
Seat 4: TGfor3 folded before Flop (didn't bet)
Seat 5: TrumpsDong (button) folded before Flop (didn't bet)
Seat 6: bigpond12 (small blind) folded before Flop
Seat 7: JJin91 (big blind) folded before Flop


*********** # 210 **************
PokerStars Hand #171488032748: Tournament #1648956629, $18.20+$1.80 USD=
 Hold'em No Limit - Level XIX (1000/2000) - 2017/06/20 22:21:59 ET
Table '1648956629 6' 9-max Seat #6 is the button
Seat 1: bulibasav (30550 in chips)=20
Seat 3: GUUUULP (55569 in chips)=20
Seat 4: TGfor3 (26192 in chips)=20
Seat 5: TrumpsDong (18830 in chips)=20
Seat 6: bigpond12 (192106 in chips)=20
Seat 7: JJin91 (105836 in chips)=20
bulibasav: posts the ante 250
GUUUULP: posts the ante 250
TGfor3: posts the ante 250
TrumpsDong: posts the ante 250
bigpond12: posts the ante 250
JJin91: posts the ante 250
JJin91: posts small blind 1000
bulibasav: posts big blind 2000
*** HOLE CARDS ***
Dealt to JJin91 [Td 2h]
GUUUULP: folds=20
TGfor3: folds=20
TrumpsDong: raises 16580 to 18580 and is all-in
bigpond12: folds=20
JJin91: folds=20
bulibasav: folds=20
Uncalled bet (16580) returned to TrumpsDong
TrumpsDong collected 6500 from pot
TrumpsDong: doesn't show hand=20
*** SUMMARY ***
Total pot 6500 | Rake 0=20
Seat 1: bulibasav (big blind) folded before Flop
Seat 3: GUUUULP folded before Flop (didn't bet)
Seat 4: TGfor3 folded before Flop (didn't bet)
Seat 5: TrumpsDong collected (6500)
Seat 6: bigpond12 (button) folded before Flop (didn't bet)
Seat 7: JJin91 (small blind) folded before Flop


*********** # 211 **************
PokerStars Hand #171488032868: Tournament #1648956629, $18.20+$1.80 USD=
 Hold'em No Limit - Level XIX (1000/2000) - 2017/06/20 22:22:25 ET
Table '1648956629 6' 9-max Seat #7 is the button
Seat 1: bulibasav (28300 in chips)=20
Seat 3: GUUUULP (55319 in chips)=20
Seat 4: TGfor3 (25942 in chips)=20
Seat 5: TrumpsDong (23080 in chips)=20
Seat 6: bigpond12 (191856 in chips)=20
Seat 7: JJin91 (104586 in chips)=20
bulibasav: posts the ante 250
GUUUULP: posts the ante 250
TGfor3: posts the ante 250
TrumpsDong: posts the ante 250
bigpond12: posts the ante 250
JJin91: posts the ante 250
bulibasav: posts small blind 1000
GUUUULP: posts big blind 2000
*** HOLE CARDS ***
Dealt to JJin91 [6h 4d]
TGfor3: folds=20
TrumpsDong: raises 20830 to 22830 and is all-in
bigpond12 has timed out
bigpond12: folds=20
bigpond12 is sitting out
JJin91: folds=20
bulibasav: folds=20
GUUUULP: folds=20
Uncalled bet (20830) returned to TrumpsDong
TrumpsDong collected 6500 from pot
TrumpsDong: doesn't show hand=20
*** SUMMARY ***
Total pot 6500 | Rake 0=20
Seat 1: bulibasav (small blind) folded before Flop
Seat 3: GUUUULP (big blind) folded before Flop
Seat 4: TGfor3 folded before Flop (didn't bet)
Seat 5: TrumpsDong collected (6500)
Seat 6: bigpond12 folded before Flop (didn't bet)
Seat 7: JJin91 (button) folded before Flop (didn't bet)


*********** # 212 **************
PokerStars Hand #171488033056: Tournament #1648956629, $18.20+$1.80 USD=
 Hold'em No Limit - Level XIX (1000/2000) - 2017/06/20 22:23:02 ET
Table '1648956629 6' 9-max Seat #1 is the button
Seat 1: bulibasav (27050 in chips)=20
Seat 3: GUUUULP (53069 in chips)=20
Seat 4: TGfor3 (25692 in chips)=20
Seat 5: TrumpsDong (27330 in chips)=20
Seat 6: bigpond12 (191606 in chips) is sitting out
Seat 7: JJin91 (104336 in chips)=20
bulibasav: posts the ante 250
GUUUULP: posts the ante 250
TGfor3: posts the ante 250
TrumpsDong: posts the ante 250
bigpond12: posts the ante 250
JJin91: posts the ante 250
GUUUULP: posts small blind 1000
TGfor3: posts big blind 2000
*** HOLE CARDS ***
Dealt to JJin91 [Kh 2h]
bigpond12 has returned
TrumpsDong: folds=20
bigpond12: calls 2000
JJin91: folds=20
bulibasav: folds=20
GUUUULP: calls 1000
TGfor3: raises 23442 to 25442 and is all-in
bigpond12: folds=20
GUUUULP: folds=20
Uncalled bet (23442) returned to TGfor3
TGfor3 collected 7500 from pot
TGfor3: doesn't show hand=20
*** SUMMARY ***
Total pot 7500 | Rake 0=20
Seat 1: bulibasav (button) folded before Flop (didn't bet)
Seat 3: GUUUULP (small blind) folded before Flop
Seat 4: TGfor3 (big blind) collected (7500)
Seat 5: TrumpsDong folded before Flop (didn't bet)
Seat 6: bigpond12 folded before Flop
Seat 7: JJin91 folded before Flop (didn't bet)


*********** # 213 **************
PokerStars Hand #171488033182: Tournament #1648956629, $18.20+$1.80 USD=
 Hold'em No Limit - Level XIX (1000/2000) - 2017/06/20 22:23:29 ET
Table '1648956629 6' 9-max Seat #3 is the button
Seat 1: bulibasav (26800 in chips)=20
Seat 3: GUUUULP (50819 in chips)=20
Seat 4: TGfor3 (30942 in chips)=20
Seat 5: TrumpsDong (27080 in chips)=20
Seat 6: bigpond12 (189356 in chips)=20
Seat 7: JJin91 (104086 in chips)=20
bulibasav: posts the ante 250
GUUUULP: posts the ante 250
TGfor3: posts the ante 250
TrumpsDong: posts the ante 250
bigpond12: posts the ante 250
JJin91: posts the ante 250
TGfor3: posts small blind 1000
TrumpsDong: posts big blind 2000
*** HOLE CARDS ***
Dealt to JJin91 [9h 3c]
bigpond12: folds=20
JJin91: folds=20
bulibasav: raises 24550 to 26550 and is all-in
GUUUULP: folds=20
TGfor3: folds=20
TrumpsDong: folds=20
Uncalled bet (24550) returned to bulibasav
bulibasav collected 6500 from pot
bulibasav: doesn't show hand=20
*** SUMMARY ***
Total pot 6500 | Rake 0=20
Seat 1: bulibasav collected (6500)
Seat 3: GUUUULP (button) folded before Flop (didn't bet)
Seat 4: TGfor3 (small blind) folded before Flop
Seat 5: TrumpsDong (big blind) folded before Flop
Seat 6: bigpond12 folded before Flop (didn't bet)
Seat 7: JJin91 folded before Flop (didn't bet)


*********** # 214 **************
PokerStars Hand #171488033289: Tournament #1648956629, $18.20+$1.80 USD=
 Hold'em No Limit - Level XIX (1000/2000) - 2017/06/20 22:23:52 ET
Table '1648956629 6' 9-max Seat #4 is the button
Seat 1: bulibasav (31050 in chips)=20
Seat 3: GUUUULP (50569 in chips)=20
Seat 4: TGfor3 (29692 in chips)=20
Seat 5: TrumpsDong (24830 in chips)=20
Seat 6: bigpond12 (189106 in chips)=20
Seat 7: JJin91 (103836 in chips)=20
bulibasav: posts the ante 250
GUUUULP: posts the ante 250
TGfor3: posts the ante 250
TrumpsDong: posts the ante 250
bigpond12: posts the ante 250
JJin91: posts the ante 250
TrumpsDong: posts small blind 1000
bigpond12: posts big blind 2000
*** HOLE CARDS ***
Dealt to JJin91 [5h 2h]
JJin91: folds=20
bulibasav: folds=20
GUUUULP: folds=20
TGfor3: folds=20
TrumpsDong: raises 22580 to 24580 and is all-in
bigpond12: calls 22580
*** FLOP *** [2c Tc Qh]
*** TURN *** [2c Tc Qh] [6s]
*** RIVER *** [2c Tc Qh 6s] [Ah]
*** SHOW DOWN ***
TrumpsDong: shows [Kd 9s] (high card Ace)
bigpond12: shows [6d As] (two pair, Aces and Sixes)
bigpond12 collected 50660 from pot
TrumpsDong finished the tournament in 13th place and received $36.69.
*** SUMMARY ***
Total pot 50660 | Rake 0=20
Board [2c Tc Qh 6s Ah]
Seat 1: bulibasav folded before Flop (didn't bet)
Seat 3: GUUUULP folded before Flop (didn't bet)
Seat 4: TGfor3 (button) folded before Flop (didn't bet)
Seat 5: TrumpsDong (small blind) showed [Kd 9s] and lost with high card=
 Ace
Seat 6: bigpond12 (big blind) showed [6d As] and won (50660) with two p=
air, Aces and Sixes
Seat 7: JJin91 folded before Flop (didn't bet)


*********** # 215 **************
PokerStars Hand #171488033416: Tournament #1648956629, $18.20+$1.80 USD=
 Hold'em No Limit - Level XIX (1000/2000) - 2017/06/20 22:24:18 ET
Table '1648956629 6' 9-max Seat #6 is the button
Seat 1: bulibasav (30800 in chips)=20
Seat 3: GUUUULP (50319 in chips)=20
Seat 4: TGfor3 (29442 in chips)=20
Seat 6: bigpond12 (214936 in chips)=20
Seat 7: JJin91 (103586 in chips)=20
bulibasav: posts the ante 250
GUUUULP: posts the ante 250
TGfor3: posts the ante 250
bigpond12: posts the ante 250
JJin91: posts the ante 250
JJin91: posts small blind 1000
bulibasav: posts big blind 2000
*** HOLE CARDS ***
Dealt to JJin91 [Ah 7d]
GUUUULP: folds=20
TGfor3: folds=20
bigpond12: folds=20
JJin91: raises 101336 to 103336 and is all-in
bulibasav: calls 28550 and is all-in
Uncalled bet (72786) returned to JJin91
*** FLOP *** [9c 4s 3c]
*** TURN *** [9c 4s 3c] [Jc]
*** RIVER *** [9c 4s 3c Jc] [2d]
*** SHOW DOWN ***
JJin91: shows [Ah 7d] (high card Ace)
bulibasav: shows [Ac 2c] (a flush, Ace high)
bulibasav collected 62350 from pot
*** SUMMARY ***
Total pot 62350 | Rake 0=20
Board [9c 4s 3c Jc 2d]
Seat 1: bulibasav (big blind) showed [Ac 2c] and won (62350) with a flu=
sh, Ace high
Seat 3: GUUUULP folded before Flop (didn't bet)
Seat 4: TGfor3 folded before Flop (didn't bet)
Seat 6: bigpond12 (button) folded before Flop (didn't bet)
Seat 7: JJin91 (small blind) showed [Ah 7d] and lost with high card Ace


*********** # 216 **************
PokerStars Hand #171488033517: Tournament #1648956629, $18.20+$1.80 USD=
 Hold'em No Limit - Level XIX (1000/2000) - 2017/06/20 22:24:40 ET
Table '1648956629 6' 9-max Seat #7 is the button
Seat 1: bulibasav (62350 in chips)=20
Seat 2: zBeanHeaDz (104181 in chips)=20
Seat 3: GUUUULP (50069 in chips)=20
Seat 4: TGfor3 (29192 in chips)=20
Seat 6: bigpond12 (214686 in chips)=20
Seat 7: JJin91 (72786 in chips)=20
bulibasav: posts the ante 250
zBeanHeaDz: posts the ante 250
GUUUULP: posts the ante 250
TGfor3: posts the ante 250
bigpond12: posts the ante 250
JJin91: posts the ante 250
bulibasav: posts small blind 1000
zBeanHeaDz: posts big blind 2000
*** HOLE CARDS ***
Dealt to JJin91 [9d 6d]
GUUUULP: folds=20
TGfor3: folds=20
bigpond12: calls 2000
JJin91: folds=20
bulibasav: calls 1000
zBeanHeaDz: checks=20
*** FLOP *** [3c Th 7c]
bulibasav: checks=20
zBeanHeaDz: bets 2850
bigpond12: calls 2850
bulibasav: calls 2850
*** TURN *** [3c Th 7c] [Ts]
bulibasav: checks=20
zBeanHeaDz: checks=20
bigpond12: checks=20
*** RIVER *** [3c Th 7c Ts] [3s]
bulibasav: checks=20
zBeanHeaDz: checks=20
bigpond12: checks=20
*** SHOW DOWN ***
bulibasav: shows [8h Jd] (two pair, Tens and Threes)
zBeanHeaDz: mucks hand=20
bigpond12: shows [4c Ac] (two pair, Tens and Threes - Ace kicker)
bigpond12 collected 16050 from pot
*** SUMMARY ***
Total pot 16050 | Rake 0=20
Board [3c Th 7c Ts 3s]
Seat 1: bulibasav (small blind) showed [8h Jd] and lost with two pair, =
Tens and Threes
Seat 2: zBeanHeaDz (big blind) mucked [6c 5d]
Seat 3: GUUUULP folded before Flop (didn't bet)
Seat 4: TGfor3 folded before Flop (didn't bet)
Seat 6: bigpond12 showed [4c Ac] and won (16050) with two pair, Tens an=
d Threes
Seat 7: JJin91 (button) folded before Flop (didn't bet)


*********** # 217 **************
PokerStars Hand #171488033745: Tournament #1648956629, $18.20+$1.80 USD=
 Hold'em No Limit - Level XIX (1000/2000) - 2017/06/20 22:25:37 ET
Table '1648956629 6' 9-max Seat #1 is the button
Seat 1: bulibasav (57250 in chips)=20
Seat 2: zBeanHeaDz (99081 in chips)=20
Seat 3: GUUUULP (49819 in chips)=20
Seat 4: TGfor3 (28942 in chips)=20
Seat 6: bigpond12 (225636 in chips)=20
Seat 7: JJin91 (72536 in chips)=20
bulibasav: posts the ante 250
zBeanHeaDz: posts the ante 250
GUUUULP: posts the ante 250
TGfor3: posts the ante 250
bigpond12: posts the ante 250
JJin91: posts the ante 250
zBeanHeaDz: posts small blind 1000
GUUUULP: posts big blind 2000
*** HOLE CARDS ***
Dealt to JJin91 [8h 8c]
TGfor3: raises 26692 to 28692 and is all-in
bigpond12: folds=20
JJin91: calls 28692
bulibasav: folds=20
zBeanHeaDz: folds=20
GUUUULP: folds=20
*** FLOP *** [6d Js 9s]
*** TURN *** [6d Js 9s] [3c]
*** RIVER *** [6d Js 9s 3c] [4d]
*** SHOW DOWN ***
TGfor3: shows [7s 8s] (high card Jack)
JJin91: shows [8h 8c] (a pair of Eights)
JJin91 collected 61884 from pot
TGfor3 finished the tournament in 12th place and received $41.93.
*** SUMMARY ***
Total pot 61884 | Rake 0=20
Board [6d Js 9s 3c 4d]
Seat 1: bulibasav (button) folded before Flop (didn't bet)
Seat 2: zBeanHeaDz (small blind) folded before Flop
Seat 3: GUUUULP (big blind) folded before Flop
Seat 4: TGfor3 showed [7s 8s] and lost with high card Jack
Seat 6: bigpond12 folded before Flop (didn't bet)
Seat 7: JJin91 showed [8h 8c] and won (61884) with a pair of Eights


*********** # 218 **************
PokerStars Hand #171488033902: Tournament #1648956629, $18.20+$1.80 USD=
 Hold'em No Limit - Level XIX (1000/2000) - 2017/06/20 22:26:16 ET
Table '1648956629 6' 9-max Seat #2 is the button
Seat 1: bulibasav (57000 in chips)=20
Seat 2: zBeanHeaDz (97831 in chips)=20
Seat 3: GUUUULP (47569 in chips)=20
Seat 6: bigpond12 (225386 in chips)=20
Seat 7: JJin91 (105478 in chips)=20
bulibasav: posts the ante 250
zBeanHeaDz: posts the ante 250
GUUUULP: posts the ante 250
bigpond12: posts the ante 250
JJin91: posts the ante 250
GUUUULP: posts small blind 1000
bigpond12: posts big blind 2000
*** HOLE CARDS ***
Dealt to JJin91 [5c Qd]
JJin91: folds=20
bulibasav: folds=20
zBeanHeaDz: folds=20
GUUUULP: calls 1000
bigpond12: checks=20
*** FLOP *** [Kh 9c 4h]
GUUUULP: bets 2310
bigpond12: calls 2310
*** TURN *** [Kh 9c 4h] [Qh]
GUUUULP: checks=20
bigpond12: bets 4000
GUUUULP: folds=20
Uncalled bet (4000) returned to bigpond12
bigpond12 collected 9870 from pot
bigpond12: doesn't show hand=20
*** SUMMARY ***
Total pot 9870 | Rake 0=20
Board [Kh 9c 4h Qh]
Seat 1: bulibasav folded before Flop (didn't bet)
Seat 2: zBeanHeaDz (button) folded before Flop (didn't bet)
Seat 3: GUUUULP (small blind) folded on the Turn
Seat 6: bigpond12 (big blind) collected (9870)
Seat 7: JJin91 folded before Flop (didn't bet)


*********** # 219 **************
PokerStars Hand #171488034034: Tournament #1648956629, $18.20+$1.80 USD=
 Hold'em No Limit - Level XIX (1000/2000) - 2017/06/20 22:26:46 ET
Table '1648956629 6' 9-max Seat #3 is the button
Seat 1: bulibasav (56750 in chips)=20
Seat 2: zBeanHeaDz (97581 in chips)=20
Seat 3: GUUUULP (43009 in chips)=20
Seat 6: bigpond12 (230696 in chips)=20
Seat 7: JJin91 (105228 in chips)=20
bulibasav: posts the ante 250
zBeanHeaDz: posts the ante 250
GUUUULP: posts the ante 250
bigpond12: posts the ante 250
JJin91: posts the ante 250
bigpond12: posts small blind 1000
JJin91: posts big blind 2000
*** HOLE CARDS ***
Dealt to JJin91 [9s 7d]
bulibasav: raises 2000 to 4000
zBeanHeaDz: folds=20
GUUUULP: folds=20
bigpond12: calls 3000
JJin91: calls 2000
*** FLOP *** [Kh 4s 4c]
bigpond12: checks=20
JJin91: checks=20
bulibasav: checks=20
*** TURN *** [Kh 4s 4c] [2h]
bigpond12: bets 8000
JJin91: folds=20
bulibasav: folds=20
Uncalled bet (8000) returned to bigpond12
bigpond12 collected 13250 from pot
bigpond12: doesn't show hand=20
*** SUMMARY ***
Total pot 13250 | Rake 0=20
Board [Kh 4s 4c 2h]
Seat 1: bulibasav folded on the Turn
Seat 2: zBeanHeaDz folded before Flop (didn't bet)
Seat 3: GUUUULP (button) folded before Flop (didn't bet)
Seat 6: bigpond12 (small blind) collected (13250)
Seat 7: JJin91 (big blind) folded on the Turn


*********** # 220 **************
PokerStars Hand #171488034323: Tournament #1648956629, $18.20+$1.80 USD=
 Hold'em No Limit - Level XX (1250/2500) - 2017/06/20 22:27:45 ET
Table '1648956629 6' 9-max Seat #6 is the button
Seat 1: bulibasav (52500 in chips)=20
Seat 2: zBeanHeaDz (97331 in chips)=20
Seat 3: GUUUULP (42759 in chips)=20
Seat 6: bigpond12 (239696 in chips)=20
Seat 7: JJin91 (100978 in chips)=20
bulibasav: posts the ante 325
zBeanHeaDz: posts the ante 325
GUUUULP: posts the ante 325
bigpond12: posts the ante 325
JJin91: posts the ante 325
JJin91: posts small blind 1250
bulibasav: posts big blind 2500
*** HOLE CARDS ***
Dealt to JJin91 [Qh 2d]
zBeanHeaDz: raises 2800 to 5300
GUUUULP: folds=20
bigpond12: folds=20
JJin91: folds=20
bulibasav: calls 2800
*** FLOP *** [7c Jh Ks]
bulibasav: checks=20
zBeanHeaDz: bets 6603
bulibasav: folds=20
Uncalled bet (6603) returned to zBeanHeaDz
zBeanHeaDz collected 13475 from pot
zBeanHeaDz: doesn't show hand=20
*** SUMMARY ***
Total pot 13475 | Rake 0=20
Board [7c Jh Ks]
Seat 1: bulibasav (big blind) folded on the Flop
Seat 2: zBeanHeaDz collected (13475)
Seat 3: GUUUULP folded before Flop (didn't bet)
Seat 6: bigpond12 (button) folded before Flop (didn't bet)
Seat 7: JJin91 (small blind) folded before Flop


*********** # 221 **************
PokerStars Hand #171488034475: Tournament #1648956629, $18.20+$1.80 USD=
 Hold'em No Limit - Level XX (1250/2500) - 2017/06/20 22:28:17 ET
Table '1648956629 6' 9-max Seat #7 is the button
Seat 1: bulibasav (46875 in chips)=20
Seat 2: zBeanHeaDz (105181 in chips)=20
Seat 3: GUUUULP (42434 in chips)=20
Seat 6: bigpond12 (239371 in chips)=20
Seat 7: JJin91 (99403 in chips)=20
bulibasav: posts the ante 325
zBeanHeaDz: posts the ante 325
GUUUULP: posts the ante 325
bigpond12: posts the ante 325
JJin91: posts the ante 325
bulibasav: posts small blind 1250
zBeanHeaDz: posts big blind 2500
*** HOLE CARDS ***
Dealt to JJin91 [7d 9h]
GUUUULP: folds=20
bigpond12: folds=20
JJin91: folds=20
bulibasav: folds=20
Uncalled bet (1250) returned to zBeanHeaDz
zBeanHeaDz collected 4125 from pot
zBeanHeaDz: doesn't show hand=20
*** SUMMARY ***
Total pot 4125 | Rake 0=20
Seat 1: bulibasav (small blind) folded before Flop
Seat 2: zBeanHeaDz (big blind) collected (4125)
Seat 3: GUUUULP folded before Flop (didn't bet)
Seat 6: bigpond12 folded before Flop (didn't bet)
Seat 7: JJin91 (button) folded before Flop (didn't bet)


*********** # 222 **************
PokerStars Hand #171488034581: Tournament #1648956629, $18.20+$1.80 USD=
 Hold'em No Limit - Level XX (1250/2500) - 2017/06/20 22:28:39 ET
Table '1648956629 6' 9-max Seat #1 is the button
Seat 1: bulibasav (45300 in chips)=20
Seat 2: zBeanHeaDz (107731 in chips)=20
Seat 3: GUUUULP (42109 in chips)=20
Seat 6: bigpond12 (239046 in chips)=20
Seat 7: JJin91 (99078 in chips)=20
bulibasav: posts the ante 325
zBeanHeaDz: posts the ante 325
GUUUULP: posts the ante 325
bigpond12: posts the ante 325
JJin91: posts the ante 325
zBeanHeaDz: posts small blind 1250
GUUUULP: posts big blind 2500
*** HOLE CARDS ***
Dealt to JJin91 [Kd 8s]
bigpond12: calls 2500
JJin91: folds=20
bulibasav: folds=20
zBeanHeaDz: folds=20
GUUUULP: checks=20
*** FLOP *** [Jd 3s Jc]
GUUUULP: checks=20
bigpond12: bets 2500
GUUUULP: calls 2500
*** TURN *** [Jd 3s Jc] [Ks]
GUUUULP: checks=20
bigpond12: bets 7500
GUUUULP: calls 7500
*** RIVER *** [Jd 3s Jc Ks] [3h]
GUUUULP: checks=20
bigpond12: checks=20
*** SHOW DOWN ***
GUUUULP: shows [Jh 5h] (a full house, Jacks full of Threes)
bigpond12: mucks hand=20
GUUUULP collected 27875 from pot
*** SUMMARY ***
Total pot 27875 | Rake 0=20
Board [Jd 3s Jc Ks 3h]
Seat 1: bulibasav (button) folded before Flop (didn't bet)
Seat 2: zBeanHeaDz (small blind) folded before Flop
Seat 3: GUUUULP (big blind) showed [Jh 5h] and won (27875) with a full =
house, Jacks full of Threes
Seat 6: bigpond12 mucked [5d Td]
Seat 7: JJin91 folded before Flop (didn't bet)


*********** # 223 **************
PokerStars Hand #171488034858: Tournament #1648956629, $18.20+$1.80 USD=
 Hold'em No Limit - Level XX (1250/2500) - 2017/06/20 22:29:42 ET
Table '1648956629 6' 9-max Seat #2 is the button
Seat 1: bulibasav (44975 in chips)=20
Seat 2: zBeanHeaDz (106156 in chips)=20
Seat 3: GUUUULP (57159 in chips)=20
Seat 6: bigpond12 (226221 in chips)=20
Seat 7: JJin91 (98753 in chips)=20
bulibasav: posts the ante 325
zBeanHeaDz: posts the ante 325
GUUUULP: posts the ante 325
bigpond12: posts the ante 325
JJin91: posts the ante 325
GUUUULP: posts small blind 1250
bigpond12: posts big blind 2500
*** HOLE CARDS ***
Dealt to JJin91 [3c 2s]
JJin91: folds=20
bulibasav: folds=20
zBeanHeaDz: raises 2800 to 5300
GUUUULP: folds=20
bigpond12: calls 2800
*** FLOP *** [5d 6h As]
bigpond12: checks=20
zBeanHeaDz: bets 5121
bigpond12: calls 5121
*** TURN *** [5d 6h As] [4s]
bigpond12: checks=20
zBeanHeaDz: bets 11621
bigpond12: folds=20
Uncalled bet (11621) returned to zBeanHeaDz
zBeanHeaDz collected 23717 from pot
zBeanHeaDz: doesn't show hand=20
*** SUMMARY ***
Total pot 23717 | Rake 0=20
Board [5d 6h As 4s]
Seat 1: bulibasav folded before Flop (didn't bet)
Seat 2: zBeanHeaDz (button) collected (23717)
Seat 3: GUUUULP (small blind) folded before Flop
Seat 6: bigpond12 (big blind) folded on the Turn
Seat 7: JJin91 folded before Flop (didn't bet)


*********** # 224 **************
PokerStars Hand #171488035067: Tournament #1648956629, $18.20+$1.80 USD=
 Hold'em No Limit - Level XX (1250/2500) - 2017/06/20 22:30:27 ET
Table '1648956629 6' 9-max Seat #3 is the button
Seat 1: bulibasav (44650 in chips)=20
Seat 2: zBeanHeaDz (119127 in chips)=20
Seat 3: GUUUULP (55584 in chips)=20
Seat 6: bigpond12 (215475 in chips)=20
Seat 7: JJin91 (98428 in chips)=20
bulibasav: posts the ante 325
zBeanHeaDz: posts the ante 325
GUUUULP: posts the ante 325
bigpond12: posts the ante 325
JJin91: posts the ante 325
bigpond12: posts small blind 1250
JJin91: posts big blind 2500
*** HOLE CARDS ***
Dealt to JJin91 [2s 7s]
bulibasav: folds=20
zBeanHeaDz: folds=20
GUUUULP: folds=20
bigpond12: folds=20
Uncalled bet (1250) returned to JJin91
JJin91 collected 4125 from pot
JJin91: doesn't show hand=20
*** SUMMARY ***
Total pot 4125 | Rake 0=20
Seat 1: bulibasav folded before Flop (didn't bet)
Seat 2: zBeanHeaDz folded before Flop (didn't bet)
Seat 3: GUUUULP (button) folded before Flop (didn't bet)
Seat 6: bigpond12 (small blind) folded before Flop
Seat 7: JJin91 (big blind) collected (4125)


*********** # 225 **************
PokerStars Hand #171488035113: Tournament #1648956629, $18.20+$1.80 USD=
 Hold'em No Limit - Level XX (1250/2500) - 2017/06/20 22:30:37 ET
Table '1648956629 6' 9-max Seat #6 is the button
Seat 1: bulibasav (44325 in chips)=20
Seat 2: zBeanHeaDz (118802 in chips)=20
Seat 3: GUUUULP (55259 in chips)=20
Seat 6: bigpond12 (213900 in chips)=20
Seat 7: JJin91 (100978 in chips)=20
bulibasav: posts the ante 325
zBeanHeaDz: posts the ante 325
GUUUULP: posts the ante 325
bigpond12: posts the ante 325
JJin91: posts the ante 325
JJin91: posts small blind 1250
bulibasav: posts big blind 2500
*** HOLE CARDS ***
Dealt to JJin91 [9s 8h]
zBeanHeaDz: folds=20
GUUUULP: folds=20
bigpond12: folds=20
JJin91: raises 3925 to 6425
bulibasav: folds=20
Uncalled bet (3925) returned to JJin91
JJin91 collected 6625 from pot
JJin91: doesn't show hand=20
*** SUMMARY ***
Total pot 6625 | Rake 0=20
Seat 1: bulibasav (big blind) folded before Flop
Seat 2: zBeanHeaDz folded before Flop (didn't bet)
Seat 3: GUUUULP folded before Flop (didn't bet)
Seat 6: bigpond12 (button) folded before Flop (didn't bet)
Seat 7: JJin91 (small blind) collected (6625)


*********** # 226 **************
PokerStars Hand #171488035249: Tournament #1648956629, $18.20+$1.80 USD=
 Hold'em No Limit - Level XX (1250/2500) - 2017/06/20 22:31:08 ET
Table '1648956629 6' 9-max Seat #7 is the button
Seat 1: bulibasav (41500 in chips)=20
Seat 2: zBeanHeaDz (118477 in chips)=20
Seat 3: GUUUULP (54934 in chips)=20
Seat 6: bigpond12 (213575 in chips)=20
Seat 7: JJin91 (104778 in chips)=20
bulibasav: posts the ante 325
zBeanHeaDz: posts the ante 325
GUUUULP: posts the ante 325
bigpond12: posts the ante 325
JJin91: posts the ante 325
bulibasav: posts small blind 1250
zBeanHeaDz: posts big blind 2500
*** HOLE CARDS ***
Dealt to JJin91 [Ks 2d]
GUUUULP: folds=20
bigpond12: calls 2500
JJin91: folds=20
bulibasav: folds=20
zBeanHeaDz: checks=20
*** FLOP *** [6c Kh 2c]
zBeanHeaDz: checks=20
bigpond12: bets 2500
zBeanHeaDz: folds=20
Uncalled bet (2500) returned to bigpond12
bigpond12 collected 7875 from pot
bigpond12: doesn't show hand=20
*** SUMMARY ***
Total pot 7875 | Rake 0=20
Board [6c Kh 2c]
Seat 1: bulibasav (small blind) folded before Flop
Seat 2: zBeanHeaDz (big blind) folded on the Flop
Seat 3: GUUUULP folded before Flop (didn't bet)
Seat 6: bigpond12 collected (7875)
Seat 7: JJin91 (button) folded before Flop (didn't bet)


*********** # 227 **************
PokerStars Hand #171488035335: Tournament #1648956629, $18.20+$1.80 USD=
 Hold'em No Limit - Level XX (1250/2500) - 2017/06/20 22:31:27 ET
Table '1648956629 6' 9-max Seat #1 is the button
Seat 1: bulibasav (39925 in chips)=20
Seat 2: zBeanHeaDz (115652 in chips)=20
Seat 3: GUUUULP (54609 in chips)=20
Seat 6: bigpond12 (218625 in chips)=20
Seat 7: JJin91 (104453 in chips)=20
bulibasav: posts the ante 325
zBeanHeaDz: posts the ante 325
GUUUULP: posts the ante 325
bigpond12: posts the ante 325
JJin91: posts the ante 325
zBeanHeaDz: posts small blind 1250
GUUUULP: posts big blind 2500
*** HOLE CARDS ***
Dealt to JJin91 [6h Ts]
bigpond12: calls 2500
JJin91: folds=20
bulibasav: folds=20
zBeanHeaDz: folds=20
GUUUULP: checks=20
*** FLOP *** [7d Jh 4s]
GUUUULP: checks=20
bigpond12: checks=20
*** TURN *** [7d Jh 4s] [9c]
GUUUULP: checks=20
bigpond12: bets 2500
GUUUULP: calls 2500
*** RIVER *** [7d Jh 4s 9c] [3s]
GUUUULP: checks=20
bigpond12: bets 2500
GUUUULP: folds=20
Uncalled bet (2500) returned to bigpond12
bigpond12 collected 12875 from pot
bigpond12: doesn't show hand=20
*** SUMMARY ***
Total pot 12875 | Rake 0=20
Board [7d Jh 4s 9c 3s]
Seat 1: bulibasav (button) folded before Flop (didn't bet)
Seat 2: zBeanHeaDz (small blind) folded before Flop
Seat 3: GUUUULP (big blind) folded on the River
Seat 6: bigpond12 collected (12875)
Seat 7: JJin91 folded before Flop (didn't bet)


*********** # 228 **************
PokerStars Hand #171488035454: Tournament #1648956629, $18.20+$1.80 USD=
 Hold'em No Limit - Level XX (1250/2500) - 2017/06/20 22:31:54 ET
Table '1648956629 6' 9-max Seat #2 is the button
Seat 1: bulibasav (39600 in chips)=20
Seat 2: zBeanHeaDz (114077 in chips)=20
Seat 3: GUUUULP (49284 in chips)=20
Seat 6: bigpond12 (226175 in chips)=20
Seat 7: JJin91 (104128 in chips)=20
bulibasav: posts the ante 325
zBeanHeaDz: posts the ante 325
GUUUULP: posts the ante 325
bigpond12: posts the ante 325
JJin91: posts the ante 325
GUUUULP: posts small blind 1250
bigpond12: posts big blind 2500
*** HOLE CARDS ***
Dealt to JJin91 [Jd Jc]
JJin91: raises 3925 to 6425
bulibasav: folds=20
zBeanHeaDz: folds=20
GUUUULP: folds=20
bigpond12: calls 3925
*** FLOP *** [3c Ad Qc]
bigpond12: checks=20
JJin91: bets 5818
bigpond12: raises 11682 to 17500
JJin91: calls 11682
*** TURN *** [3c Ad Qc] [5h]
bigpond12: bets 50725
JJin91: folds=20
Uncalled bet (50725) returned to bigpond12
bigpond12 collected 50725 from pot
bigpond12: doesn't show hand=20
*** SUMMARY ***
Total pot 50725 | Rake 0=20
Board [3c Ad Qc 5h]
Seat 1: bulibasav folded before Flop (didn't bet)
Seat 2: zBeanHeaDz (button) folded before Flop (didn't bet)
Seat 3: GUUUULP (small blind) folded before Flop
Seat 6: bigpond12 (big blind) collected (50725)
Seat 7: JJin91 folded on the Turn


*********** # 229 **************
PokerStars Hand #171488035678: Tournament #1648956629, $18.20+$1.80 USD=
 Hold'em No Limit - Level XX (1250/2500) - 2017/06/20 22:32:42 ET
Table '1648956629 6' 9-max Seat #3 is the button
Seat 1: bulibasav (39275 in chips)=20
Seat 2: zBeanHeaDz (113752 in chips)=20
Seat 3: GUUUULP (47709 in chips)=20
Seat 6: bigpond12 (252650 in chips)=20
Seat 7: JJin91 (79878 in chips)=20
bulibasav: posts the ante 325
zBeanHeaDz: posts the ante 325
GUUUULP: posts the ante 325
bigpond12: posts the ante 325
JJin91: posts the ante 325
bigpond12: posts small blind 1250
JJin91: posts big blind 2500
*** HOLE CARDS ***
Dealt to JJin91 [Qh Qd]
bulibasav: folds=20
zBeanHeaDz: folds=20
GUUUULP: folds=20
bigpond12: calls 1250
JJin91: raises 6225 to 8725
bigpond12: calls 6225
*** FLOP *** [4d Ts 7s]
bigpond12: checks=20
JJin91: bets 13873
bigpond12: calls 13873
*** TURN *** [4d Ts 7s] [5c]
bigpond12: checks=20
JJin91: checks=20
*** RIVER *** [4d Ts 7s 5c] [2h]
bigpond12: checks=20
JJin91: checks=20
*** SHOW DOWN ***
bigpond12: shows [6d 6h] (a pair of Sixes)
JJin91: shows [Qh Qd] (a pair of Queens)
JJin91 collected 46821 from pot
*** SUMMARY ***
Total pot 46821 | Rake 0=20
Board [4d Ts 7s 5c 2h]
Seat 1: bulibasav folded before Flop (didn't bet)
Seat 2: zBeanHeaDz folded before Flop (didn't bet)
Seat 3: GUUUULP (button) folded before Flop (didn't bet)
Seat 6: bigpond12 (small blind) showed [6d 6h] and lost with a pair of =
Sixes
Seat 7: JJin91 (big blind) showed [Qh Qd] and won (46821) with a pair o=
f Queens


*********** # 230 **************
PokerStars Hand #171488035937: Tournament #1648956629, $18.20+$1.80 USD=
 Hold'em No Limit - Level XX (1250/2500) - 2017/06/20 22:33:38 ET
Table '1648956629 6' 9-max Seat #6 is the button
Seat 1: bulibasav (38950 in chips)=20
Seat 2: zBeanHeaDz (113427 in chips)=20
Seat 3: GUUUULP (47384 in chips)=20
Seat 6: bigpond12 (229727 in chips)=20
Seat 7: JJin91 (103776 in chips)=20
bulibasav: posts the ante 325
zBeanHeaDz: posts the ante 325
GUUUULP: posts the ante 325
bigpond12: posts the ante 325
JJin91: posts the ante 325
JJin91: posts small blind 1250
bulibasav: posts big blind 2500
*** HOLE CARDS ***
Dealt to JJin91 [9d Ad]
zBeanHeaDz: raises 3500 to 6000
GUUUULP: folds=20
bigpond12: calls 6000
JJin91: calls 4750
bulibasav: folds=20
*** FLOP *** [8d 7s Ks]
JJin91: checks=20
zBeanHeaDz: bets 8408
bigpond12: folds=20
JJin91: folds=20
Uncalled bet (8408) returned to zBeanHeaDz
zBeanHeaDz collected 22125 from pot
zBeanHeaDz: doesn't show hand=20
*** SUMMARY ***
Total pot 22125 | Rake 0=20
Board [8d 7s Ks]
Seat 1: bulibasav (big blind) folded before Flop
Seat 2: zBeanHeaDz collected (22125)
Seat 3: GUUUULP folded before Flop (didn't bet)
Seat 6: bigpond12 (button) folded on the Flop
Seat 7: JJin91 (small blind) folded on the Flop


*********** # 231 **************
PokerStars Hand #171488036112: Tournament #1648956629, $18.20+$1.80 USD=
 Hold'em No Limit - Level XX (1250/2500) - 2017/06/20 22:34:13 ET
Table '1648956629 6' 9-max Seat #7 is the button
Seat 1: bulibasav (36125 in chips)=20
Seat 2: zBeanHeaDz (129227 in chips)=20
Seat 3: GUUUULP (47059 in chips)=20
Seat 6: bigpond12 (223402 in chips)=20
Seat 7: JJin91 (97451 in chips)=20
bulibasav: posts the ante 325
zBeanHeaDz: posts the ante 325
GUUUULP: posts the ante 325
bigpond12: posts the ante 325
JJin91: posts the ante 325
bulibasav: posts small blind 1250
zBeanHeaDz: posts big blind 2500
*** HOLE CARDS ***
Dealt to JJin91 [4c 8c]
GUUUULP: folds=20
bigpond12: folds=20
JJin91: folds=20
bulibasav: folds=20
Uncalled bet (1250) returned to zBeanHeaDz
zBeanHeaDz collected 4125 from pot
zBeanHeaDz: doesn't show hand=20
*** SUMMARY ***
Total pot 4125 | Rake 0=20
Seat 1: bulibasav (small blind) folded before Flop
Seat 2: zBeanHeaDz (big blind) collected (4125)
Seat 3: GUUUULP folded before Flop (didn't bet)
Seat 6: bigpond12 folded before Flop (didn't bet)
Seat 7: JJin91 (button) folded before Flop (didn't bet)


*********** # 232 **************
PokerStars Hand #171488036213: Tournament #1648956629, $18.20+$1.80 USD=
 Hold'em No Limit - Level XX (1250/2500) - 2017/06/20 22:34:33 ET
Table '1648956629 6' 9-max Seat #1 is the button
Seat 1: bulibasav (34550 in chips)=20
Seat 2: zBeanHeaDz (131777 in chips)=20
Seat 3: GUUUULP (46734 in chips)=20
Seat 6: bigpond12 (223077 in chips)=20
Seat 7: JJin91 (97126 in chips)=20
bulibasav: posts the ante 325
zBeanHeaDz: posts the ante 325
GUUUULP: posts the ante 325
bigpond12: posts the ante 325
JJin91: posts the ante 325
zBeanHeaDz: posts small blind 1250
GUUUULP: posts big blind 2500
*** HOLE CARDS ***
Dealt to JJin91 [As Ad]
bigpond12: folds=20
JJin91: raises 3925 to 6425
bulibasav: folds=20
zBeanHeaDz: raises 8575 to 15000
GUUUULP: folds=20
JJin91: calls 8575
*** FLOP *** [Qc 2h Jc]
zBeanHeaDz: bets 12968
JJin91: raises 17968 to 30936
zBeanHeaDz: folds=20
Uncalled bet (17968) returned to JJin91
JJin91 collected 60061 from pot
JJin91: doesn't show hand=20
*** SUMMARY ***
Total pot 60061 | Rake 0=20
Board [Qc 2h Jc]
Seat 1: bulibasav (button) folded before Flop (didn't bet)
Seat 2: zBeanHeaDz (small blind) folded on the Flop
Seat 3: GUUUULP (big blind) folded before Flop
Seat 6: bigpond12 folded before Flop (didn't bet)
Seat 7: JJin91 collected (60061)


*********** # 233 **************
PokerStars Hand #171488036530: Tournament #1648956629, $18.20+$1.80 USD=
 Hold'em No Limit - Level XX (1250/2500) - 2017/06/20 22:35:37 ET
Table '1648956629 6' 9-max Seat #2 is the button
Seat 1: bulibasav (34225 in chips)=20
Seat 2: zBeanHeaDz (103484 in chips)=20
Seat 3: GUUUULP (43909 in chips)=20
Seat 6: bigpond12 (222752 in chips)=20
Seat 7: JJin91 (128894 in chips)=20
bulibasav: posts the ante 325
zBeanHeaDz: posts the ante 325
GUUUULP: posts the ante 325
bigpond12: posts the ante 325
JJin91: posts the ante 325
GUUUULP: posts small blind 1250
bigpond12: posts big blind 2500
*** HOLE CARDS ***
Dealt to JJin91 [4d Ts]
JJin91: folds=20
bulibasav: raises 31400 to 33900 and is all-in
zBeanHeaDz: folds=20
GUUUULP: folds=20
bigpond12: folds=20
Uncalled bet (31400) returned to bulibasav
bulibasav collected 7875 from pot
bulibasav: doesn't show hand=20
*** SUMMARY ***
Total pot 7875 | Rake 0=20
Seat 1: bulibasav collected (7875)
Seat 2: zBeanHeaDz (button) folded before Flop (didn't bet)
Seat 3: GUUUULP (small blind) folded before Flop
Seat 6: bigpond12 (big blind) folded before Flop
Seat 7: JJin91 folded before Flop (didn't bet)


*********** # 234 **************
PokerStars Hand #171488036667: Tournament #1648956629, $18.20+$1.80 USD=
 Hold'em No Limit - Level XX (1250/2500) - 2017/06/20 22:36:04 ET
Table '1648956629 6' 9-max Seat #3 is the button
Seat 1: bulibasav (39275 in chips)=20
Seat 2: zBeanHeaDz (103159 in chips)=20
Seat 3: GUUUULP (42334 in chips)=20
Seat 6: bigpond12 (219927 in chips)=20
Seat 7: JJin91 (128569 in chips)=20
bulibasav: posts the ante 325
zBeanHeaDz: posts the ante 325
GUUUULP: posts the ante 325
bigpond12: posts the ante 325
JJin91: posts the ante 325
bigpond12: posts small blind 1250
JJin91: posts big blind 2500
*** HOLE CARDS ***
Dealt to JJin91 [Kh Ks]
bulibasav: calls 2500
zBeanHeaDz: folds=20
GUUUULP: folds=20
bigpond12: folds=20
JJin91: raises 6225 to 8725
bulibasav: folds=20
Uncalled bet (6225) returned to JJin91
JJin91 collected 7875 from pot
JJin91: doesn't show hand=20
*** SUMMARY ***
Total pot 7875 | Rake 0=20
Seat 1: bulibasav folded before Flop
Seat 2: zBeanHeaDz folded before Flop (didn't bet)
Seat 3: GUUUULP (button) folded before Flop (didn't bet)
Seat 6: bigpond12 (small blind) folded before Flop
Seat 7: JJin91 (big blind) collected (7875)


*********** # 235 **************
PokerStars Hand #171488036798: Tournament #1648956629, $18.20+$1.80 USD=
 Hold'em No Limit - Level XX (1250/2500) - 2017/06/20 22:36:35 ET
Table '1648956629 6' 9-max Seat #6 is the button
Seat 1: bulibasav (36450 in chips)=20
Seat 2: zBeanHeaDz (102834 in chips)=20
Seat 3: GUUUULP (42009 in chips)=20
Seat 6: bigpond12 (218352 in chips)=20
Seat 7: JJin91 (133619 in chips)=20
bulibasav: posts the ante 325
zBeanHeaDz: posts the ante 325
GUUUULP: posts the ante 325
bigpond12: posts the ante 325
JJin91: posts the ante 325
JJin91: posts small blind 1250
bulibasav: posts big blind 2500
*** HOLE CARDS ***
Dealt to JJin91 [3d Tc]
zBeanHeaDz: folds=20
GUUUULP: folds=20
bigpond12: folds=20
JJin91: folds=20
Uncalled bet (1250) returned to bulibasav
bulibasav collected 4125 from pot
bulibasav: doesn't show hand=20
*** SUMMARY ***
Total pot 4125 | Rake 0=20
Seat 1: bulibasav (big blind) collected (4125)
Seat 2: zBeanHeaDz folded before Flop (didn't bet)
Seat 3: GUUUULP folded before Flop (didn't bet)
Seat 6: bigpond12 (button) folded before Flop (didn't bet)
Seat 7: JJin91 (small blind) folded before Flop


*********** # 236 **************
PokerStars Hand #171488036857: Tournament #1648956629, $18.20+$1.80 USD=
 Hold'em No Limit - Level XX (1250/2500) - 2017/06/20 22:36:45 ET
Table '1648956629 6' 9-max Seat #7 is the button
Seat 1: bulibasav (39000 in chips)=20
Seat 2: zBeanHeaDz (102509 in chips)=20
Seat 3: GUUUULP (41684 in chips)=20
Seat 6: bigpond12 (218027 in chips)=20
Seat 7: JJin91 (132044 in chips)=20
bulibasav: posts the ante 325
zBeanHeaDz: posts the ante 325
GUUUULP: posts the ante 325
bigpond12: posts the ante 325
JJin91: posts the ante 325
bulibasav: posts small blind 1250
zBeanHeaDz: posts big blind 2500
*** HOLE CARDS ***
Dealt to JJin91 [7s Ks]
GUUUULP: folds=20
bigpond12: calls 2500
JJin91: calls 2500
bulibasav: folds=20
zBeanHeaDz: checks=20
*** FLOP *** [3c 4h 8d]
zBeanHeaDz: checks=20
bigpond12: bets 5000
JJin91: folds=20
zBeanHeaDz: calls 5000
*** TURN *** [3c 4h 8d] [3d]
zBeanHeaDz: checks=20
bigpond12: bets 7500
zBeanHeaDz: calls 7500
*** RIVER *** [3c 4h 8d 3d] [2c]
zBeanHeaDz: checks=20
bigpond12: checks=20
*** SHOW DOWN ***
zBeanHeaDz: shows [8s Qc] (two pair, Eights and Threes)
bigpond12: mucks hand=20
zBeanHeaDz collected 35375 from pot
*** SUMMARY ***
Total pot 35375 | Rake 0=20
Board [3c 4h 8d 3d 2c]
Seat 1: bulibasav (small blind) folded before Flop
Seat 2: zBeanHeaDz (big blind) showed [8s Qc] and won (35375) with two =
pair, Eights and Threes
Seat 3: GUUUULP folded before Flop (didn't bet)
Seat 6: bigpond12 mucked [9s 7d]
Seat 7: JJin91 (button) folded on the Flop


*********** # 237 **************
PokerStars Hand #171488037150: Tournament #1648956629, $18.20+$1.80 USD=
 Hold'em No Limit - Level XXI (1500/3000) - 2017/06/20 22:37:45 ET
Table '1648956629 6' 9-max Seat #1 is the button
Seat 1: bulibasav (37425 in chips)=20
Seat 2: zBeanHeaDz (122559 in chips)=20
Seat 3: GUUUULP (41359 in chips)=20
Seat 6: bigpond12 (202702 in chips)=20
Seat 7: JJin91 (129219 in chips)=20
bulibasav: posts the ante 375
zBeanHeaDz: posts the ante 375
GUUUULP: posts the ante 375
bigpond12: posts the ante 375
JJin91: posts the ante 375
zBeanHeaDz: posts small blind 1500
GUUUULP: posts big blind 3000
*** HOLE CARDS ***
Dealt to JJin91 [Kc 6h]
bigpond12: calls 3000
JJin91: folds=20
bulibasav: calls 3000
zBeanHeaDz: folds=20
GUUUULP: raises 37984 to 40984 and is all-in
bigpond12: folds=20
bulibasav: folds=20
Uncalled bet (37984) returned to GUUUULP
GUUUULP collected 12375 from pot
*** SUMMARY ***
Total pot 12375 | Rake 0=20
Seat 1: bulibasav (button) folded before Flop
Seat 2: zBeanHeaDz (small blind) folded before Flop
Seat 3: GUUUULP (big blind) collected (12375)
Seat 6: bigpond12 folded before Flop
Seat 7: JJin91 folded before Flop (didn't bet)


*********** # 238 **************
PokerStars Hand #171488037239: Tournament #1648956629, $18.20+$1.80 USD=
 Hold'em No Limit - Level XXI (1500/3000) - 2017/06/20 22:38:03 ET
Table '1648956629 6' 9-max Seat #2 is the button
Seat 1: bulibasav (34050 in chips)=20
Seat 2: zBeanHeaDz (120684 in chips)=20
Seat 3: GUUUULP (50359 in chips)=20
Seat 6: bigpond12 (199327 in chips)=20
Seat 7: JJin91 (128844 in chips)=20
bulibasav: posts the ante 375
zBeanHeaDz: posts the ante 375
GUUUULP: posts the ante 375
bigpond12: posts the ante 375
JJin91: posts the ante 375
GUUUULP: posts small blind 1500
bigpond12: posts big blind 3000
*** HOLE CARDS ***
Dealt to JJin91 [2c 9s]
JJin91: folds=20
bulibasav: folds=20
zBeanHeaDz: folds=20
GUUUULP is disconnected=20
GUUUULP has timed out while disconnected
GUUUULP: folds=20
Uncalled bet (1500) returned to bigpond12
GUUUULP is sitting out
bigpond12 collected 4875 from pot
bigpond12: doesn't show hand=20
*** SUMMARY ***
Total pot 4875 | Rake 0=20
Seat 1: bulibasav folded before Flop (didn't bet)
Seat 2: zBeanHeaDz (button) folded before Flop (didn't bet)
Seat 3: GUUUULP (small blind) folded before Flop
Seat 6: bigpond12 (big blind) collected (4875)
Seat 7: JJin91 folded before Flop (didn't bet)


*********** # 239 **************
PokerStars Hand #171488037492: Tournament #1648956629, $18.20+$1.80 USD=
 Hold'em No Limit - Level XXI (1500/3000) - 2017/06/20 22:39:01 ET
Table '1648956629 6' 9-max Seat #3 is the button
Seat 1: bulibasav (33675 in chips)=20
Seat 2: zBeanHeaDz (120309 in chips)=20
Seat 3: GUUUULP (48484 in chips) is sitting out
Seat 6: bigpond12 (202327 in chips)=20
Seat 7: JJin91 (128469 in chips)=20
bulibasav: posts the ante 375
zBeanHeaDz: posts the ante 375
GUUUULP: posts the ante 375
bigpond12: posts the ante 375
JJin91: posts the ante 375
bigpond12: posts small blind 1500
JJin91: posts big blind 3000
*** HOLE CARDS ***
Dealt to JJin91 [Ks 2c]
bulibasav: raises 30300 to 33300 and is all-in
zBeanHeaDz: calls 33300
GUUUULP: folds=20
bigpond12: folds=20
JJin91: folds=20
*** FLOP *** [7s 9s As]
*** TURN *** [7s 9s As] [Kc]
*** RIVER *** [7s 9s As Kc] [6d]
*** SHOW DOWN ***
bulibasav: shows [Ac 4h] (a pair of Aces)
zBeanHeaDz: shows [Qh Ah] (a pair of Aces - King+Queen kicker)
zBeanHeaDz collected 72975 from pot
bulibasav finished the tournament in 11th place and received $41.93.
*** SUMMARY ***
Total pot 72975 | Rake 0=20
Board [7s 9s As Kc 6d]
Seat 1: bulibasav showed [Ac 4h] and lost with a pair of Aces
Seat 2: zBeanHeaDz showed [Qh Ah] and won (72975) with a pair of Aces
Seat 3: GUUUULP (button) folded before Flop (didn't bet)
Seat 6: bigpond12 (small blind) folded before Flop
Seat 7: JJin91 (big blind) folded before Flop


*********** # 240 **************
PokerStars Hand #171488037579: Tournament #1648956629, $18.20+$1.80 USD=
 Hold'em No Limit - Level XXI (1500/3000) - 2017/06/20 22:39:21 ET
Table '1648956629 6' 9-max Seat #6 is the button
Seat 2: zBeanHeaDz (159609 in chips)=20
Seat 3: GUUUULP (48109 in chips) is sitting out
Seat 6: bigpond12 (200452 in chips)=20
Seat 7: JJin91 (125094 in chips)=20
zBeanHeaDz: posts the ante 375
GUUUULP: posts the ante 375
bigpond12: posts the ante 375
JJin91: posts the ante 375
JJin91: posts small blind 1500
zBeanHeaDz: posts big blind 3000
*** HOLE CARDS ***
Dealt to JJin91 [5h 6s]
GUUUULP: folds=20
bigpond12: calls 3000
GUUUULP has returned
JJin91: folds=20
zBeanHeaDz: checks=20
*** FLOP *** [4d 2c As]
zBeanHeaDz: checks=20
bigpond12: bets 6000
zBeanHeaDz: folds=20
Uncalled bet (6000) returned to bigpond12
bigpond12 collected 9000 from pot
bigpond12: doesn't show hand=20
*** SUMMARY ***
Total pot 9000 | Rake 0=20
Board [4d 2c As]
Seat 2: zBeanHeaDz (big blind) folded on the Flop
Seat 3: GUUUULP folded before Flop (didn't bet)
Seat 6: bigpond12 (button) collected (9000)
Seat 7: JJin91 (small blind) folded before Flop


*********** # 241 **************
PokerStars Hand #171488037728: Tournament #1648956629, $18.20+$1.80 USD=
 Hold'em No Limit - Level XXI (1500/3000) - 2017/06/20 22:39:53 ET
Table '1648956629 6' 9-max Seat #7 is the button
Seat 2: zBeanHeaDz (156234 in chips)=20
Seat 3: GUUUULP (47734 in chips)=20
Seat 4: VagColeSlaw (30454 in chips)=20
Seat 6: bigpond12 (206077 in chips)=20
Seat 7: JJin91 (123219 in chips)=20
zBeanHeaDz: posts the ante 375
GUUUULP: posts the ante 375
VagColeSlaw: posts the ante 375
bigpond12: posts the ante 375
JJin91: posts the ante 375
zBeanHeaDz: posts small blind 1500
GUUUULP: posts big blind 3000
*** HOLE CARDS ***
Dealt to JJin91 [8h 4d]
VagColeSlaw: raises 3000 to 6000
bigpond12: folds=20
JJin91: folds=20
zBeanHeaDz: folds=20
GUUUULP: folds=20
Uncalled bet (3000) returned to VagColeSlaw
VagColeSlaw collected 9375 from pot
VagColeSlaw: doesn't show hand=20
*** SUMMARY ***
Total pot 9375 | Rake 0=20
Seat 2: zBeanHeaDz (small blind) folded before Flop
Seat 3: GUUUULP (big blind) folded before Flop
Seat 4: VagColeSlaw collected (9375)
Seat 6: bigpond12 folded before Flop (didn't bet)
Seat 7: JJin91 (button) folded before Flop (didn't bet)


*********** # 242 **************
PokerStars Hand #171488037928: Tournament #1648956629, $18.20+$1.80 USD=
 Hold'em No Limit - Level XXI (1500/3000) - 2017/06/20 22:40:32 ET
Table '1648956629 6' 9-max Seat #2 is the button
Seat 2: zBeanHeaDz (154359 in chips)=20
Seat 3: GUUUULP (44359 in chips)=20
Seat 4: VagColeSlaw (36454 in chips)=20
Seat 6: bigpond12 (205702 in chips)=20
Seat 7: JJin91 (122844 in chips)=20
zBeanHeaDz: posts the ante 375
GUUUULP: posts the ante 375
VagColeSlaw: posts the ante 375
bigpond12: posts the ante 375
JJin91: posts the ante 375
GUUUULP: posts small blind 1500
VagColeSlaw: posts big blind 3000
*** HOLE CARDS ***
Dealt to JJin91 [9c 3d]
bigpond12: calls 3000
JJin91: folds=20
zBeanHeaDz: folds=20
GUUUULP: calls 1500
VagColeSlaw: raises 33079 to 36079 and is all-in
bigpond12: folds=20
GUUUULP has timed out while disconnected
GUUUULP: folds=20
Uncalled bet (33079) returned to VagColeSlaw
GUUUULP is sitting out
VagColeSlaw collected 10875 from pot
VagColeSlaw: doesn't show hand=20
*** SUMMARY ***
Total pot 10875 | Rake 0=20
Seat 2: zBeanHeaDz (button) folded before Flop (didn't bet)
Seat 3: GUUUULP (small blind) folded before Flop
Seat 4: VagColeSlaw (big blind) collected (10875)
Seat 6: bigpond12 folded before Flop
Seat 7: JJin91 folded before Flop (didn't bet)


*********** # 243 **************
PokerStars Hand #171488038171: Tournament #1648956629, $18.20+$1.80 USD=
 Hold'em No Limit - Level XXI (1500/3000) - 2017/06/20 22:41:22 ET
Table '1648956629 6' 9-max Seat #3 is the button
Seat 2: zBeanHeaDz (153984 in chips)=20
Seat 3: GUUUULP (40984 in chips) is sitting out
Seat 4: VagColeSlaw (43954 in chips)=20
Seat 6: bigpond12 (202327 in chips)=20
Seat 7: JJin91 (122469 in chips)=20
zBeanHeaDz: posts the ante 375
GUUUULP: posts the ante 375
VagColeSlaw: posts the ante 375
bigpond12: posts the ante 375
JJin91: posts the ante 375
VagColeSlaw: posts small blind 1500
bigpond12: posts big blind 3000
*** HOLE CARDS ***
Dealt to JJin91 [8h Td]
JJin91: folds=20
zBeanHeaDz: folds=20
GUUUULP: folds=20
VagColeSlaw: folds=20
Uncalled bet (1500) returned to bigpond12
bigpond12 collected 4875 from pot
bigpond12: doesn't show hand=20
*** SUMMARY ***
Total pot 4875 | Rake 0=20
Seat 2: zBeanHeaDz folded before Flop (didn't bet)
Seat 3: GUUUULP (button) folded before Flop (didn't bet)
Seat 4: VagColeSlaw (small blind) folded before Flop
Seat 6: bigpond12 (big blind) collected (4875)
Seat 7: JJin91 folded before Flop (didn't bet)


*********** # 244 **************
PokerStars Hand #171488038254: Tournament #1648956629, $18.20+$1.80 USD=
 Hold'em No Limit - Level XXI (1500/3000) - 2017/06/20 22:41:37 ET
Table '1648956629 6' 9-max Seat #4 is the button
Seat 2: zBeanHeaDz (153609 in chips)=20
Seat 3: GUUUULP (40609 in chips) is sitting out
Seat 4: VagColeSlaw (42079 in chips)=20
Seat 6: bigpond12 (205327 in chips)=20
Seat 7: JJin91 (122094 in chips)=20
zBeanHeaDz: posts the ante 375
GUUUULP: posts the ante 375
VagColeSlaw: posts the ante 375
bigpond12: posts the ante 375
JJin91: posts the ante 375
bigpond12: posts small blind 1500
JJin91: posts big blind 3000
*** HOLE CARDS ***
Dealt to JJin91 [8d 3d]
zBeanHeaDz: raises 4200 to 7200
GUUUULP: folds=20
VagColeSlaw: folds=20
bigpond12: calls 5700
JJin91: calls 4200
*** FLOP *** [Qh 7c 4d]
bigpond12: checks=20
JJin91: bets 13381
zBeanHeaDz: folds=20
bigpond12: folds=20
Uncalled bet (13381) returned to JJin91
JJin91 collected 23475 from pot
JJin91: doesn't show hand=20
*** SUMMARY ***
Total pot 23475 | Rake 0=20
Board [Qh 7c 4d]
Seat 2: zBeanHeaDz folded on the Flop
Seat 3: GUUUULP folded before Flop (didn't bet)
Seat 4: VagColeSlaw (button) folded before Flop (didn't bet)
Seat 6: bigpond12 (small blind) folded on the Flop
Seat 7: JJin91 (big blind) collected (23475)


*********** # 245 **************
PokerStars Hand #171488038453: Tournament #1648956629, $18.20+$1.80 USD=
 Hold'em No Limit - Level XXI (1500/3000) - 2017/06/20 22:42:17 ET
Table '1648956629 6' 9-max Seat #6 is the button
Seat 2: zBeanHeaDz (146034 in chips)=20
Seat 3: GUUUULP (40234 in chips) is sitting out
Seat 4: VagColeSlaw (41704 in chips)=20
Seat 6: bigpond12 (197752 in chips)=20
Seat 7: JJin91 (137994 in chips)=20
zBeanHeaDz: posts the ante 375
GUUUULP: posts the ante 375
VagColeSlaw: posts the ante 375
bigpond12: posts the ante 375
JJin91: posts the ante 375
JJin91: posts small blind 1500
zBeanHeaDz: posts big blind 3000
*** HOLE CARDS ***
Dealt to JJin91 [5s 3d]
GUUUULP: folds=20
VagColeSlaw: folds=20
bigpond12: folds=20
JJin91: folds=20
Uncalled bet (1500) returned to zBeanHeaDz
zBeanHeaDz collected 4875 from pot
zBeanHeaDz: doesn't show hand=20
*** SUMMARY ***
Total pot 4875 | Rake 0=20
Seat 2: zBeanHeaDz (big blind) collected (4875)
Seat 3: GUUUULP folded before Flop (didn't bet)
Seat 4: VagColeSlaw folded before Flop (didn't bet)
Seat 6: bigpond12 (button) folded before Flop (didn't bet)
Seat 7: JJin91 (small blind) folded before Flop


*********** # 246 **************
PokerStars Hand #171488038527: Tournament #1648956629, $18.20+$1.80 USD=
 Hold'em No Limit - Level XXI (1500/3000) - 2017/06/20 22:42:32 ET
Table '1648956629 6' 9-max Seat #7 is the button
Seat 2: zBeanHeaDz (149034 in chips)=20
Seat 3: GUUUULP (39859 in chips) is sitting out
Seat 4: VagColeSlaw (41329 in chips)=20
Seat 6: bigpond12 (197377 in chips)=20
Seat 7: JJin91 (136119 in chips)=20
zBeanHeaDz: posts the ante 375
GUUUULP: posts the ante 375
VagColeSlaw: posts the ante 375
bigpond12: posts the ante 375
JJin91: posts the ante 375
zBeanHeaDz: posts small blind 1500
GUUUULP: posts big blind 3000
*** HOLE CARDS ***
Dealt to JJin91 [3c 8d]
VagColeSlaw: raises 3000 to 6000
bigpond12: folds=20
JJin91: folds=20
zBeanHeaDz: folds=20
GUUUULP: folds=20
Uncalled bet (3000) returned to VagColeSlaw
VagColeSlaw collected 9375 from pot
VagColeSlaw: doesn't show hand=20
*** SUMMARY ***
Total pot 9375 | Rake 0=20
Seat 2: zBeanHeaDz (small blind) folded before Flop
Seat 3: GUUUULP (big blind) folded before Flop
Seat 4: VagColeSlaw collected (9375)
Seat 6: bigpond12 folded before Flop (didn't bet)
Seat 7: JJin91 (button) folded before Flop (didn't bet)


*********** # 247 **************
PokerStars Hand #171488038638: Tournament #1648956629, $18.20+$1.80 USD=
 Hold'em No Limit - Level XXI (1500/3000) - 2017/06/20 22:42:58 ET
Table '1648956629 6' 9-max Seat #2 is the button
Seat 2: zBeanHeaDz (147159 in chips)=20
Seat 3: GUUUULP (36484 in chips) is sitting out
Seat 4: VagColeSlaw (47329 in chips)=20
Seat 6: bigpond12 (197002 in chips)=20
Seat 7: JJin91 (135744 in chips)=20
zBeanHeaDz: posts the ante 375
GUUUULP: posts the ante 375
VagColeSlaw: posts the ante 375
bigpond12: posts the ante 375
JJin91: posts the ante 375
GUUUULP: posts small blind 1500
VagColeSlaw: posts big blind 3000
*** HOLE CARDS ***
Dealt to JJin91 [Js 5s]
bigpond12: folds=20
JJin91: raises 4710 to 7710
zBeanHeaDz: folds=20
GUUUULP: folds=20
VagColeSlaw: folds=20
Uncalled bet (4710) returned to JJin91
JJin91 collected 9375 from pot
JJin91: doesn't show hand=20
*** SUMMARY ***
Total pot 9375 | Rake 0=20
Seat 2: zBeanHeaDz (button) folded before Flop (didn't bet)
Seat 3: GUUUULP (small blind) folded before Flop
Seat 4: VagColeSlaw (big blind) folded before Flop
Seat 6: bigpond12 folded before Flop (didn't bet)
Seat 7: JJin91 collected (9375)


*********** # 248 **************
PokerStars Hand #171488038719: Tournament #1648956629, $18.20+$1.80 USD=
 Hold'em No Limit - Level XXI (1500/3000) - 2017/06/20 22:43:15 ET
Table '1648956629 6' 9-max Seat #3 is the button
Seat 2: zBeanHeaDz (146784 in chips)=20
Seat 3: GUUUULP (34609 in chips) is sitting out
Seat 4: VagColeSlaw (43954 in chips)=20
Seat 6: bigpond12 (196627 in chips)=20
Seat 7: JJin91 (141744 in chips)=20
zBeanHeaDz: posts the ante 375
GUUUULP: posts the ante 375
VagColeSlaw: posts the ante 375
bigpond12: posts the ante 375
JJin91: posts the ante 375
VagColeSlaw: posts small blind 1500
bigpond12: posts big blind 3000
*** HOLE CARDS ***
Dealt to JJin91 [Qd As]
JJin91: raises 4710 to 7710
zBeanHeaDz: folds=20
GUUUULP: folds=20
VagColeSlaw: folds=20
bigpond12: calls 4710
*** FLOP *** [Js Kd Jc]
bigpond12: checks=20
JJin91: checks=20
*** TURN *** [Js Kd Jc] [9h]
bigpond12: checks=20
JJin91: checks=20
*** RIVER *** [Js Kd Jc 9h] [9s]
bigpond12: checks=20
JJin91: checks=20
*** SHOW DOWN ***
bigpond12: shows [8s 5s] (two pair, Jacks and Nines)
JJin91: shows [Qd As] (two pair, Jacks and Nines - Ace kicker)
JJin91 collected 18795 from pot
*** SUMMARY ***
Total pot 18795 | Rake 0=20
Board [Js Kd Jc 9h 9s]
Seat 2: zBeanHeaDz folded before Flop (didn't bet)
Seat 3: GUUUULP (button) folded before Flop (didn't bet)
Seat 4: VagColeSlaw (small blind) folded before Flop
Seat 6: bigpond12 (big blind) showed [8s 5s] and lost with two pair, Ja=
cks and Nines
Seat 7: JJin91 showed [Qd As] and won (18795) with two pair, Jacks and =
Nines


*********** # 249 **************
PokerStars Hand #171488038855: Tournament #1648956629, $18.20+$1.80 USD=
 Hold'em No Limit - Level XXI (1500/3000) - 2017/06/20 22:43:44 ET
Table '1648956629 6' 9-max Seat #4 is the button
Seat 2: zBeanHeaDz (146409 in chips)=20
Seat 3: GUUUULP (34234 in chips) is sitting out
Seat 4: VagColeSlaw (42079 in chips)=20
Seat 6: bigpond12 (188542 in chips)=20
Seat 7: JJin91 (152454 in chips)=20
zBeanHeaDz: posts the ante 375
GUUUULP: posts the ante 375
VagColeSlaw: posts the ante 375
bigpond12: posts the ante 375
JJin91: posts the ante 375
bigpond12: posts small blind 1500
JJin91: posts big blind 3000
*** HOLE CARDS ***
Dealt to JJin91 [7h 2h]
GUUUULP has returned
zBeanHeaDz: raises 3360 to 6360
GUUUULP: folds=20
VagColeSlaw: folds=20
bigpond12: calls 4860
JJin91: folds=20
*** FLOP *** [Qc 8h Ac]
bigpond12: checks=20
zBeanHeaDz: bets 6686
bigpond12: calls 6686
*** TURN *** [Qc 8h Ac] [Qs]
bigpond12: checks=20
zBeanHeaDz: checks=20
*** RIVER *** [Qc 8h Ac Qs] [6c]
bigpond12: checks=20
zBeanHeaDz: checks=20
*** SHOW DOWN ***
bigpond12: shows [8s 7s] (two pair, Queens and Eights)
zBeanHeaDz: mucks hand=20
bigpond12 collected 30967 from pot
*** SUMMARY ***
Total pot 30967 | Rake 0=20
Board [Qc 8h Ac Qs 6c]
Seat 2: zBeanHeaDz mucked [5d 4d]
Seat 3: GUUUULP folded before Flop (didn't bet)
Seat 4: VagColeSlaw (button) folded before Flop (didn't bet)
Seat 6: bigpond12 (small blind) showed [8s 7s] and won (30967) with two=
 pair, Queens and Eights
Seat 7: JJin91 (big blind) folded before Flop


*********** # 250 **************
PokerStars Hand #171488039176: Tournament #1648956629, $18.20+$1.80 USD=
 Hold'em No Limit - Level XXI (1500/3000) - 2017/06/20 22:44:48 ET
Table '1648956629 6' 9-max Seat #6 is the button
Seat 2: zBeanHeaDz (132988 in chips)=20
Seat 3: GUUUULP (33859 in chips)=20
Seat 4: VagColeSlaw (41704 in chips)=20
Seat 6: bigpond12 (206088 in chips)=20
Seat 7: JJin91 (149079 in chips)=20
zBeanHeaDz: posts the ante 375
GUUUULP: posts the ante 375
VagColeSlaw: posts the ante 375
bigpond12: posts the ante 375
JJin91: posts the ante 375
JJin91: posts small blind 1500
zBeanHeaDz: posts big blind 3000
*** HOLE CARDS ***
Dealt to JJin91 [3s 5s]
GUUUULP: folds=20
VagColeSlaw: folds=20
bigpond12: folds=20
JJin91: folds=20
Uncalled bet (1500) returned to zBeanHeaDz
zBeanHeaDz collected 4875 from pot
zBeanHeaDz: doesn't show hand=20
*** SUMMARY ***
Total pot 4875 | Rake 0=20
Seat 2: zBeanHeaDz (big blind) collected (4875)
Seat 3: GUUUULP folded before Flop (didn't bet)
Seat 4: VagColeSlaw folded before Flop (didn't bet)
Seat 6: bigpond12 (button) folded before Flop (didn't bet)
Seat 7: JJin91 (small blind) folded before Flop


*********** # 251 **************
PokerStars Hand #171488039286: Tournament #1648956629, $18.20+$1.80 USD=
 Hold'em No Limit - Level XXI (1500/3000) - 2017/06/20 22:45:13 ET
Table '1648956629 6' 9-max Seat #7 is the button
Seat 2: zBeanHeaDz (135988 in chips)=20
Seat 3: GUUUULP (33484 in chips)=20
Seat 4: VagColeSlaw (41329 in chips)=20
Seat 6: bigpond12 (205713 in chips)=20
Seat 7: JJin91 (147204 in chips)=20
zBeanHeaDz: posts the ante 375
GUUUULP: posts the ante 375
VagColeSlaw: posts the ante 375
bigpond12: posts the ante 375
JJin91: posts the ante 375
zBeanHeaDz: posts small blind 1500
GUUUULP: posts big blind 3000
*** HOLE CARDS ***
Dealt to JJin91 [3s Ts]
VagColeSlaw: folds=20
bigpond12: folds=20
JJin91: raises 4710 to 7710
zBeanHeaDz: folds=20
GUUUULP: folds=20
Uncalled bet (4710) returned to JJin91
JJin91 collected 9375 from pot
JJin91: doesn't show hand=20
*** SUMMARY ***
Total pot 9375 | Rake 0=20
Seat 2: zBeanHeaDz (small blind) folded before Flop
Seat 3: GUUUULP (big blind) folded before Flop
Seat 4: VagColeSlaw folded before Flop (didn't bet)
Seat 6: bigpond12 folded before Flop (didn't bet)
Seat 7: JJin91 (button) collected (9375)


*********** # 252 **************
PokerStars Hand #171488039472: Tournament #1648956629, $18.20+$1.80 USD=
 Hold'em No Limit - Level XXI (1500/3000) - 2017/06/20 22:45:49 ET
Table '1648956629 6' 9-max Seat #2 is the button
Seat 2: zBeanHeaDz (134113 in chips)=20
Seat 3: GUUUULP (30109 in chips)=20
Seat 4: VagColeSlaw (40954 in chips)=20
Seat 6: bigpond12 (205338 in chips)=20
Seat 7: JJin91 (153204 in chips)=20
zBeanHeaDz: posts the ante 375
GUUUULP: posts the ante 375
VagColeSlaw: posts the ante 375
bigpond12: posts the ante 375
JJin91: posts the ante 375
GUUUULP: posts small blind 1500
VagColeSlaw: posts big blind 3000
*** HOLE CARDS ***
Dealt to JJin91 [Tc 7c]
bigpond12: folds=20
JJin91: folds=20
zBeanHeaDz: folds=20
GUUUULP: raises 26734 to 29734 and is all-in
VagColeSlaw: folds=20
Uncalled bet (26734) returned to GUUUULP
GUUUULP collected 7875 from pot
*** SUMMARY ***
Total pot 7875 | Rake 0=20
Seat 2: zBeanHeaDz (button) folded before Flop (didn't bet)
Seat 3: GUUUULP (small blind) collected (7875)
Seat 4: VagColeSlaw (big blind) folded before Flop
Seat 6: bigpond12 folded before Flop (didn't bet)
Seat 7: JJin91 folded before Flop (didn't bet)


*********** # 253 **************
PokerStars Hand #171488039560: Tournament #1648956629, $18.20+$1.80 USD=
 Hold'em No Limit - Level XXI (1500/3000) - 2017/06/20 22:46:08 ET
Table '1648956629 6' 9-max Seat #3 is the button
Seat 2: zBeanHeaDz (133738 in chips)=20
Seat 3: GUUUULP (34609 in chips)=20
Seat 4: VagColeSlaw (37579 in chips)=20
Seat 6: bigpond12 (204963 in chips)=20
Seat 7: JJin91 (152829 in chips)=20
zBeanHeaDz: posts the ante 375
GUUUULP: posts the ante 375
VagColeSlaw: posts the ante 375
bigpond12: posts the ante 375
JJin91: posts the ante 375
VagColeSlaw: posts small blind 1500
bigpond12: posts big blind 3000
*** HOLE CARDS ***
Dealt to JJin91 [2h As]
JJin91: folds=20
zBeanHeaDz: raises 3360 to 6360
GUUUULP: folds=20
VagColeSlaw: folds=20
bigpond12: calls 3360
*** FLOP *** [Qh 8s Qd]
bigpond12: checks=20
zBeanHeaDz: bets 6116
bigpond12: raises 6116 to 12232
zBeanHeaDz: calls 6116
*** TURN *** [Qh 8s Qd] [9h]
bigpond12: checks=20
zBeanHeaDz: checks=20
*** RIVER *** [Qh 8s Qd 9h] [2c]
bigpond12: checks=20
zBeanHeaDz: checks=20
*** SHOW DOWN ***
bigpond12: shows [Ad 4h] (a pair of Queens)
zBeanHeaDz: shows [8c Tc] (two pair, Queens and Eights)
zBeanHeaDz collected 40559 from pot
*** SUMMARY ***
Total pot 40559 | Rake 0=20
Board [Qh 8s Qd 9h 2c]
Seat 2: zBeanHeaDz showed [8c Tc] and won (40559) with two pair, Queens=
 and Eights
Seat 3: GUUUULP (button) folded before Flop (didn't bet)
Seat 4: VagColeSlaw (small blind) folded before Flop
Seat 6: bigpond12 (big blind) showed [Ad 4h] and lost with a pair of Qu=
eens
Seat 7: JJin91 folded before Flop (didn't bet)


*********** # 254 **************
PokerStars Hand #171488039707: Tournament #1648956629, $18.20+$1.80 USD=
 Hold'em No Limit - Level XXI (1500/3000) - 2017/06/20 22:46:40 ET
Table '1648956629 6' 9-max Seat #4 is the button
Seat 2: zBeanHeaDz (155330 in chips)=20
Seat 3: GUUUULP (34234 in chips)=20
Seat 4: VagColeSlaw (35704 in chips)=20
Seat 6: bigpond12 (185996 in chips)=20
Seat 7: JJin91 (152454 in chips)=20
zBeanHeaDz: posts the ante 375
GUUUULP: posts the ante 375
VagColeSlaw: posts the ante 375
bigpond12: posts the ante 375
JJin91: posts the ante 375
bigpond12: posts small blind 1500
JJin91: posts big blind 3000
*** HOLE CARDS ***
Dealt to JJin91 [8h Jc]
zBeanHeaDz: folds=20
GUUUULP: folds=20
VagColeSlaw: raises 3000 to 6000
bigpond12: calls 4500
JJin91: calls 3000
*** FLOP *** [5d 3h 5h]
bigpond12: checks=20
JJin91: checks=20
VagColeSlaw: checks=20
*** TURN *** [5d 3h 5h] [Qd]
bigpond12: bets 6000
JJin91: calls 6000
VagColeSlaw: folds=20
*** RIVER *** [5d 3h 5h Qd] [Qc]
bigpond12: bets 6000
JJin91: folds=20
Uncalled bet (6000) returned to bigpond12
bigpond12 collected 31875 from pot
bigpond12: doesn't show hand=20
*** SUMMARY ***
Total pot 31875 | Rake 0=20
Board [5d 3h 5h Qd Qc]
Seat 2: zBeanHeaDz folded before Flop (didn't bet)
Seat 3: GUUUULP folded before Flop (didn't bet)
Seat 4: VagColeSlaw (button) folded on the Turn
Seat 6: bigpond12 (small blind) collected (31875)
Seat 7: JJin91 (big blind) folded on the River


*********** # 255 **************
PokerStars Hand #171488984258: Tournament #1648956629, $18.20+$1.80 USD=
 Hold'em No Limit - Level XXII (2000/4000) - 2017/06/20 22:47:55 ET
Table '1648956629 6' 9-max Seat #6 is the button
Seat 2: zBeanHeaDz (154955 in chips)=20
Seat 3: GUUUULP (33859 in chips)=20
Seat 4: VagColeSlaw (29329 in chips)=20
Seat 6: bigpond12 (205496 in chips)=20
Seat 7: JJin91 (140079 in chips)=20
zBeanHeaDz: posts the ante 500
GUUUULP: posts the ante 500
VagColeSlaw: posts the ante 500
bigpond12: posts the ante 500
JJin91: posts the ante 500
JJin91: posts small blind 2000
zBeanHeaDz: posts big blind 4000
*** HOLE CARDS ***
Dealt to JJin91 [7c 8s]
GUUUULP: folds=20
VagColeSlaw: folds=20
bigpond12: raises 4000 to 8000
JJin91: folds=20
zBeanHeaDz: folds=20
Uncalled bet (4000) returned to bigpond12
bigpond12 collected 12500 from pot
bigpond12: doesn't show hand=20
*** SUMMARY ***
Total pot 12500 | Rake 0=20
Seat 2: zBeanHeaDz (big blind) folded before Flop
Seat 3: GUUUULP folded before Flop (didn't bet)
Seat 4: VagColeSlaw folded before Flop (didn't bet)
Seat 6: bigpond12 (button) collected (12500)
Seat 7: JJin91 (small blind) folded before Flop


*********** # 256 **************
PokerStars Hand #171488984511: Tournament #1648956629, $18.20+$1.80 USD=
 Hold'em No Limit - Level XXII (2000/4000) - 2017/06/20 22:48:47 ET
Table '1648956629 6' 9-max Seat #7 is the button
Seat 2: zBeanHeaDz (150455 in chips)=20
Seat 3: GUUUULP (33359 in chips)=20
Seat 4: VagColeSlaw (28829 in chips)=20
Seat 6: bigpond12 (213496 in chips)=20
Seat 7: JJin91 (137579 in chips)=20
zBeanHeaDz: posts the ante 500
GUUUULP: posts the ante 500
VagColeSlaw: posts the ante 500
bigpond12: posts the ante 500
JJin91: posts the ante 500
zBeanHeaDz: posts small blind 2000
GUUUULP: posts big blind 4000
*** HOLE CARDS ***
Dealt to JJin91 [Tc 6c]
VagColeSlaw: folds=20
bigpond12: calls 4000
JJin91: folds=20
zBeanHeaDz: raises 6255 to 10255
GUUUULP: folds=20
bigpond12: calls 6255
*** FLOP *** [8c Kc 4s]
zBeanHeaDz: bets 10264
bigpond12: calls 10264
*** TURN *** [8c Kc 4s] [2d]
zBeanHeaDz: bets 12000
bigpond12: calls 12000
*** RIVER *** [8c Kc 4s 2d] [3s]
zBeanHeaDz: checks=20
bigpond12: bets 16000
zBeanHeaDz: calls 16000
*** SHOW DOWN ***
bigpond12: shows [Kd Qs] (a pair of Kings)
zBeanHeaDz: mucks hand=20
bigpond12 collected 103538 from pot
*** SUMMARY ***
Total pot 103538 | Rake 0=20
Board [8c Kc 4s 2d 3s]
Seat 2: zBeanHeaDz (small blind) mucked [Ks Jh]
Seat 3: GUUUULP (big blind) folded before Flop
Seat 4: VagColeSlaw folded before Flop (didn't bet)
Seat 6: bigpond12 showed [Kd Qs] and won (103538) with a pair of Kings
Seat 7: JJin91 (button) folded before Flop (didn't bet)


*********** # 257 **************
PokerStars Hand #171488984770: Tournament #1648956629, $18.20+$1.80 USD=
 Hold'em No Limit - Level XXII (2000/4000) - 2017/06/20 22:49:45 ET
Table '1648956629 6' 9-max Seat #2 is the button
Seat 2: zBeanHeaDz (101436 in chips)=20
Seat 3: GUUUULP (28859 in chips)=20
Seat 4: VagColeSlaw (28329 in chips)=20
Seat 6: bigpond12 (268015 in chips)=20
Seat 7: JJin91 (137079 in chips)=20
zBeanHeaDz: posts the ante 500
GUUUULP: posts the ante 500
VagColeSlaw: posts the ante 500
bigpond12: posts the ante 500
JJin91: posts the ante 500
GUUUULP: posts small blind 2000
VagColeSlaw: posts big blind 4000
*** HOLE CARDS ***
Dealt to JJin91 [Kc Qh]
bigpond12: folds=20
JJin91: raises 6280 to 10280
zBeanHeaDz: folds=20
GUUUULP: folds=20
VagColeSlaw: folds=20
Uncalled bet (6280) returned to JJin91
JJin91 collected 12500 from pot
JJin91: doesn't show hand=20
*** SUMMARY ***
Total pot 12500 | Rake 0=20
Seat 2: zBeanHeaDz (button) folded before Flop (didn't bet)
Seat 3: GUUUULP (small blind) folded before Flop
Seat 4: VagColeSlaw (big blind) folded before Flop
Seat 6: bigpond12 folded before Flop (didn't bet)
Seat 7: JJin91 collected (12500)


*********** # 258 **************
PokerStars Hand #171488984899: Tournament #1648956629, $18.20+$1.80 USD=
 Hold'em No Limit - Level XXII (2000/4000) - 2017/06/20 22:50:13 ET
Table '1648956629 6' 9-max Seat #3 is the button
Seat 2: zBeanHeaDz (100936 in chips)=20
Seat 3: GUUUULP (26359 in chips)=20
Seat 4: VagColeSlaw (23829 in chips)=20
Seat 6: bigpond12 (267515 in chips)=20
Seat 7: JJin91 (145079 in chips)=20
zBeanHeaDz: posts the ante 500
GUUUULP: posts the ante 500
VagColeSlaw: posts the ante 500
bigpond12: posts the ante 500
JJin91: posts the ante 500
VagColeSlaw: posts small blind 2000
bigpond12: posts big blind 4000
*** HOLE CARDS ***
Dealt to JJin91 [3c 3h]
JJin91: raises 6280 to 10280
zBeanHeaDz: folds=20
GUUUULP: folds=20
VagColeSlaw: folds=20
bigpond12: calls 6280
*** FLOP *** [8h Qc 9c]
bigpond12: checks=20
JJin91: bets 9272
bigpond12: calls 9272
*** TURN *** [8h Qc 9c] [Tc]
bigpond12: checks=20
JJin91: bets 24854
bigpond12: folds=20
Uncalled bet (24854) returned to JJin91
JJin91 collected 43604 from pot
JJin91: doesn't show hand=20
*** SUMMARY ***
Total pot 43604 | Rake 0=20
Board [8h Qc 9c Tc]
Seat 2: zBeanHeaDz folded before Flop (didn't bet)
Seat 3: GUUUULP (button) folded before Flop (didn't bet)
Seat 4: VagColeSlaw (small blind) folded before Flop
Seat 6: bigpond12 (big blind) folded on the Turn
Seat 7: JJin91 collected (43604)


*********** # 259 **************
PokerStars Hand #171488985008: Tournament #1648956629, $18.20+$1.80 USD=
 Hold'em No Limit - Level XXII (2000/4000) - 2017/06/20 22:50:40 ET
Table '1648956629 6' 9-max Seat #4 is the button
Seat 2: zBeanHeaDz (100436 in chips)=20
Seat 3: GUUUULP (25859 in chips)=20
Seat 4: VagColeSlaw (21329 in chips)=20
Seat 6: bigpond12 (247463 in chips)=20
Seat 7: JJin91 (168631 in chips)=20
zBeanHeaDz: posts the ante 500
GUUUULP: posts the ante 500
VagColeSlaw: posts the ante 500
bigpond12: posts the ante 500
JJin91: posts the ante 500
bigpond12: posts small blind 2000
JJin91: posts big blind 4000
*** HOLE CARDS ***
Dealt to JJin91 [5h Th]
zBeanHeaDz: folds=20
GUUUULP: folds=20
VagColeSlaw: folds=20
bigpond12: folds=20
Uncalled bet (2000) returned to JJin91
JJin91 collected 6500 from pot
JJin91: doesn't show hand=20
*** SUMMARY ***
Total pot 6500 | Rake 0=20
Seat 2: zBeanHeaDz folded before Flop (didn't bet)
Seat 3: GUUUULP folded before Flop (didn't bet)
Seat 4: VagColeSlaw (button) folded before Flop (didn't bet)
Seat 6: bigpond12 (small blind) folded before Flop
Seat 7: JJin91 (big blind) collected (6500)


*********** # 260 **************
PokerStars Hand #171488985141: Tournament #1648956629, $18.20+$1.80 USD=
 Hold'em No Limit - Level XXII (2000/4000) - 2017/06/20 22:51:09 ET
Table '1648956629 6' 9-max Seat #6 is the button
Seat 2: zBeanHeaDz (99936 in chips)=20
Seat 3: GUUUULP (25359 in chips)=20
Seat 4: VagColeSlaw (20829 in chips)=20
Seat 6: bigpond12 (244963 in chips)=20
Seat 7: JJin91 (172631 in chips)=20
zBeanHeaDz: posts the ante 500
GUUUULP: posts the ante 500
VagColeSlaw: posts the ante 500
bigpond12: posts the ante 500
JJin91: posts the ante 500
JJin91: posts small blind 2000
zBeanHeaDz: posts big blind 4000
*** HOLE CARDS ***
Dealt to JJin91 [8s Jd]
GUUUULP: folds=20
VagColeSlaw: folds=20
bigpond12: folds=20
JJin91: folds=20
Uncalled bet (2000) returned to zBeanHeaDz
zBeanHeaDz collected 6500 from pot
zBeanHeaDz: doesn't show hand=20
*** SUMMARY ***
Total pot 6500 | Rake 0=20
Seat 2: zBeanHeaDz (big blind) collected (6500)
Seat 3: GUUUULP folded before Flop (didn't bet)
Seat 4: VagColeSlaw folded before Flop (didn't bet)
Seat 6: bigpond12 (button) folded before Flop (didn't bet)
Seat 7: JJin91 (small blind) folded before Flop


*********** # 261 **************
PokerStars Hand #171488985327: Tournament #1648956629, $18.20+$1.80 USD=
 Hold'em No Limit - Level XXII (2000/4000) - 2017/06/20 22:51:53 ET
Table '1648956629 6' 9-max Seat #7 is the button
Seat 2: zBeanHeaDz (103936 in chips)=20
Seat 3: GUUUULP (24859 in chips)=20
Seat 4: VagColeSlaw (20329 in chips)=20
Seat 6: bigpond12 (244463 in chips)=20
Seat 7: JJin91 (170131 in chips)=20
zBeanHeaDz: posts the ante 500
GUUUULP: posts the ante 500
VagColeSlaw: posts the ante 500
bigpond12: posts the ante 500
JJin91: posts the ante 500
zBeanHeaDz: posts small blind 2000
GUUUULP: posts big blind 4000
*** HOLE CARDS ***
Dealt to JJin91 [Jh 9s]
VagColeSlaw: folds=20
bigpond12: folds=20
JJin91: raises 6280 to 10280
zBeanHeaDz: folds=20
GUUUULP: folds=20
Uncalled bet (6280) returned to JJin91
JJin91 collected 12500 from pot
JJin91: doesn't show hand=20
*** SUMMARY ***
Total pot 12500 | Rake 0=20
Seat 2: zBeanHeaDz (small blind) folded before Flop
Seat 3: GUUUULP (big blind) folded before Flop
Seat 4: VagColeSlaw folded before Flop (didn't bet)
Seat 6: bigpond12 folded before Flop (didn't bet)
Seat 7: JJin91 (button) collected (12500)


*********** # 262 **************
PokerStars Hand #171488985508: Tournament #1648956629, $18.20+$1.80 USD=
 Hold'em No Limit - Level XXII (2000/4000) - 2017/06/20 22:52:29 ET
Table '1648956629 6' 9-max Seat #2 is the button
Seat 2: zBeanHeaDz (101436 in chips)=20
Seat 3: GUUUULP (20359 in chips)=20
Seat 4: VagColeSlaw (19829 in chips)=20
Seat 6: bigpond12 (243963 in chips)=20
Seat 7: JJin91 (178131 in chips)=20
zBeanHeaDz: posts the ante 500
GUUUULP: posts the ante 500
VagColeSlaw: posts the ante 500
bigpond12: posts the ante 500
JJin91: posts the ante 500
GUUUULP: posts small blind 2000
VagColeSlaw: posts big blind 4000
*** HOLE CARDS ***
Dealt to JJin91 [9s 4c]
bigpond12: folds=20
JJin91: folds=20
zBeanHeaDz: folds=20
GUUUULP: raises 15859 to 19859 and is all-in
VagColeSlaw: folds=20
Uncalled bet (15859) returned to GUUUULP
GUUUULP collected 10500 from pot
GUUUULP: doesn't show hand=20
*** SUMMARY ***
Total pot 10500 | Rake 0=20
Seat 2: zBeanHeaDz (button) folded before Flop (didn't bet)
Seat 3: GUUUULP (small blind) collected (10500)
Seat 4: VagColeSlaw (big blind) folded before Flop
Seat 6: bigpond12 folded before Flop (didn't bet)
Seat 7: JJin91 folded before Flop (didn't bet)


*********** # 263 **************
PokerStars Hand #171488985617: Tournament #1648956629, $18.20+$1.80 USD=
 Hold'em No Limit - Level XXII (2000/4000) - 2017/06/20 22:52:54 ET
Table '1648956629 6' 9-max Seat #3 is the button
Seat 2: zBeanHeaDz (100936 in chips)=20
Seat 3: GUUUULP (26359 in chips)=20
Seat 4: VagColeSlaw (15329 in chips)=20
Seat 6: bigpond12 (243463 in chips)=20
Seat 7: JJin91 (177631 in chips)=20
zBeanHeaDz: posts the ante 500
GUUUULP: posts the ante 500
VagColeSlaw: posts the ante 500
bigpond12: posts the ante 500
JJin91: posts the ante 500
VagColeSlaw: posts small blind 2000
bigpond12: posts big blind 4000
*** HOLE CARDS ***
Dealt to JJin91 [6s 3c]
JJin91: folds=20
zBeanHeaDz: folds=20
GUUUULP: raises 21859 to 25859 and is all-in
VagColeSlaw: calls 12829 and is all-in
bigpond12: calls 21859
*** FLOP *** [6h Qh 7d]
*** TURN *** [6h Qh 7d] [Jh]
*** RIVER *** [6h Qh 7d Jh] [2d]
*** SHOW DOWN ***
bigpond12: shows [8h Kc] (high card King)
GUUUULP: shows [Jc Qc] (two pair, Queens and Jacks)
GUUUULP collected 22060 from side pot
VagColeSlaw: shows [5s 5d] (a pair of Fives)
GUUUULP collected 46987 from main pot
VagColeSlaw finished the tournament in 10th place and received $41.93.
*** SUMMARY ***
Total pot 69047 Main pot 46987. Side pot 22060. | Rake 0=20
Board [6h Qh 7d Jh 2d]
Seat 2: zBeanHeaDz folded before Flop (didn't bet)
Seat 3: GUUUULP (button) showed [Jc Qc] and won (69047) with two pair, =
Queens and Jacks
Seat 4: VagColeSlaw (small blind) showed [5s 5d] and lost with a pair o=
f Fives
Seat 6: bigpond12 (big blind) showed [8h Kc] and lost with high card Ki=
ng
Seat 7: JJin91 folded before Flop (didn't bet)


*********** # 264 **************
PokerStars Hand #171488985817: Tournament #1648956629, $18.20+$1.80 USD=
 Hold'em No Limit - Level XXII (2000/4000) - 2017/06/20 22:53:40 ET
Table '1648956629 1' 9-max Seat #5 is the button
Seat 1: bigpond12 (217104 in chips)=20
Seat 2: GUUUULP (69047 in chips)=20
Seat 3: zBeanHeaDz (100436 in chips)=20
Seat 4: JJin91 (177131 in chips)=20
Seat 5: Labba609 (45188 in chips)=20
Seat 6: GoFish8686 (114621 in chips)=20
Seat 7: PureWizardry (56641 in chips)=20
Seat 8: Deuxexmachen (97784 in chips)=20
Seat 9: MoeHawk101 (82048 in chips)=20
bigpond12: posts the ante 500
GUUUULP: posts the ante 500
zBeanHeaDz: posts the ante 500
JJin91: posts the ante 500
Labba609: posts the ante 500
GoFish8686: posts the ante 500
PureWizardry: posts the ante 500
Deuxexmachen: posts the ante 500
MoeHawk101: posts the ante 500
GoFish8686: posts small blind 2000
PureWizardry: posts big blind 4000
*** HOLE CARDS ***
Dealt to JJin91 [8h 5d]
Deuxexmachen: folds=20
MoeHawk101: folds=20
GoFish8686 said, "gl laabbbaa"
bigpond12: calls 4000
GoFish8686 said, "I'm pulling for you"
GUUUULP: folds=20
zBeanHeaDz: folds=20
JJin91: folds=20
Labba609: folds=20
GoFish8686: folds=20
PureWizardry: checks=20
*** FLOP *** [4d 5c 7d]
PureWizardry: checks=20
bigpond12: checks=20
*** TURN *** [4d 5c 7d] [Kc]
PureWizardry: checks=20
bigpond12: bets 12000
PureWizardry: folds=20
Uncalled bet (12000) returned to bigpond12
bigpond12 collected 14500 from pot
bigpond12: doesn't show hand=20
*** SUMMARY ***
Total pot 14500 | Rake 0=20
Board [4d 5c 7d Kc]
Seat 1: bigpond12 collected (14500)
Seat 2: GUUUULP folded before Flop (didn't bet)
Seat 3: zBeanHeaDz folded before Flop (didn't bet)
Seat 4: JJin91 folded before Flop (didn't bet)
Seat 5: Labba609 (button) folded before Flop (didn't bet)
Seat 6: GoFish8686 (small blind) folded before Flop
Seat 7: PureWizardry (big blind) folded on the Turn
Seat 8: Deuxexmachen folded before Flop (didn't bet)
Seat 9: MoeHawk101 folded before Flop (didn't bet)


*********** # 265 **************
PokerStars Hand #171488986046: Tournament #1648956629, $18.20+$1.80 USD=
 Hold'em No Limit - Level XXII (2000/4000) - 2017/06/20 22:54:29 ET
Table '1648956629 1' 9-max Seat #6 is the button
Seat 1: bigpond12 (227104 in chips)=20
Seat 2: GUUUULP (68547 in chips)=20
Seat 3: zBeanHeaDz (99936 in chips)=20
Seat 4: JJin91 (176631 in chips)=20
Seat 5: Labba609 (44688 in chips)=20
Seat 6: GoFish8686 (112121 in chips)=20
Seat 7: PureWizardry (52141 in chips)=20
Seat 8: Deuxexmachen (97284 in chips)=20
Seat 9: MoeHawk101 (81548 in chips)=20
bigpond12: posts the ante 500
GUUUULP: posts the ante 500
zBeanHeaDz: posts the ante 500
JJin91: posts the ante 500
Labba609: posts the ante 500
GoFish8686: posts the ante 500
PureWizardry: posts the ante 500
Deuxexmachen: posts the ante 500
MoeHawk101: posts the ante 500
PureWizardry: posts small blind 2000
Deuxexmachen: posts big blind 4000
*** HOLE CARDS ***
Dealt to JJin91 [5c 8c]
MoeHawk101: folds=20
bigpond12: folds=20
GUUUULP: folds=20
zBeanHeaDz: folds=20
JJin91: folds=20
Labba609: folds=20
GoFish8686: folds=20
PureWizardry: folds=20
Uncalled bet (2000) returned to Deuxexmachen
Deuxexmachen collected 8500 from pot
Deuxexmachen: doesn't show hand=20
*** SUMMARY ***
Total pot 8500 | Rake 0=20
Seat 1: bigpond12 folded before Flop (didn't bet)
Seat 2: GUUUULP folded before Flop (didn't bet)
Seat 3: zBeanHeaDz folded before Flop (didn't bet)
Seat 4: JJin91 folded before Flop (didn't bet)
Seat 5: Labba609 folded before Flop (didn't bet)
Seat 6: GoFish8686 (button) folded before Flop (didn't bet)
Seat 7: PureWizardry (small blind) folded before Flop
Seat 8: Deuxexmachen (big blind) collected (8500)
Seat 9: MoeHawk101 folded before Flop (didn't bet)


*********** # 266 **************
PokerStars Hand #171488986254: Tournament #1648956629, $18.20+$1.80 USD=
 Hold'em No Limit - Level XXII (2000/4000) - 2017/06/20 22:55:10 ET
Table '1648956629 1' 9-max Seat #7 is the button
Seat 1: bigpond12 (226604 in chips)=20
Seat 2: GUUUULP (68047 in chips)=20
Seat 3: zBeanHeaDz (99436 in chips)=20
Seat 4: JJin91 (176131 in chips)=20
Seat 5: Labba609 (44188 in chips)=20
Seat 6: GoFish8686 (111621 in chips)=20
Seat 7: PureWizardry (49641 in chips)=20
Seat 8: Deuxexmachen (103284 in chips)=20
Seat 9: MoeHawk101 (81048 in chips)=20
bigpond12: posts the ante 500
GUUUULP: posts the ante 500
zBeanHeaDz: posts the ante 500
JJin91: posts the ante 500
Labba609: posts the ante 500
GoFish8686: posts the ante 500
PureWizardry: posts the ante 500
Deuxexmachen: posts the ante 500
MoeHawk101: posts the ante 500
Deuxexmachen: posts small blind 2000
MoeHawk101: posts big blind 4000
*** HOLE CARDS ***
Dealt to JJin91 [5h Td]
bigpond12: folds=20
GUUUULP: folds=20
zBeanHeaDz: folds=20
JJin91: folds=20
Labba609: folds=20
GoFish8686: folds=20
PureWizardry: folds=20
Deuxexmachen: raises 8000 to 12000
MoeHawk101: raises 68548 to 80548 and is all-in
Deuxexmachen: folds=20
Uncalled bet (68548) returned to MoeHawk101
MoeHawk101 collected 28500 from pot
MoeHawk101: doesn't show hand=20
JJin91 is disconnected=20
zBeanHeaDz is disconnected=20
Deuxexmachen is disconnected=20
PureWizardry is disconnected=20
GUUUULP is disconnected=20
GoFish8686 is disconnected=20
bigpond12 is disconnected=20
Labba609 is disconnected=20
*** SUMMARY ***
Total pot 28500 | Rake 0=20
Seat 1: bigpond12 folded before Flop (didn't bet)
Seat 2: GUUUULP folded before Flop (didn't bet)
Seat 3: zBeanHeaDz folded before Flop (didn't bet)
Seat 4: JJin91 folded before Flop (didn't bet)
Seat 5: Labba609 folded before Flop (didn't bet)
Seat 6: GoFish8686 folded before Flop (didn't bet)
Seat 7: PureWizardry (button) folded before Flop (didn't bet)
Seat 8: Deuxexmachen (small blind) folded before Flop
Seat 9: MoeHawk101 (big blind) collected (28500)


*********** # 267 **************
PokerStars Hand #171488987659: Tournament #1648956629, $18.20+$1.80 USD=
 Hold'em No Limit - Level XXII (2000/4000) - 2017/06/20 23:01:12 ET
Table '1648956629 1' 9-max Seat #8 is the button
Seat 1: bigpond12 (226104 in chips)=20
Seat 2: GUUUULP (67547 in chips)=20
Seat 3: zBeanHeaDz (98936 in chips)=20
Seat 4: JJin91 (175631 in chips)=20
Seat 5: Labba609 (43688 in chips)=20
Seat 6: GoFish8686 (111121 in chips)=20
Seat 7: PureWizardry (49141 in chips)=20
Seat 8: Deuxexmachen (90784 in chips)=20
Seat 9: MoeHawk101 (97048 in chips)=20
bigpond12: posts the ante 500
GUUUULP: posts the ante 500
zBeanHeaDz: posts the ante 500
JJin91: posts the ante 500
Labba609: posts the ante 500
GoFish8686: posts the ante 500
PureWizardry: posts the ante 500
Deuxexmachen: posts the ante 500
MoeHawk101: posts the ante 500
MoeHawk101: posts small blind 2000
bigpond12: posts big blind 4000
*** HOLE CARDS ***
Dealt to JJin91 [4d 9h]
GUUUULP: folds=20
zBeanHeaDz: raises 5600 to 9600
JJin91: folds=20
Labba609: folds=20
GoFish8686: folds=20
PureWizardry: folds=20
Deuxexmachen: folds=20
MoeHawk101: folds=20
bigpond12: calls 5600
*** FLOP *** [8c Ad 3s]
bigpond12: checks=20
zBeanHeaDz: bets 9766
bigpond12: calls 9766
*** TURN *** [8c Ad 3s] [Kh]
bigpond12: checks=20
zBeanHeaDz: checks=20
*** RIVER *** [8c Ad 3s Kh] [Td]
bigpond12: bets 45232
zBeanHeaDz: folds=20
Uncalled bet (45232) returned to bigpond12
bigpond12 collected 45232 from pot
bigpond12: doesn't show hand=20
*** SUMMARY ***
Total pot 45232 | Rake 0=20
Board [8c Ad 3s Kh Td]
Seat 1: bigpond12 (big blind) collected (45232)
Seat 2: GUUUULP folded before Flop (didn't bet)
Seat 3: zBeanHeaDz folded on the River
Seat 4: JJin91 folded before Flop (didn't bet)
Seat 5: Labba609 folded before Flop (didn't bet)
Seat 6: GoFish8686 folded before Flop (didn't bet)
Seat 7: PureWizardry folded before Flop (didn't bet)
Seat 8: Deuxexmachen (button) folded before Flop (didn't bet)
Seat 9: MoeHawk101 (small blind) folded before Flop


*********** # 268 **************
PokerStars Hand #171488987936: Tournament #1648956629, $18.20+$1.80 USD=
 Hold'em No Limit - Level XXII (2000/4000) - 2017/06/20 23:02:12 ET
Table '1648956629 1' 9-max Seat #9 is the button
Seat 1: bigpond12 (251470 in chips)=20
Seat 2: GUUUULP (67047 in chips)=20
Seat 3: zBeanHeaDz (79070 in chips)=20
Seat 4: JJin91 (175131 in chips)=20
Seat 5: Labba609 (43188 in chips)=20
Seat 6: GoFish8686 (110621 in chips)=20
Seat 7: PureWizardry (48641 in chips)=20
Seat 8: Deuxexmachen (90284 in chips)=20
Seat 9: MoeHawk101 (94548 in chips)=20
bigpond12: posts the ante 500
GUUUULP: posts the ante 500
zBeanHeaDz: posts the ante 500
JJin91: posts the ante 500
Labba609: posts the ante 500
GoFish8686: posts the ante 500
PureWizardry: posts the ante 500
Deuxexmachen: posts the ante 500
MoeHawk101: posts the ante 500
bigpond12: posts small blind 2000
GUUUULP: posts big blind 4000
*** HOLE CARDS ***
Dealt to JJin91 [7c 9h]
zBeanHeaDz: folds=20
JJin91: folds=20
Labba609: folds=20
GoFish8686: raises 8000 to 12000
PureWizardry: folds=20
Deuxexmachen: folds=20
MoeHawk101: folds=20
bigpond12: folds=20
GUUUULP: folds=20
Uncalled bet (8000) returned to GoFish8686
GoFish8686 collected 14500 from pot
GoFish8686: doesn't show hand=20
*** SUMMARY ***
Total pot 14500 | Rake 0=20
Seat 1: bigpond12 (small blind) folded before Flop
Seat 2: GUUUULP (big blind) folded before Flop
Seat 3: zBeanHeaDz folded before Flop (didn't bet)
Seat 4: JJin91 folded before Flop (didn't bet)
Seat 5: Labba609 folded before Flop (didn't bet)
Seat 6: GoFish8686 collected (14500)
Seat 7: PureWizardry folded before Flop (didn't bet)
Seat 8: Deuxexmachen folded before Flop (didn't bet)
Seat 9: MoeHawk101 (button) folded before Flop (didn't bet)


*********** # 269 **************
PokerStars Hand #171488988052: Tournament #1648956629, $18.20+$1.80 USD=
 Hold'em No Limit - Level XXII (2000/4000) - 2017/06/20 23:02:36 ET
Table '1648956629 1' 9-max Seat #1 is the button
Seat 1: bigpond12 (248970 in chips)=20
Seat 2: GUUUULP (62547 in chips)=20
Seat 3: zBeanHeaDz (78570 in chips)=20
Seat 4: JJin91 (174631 in chips)=20
Seat 5: Labba609 (42688 in chips)=20
Seat 6: GoFish8686 (120621 in chips)=20
Seat 7: PureWizardry (48141 in chips)=20
Seat 8: Deuxexmachen (89784 in chips)=20
Seat 9: MoeHawk101 (94048 in chips)=20
bigpond12: posts the ante 500
GUUUULP: posts the ante 500
zBeanHeaDz: posts the ante 500
JJin91: posts the ante 500
Labba609: posts the ante 500
GoFish8686: posts the ante 500
PureWizardry: posts the ante 500
Deuxexmachen: posts the ante 500
MoeHawk101: posts the ante 500
GUUUULP: posts small blind 2000
zBeanHeaDz: posts big blind 4000
*** HOLE CARDS ***
Dealt to JJin91 [2h Js]
JJin91: folds=20
Labba609: folds=20
GoFish8686: folds=20
PureWizardry: raises 20000 to 24000
Deuxexmachen: folds=20
MoeHawk101: folds=20
bigpond12: folds=20
GUUUULP: folds=20
zBeanHeaDz: folds=20
Uncalled bet (20000) returned to PureWizardry
PureWizardry collected 14500 from pot
PureWizardry: doesn't show hand=20
*** SUMMARY ***
Total pot 14500 | Rake 0=20
Seat 1: bigpond12 (button) folded before Flop (didn't bet)
Seat 2: GUUUULP (small blind) folded before Flop
Seat 3: zBeanHeaDz (big blind) folded before Flop
Seat 4: JJin91 folded before Flop (didn't bet)
Seat 5: Labba609 folded before Flop (didn't bet)
Seat 6: GoFish8686 folded before Flop (didn't bet)
Seat 7: PureWizardry collected (14500)
Seat 8: Deuxexmachen folded before Flop (didn't bet)
Seat 9: MoeHawk101 folded before Flop (didn't bet)


*********** # 270 **************
PokerStars Hand #171488988159: Tournament #1648956629, $18.20+$1.80 USD=
 Hold'em No Limit - Level XXII (2000/4000) - 2017/06/20 23:03:03 ET
Table '1648956629 1' 9-max Seat #2 is the button
Seat 1: bigpond12 (248470 in chips)=20
Seat 2: GUUUULP (60047 in chips)=20
Seat 3: zBeanHeaDz (74070 in chips)=20
Seat 4: JJin91 (174131 in chips)=20
Seat 5: Labba609 (42188 in chips)=20
Seat 6: GoFish8686 (120121 in chips)=20
Seat 7: PureWizardry (58141 in chips)=20
Seat 8: Deuxexmachen (89284 in chips)=20
Seat 9: MoeHawk101 (93548 in chips)=20
bigpond12: posts the ante 500
GUUUULP: posts the ante 500
zBeanHeaDz: posts the ante 500
JJin91: posts the ante 500
Labba609: posts the ante 500
GoFish8686: posts the ante 500
PureWizardry: posts the ante 500
Deuxexmachen: posts the ante 500
MoeHawk101: posts the ante 500
zBeanHeaDz: posts small blind 2000
JJin91: posts big blind 4000
*** HOLE CARDS ***
Dealt to JJin91 [4h 2h]
Labba609: folds=20
GoFish8686: folds=20
PureWizardry: folds=20
Deuxexmachen: folds=20
MoeHawk101: raises 4000 to 8000
bigpond12: folds=20
GUUUULP: folds=20
zBeanHeaDz: folds=20
JJin91: raises 4000 to 12000
MoeHawk101: calls 4000
*** FLOP *** [2d Qs 7c]
JJin91: bets 11285
MoeHawk101: folds=20
Uncalled bet (11285) returned to JJin91
JJin91 collected 30500 from pot
JJin91: doesn't show hand=20
*** SUMMARY ***
Total pot 30500 | Rake 0=20
Board [2d Qs 7c]
Seat 1: bigpond12 folded before Flop (didn't bet)
Seat 2: GUUUULP (button) folded before Flop (didn't bet)
Seat 3: zBeanHeaDz (small blind) folded before Flop
Seat 4: JJin91 (big blind) collected (30500)
Seat 5: Labba609 folded before Flop (didn't bet)
Seat 6: GoFish8686 folded before Flop (didn't bet)
Seat 7: PureWizardry folded before Flop (didn't bet)
Seat 8: Deuxexmachen folded before Flop (didn't bet)
Seat 9: MoeHawk101 folded on the Flop


*********** # 271 **************
PokerStars Hand #171488988421: Tournament #1648956629, $18.20+$1.80 USD=
 Hold'em No Limit - Level XXIII (2500/5000) - 2017/06/20 23:03:58 ET
Table '1648956629 1' 9-max Seat #3 is the button
Seat 1: bigpond12 (247970 in chips)=20
Seat 2: GUUUULP (59547 in chips)=20
Seat 3: zBeanHeaDz (71570 in chips)=20
Seat 4: JJin91 (192131 in chips)=20
Seat 5: Labba609 (41688 in chips)=20
Seat 6: GoFish8686 (119621 in chips)=20
Seat 7: PureWizardry (57641 in chips)=20
Seat 8: Deuxexmachen (88784 in chips)=20
Seat 9: MoeHawk101 (81048 in chips)=20
bigpond12: posts the ante 625
GUUUULP: posts the ante 625
zBeanHeaDz: posts the ante 625
JJin91: posts the ante 625
Labba609: posts the ante 625
GoFish8686: posts the ante 625
PureWizardry: posts the ante 625
Deuxexmachen: posts the ante 625
MoeHawk101: posts the ante 625
JJin91: posts small blind 2500
Labba609: posts big blind 5000
*** HOLE CARDS ***
Dealt to JJin91 [7h Jd]
GoFish8686: folds=20
PureWizardry: folds=20
Deuxexmachen: folds=20
MoeHawk101: folds=20
bigpond12: raises 10000 to 15000
GUUUULP: folds=20
zBeanHeaDz: folds=20
JJin91: folds=20
Labba609: raises 26063 to 41063 and is all-in
bigpond12: calls 26063
*** FLOP *** [Ad Qs 4h]
*** TURN *** [Ad Qs 4h] [Ac]
*** RIVER *** [Ad Qs 4h Ac] [5d]
*** SHOW DOWN ***
Labba609: shows [2d 2h] (two pair, Aces and Deuces)
bigpond12: shows [Kh Qh] (two pair, Aces and Queens)
bigpond12 collected 90251 from pot
Labba609 finished the tournament in 9th place and received $48.04.
*** SUMMARY ***
Total pot 90251 | Rake 0=20
Board [Ad Qs 4h Ac 5d]
Seat 1: bigpond12 showed [Kh Qh] and won (90251) with two pair, Aces an=
d Queens
Seat 2: GUUUULP folded before Flop (didn't bet)
Seat 3: zBeanHeaDz (button) folded before Flop (didn't bet)
Seat 4: JJin91 (small blind) folded before Flop
Seat 5: Labba609 (big blind) showed [2d 2h] and lost with two pair, Ace=
s and Deuces
Seat 6: GoFish8686 folded before Flop (didn't bet)
Seat 7: PureWizardry folded before Flop (didn't bet)
Seat 8: Deuxexmachen folded before Flop (didn't bet)
Seat 9: MoeHawk101 folded before Flop (didn't bet)


*********** # 272 **************
PokerStars Hand #171488988591: Tournament #1648956629, $18.20+$1.80 USD=
 Hold'em No Limit - Level XXIII (2500/5000) - 2017/06/20 23:04:39 ET
Table '1648956629 1' 9-max Seat #4 is the button
Seat 1: bigpond12 (296533 in chips)=20
Seat 2: GUUUULP (58922 in chips)=20
Seat 3: zBeanHeaDz (70945 in chips)=20
Seat 4: JJin91 (189006 in chips)=20
Seat 6: GoFish8686 (118996 in chips)=20
Seat 7: PureWizardry (57016 in chips)=20
Seat 8: Deuxexmachen (88159 in chips)=20
Seat 9: MoeHawk101 (80423 in chips)=20
bigpond12: posts the ante 625
GUUUULP: posts the ante 625
zBeanHeaDz: posts the ante 625
JJin91: posts the ante 625
GoFish8686: posts the ante 625
PureWizardry: posts the ante 625
Deuxexmachen: posts the ante 625
MoeHawk101: posts the ante 625
GoFish8686: posts small blind 2500
PureWizardry: posts big blind 5000
*** HOLE CARDS ***
Dealt to JJin91 [Jd 8h]
Deuxexmachen: folds=20
MoeHawk101: raises 7000 to 12000
bigpond12: calls 12000
GUUUULP: folds=20
zBeanHeaDz: folds=20
JJin91: folds=20
GoFish8686: folds=20
PureWizardry: folds=20
*** FLOP *** [2s 2c 9c]
MoeHawk101: bets 18250
bigpond12: folds [Ad Ts]
Uncalled bet (18250) returned to MoeHawk101
MoeHawk101 collected 36500 from pot
MoeHawk101: doesn't show hand=20
*** SUMMARY ***
Total pot 36500 | Rake 0=20
Board [2s 2c 9c]
Seat 1: bigpond12 folded on the Flop
Seat 2: GUUUULP folded before Flop (didn't bet)
Seat 3: zBeanHeaDz folded before Flop (didn't bet)
Seat 4: JJin91 (button) folded before Flop (didn't bet)
Seat 6: GoFish8686 (small blind) folded before Flop
Seat 7: PureWizardry (big blind) folded before Flop
Seat 8: Deuxexmachen folded before Flop (didn't bet)
Seat 9: MoeHawk101 collected (36500)


*********** # 273 **************
PokerStars Hand #171488988794: Tournament #1648956629, $18.20+$1.80 USD=
 Hold'em No Limit - Level XXIII (2500/5000) - 2017/06/20 23:05:30 ET
Table '1648956629 1' 9-max Seat #6 is the button
Seat 1: bigpond12 (283908 in chips)=20
Seat 2: GUUUULP (58297 in chips)=20
Seat 3: zBeanHeaDz (70320 in chips)=20
Seat 4: JJin91 (188381 in chips)=20
Seat 6: GoFish8686 (115871 in chips)=20
Seat 7: PureWizardry (51391 in chips)=20
Seat 8: Deuxexmachen (87534 in chips)=20
Seat 9: MoeHawk101 (104298 in chips)=20
bigpond12: posts the ante 625
GUUUULP: posts the ante 625
zBeanHeaDz: posts the ante 625
JJin91: posts the ante 625
GoFish8686: posts the ante 625
PureWizardry: posts the ante 625
Deuxexmachen: posts the ante 625
MoeHawk101: posts the ante 625
PureWizardry: posts small blind 2500
Deuxexmachen: posts big blind 5000
*** HOLE CARDS ***
Dealt to JJin91 [Kc Qd]
MoeHawk101: folds=20
bigpond12: calls 5000
GUUUULP: folds=20
zBeanHeaDz: folds=20
JJin91 is disconnected=20
JJin91 is connected=20
JJin91 is disconnected=20
JJin91 is connected=20
JJin91: folds=20
GoFish8686: folds=20
PureWizardry: calls 2500
Deuxexmachen: checks=20
*** FLOP *** [3s Tc 9d]
PureWizardry: checks=20
Deuxexmachen: checks=20
bigpond12: bets 5000
PureWizardry: folds=20
Deuxexmachen: calls 5000
*** TURN *** [3s Tc 9d] [5h]
Deuxexmachen: checks=20
bigpond12: bets 5000
Deuxexmachen: calls 5000
*** RIVER *** [3s Tc 9d 5h] [9c]
Deuxexmachen: checks=20
bigpond12: checks=20
*** SHOW DOWN ***
Deuxexmachen: shows [Td 4c] (two pair, Tens and Nines)
bigpond12: mucks hand=20
Deuxexmachen collected 40000 from pot
*** SUMMARY ***
Total pot 40000 | Rake 0=20
Board [3s Tc 9d 5h 9c]
Seat 1: bigpond12 mucked [7d 7c]
Seat 2: GUUUULP folded before Flop (didn't bet)
Seat 3: zBeanHeaDz folded before Flop (didn't bet)
Seat 4: JJin91 folded before Flop (didn't bet)
Seat 6: GoFish8686 (button) folded before Flop (didn't bet)
Seat 7: PureWizardry (small blind) folded on the Flop
Seat 8: Deuxexmachen (big blind) showed [Td 4c] and won (40000) with tw=
o pair, Tens and Nines
Seat 9: MoeHawk101 folded before Flop (didn't bet)


*********** # 274 **************
PokerStars Hand #171488989001: Tournament #1648956629, $18.20+$1.80 USD=
 Hold'em No Limit - Level XXIII (2500/5000) - 2017/06/20 23:06:17 ET
Table '1648956629 1' 9-max Seat #7 is the button
Seat 1: bigpond12 (268283 in chips)=20
Seat 2: GUUUULP (57672 in chips)=20
Seat 3: zBeanHeaDz (69695 in chips)=20
Seat 4: JJin91 (187756 in chips)=20
Seat 6: GoFish8686 (115246 in chips)=20
Seat 7: PureWizardry (45766 in chips)=20
Seat 8: Deuxexmachen (111909 in chips)=20
Seat 9: MoeHawk101 (103673 in chips)=20
bigpond12: posts the ante 625
GUUUULP: posts the ante 625
zBeanHeaDz: posts the ante 625
JJin91: posts the ante 625
GoFish8686: posts the ante 625
PureWizardry: posts the ante 625
Deuxexmachen: posts the ante 625
MoeHawk101: posts the ante 625
Deuxexmachen: posts small blind 2500
MoeHawk101: posts big blind 5000
*** HOLE CARDS ***
Dealt to JJin91 [5h 9d]
bigpond12: raises 5000 to 10000
GUUUULP: folds=20
zBeanHeaDz: folds=20
JJin91: folds=20
GoFish8686: folds=20
PureWizardry: folds=20
Deuxexmachen: folds=20
MoeHawk101: folds=20
Uncalled bet (5000) returned to bigpond12
bigpond12 collected 17500 from pot
bigpond12: doesn't show hand=20
*** SUMMARY ***
Total pot 17500 | Rake 0=20
Seat 1: bigpond12 collected (17500)
Seat 2: GUUUULP folded before Flop (didn't bet)
Seat 3: zBeanHeaDz folded before Flop (didn't bet)
Seat 4: JJin91 folded before Flop (didn't bet)
Seat 6: GoFish8686 folded before Flop (didn't bet)
Seat 7: PureWizardry (button) folded before Flop (didn't bet)
Seat 8: Deuxexmachen (small blind) folded before Flop
Seat 9: MoeHawk101 (big blind) folded before Flop


*********** # 275 **************
PokerStars Hand #171488989211: Tournament #1648956629, $18.20+$1.80 USD=
 Hold'em No Limit - Level XXIII (2500/5000) - 2017/06/20 23:07:07 ET
Table '1648956629 1' 9-max Seat #8 is the button
Seat 1: bigpond12 (280158 in chips)=20
Seat 2: GUUUULP (57047 in chips)=20
Seat 3: zBeanHeaDz (69070 in chips)=20
Seat 4: JJin91 (187131 in chips)=20
Seat 6: GoFish8686 (114621 in chips)=20
Seat 7: PureWizardry (45141 in chips)=20
Seat 8: Deuxexmachen (108784 in chips)=20
Seat 9: MoeHawk101 (98048 in chips)=20
bigpond12: posts the ante 625
GUUUULP: posts the ante 625
zBeanHeaDz: posts the ante 625
JJin91: posts the ante 625
GoFish8686: posts the ante 625
PureWizardry: posts the ante 625
Deuxexmachen: posts the ante 625
MoeHawk101: posts the ante 625
MoeHawk101: posts small blind 2500
bigpond12: posts big blind 5000
*** HOLE CARDS ***
Dealt to JJin91 [Ts Kc]
GUUUULP: folds=20
zBeanHeaDz: folds=20
JJin91: folds=20
GoFish8686: folds=20
PureWizardry: folds=20
Deuxexmachen: folds=20
MoeHawk101: calls 2500
bigpond12: checks=20
*** FLOP *** [Ks 7s 4h]
MoeHawk101: checks=20
bigpond12: bets 5000
MoeHawk101: calls 5000
*** TURN *** [Ks 7s 4h] [5c]
MoeHawk101: checks=20
bigpond12: bets 10000
MoeHawk101: folds=20
Uncalled bet (10000) returned to bigpond12
bigpond12 collected 25000 from pot
bigpond12: doesn't show hand=20
*** SUMMARY ***
Total pot 25000 | Rake 0=20
Board [Ks 7s 4h 5c]
Seat 1: bigpond12 (big blind) collected (25000)
Seat 2: GUUUULP folded before Flop (didn't bet)
Seat 3: zBeanHeaDz folded before Flop (didn't bet)
Seat 4: JJin91 folded before Flop (didn't bet)
Seat 6: GoFish8686 folded before Flop (didn't bet)
Seat 7: PureWizardry folded before Flop (didn't bet)
Seat 8: Deuxexmachen (button) folded before Flop (didn't bet)
Seat 9: MoeHawk101 (small blind) folded on the Turn


*********** # 276 **************
PokerStars Hand #171488989401: Tournament #1648956629, $18.20+$1.80 USD=
 Hold'em No Limit - Level XXIII (2500/5000) - 2017/06/20 23:07:56 ET
Table '1648956629 1' 9-max Seat #9 is the button
Seat 1: bigpond12 (294533 in chips)=20
Seat 2: GUUUULP (56422 in chips)=20
Seat 3: zBeanHeaDz (68445 in chips)=20
Seat 4: JJin91 (186506 in chips)=20
Seat 6: GoFish8686 (113996 in chips)=20
Seat 7: PureWizardry (44516 in chips)=20
Seat 8: Deuxexmachen (108159 in chips)=20
Seat 9: MoeHawk101 (87423 in chips)=20
bigpond12: posts the ante 625
GUUUULP: posts the ante 625
zBeanHeaDz: posts the ante 625
JJin91: posts the ante 625
GoFish8686: posts the ante 625
PureWizardry: posts the ante 625
Deuxexmachen: posts the ante 625
MoeHawk101: posts the ante 625
bigpond12: posts small blind 2500
GUUUULP: posts big blind 5000
*** HOLE CARDS ***
Dealt to JJin91 [2c 7d]
zBeanHeaDz: folds=20
JJin91: folds=20
GoFish8686: folds=20
PureWizardry: folds=20
Deuxexmachen: raises 8555 to 13555
MoeHawk101: folds=20
bigpond12: folds=20
GUUUULP: folds=20
Uncalled bet (8555) returned to Deuxexmachen
Deuxexmachen collected 17500 from pot
Deuxexmachen: doesn't show hand=20
*** SUMMARY ***
Total pot 17500 | Rake 0=20
Seat 1: bigpond12 (small blind) folded before Flop
Seat 2: GUUUULP (big blind) folded before Flop
Seat 3: zBeanHeaDz folded before Flop (didn't bet)
Seat 4: JJin91 folded before Flop (didn't bet)
Seat 6: GoFish8686 folded before Flop (didn't bet)
Seat 7: PureWizardry folded before Flop (didn't bet)
Seat 8: Deuxexmachen collected (17500)
Seat 9: MoeHawk101 (button) folded before Flop (didn't bet)


*********** # 277 **************
PokerStars Hand #171488989530: Tournament #1648956629, $18.20+$1.80 USD=
 Hold'em No Limit - Level XXIII (2500/5000) - 2017/06/20 23:08:27 ET
Table '1648956629 1' 9-max Seat #1 is the button
Seat 1: bigpond12 (291408 in chips)=20
Seat 2: GUUUULP (50797 in chips)=20
Seat 3: zBeanHeaDz (67820 in chips)=20
Seat 4: JJin91 (185881 in chips)=20
Seat 6: GoFish8686 (113371 in chips)=20
Seat 7: PureWizardry (43891 in chips)=20
Seat 8: Deuxexmachen (120034 in chips)=20
Seat 9: MoeHawk101 (86798 in chips)=20
bigpond12: posts the ante 625
GUUUULP: posts the ante 625
zBeanHeaDz: posts the ante 625
JJin91: posts the ante 625
GoFish8686: posts the ante 625
PureWizardry: posts the ante 625
Deuxexmachen: posts the ante 625
MoeHawk101: posts the ante 625
GUUUULP: posts small blind 2500
zBeanHeaDz: posts big blind 5000
*** HOLE CARDS ***
Dealt to JJin91 [Kc 4c]
JJin91: folds=20
GoFish8686: raises 10000 to 15000
PureWizardry: folds=20
Deuxexmachen: folds=20
MoeHawk101: folds=20
bigpond12: folds=20
GUUUULP: folds=20
zBeanHeaDz: folds=20
Uncalled bet (10000) returned to GoFish8686
GoFish8686 collected 17500 from pot
GoFish8686: doesn't show hand=20
*** SUMMARY ***
Total pot 17500 | Rake 0=20
Seat 1: bigpond12 (button) folded before Flop (didn't bet)
Seat 2: GUUUULP (small blind) folded before Flop
Seat 3: zBeanHeaDz (big blind) folded before Flop
Seat 4: JJin91 folded before Flop (didn't bet)
Seat 6: GoFish8686 collected (17500)
Seat 7: PureWizardry folded before Flop (didn't bet)
Seat 8: Deuxexmachen folded before Flop (didn't bet)
Seat 9: MoeHawk101 folded before Flop (didn't bet)


*********** # 278 **************
PokerStars Hand #171488989668: Tournament #1648956629, $18.20+$1.80 USD=
 Hold'em No Limit - Level XXIII (2500/5000) - 2017/06/20 23:08:59 ET
Table '1648956629 1' 9-max Seat #2 is the button
Seat 1: bigpond12 (290783 in chips)=20
Seat 2: GUUUULP (47672 in chips)=20
Seat 3: zBeanHeaDz (62195 in chips)=20
Seat 4: JJin91 (185256 in chips)=20
Seat 6: GoFish8686 (125246 in chips)=20
Seat 7: PureWizardry (43266 in chips)=20
Seat 8: Deuxexmachen (119409 in chips)=20
Seat 9: MoeHawk101 (86173 in chips)=20
bigpond12: posts the ante 625
GUUUULP: posts the ante 625
zBeanHeaDz: posts the ante 625
JJin91: posts the ante 625
GoFish8686: posts the ante 625
PureWizardry: posts the ante 625
Deuxexmachen: posts the ante 625
MoeHawk101: posts the ante 625
zBeanHeaDz: posts small blind 2500
JJin91: posts big blind 5000
*** HOLE CARDS ***
Dealt to JJin91 [Ks 6c]
GoFish8686: folds=20
PureWizardry: folds=20
Deuxexmachen: folds=20
MoeHawk101: raises 5000 to 10000
bigpond12: calls 10000
GUUUULP: folds=20
zBeanHeaDz: folds=20
JJin91: calls 5000
*** FLOP *** [3c 8d Th]
JJin91: checks=20
MoeHawk101: checks=20
bigpond12: checks=20
*** TURN *** [3c 8d Th] [Qh]
JJin91: checks=20
MoeHawk101: bets 15000
bigpond12: calls 15000
JJin91: folds=20
*** RIVER *** [3c 8d Th Qh] [2c]
MoeHawk101: bets 40000
bigpond12: calls 40000
*** SHOW DOWN ***
MoeHawk101: shows [4s 5s] (high card Queen)
bigpond12: shows [6d 6s] (a pair of Sixes)
bigpond12 collected 147500 from pot
*** SUMMARY ***
Total pot 147500 | Rake 0=20
Board [3c 8d Th Qh 2c]
Seat 1: bigpond12 showed [6d 6s] and won (147500) with a pair of Sixes
Seat 2: GUUUULP (button) folded before Flop (didn't bet)
Seat 3: zBeanHeaDz (small blind) folded before Flop
Seat 4: JJin91 (big blind) folded on the Turn
Seat 6: GoFish8686 folded before Flop (didn't bet)
Seat 7: PureWizardry folded before Flop (didn't bet)
Seat 8: Deuxexmachen folded before Flop (didn't bet)
Seat 9: MoeHawk101 showed [4s 5s] and lost with high card Queen


*********** # 279 **************
PokerStars Hand #171488989950: Tournament #1648956629, $18.20+$1.80 USD=
 Hold'em No Limit - Level XXIII (2500/5000) - 2017/06/20 23:10:08 ET
Table '1648956629 1' 9-max Seat #3 is the button
Seat 1: bigpond12 (372658 in chips)=20
Seat 2: GUUUULP (47047 in chips)=20
Seat 3: zBeanHeaDz (59070 in chips)=20
Seat 4: JJin91 (174631 in chips)=20
Seat 6: GoFish8686 (124621 in chips)=20
Seat 7: PureWizardry (42641 in chips)=20
Seat 8: Deuxexmachen (118784 in chips)=20
Seat 9: MoeHawk101 (20548 in chips)=20
bigpond12: posts the ante 625
GUUUULP: posts the ante 625
zBeanHeaDz: posts the ante 625
JJin91: posts the ante 625
GoFish8686: posts the ante 625
PureWizardry: posts the ante 625
Deuxexmachen: posts the ante 625
MoeHawk101: posts the ante 625
JJin91: posts small blind 2500
GoFish8686: posts big blind 5000
*** HOLE CARDS ***
Dealt to JJin91 [6d 2c]
PureWizardry: folds=20
Deuxexmachen: folds=20
MoeHawk101: raises 14923 to 19923 and is all-in
bigpond12: folds=20
GUUUULP: folds=20
zBeanHeaDz: folds=20
JJin91: folds=20
GoFish8686: folds=20
Uncalled bet (14923) returned to MoeHawk101
MoeHawk101 collected 17500 from pot
*** SUMMARY ***
Total pot 17500 | Rake 0=20
Seat 1: bigpond12 folded before Flop (didn't bet)
Seat 2: GUUUULP folded before Flop (didn't bet)
Seat 3: zBeanHeaDz (button) folded before Flop (didn't bet)
Seat 4: JJin91 (small blind) folded before Flop
Seat 6: GoFish8686 (big blind) folded before Flop
Seat 7: PureWizardry folded before Flop (didn't bet)
Seat 8: Deuxexmachen folded before Flop (didn't bet)
Seat 9: MoeHawk101 collected (17500)


*********** # 280 **************
PokerStars Hand #171489514930: Tournament #1648956629, $18.20+$1.80 USD=
 Hold'em No Limit - Level XXIII (2500/5000) - 2017/06/20 23:10:47 ET
Table '1648956629 1' 9-max Seat #4 is the button
Seat 1: bigpond12 (372033 in chips)=20
Seat 2: GUUUULP (46422 in chips)=20
Seat 3: zBeanHeaDz (58445 in chips)=20
Seat 4: JJin91 (171506 in chips)=20
Seat 6: GoFish8686 (118996 in chips)=20
Seat 7: PureWizardry (42016 in chips)=20
Seat 8: Deuxexmachen (118159 in chips)=20
Seat 9: MoeHawk101 (32423 in chips)=20
bigpond12: posts the ante 625
GUUUULP: posts the ante 625
zBeanHeaDz: posts the ante 625
JJin91: posts the ante 625
GoFish8686: posts the ante 625
PureWizardry: posts the ante 625
Deuxexmachen: posts the ante 625
MoeHawk101: posts the ante 625
GoFish8686: posts small blind 2500
PureWizardry: posts big blind 5000
*** HOLE CARDS ***
Dealt to JJin91 [8c Jh]
Deuxexmachen: folds=20
MoeHawk101: folds=20
bigpond12: folds=20
GUUUULP: folds=20
zBeanHeaDz: raises 52820 to 57820 and is all-in
JJin91: folds=20
GoFish8686: folds=20
PureWizardry: folds=20
Uncalled bet (52820) returned to zBeanHeaDz
zBeanHeaDz collected 17500 from pot
zBeanHeaDz: doesn't show hand=20
*** SUMMARY ***
Total pot 17500 | Rake 0=20
Seat 1: bigpond12 folded before Flop (didn't bet)
Seat 2: GUUUULP folded before Flop (didn't bet)
Seat 3: zBeanHeaDz collected (17500)
Seat 4: JJin91 (button) folded before Flop (didn't bet)
Seat 6: GoFish8686 (small blind) folded before Flop
Seat 7: PureWizardry (big blind) folded before Flop
Seat 8: Deuxexmachen folded before Flop (didn't bet)
Seat 9: MoeHawk101 folded before Flop (didn't bet)


*********** # 281 **************
PokerStars Hand #171489515054: Tournament #1648956629, $18.20+$1.80 USD=
 Hold'em No Limit - Level XXIII (2500/5000) - 2017/06/20 23:11:19 ET
Table '1648956629 1' 9-max Seat #6 is the button
Seat 1: bigpond12 (371408 in chips)=20
Seat 2: GUUUULP (45797 in chips)=20
Seat 3: zBeanHeaDz (70320 in chips)=20
Seat 4: JJin91 (170881 in chips)=20
Seat 6: GoFish8686 (115871 in chips)=20
Seat 7: PureWizardry (36391 in chips)=20
Seat 8: Deuxexmachen (117534 in chips)=20
Seat 9: MoeHawk101 (31798 in chips)=20
bigpond12: posts the ante 625
GUUUULP: posts the ante 625
zBeanHeaDz: posts the ante 625
JJin91: posts the ante 625
GoFish8686: posts the ante 625
PureWizardry: posts the ante 625
Deuxexmachen: posts the ante 625
MoeHawk101: posts the ante 625
PureWizardry: posts small blind 2500
Deuxexmachen: posts big blind 5000
*** HOLE CARDS ***
Dealt to JJin91 [3s 5d]
MoeHawk101: raises 26173 to 31173 and is all-in
bigpond12: folds=20
GUUUULP: folds=20
zBeanHeaDz: folds=20
JJin91: folds=20
GoFish8686: folds=20
PureWizardry: folds=20
Deuxexmachen: folds=20
Uncalled bet (26173) returned to MoeHawk101
MoeHawk101 collected 17500 from pot
MoeHawk101: doesn't show hand=20
*** SUMMARY ***
Total pot 17500 | Rake 0=20
Seat 1: bigpond12 folded before Flop (didn't bet)
Seat 2: GUUUULP folded before Flop (didn't bet)
Seat 3: zBeanHeaDz folded before Flop (didn't bet)
Seat 4: JJin91 folded before Flop (didn't bet)
Seat 6: GoFish8686 (button) folded before Flop (didn't bet)
Seat 7: PureWizardry (small blind) folded before Flop
Seat 8: Deuxexmachen (big blind) folded before Flop
Seat 9: MoeHawk101 collected (17500)


*********** # 282 **************
PokerStars Hand #171489515158: Tournament #1648956629, $18.20+$1.80 USD=
 Hold'em No Limit - Level XXIII (2500/5000) - 2017/06/20 23:11:44 ET
Table '1648956629 1' 9-max Seat #7 is the button
Seat 1: bigpond12 (370783 in chips)=20
Seat 2: GUUUULP (45172 in chips)=20
Seat 3: zBeanHeaDz (69695 in chips)=20
Seat 4: JJin91 (170256 in chips)=20
Seat 6: GoFish8686 (115246 in chips)=20
Seat 7: PureWizardry (33266 in chips)=20
Seat 8: Deuxexmachen (111909 in chips)=20
Seat 9: MoeHawk101 (43673 in chips)=20
bigpond12: posts the ante 625
GUUUULP: posts the ante 625
zBeanHeaDz: posts the ante 625
JJin91: posts the ante 625
GoFish8686: posts the ante 625
PureWizardry: posts the ante 625
Deuxexmachen: posts the ante 625
MoeHawk101: posts the ante 625
Deuxexmachen: posts small blind 2500
MoeHawk101: posts big blind 5000
*** HOLE CARDS ***
Dealt to JJin91 [Js Jd]
bigpond12: folds=20
GUUUULP: folds=20
zBeanHeaDz: folds=20
JJin91: raises 5950 to 10950
GoFish8686: folds=20
PureWizardry: raises 21691 to 32641 and is all-in
Deuxexmachen: folds=20
MoeHawk101: folds=20
JJin91: calls 21691
*** FLOP *** [8s 5h Kc]
*** TURN *** [8s 5h Kc] [6s]
*** RIVER *** [8s 5h Kc 6s] [5d]
*** SHOW DOWN ***
JJin91: shows [Js Jd] (two pair, Jacks and Fives)
PureWizardry: shows [Ac Qd] (a pair of Fives)
JJin91 collected 77782 from pot
PureWizardry finished the tournament in 8th place and received $61.15.
*** SUMMARY ***
Total pot 77782 | Rake 0=20
Board [8s 5h Kc 6s 5d]
Seat 1: bigpond12 folded before Flop (didn't bet)
Seat 2: GUUUULP folded before Flop (didn't bet)
Seat 3: zBeanHeaDz folded before Flop (didn't bet)
Seat 4: JJin91 showed [Js Jd] and won (77782) with two pair, Jacks and =
Fives
Seat 6: GoFish8686 folded before Flop (didn't bet)
Seat 7: PureWizardry (button) showed [Ac Qd] and lost with a pair of Fi=
ves
Seat 8: Deuxexmachen (small blind) folded before Flop
Seat 9: MoeHawk101 (big blind) folded before Flop


*********** # 283 **************
PokerStars Hand #171489515356: Tournament #1648956629, $18.20+$1.80 USD=
 Hold'em No Limit - Level XXIII (2500/5000) - 2017/06/20 23:12:27 ET
Table '1648956629 1' 9-max Seat #8 is the button
Seat 1: bigpond12 (370158 in chips)=20
Seat 2: GUUUULP (44547 in chips)=20
Seat 3: zBeanHeaDz (69070 in chips)=20
Seat 4: JJin91 (214772 in chips)=20
Seat 6: GoFish8686 (114621 in chips)=20
Seat 8: Deuxexmachen (108784 in chips)=20
Seat 9: MoeHawk101 (38048 in chips)=20
bigpond12: posts the ante 625
GUUUULP: posts the ante 625
zBeanHeaDz: posts the ante 625
JJin91: posts the ante 625
GoFish8686: posts the ante 625
Deuxexmachen: posts the ante 625
MoeHawk101: posts the ante 625
MoeHawk101: posts small blind 2500
bigpond12: posts big blind 5000
*** HOLE CARDS ***
Dealt to JJin91 [Kd 7s]
GUUUULP: raises 38922 to 43922 and is all-in
zBeanHeaDz: folds=20
JJin91: folds=20
GoFish8686: folds=20
Deuxexmachen: folds=20
MoeHawk101: calls 34923 and is all-in
bigpond12: calls 38922
*** FLOP *** [9h Td Ks]
*** TURN *** [9h Td Ks] [8h]
*** RIVER *** [9h Td Ks 8h] [3s]
*** SHOW DOWN ***
bigpond12: shows [Js Ac] (high card Ace)
GUUUULP: shows [As Jd] (high card Ace)
bigpond12 collected 6499 from side pot
GUUUULP collected 6499 from side pot
MoeHawk101: shows [3h Ah] (a pair of Threes)
MoeHawk101 collected 116644 from main pot
*** SUMMARY ***
Total pot 129642 Main pot 116644. Side pot 12998. | Rake 0=20
Board [9h Td Ks 8h 3s]
Seat 1: bigpond12 (big blind) showed [Js Ac] and won (6499) with high c=
ard Ace
Seat 2: GUUUULP showed [As Jd] and won (6499) with high card Ace
Seat 3: zBeanHeaDz folded before Flop (didn't bet)
Seat 4: JJin91 folded before Flop (didn't bet)
Seat 6: GoFish8686 folded before Flop (didn't bet)
Seat 8: Deuxexmachen (button) folded before Flop (didn't bet)
Seat 9: MoeHawk101 (small blind) showed [3h Ah] and won (116644) with a=
 pair of Threes


*********** # 284 **************
PokerStars Hand #171489515521: Tournament #1648956629, $18.20+$1.80 USD=
 Hold'em No Limit - Level XXIII (2500/5000) - 2017/06/20 23:13:03 ET
Table '1648956629 1' 9-max Seat #9 is the button
Seat 1: bigpond12 (332110 in chips)=20
Seat 2: GUUUULP (6499 in chips)=20
Seat 3: zBeanHeaDz (68445 in chips)=20
Seat 4: JJin91 (214147 in chips)=20
Seat 6: GoFish8686 (113996 in chips)=20
Seat 8: Deuxexmachen (108159 in chips)=20
Seat 9: MoeHawk101 (116644 in chips)=20
bigpond12: posts the ante 625
GUUUULP: posts the ante 625
zBeanHeaDz: posts the ante 625
JJin91: posts the ante 625
GoFish8686: posts the ante 625
Deuxexmachen: posts the ante 625
MoeHawk101: posts the ante 625
bigpond12: posts small blind 2500
GUUUULP: posts big blind 5000
*** HOLE CARDS ***
Dealt to JJin91 [4s Th]
zBeanHeaDz: folds=20
JJin91: folds=20
MoeHawk101 said, ":))))))"
GoFish8686: folds=20
Deuxexmachen: raises 5000 to 10000
GUUUULP said, "i dont think a3 is a call :)"
MoeHawk101: calls 10000
bigpond12: raises 20000 to 30000
GUUUULP: calls 874 and is all-in
Deuxexmachen: folds=20
MoeHawk101: folds=20
Uncalled bet (20000) returned to bigpond12
*** FLOP *** [2h 4c 8s]
*** TURN *** [2h 4c 8s] [Td]
*** RIVER *** [2h 4c 8s Td] [Kh]
*** SHOW DOWN ***
bigpond12: shows [4h 4d] (three of a kind, Fours)
bigpond12 collected 12378 from side pot
GUUUULP: shows [Kd Js] (a pair of Kings)
bigpond12 collected 27871 from main pot
GUUUULP finished the tournament in 7th place and received $74.25.
*** SUMMARY ***
Total pot 40249 Main pot 27871. Side pot 12378. | Rake 0=20
Board [2h 4c 8s Td Kh]
Seat 1: bigpond12 (small blind) showed [4h 4d] and won (40249) with thr=
ee of a kind, Fours
Seat 2: GUUUULP (big blind) showed [Kd Js] and lost with a pair of Kings
Seat 3: zBeanHeaDz folded before Flop (didn't bet)
Seat 4: JJin91 folded before Flop (didn't bet)
Seat 6: GoFish8686 folded before Flop (didn't bet)
Seat 8: Deuxexmachen folded before Flop
Seat 9: MoeHawk101 (button) folded before Flop


*********** # 285 **************
PokerStars Hand #171489515748: Tournament #1648956629, $18.20+$1.80 USD=
 Hold'em No Limit - Level XXIV (3000/6000) - 2017/06/20 23:13:50 ET
Table '1648956629 1' 9-max Seat #1 is the button
Seat 1: bigpond12 (361734 in chips)=20
Seat 3: zBeanHeaDz (67820 in chips)=20
Seat 4: JJin91 (213522 in chips)=20
Seat 6: GoFish8686 (113371 in chips)=20
Seat 8: Deuxexmachen (97534 in chips)=20
Seat 9: MoeHawk101 (106019 in chips)=20
bigpond12: posts the ante 750
zBeanHeaDz: posts the ante 750
JJin91: posts the ante 750
GoFish8686: posts the ante 750
Deuxexmachen: posts the ante 750
MoeHawk101: posts the ante 750
zBeanHeaDz: posts small blind 3000
JJin91: posts big blind 6000
*** HOLE CARDS ***
Dealt to JJin91 [8s 5d]
GoFish8686: folds=20
Deuxexmachen: folds=20
MoeHawk101: raises 12000 to 18000
bigpond12: calls 18000
zBeanHeaDz: folds=20
JJin91: folds=20
*** FLOP *** [4c Td Ah]
MoeHawk101: checks=20
bigpond12: checks=20
*** TURN *** [4c Td Ah] [9h]
MoeHawk101: checks=20
bigpond12: bets 12000
MoeHawk101: calls 12000
*** RIVER *** [4c Td Ah 9h] [9c]
MoeHawk101: checks=20
bigpond12: checks=20
*** SHOW DOWN ***
MoeHawk101: shows [7c 7s] (two pair, Nines and Sevens)
bigpond12: shows [8h Th] (two pair, Tens and Nines)
bigpond12 collected 73500 from pot
*** SUMMARY ***
Total pot 73500 | Rake 0=20
Board [4c Td Ah 9h 9c]
Seat 1: bigpond12 (button) showed [8h Th] and won (73500) with two pair=
, Tens and Nines
Seat 3: zBeanHeaDz (small blind) folded before Flop
Seat 4: JJin91 (big blind) folded before Flop
Seat 6: GoFish8686 folded before Flop (didn't bet)
Seat 8: Deuxexmachen folded before Flop (didn't bet)
Seat 9: MoeHawk101 showed [7c 7s] and lost with two pair, Nines and Sev=
ens


*********** # 286 **************
PokerStars Hand #171489515963: Tournament #1648956629, $18.20+$1.80 USD=
 Hold'em No Limit - Level XXIV (3000/6000) - 2017/06/20 23:14:35 ET
Table '1648956629 1' 9-max Seat #3 is the button
Seat 1: bigpond12 (404484 in chips)=20
Seat 3: zBeanHeaDz (64070 in chips)=20
Seat 4: JJin91 (206772 in chips)=20
Seat 6: GoFish8686 (112621 in chips)=20
Seat 8: Deuxexmachen (96784 in chips)=20
Seat 9: MoeHawk101 (75269 in chips)=20
bigpond12: posts the ante 750
zBeanHeaDz: posts the ante 750
JJin91: posts the ante 750
GoFish8686: posts the ante 750
Deuxexmachen: posts the ante 750
MoeHawk101: posts the ante 750
JJin91: posts small blind 3000
GoFish8686: posts big blind 6000
*** HOLE CARDS ***
Dealt to JJin91 [8c 7d]
Deuxexmachen: folds=20
MoeHawk101: raises 12000 to 18000
bigpond12: folds=20
zBeanHeaDz: raises 45320 to 63320 and is all-in
JJin91: folds=20
GoFish8686: raises 48551 to 111871 and is all-in
MoeHawk101: calls 56519 and is all-in
Uncalled bet (37352) returned to GoFish8686
*** FLOP *** [5s Qh 6s]
*** TURN *** [5s Qh 6s] [Kc]
*** RIVER *** [5s Qh 6s Kc] [9s]
*** SHOW DOWN ***
GoFish8686: shows [As Kh] (a pair of Kings)
MoeHawk101: shows [9d 9h] (three of a kind, Nines)
MoeHawk101 collected 22398 from side pot
zBeanHeaDz: shows [Td Th] (a pair of Tens)
MoeHawk101 collected 197460 from main pot
zBeanHeaDz finished the tournament in 6th place and received $91.72.
*** SUMMARY ***
Total pot 219858 Main pot 197460. Side pot 22398. | Rake 0=20
Board [5s Qh 6s Kc 9s]
Seat 1: bigpond12 folded before Flop (didn't bet)
Seat 3: zBeanHeaDz (button) showed [Td Th] and lost with a pair of Tens
Seat 4: JJin91 (small blind) folded before Flop
Seat 6: GoFish8686 (big blind) showed [As Kh] and lost with a pair of K=
ings
Seat 8: Deuxexmachen folded before Flop (didn't bet)
Seat 9: MoeHawk101 showed [9d 9h] and won (219858) with three of a kind=
, Nines


*********** # 287 **************
PokerStars Hand #171489516086: Tournament #1648956629, $18.20+$1.80 USD=
 Hold'em No Limit - Level XXIV (3000/6000) - 2017/06/20 23:15:05 ET
Table '1648956629 1' 9-max Seat #4 is the button
Seat 1: bigpond12 (403734 in chips)=20
Seat 4: JJin91 (203022 in chips)=20
Seat 6: GoFish8686 (37352 in chips)=20
Seat 8: Deuxexmachen (96034 in chips)=20
Seat 9: MoeHawk101 (219858 in chips)=20
bigpond12: posts the ante 750
JJin91: posts the ante 750
GoFish8686: posts the ante 750
Deuxexmachen: posts the ante 750
MoeHawk101: posts the ante 750
GoFish8686: posts small blind 3000
Deuxexmachen: posts big blind 6000
*** HOLE CARDS ***
Dealt to JJin91 [5h 2c]
MoeHawk101: folds=20
bigpond12: folds=20
JJin91: folds=20
GoFish8686: raises 30602 to 36602 and is all-in
Deuxexmachen: calls 30602
*** FLOP *** [9h Kd Ad]
*** TURN *** [9h Kd Ad] [Td]
*** RIVER *** [9h Kd Ad Td] [3h]
*** SHOW DOWN ***
GoFish8686: shows [7h Ts] (a pair of Tens)
Deuxexmachen: shows [Qd Ah] (a pair of Aces)
Deuxexmachen collected 76954 from pot
GoFish8686 finished the tournament in 5th place and received $113.56.
*** SUMMARY ***
Total pot 76954 | Rake 0=20
Board [9h Kd Ad Td 3h]
Seat 1: bigpond12 folded before Flop (didn't bet)
Seat 4: JJin91 (button) folded before Flop (didn't bet)
Seat 6: GoFish8686 (small blind) showed [7h Ts] and lost with a pair of=
 Tens
Seat 8: Deuxexmachen (big blind) showed [Qd Ah] and won (76954) with a =
pair of Aces
Seat 9: MoeHawk101 folded before Flop (didn't bet)


*********** # 288 **************
PokerStars Hand #171489516232: Tournament #1648956629, $18.20+$1.80 USD=
 Hold'em No Limit - Level XXIV (3000/6000) - 2017/06/20 23:15:41 ET
Table '1648956629 1' 9-max Seat #8 is the button
Seat 1: bigpond12 (402984 in chips)=20
Seat 4: JJin91 (202272 in chips)=20
Seat 8: Deuxexmachen (135636 in chips)=20
Seat 9: MoeHawk101 (219108 in chips)=20
bigpond12: posts the ante 750
JJin91: posts the ante 750
Deuxexmachen: posts the ante 750
MoeHawk101: posts the ante 750
MoeHawk101: posts small blind 3000
bigpond12: posts big blind 6000
*** HOLE CARDS ***
Dealt to JJin91 [4c Qs]
JJin91: folds=20
Deuxexmachen: folds=20
MoeHawk101: calls 3000
bigpond12: raises 12000 to 18000
MoeHawk101: calls 12000
*** FLOP *** [Jh Td 7h]
MoeHawk101: checks=20
bigpond12: bets 12000
MoeHawk101: calls 12000
*** TURN *** [Jh Td 7h] [8h]
MoeHawk101: checks=20
bigpond12: checks=20
*** RIVER *** [Jh Td 7h 8h] [7c]
MoeHawk101: checks=20
bigpond12: bets 24000
MoeHawk101: calls 24000
*** SHOW DOWN ***
bigpond12: shows [9d Ad] (a straight, Seven to Jack)
MoeHawk101: mucks hand=20
bigpond12 collected 111000 from pot
*** SUMMARY ***
Total pot 111000 | Rake 0=20
Board [Jh Td 7h 8h 7c]
Seat 1: bigpond12 (big blind) showed [9d Ad] and won (111000) with a st=
raight, Seven to Jack
Seat 4: JJin91 folded before Flop (didn't bet)
Seat 8: Deuxexmachen (button) folded before Flop (didn't bet)
Seat 9: MoeHawk101 (small blind) mucked [Jd 4d]


*********** # 289 **************
PokerStars Hand #171489516399: Tournament #1648956629, $18.20+$1.80 USD=
 Hold'em No Limit - Level XXIV (3000/6000) - 2017/06/20 23:16:18 ET
Table '1648956629 1' 9-max Seat #9 is the button
Seat 1: bigpond12 (459234 in chips)=20
Seat 4: JJin91 (201522 in chips)=20
Seat 8: Deuxexmachen (134886 in chips)=20
Seat 9: MoeHawk101 (164358 in chips)=20
bigpond12: posts the ante 750
JJin91: posts the ante 750
Deuxexmachen: posts the ante 750
MoeHawk101: posts the ante 750
bigpond12: posts small blind 3000
JJin91: posts big blind 6000
*** HOLE CARDS ***
Dealt to JJin91 [5h Th]
Deuxexmachen: folds=20
MoeHawk101 said, "always run like this ?"
MoeHawk101: raises 6000 to 12000
bigpond12: calls 9000
JJin91: calls 6000
*** FLOP *** [Qh 2s 9d]
bigpond12: checks=20
JJin91: bets 14430
MoeHawk101: folds=20
bigpond12: folds=20
Uncalled bet (14430) returned to JJin91
JJin91 collected 39000 from pot
JJin91: doesn't show hand=20
*** SUMMARY ***
Total pot 39000 | Rake 0=20
Board [Qh 2s 9d]
Seat 1: bigpond12 (small blind) folded on the Flop
Seat 4: JJin91 (big blind) collected (39000)
Seat 8: Deuxexmachen folded before Flop (didn't bet)
Seat 9: MoeHawk101 (button) folded on the Flop


*********** # 290 **************
PokerStars Hand #171489516553: Tournament #1648956629, $18.20+$1.80 USD=
 Hold'em No Limit - Level XXIV (3000/6000) - 2017/06/20 23:16:53 ET
Table '1648956629 1' 9-max Seat #1 is the button
Seat 1: bigpond12 (446484 in chips)=20
Seat 4: JJin91 (227772 in chips)=20
Seat 8: Deuxexmachen (134136 in chips)=20
Seat 9: MoeHawk101 (151608 in chips)=20
bigpond12: posts the ante 750
JJin91: posts the ante 750
Deuxexmachen: posts the ante 750
MoeHawk101: posts the ante 750
JJin91: posts small blind 3000
Deuxexmachen: posts big blind 6000
*** HOLE CARDS ***
Dealt to JJin91 [5d 8s]
MoeHawk101: folds=20
bigpond12: calls 6000
JJin91: folds=20
Deuxexmachen: checks=20
*** FLOP *** [Ac 6s Ah]
Deuxexmachen: checks=20
bigpond12: bets 6000
Deuxexmachen: folds=20
Uncalled bet (6000) returned to bigpond12
bigpond12 collected 18000 from pot
bigpond12: doesn't show hand=20
*** SUMMARY ***
Total pot 18000 | Rake 0=20
Board [Ac 6s Ah]
Seat 1: bigpond12 (button) collected (18000)
Seat 4: JJin91 (small blind) folded before Flop
Seat 8: Deuxexmachen (big blind) folded on the Flop
Seat 9: MoeHawk101 folded before Flop (didn't bet)


*********** # 291 **************
PokerStars Hand #171489516733: Tournament #1648956629, $18.20+$1.80 USD=
 Hold'em No Limit - Level XXIV (3000/6000) - 2017/06/20 23:17:30 ET
Table '1648956629 1' 9-max Seat #4 is the button
Seat 1: bigpond12 (457734 in chips)=20
Seat 4: JJin91 (224022 in chips)=20
Seat 8: Deuxexmachen (127386 in chips)=20
Seat 9: MoeHawk101 (150858 in chips)=20
bigpond12: posts the ante 750
JJin91: posts the ante 750
Deuxexmachen: posts the ante 750
MoeHawk101: posts the ante 750
Deuxexmachen: posts small blind 3000
MoeHawk101: posts big blind 6000
*** HOLE CARDS ***
Dealt to JJin91 [3s Jc]
bigpond12: folds=20
JJin91: folds=20
Deuxexmachen: calls 3000
MoeHawk101: raises 12000 to 18000
Deuxexmachen: folds=20
Uncalled bet (12000) returned to MoeHawk101
MoeHawk101 collected 15000 from pot
MoeHawk101: doesn't show hand=20
*** SUMMARY ***
Total pot 15000 | Rake 0=20
Seat 1: bigpond12 folded before Flop (didn't bet)
Seat 4: JJin91 (button) folded before Flop (didn't bet)
Seat 8: Deuxexmachen (small blind) folded before Flop
Seat 9: MoeHawk101 (big blind) collected (15000)


*********** # 292 **************
PokerStars Hand #171489516809: Tournament #1648956629, $18.20+$1.80 USD=
 Hold'em No Limit - Level XXIV (3000/6000) - 2017/06/20 23:17:48 ET
Table '1648956629 1' 9-max Seat #8 is the button
Seat 1: bigpond12 (456984 in chips)=20
Seat 4: JJin91 (223272 in chips)=20
Seat 8: Deuxexmachen (120636 in chips)=20
Seat 9: MoeHawk101 (159108 in chips)=20
bigpond12: posts the ante 750
JJin91: posts the ante 750
Deuxexmachen: posts the ante 750
MoeHawk101: posts the ante 750
MoeHawk101: posts small blind 3000
bigpond12: posts big blind 6000
*** HOLE CARDS ***
Dealt to JJin91 [Ad 4d]
JJin91: raises 7140 to 13140
Deuxexmachen: folds=20
MoeHawk101: folds=20
bigpond12: folds=20
Uncalled bet (7140) returned to JJin91
JJin91 collected 18000 from pot
JJin91: doesn't show hand=20
*** SUMMARY ***
Total pot 18000 | Rake 0=20
Seat 1: bigpond12 (big blind) folded before Flop
Seat 4: JJin91 collected (18000)
Seat 8: Deuxexmachen (button) folded before Flop (didn't bet)
Seat 9: MoeHawk101 (small blind) folded before Flop


*********** # 293 **************
PokerStars Hand #171489516853: Tournament #1648956629, $18.20+$1.80 USD=
 Hold'em No Limit - Level XXIV (3000/6000) - 2017/06/20 23:17:59 ET
Table '1648956629 1' 9-max Seat #9 is the button
Seat 1: bigpond12 (450234 in chips)=20
Seat 4: JJin91 (234522 in chips)=20
Seat 8: Deuxexmachen (119886 in chips)=20
Seat 9: MoeHawk101 (155358 in chips)=20
bigpond12: posts the ante 750
JJin91: posts the ante 750
Deuxexmachen: posts the ante 750
MoeHawk101: posts the ante 750
bigpond12: posts small blind 3000
JJin91: posts big blind 6000
*** HOLE CARDS ***
Dealt to JJin91 [Jh As]
Deuxexmachen: raises 9555 to 15555
MoeHawk101: folds=20
bigpond12: calls 12555
JJin91: calls 9555
*** FLOP *** [3s 2c 8d]
bigpond12: checks=20
JJin91: checks=20
Deuxexmachen: bets 12000
bigpond12: folds=20
JJin91: calls 12000
*** TURN *** [3s 2c 8d] [Ad]
JJin91: checks=20
Deuxexmachen: checks=20
*** RIVER *** [3s 2c 8d Ad] [3d]
JJin91: checks=20
Deuxexmachen: checks=20
*** SHOW DOWN ***
JJin91: shows [Jh As] (two pair, Aces and Threes)
Deuxexmachen: mucks hand=20
JJin91 collected 73665 from pot
*** SUMMARY ***
Total pot 73665 | Rake 0=20
Board [3s 2c 8d Ad 3d]
Seat 1: bigpond12 (small blind) folded on the Flop
Seat 4: JJin91 (big blind) showed [Jh As] and won (73665) with two pair=
, Aces and Threes
Seat 8: Deuxexmachen mucked [Jd Tc]
Seat 9: MoeHawk101 (button) folded before Flop (didn't bet)


*********** # 294 **************
PokerStars Hand #171489517112: Tournament #1648956629, $18.20+$1.80 USD=
 Hold'em No Limit - Level XXIV (3000/6000) - 2017/06/20 23:18:59 ET
Table '1648956629 1' 9-max Seat #1 is the button
Seat 1: bigpond12 (433929 in chips)=20
Seat 4: JJin91 (279882 in chips)=20
Seat 8: Deuxexmachen (91581 in chips)=20
Seat 9: MoeHawk101 (154608 in chips)=20
bigpond12: posts the ante 750
JJin91: posts the ante 750
Deuxexmachen: posts the ante 750
MoeHawk101: posts the ante 750
JJin91: posts small blind 3000
Deuxexmachen: posts big blind 6000
*** HOLE CARDS ***
Dealt to JJin91 [Kc 6h]
MoeHawk101: raises 9000 to 15000
bigpond12: folds=20
JJin91: folds=20
Deuxexmachen: raises 75831 to 90831 and is all-in
MoeHawk101: folds=20
Uncalled bet (75831) returned to Deuxexmachen
Deuxexmachen collected 36000 from pot
Deuxexmachen: doesn't show hand=20
*** SUMMARY ***
Total pot 36000 | Rake 0=20
Seat 1: bigpond12 (button) folded before Flop (didn't bet)
Seat 4: JJin91 (small blind) folded before Flop
Seat 8: Deuxexmachen (big blind) collected (36000)
Seat 9: MoeHawk101 folded before Flop


*********** # 295 **************
PokerStars Hand #171489517215: Tournament #1648956629, $18.20+$1.80 USD=
 Hold'em No Limit - Level XXIV (3000/6000) - 2017/06/20 23:19:26 ET
Table '1648956629 1' 9-max Seat #4 is the button
Seat 1: bigpond12 (433179 in chips)=20
Seat 4: JJin91 (276132 in chips)=20
Seat 8: Deuxexmachen (111831 in chips)=20
Seat 9: MoeHawk101 (138858 in chips)=20
bigpond12: posts the ante 750
JJin91: posts the ante 750
Deuxexmachen: posts the ante 750
MoeHawk101: posts the ante 750
Deuxexmachen: posts small blind 3000
MoeHawk101: posts big blind 6000
*** HOLE CARDS ***
Dealt to JJin91 [7c Qs]
bigpond12: calls 6000
JJin91: folds=20
Deuxexmachen: folds=20
MoeHawk101: checks=20
*** FLOP *** [5s Kc 4s]
MoeHawk101: checks=20
bigpond12: bets 6000
MoeHawk101: raises 12000 to 18000
bigpond12: calls 12000
*** TURN *** [5s Kc 4s] [Qc]
MoeHawk101: bets 114108 and is all-in
bigpond12: calls 114108
*** RIVER *** [5s Kc 4s Qc] [4d]
*** SHOW DOWN ***
MoeHawk101: shows [Js 8s] (a pair of Fours)
bigpond12: shows [6d Kd] (two pair, Kings and Fours)
bigpond12 collected 282216 from pot
MoeHawk101 finished the tournament in 4th place and received $161.61.
*** SUMMARY ***
Total pot 282216 | Rake 0=20
Board [5s Kc 4s Qc 4d]
Seat 1: bigpond12 showed [6d Kd] and won (282216) with two pair, Kings =
and Fours
Seat 4: JJin91 (button) folded before Flop (didn't bet)
Seat 8: Deuxexmachen (small blind) folded before Flop
Seat 9: MoeHawk101 (big blind) showed [Js 8s] and lost with a pair of F=
ours


*********** # 296 **************
PokerStars Hand #171489517405: Tournament #1648956629, $18.20+$1.80 USD=
 Hold'em No Limit - Level XXIV (3000/6000) - 2017/06/20 23:20:11 ET
Table '1648956629 1' 9-max Seat #8 is the button
Seat 1: bigpond12 (576537 in chips)=20
Seat 4: JJin91 (275382 in chips)=20
Seat 8: Deuxexmachen (108081 in chips)=20
bigpond12: posts the ante 750
JJin91: posts the ante 750
Deuxexmachen: posts the ante 750
bigpond12: posts small blind 3000
JJin91: posts big blind 6000
*** HOLE CARDS ***
Dealt to JJin91 [5h Qc]
Deuxexmachen: folds=20
bigpond12: calls 3000
JJin91: checks=20
*** FLOP *** [Ah 5d Qs]
bigpond12: bets 6000
JJin91: calls 6000
*** TURN *** [Ah 5d Qs] [8s]
bigpond12: bets 12000
JJin91: calls 12000
*** RIVER *** [Ah 5d Qs 8s] [9h]
bigpond12: bets 60000
JJin91: calls 60000
*** SHOW DOWN ***
bigpond12: shows [Ac 9c] (two pair, Aces and Nines)
JJin91: mucks hand=20
bigpond12 collected 170250 from pot
*** SUMMARY ***
Total pot 170250 | Rake 0=20
Board [Ah 5d Qs 8s 9h]
Seat 1: bigpond12 (small blind) showed [Ac 9c] and won (170250) with tw=
o pair, Aces and Nines
Seat 4: JJin91 (big blind) mucked [5h Qc]
Seat 8: Deuxexmachen (button) folded before Flop (didn't bet)


*********** # 297 **************
PokerStars Hand #171489517575: Tournament #1648956629, $18.20+$1.80 USD=
 Hold'em No Limit - Level XXIV (3000/6000) - 2017/06/20 23:20:50 ET
Table '1648956629 1' 9-max Seat #1 is the button
Seat 1: bigpond12 (662037 in chips)=20
Seat 4: JJin91 (190632 in chips)=20
Seat 8: Deuxexmachen (107331 in chips)=20
bigpond12: posts the ante 750
JJin91: posts the ante 750
Deuxexmachen: posts the ante 750
JJin91: posts small blind 3000
Deuxexmachen: posts big blind 6000
*** HOLE CARDS ***
Dealt to JJin91 [8c 6s]
bigpond12: calls 6000
JJin91: folds=20
Deuxexmachen: checks=20
*** FLOP *** [Ah Jh Qs]
Deuxexmachen: checks=20
bigpond12: bets 6000
Deuxexmachen: calls 6000
*** TURN *** [Ah Jh Qs] [4c]
Deuxexmachen: checks=20
bigpond12: checks=20
*** RIVER *** [Ah Jh Qs 4c] [5h]
Deuxexmachen: checks=20
bigpond12: bets 24000
Deuxexmachen: folds=20
Uncalled bet (24000) returned to bigpond12
bigpond12 collected 29250 from pot
bigpond12: doesn't show hand=20
*** SUMMARY ***
Total pot 29250 | Rake 0=20
Board [Ah Jh Qs 4c 5h]
Seat 1: bigpond12 (button) collected (29250)
Seat 4: JJin91 (small blind) folded before Flop
Seat 8: Deuxexmachen (big blind) folded on the River


*********** # 298 **************
PokerStars Hand #171489517704: Tournament #1648956629, $18.20+$1.80 USD=
 Hold'em No Limit - Level XXIV (3000/6000) - 2017/06/20 23:21:22 ET
Table '1648956629 1' 9-max Seat #4 is the button
Seat 1: bigpond12 (678537 in chips)=20
Seat 4: JJin91 (186882 in chips)=20
Seat 8: Deuxexmachen (94581 in chips)=20
bigpond12: posts the ante 750
JJin91: posts the ante 750
Deuxexmachen: posts the ante 750
Deuxexmachen: posts small blind 3000
bigpond12: posts big blind 6000
*** HOLE CARDS ***
Dealt to JJin91 [4h Tc]
JJin91: folds=20
Deuxexmachen: calls 3000
bigpond12: checks=20
*** FLOP *** [Jc 9d Jh]
Deuxexmachen: checks=20
bigpond12: bets 6000
Deuxexmachen: folds=20
Uncalled bet (6000) returned to bigpond12
bigpond12 collected 14250 from pot
bigpond12: doesn't show hand=20
*** SUMMARY ***
Total pot 14250 | Rake 0=20
Board [Jc 9d Jh]
Seat 1: bigpond12 (big blind) collected (14250)
Seat 4: JJin91 (button) folded before Flop (didn't bet)
Seat 8: Deuxexmachen (small blind) folded on the Flop


*********** # 299 **************
PokerStars Hand #171489517826: Tournament #1648956629, $18.20+$1.80 USD=
 Hold'em No Limit - Level XXIV (3000/6000) - 2017/06/20 23:21:52 ET
Table '1648956629 1' 9-max Seat #8 is the button
Seat 1: bigpond12 (686037 in chips)=20
Seat 4: JJin91 (186132 in chips)=20
Seat 8: Deuxexmachen (87831 in chips)=20
bigpond12: posts the ante 750
JJin91: posts the ante 750
Deuxexmachen: posts the ante 750
bigpond12: posts small blind 3000
JJin91: posts big blind 6000
*** HOLE CARDS ***
Dealt to JJin91 [2c 5s]
Deuxexmachen: raises 81081 to 87081 and is all-in
bigpond12: calls 84081
JJin91: folds=20
*** FLOP *** [Jh 7d 6h]
*** TURN *** [Jh 7d 6h] [Kd]
*** RIVER *** [Jh 7d 6h Kd] [8d]
*** SHOW DOWN ***
bigpond12: shows [Ah Kh] (a pair of Kings)
Deuxexmachen: shows [7s Ac] (a pair of Sevens)
bigpond12 collected 182412 from pot
Deuxexmachen finished the tournament in 3rd place and received $227.13.
*** SUMMARY ***
Total pot 182412 | Rake 0=20
Board [Jh 7d 6h Kd 8d]
Seat 1: bigpond12 (small blind) showed [Ah Kh] and won (182412) with a =
pair of Kings
Seat 4: JJin91 (big blind) folded before Flop
Seat 8: Deuxexmachen (button) showed [7s Ac] and lost with a pair of Se=
vens


*********** # 300 **************
PokerStars Hand #171489517921: Tournament #1648956629, $18.20+$1.80 USD=
 Hold'em No Limit - Level XXIV (3000/6000) - 2017/06/20 23:22:16 ET
Table '1648956629 1' 9-max Seat #1 is the button
Seat 1: bigpond12 (780618 in chips)=20
Seat 4: JJin91 (179382 in chips)=20
bigpond12: posts the ante 750
JJin91: posts the ante 750
bigpond12: posts small blind 3000
JJin91: posts big blind 6000
*** HOLE CARDS ***
Dealt to JJin91 [Kh Ad]
bigpond12: calls 3000
JJin91: raises 9420 to 15420
bigpond12: calls 9420
*** FLOP *** [7c 3d 8s]
JJin91: checks=20
bigpond12: checks=20
*** TURN *** [7c 3d 8s] [Qd]
JJin91: checks=20
bigpond12: bets 18000
JJin91: calls 18000
*** RIVER *** [7c 3d 8s Qd] [2d]
JJin91: bets 25286
bigpond12: folds=20
Uncalled bet (25286) returned to JJin91
JJin91 collected 68340 from pot
JJin91: doesn't show hand=20
*** SUMMARY ***
Total pot 68340 | Rake 0=20
Board [7c 3d 8s Qd 2d]
Seat 1: bigpond12 (button) (small blind) folded on the River
Seat 4: JJin91 (big blind) collected (68340)


*********** # 301 **************
PokerStars Hand #171489518063: Tournament #1648956629, $18.20+$1.80 USD=
 Hold'em No Limit - Level XXIV (3000/6000) - 2017/06/20 23:22:54 ET
Table '1648956629 1' 9-max Seat #4 is the button
Seat 1: bigpond12 (746448 in chips)=20
Seat 4: JJin91 (213552 in chips)=20
bigpond12: posts the ante 750
JJin91: posts the ante 750
JJin91: posts small blind 3000
bigpond12: posts big blind 6000
*** HOLE CARDS ***
Dealt to JJin91 [4h Kd]
JJin91: folds=20
Uncalled bet (3000) returned to bigpond12
bigpond12 collected 7500 from pot
bigpond12: doesn't show hand=20
*** SUMMARY ***
Total pot 7500 | Rake 0=20
Seat 1: bigpond12 (big blind) collected (7500)
Seat 4: JJin91 (button) (small blind) folded before Flop


*********** # 302 **************
PokerStars Hand #171489518089: Tournament #1648956629, $18.20+$1.80 USD=
 Hold'em No Limit - Level XXIV (3000/6000) - 2017/06/20 23:23:01 ET
Table '1648956629 1' 9-max Seat #1 is the button
Seat 1: bigpond12 (750198 in chips)=20
Seat 4: JJin91 (209802 in chips)=20
bigpond12: posts the ante 750
JJin91: posts the ante 750
bigpond12: posts small blind 3000
JJin91: posts big blind 6000
*** HOLE CARDS ***
Dealt to JJin91 [Js Qs]
bigpond12: folds=20
Uncalled bet (3000) returned to JJin91
JJin91 collected 7500 from pot
JJin91: doesn't show hand=20
*** SUMMARY ***
Total pot 7500 | Rake 0=20
Seat 1: bigpond12 (button) (small blind) folded before Flop
Seat 4: JJin91 (big blind) collected (7500)


*********** # 303 **************
PokerStars Hand #171489518108: Tournament #1648956629, $18.20+$1.80 USD=
 Hold'em No Limit - Level XXIV (3000/6000) - 2017/06/20 23:23:06 ET
Table '1648956629 1' 9-max Seat #4 is the button
Seat 1: bigpond12 (746448 in chips)=20
Seat 4: JJin91 (213552 in chips)=20
bigpond12: posts the ante 750
JJin91: posts the ante 750
JJin91: posts small blind 3000
bigpond12: posts big blind 6000
*** HOLE CARDS ***
Dealt to JJin91 [4h 2h]
JJin91: folds=20
Uncalled bet (3000) returned to bigpond12
bigpond12 collected 7500 from pot
bigpond12: doesn't show hand=20
*** SUMMARY ***
Total pot 7500 | Rake 0=20
Seat 1: bigpond12 (big blind) collected (7500)
Seat 4: JJin91 (button) (small blind) folded before Flop


*********** # 304 **************
PokerStars Hand #171489518130: Tournament #1648956629, $18.20+$1.80 USD=
 Hold'em No Limit - Level XXIV (3000/6000) - 2017/06/20 23:23:12 ET
Table '1648956629 1' 9-max Seat #1 is the button
Seat 1: bigpond12 (750198 in chips)=20
Seat 4: JJin91 (209802 in chips)=20
bigpond12: posts the ante 750
JJin91: posts the ante 750
bigpond12: posts small blind 3000
JJin91: posts big blind 6000
*** HOLE CARDS ***
Dealt to JJin91 [4s 5d]
bigpond12: raises 12000 to 18000
JJin91: folds=20
Uncalled bet (12000) returned to bigpond12
bigpond12 collected 13500 from pot
bigpond12: doesn't show hand=20
*** SUMMARY ***
Total pot 13500 | Rake 0=20
Seat 1: bigpond12 (button) (small blind) collected (13500)
Seat 4: JJin91 (big blind) folded before Flop


*********** # 305 **************
PokerStars Hand #171489518171: Tournament #1648956629, $18.20+$1.80 USD=
 Hold'em No Limit - Level XXIV (3000/6000) - 2017/06/20 23:23:22 ET
Table '1648956629 1' 9-max Seat #4 is the button
Seat 1: bigpond12 (756948 in chips)=20
Seat 4: JJin91 (203052 in chips)=20
bigpond12: posts the ante 750
JJin91: posts the ante 750
JJin91: posts small blind 3000
bigpond12: posts big blind 6000
*** HOLE CARDS ***
Dealt to JJin91 [Ad Qd]
JJin91: raises 9420 to 15420
bigpond12: folds=20
Uncalled bet (9420) returned to JJin91
JJin91 collected 13500 from pot
JJin91: doesn't show hand=20
*** SUMMARY ***
Total pot 13500 | Rake 0=20
Seat 1: bigpond12 (big blind) folded before Flop
Seat 4: JJin91 (button) (small blind) collected (13500)


*********** # 306 **************
PokerStars Hand #171489518207: Tournament #1648956629, $18.20+$1.80 USD=
 Hold'em No Limit - Level XXV (3500/7000) - 2017/06/20 23:23:35 ET
Table '1648956629 1' 9-max Seat #1 is the button
Seat 1: bigpond12 (750198 in chips)=20
Seat 4: JJin91 (209802 in chips)=20
bigpond12: posts the ante 875
JJin91: posts the ante 875
bigpond12: posts small blind 3500
JJin91: posts big blind 7000
*** HOLE CARDS ***
Dealt to JJin91 [8s Ac]
bigpond12: calls 3500
JJin91: checks=20
*** FLOP *** [As Ks Jh]
JJin91: checks=20
bigpond12: bets 7000
JJin91: raises 7000 to 14000
bigpond12: calls 7000
*** TURN *** [As Ks Jh] [6s]
JJin91: checks=20
bigpond12: checks=20
*** RIVER *** [As Ks Jh 6s] [Tc]
JJin91: checks=20
bigpond12: checks=20
*** SHOW DOWN ***
JJin91: shows [8s Ac] (a pair of Aces)
bigpond12: shows [Ah 5d] (a pair of Aces)
JJin91 collected 21875 from pot
bigpond12 collected 21875 from pot
*** SUMMARY ***
Total pot 43750 | Rake 0=20
Board [As Ks Jh 6s Tc]
Seat 1: bigpond12 (button) (small blind) showed [Ah 5d] and won (21875)=
 with a pair of Aces
Seat 4: JJin91 (big blind) showed [8s Ac] and won (21875) with a pair o=
f Aces


*********** # 307 **************
PokerStars Hand #171489518386: Tournament #1648956629, $18.20+$1.80 USD=
 Hold'em No Limit - Level XXV (3500/7000) - 2017/06/20 23:24:18 ET
Table '1648956629 1' 9-max Seat #4 is the button
Seat 1: bigpond12 (750198 in chips)=20
Seat 4: JJin91 (209802 in chips)=20
bigpond12: posts the ante 875
JJin91: posts the ante 875
JJin91: posts small blind 3500
bigpond12: posts big blind 7000
*** HOLE CARDS ***
Dealt to JJin91 [5c Tc]
JJin91: calls 3500
bigpond12: checks=20
*** FLOP *** [Kh 3h 7d]
bigpond12: bets 7000
JJin91: folds=20
Uncalled bet (7000) returned to bigpond12
bigpond12 collected 15750 from pot
bigpond12: doesn't show hand=20
*** SUMMARY ***
Total pot 15750 | Rake 0=20
Board [Kh 3h 7d]
Seat 1: bigpond12 (big blind) collected (15750)
Seat 4: JJin91 (button) (small blind) folded on the Flop


*********** # 308 **************
PokerStars Hand #171489518439: Tournament #1648956629, $18.20+$1.80 USD=
 Hold'em No Limit - Level XXV (3500/7000) - 2017/06/20 23:24:33 ET
Table '1648956629 1' 9-max Seat #1 is the button
Seat 1: bigpond12 (758073 in chips)=20
Seat 4: JJin91 (201927 in chips)=20
bigpond12: posts the ante 875
JJin91: posts the ante 875
bigpond12: posts small blind 3500
JJin91: posts big blind 7000
*** HOLE CARDS ***
Dealt to JJin91 [Ac 4d]
bigpond12: raises 7000 to 14000
JJin91: calls 7000
*** FLOP *** [Td 6h 2c]
JJin91: checks=20
bigpond12: bets 14000
JJin91: folds=20
Uncalled bet (14000) returned to bigpond12
bigpond12 collected 29750 from pot
bigpond12: doesn't show hand=20
*** SUMMARY ***
Total pot 29750 | Rake 0=20
Board [Td 6h 2c]
Seat 1: bigpond12 (button) (small blind) collected (29750)
Seat 4: JJin91 (big blind) folded on the Flop


*********** # 309 **************
PokerStars Hand #171489518513: Tournament #1648956629, $18.20+$1.80 USD=
 Hold'em No Limit - Level XXV (3500/7000) - 2017/06/20 23:24:51 ET
Table '1648956629 1' 9-max Seat #4 is the button
Seat 1: bigpond12 (772948 in chips)=20
Seat 4: JJin91 (187052 in chips)=20
bigpond12: posts the ante 875
JJin91: posts the ante 875
JJin91: posts small blind 3500
bigpond12: posts big blind 7000
*** HOLE CARDS ***
Dealt to JJin91 [Th Td]
JJin91: calls 3500
bigpond12: raises 14000 to 21000
JJin91: raises 34122 to 55122
bigpond12: calls 34122
*** FLOP *** [Qs As 3c]
bigpond12: checks=20
JJin91: bets 22333
bigpond12: calls 22333
*** TURN *** [Qs As 3c] [Ks]
bigpond12: checks=20
JJin91: bets 108722 and is all-in
bigpond12: folds=20
Uncalled bet (108722) returned to JJin91
JJin91 collected 156660 from pot
JJin91: doesn't show hand=20
*** SUMMARY ***
Total pot 156660 | Rake 0=20
Board [Qs As 3c Ks]
Seat 1: bigpond12 (big blind) folded on the Turn
Seat 4: JJin91 (button) (small blind) collected (156660)


*********** # 310 **************
PokerStars Hand #171489518710: Tournament #1648956629, $18.20+$1.80 USD=
 Hold'em No Limit - Level XXV (3500/7000) - 2017/06/20 23:25:40 ET
Table '1648956629 1' 9-max Seat #1 is the button
Seat 1: bigpond12 (694618 in chips)=20
Seat 4: JJin91 (265382 in chips)=20
bigpond12: posts the ante 875
JJin91: posts the ante 875
bigpond12: posts small blind 3500
JJin91: posts big blind 7000
*** HOLE CARDS ***
Dealt to JJin91 [8s Qs]
bigpond12: folds=20
Uncalled bet (3500) returned to JJin91
JJin91 collected 8750 from pot
JJin91: doesn't show hand=20
*** SUMMARY ***
Total pot 8750 | Rake 0=20
Seat 1: bigpond12 (button) (small blind) folded before Flop
Seat 4: JJin91 (big blind) collected (8750)


*********** # 311 **************
PokerStars Hand #171489518733: Tournament #1648956629, $18.20+$1.80 USD=
 Hold'em No Limit - Level XXV (3500/7000) - 2017/06/20 23:25:46 ET
Table '1648956629 1' 9-max Seat #4 is the button
Seat 1: bigpond12 (690243 in chips)=20
Seat 4: JJin91 (269757 in chips)=20
bigpond12: posts the ante 875
JJin91: posts the ante 875
JJin91: posts small blind 3500
bigpond12: posts big blind 7000
*** HOLE CARDS ***
Dealt to JJin91 [4h Jd]
JJin91: folds=20
Uncalled bet (3500) returned to bigpond12
bigpond12 collected 8750 from pot
bigpond12: doesn't show hand=20
*** SUMMARY ***
Total pot 8750 | Rake 0=20
Seat 1: bigpond12 (big blind) collected (8750)
Seat 4: JJin91 (button) (small blind) folded before Flop


*********** # 312 **************
PokerStars Hand #171489518766: Tournament #1648956629, $18.20+$1.80 USD=
 Hold'em No Limit - Level XXV (3500/7000) - 2017/06/20 23:25:53 ET
Table '1648956629 1' 9-max Seat #1 is the button
Seat 1: bigpond12 (694618 in chips)=20
Seat 4: JJin91 (265382 in chips)=20
bigpond12: posts the ante 875
JJin91: posts the ante 875
bigpond12: posts small blind 3500
JJin91: posts big blind 7000
*** HOLE CARDS ***
Dealt to JJin91 [Jc 9h]
bigpond12: calls 3500
JJin91: checks=20
*** FLOP *** [3d 4s Ac]
JJin91: bets 8978
bigpond12: calls 8978
*** TURN *** [3d 4s Ac] [3h]
JJin91: bets 12471
bigpond12: calls 12471
*** RIVER *** [3d 4s Ac 3h] [8c]
JJin91: checks=20
bigpond12: bets 58648
JJin91: folds=20
Uncalled bet (58648) returned to bigpond12
bigpond12 collected 58648 from pot
bigpond12: doesn't show hand=20
*** SUMMARY ***
Total pot 58648 | Rake 0=20
Board [3d 4s Ac 3h 8c]
Seat 1: bigpond12 (button) (small blind) collected (58648)
Seat 4: JJin91 (big blind) folded on the River


*********** # 313 **************
PokerStars Hand #171489518874: Tournament #1648956629, $18.20+$1.80 USD=
 Hold'em No Limit - Level XXV (3500/7000) - 2017/06/20 23:26:22 ET
Table '1648956629 1' 9-max Seat #4 is the button
Seat 1: bigpond12 (723942 in chips)=20
Seat 4: JJin91 (236058 in chips)=20
bigpond12: posts the ante 875
JJin91: posts the ante 875
JJin91: posts small blind 3500
bigpond12: posts big blind 7000
*** HOLE CARDS ***
Dealt to JJin91 [4c 8c]
JJin91: raises 228183 to 235183 and is all-in
bigpond12: folds=20
Uncalled bet (228183) returned to JJin91
JJin91 collected 15750 from pot
JJin91: doesn't show hand=20
*** SUMMARY ***
Total pot 15750 | Rake 0=20
Seat 1: bigpond12 (big blind) folded before Flop
Seat 4: JJin91 (button) (small blind) collected (15750)


*********** # 314 **************
PokerStars Hand #171489518912: Tournament #1648956629, $18.20+$1.80 USD=
 Hold'em No Limit - Level XXV (3500/7000) - 2017/06/20 23:26:33 ET
Table '1648956629 1' 9-max Seat #1 is the button
Seat 1: bigpond12 (716067 in chips)=20
Seat 4: JJin91 (243933 in chips)=20
bigpond12: posts the ante 875
JJin91: posts the ante 875
bigpond12: posts small blind 3500
JJin91: posts big blind 7000
*** HOLE CARDS ***
Dealt to JJin91 [9h Qh]
bigpond12: calls 3500
JJin91: checks=20
*** FLOP *** [8s 6c Jd]
JJin91: checks=20
bigpond12: bets 14000
JJin91: calls 14000
*** TURN *** [8s 6c Jd] [As]
JJin91: checks=20
bigpond12: bets 14000
JJin91: folds=20
Uncalled bet (14000) returned to bigpond12
bigpond12 collected 43750 from pot
bigpond12: doesn't show hand=20
*** SUMMARY ***
Total pot 43750 | Rake 0=20
Board [8s 6c Jd As]
Seat 1: bigpond12 (button) (small blind) collected (43750)
Seat 4: JJin91 (big blind) folded on the Turn


*********** # 315 **************
PokerStars Hand #171489519004: Tournament #1648956629, $18.20+$1.80 USD=
 Hold'em No Limit - Level XXV (3500/7000) - 2017/06/20 23:26:59 ET
Table '1648956629 1' 9-max Seat #4 is the button
Seat 1: bigpond12 (737942 in chips)=20
Seat 4: JJin91 (222058 in chips)=20
bigpond12: posts the ante 875
JJin91: posts the ante 875
JJin91: posts small blind 3500
bigpond12: posts big blind 7000
*** HOLE CARDS ***
Dealt to JJin91 [4s Ts]
JJin91: calls 3500
bigpond12: checks=20
*** FLOP *** [3h 5d 7s]
bigpond12: bets 14000
JJin91: folds=20
Uncalled bet (14000) returned to bigpond12
bigpond12 collected 15750 from pot
bigpond12: doesn't show hand=20
*** SUMMARY ***
Total pot 15750 | Rake 0=20
Board [3h 5d 7s]
Seat 1: bigpond12 (big blind) collected (15750)
Seat 4: JJin91 (button) (small blind) folded on the Flop


*********** # 316 **************
PokerStars Hand #171489519061: Tournament #1648956629, $18.20+$1.80 USD=
 Hold'em No Limit - Level XXV (3500/7000) - 2017/06/20 23:27:14 ET
Table '1648956629 1' 9-max Seat #1 is the button
Seat 1: bigpond12 (745817 in chips)=20
Seat 4: JJin91 (214183 in chips)=20
bigpond12: posts the ante 875
JJin91: posts the ante 875
bigpond12: posts small blind 3500
JJin91: posts big blind 7000
*** HOLE CARDS ***
Dealt to JJin91 [6c 8h]
bigpond12: calls 3500
JJin91: checks=20
*** FLOP *** [Qd 6d 9h]
JJin91: checks=20
bigpond12: bets 14000
JJin91: folds=20
Uncalled bet (14000) returned to bigpond12
bigpond12 collected 15750 from pot
bigpond12: doesn't show hand=20
*** SUMMARY ***
Total pot 15750 | Rake 0=20
Board [Qd 6d 9h]
Seat 1: bigpond12 (button) (small blind) collected (15750)
Seat 4: JJin91 (big blind) folded on the Flop


*********** # 317 **************
PokerStars Hand #171489519126: Tournament #1648956629, $18.20+$1.80 USD=
 Hold'em No Limit - Level XXV (3500/7000) - 2017/06/20 23:27:32 ET
Table '1648956629 1' 9-max Seat #4 is the button
Seat 1: bigpond12 (753692 in chips)=20
Seat 4: JJin91 (206308 in chips)=20
bigpond12: posts the ante 875
JJin91: posts the ante 875
JJin91: posts small blind 3500
bigpond12: posts big blind 7000
*** HOLE CARDS ***
Dealt to JJin91 [6h 8d]
JJin91: folds=20
Uncalled bet (3500) returned to bigpond12
bigpond12 collected 8750 from pot
bigpond12: doesn't show hand=20
*** SUMMARY ***
Total pot 8750 | Rake 0=20
Seat 1: bigpond12 (big blind) collected (8750)
Seat 4: JJin91 (button) (small blind) folded before Flop


*********** # 318 **************
PokerStars Hand #171489519148: Tournament #1648956629, $18.20+$1.80 USD=
 Hold'em No Limit - Level XXV (3500/7000) - 2017/06/20 23:27:38 ET
Table '1648956629 1' 9-max Seat #1 is the button
Seat 1: bigpond12 (758067 in chips)=20
Seat 4: JJin91 (201933 in chips)=20
bigpond12: posts the ante 875
JJin91: posts the ante 875
bigpond12: posts small blind 3500
JJin91: posts big blind 7000
*** HOLE CARDS ***
Dealt to JJin91 [Qh Qc]
bigpond12: calls 3500
JJin91: raises 10990 to 17990
bigpond12: folds=20
Uncalled bet (10990) returned to JJin91
JJin91 collected 15750 from pot
JJin91: doesn't show hand=20
*** SUMMARY ***
Total pot 15750 | Rake 0=20
Seat 1: bigpond12 (button) (small blind) folded before Flop
Seat 4: JJin91 (big blind) collected (15750)


*********** # 319 **************
PokerStars Hand #171489519209: Tournament #1648956629, $18.20+$1.80 USD=
 Hold'em No Limit - Level XXV (3500/7000) - 2017/06/20 23:27:56 ET
Table '1648956629 1' 9-max Seat #4 is the button
Seat 1: bigpond12 (750192 in chips)=20
Seat 4: JJin91 (209808 in chips)=20
bigpond12: posts the ante 875
JJin91: posts the ante 875
JJin91: posts small blind 3500
bigpond12: posts big blind 7000
*** HOLE CARDS ***
Dealt to JJin91 [8d 7h]
JJin91: raises 10990 to 17990
bigpond12: folds=20
Uncalled bet (10990) returned to JJin91
JJin91 collected 15750 from pot
JJin91: doesn't show hand=20
*** SUMMARY ***
Total pot 15750 | Rake 0=20
Seat 1: bigpond12 (big blind) folded before Flop
Seat 4: JJin91 (button) (small blind) collected (15750)


*********** # 320 **************
PokerStars Hand #171489519243: Tournament #1648956629, $18.20+$1.80 USD=
 Hold'em No Limit - Level XXV (3500/7000) - 2017/06/20 23:28:05 ET
Table '1648956629 1' 9-max Seat #1 is the button
Seat 1: bigpond12 (742317 in chips)=20
Seat 4: JJin91 (217683 in chips)=20
bigpond12: posts the ante 875
JJin91: posts the ante 875
bigpond12: posts small blind 3500
JJin91: posts big blind 7000
*** HOLE CARDS ***
Dealt to JJin91 [5h 8c]
bigpond12: calls 3500
JJin91: checks=20
*** FLOP *** [3c Qh 4d]
JJin91: checks=20
bigpond12: bets 14000
JJin91: folds=20
Uncalled bet (14000) returned to bigpond12
bigpond12 collected 15750 from pot
bigpond12: doesn't show hand=20
*** SUMMARY ***
Total pot 15750 | Rake 0=20
Board [3c Qh 4d]
Seat 1: bigpond12 (button) (small blind) collected (15750)
Seat 4: JJin91 (big blind) folded on the Flop


*********** # 321 **************
PokerStars Hand #171489519320: Tournament #1648956629, $18.20+$1.80 USD=
 Hold'em No Limit - Level XXV (3500/7000) - 2017/06/20 23:28:22 ET
Table '1648956629 1' 9-max Seat #4 is the button
Seat 1: bigpond12 (750192 in chips)=20
Seat 4: JJin91 (209808 in chips)=20
bigpond12: posts the ante 875
JJin91: posts the ante 875
JJin91: posts small blind 3500
bigpond12: posts big blind 7000
*** HOLE CARDS ***
Dealt to JJin91 [3h 9c]
JJin91: folds=20
Uncalled bet (3500) returned to bigpond12
bigpond12 collected 8750 from pot
bigpond12: doesn't show hand=20
*** SUMMARY ***
Total pot 8750 | Rake 0=20
Seat 1: bigpond12 (big blind) collected (8750)
Seat 4: JJin91 (button) (small blind) folded before Flop


*********** # 322 **************
PokerStars Hand #171489519341: Tournament #1648956629, $18.20+$1.80 USD=
 Hold'em No Limit - Level XXV (3500/7000) - 2017/06/20 23:28:28 ET
Table '1648956629 1' 9-max Seat #1 is the button
Seat 1: bigpond12 (754567 in chips)=20
Seat 4: JJin91 (205433 in chips)=20
bigpond12: posts the ante 875
JJin91: posts the ante 875
bigpond12: posts small blind 3500
JJin91: posts big blind 7000
*** HOLE CARDS ***
Dealt to JJin91 [9h 5d]
bigpond12: folds=20
Uncalled bet (3500) returned to JJin91
JJin91 collected 8750 from pot
JJin91: doesn't show hand=20
*** SUMMARY ***
Total pot 8750 | Rake 0=20
Seat 1: bigpond12 (button) (small blind) folded before Flop
Seat 4: JJin91 (big blind) collected (8750)


*********** # 323 **************
PokerStars Hand #171489519366: Tournament #1648956629, $18.20+$1.80 USD=
 Hold'em No Limit - Level XXV (3500/7000) - 2017/06/20 23:28:35 ET
Table '1648956629 1' 9-max Seat #4 is the button
Seat 1: bigpond12 (750192 in chips)=20
Seat 4: JJin91 (209808 in chips)=20
bigpond12: posts the ante 875
JJin91: posts the ante 875
JJin91: posts small blind 3500
bigpond12: posts big blind 7000
*** HOLE CARDS ***
Dealt to JJin91 [7h Tc]
JJin91: raises 201933 to 208933 and is all-in
bigpond12: folds=20
Uncalled bet (201933) returned to JJin91
JJin91 collected 15750 from pot
JJin91: doesn't show hand=20
*** SUMMARY ***
Total pot 15750 | Rake 0=20
Seat 1: bigpond12 (big blind) folded before Flop
Seat 4: JJin91 (button) (small blind) collected (15750)


*********** # 324 **************
PokerStars Hand #171489519395: Tournament #1648956629, $18.20+$1.80 USD=
 Hold'em No Limit - Level XXV (3500/7000) - 2017/06/20 23:28:44 ET
Table '1648956629 1' 9-max Seat #1 is the button
Seat 1: bigpond12 (742317 in chips)=20
Seat 4: JJin91 (217683 in chips)=20
bigpond12: posts the ante 875
JJin91: posts the ante 875
bigpond12: posts small blind 3500
JJin91: posts big blind 7000
*** HOLE CARDS ***
Dealt to JJin91 [4s Ts]
bigpond12: folds=20
Uncalled bet (3500) returned to JJin91
JJin91 collected 8750 from pot
JJin91: doesn't show hand=20
*** SUMMARY ***
Total pot 8750 | Rake 0=20
Seat 1: bigpond12 (button) (small blind) folded before Flop
Seat 4: JJin91 (big blind) collected (8750)


*********** # 325 **************
PokerStars Hand #171489519420: Tournament #1648956629, $18.20+$1.80 USD=
 Hold'em No Limit - Level XXV (3500/7000) - 2017/06/20 23:28:51 ET
Table '1648956629 1' 9-max Seat #4 is the button
Seat 1: bigpond12 (737942 in chips)=20
Seat 4: JJin91 (222058 in chips)=20
bigpond12: posts the ante 875
JJin91: posts the ante 875
JJin91: posts small blind 3500
bigpond12: posts big blind 7000
*** HOLE CARDS ***
Dealt to JJin91 [6h Qh]
JJin91: calls 3500
bigpond12: checks=20
*** FLOP *** [7s 3c 7c]
bigpond12: bets 7000
JJin91: calls 7000
*** TURN *** [7s 3c 7c] [As]
bigpond12: bets 7000
JJin91: raises 15441 to 22441
bigpond12: folds=20
Uncalled bet (15441) returned to JJin91
JJin91 collected 43750 from pot
JJin91: doesn't show hand=20
*** SUMMARY ***
Total pot 43750 | Rake 0=20
Board [7s 3c 7c As]
Seat 1: bigpond12 (big blind) folded on the Turn
Seat 4: JJin91 (button) (small blind) collected (43750)


*********** # 326 **************
PokerStars Hand #171489519508: Tournament #1648956629, $18.20+$1.80 USD=
 Hold'em No Limit - Level XXV (3500/7000) - 2017/06/20 23:29:12 ET
Table '1648956629 1' 9-max Seat #1 is the button
Seat 1: bigpond12 (716067 in chips)=20
Seat 4: JJin91 (243933 in chips)=20
bigpond12: posts the ante 875
JJin91: posts the ante 875
bigpond12: posts small blind 3500
JJin91: posts big blind 7000
*** HOLE CARDS ***
Dealt to JJin91 [Jc Ad]
bigpond12: folds=20
Uncalled bet (3500) returned to JJin91
JJin91 collected 8750 from pot
JJin91: doesn't show hand=20
*** SUMMARY ***
Total pot 8750 | Rake 0=20
Seat 1: bigpond12 (button) (small blind) folded before Flop
Seat 4: JJin91 (big blind) collected (8750)


*********** # 327 **************
PokerStars Hand #171489519536: Tournament #1648956629, $18.20+$1.80 USD=
 Hold'em No Limit - Level XXV (3500/7000) - 2017/06/20 23:29:19 ET
Table '1648956629 1' 9-max Seat #4 is the button
Seat 1: bigpond12 (711692 in chips)=20
Seat 4: JJin91 (248308 in chips)=20
bigpond12: posts the ante 875
JJin91: posts the ante 875
JJin91: posts small blind 3500
bigpond12: posts big blind 7000
*** HOLE CARDS ***
Dealt to JJin91 [2s 9h]
JJin91: folds=20
Uncalled bet (3500) returned to bigpond12
bigpond12 collected 8750 from pot
bigpond12: doesn't show hand=20
*** SUMMARY ***
Total pot 8750 | Rake 0=20
Seat 1: bigpond12 (big blind) collected (8750)
Seat 4: JJin91 (button) (small blind) folded before Flop


*********** # 328 **************
PokerStars Hand #171489519558: Tournament #1648956629, $18.20+$1.80 USD=
 Hold'em No Limit - Level XXV (3500/7000) - 2017/06/20 23:29:25 ET
Table '1648956629 1' 9-max Seat #1 is the button
Seat 1: bigpond12 (716067 in chips)=20
Seat 4: JJin91 (243933 in chips)=20
bigpond12: posts the ante 875
JJin91: posts the ante 875
bigpond12: posts small blind 3500
JJin91: posts big blind 7000
*** HOLE CARDS ***
Dealt to JJin91 [2s Ad]
bigpond12: calls 3500
JJin91: raises 236058 to 243058 and is all-in
bigpond12: folds=20
Uncalled bet (236058) returned to JJin91
JJin91 collected 15750 from pot
JJin91: doesn't show hand=20
*** SUMMARY ***
Total pot 15750 | Rake 0=20
Seat 1: bigpond12 (button) (small blind) folded before Flop
Seat 4: JJin91 (big blind) collected (15750)


*********** # 329 **************
PokerStars Hand #171489519598: Tournament #1648956629, $18.20+$1.80 USD=
 Hold'em No Limit - Level XXV (3500/7000) - 2017/06/20 23:29:35 ET
Table '1648956629 1' 9-max Seat #4 is the button
Seat 1: bigpond12 (708192 in chips)=20
Seat 4: JJin91 (251808 in chips)=20
bigpond12: posts the ante 875
JJin91: posts the ante 875
JJin91: posts small blind 3500
bigpond12: posts big blind 7000
*** HOLE CARDS ***
Dealt to JJin91 [4d 3c]
JJin91: folds=20
Uncalled bet (3500) returned to bigpond12
bigpond12 collected 8750 from pot
bigpond12: doesn't show hand=20
*** SUMMARY ***
Total pot 8750 | Rake 0=20
Seat 1: bigpond12 (big blind) collected (8750)
Seat 4: JJin91 (button) (small blind) folded before Flop


*********** # 330 **************
PokerStars Hand #171489519625: Tournament #1648956629, $18.20+$1.80 USD=
 Hold'em No Limit - Level XXV (3500/7000) - 2017/06/20 23:29:41 ET
Table '1648956629 1' 9-max Seat #1 is the button
Seat 1: bigpond12 (712567 in chips)=20
Seat 4: JJin91 (247433 in chips)=20
bigpond12: posts the ante 875
JJin91: posts the ante 875
bigpond12: posts small blind 3500
JJin91: posts big blind 7000
*** HOLE CARDS ***
Dealt to JJin91 [2d 6h]
bigpond12: calls 3500
JJin91: checks=20
*** FLOP *** [6d Ad 5s]
JJin91: bets 8978
bigpond12: folds=20
Uncalled bet (8978) returned to JJin91
JJin91 collected 15750 from pot
JJin91: doesn't show hand=20
*** SUMMARY ***
Total pot 15750 | Rake 0=20
Board [6d Ad 5s]
Seat 1: bigpond12 (button) (small blind) folded on the Flop
Seat 4: JJin91 (big blind) collected (15750)


*********** # 331 **************
PokerStars Hand #171489519700: Tournament #1648956629, $18.20+$1.80 USD=
 Hold'em No Limit - Level XXV (3500/7000) - 2017/06/20 23:29:57 ET
Table '1648956629 1' 9-max Seat #4 is the button
Seat 1: bigpond12 (704692 in chips)=20
Seat 4: JJin91 (255308 in chips)=20
bigpond12: posts the ante 875
JJin91: posts the ante 875
JJin91: posts small blind 3500
bigpond12: posts big blind 7000
*** HOLE CARDS ***
Dealt to JJin91 [5c 5h]
JJin91: raises 247433 to 254433 and is all-in
bigpond12: folds=20
Uncalled bet (247433) returned to JJin91
JJin91 collected 15750 from pot
JJin91: doesn't show hand=20
*** SUMMARY ***
Total pot 15750 | Rake 0=20
Seat 1: bigpond12 (big blind) folded before Flop
Seat 4: JJin91 (button) (small blind) collected (15750)


*********** # 332 **************
PokerStars Hand #171489519737: Tournament #1648956629, $18.20+$1.80 USD=
 Hold'em No Limit - Level XXV (3500/7000) - 2017/06/20 23:30:05 ET
Table '1648956629 1' 9-max Seat #1 is the button
Seat 1: bigpond12 (696817 in chips)=20
Seat 4: JJin91 (263183 in chips)=20
bigpond12: posts the ante 875
JJin91: posts the ante 875
bigpond12: posts small blind 3500
JJin91: posts big blind 7000
*** HOLE CARDS ***
Dealt to JJin91 [9d Kc]
bigpond12: calls 3500
JJin91: raises 255308 to 262308 and is all-in
bigpond12: folds=20
Uncalled bet (255308) returned to JJin91
JJin91 collected 15750 from pot
JJin91: doesn't show hand=20
*** SUMMARY ***
Total pot 15750 | Rake 0=20
Seat 1: bigpond12 (button) (small blind) folded before Flop
Seat 4: JJin91 (big blind) collected (15750)


*********** # 333 **************
PokerStars Hand #171489519786: Tournament #1648956629, $18.20+$1.80 USD=
 Hold'em No Limit - Level XXV (3500/7000) - 2017/06/20 23:30:16 ET
Table '1648956629 1' 9-max Seat #4 is the button
Seat 1: bigpond12 (688942 in chips)=20
Seat 4: JJin91 (271058 in chips)=20
bigpond12: posts the ante 875
JJin91: posts the ante 875
JJin91: posts small blind 3500
bigpond12: posts big blind 7000
*** HOLE CARDS ***
Dealt to JJin91 [Th Qc]
JJin91: raises 263183 to 270183 and is all-in
bigpond12: folds=20
Uncalled bet (263183) returned to JJin91
JJin91 collected 15750 from pot
JJin91: doesn't show hand=20
*** SUMMARY ***
Total pot 15750 | Rake 0=20
Seat 1: bigpond12 (big blind) folded before Flop
Seat 4: JJin91 (button) (small blind) collected (15750)


*********** # 334 **************
PokerStars Hand #171489519817: Tournament #1648956629, $18.20+$1.80 USD=
 Hold'em No Limit - Level XXV (3500/7000) - 2017/06/20 23:30:25 ET
Table '1648956629 1' 9-max Seat #1 is the button
Seat 1: bigpond12 (681067 in chips)=20
Seat 4: JJin91 (278933 in chips)=20
bigpond12: posts the ante 875
JJin91: posts the ante 875
bigpond12: posts small blind 3500
JJin91: posts big blind 7000
*** HOLE CARDS ***
Dealt to JJin91 [6d 7c]
bigpond12: folds=20
Uncalled bet (3500) returned to JJin91
JJin91 collected 8750 from pot
JJin91: doesn't show hand=20
*** SUMMARY ***
Total pot 8750 | Rake 0=20
Seat 1: bigpond12 (button) (small blind) folded before Flop
Seat 4: JJin91 (big blind) collected (8750)


*********** # 335 **************
PokerStars Hand #171489519839: Tournament #1648956629, $18.20+$1.80 USD=
 Hold'em No Limit - Level XXV (3500/7000) - 2017/06/20 23:30:31 ET
Table '1648956629 1' 9-max Seat #4 is the button
Seat 1: bigpond12 (676692 in chips)=20
Seat 4: JJin91 (283308 in chips)=20
bigpond12: posts the ante 875
JJin91: posts the ante 875
JJin91: posts small blind 3500
bigpond12: posts big blind 7000
*** HOLE CARDS ***
Dealt to JJin91 [Kh 3d]
JJin91: folds=20
Uncalled bet (3500) returned to bigpond12
bigpond12 collected 8750 from pot
bigpond12: doesn't show hand=20
*** SUMMARY ***
Total pot 8750 | Rake 0=20
Seat 1: bigpond12 (big blind) collected (8750)
Seat 4: JJin91 (button) (small blind) folded before Flop


*********** # 336 **************
PokerStars Hand #171489519873: Tournament #1648956629, $18.20+$1.80 USD=
 Hold'em No Limit - Level XXV (3500/7000) - 2017/06/20 23:30:37 ET
Table '1648956629 1' 9-max Seat #1 is the button
Seat 1: bigpond12 (681067 in chips)=20
Seat 4: JJin91 (278933 in chips)=20
bigpond12: posts the ante 875
JJin91: posts the ante 875
bigpond12: posts small blind 3500
JJin91: posts big blind 7000
*** HOLE CARDS ***
Dealt to JJin91 [Jc Js]
bigpond12: folds=20
Uncalled bet (3500) returned to JJin91
JJin91 collected 8750 from pot
JJin91: doesn't show hand=20
*** SUMMARY ***
Total pot 8750 | Rake 0=20
Seat 1: bigpond12 (button) (small blind) folded before Flop
Seat 4: JJin91 (big blind) collected (8750)


*********** # 337 **************
PokerStars Hand #171489519903: Tournament #1648956629, $18.20+$1.80 USD=
 Hold'em No Limit - Level XXV (3500/7000) - 2017/06/20 23:30:43 ET
Table '1648956629 1' 9-max Seat #4 is the button
Seat 1: bigpond12 (676692 in chips)=20
Seat 4: JJin91 (283308 in chips)=20
bigpond12: posts the ante 875
JJin91: posts the ante 875
JJin91: posts small blind 3500
bigpond12: posts big blind 7000
*** HOLE CARDS ***
Dealt to JJin91 [Ac Qc]
JJin91: raises 275433 to 282433 and is all-in
bigpond12: calls 275433
*** FLOP *** [9s 2h 3d]
*** TURN *** [9s 2h 3d] [9d]
*** RIVER *** [9s 2h 3d 9d] [6h]
*** SHOW DOWN ***
bigpond12: shows [8d Kd] (a pair of Nines)
JJin91: shows [Ac Qc] (a pair of Nines - Ace kicker)
JJin91 collected 566616 from pot
*** SUMMARY ***
Total pot 566616 | Rake 0=20
Board [9s 2h 3d 9d 6h]
Seat 1: bigpond12 (big blind) showed [8d Kd] and lost with a pair of Ni=
nes
Seat 4: JJin91 (button) (small blind) showed [Ac Qc] and won (566616) w=
ith a pair of Nines


*********** # 338 **************
PokerStars Hand #171489519962: Tournament #1648956629, $18.20+$1.80 USD=
 Hold'em No Limit - Level XXV (3500/7000) - 2017/06/20 23:30:57 ET
Table '1648956629 1' 9-max Seat #1 is the button
Seat 1: bigpond12 (393384 in chips)=20
Seat 4: JJin91 (566616 in chips)=20
bigpond12: posts the ante 875
JJin91: posts the ante 875
bigpond12: posts small blind 3500
JJin91: posts big blind 7000
*** HOLE CARDS ***
Dealt to JJin91 [4c As]
bigpond12: folds=20
Uncalled bet (3500) returned to JJin91
JJin91 collected 8750 from pot
JJin91: doesn't show hand=20
*** SUMMARY ***
Total pot 8750 | Rake 0=20
Seat 1: bigpond12 (button) (small blind) folded before Flop
Seat 4: JJin91 (big blind) collected (8750)


*********** # 339 **************
PokerStars Hand #171489519974: Tournament #1648956629, $18.20+$1.80 USD=
 Hold'em No Limit - Level XXV (3500/7000) - 2017/06/20 23:31:03 ET
Table '1648956629 1' 9-max Seat #4 is the button
Seat 1: bigpond12 (389009 in chips)=20
Seat 4: JJin91 (570991 in chips)=20
bigpond12: posts the ante 875
JJin91: posts the ante 875
JJin91: posts small blind 3500
bigpond12: posts big blind 7000
*** HOLE CARDS ***
Dealt to JJin91 [7c Th]
JJin91: calls 3500
bigpond12: checks=20
*** FLOP *** [4s 5h 9s]
bigpond12: checks=20
JJin91: bets 8978
bigpond12: folds=20
Uncalled bet (8978) returned to JJin91
JJin91 collected 15750 from pot
JJin91: doesn't show hand=20
*** SUMMARY ***
Total pot 15750 | Rake 0=20
Board [4s 5h 9s]
Seat 1: bigpond12 (big blind) folded on the Flop
Seat 4: JJin91 (button) (small blind) collected (15750)


*********** # 340 **************
PokerStars Hand #171489946232: Tournament #1648956629, $18.20+$1.80 USD=
 Hold'em No Limit - Level XXV (3500/7000) - 2017/06/20 23:31:18 ET
Table '1648956629 1' 9-max Seat #1 is the button
Seat 1: bigpond12 (381134 in chips)=20
Seat 4: JJin91 (578866 in chips)=20
bigpond12: posts the ante 875
JJin91: posts the ante 875
bigpond12: posts small blind 3500
JJin91: posts big blind 7000
*** HOLE CARDS ***
Dealt to JJin91 [Js Td]
bigpond12: calls 3500
JJin91: checks=20
*** FLOP *** [7h Jh Kd]
JJin91: bets 8978
bigpond12: raises 8978 to 17956
JJin91: calls 8978
*** TURN *** [7h Jh Kd] [4d]
JJin91: checks=20
bigpond12: bets 28000
JJin91: folds=20
Uncalled bet (28000) returned to bigpond12
bigpond12 collected 51662 from pot
bigpond12: doesn't show hand=20
*** SUMMARY ***
Total pot 51662 | Rake 0=20
Board [7h Jh Kd 4d]
Seat 1: bigpond12 (button) (small blind) collected (51662)
Seat 4: JJin91 (big blind) folded on the Turn


*********** # 341 **************
PokerStars Hand #171489946338: Tournament #1648956629, $18.20+$1.80 USD=
 Hold'em No Limit - Level XXV (3500/7000) - 2017/06/20 23:31:45 ET
Table '1648956629 1' 9-max Seat #4 is the button
Seat 1: bigpond12 (406965 in chips)=20
Seat 4: JJin91 (553035 in chips)=20
bigpond12: posts the ante 875
JJin91: posts the ante 875
JJin91: posts small blind 3500
bigpond12: posts big blind 7000
*** HOLE CARDS ***
Dealt to JJin91 [Ah 4s]
JJin91: raises 10990 to 17990
bigpond12: calls 10990
*** FLOP *** [4c 3h 8h]
bigpond12: checks=20
JJin91: checks=20
*** TURN *** [4c 3h 8h] [Ks]
bigpond12: bets 28000
JJin91: folds=20
Uncalled bet (28000) returned to bigpond12
bigpond12 collected 37730 from pot
bigpond12: doesn't show hand=20
*** SUMMARY ***
Total pot 37730 | Rake 0=20
Board [4c 3h 8h Ks]
Seat 1: bigpond12 (big blind) collected (37730)
Seat 4: JJin91 (button) (small blind) folded on the Turn


*********** # 342 **************
PokerStars Hand #171489946424: Tournament #1648956629, $18.20+$1.80 USD=
 Hold'em No Limit - Level XXV (3500/7000) - 2017/06/20 23:32:05 ET
Table '1648956629 1' 9-max Seat #1 is the button
Seat 1: bigpond12 (425830 in chips)=20
Seat 4: JJin91 (534170 in chips)=20
bigpond12: posts the ante 875
JJin91: posts the ante 875
bigpond12: posts small blind 3500
JJin91: posts big blind 7000
*** HOLE CARDS ***
Dealt to JJin91 [Qh 6c]
bigpond12: calls 3500
JJin91: checks=20
*** FLOP *** [9s 3d Th]
JJin91: checks=20
bigpond12: bets 7000
JJin91: folds=20
Uncalled bet (7000) returned to bigpond12
bigpond12 collected 15750 from pot
bigpond12: doesn't show hand=20
*** SUMMARY ***
Total pot 15750 | Rake 0=20
Board [9s 3d Th]
Seat 1: bigpond12 (button) (small blind) collected (15750)
Seat 4: JJin91 (big blind) folded on the Flop


*********** # 343 **************
PokerStars Hand #171489946481: Tournament #1648956629, $18.20+$1.80 USD=
 Hold'em No Limit - Level XXV (3500/7000) - 2017/06/20 23:32:19 ET
Table '1648956629 1' 9-max Seat #4 is the button
Seat 1: bigpond12 (433705 in chips)=20
Seat 4: JJin91 (526295 in chips)=20
bigpond12: posts the ante 875
JJin91: posts the ante 875
JJin91: posts small blind 3500
bigpond12: posts big blind 7000
*** HOLE CARDS ***
Dealt to JJin91 [7s Td]
JJin91: folds=20
Uncalled bet (3500) returned to bigpond12
bigpond12 collected 8750 from pot
bigpond12: doesn't show hand=20
*** SUMMARY ***
Total pot 8750 | Rake 0=20
Seat 1: bigpond12 (big blind) collected (8750)
Seat 4: JJin91 (button) (small blind) folded before Flop


*********** # 344 **************
PokerStars Hand #171489946506: Tournament #1648956629, $18.20+$1.80 USD=
 Hold'em No Limit - Level XXV (3500/7000) - 2017/06/20 23:32:25 ET
Table '1648956629 1' 9-max Seat #1 is the button
Seat 1: bigpond12 (438080 in chips)=20
Seat 4: JJin91 (521920 in chips)=20
bigpond12: posts the ante 875
JJin91: posts the ante 875
bigpond12: posts small blind 3500
JJin91: posts big blind 7000
*** HOLE CARDS ***
Dealt to JJin91 [3c 2d]
bigpond12: calls 3500
JJin91: checks=20
*** FLOP *** [4c Jc 9d]
JJin91: checks=20
bigpond12: bets 7000
JJin91: folds=20
Uncalled bet (7000) returned to bigpond12
bigpond12 collected 15750 from pot
bigpond12: doesn't show hand=20
*** SUMMARY ***
Total pot 15750 | Rake 0=20
Board [4c Jc 9d]
Seat 1: bigpond12 (button) (small blind) collected (15750)
Seat 4: JJin91 (big blind) folded on the Flop


*********** # 345 **************
PokerStars Hand #171489946568: Tournament #1648956629, $18.20+$1.80 USD=
 Hold'em No Limit - Level XXV (3500/7000) - 2017/06/20 23:32:40 ET
Table '1648956629 1' 9-max Seat #4 is the button
Seat 1: bigpond12 (445955 in chips)=20
Seat 4: JJin91 (514045 in chips)=20
bigpond12: posts the ante 875
JJin91: posts the ante 875
JJin91: posts small blind 3500
bigpond12: posts big blind 7000
*** HOLE CARDS ***
Dealt to JJin91 [2h 8d]
JJin91: raises 10990 to 17990
bigpond12: calls 10990
*** FLOP *** [6h 6c Td]
bigpond12: checks=20
JJin91: checks=20
*** TURN *** [6h 6c Td] [2d]
bigpond12: checks=20
JJin91: checks=20
*** RIVER *** [6h 6c Td 2d] [6d]
bigpond12: checks=20
JJin91: bets 13960
bigpond12: folds=20
Uncalled bet (13960) returned to JJin91
JJin91 collected 37730 from pot
JJin91: doesn't show hand=20
*** SUMMARY ***
Total pot 37730 | Rake 0=20
Board [6h 6c Td 2d 6d]
Seat 1: bigpond12 (big blind) folded on the River
Seat 4: JJin91 (button) (small blind) collected (37730)


*********** # 346 **************
PokerStars Hand #171489946658: Tournament #1648956629, $18.20+$1.80 USD=
 Hold'em No Limit - Level XXV (3500/7000) - 2017/06/20 23:33:01 ET
Table '1648956629 1' 9-max Seat #1 is the button
Seat 1: bigpond12 (427090 in chips)=20
Seat 4: JJin91 (532910 in chips)=20
bigpond12: posts the ante 875
JJin91: posts the ante 875
bigpond12: posts small blind 3500
JJin91: posts big blind 7000
*** HOLE CARDS ***
Dealt to JJin91 [As 8h]
bigpond12: calls 3500
JJin91: raises 10990 to 17990
bigpond12: calls 10990
*** FLOP *** [Th 8c Kd]
JJin91: bets 13960
bigpond12: folds=20
Uncalled bet (13960) returned to JJin91
JJin91 collected 37730 from pot
JJin91: doesn't show hand=20
*** SUMMARY ***
Total pot 37730 | Rake 0=20
Board [Th 8c Kd]
Seat 1: bigpond12 (button) (small blind) folded on the Flop
Seat 4: JJin91 (big blind) collected (37730)


*********** # 347 **************
PokerStars Hand #171489946732: Tournament #1648956629, $18.20+$1.80 USD=
 Hold'em No Limit - Level XXV (3500/7000) - 2017/06/20 23:33:19 ET
Table '1648956629 1' 9-max Seat #4 is the button
Seat 1: bigpond12 (408225 in chips)=20
Seat 4: JJin91 (551775 in chips)=20
bigpond12: posts the ante 875
JJin91: posts the ante 875
JJin91: posts small blind 3500
bigpond12: posts big blind 7000
*** HOLE CARDS ***
Dealt to JJin91 [Kd 4c]
JJin91: calls 3500
bigpond12: raises 14000 to 21000
JJin91: folds=20
Uncalled bet (14000) returned to bigpond12
bigpond12 collected 15750 from pot
bigpond12: doesn't show hand=20
*** SUMMARY ***
Total pot 15750 | Rake 0=20
Seat 1: bigpond12 (big blind) collected (15750)
Seat 4: JJin91 (button) (small blind) folded before Flop


*********** # 348 **************
PokerStars Hand #171489946801: Tournament #1648956629, $18.20+$1.80 USD=
 Hold'em No Limit - Level XXVI (4000/8000) - 2017/06/20 23:33:33 ET
Table '1648956629 1' 9-max Seat #1 is the button
Seat 1: bigpond12 (416100 in chips)=20
Seat 4: JJin91 (543900 in chips)=20
bigpond12: posts the ante 1000
JJin91: posts the ante 1000
bigpond12: posts small blind 4000
JJin91: posts big blind 8000
*** HOLE CARDS ***
Dealt to JJin91 [3s 6h]
bigpond12: folds=20
Uncalled bet (4000) returned to JJin91
JJin91 collected 10000 from pot
JJin91: doesn't show hand=20
*** SUMMARY ***
Total pot 10000 | Rake 0=20
Seat 1: bigpond12 (button) (small blind) folded before Flop
Seat 4: JJin91 (big blind) collected (10000)


*********** # 349 **************
PokerStars Hand #171489946825: Tournament #1648956629, $18.20+$1.80 USD=
 Hold'em No Limit - Level XXVI (4000/8000) - 2017/06/20 23:33:39 ET
Table '1648956629 1' 9-max Seat #4 is the button
Seat 1: bigpond12 (411100 in chips)=20
Seat 4: JJin91 (548900 in chips)=20
bigpond12: posts the ante 1000
JJin91: posts the ante 1000
JJin91: posts small blind 4000
bigpond12: posts big blind 8000
*** HOLE CARDS ***
Dealt to JJin91 [7d 4d]
JJin91: raises 12560 to 20560
bigpond12: calls 12560
*** FLOP *** [7c 5s Tc]
bigpond12: checks=20
JJin91: checks=20
*** TURN *** [7c 5s Tc] [Js]
bigpond12: checks=20
JJin91: checks=20
*** RIVER *** [7c 5s Tc Js] [6d]
bigpond12: bets 16000
JJin91: calls 16000
*** SHOW DOWN ***
bigpond12: shows [9s 9c] (a pair of Nines)
JJin91: mucks hand=20
bigpond12 collected 75120 from pot
*** SUMMARY ***
Total pot 75120 | Rake 0=20
Board [7c 5s Tc Js 6d]
Seat 1: bigpond12 (big blind) showed [9s 9c] and won (75120) with a pai=
r of Nines
Seat 4: JJin91 (button) (small blind) mucked [7d 4d]


*********** # 350 **************
PokerStars Hand #171489946915: Tournament #1648956629, $18.20+$1.80 USD=
 Hold'em No Limit - Level XXVI (4000/8000) - 2017/06/20 23:34:00 ET
Table '1648956629 1' 9-max Seat #1 is the button
Seat 1: bigpond12 (448660 in chips)=20
Seat 4: JJin91 (511340 in chips)=20
bigpond12: posts the ante 1000
JJin91: posts the ante 1000
bigpond12: posts small blind 4000
JJin91: posts big blind 8000
*** HOLE CARDS ***
Dealt to JJin91 [Td Ac]
bigpond12: folds=20
Uncalled bet (4000) returned to JJin91
JJin91 collected 10000 from pot
JJin91: doesn't show hand=20
*** SUMMARY ***
Total pot 10000 | Rake 0=20
Seat 1: bigpond12 (button) (small blind) folded before Flop
Seat 4: JJin91 (big blind) collected (10000)


*********** # 351 **************
PokerStars Hand #171489946941: Tournament #1648956629, $18.20+$1.80 USD=
 Hold'em No Limit - Level XXVI (4000/8000) - 2017/06/20 23:34:06 ET
Table '1648956629 1' 9-max Seat #4 is the button
Seat 1: bigpond12 (443660 in chips)=20
Seat 4: JJin91 (516340 in chips)=20
bigpond12: posts the ante 1000
JJin91: posts the ante 1000
JJin91: posts small blind 4000
bigpond12: posts big blind 8000
*** HOLE CARDS ***
Dealt to JJin91 [Js Tc]
JJin91: raises 12560 to 20560
bigpond12: folds=20
Uncalled bet (12560) returned to JJin91
JJin91 collected 18000 from pot
JJin91: doesn't show hand=20
*** SUMMARY ***
Total pot 18000 | Rake 0=20
Seat 1: bigpond12 (big blind) folded before Flop
Seat 4: JJin91 (button) (small blind) collected (18000)


*********** # 352 **************
PokerStars Hand #171489946990: Tournament #1648956629, $18.20+$1.80 USD=
 Hold'em No Limit - Level XXVI (4000/8000) - 2017/06/20 23:34:17 ET
Table '1648956629 1' 9-max Seat #1 is the button
Seat 1: bigpond12 (434660 in chips)=20
Seat 4: JJin91 (525340 in chips)=20
bigpond12: posts the ante 1000
JJin91: posts the ante 1000
bigpond12: posts small blind 4000
JJin91: posts big blind 8000
*** HOLE CARDS ***
Dealt to JJin91 [3c 8h]
bigpond12: calls 4000
JJin91: checks=20
*** FLOP *** [6h 9d 4c]
JJin91: bets 10260
bigpond12: calls 10260
*** TURN *** [6h 9d 4c] [9s]
JJin91: checks=20
bigpond12: bets 24000
JJin91: folds=20
Uncalled bet (24000) returned to bigpond12
bigpond12 collected 38520 from pot
bigpond12: doesn't show hand=20
*** SUMMARY ***
Total pot 38520 | Rake 0=20
Board [6h 9d 4c 9s]
Seat 1: bigpond12 (button) (small blind) collected (38520)
Seat 4: JJin91 (big blind) folded on the Turn


*********** # 353 **************
PokerStars Hand #171489947070: Tournament #1648956629, $18.20+$1.80 USD=
 Hold'em No Limit - Level XXVI (4000/8000) - 2017/06/20 23:34:38 ET
Table '1648956629 1' 9-max Seat #4 is the button
Seat 1: bigpond12 (453920 in chips)=20
Seat 4: JJin91 (506080 in chips)=20
bigpond12: posts the ante 1000
JJin91: posts the ante 1000
JJin91: posts small blind 4000
bigpond12: posts big blind 8000
*** HOLE CARDS ***
Dealt to JJin91 [2h Ac]
JJin91: raises 12560 to 20560
bigpond12: calls 12560
*** FLOP *** [7c Js 9s]
bigpond12: checks=20
JJin91: checks=20
*** TURN *** [7c Js 9s] [7h]
bigpond12: checks=20
JJin91: checks=20
*** RIVER *** [7c Js 9s 7h] [2c]
bigpond12: checks=20
JJin91: checks=20
*** SHOW DOWN ***
bigpond12: shows [Kc 9c] (two pair, Nines and Sevens)
JJin91: mucks hand=20
bigpond12 collected 43120 from pot
*** SUMMARY ***
Total pot 43120 | Rake 0=20
Board [7c Js 9s 7h 2c]
Seat 1: bigpond12 (big blind) showed [Kc 9c] and won (43120) with two p=
air, Nines and Sevens
Seat 4: JJin91 (button) (small blind) mucked [2h Ac]


*********** # 354 **************
PokerStars Hand #171489947167: Tournament #1648956629, $18.20+$1.80 USD=
 Hold'em No Limit - Level XXVI (4000/8000) - 2017/06/20 23:34:58 ET
Table '1648956629 1' 9-max Seat #1 is the button
Seat 1: bigpond12 (475480 in chips)=20
Seat 4: JJin91 (484520 in chips)=20
bigpond12: posts the ante 1000
JJin91: posts the ante 1000
bigpond12: posts small blind 4000
JJin91: posts big blind 8000
*** HOLE CARDS ***
Dealt to JJin91 [3c Tc]
bigpond12: folds=20
Uncalled bet (4000) returned to JJin91
JJin91 collected 10000 from pot
JJin91: doesn't show hand=20
*** SUMMARY ***
Total pot 10000 | Rake 0=20
Seat 1: bigpond12 (button) (small blind) folded before Flop
Seat 4: JJin91 (big blind) collected (10000)


*********** # 355 **************
PokerStars Hand #171489947198: Tournament #1648956629, $18.20+$1.80 USD=
 Hold'em No Limit - Level XXVI (4000/8000) - 2017/06/20 23:35:03 ET
Table '1648956629 1' 9-max Seat #4 is the button
Seat 1: bigpond12 (470480 in chips)=20
Seat 4: JJin91 (489520 in chips)=20
bigpond12: posts the ante 1000
JJin91: posts the ante 1000
JJin91: posts small blind 4000
bigpond12: posts big blind 8000
*** HOLE CARDS ***
Dealt to JJin91 [6c 2s]
JJin91: folds=20
Uncalled bet (4000) returned to bigpond12
bigpond12 collected 10000 from pot
bigpond12: doesn't show hand=20
*** SUMMARY ***
Total pot 10000 | Rake 0=20
Seat 1: bigpond12 (big blind) collected (10000)
Seat 4: JJin91 (button) (small blind) folded before Flop


*********** # 356 **************
PokerStars Hand #171489947228: Tournament #1648956629, $18.20+$1.80 USD=
 Hold'em No Limit - Level XXVI (4000/8000) - 2017/06/20 23:35:09 ET
Table '1648956629 1' 9-max Seat #1 is the button
Seat 1: bigpond12 (475480 in chips)=20
Seat 4: JJin91 (484520 in chips)=20
bigpond12: posts the ante 1000
JJin91: posts the ante 1000
bigpond12: posts small blind 4000
JJin91: posts big blind 8000
*** HOLE CARDS ***
Dealt to JJin91 [8s 7h]
bigpond12: calls 4000
JJin91: raises 12560 to 20560
bigpond12: calls 12560
*** FLOP *** [4c 8d 3c]
JJin91: bets 24578
bigpond12: calls 24578
*** TURN *** [4c 8d 3c] [Qs]
JJin91: checks=20
bigpond12: checks=20
*** RIVER *** [4c 8d 3c Qs] [6d]
JJin91: checks=20
bigpond12: checks=20
*** SHOW DOWN ***
JJin91: shows [8s 7h] (a pair of Eights)
bigpond12: mucks hand=20
JJin91 collected 92276 from pot
*** SUMMARY ***
Total pot 92276 | Rake 0=20
Board [4c 8d 3c Qs 6d]
Seat 1: bigpond12 (button) (small blind) mucked [2h 2s]
Seat 4: JJin91 (big blind) showed [8s 7h] and won (92276) with a pair o=
f Eights


*********** # 357 **************
PokerStars Hand #171489947343: Tournament #1648956629, $18.20+$1.80 USD=
 Hold'em No Limit - Level XXVI (4000/8000) - 2017/06/20 23:35:39 ET
Table '1648956629 1' 9-max Seat #4 is the button
Seat 1: bigpond12 (429342 in chips)=20
Seat 4: JJin91 (530658 in chips)=20
bigpond12: posts the ante 1000
JJin91: posts the ante 1000
JJin91: posts small blind 4000
bigpond12: posts big blind 8000
*** HOLE CARDS ***
Dealt to JJin91 [Jd Js]
JJin91: calls 4000
bigpond12: checks=20
*** FLOP *** [5h Kd 8d]
bigpond12: bets 8000
JJin91: raises 11380 to 19380
bigpond12: folds=20
Uncalled bet (11380) returned to JJin91
JJin91 collected 34000 from pot
JJin91: doesn't show hand=20
*** SUMMARY ***
Total pot 34000 | Rake 0=20
Board [5h Kd 8d]
Seat 1: bigpond12 (big blind) folded on the Flop
Seat 4: JJin91 (button) (small blind) collected (34000)


*********** # 358 **************
PokerStars Hand #171489947431: Tournament #1648956629, $18.20+$1.80 USD=
 Hold'em No Limit - Level XXVI (4000/8000) - 2017/06/20 23:36:02 ET
Table '1648956629 1' 9-max Seat #1 is the button
Seat 1: bigpond12 (412342 in chips)=20
Seat 4: JJin91 (547658 in chips)=20
bigpond12: posts the ante 1000
JJin91: posts the ante 1000
bigpond12: posts small blind 4000
JJin91: posts big blind 8000
*** HOLE CARDS ***
Dealt to JJin91 [6c Kh]
bigpond12: folds=20
Uncalled bet (4000) returned to JJin91
JJin91 collected 10000 from pot
JJin91: doesn't show hand=20
*** SUMMARY ***
Total pot 10000 | Rake 0=20
Seat 1: bigpond12 (button) (small blind) folded before Flop
Seat 4: JJin91 (big blind) collected (10000)


*********** # 359 **************
PokerStars Hand #171489947450: Tournament #1648956629, $18.20+$1.80 USD=
 Hold'em No Limit - Level XXVI (4000/8000) - 2017/06/20 23:36:08 ET
Table '1648956629 1' 9-max Seat #4 is the button
Seat 1: bigpond12 (407342 in chips)=20
Seat 4: JJin91 (552658 in chips)=20
bigpond12: posts the ante 1000
JJin91: posts the ante 1000
JJin91: posts small blind 4000
bigpond12: posts big blind 8000
*** HOLE CARDS ***
Dealt to JJin91 [Qh 8d]
JJin91: calls 4000
bigpond12: checks=20
*** FLOP *** [Qs 9d As]
bigpond12: bets 8000
JJin91: calls 8000
*** TURN *** [Qs 9d As] [8s]
bigpond12: bets 16000
JJin91: calls 16000
*** RIVER *** [Qs 9d As 8s] [Ks]
bigpond12: checks=20
JJin91: checks=20
*** SHOW DOWN ***
bigpond12: shows [Kh 9s] (a flush, Ace high)
JJin91: mucks hand=20
bigpond12 collected 66000 from pot
*** SUMMARY ***
Total pot 66000 | Rake 0=20
Board [Qs 9d As 8s Ks]
Seat 1: bigpond12 (big blind) showed [Kh 9s] and won (66000) with a flu=
sh, Ace high
Seat 4: JJin91 (button) (small blind) mucked [Qh 8d]


*********** # 360 **************
PokerStars Hand #171489947556: Tournament #1648956629, $18.20+$1.80 USD=
 Hold'em No Limit - Level XXVI (4000/8000) - 2017/06/20 23:36:31 ET
Table '1648956629 1' 9-max Seat #1 is the button
Seat 1: bigpond12 (440342 in chips)=20
Seat 4: JJin91 (519658 in chips)=20
bigpond12: posts the ante 1000
JJin91: posts the ante 1000
bigpond12: posts small blind 4000
JJin91: posts big blind 8000
*** HOLE CARDS ***
Dealt to JJin91 [4h Ac]
bigpond12: calls 4000
JJin91: raises 12560 to 20560
bigpond12: calls 12560
*** FLOP *** [Jc 5d Kd]
JJin91: bets 24578
bigpond12: calls 24578
*** TURN *** [Jc 5d Kd] [Th]
JJin91: bets 34142
bigpond12: calls 34142
*** RIVER *** [Jc 5d Kd Th] [Ah]
JJin91: checks=20
bigpond12: checks=20
*** SHOW DOWN ***
JJin91: shows [4h Ac] (a pair of Aces)
bigpond12: shows [5h Kh] (two pair, Kings and Fives)
bigpond12 collected 160560 from pot
*** SUMMARY ***
Total pot 160560 | Rake 0=20
Board [Jc 5d Kd Th Ah]
Seat 1: bigpond12 (button) (small blind) showed [5h Kh] and won (160560=
) with two pair, Kings and Fives
Seat 4: JJin91 (big blind) showed [4h Ac] and lost with a pair of Aces


*********** # 361 **************
PokerStars Hand #171489947697: Tournament #1648956629, $18.20+$1.80 USD=
 Hold'em No Limit - Level XXVI (4000/8000) - 2017/06/20 23:37:05 ET
Table '1648956629 1' 9-max Seat #4 is the button
Seat 1: bigpond12 (520622 in chips)=20
Seat 4: JJin91 (439378 in chips)=20
bigpond12: posts the ante 1000
JJin91: posts the ante 1000
JJin91: posts small blind 4000
bigpond12: posts big blind 8000
*** HOLE CARDS ***
Dealt to JJin91 [4c 3d]
JJin91: folds=20
Uncalled bet (4000) returned to bigpond12
bigpond12 collected 10000 from pot
bigpond12: doesn't show hand=20
*** SUMMARY ***
Total pot 10000 | Rake 0=20
Seat 1: bigpond12 (big blind) collected (10000)
Seat 4: JJin91 (button) (small blind) folded before Flop


*********** # 362 **************
PokerStars Hand #171489947720: Tournament #1648956629, $18.20+$1.80 USD=
 Hold'em No Limit - Level XXVI (4000/8000) - 2017/06/20 23:37:11 ET
Table '1648956629 1' 9-max Seat #1 is the button
Seat 1: bigpond12 (525622 in chips)=20
Seat 4: JJin91 (434378 in chips)=20
bigpond12: posts the ante 1000
JJin91: posts the ante 1000
bigpond12: posts small blind 4000
JJin91: posts big blind 8000
*** HOLE CARDS ***
Dealt to JJin91 [7h 6c]
bigpond12: calls 4000
JJin91: checks=20
*** FLOP *** [6h 2d Tc]
JJin91: bets 10260
bigpond12: folds=20
Uncalled bet (10260) returned to JJin91
JJin91 collected 18000 from pot
JJin91: doesn't show hand=20
*** SUMMARY ***
Total pot 18000 | Rake 0=20
Board [6h 2d Tc]
Seat 1: bigpond12 (button) (small blind) folded on the Flop
Seat 4: JJin91 (big blind) collected (18000)


*********** # 363 **************
PokerStars Hand #171489947781: Tournament #1648956629, $18.20+$1.80 USD=
 Hold'em No Limit - Level XXVI (4000/8000) - 2017/06/20 23:37:24 ET
Table '1648956629 1' 9-max Seat #4 is the button
Seat 1: bigpond12 (516622 in chips)=20
Seat 4: JJin91 (443378 in chips)=20
bigpond12: posts the ante 1000
JJin91: posts the ante 1000
JJin91: posts small blind 4000
bigpond12: posts big blind 8000
*** HOLE CARDS ***
Dealt to JJin91 [Ts 6c]
JJin91 said, "deal??"
JJin91 said, "its getting late"
JJin91 said, "k gg"
JJin91: folds=20
Uncalled bet (4000) returned to bigpond12
bigpond12 collected 10000 from pot
bigpond12: doesn't show hand=20
*** SUMMARY ***
Total pot 10000 | Rake 0=20
Seat 1: bigpond12 (big blind) collected (10000)
Seat 4: JJin91 (button) (small blind) folded before Flop


*********** # 364 **************
PokerStars Hand #171489947867: Tournament #1648956629, $18.20+$1.80 USD=
 Hold'em No Limit - Level XXVI (4000/8000) - 2017/06/20 23:37:47 ET
Table '1648956629 1' 9-max Seat #1 is the button
Seat 1: bigpond12 (521622 in chips)=20
Seat 4: JJin91 (438378 in chips)=20
bigpond12: posts the ante 1000
JJin91: posts the ante 1000
bigpond12: posts small blind 4000
JJin91: posts big blind 8000
*** HOLE CARDS ***
Dealt to JJin91 [6c 3c]
bigpond12: calls 4000
JJin91: checks=20
*** FLOP *** [8c Qh 2h]
JJin91: checks=20
bigpond12: bets 8000
JJin91: folds=20
Uncalled bet (8000) returned to bigpond12
bigpond12 collected 18000 from pot
bigpond12: doesn't show hand=20
*** SUMMARY ***
Total pot 18000 | Rake 0=20
Board [8c Qh 2h]
Seat 1: bigpond12 (button) (small blind) collected (18000)
Seat 4: JJin91 (big blind) folded on the Flop


*********** # 365 **************
PokerStars Hand #171489947931: Tournament #1648956629, $18.20+$1.80 USD=
 Hold'em No Limit - Level XXVI (4000/8000) - 2017/06/20 23:38:04 ET
Table '1648956629 1' 9-max Seat #4 is the button
Seat 1: bigpond12 (530622 in chips)=20
Seat 4: JJin91 (429378 in chips)=20
bigpond12: posts the ante 1000
JJin91: posts the ante 1000
JJin91: posts small blind 4000
bigpond12: posts big blind 8000
*** HOLE CARDS ***
Dealt to JJin91 [4s 4h]
JJin91: raises 420378 to 428378 and is all-in
bigpond12: folds=20
Uncalled bet (420378) returned to JJin91
JJin91 collected 18000 from pot
JJin91: doesn't show hand=20
*** SUMMARY ***
Total pot 18000 | Rake 0=20
Seat 1: bigpond12 (big blind) folded before Flop
Seat 4: JJin91 (button) (small blind) collected (18000)


*********** # 366 **************
PokerStars Hand #171489947960: Tournament #1648956629, $18.20+$1.80 USD=
 Hold'em No Limit - Level XXVI (4000/8000) - 2017/06/20 23:38:12 ET
Table '1648956629 1' 9-max Seat #1 is the button
Seat 1: bigpond12 (521622 in chips)=20
Seat 4: JJin91 (438378 in chips)=20
bigpond12: posts the ante 1000
JJin91: posts the ante 1000
bigpond12: posts small blind 4000
JJin91: posts big blind 8000
*** HOLE CARDS ***
Dealt to JJin91 [9s 6d]
bigpond12: calls 4000
JJin91: checks=20
*** FLOP *** [5d Jh 7d]
JJin91: checks=20
bigpond12: bets 8000
JJin91: calls 8000
*** TURN *** [5d Jh 7d] [Jc]
JJin91: checks=20
bigpond12: checks=20
*** RIVER *** [5d Jh 7d Jc] [2d]
JJin91: bets 19380
bigpond12: folds=20
Uncalled bet (19380) returned to JJin91
JJin91 collected 34000 from pot
JJin91: doesn't show hand=20
*** SUMMARY ***
Total pot 34000 | Rake 0=20
Board [5d Jh 7d Jc 2d]
Seat 1: bigpond12 (button) (small blind) folded on the River
Seat 4: JJin91 (big blind) collected (34000)


*********** # 367 **************
PokerStars Hand #171489948077: Tournament #1648956629, $18.20+$1.80 USD=
 Hold'em No Limit - Level XXVI (4000/8000) - 2017/06/20 23:38:40 ET
Table '1648956629 1' 9-max Seat #4 is the button
Seat 1: bigpond12 (504622 in chips)=20
Seat 4: JJin91 (455378 in chips)=20
bigpond12: posts the ante 1000
JJin91: posts the ante 1000
JJin91: posts small blind 4000
bigpond12: posts big blind 8000
*** HOLE CARDS ***
Dealt to JJin91 [As Ad]
JJin91: calls 4000
bigpond12: checks=20
*** FLOP *** [9d 6d 7d]
bigpond12: checks=20
JJin91: bets 10260
bigpond12: folds=20
Uncalled bet (10260) returned to JJin91
JJin91 collected 18000 from pot
JJin91: doesn't show hand=20
*** SUMMARY ***
Total pot 18000 | Rake 0=20
Board [9d 6d 7d]
Seat 1: bigpond12 (big blind) folded on the Flop
Seat 4: JJin91 (button) (small blind) collected (18000)


*********** # 368 **************
PokerStars Hand #171489948149: Tournament #1648956629, $18.20+$1.80 USD=
 Hold'em No Limit - Level XXVI (4000/8000) - 2017/06/20 23:38:54 ET
Table '1648956629 1' 9-max Seat #1 is the button
Seat 1: bigpond12 (495622 in chips)=20
Seat 4: JJin91 (464378 in chips)=20
bigpond12: posts the ante 1000
JJin91: posts the ante 1000
bigpond12: posts small blind 4000
JJin91: posts big blind 8000
*** HOLE CARDS ***
Dealt to JJin91 [Kc 9s]
bigpond12: calls 4000
JJin91: checks=20
*** FLOP *** [7h 5s Jc]
JJin91: checks=20
bigpond12: bets 8000
JJin91: calls 8000
*** TURN *** [7h 5s Jc] [Td]
JJin91: checks=20
bigpond12: bets 24000
JJin91: folds=20
Uncalled bet (24000) returned to bigpond12
bigpond12 collected 34000 from pot
bigpond12: doesn't show hand=20
*** SUMMARY ***
Total pot 34000 | Rake 0=20
Board [7h 5s Jc Td]
Seat 1: bigpond12 (button) (small blind) collected (34000)
Seat 4: JJin91 (big blind) folded on the Turn


*********** # 369 **************
PokerStars Hand #171489948245: Tournament #1648956629, $18.20+$1.80 USD=
 Hold'em No Limit - Level XXVI (4000/8000) - 2017/06/20 23:39:17 ET
Table '1648956629 1' 9-max Seat #4 is the button
Seat 1: bigpond12 (512622 in chips)=20
Seat 4: JJin91 (447378 in chips)=20
bigpond12: posts the ante 1000
JJin91: posts the ante 1000
JJin91: posts small blind 4000
bigpond12: posts big blind 8000
*** HOLE CARDS ***
Dealt to JJin91 [Ah 7c]
JJin91: raises 12560 to 20560
bigpond12: calls 12560
*** FLOP *** [Ts 9d 2c]
bigpond12: checks=20
JJin91: bets 24578
bigpond12: calls 24578
*** TURN *** [Ts 9d 2c] [Jh]
bigpond12: checks=20
JJin91: checks=20
*** RIVER *** [Ts 9d 2c Jh] [4h]
bigpond12: checks=20
JJin91: bets 52597
bigpond12: calls 52597
*** SHOW DOWN ***
JJin91: shows [Ah 7c] (high card Ace)
bigpond12: shows [Kc Jc] (a pair of Jacks)
bigpond12 collected 197470 from pot
*** SUMMARY ***
Total pot 197470 | Rake 0=20
Board [Ts 9d 2c Jh 4h]
Seat 1: bigpond12 (big blind) showed [Kc Jc] and won (197470) with a pa=
ir of Jacks
Seat 4: JJin91 (button) (small blind) showed [Ah 7c] and lost with high=
 card Ace


*********** # 370 **************
PokerStars Hand #171489948362: Tournament #1648956629, $18.20+$1.80 USD=
 Hold'em No Limit - Level XXVI (4000/8000) - 2017/06/20 23:39:45 ET
Table '1648956629 1' 9-max Seat #1 is the button
Seat 1: bigpond12 (611357 in chips)=20
Seat 4: JJin91 (348643 in chips)=20
bigpond12: posts the ante 1000
JJin91: posts the ante 1000
bigpond12: posts small blind 4000
JJin91: posts big blind 8000
*** HOLE CARDS ***
Dealt to JJin91 [6c Ks]
bigpond12: folds=20
Uncalled bet (4000) returned to JJin91
JJin91 collected 10000 from pot
JJin91: doesn't show hand=20
*** SUMMARY ***
Total pot 10000 | Rake 0=20
Seat 1: bigpond12 (button) (small blind) folded before Flop
Seat 4: JJin91 (big blind) collected (10000)


*********** # 371 **************
PokerStars Hand #171489948384: Tournament #1648956629, $18.20+$1.80 USD=
 Hold'em No Limit - Level XXVI (4000/8000) - 2017/06/20 23:39:50 ET
Table '1648956629 1' 9-max Seat #4 is the button
Seat 1: bigpond12 (606357 in chips)=20
Seat 4: JJin91 (353643 in chips)=20
bigpond12: posts the ante 1000
JJin91: posts the ante 1000
JJin91: posts small blind 4000
bigpond12: posts big blind 8000
*** HOLE CARDS ***
Dealt to JJin91 [Jh Jc]
JJin91: raises 12560 to 20560
bigpond12: folds=20
Uncalled bet (12560) returned to JJin91
JJin91 collected 18000 from pot
JJin91: doesn't show hand=20
*** SUMMARY ***
Total pot 18000 | Rake 0=20
Seat 1: bigpond12 (big blind) folded before Flop
Seat 4: JJin91 (button) (small blind) collected (18000)


*********** # 372 **************
PokerStars Hand #171489948423: Tournament #1648956629, $18.20+$1.80 USD=
 Hold'em No Limit - Level XXVI (4000/8000) - 2017/06/20 23:40:00 ET
Table '1648956629 1' 9-max Seat #1 is the button
Seat 1: bigpond12 (597357 in chips)=20
Seat 4: JJin91 (362643 in chips)=20
bigpond12: posts the ante 1000
JJin91: posts the ante 1000
bigpond12: posts small blind 4000
JJin91: posts big blind 8000
*** HOLE CARDS ***
Dealt to JJin91 [6h 3d]
bigpond12: calls 4000
JJin91: checks=20
*** FLOP *** [Td 2h 5d]
JJin91: checks=20
bigpond12: bets 8000
JJin91: folds=20
Uncalled bet (8000) returned to bigpond12
bigpond12 collected 18000 from pot
bigpond12: doesn't show hand=20
*** SUMMARY ***
Total pot 18000 | Rake 0=20
Board [Td 2h 5d]
Seat 1: bigpond12 (button) (small blind) collected (18000)
Seat 4: JJin91 (big blind) folded on the Flop


*********** # 373 **************
PokerStars Hand #171489948479: Tournament #1648956629, $18.20+$1.80 USD=
 Hold'em No Limit - Level XXVI (4000/8000) - 2017/06/20 23:40:14 ET
Table '1648956629 1' 9-max Seat #4 is the button
Seat 1: bigpond12 (606357 in chips)=20
Seat 4: JJin91 (353643 in chips)=20
bigpond12: posts the ante 1000
JJin91: posts the ante 1000
JJin91: posts small blind 4000
bigpond12: posts big blind 8000
*** HOLE CARDS ***
Dealt to JJin91 [2s 3c]
JJin91: folds=20
Uncalled bet (4000) returned to bigpond12
bigpond12 collected 10000 from pot
bigpond12: doesn't show hand=20
*** SUMMARY ***
Total pot 10000 | Rake 0=20
Seat 1: bigpond12 (big blind) collected (10000)
Seat 4: JJin91 (button) (small blind) folded before Flop


*********** # 374 **************
PokerStars Hand #171489948502: Tournament #1648956629, $18.20+$1.80 USD=
 Hold'em No Limit - Level XXVI (4000/8000) - 2017/06/20 23:40:20 ET
Table '1648956629 1' 9-max Seat #1 is the button
Seat 1: bigpond12 (611357 in chips)=20
Seat 4: JJin91 (348643 in chips)=20
bigpond12: posts the ante 1000
JJin91: posts the ante 1000
bigpond12: posts small blind 4000
JJin91: posts big blind 8000
*** HOLE CARDS ***
Dealt to JJin91 [4s 8c]
bigpond12: calls 4000
JJin91: checks=20
*** FLOP *** [Js Qh 4h]
JJin91: checks=20
bigpond12: bets 8000
JJin91: raises 11999 to 19999
bigpond12: calls 11999
*** TURN *** [Js Qh 4h] [Jc]
JJin91: checks=20
bigpond12: checks=20
*** RIVER *** [Js Qh 4h Jc] [3d]
JJin91: bets 77223
bigpond12: raises 212444 to 289667
JJin91: folds=20
Uncalled bet (212444) returned to bigpond12
bigpond12 collected 212444 from pot
bigpond12: doesn't show hand=20
*** SUMMARY ***
Total pot 212444 | Rake 0=20
Board [Js Qh 4h Jc 3d]
Seat 1: bigpond12 (button) (small blind) collected (212444)
Seat 4: JJin91 (big blind) folded on the River


*********** # 375 **************
PokerStars Hand #171489948679: Tournament #1648956629, $18.20+$1.80 USD=
 Hold'em No Limit - Level XXVI (4000/8000) - 2017/06/20 23:40:59 ET
Table '1648956629 1' 9-max Seat #4 is the button
Seat 1: bigpond12 (717579 in chips)=20
Seat 4: JJin91 (242421 in chips)=20
bigpond12: posts the ante 1000
JJin91: posts the ante 1000
JJin91: posts small blind 4000
bigpond12: posts big blind 8000
*** HOLE CARDS ***
Dealt to JJin91 [2s 7d]
JJin91: folds=20
Uncalled bet (4000) returned to bigpond12
bigpond12 collected 10000 from pot
bigpond12: doesn't show hand=20
*** SUMMARY ***
Total pot 10000 | Rake 0=20
Seat 1: bigpond12 (big blind) collected (10000)
Seat 4: JJin91 (button) (small blind) folded before Flop


*********** # 376 **************
PokerStars Hand #171489948695: Tournament #1648956629, $18.20+$1.80 USD=
 Hold'em No Limit - Level XXVI (4000/8000) - 2017/06/20 23:41:05 ET
Table '1648956629 1' 9-max Seat #1 is the button
Seat 1: bigpond12 (722579 in chips)=20
Seat 4: JJin91 (237421 in chips)=20
bigpond12: posts the ante 1000
JJin91: posts the ante 1000
bigpond12: posts small blind 4000
JJin91: posts big blind 8000
*** HOLE CARDS ***
Dealt to JJin91 [As Ks]
bigpond12: calls 4000
JJin91: raises 228421 to 236421 and is all-in
bigpond12: folds=20
Uncalled bet (228421) returned to JJin91
JJin91 collected 18000 from pot
JJin91: doesn't show hand=20
*** SUMMARY ***
Total pot 18000 | Rake 0=20
Seat 1: bigpond12 (button) (small blind) folded before Flop
Seat 4: JJin91 (big blind) collected (18000)


*********** # 377 **************
PokerStars Hand #171489948736: Tournament #1648956629, $18.20+$1.80 USD=
 Hold'em No Limit - Level XXVI (4000/8000) - 2017/06/20 23:41:18 ET
Table '1648956629 1' 9-max Seat #4 is the button
Seat 1: bigpond12 (713579 in chips)=20
Seat 4: JJin91 (246421 in chips)=20
bigpond12: posts the ante 1000
JJin91: posts the ante 1000
JJin91: posts small blind 4000
bigpond12: posts big blind 8000
*** HOLE CARDS ***
Dealt to JJin91 [9h 2h]
JJin91: calls 4000
bigpond12: raises 18000 to 26000
JJin91: folds=20
Uncalled bet (18000) returned to bigpond12
bigpond12 collected 18000 from pot
bigpond12: doesn't show hand=20
*** SUMMARY ***
Total pot 18000 | Rake 0=20
Seat 1: bigpond12 (big blind) collected (18000)
Seat 4: JJin91 (button) (small blind) folded before Flop


*********** # 378 **************
PokerStars Hand #171489948778: Tournament #1648956629, $18.20+$1.80 USD=
 Hold'em No Limit - Level XXVI (4000/8000) - 2017/06/20 23:41:30 ET
Table '1648956629 1' 9-max Seat #1 is the button
Seat 1: bigpond12 (722579 in chips)=20
Seat 4: JJin91 (237421 in chips)=20
bigpond12: posts the ante 1000
JJin91: posts the ante 1000
bigpond12: posts small blind 4000
JJin91: posts big blind 8000
*** HOLE CARDS ***
Dealt to JJin91 [Td 6c]
bigpond12: calls 4000
JJin91: checks=20
*** FLOP *** [7d 2h 8c]
JJin91: checks=20
bigpond12: bets 8000
JJin91: calls 8000
*** TURN *** [7d 2h 8c] [Ts]
JJin91: checks=20
bigpond12: bets 8000
JJin91: raises 18500 to 26500
bigpond12: calls 18500
*** RIVER *** [7d 2h 8c Ts] [Ac]
JJin91: checks=20
bigpond12: checks=20
*** SHOW DOWN ***
JJin91: shows [Td 6c] (a pair of Tens)
bigpond12: mucks hand=20
JJin91 collected 87000 from pot
*** SUMMARY ***
Total pot 87000 | Rake 0=20
Board [7d 2h 8c Ts Ac]
Seat 1: bigpond12 (button) (small blind) mucked [6s 7s]
Seat 4: JJin91 (big blind) showed [Td 6c] and won (87000) with a pair o=
f Tens


*********** # 379 **************
PokerStars Hand #171489948942: Tournament #1648956629, $18.20+$1.80 USD=
 Hold'em No Limit - Level XXVI (4000/8000) - 2017/06/20 23:42:07 ET
Table '1648956629 1' 9-max Seat #4 is the button
Seat 1: bigpond12 (679079 in chips)=20
Seat 4: JJin91 (280921 in chips)=20
bigpond12: posts the ante 1000
JJin91: posts the ante 1000
JJin91: posts small blind 4000
bigpond12: posts big blind 8000
*** HOLE CARDS ***
Dealt to JJin91 [Jc As]
JJin91: raises 12560 to 20560
bigpond12: folds=20
Uncalled bet (12560) returned to JJin91
JJin91 collected 18000 from pot
JJin91: doesn't show hand=20
*** SUMMARY ***
Total pot 18000 | Rake 0=20
Seat 1: bigpond12 (big blind) folded before Flop
Seat 4: JJin91 (button) (small blind) collected (18000)


*********** # 380 **************
PokerStars Hand #171489948977: Tournament #1648956629, $18.20+$1.80 USD=
 Hold'em No Limit - Level XXVI (4000/8000) - 2017/06/20 23:42:15 ET
Table '1648956629 1' 9-max Seat #1 is the button
Seat 1: bigpond12 (670079 in chips)=20
Seat 4: JJin91 (289921 in chips)=20
bigpond12: posts the ante 1000
JJin91: posts the ante 1000
bigpond12: posts small blind 4000
JJin91: posts big blind 8000
*** HOLE CARDS ***
Dealt to JJin91 [As 3d]
bigpond12: calls 4000
JJin91: checks=20
*** FLOP *** [Jh Jc Ks]
JJin91: checks=20
bigpond12: bets 16000
JJin91: calls 16000
*** TURN *** [Jh Jc Ks] [9d]
JJin91: checks=20
bigpond12: bets 24000
JJin91: folds=20
Uncalled bet (24000) returned to bigpond12
bigpond12 collected 50000 from pot
bigpond12: doesn't show hand=20
*** SUMMARY ***
Total pot 50000 | Rake 0=20
Board [Jh Jc Ks 9d]
Seat 1: bigpond12 (button) (small blind) collected (50000)
Seat 4: JJin91 (big blind) folded on the Turn


*********** # 381 **************
PokerStars Hand #171489949098: Tournament #1648956629, $18.20+$1.80 USD=
 Hold'em No Limit - Level XXVI (4000/8000) - 2017/06/20 23:42:45 ET
Table '1648956629 1' 9-max Seat #4 is the button
Seat 1: bigpond12 (695079 in chips)=20
Seat 4: JJin91 (264921 in chips)=20
bigpond12: posts the ante 1000
JJin91: posts the ante 1000
JJin91: posts small blind 4000
bigpond12: posts big blind 8000
*** HOLE CARDS ***
Dealt to JJin91 [Qh 4s]
JJin91: raises 12560 to 20560
bigpond12: raises 673519 to 694079 and is all-in
JJin91: folds=20
Uncalled bet (673519) returned to bigpond12
bigpond12 collected 43120 from pot
bigpond12: doesn't show hand=20
*** SUMMARY ***
Total pot 43120 | Rake 0=20
Seat 1: bigpond12 (big blind) collected (43120)
Seat 4: JJin91 (button) (small blind) folded before Flop


*********** # 382 **************
PokerStars Hand #171489949151: Tournament #1648956629, $18.20+$1.80 USD=
 Hold'em No Limit - Level XXVI (4000/8000) - 2017/06/20 23:42:57 ET
Table '1648956629 1' 9-max Seat #1 is the button
Seat 1: bigpond12 (716639 in chips)=20
Seat 4: JJin91 (243361 in chips)=20
bigpond12: posts the ante 1000
JJin91: posts the ante 1000
bigpond12: posts small blind 4000
JJin91: posts big blind 8000
*** HOLE CARDS ***
Dealt to JJin91 [Kd 2h]
bigpond12: calls 4000
JJin91: checks=20
*** FLOP *** [Ts 2c 3s]
JJin91: bets 10260
bigpond12: folds=20
Uncalled bet (10260) returned to JJin91
JJin91 collected 18000 from pot
JJin91: doesn't show hand=20
*** SUMMARY ***
Total pot 18000 | Rake 0=20
Board [Ts 2c 3s]
Seat 1: bigpond12 (button) (small blind) folded on the Flop
Seat 4: JJin91 (big blind) collected (18000)


*********** # 383 **************
PokerStars Hand #171489949208: Tournament #1648956629, $18.20+$1.80 USD=
 Hold'em No Limit - Level XXVI (4000/8000) - 2017/06/20 23:43:11 ET
Table '1648956629 1' 9-max Seat #4 is the button
Seat 1: bigpond12 (707639 in chips)=20
Seat 4: JJin91 (252361 in chips)=20
bigpond12: posts the ante 1000
JJin91: posts the ante 1000
JJin91: posts small blind 4000
bigpond12: posts big blind 8000
*** HOLE CARDS ***
Dealt to JJin91 [7c 6h]
JJin91: calls 4000
bigpond12: checks=20
*** FLOP *** [6c Ac Qh]
bigpond12: checks=20
JJin91: checks=20
*** TURN *** [6c Ac Qh] [5h]
bigpond12: bets 16000
JJin91: folds=20
Uncalled bet (16000) returned to bigpond12
bigpond12 collected 18000 from pot
bigpond12: doesn't show hand=20
*** SUMMARY ***
Total pot 18000 | Rake 0=20
Board [6c Ac Qh 5h]
Seat 1: bigpond12 (big blind) collected (18000)
Seat 4: JJin91 (button) (small blind) folded on the Turn


*********** # 384 **************
PokerStars Hand #171489949317: Tournament #1648956629, $18.20+$1.80 USD=
 Hold'em No Limit - Level XXVII (5000/10000) - 2017/06/20 23:43:38 ET
Table '1648956629 1' 9-max Seat #1 is the button
Seat 1: bigpond12 (716639 in chips)=20
Seat 4: JJin91 (243361 in chips)=20
bigpond12: posts the ante 1250
JJin91: posts the ante 1250
bigpond12: posts small blind 5000
JJin91: posts big blind 10000
*** HOLE CARDS ***
Dealt to JJin91 [4h Td]
bigpond12: calls 5000
JJin91: checks=20
*** FLOP *** [Ac 8h 6h]
JJin91: checks=20
bigpond12: bets 20000
JJin91: folds=20
Uncalled bet (20000) returned to bigpond12
bigpond12 collected 22500 from pot
bigpond12: doesn't show hand=20
*** SUMMARY ***
Total pot 22500 | Rake 0=20
Board [Ac 8h 6h]
Seat 1: bigpond12 (button) (small blind) collected (22500)
Seat 4: JJin91 (big blind) folded on the Flop


*********** # 385 **************
PokerStars Hand #171489949412: Tournament #1648956629, $18.20+$1.80 USD=
 Hold'em No Limit - Level XXVII (5000/10000) - 2017/06/20 23:43:58 ET
Table '1648956629 1' 9-max Seat #4 is the button
Seat 1: bigpond12 (727889 in chips)=20
Seat 4: JJin91 (232111 in chips)=20
bigpond12: posts the ante 1250
JJin91: posts the ante 1250
JJin91: posts small blind 5000
bigpond12: posts big blind 10000
*** HOLE CARDS ***
Dealt to JJin91 [Js 7s]
JJin91: raises 15700 to 25700
bigpond12: calls 15700
*** FLOP *** [Qh 3h 8d]
bigpond12: checks=20
JJin91: bets 30723
bigpond12: calls 30723
*** TURN *** [Qh 3h 8d] [5h]
bigpond12: checks=20
JJin91: bets 65747
bigpond12: calls 65747
*** RIVER *** [Qh 3h 8d 5h] [Jc]
bigpond12: checks=20
JJin91: bets 108691 and is all-in
bigpond12: folds=20
Uncalled bet (108691) returned to JJin91
JJin91 collected 246840 from pot
JJin91: doesn't show hand=20
*** SUMMARY ***
Total pot 246840 | Rake 0=20
Board [Qh 3h 8d 5h Jc]
Seat 1: bigpond12 (big blind) folded on the River
Seat 4: JJin91 (button) (small blind) collected (246840)


*********** # 386 **************
PokerStars Hand #171489949538: Tournament #1648956629, $18.20+$1.80 USD=
 Hold'em No Limit - Level XXVII (5000/10000) - 2017/06/20 23:44:26 ET
Table '1648956629 1' 9-max Seat #1 is the button
Seat 1: bigpond12 (604469 in chips)=20
Seat 4: JJin91 (355531 in chips)=20
bigpond12: posts the ante 1250
JJin91: posts the ante 1250
bigpond12: posts small blind 5000
JJin91: posts big blind 10000
*** HOLE CARDS ***
Dealt to JJin91 [2h Td]
bigpond12: calls 5000
JJin91: checks=20
*** FLOP *** [Ks Jh 9h]
JJin91: checks=20
bigpond12: bets 20000
JJin91: folds=20
Uncalled bet (20000) returned to bigpond12
bigpond12 collected 22500 from pot
bigpond12: doesn't show hand=20
*** SUMMARY ***
Total pot 22500 | Rake 0=20
Board [Ks Jh 9h]
Seat 1: bigpond12 (button) (small blind) collected (22500)
Seat 4: JJin91 (big blind) folded on the Flop


*********** # 387 **************
PokerStars Hand #171489949599: Tournament #1648956629, $18.20+$1.80 USD=
 Hold'em No Limit - Level XXVII (5000/10000) - 2017/06/20 23:44:41 ET
Table '1648956629 1' 9-max Seat #4 is the button
Seat 1: bigpond12 (615719 in chips)=20
Seat 4: JJin91 (344281 in chips)=20
bigpond12: posts the ante 1250
JJin91: posts the ante 1250
JJin91: posts small blind 5000
bigpond12: posts big blind 10000
*** HOLE CARDS ***
Dealt to JJin91 [Ks 2c]
JJin91: calls 5000
bigpond12: checks=20
*** FLOP *** [5d 7c 9h]
bigpond12: checks=20
JJin91: checks=20
*** TURN *** [5d 7c 9h] [Jc]
bigpond12: bets 20000
JJin91: folds=20
Uncalled bet (20000) returned to bigpond12
bigpond12 collected 22500 from pot
bigpond12: doesn't show hand=20
*** SUMMARY ***
Total pot 22500 | Rake 0=20
Board [5d 7c 9h Jc]
Seat 1: bigpond12 (big blind) collected (22500)
Seat 4: JJin91 (button) (small blind) folded on the Turn


*********** # 388 **************
PokerStars Hand #171489949688: Tournament #1648956629, $18.20+$1.80 USD=
 Hold'em No Limit - Level XXVII (5000/10000) - 2017/06/20 23:45:04 ET
Table '1648956629 1' 9-max Seat #1 is the button
Seat 1: bigpond12 (626969 in chips)=20
Seat 4: JJin91 (333031 in chips)=20
bigpond12: posts the ante 1250
JJin91: posts the ante 1250
bigpond12: posts small blind 5000
JJin91: posts big blind 10000
*** HOLE CARDS ***
Dealt to JJin91 [4s Tc]
bigpond12: calls 5000
JJin91: checks=20
*** FLOP *** [7s 3s 6d]
JJin91: bets 12825
bigpond12: folds=20
Uncalled bet (12825) returned to JJin91
JJin91 collected 22500 from pot
JJin91: doesn't show hand=20
*** SUMMARY ***
Total pot 22500 | Rake 0=20
Board [7s 3s 6d]
Seat 1: bigpond12 (button) (small blind) folded on the Flop
Seat 4: JJin91 (big blind) collected (22500)


*********** # 389 **************
PokerStars Hand #171489949746: Tournament #1648956629, $18.20+$1.80 USD=
 Hold'em No Limit - Level XXVII (5000/10000) - 2017/06/20 23:45:18 ET
Table '1648956629 1' 9-max Seat #4 is the button
Seat 1: bigpond12 (615719 in chips)=20
Seat 4: JJin91 (344281 in chips)=20
bigpond12: posts the ante 1250
JJin91: posts the ante 1250
JJin91: posts small blind 5000
bigpond12: posts big blind 10000
*** HOLE CARDS ***
Dealt to JJin91 [As 5h]
JJin91: raises 15700 to 25700
bigpond12: calls 15700
*** FLOP *** [Qc Kd Qs]
bigpond12: checks=20
JJin91: checks=20
*** TURN *** [Qc Kd Qs] [9d]
bigpond12: bets 20000
JJin91: folds=20
Uncalled bet (20000) returned to bigpond12
bigpond12 collected 53900 from pot
bigpond12: doesn't show hand=20
*** SUMMARY ***
Total pot 53900 | Rake 0=20
Board [Qc Kd Qs 9d]
Seat 1: bigpond12 (big blind) collected (53900)
Seat 4: JJin91 (button) (small blind) folded on the Turn


*********** # 390 **************
PokerStars Hand #171489949833: Tournament #1648956629, $18.20+$1.80 USD=
 Hold'em No Limit - Level XXVII (5000/10000) - 2017/06/20 23:45:37 ET
Table '1648956629 1' 9-max Seat #1 is the button
Seat 1: bigpond12 (642669 in chips)=20
Seat 4: JJin91 (317331 in chips)=20
bigpond12: posts the ante 1250
JJin91: posts the ante 1250
bigpond12: posts small blind 5000
JJin91: posts big blind 10000
*** HOLE CARDS ***
Dealt to JJin91 [2s 9h]
bigpond12: folds=20
Uncalled bet (5000) returned to JJin91
JJin91 collected 12500 from pot
JJin91: doesn't show hand=20
*** SUMMARY ***
Total pot 12500 | Rake 0=20
Seat 1: bigpond12 (button) (small blind) folded before Flop
Seat 4: JJin91 (big blind) collected (12500)


*********** # 391 **************
PokerStars Hand #171489949857: Tournament #1648956629, $18.20+$1.80 USD=
 Hold'em No Limit - Level XXVII (5000/10000) - 2017/06/20 23:45:43 ET
Table '1648956629 1' 9-max Seat #4 is the button
Seat 1: bigpond12 (636419 in chips)=20
Seat 4: JJin91 (323581 in chips)=20
bigpond12: posts the ante 1250
JJin91: posts the ante 1250
JJin91: posts small blind 5000
bigpond12: posts big blind 10000
*** HOLE CARDS ***
Dealt to JJin91 [7d 8c]
JJin91: calls 5000
bigpond12: checks=20
*** FLOP *** [9c Qs Tc]
bigpond12: bets 10000
JJin91: raises 12331 to 22331
bigpond12: folds=20
Uncalled bet (12331) returned to JJin91
JJin91 collected 42500 from pot
JJin91: doesn't show hand=20
*** SUMMARY ***
Total pot 42500 | Rake 0=20
Board [9c Qs Tc]
Seat 1: bigpond12 (big blind) folded on the Flop
Seat 4: JJin91 (button) (small blind) collected (42500)


*********** # 392 **************
PokerStars Hand #171489949962: Tournament #1648956629, $18.20+$1.80 USD=
 Hold'em No Limit - Level XXVII (5000/10000) - 2017/06/20 23:46:06 ET
Table '1648956629 1' 9-max Seat #1 is the button
Seat 1: bigpond12 (615169 in chips)=20
Seat 4: JJin91 (344831 in chips)=20
bigpond12: posts the ante 1250
JJin91: posts the ante 1250
bigpond12: posts small blind 5000
JJin91: posts big blind 10000
*** HOLE CARDS ***
Dealt to JJin91 [5c 2c]
bigpond12: calls 5000
JJin91: checks=20
*** FLOP *** [Jc 3s 6h]
JJin91: checks=20
bigpond12: bets 20000
JJin91: folds=20
Uncalled bet (20000) returned to bigpond12
bigpond12 collected 22500 from pot
bigpond12: doesn't show hand=20
*** SUMMARY ***
Total pot 22500 | Rake 0=20
Board [Jc 3s 6h]
Seat 1: bigpond12 (button) (small blind) collected (22500)
Seat 4: JJin91 (big blind) folded on the Flop


*********** # 393 **************
PokerStars Hand #171490273258: Tournament #1648956629, $18.20+$1.80 USD=
 Hold'em No Limit - Level XXVII (5000/10000) - 2017/06/20 23:46:27 ET
Table '1648956629 1' 9-max Seat #4 is the button
Seat 1: bigpond12 (626419 in chips)=20
Seat 4: JJin91 (333581 in chips)=20
bigpond12: posts the ante 1250
JJin91: posts the ante 1250
JJin91: posts small blind 5000
bigpond12: posts big blind 10000
*** HOLE CARDS ***
Dealt to JJin91 [8s 7h]
JJin91: raises 15700 to 25700
bigpond12: folds=20
Uncalled bet (15700) returned to JJin91
JJin91 collected 22500 from pot
JJin91: doesn't show hand=20
*** SUMMARY ***
Total pot 22500 | Rake 0=20
Seat 1: bigpond12 (big blind) folded before Flop
Seat 4: JJin91 (button) (small blind) collected (22500)


*********** # 394 **************
PokerStars Hand #171490273289: Tournament #1648956629, $18.20+$1.80 USD=
 Hold'em No Limit - Level XXVII (5000/10000) - 2017/06/20 23:46:35 ET
Table '1648956629 1' 9-max Seat #1 is the button
Seat 1: bigpond12 (615169 in chips)=20
Seat 4: JJin91 (344831 in chips)=20
bigpond12: posts the ante 1250
JJin91: posts the ante 1250
bigpond12: posts small blind 5000
JJin91: posts big blind 10000
*** HOLE CARDS ***
Dealt to JJin91 [Qs 9s]
bigpond12: calls 5000
JJin91: raises 15700 to 25700
bigpond12: calls 15700
*** FLOP *** [Td 9d 5c]
JJin91: checks=20
bigpond12: bets 26950
JJin91: calls 26950
*** TURN *** [Td 9d 5c] [9c]
JJin91: checks=20
bigpond12: checks=20
*** RIVER *** [Td 9d 5c 9c] [8c]
JJin91: checks=20
bigpond12: checks=20
*** SHOW DOWN ***
JJin91: shows [Qs 9s] (three of a kind, Nines)
bigpond12: mucks hand=20
JJin91 collected 107800 from pot
*** SUMMARY ***
Total pot 107800 | Rake 0=20
Board [Td 9d 5c 9c 8c]
Seat 1: bigpond12 (button) (small blind) mucked [Kc 4d]
Seat 4: JJin91 (big blind) showed [Qs 9s] and won (107800) with three o=
f a kind, Nines


*********** # 395 **************
PokerStars Hand #171490273433: Tournament #1648956629, $18.20+$1.80 USD=
 Hold'em No Limit - Level XXVII (5000/10000) - 2017/06/20 23:47:09 ET
Table '1648956629 1' 9-max Seat #4 is the button
Seat 1: bigpond12 (561269 in chips)=20
Seat 4: JJin91 (398731 in chips)=20
bigpond12: posts the ante 1250
JJin91: posts the ante 1250
JJin91: posts small blind 5000
bigpond12: posts big blind 10000
*** HOLE CARDS ***
Dealt to JJin91 [Qs 5c]
JJin91: calls 5000
bigpond12: raises 20000 to 30000
JJin91: folds=20
Uncalled bet (20000) returned to bigpond12
bigpond12 collected 22500 from pot
bigpond12: doesn't show hand=20
*** SUMMARY ***
Total pot 22500 | Rake 0=20
Seat 1: bigpond12 (big blind) collected (22500)
Seat 4: JJin91 (button) (small blind) folded before Flop


*********** # 396 **************
PokerStars Hand #171490273474: Tournament #1648956629, $18.20+$1.80 USD=
 Hold'em No Limit - Level XXVII (5000/10000) - 2017/06/20 23:47:20 ET
Table '1648956629 1' 9-max Seat #1 is the button
Seat 1: bigpond12 (572519 in chips)=20
Seat 4: JJin91 (387481 in chips)=20
bigpond12: posts the ante 1250
JJin91: posts the ante 1250
bigpond12: posts small blind 5000
JJin91: posts big blind 10000
*** HOLE CARDS ***
Dealt to JJin91 [Jh 3c]
bigpond12: folds=20
Uncalled bet (5000) returned to JJin91
JJin91 collected 12500 from pot
JJin91: doesn't show hand=20
*** SUMMARY ***
Total pot 12500 | Rake 0=20
Seat 1: bigpond12 (button) (small blind) folded before Flop
Seat 4: JJin91 (big blind) collected (12500)


*********** # 397 **************
PokerStars Hand #171490273496: Tournament #1648956629, $18.20+$1.80 USD=
 Hold'em No Limit - Level XXVII (5000/10000) - 2017/06/20 23:47:26 ET
Table '1648956629 1' 9-max Seat #4 is the button
Seat 1: bigpond12 (566269 in chips)=20
Seat 4: JJin91 (393731 in chips)=20
bigpond12: posts the ante 1250
JJin91: posts the ante 1250
JJin91: posts small blind 5000
bigpond12: posts big blind 10000
*** HOLE CARDS ***
Dealt to JJin91 [6d 7s]
JJin91: raises 15700 to 25700
bigpond12: calls 15700
*** FLOP *** [7c Ks 3h]
bigpond12: checks=20
JJin91: bets 19943
bigpond12: calls 19943
*** TURN *** [7c Ks 3h] [5c]
bigpond12: checks=20
JJin91: bets 44225
bigpond12: folds=20
Uncalled bet (44225) returned to JJin91
JJin91 collected 93786 from pot
JJin91: doesn't show hand=20
*** SUMMARY ***
Total pot 93786 | Rake 0=20
Board [7c Ks 3h 5c]
Seat 1: bigpond12 (big blind) folded on the Turn
Seat 4: JJin91 (button) (small blind) collected (93786)


*********** # 398 **************
PokerStars Hand #171490273601: Tournament #1648956629, $18.20+$1.80 USD=
 Hold'em No Limit - Level XXVII (5000/10000) - 2017/06/20 23:47:53 ET
Table '1648956629 1' 9-max Seat #1 is the button
Seat 1: bigpond12 (519376 in chips)=20
Seat 4: JJin91 (440624 in chips)=20
bigpond12: posts the ante 1250
JJin91: posts the ante 1250
bigpond12: posts small blind 5000
JJin91: posts big blind 10000
*** HOLE CARDS ***
Dealt to JJin91 [7d 3s]
bigpond12: folds=20
Uncalled bet (5000) returned to JJin91
JJin91 collected 12500 from pot
JJin91: doesn't show hand=20
*** SUMMARY ***
Total pot 12500 | Rake 0=20
Seat 1: bigpond12 (button) (small blind) folded before Flop
Seat 4: JJin91 (big blind) collected (12500)


*********** # 399 **************
PokerStars Hand #171490273630: Tournament #1648956629, $18.20+$1.80 USD=
 Hold'em No Limit - Level XXVII (5000/10000) - 2017/06/20 23:48:00 ET
Table '1648956629 1' 9-max Seat #4 is the button
Seat 1: bigpond12 (513126 in chips)=20
Seat 4: JJin91 (446874 in chips)=20
bigpond12: posts the ante 1250
JJin91: posts the ante 1250
JJin91: posts small blind 5000
bigpond12: posts big blind 10000
*** HOLE CARDS ***
Dealt to JJin91 [7d Th]
JJin91: calls 5000
bigpond12: checks=20
*** FLOP *** [Kc 5s 7s]
bigpond12: checks=20
JJin91: checks=20
*** TURN *** [Kc 5s 7s] [Kh]
bigpond12: bets 20000
JJin91: calls 20000
*** RIVER *** [Kc 5s 7s Kh] [6h]
bigpond12: checks=20
JJin91: checks=20
*** SHOW DOWN ***
bigpond12: shows [2s 2d] (two pair, Kings and Deuces)
JJin91: shows [7d Th] (two pair, Kings and Sevens)
JJin91 collected 62500 from pot
*** SUMMARY ***
Total pot 62500 | Rake 0=20
Board [Kc 5s 7s Kh 6h]
Seat 1: bigpond12 (big blind) showed [2s 2d] and lost with two pair, Ki=
ngs and Deuces
Seat 4: JJin91 (button) (small blind) showed [7d Th] and won (62500) wi=
th two pair, Kings and Sevens


*********** # 400 **************
PokerStars Hand #171490273715: Tournament #1648956629, $18.20+$1.80 USD=
 Hold'em No Limit - Level XXVII (5000/10000) - 2017/06/20 23:48:21 ET
Table '1648956629 1' 9-max Seat #1 is the button
Seat 1: bigpond12 (481876 in chips)=20
Seat 4: JJin91 (478124 in chips)=20
bigpond12: posts the ante 1250
JJin91: posts the ante 1250
bigpond12: posts small blind 5000
JJin91: posts big blind 10000
*** HOLE CARDS ***
Dealt to JJin91 [8d Qc]
bigpond12: calls 5000
JJin91: checks=20
*** FLOP *** [7s 6c 3c]
JJin91: checks=20
bigpond12: bets 10000
JJin91: calls 10000
*** TURN *** [7s 6c 3c] [6d]
JJin91: checks=20
bigpond12: checks=20
*** RIVER *** [7s 6c 3c 6d] [2d]
JJin91: checks=20
bigpond12: checks=20
*** SHOW DOWN ***
JJin91: shows [8d Qc] (a pair of Sixes)
bigpond12: mucks hand=20
JJin91 collected 42500 from pot
*** SUMMARY ***
Total pot 42500 | Rake 0=20
Board [7s 6c 3c 6d 2d]
Seat 1: bigpond12 (button) (small blind) mucked [Jh 5h]
Seat 4: JJin91 (big blind) showed [8d Qc] and won (42500) with a pair o=
f Sixes


*********** # 401 **************
PokerStars Hand #171490273820: Tournament #1648956629, $18.20+$1.80 USD=
 Hold'em No Limit - Level XXVII (5000/10000) - 2017/06/20 23:48:45 ET
Table '1648956629 1' 9-max Seat #4 is the button
Seat 1: bigpond12 (460626 in chips)=20
Seat 4: JJin91 (499374 in chips)=20
bigpond12: posts the ante 1250
JJin91: posts the ante 1250
JJin91: posts small blind 5000
bigpond12: posts big blind 10000
*** HOLE CARDS ***
Dealt to JJin91 [Ks 8h]
JJin91: raises 15700 to 25700
bigpond12: calls 15700
*** FLOP *** [Tc Js 5d]
bigpond12: checks=20
JJin91: checks=20
*** TURN *** [Tc Js 5d] [Qh]
bigpond12: checks=20
JJin91: bets 19943
bigpond12: calls 19943
*** RIVER *** [Tc Js 5d Qh] [Th]
bigpond12: checks=20
JJin91: bets 10000
bigpond12: calls 10000
*** SHOW DOWN ***
JJin91: shows [Ks 8h] (a pair of Tens)
bigpond12: shows [4d Kd] (a pair of Tens)
bigpond12 collected 56893 from pot
JJin91 collected 56893 from pot
*** SUMMARY ***
Total pot 113786 | Rake 0=20
Board [Tc Js 5d Qh Th]
Seat 1: bigpond12 (big blind) showed [4d Kd] and won (56893) with a pai=
r of Tens
Seat 4: JJin91 (button) (small blind) showed [Ks 8h] and won (56893) wi=
th a pair of Tens


*********** # 402 **************
PokerStars Hand #171490273920: Tournament #1648956629, $18.20+$1.80 USD=
 Hold'em No Limit - Level XXVII (5000/10000) - 2017/06/20 23:49:09 ET
Table '1648956629 1' 9-max Seat #1 is the button
Seat 1: bigpond12 (460626 in chips)=20
Seat 4: JJin91 (499374 in chips)=20
bigpond12: posts the ante 1250
JJin91: posts the ante 1250
bigpond12: posts small blind 5000
JJin91: posts big blind 10000
*** HOLE CARDS ***
Dealt to JJin91 [5c 6d]
bigpond12: folds=20
Uncalled bet (5000) returned to JJin91
JJin91 collected 12500 from pot
JJin91: doesn't show hand=20
*** SUMMARY ***
Total pot 12500 | Rake 0=20
Seat 1: bigpond12 (button) (small blind) folded before Flop
Seat 4: JJin91 (big blind) collected (12500)


*********** # 403 **************
PokerStars Hand #171490273941: Tournament #1648956629, $18.20+$1.80 USD=
 Hold'em No Limit - Level XXVII (5000/10000) - 2017/06/20 23:49:15 ET
Table '1648956629 1' 9-max Seat #4 is the button
Seat 1: bigpond12 (454376 in chips)=20
Seat 4: JJin91 (505624 in chips)=20
bigpond12: posts the ante 1250
JJin91: posts the ante 1250
JJin91: posts small blind 5000
bigpond12: posts big blind 10000
*** HOLE CARDS ***
Dealt to JJin91 [7h Kd]
JJin91: calls 5000
bigpond12: raises 20000 to 30000
JJin91: calls 20000
*** FLOP *** [3h Kc Td]
bigpond12: bets 40000
JJin91: calls 40000
*** TURN *** [3h Kc Td] [2s]
bigpond12: bets 80000
JJin91: calls 80000
*** RIVER *** [3h Kc Td 2s] [4c]
bigpond12: checks=20
JJin91: checks=20
*** SHOW DOWN ***
bigpond12: shows [8c 9c] (high card King)
JJin91: shows [7h Kd] (a pair of Kings)
JJin91 collected 302500 from pot
*** SUMMARY ***
Total pot 302500 | Rake 0=20
Board [3h Kc Td 2s 4c]
Seat 1: bigpond12 (big blind) showed [8c 9c] and lost with high card Ki=
ng
Seat 4: JJin91 (button) (small blind) showed [7h Kd] and won (302500) w=
ith a pair of Kings


*********** # 404 **************
PokerStars Hand #171490274082: Tournament #1648956629, $18.20+$1.80 USD=
 Hold'em No Limit - Level XXVII (5000/10000) - 2017/06/20 23:49:51 ET
Table '1648956629 1' 9-max Seat #1 is the button
Seat 1: bigpond12 (303126 in chips)=20
Seat 4: JJin91 (656874 in chips)=20
bigpond12: posts the ante 1250
JJin91: posts the ante 1250
bigpond12: posts small blind 5000
JJin91: posts big blind 10000
*** HOLE CARDS ***
Dealt to JJin91 [5d 6d]
bigpond12: folds=20
Uncalled bet (5000) returned to JJin91
JJin91 collected 12500 from pot
JJin91: doesn't show hand=20
*** SUMMARY ***
Total pot 12500 | Rake 0=20
Seat 1: bigpond12 (button) (small blind) folded before Flop
Seat 4: JJin91 (big blind) collected (12500)


*********** # 405 **************
PokerStars Hand #171490274102: Tournament #1648956629, $18.20+$1.80 USD=
 Hold'em No Limit - Level XXVII (5000/10000) - 2017/06/20 23:49:56 ET
Table '1648956629 1' 9-max Seat #4 is the button
Seat 1: bigpond12 (296876 in chips)=20
Seat 4: JJin91 (663124 in chips)=20
bigpond12: posts the ante 1250
JJin91: posts the ante 1250
JJin91: posts small blind 5000
bigpond12: posts big blind 10000
*** HOLE CARDS ***
Dealt to JJin91 [5s 7d]
JJin91: raises 15700 to 25700
bigpond12: folds=20
Uncalled bet (15700) returned to JJin91
JJin91 collected 22500 from pot
JJin91: doesn't show hand=20
*** SUMMARY ***
Total pot 22500 | Rake 0=20
Seat 1: bigpond12 (big blind) folded before Flop
Seat 4: JJin91 (button) (small blind) collected (22500)


*********** # 406 **************
PokerStars Hand #171490274139: Tournament #1648956629, $18.20+$1.80 USD=
 Hold'em No Limit - Level XXVII (5000/10000) - 2017/06/20 23:50:05 ET
Table '1648956629 1' 9-max Seat #1 is the button
Seat 1: bigpond12 (285626 in chips)=20
Seat 4: JJin91 (674374 in chips)=20
bigpond12: posts the ante 1250
JJin91: posts the ante 1250
bigpond12: posts small blind 5000
JJin91: posts big blind 10000
*** HOLE CARDS ***
Dealt to JJin91 [Kh 5c]
bigpond12: folds=20
Uncalled bet (5000) returned to JJin91
JJin91 collected 12500 from pot
JJin91: doesn't show hand=20
*** SUMMARY ***
Total pot 12500 | Rake 0=20
Seat 1: bigpond12 (button) (small blind) folded before Flop
Seat 4: JJin91 (big blind) collected (12500)


*********** # 407 **************
PokerStars Hand #171490274159: Tournament #1648956629, $18.20+$1.80 USD=
 Hold'em No Limit - Level XXVII (5000/10000) - 2017/06/20 23:50:11 ET
Table '1648956629 1' 9-max Seat #4 is the button
Seat 1: bigpond12 (279376 in chips)=20
Seat 4: JJin91 (680624 in chips)=20
bigpond12: posts the ante 1250
JJin91: posts the ante 1250
JJin91: posts small blind 5000
bigpond12: posts big blind 10000
*** HOLE CARDS ***
Dealt to JJin91 [Td As]
JJin91: raises 15700 to 25700
bigpond12: folds=20
Uncalled bet (15700) returned to JJin91
JJin91 collected 22500 from pot
JJin91: doesn't show hand=20
*** SUMMARY ***
Total pot 22500 | Rake 0=20
Seat 1: bigpond12 (big blind) folded before Flop
Seat 4: JJin91 (button) (small blind) collected (22500)


*********** # 408 **************
PokerStars Hand #171490274197: Tournament #1648956629, $18.20+$1.80 USD=
 Hold'em No Limit - Level XXVII (5000/10000) - 2017/06/20 23:50:22 ET
Table '1648956629 1' 9-max Seat #1 is the button
Seat 1: bigpond12 (268126 in chips)=20
Seat 4: JJin91 (691874 in chips)=20
bigpond12: posts the ante 1250
JJin91: posts the ante 1250
bigpond12: posts small blind 5000
JJin91: posts big blind 10000
*** HOLE CARDS ***
Dealt to JJin91 [Ad Ks]
bigpond12: calls 5000
JJin91: raises 24900 to 34900
bigpond12: raises 231976 to 266876 and is all-in
JJin91: calls 231976
*** FLOP *** [5h Qc 9c]
*** TURN *** [5h Qc 9c] [7s]
*** RIVER *** [5h Qc 9c 7s] [Td]
*** SHOW DOWN ***
JJin91: shows [Ad Ks] (high card Ace)
bigpond12: shows [Jh As] (high card Ace - lower kicker)
JJin91 collected 536252 from pot
bigpond12 finished the tournament in 2nd place and received $297.02.
JJin91 wins the tournament and receives $436.86 - congratulations!
*** SUMMARY ***
Total pot 536252 | Rake 0=20
Board [5h Qc 9c 7s Td]
Seat 1: bigpond12 (button) (small blind) showed [Jh As] and lost with h=
igh card Ace
Seat 4: JJin91 (big blind) showed [Ad Ks] and won (536252) with high ca=
rd Ace



If you have any questions, please contact us at "PokerStars Support" <s=
upport@pokerstarsnj.com>


