Transcript for tournament #1701776547 requested by JJin91 (jamiejin91@g=
mail.com)

*********** # 1 **************
PokerStars Hand #175009023063: Tournament #1701776547, $18.20+$1.80 USD=
 Hold'em No Limit - Level I (25/50) - 2017/09/13 19:00:03 ET
Table '1701776547 2' 9-max Seat #1 is the button
Seat 1: mmenz08816 (10000 in chips)=20
Seat 2: jj0420&&78 (10000 in chips)=20
Seat 5: iFoldN0T (10000 in chips)=20
Seat 6: senor stinks (10000 in chips)=20
Seat 7: lennycappy (10000 in chips)=20
Seat 8: JJin91 (10000 in chips)=20
Seat 9: TheBulldawgg (10000 in chips)=20
jj0420&&78: posts small blind 25
iFoldN0T: posts big blind 50
*** HOLE CARDS ***
Dealt to JJin91 [Ad 4d]
senor stinks: folds=20
lennycappy has timed out
lennycappy: folds=20
lennycappy is sitting out
JJin91 has timed out
JJin91: folds=20
JJin91 is sitting out
TheBulldawgg: folds=20
mmenz08816: folds=20
lennycappy has returned
jj0420&&78: raises 50 to 100
iFoldN0T: calls 50
*** FLOP *** [6h 8c 3h]
jj0420&&78: bets 50
iFoldN0T: folds=20
Uncalled bet (50) returned to jj0420&&78
jj0420&&78 collected 200 from pot
jj0420&&78: doesn't show hand=20
*** SUMMARY ***
Total pot 200 | Rake 0=20
Board [6h 8c 3h]
Seat 1: mmenz08816 (button) folded before Flop (didn't bet)
Seat 2: jj0420&&78 (small blind) collected (200)
Seat 5: iFoldN0T (big blind) folded on the Flop
Seat 6: senor stinks folded before Flop (didn't bet)
Seat 7: lennycappy folded before Flop (didn't bet)
Seat 8: JJin91 folded before Flop (didn't bet)
Seat 9: TheBulldawgg folded before Flop (didn't bet)


*********** # 2 **************
PokerStars Hand #175009023259: Tournament #1701776547, $18.20+$1.80 USD=
 Hold'em No Limit - Level I (25/50) - 2017/09/13 19:01:12 ET
Table '1701776547 2' 9-max Seat #2 is the button
Seat 1: mmenz08816 (10000 in chips)=20
Seat 2: jj0420&&78 (10100 in chips)=20
Seat 5: iFoldN0T (9900 in chips)=20
Seat 6: senor stinks (10000 in chips)=20
Seat 7: lennycappy (10000 in chips)=20
Seat 8: JJin91 (10000 in chips) is sitting out
Seat 9: TheBulldawgg (10000 in chips)=20
iFoldN0T: posts small blind 25
senor stinks: posts big blind 50
*** HOLE CARDS ***
Dealt to JJin91 [7s Jc]
lennycappy: folds=20
JJin91: folds=20
TheBulldawgg: folds=20
mmenz08816: folds=20
jj0420&&78: calls 50
iFoldN0T: calls 25
senor stinks: checks=20
*** FLOP *** [8h 7d 6c]
iFoldN0T: checks=20
senor stinks: checks=20
jj0420&&78: bets 50
iFoldN0T: calls 50
senor stinks: folds=20
*** TURN *** [8h 7d 6c] [9h]
iFoldN0T: bets 167
jj0420&&78: calls 167
*** RIVER *** [8h 7d 6c 9h] [2d]
iFoldN0T: bets 345
jj0420&&78: raises 1255 to 1600
iFoldN0T: folds=20
Uncalled bet (1255) returned to jj0420&&78
jj0420&&78 collected 1274 from pot
jj0420&&78: doesn't show hand=20
*** SUMMARY ***
Total pot 1274 | Rake 0=20
Board [8h 7d 6c 9h 2d]
Seat 1: mmenz08816 folded before Flop (didn't bet)
Seat 2: jj0420&&78 (button) collected (1274)
Seat 5: iFoldN0T (small blind) folded on the River
Seat 6: senor stinks (big blind) folded on the Flop
Seat 7: lennycappy folded before Flop (didn't bet)
Seat 8: JJin91 folded before Flop (didn't bet)
Seat 9: TheBulldawgg folded before Flop (didn't bet)


*********** # 3 **************
PokerStars Hand #175009023409: Tournament #1701776547, $18.20+$1.80 USD=
 Hold'em No Limit - Level I (25/50) - 2017/09/13 19:02:00 ET
Table '1701776547 2' 9-max Seat #5 is the button
Seat 1: mmenz08816 (10000 in chips)=20
Seat 2: jj0420&&78 (10762 in chips)=20
Seat 4: helzkitchen (10000 in chips)=20
Seat 5: iFoldN0T (9288 in chips)=20
Seat 6: senor stinks (9950 in chips)=20
Seat 7: lennycappy (10000 in chips)=20
Seat 8: JJin91 (10000 in chips) is sitting out
Seat 9: TheBulldawgg (10000 in chips)=20
senor stinks: posts small blind 25
lennycappy: posts big blind 50
*** HOLE CARDS ***
Dealt to JJin91 [Jd 5d]
JJin91: folds=20
TheBulldawgg: folds=20
mmenz08816: folds=20
jj0420&&78: calls 50
helzkitchen: folds=20
iFoldN0T: folds=20
JJin91 has returned
senor stinks: calls 25
lennycappy: checks=20
*** FLOP *** [2h Jc Tc]
senor stinks: bets 100
lennycappy: calls 100
jj0420&&78: calls 100
*** TURN *** [2h Jc Tc] [3h]
senor stinks: bets 300
lennycappy: calls 300
jj0420&&78: calls 300
*** RIVER *** [2h Jc Tc 3h] [8s]
senor stinks: bets 1000
lennycappy: calls 1000
jj0420&&78: folds=20
*** SHOW DOWN ***
senor stinks: shows [Qh 9c] (a straight, Eight to Queen)
lennycappy: mucks hand=20
senor stinks collected 3350 from pot
*** SUMMARY ***
Total pot 3350 | Rake 0=20
Board [2h Jc Tc 3h 8s]
Seat 1: mmenz08816 folded before Flop (didn't bet)
Seat 2: jj0420&&78 folded on the River
Seat 4: helzkitchen folded before Flop (didn't bet)
Seat 5: iFoldN0T (button) folded before Flop (didn't bet)
Seat 6: senor stinks (small blind) showed [Qh 9c] and won (3350) with a=
 straight, Eight to Queen
Seat 7: lennycappy (big blind) mucked [8h Ac]
Seat 8: JJin91 folded before Flop (didn't bet)
Seat 9: TheBulldawgg folded before Flop (didn't bet)


*********** # 4 **************
PokerStars Hand #175009023605: Tournament #1701776547, $18.20+$1.80 USD=
 Hold'em No Limit - Level I (25/50) - 2017/09/13 19:03:03 ET
Table '1701776547 2' 9-max Seat #6 is the button
Seat 1: mmenz08816 (10000 in chips)=20
Seat 2: jj0420&&78 (10312 in chips)=20
Seat 4: helzkitchen (10000 in chips)=20
Seat 5: iFoldN0T (9288 in chips)=20
Seat 6: senor stinks (11850 in chips)=20
Seat 7: lennycappy (8550 in chips)=20
Seat 8: JJin91 (10000 in chips)=20
Seat 9: TheBulldawgg (10000 in chips)=20
lennycappy: posts small blind 25
JJin91: posts big blind 50
*** HOLE CARDS ***
Dealt to JJin91 [6h 3d]
TheBulldawgg: folds=20
mmenz08816: folds=20
jj0420&&78: calls 50
helzkitchen: raises 200 to 250
iFoldN0T: folds=20
senor stinks: folds=20
lennycappy: calls 225
JJin91: folds=20
jj0420&&78: calls 200
*** FLOP *** [4d Ts Td]
lennycappy: bets 50
jj0420&&78: raises 450 to 500
helzkitchen: folds=20
lennycappy: calls 450
*** TURN *** [4d Ts Td] [4s]
lennycappy: checks=20
jj0420&&78: checks=20
*** RIVER *** [4d Ts Td 4s] [Qs]
lennycappy: checks=20
jj0420&&78: checks=20
*** SHOW DOWN ***
lennycappy: shows [8c 8s] (two pair, Tens and Eights)
jj0420&&78: mucks hand=20
lennycappy collected 1800 from pot
*** SUMMARY ***
Total pot 1800 | Rake 0=20
Board [4d Ts Td 4s Qs]
Seat 1: mmenz08816 folded before Flop (didn't bet)
Seat 2: jj0420&&78 mucked [As 2c]
Seat 4: helzkitchen folded on the Flop
Seat 5: iFoldN0T folded before Flop (didn't bet)
Seat 6: senor stinks (button) folded before Flop (didn't bet)
Seat 7: lennycappy (small blind) showed [8c 8s] and won (1800) with two=
 pair, Tens and Eights
Seat 8: JJin91 (big blind) folded before Flop
Seat 9: TheBulldawgg folded before Flop (didn't bet)


*********** # 5 **************
PokerStars Hand #175009023847: Tournament #1701776547, $18.20+$1.80 USD=
 Hold'em No Limit - Level I (25/50) - 2017/09/13 19:04:21 ET
Table '1701776547 2' 9-max Seat #7 is the button
Seat 1: mmenz08816 (10000 in chips)=20
Seat 2: jj0420&&78 (9562 in chips)=20
Seat 4: helzkitchen (9750 in chips)=20
Seat 5: iFoldN0T (9288 in chips)=20
Seat 6: senor stinks (11850 in chips)=20
Seat 7: lennycappy (9600 in chips)=20
Seat 8: JJin91 (9950 in chips)=20
Seat 9: TheBulldawgg (10000 in chips)=20
JJin91: posts small blind 25
TheBulldawgg: posts big blind 50
*** HOLE CARDS ***
Dealt to JJin91 [4c Ac]
mmenz08816: folds=20
jj0420&&78 has timed out
jj0420&&78: folds=20
jj0420&&78 is sitting out
helzkitchen: folds=20
jj0420&&78 has returned
iFoldN0T: raises 100 to 150
senor stinks: folds=20
lennycappy: folds=20
JJin91: raises 300 to 450
TheBulldawgg: folds=20
iFoldN0T: calls 300
*** FLOP *** [Jc 9h Th]
JJin91: bets 485
iFoldN0T: calls 485
*** TURN *** [Jc 9h Th] [4h]
JJin91: checks=20
iFoldN0T: bets 1350
JJin91: folds=20
Uncalled bet (1350) returned to iFoldN0T
iFoldN0T collected 1920 from pot
iFoldN0T: doesn't show hand=20
*** SUMMARY ***
Total pot 1920 | Rake 0=20
Board [Jc 9h Th 4h]
Seat 1: mmenz08816 folded before Flop (didn't bet)
Seat 2: jj0420&&78 folded before Flop (didn't bet)
Seat 4: helzkitchen folded before Flop (didn't bet)
Seat 5: iFoldN0T collected (1920)
Seat 6: senor stinks folded before Flop (didn't bet)
Seat 7: lennycappy (button) folded before Flop (didn't bet)
Seat 8: JJin91 (small blind) folded on the Turn
Seat 9: TheBulldawgg (big blind) folded before Flop


*********** # 6 **************
PokerStars Hand #175009024108: Tournament #1701776547, $18.20+$1.80 USD=
 Hold'em No Limit - Level I (25/50) - 2017/09/13 19:05:49 ET
Table '1701776547 2' 9-max Seat #8 is the button
Seat 2: jj0420&&78 (9562 in chips)=20
Seat 3: bulibasav (10000 in chips)=20
Seat 4: helzkitchen (9750 in chips)=20
Seat 5: iFoldN0T (10273 in chips)=20
Seat 6: senor stinks (11850 in chips)=20
Seat 7: lennycappy (9600 in chips)=20
Seat 8: JJin91 (9015 in chips)=20
Seat 9: TheBulldawgg (9950 in chips)=20
TheBulldawgg: posts small blind 25
jj0420&&78: posts big blind 50
*** HOLE CARDS ***
Dealt to JJin91 [3d 6c]
bulibasav: folds=20
helzkitchen: folds=20
iFoldN0T: folds=20
senor stinks: folds=20
lennycappy: raises 50 to 100
JJin91: folds=20
TheBulldawgg: folds=20
jj0420&&78: calls 50
*** FLOP *** [3h Jc Ac]
jj0420&&78: checks=20
lennycappy: checks=20
*** TURN *** [3h Jc Ac] [8c]
jj0420&&78: bets 50
lennycappy: calls 50
*** RIVER *** [3h Jc Ac 8c] [5d]
jj0420&&78: bets 300
lennycappy: calls 300
*** SHOW DOWN ***
jj0420&&78: shows [Kh 2h] (high card Ace)
lennycappy: shows [Ah Tc] (a pair of Aces)
lennycappy collected 925 from pot
*** SUMMARY ***
Total pot 925 | Rake 0=20
Board [3h Jc Ac 8c 5d]
Seat 2: jj0420&&78 (big blind) showed [Kh 2h] and lost with high card A=
ce
Seat 3: bulibasav folded before Flop (didn't bet)
Seat 4: helzkitchen folded before Flop (didn't bet)
Seat 5: iFoldN0T folded before Flop (didn't bet)
Seat 6: senor stinks folded before Flop (didn't bet)
Seat 7: lennycappy showed [Ah Tc] and won (925) with a pair of Aces
Seat 8: JJin91 (button) folded before Flop (didn't bet)
Seat 9: TheBulldawgg (small blind) folded before Flop


*********** # 7 **************
PokerStars Hand #175009024198: Tournament #1701776547, $18.20+$1.80 USD=
 Hold'em No Limit - Level I (25/50) - 2017/09/13 19:06:19 ET
Table '1701776547 2' 9-max Seat #9 is the button
Seat 2: jj0420&&78 (9112 in chips)=20
Seat 4: helzkitchen (9750 in chips)=20
Seat 5: iFoldN0T (10273 in chips)=20
Seat 6: senor stinks (11850 in chips)=20
Seat 7: lennycappy (10075 in chips)=20
Seat 8: JJin91 (9015 in chips)=20
Seat 9: TheBulldawgg (9925 in chips)=20
jj0420&&78: posts small blind 25
helzkitchen: posts big blind 50
*** HOLE CARDS ***
Dealt to JJin91 [Td 9s]
iFoldN0T: folds=20
senor stinks: folds=20
lennycappy: folds=20
JJin91: folds=20
TheBulldawgg: raises 200 to 250
jj0420&&78: calls 225
helzkitchen: calls 200
*** FLOP *** [Jh Jd 3s]
jj0420&&78: checks=20
helzkitchen: checks=20
TheBulldawgg: checks=20
*** TURN *** [Jh Jd 3s] [Ks]
jj0420&&78: checks=20
helzkitchen: checks=20
TheBulldawgg: bets 250
jj0420&&78: raises 250 to 500
helzkitchen: folds=20
TheBulldawgg: calls 250
*** RIVER *** [Jh Jd 3s Ks] [2d]
jj0420&&78: bets 1750
TheBulldawgg: raises 7425 to 9175 and is all-in
jj0420&&78: folds=20
Uncalled bet (7425) returned to TheBulldawgg
TheBulldawgg collected 5250 from pot
TheBulldawgg: doesn't show hand=20
*** SUMMARY ***
Total pot 5250 | Rake 0=20
Board [Jh Jd 3s Ks 2d]
Seat 2: jj0420&&78 (small blind) folded on the River
Seat 4: helzkitchen (big blind) folded on the Turn
Seat 5: iFoldN0T folded before Flop (didn't bet)
Seat 6: senor stinks folded before Flop (didn't bet)
Seat 7: lennycappy folded before Flop (didn't bet)
Seat 8: JJin91 folded before Flop (didn't bet)
Seat 9: TheBulldawgg (button) collected (5250)


*********** # 8 **************
PokerStars Hand #175009024496: Tournament #1701776547, $18.20+$1.80 USD=
 Hold'em No Limit - Level I (25/50) - 2017/09/13 19:07:49 ET
Table '1701776547 2' 9-max Seat #2 is the button
Seat 1: WyldCard33 (9550 in chips)=20
Seat 2: jj0420&&78 (6612 in chips)=20
Seat 3: JerseyRU (11039 in chips) out of hand (moved from another table=
 into small blind)
Seat 4: helzkitchen (9500 in chips)=20
Seat 6: senor stinks (11850 in chips)=20
Seat 7: lennycappy (10075 in chips)=20
Seat 8: JJin91 (9015 in chips)=20
Seat 9: TheBulldawgg (12675 in chips)=20
helzkitchen: posts small blind 25
senor stinks: posts big blind 50
*** HOLE CARDS ***
Dealt to JJin91 [Ah 7c]
lennycappy: folds=20
JJin91: folds=20
TheBulldawgg: folds=20
WyldCard33: folds=20
jj0420&&78: calls 50
helzkitchen: folds=20
senor stinks: checks=20
*** FLOP *** [Qh 4d 7d]
senor stinks: checks=20
jj0420&&78: checks=20
*** TURN *** [Qh 4d 7d] [2s]
senor stinks: bets 100
jj0420&&78: calls 100
*** RIVER *** [Qh 4d 7d 2s] [5c]
senor stinks: bets 200
jj0420&&78: folds=20
Uncalled bet (200) returned to senor stinks
senor stinks collected 325 from pot
senor stinks: doesn't show hand=20
*** SUMMARY ***
Total pot 325 | Rake 0=20
Board [Qh 4d 7d 2s 5c]
Seat 1: WyldCard33 folded before Flop (didn't bet)
Seat 2: jj0420&&78 (button) folded on the River
Seat 4: helzkitchen (small blind) folded before Flop
Seat 6: senor stinks (big blind) collected (325)
Seat 7: lennycappy folded before Flop (didn't bet)
Seat 8: JJin91 folded before Flop (didn't bet)
Seat 9: TheBulldawgg folded before Flop (didn't bet)


*********** # 9 **************
PokerStars Hand #175009024599: Tournament #1701776547, $18.20+$1.80 USD=
 Hold'em No Limit - Level I (25/50) - 2017/09/13 19:08:21 ET
Table '1701776547 2' 9-max Seat #4 is the button
Seat 1: WyldCard33 (9550 in chips)=20
Seat 2: jj0420&&78 (6462 in chips)=20
Seat 3: JerseyRU (11039 in chips)=20
Seat 4: helzkitchen (9475 in chips)=20
Seat 6: senor stinks (12025 in chips)=20
Seat 8: JJin91 (9015 in chips)=20
Seat 9: TheBulldawgg (12675 in chips)=20
senor stinks: posts small blind 25
JJin91: posts big blind 50
*** HOLE CARDS ***
Dealt to JJin91 [4c As]
TheBulldawgg: folds=20
WyldCard33: folds=20
jj0420&&78: folds=20
JerseyRU: raises 100 to 150
helzkitchen: raises 250 to 400
senor stinks: folds=20
JJin91: folds=20
JerseyRU: calls 250
*** FLOP *** [Qd 5h Qc]
JerseyRU: checks=20
helzkitchen: bets 263
JerseyRU: folds=20
Uncalled bet (263) returned to helzkitchen
helzkitchen collected 875 from pot
helzkitchen: doesn't show hand=20
*** SUMMARY ***
Total pot 875 | Rake 0=20
Board [Qd 5h Qc]
Seat 1: WyldCard33 folded before Flop (didn't bet)
Seat 2: jj0420&&78 folded before Flop (didn't bet)
Seat 3: JerseyRU folded on the Flop
Seat 4: helzkitchen (button) collected (875)
Seat 6: senor stinks (small blind) folded before Flop
Seat 8: JJin91 (big blind) folded before Flop
Seat 9: TheBulldawgg folded before Flop (didn't bet)


*********** # 10 **************
PokerStars Hand #175009024748: Tournament #1701776547, $18.20+$1.80 USD=
 Hold'em No Limit - Level I (25/50) - 2017/09/13 19:09:03 ET
Table '1701776547 2' 9-max Seat #6 is the button
Seat 2: jj0420&&78 (6462 in chips)=20
Seat 3: JerseyRU (10639 in chips)=20
Seat 4: helzkitchen (9950 in chips)=20
Seat 6: senor stinks (12000 in chips)=20
Seat 8: JJin91 (8965 in chips)=20
Seat 9: TheBulldawgg (12675 in chips)=20
JJin91: posts small blind 25
TheBulldawgg: posts big blind 50
*** HOLE CARDS ***
Dealt to JJin91 [5d Kd]
jj0420&&78: raises 50 to 100
JerseyRU: folds=20
helzkitchen: folds=20
senor stinks: folds=20
JJin91: folds=20
TheBulldawgg: folds=20
Uncalled bet (50) returned to jj0420&&78
jj0420&&78 collected 125 from pot
jj0420&&78: doesn't show hand=20
*** SUMMARY ***
Total pot 125 | Rake 0=20
Seat 2: jj0420&&78 collected (125)
Seat 3: JerseyRU folded before Flop (didn't bet)
Seat 4: helzkitchen folded before Flop (didn't bet)
Seat 6: senor stinks (button) folded before Flop (didn't bet)
Seat 8: JJin91 (small blind) folded before Flop
Seat 9: TheBulldawgg (big blind) folded before Flop


*********** # 11 **************
PokerStars Hand #175009024827: Tournament #1701776547, $18.20+$1.80 USD=
 Hold'em No Limit - Level I (25/50) - 2017/09/13 19:09:28 ET
Table '1701776547 2' 9-max Seat #8 is the button
Seat 2: jj0420&&78 (6537 in chips)=20
Seat 3: JerseyRU (10639 in chips)=20
Seat 4: helzkitchen (9950 in chips)=20
Seat 6: senor stinks (12000 in chips)=20
Seat 8: JJin91 (8940 in chips)=20
Seat 9: TheBulldawgg (12625 in chips)=20
TheBulldawgg: posts small blind 25
jj0420&&78: posts big blind 50
*** HOLE CARDS ***
Dealt to JJin91 [2h Ks]
JerseyRU: raises 100 to 150
helzkitchen: raises 150 to 300
senor stinks: folds=20
JJin91: folds=20
TheBulldawgg: folds=20
jj0420&&78: calls 250
JerseyRU: raises 950 to 1250
helzkitchen: calls 950
jj0420&&78: calls 950
*** FLOP *** [Ad 7c 5c]
jj0420&&78: bets 5287 and is all-in
JerseyRU: folds=20
helzkitchen: folds=20
Uncalled bet (5287) returned to jj0420&&78
jj0420&&78 collected 3775 from pot
jj0420&&78: doesn't show hand=20
*** SUMMARY ***
Total pot 3775 | Rake 0=20
Board [Ad 7c 5c]
Seat 2: jj0420&&78 (big blind) collected (3775)
Seat 3: JerseyRU folded on the Flop
Seat 4: helzkitchen folded on the Flop
Seat 6: senor stinks folded before Flop (didn't bet)
Seat 8: JJin91 (button) folded before Flop (didn't bet)
Seat 9: TheBulldawgg (small blind) folded before Flop


*********** # 12 **************
PokerStars Hand #175009025038: Tournament #1701776547, $18.20+$1.80 USD=
 Hold'em No Limit - Level II (30/60) - 2017/09/13 19:10:31 ET
Table '1701776547 2' 9-max Seat #9 is the button
Seat 2: jj0420&&78 (9062 in chips)=20
Seat 3: JerseyRU (9389 in chips)=20
Seat 4: helzkitchen (8700 in chips)=20
Seat 6: senor stinks (12000 in chips)=20
Seat 8: JJin91 (8940 in chips)=20
Seat 9: TheBulldawgg (12600 in chips)=20
jj0420&&78: posts small blind 30
JerseyRU: posts big blind 60
*** HOLE CARDS ***
Dealt to JJin91 [4d 3c]
helzkitchen: raises 120 to 180
senor stinks: folds=20
JJin91: folds=20
TheBulldawgg: folds=20
jj0420&&78: calls 150
JerseyRU: folds=20
*** FLOP *** [8s Kh Ks]
jj0420&&78: bets 60
helzkitchen: calls 60
*** TURN *** [8s Kh Ks] [5c]
jj0420&&78: bets 60
helzkitchen: calls 60
*** RIVER *** [8s Kh Ks 5c] [6s]
jj0420&&78: bets 60
helzkitchen: calls 60
*** SHOW DOWN ***
jj0420&&78: shows [8h 9h] (two pair, Kings and Eights)
helzkitchen: mucks hand=20
jj0420&&78 collected 780 from pot
*** SUMMARY ***
Total pot 780 | Rake 0=20
Board [8s Kh Ks 5c 6s]
Seat 2: jj0420&&78 (small blind) showed [8h 9h] and won (780) with two =
pair, Kings and Eights
Seat 3: JerseyRU (big blind) folded before Flop
Seat 4: helzkitchen mucked [As Tc]
Seat 6: senor stinks folded before Flop (didn't bet)
Seat 8: JJin91 folded before Flop (didn't bet)
Seat 9: TheBulldawgg (button) folded before Flop (didn't bet)


*********** # 13 **************
PokerStars Hand #175009025165: Tournament #1701776547, $18.20+$1.80 USD=
 Hold'em No Limit - Level II (30/60) - 2017/09/13 19:11:05 ET
Table '1701776547 2' 9-max Seat #2 is the button
Seat 2: jj0420&&78 (9482 in chips)=20
Seat 3: JerseyRU (9329 in chips)=20
Seat 4: helzkitchen (8340 in chips)=20
Seat 6: senor stinks (12000 in chips)=20
Seat 8: JJin91 (8940 in chips)=20
Seat 9: TheBulldawgg (12600 in chips)=20
JerseyRU: posts small blind 30
helzkitchen: posts big blind 60
*** HOLE CARDS ***
Dealt to JJin91 [Kh 9c]
senor stinks: folds=20
JJin91: raises 70 to 130
TheBulldawgg: folds=20
jj0420&&78: raises 70 to 200
JerseyRU: folds=20
helzkitchen: folds=20
JJin91: calls 70
*** FLOP *** [6h Tc 9d]
JJin91: checks=20
jj0420&&78: bets 480
JJin91: calls 480
*** TURN *** [6h Tc 9d] [Ks]
JJin91: checks=20
jj0420&&78: checks=20
*** RIVER *** [6h Tc 9d Ks] [2c]
JJin91: bets 740
jj0420&&78: calls 740
*** SHOW DOWN ***
JJin91: shows [Kh 9c] (two pair, Kings and Nines)
jj0420&&78: mucks hand=20
JJin91 collected 2930 from pot
*** SUMMARY ***
Total pot 2930 | Rake 0=20
Board [6h Tc 9d Ks 2c]
Seat 2: jj0420&&78 (button) mucked [Qs Qh]
Seat 3: JerseyRU (small blind) folded before Flop
Seat 4: helzkitchen (big blind) folded before Flop
Seat 6: senor stinks folded before Flop (didn't bet)
Seat 8: JJin91 showed [Kh 9c] and won (2930) with two pair, Kings and N=
ines
Seat 9: TheBulldawgg folded before Flop (didn't bet)


*********** # 14 **************
PokerStars Hand #175009025374: Tournament #1701776547, $18.20+$1.80 USD=
 Hold'em No Limit - Level II (30/60) - 2017/09/13 19:12:10 ET
Table '1701776547 2' 9-max Seat #3 is the button
Seat 2: jj0420&&78 (8062 in chips)=20
Seat 3: JerseyRU (9299 in chips)=20
Seat 4: helzkitchen (8280 in chips)=20
Seat 6: senor stinks (12000 in chips)=20
Seat 8: JJin91 (10450 in chips)=20
Seat 9: TheBulldawgg (12600 in chips)=20
helzkitchen: posts small blind 30
senor stinks: posts big blind 60
*** HOLE CARDS ***
Dealt to JJin91 [2s 4c]
JJin91: folds=20
TheBulldawgg: folds=20
jj0420&&78: folds=20
JerseyRU: folds=20
helzkitchen: calls 30
senor stinks: raises 180 to 240
helzkitchen: calls 180
*** FLOP *** [Kh 3s 8d]
helzkitchen: checks=20
senor stinks: bets 240
helzkitchen: calls 240
*** TURN *** [Kh 3s 8d] [Js]
helzkitchen: checks=20
senor stinks: checks=20
*** RIVER *** [Kh 3s 8d Js] [6h]
helzkitchen: bets 480
senor stinks: calls 480
*** SHOW DOWN ***
helzkitchen: shows [Jc Qd] (a pair of Jacks)
senor stinks: mucks hand=20
helzkitchen collected 1920 from pot
*** SUMMARY ***
Total pot 1920 | Rake 0=20
Board [Kh 3s 8d Js 6h]
Seat 2: jj0420&&78 folded before Flop (didn't bet)
Seat 3: JerseyRU (button) folded before Flop (didn't bet)
Seat 4: helzkitchen (small blind) showed [Jc Qd] and won (1920) with a =
pair of Jacks
Seat 6: senor stinks (big blind) mucked [Jd Td]
Seat 8: JJin91 folded before Flop (didn't bet)
Seat 9: TheBulldawgg folded before Flop (didn't bet)


*********** # 15 **************
PokerStars Hand #175009025546: Tournament #1701776547, $18.20+$1.80 USD=
 Hold'em No Limit - Level II (30/60) - 2017/09/13 19:12:57 ET
Table '1701776547 2' 9-max Seat #4 is the button
Seat 2: jj0420&&78 (8062 in chips)=20
Seat 3: JerseyRU (9299 in chips)=20
Seat 4: helzkitchen (9240 in chips)=20
Seat 6: senor stinks (11040 in chips)=20
Seat 8: JJin91 (10450 in chips)=20
Seat 9: TheBulldawgg (12600 in chips)=20
senor stinks: posts small blind 30
JJin91: posts big blind 60
*** HOLE CARDS ***
Dealt to JJin91 [Tc 2d]
TheBulldawgg: calls 60
jj0420&&78: calls 60
JerseyRU: folds=20
helzkitchen: folds=20
senor stinks: calls 30
JJin91: checks=20
*** FLOP *** [7c Td 6d]
senor stinks: bets 180
JJin91: calls 180
TheBulldawgg: calls 180
jj0420&&78: calls 180
*** TURN *** [7c Td 6d] [9d]
senor stinks: checks=20
JJin91: checks=20
TheBulldawgg: bets 550
jj0420&&78: folds=20
senor stinks: calls 550
JJin91: folds=20
*** RIVER *** [7c Td 6d 9d] [9c]
senor stinks: bets 10250 and is all-in
TheBulldawgg: folds=20
Uncalled bet (10250) returned to senor stinks
senor stinks collected 2060 from pot
senor stinks: doesn't show hand=20
*** SUMMARY ***
Total pot 2060 | Rake 0=20
Board [7c Td 6d 9d 9c]
Seat 2: jj0420&&78 folded on the Turn
Seat 3: JerseyRU folded before Flop (didn't bet)
Seat 4: helzkitchen (button) folded before Flop (didn't bet)
Seat 6: senor stinks (small blind) collected (2060)
Seat 8: JJin91 (big blind) folded on the Turn
Seat 9: TheBulldawgg folded on the River


*********** # 16 **************
PokerStars Hand #175009025867: Tournament #1701776547, $18.20+$1.80 USD=
 Hold'em No Limit - Level II (30/60) - 2017/09/13 19:14:40 ET
Table '1701776547 2' 9-max Seat #6 is the button
Seat 2: jj0420&&78 (7822 in chips)=20
Seat 3: JerseyRU (9299 in chips)=20
Seat 4: helzkitchen (9240 in chips)=20
Seat 6: senor stinks (12310 in chips)=20
Seat 8: JJin91 (10210 in chips)=20
Seat 9: TheBulldawgg (11810 in chips)=20
JJin91: posts small blind 30
TheBulldawgg: posts big blind 60
*** HOLE CARDS ***
Dealt to JJin91 [9s Th]
jj0420&&78: raises 60 to 120
JerseyRU: folds=20
helzkitchen: folds=20
senor stinks: folds=20
TheBulldawgg said, "you have the boat?"
JJin91: folds=20
TheBulldawgg: folds=20
Uncalled bet (60) returned to jj0420&&78
jj0420&&78 collected 150 from pot
jj0420&&78: doesn't show hand=20
*** SUMMARY ***
Total pot 150 | Rake 0=20
Seat 2: jj0420&&78 collected (150)
Seat 3: JerseyRU folded before Flop (didn't bet)
Seat 4: helzkitchen folded before Flop (didn't bet)
Seat 6: senor stinks (button) folded before Flop (didn't bet)
Seat 8: JJin91 (small blind) folded before Flop
Seat 9: TheBulldawgg (big blind) folded before Flop


*********** # 17 **************
PokerStars Hand #175009025919: Tournament #1701776547, $18.20+$1.80 USD=
 Hold'em No Limit - Level II (30/60) - 2017/09/13 19:14:56 ET
Table '1701776547 2' 9-max Seat #8 is the button
Seat 2: jj0420&&78 (7912 in chips)=20
Seat 3: JerseyRU (9299 in chips)=20
Seat 4: helzkitchen (9240 in chips)=20
Seat 6: senor stinks (12310 in chips)=20
Seat 8: JJin91 (10180 in chips)=20
Seat 9: TheBulldawgg (11750 in chips)=20
TheBulldawgg: posts small blind 30
jj0420&&78: posts big blind 60
*** HOLE CARDS ***
Dealt to JJin91 [4h 2c]
JerseyRU: raises 120 to 180
helzkitchen: folds=20
senor stinks: folds=20
JJin91: folds=20
TheBulldawgg: folds=20
jj0420&&78: calls 120
*** FLOP *** [6c 7d Th]
jj0420&&78: bets 360
JerseyRU: raises 600 to 960
jj0420&&78: folds=20
Uncalled bet (600) returned to JerseyRU
JerseyRU collected 1110 from pot
JerseyRU: doesn't show hand=20
*** SUMMARY ***
Total pot 1110 | Rake 0=20
Board [6c 7d Th]
Seat 2: jj0420&&78 (big blind) folded on the Flop
Seat 3: JerseyRU collected (1110)
Seat 4: helzkitchen folded before Flop (didn't bet)
Seat 6: senor stinks folded before Flop (didn't bet)
Seat 8: JJin91 (button) folded before Flop (didn't bet)
Seat 9: TheBulldawgg (small blind) folded before Flop


*********** # 18 **************
PokerStars Hand #175009026080: Tournament #1701776547, $18.20+$1.80 USD=
 Hold'em No Limit - Level II (30/60) - 2017/09/13 19:15:47 ET
Table '1701776547 2' 9-max Seat #9 is the button
Seat 2: jj0420&&78 (7372 in chips)=20
Seat 3: JerseyRU (9869 in chips)=20
Seat 4: helzkitchen (9240 in chips)=20
Seat 6: senor stinks (12310 in chips)=20
Seat 8: JJin91 (10180 in chips)=20
Seat 9: TheBulldawgg (11720 in chips)=20
jj0420&&78: posts small blind 30
JerseyRU: posts big blind 60
*** HOLE CARDS ***
Dealt to JJin91 [4s Ah]
helzkitchen: folds=20
senor stinks: folds=20
JJin91: raises 70 to 130
TheBulldawgg: calls 130
jj0420&&78: calls 100
JerseyRU: folds=20
*** FLOP *** [8s 9c 4c]
jj0420&&78: checks=20
JJin91: bets 288
TheBulldawgg: calls 288
jj0420&&78: folds=20
*** TURN *** [8s 9c 4c] [Jc]
JJin91: checks=20
TheBulldawgg: bets 600
JJin91: folds=20
Uncalled bet (600) returned to TheBulldawgg
TheBulldawgg collected 1026 from pot
TheBulldawgg: doesn't show hand=20
*** SUMMARY ***
Total pot 1026 | Rake 0=20
Board [8s 9c 4c Jc]
Seat 2: jj0420&&78 (small blind) folded on the Flop
Seat 3: JerseyRU (big blind) folded before Flop
Seat 4: helzkitchen folded before Flop (didn't bet)
Seat 6: senor stinks folded before Flop (didn't bet)
Seat 8: JJin91 folded on the Turn
Seat 9: TheBulldawgg (button) collected (1026)


*********** # 19 **************
PokerStars Hand #175009026339: Tournament #1701776547, $18.20+$1.80 USD=
 Hold'em No Limit - Level II (30/60) - 2017/09/13 19:17:10 ET
Table '1701776547 2' 9-max Seat #2 is the button
Seat 2: jj0420&&78 (7242 in chips)=20
Seat 3: JerseyRU (9809 in chips)=20
Seat 4: helzkitchen (9240 in chips)=20
Seat 6: senor stinks (12310 in chips)=20
Seat 8: JJin91 (9762 in chips)=20
Seat 9: TheBulldawgg (12328 in chips)=20
JerseyRU: posts small blind 30
helzkitchen: posts big blind 60
*** HOLE CARDS ***
Dealt to JJin91 [2c Jc]
senor stinks: folds=20
JJin91: folds=20
TheBulldawgg: folds=20
jj0420&&78: raises 150 to 210
JerseyRU: calls 180
helzkitchen: folds=20
*** FLOP *** [4s 8d Js]
JerseyRU: checks=20
jj0420&&78: bets 60
JerseyRU: folds=20
Uncalled bet (60) returned to jj0420&&78
jj0420&&78 collected 480 from pot
jj0420&&78: doesn't show hand=20
*** SUMMARY ***
Total pot 480 | Rake 0=20
Board [4s 8d Js]
Seat 2: jj0420&&78 (button) collected (480)
Seat 3: JerseyRU (small blind) folded on the Flop
Seat 4: helzkitchen (big blind) folded before Flop
Seat 6: senor stinks folded before Flop (didn't bet)
Seat 8: JJin91 folded before Flop (didn't bet)
Seat 9: TheBulldawgg folded before Flop (didn't bet)


*********** # 20 **************
PokerStars Hand #175009026440: Tournament #1701776547, $18.20+$1.80 USD=
 Hold'em No Limit - Level II (30/60) - 2017/09/13 19:17:41 ET
Table '1701776547 2' 9-max Seat #3 is the button
Seat 2: jj0420&&78 (7512 in chips)=20
Seat 3: JerseyRU (9599 in chips)=20
Seat 4: helzkitchen (9180 in chips)=20
Seat 6: senor stinks (12310 in chips)=20
Seat 8: JJin91 (9762 in chips)=20
Seat 9: TheBulldawgg (12328 in chips)=20
helzkitchen: posts small blind 30
senor stinks: posts big blind 60
*** HOLE CARDS ***
Dealt to JJin91 [6s Kd]
JJin91: folds=20
TheBulldawgg: raises 90 to 150
jj0420&&78: calls 150
JerseyRU: calls 150
helzkitchen: folds=20
senor stinks: folds=20
*** FLOP *** [Ks Tc 2s]
TheBulldawgg: bets 180
jj0420&&78: folds=20
JerseyRU: calls 180
*** TURN *** [Ks Tc 2s] [3c]
TheBulldawgg: bets 500
JerseyRU: calls 500
*** RIVER *** [Ks Tc 2s 3c] [Qd]
TheBulldawgg: bets 700
JerseyRU: folds=20
Uncalled bet (700) returned to TheBulldawgg
TheBulldawgg collected 1900 from pot
TheBulldawgg: doesn't show hand=20
*** SUMMARY ***
Total pot 1900 | Rake 0=20
Board [Ks Tc 2s 3c Qd]
Seat 2: jj0420&&78 folded on the Flop
Seat 3: JerseyRU (button) folded on the River
Seat 4: helzkitchen (small blind) folded before Flop
Seat 6: senor stinks (big blind) folded before Flop
Seat 8: JJin91 folded before Flop (didn't bet)
Seat 9: TheBulldawgg collected (1900)


*********** # 21 **************
PokerStars Hand #175009026686: Tournament #1701776547, $18.20+$1.80 USD=
 Hold'em No Limit - Level II (30/60) - 2017/09/13 19:18:50 ET
Table '1701776547 2' 9-max Seat #4 is the button
Seat 2: jj0420&&78 (7362 in chips)=20
Seat 3: JerseyRU (8769 in chips)=20
Seat 4: helzkitchen (9150 in chips)=20
Seat 5: Ch1no354 (10000 in chips) out of hand (moved from another table=
 into small blind)
Seat 6: senor stinks (12250 in chips)=20
Seat 8: JJin91 (9762 in chips)=20
Seat 9: TheBulldawgg (13398 in chips)=20
senor stinks: posts small blind 30
JJin91: posts big blind 60
*** HOLE CARDS ***
Dealt to JJin91 [8h 3c]
TheBulldawgg: folds=20
jj0420&&78: raises 60 to 120
JerseyRU: folds=20
helzkitchen: folds=20
senor stinks: raises 420 to 540
JJin91: folds=20
jj0420&&78: calls 420
*** FLOP *** [6s As 5h]
senor stinks: checks=20
jj0420&&78: bets 60
senor stinks: calls 60
*** TURN *** [6s As 5h] [Js]
senor stinks: checks=20
jj0420&&78: bets 600
senor stinks: folds=20
Uncalled bet (600) returned to jj0420&&78
jj0420&&78 collected 1260 from pot
jj0420&&78: doesn't show hand=20
*** SUMMARY ***
Total pot 1260 | Rake 0=20
Board [6s As 5h Js]
Seat 2: jj0420&&78 collected (1260)
Seat 3: JerseyRU folded before Flop (didn't bet)
Seat 4: helzkitchen (button) folded before Flop (didn't bet)
Seat 6: senor stinks (small blind) folded on the Turn
Seat 8: JJin91 (big blind) folded before Flop
Seat 9: TheBulldawgg folded before Flop (didn't bet)


*********** # 22 **************
PokerStars Hand #175009026876: Tournament #1701776547, $18.20+$1.80 USD=
 Hold'em No Limit - Level II (30/60) - 2017/09/13 19:19:48 ET
Table '1701776547 2' 9-max Seat #6 is the button
Seat 2: jj0420&&78 (8022 in chips)=20
Seat 3: JerseyRU (8769 in chips)=20
Seat 4: helzkitchen (9150 in chips)=20
Seat 5: Ch1no354 (10000 in chips)=20
Seat 6: senor stinks (11650 in chips)=20
Seat 8: JJin91 (9702 in chips)=20
Seat 9: TheBulldawgg (13398 in chips)=20
JJin91: posts small blind 30
TheBulldawgg: posts big blind 60
*** HOLE CARDS ***
Dealt to JJin91 [Ks Qh]
jj0420&&78: raises 60 to 120
JerseyRU: folds=20
helzkitchen: folds=20
Ch1no354: folds=20
senor stinks: folds=20
JJin91: raises 546 to 666
TheBulldawgg: folds=20
jj0420&&78: raises 7356 to 8022 and is all-in
JJin91: folds=20
Uncalled bet (7356) returned to jj0420&&78
jj0420&&78 collected 1392 from pot
jj0420&&78: doesn't show hand=20
*** SUMMARY ***
Total pot 1392 | Rake 0=20
Seat 2: jj0420&&78 collected (1392)
Seat 3: JerseyRU folded before Flop (didn't bet)
Seat 4: helzkitchen folded before Flop (didn't bet)
Seat 5: Ch1no354 folded before Flop (didn't bet)
Seat 6: senor stinks (button) folded before Flop (didn't bet)
Seat 8: JJin91 (small blind) folded before Flop
Seat 9: TheBulldawgg (big blind) folded before Flop


*********** # 23 **************
PokerStars Hand #175009027101: Tournament #1701776547, $18.20+$1.80 USD=
 Hold'em No Limit - Level III (40/80) - 2017/09/13 19:20:53 ET
Table '1701776547 2' 9-max Seat #8 is the button
Seat 2: jj0420&&78 (8748 in chips)=20
Seat 3: JerseyRU (8769 in chips)=20
Seat 4: helzkitchen (9150 in chips)=20
Seat 5: Ch1no354 (10000 in chips)=20
Seat 6: senor stinks (11650 in chips)=20
Seat 8: JJin91 (9036 in chips)=20
Seat 9: TheBulldawgg (13338 in chips)=20
TheBulldawgg: posts small blind 40
jj0420&&78: posts big blind 80
*** HOLE CARDS ***
Dealt to JJin91 [3s 9s]
JerseyRU: folds=20
helzkitchen: raises 240 to 320
Ch1no354: folds=20
senor stinks: folds=20
JJin91: folds=20
TheBulldawgg: folds=20
jj0420&&78: calls 240
*** FLOP *** [2c 3d Qc]
jj0420&&78: checks=20
helzkitchen: checks=20
*** TURN *** [2c 3d Qc] [Ah]
jj0420&&78: bets 80
helzkitchen: raises 320 to 400
jj0420&&78: calls 320
*** RIVER *** [2c 3d Qc Ah] [Ks]
jj0420&&78: checks=20
helzkitchen: bets 740
jj0420&&78: folds=20
Uncalled bet (740) returned to helzkitchen
helzkitchen collected 1480 from pot
helzkitchen: doesn't show hand=20
*** SUMMARY ***
Total pot 1480 | Rake 0=20
Board [2c 3d Qc Ah Ks]
Seat 2: jj0420&&78 (big blind) folded on the River
Seat 3: JerseyRU folded before Flop (didn't bet)
Seat 4: helzkitchen collected (1480)
Seat 5: Ch1no354 folded before Flop (didn't bet)
Seat 6: senor stinks folded before Flop (didn't bet)
Seat 8: JJin91 (button) folded before Flop (didn't bet)
Seat 9: TheBulldawgg (small blind) folded before Flop


*********** # 24 **************
PokerStars Hand #175009027283: Tournament #1701776547, $18.20+$1.80 USD=
 Hold'em No Limit - Level III (40/80) - 2017/09/13 19:21:49 ET
Table '1701776547 2' 9-max Seat #9 is the button
Seat 2: jj0420&&78 (8028 in chips)=20
Seat 3: JerseyRU (8769 in chips)=20
Seat 4: helzkitchen (9910 in chips)=20
Seat 5: Ch1no354 (10000 in chips)=20
Seat 6: senor stinks (11650 in chips)=20
Seat 8: JJin91 (9036 in chips)=20
Seat 9: TheBulldawgg (13298 in chips)=20
jj0420&&78: posts small blind 40
JerseyRU: posts big blind 80
*** HOLE CARDS ***
Dealt to JJin91 [7d 6d]
helzkitchen: folds=20
Ch1no354: folds=20
senor stinks: raises 160 to 240
JJin91: folds=20
TheBulldawgg: folds=20
jj0420&&78: calls 200
JerseyRU: folds=20
*** FLOP *** [8h 8c Td]
jj0420&&78: checks=20
senor stinks: checks=20
*** TURN *** [8h 8c Td] [Th]
jj0420&&78: checks=20
senor stinks: checks=20
*** RIVER *** [8h 8c Td Th] [Qs]
jj0420&&78: bets 560
senor stinks: folds=20
Uncalled bet (560) returned to jj0420&&78
jj0420&&78 collected 560 from pot
jj0420&&78: doesn't show hand=20
*** SUMMARY ***
Total pot 560 | Rake 0=20
Board [8h 8c Td Th Qs]
Seat 2: jj0420&&78 (small blind) collected (560)
Seat 3: JerseyRU (big blind) folded before Flop
Seat 4: helzkitchen folded before Flop (didn't bet)
Seat 5: Ch1no354 folded before Flop (didn't bet)
Seat 6: senor stinks folded on the River
Seat 8: JJin91 folded before Flop (didn't bet)
Seat 9: TheBulldawgg (button) folded before Flop (didn't bet)


*********** # 25 **************
PokerStars Hand #175009027449: Tournament #1701776547, $18.20+$1.80 USD=
 Hold'em No Limit - Level III (40/80) - 2017/09/13 19:22:40 ET
Table '1701776547 2' 9-max Seat #2 is the button
Seat 2: jj0420&&78 (8348 in chips)=20
Seat 3: JerseyRU (8689 in chips)=20
Seat 4: helzkitchen (9910 in chips)=20
Seat 5: Ch1no354 (10000 in chips)=20
Seat 6: senor stinks (11410 in chips)=20
Seat 8: JJin91 (9036 in chips)=20
Seat 9: TheBulldawgg (13298 in chips)=20
JerseyRU: posts small blind 40
helzkitchen: posts big blind 80
*** HOLE CARDS ***
Dealt to JJin91 [Ah 4s]
Ch1no354: folds=20
senor stinks: folds=20
JJin91: folds=20
TheBulldawgg: raises 120 to 200
jj0420&&78: folds=20
JerseyRU: folds=20
helzkitchen: folds=20
Uncalled bet (120) returned to TheBulldawgg
TheBulldawgg collected 200 from pot
TheBulldawgg: doesn't show hand=20
*** SUMMARY ***
Total pot 200 | Rake 0=20
Seat 2: jj0420&&78 (button) folded before Flop (didn't bet)
Seat 3: JerseyRU (small blind) folded before Flop
Seat 4: helzkitchen (big blind) folded before Flop
Seat 5: Ch1no354 folded before Flop (didn't bet)
Seat 6: senor stinks folded before Flop (didn't bet)
Seat 8: JJin91 folded before Flop (didn't bet)
Seat 9: TheBulldawgg collected (200)


*********** # 26 **************
PokerStars Hand #175009027556: Tournament #1701776547, $18.20+$1.80 USD=
 Hold'em No Limit - Level III (40/80) - 2017/09/13 19:23:12 ET
Table '1701776547 2' 9-max Seat #3 is the button
Seat 2: jj0420&&78 (8348 in chips)=20
Seat 3: JerseyRU (8649 in chips)=20
Seat 4: helzkitchen (9830 in chips)=20
Seat 5: Ch1no354 (10000 in chips)=20
Seat 6: senor stinks (11410 in chips)=20
Seat 8: JJin91 (9036 in chips)=20
Seat 9: TheBulldawgg (13418 in chips)=20
helzkitchen: posts small blind 40
Ch1no354: posts big blind 80
*** HOLE CARDS ***
Dealt to JJin91 [Th 8d]
senor stinks: folds=20
JJin91: folds=20
TheBulldawgg: folds=20
jj0420&&78: calls 80
JerseyRU: raises 160 to 240
helzkitchen: folds=20
Ch1no354: folds=20
jj0420&&78: calls 160
*** FLOP *** [Td 2s Ac]
jj0420&&78: bets 80
JerseyRU: raises 400 to 480
jj0420&&78: folds=20
Uncalled bet (400) returned to JerseyRU
JerseyRU collected 760 from pot
JerseyRU: doesn't show hand=20
*** SUMMARY ***
Total pot 760 | Rake 0=20
Board [Td 2s Ac]
Seat 2: jj0420&&78 folded on the Flop
Seat 3: JerseyRU (button) collected (760)
Seat 4: helzkitchen (small blind) folded before Flop
Seat 5: Ch1no354 (big blind) folded before Flop
Seat 6: senor stinks folded before Flop (didn't bet)
Seat 8: JJin91 folded before Flop (didn't bet)
Seat 9: TheBulldawgg folded before Flop (didn't bet)


*********** # 27 **************
PokerStars Hand #175009027761: Tournament #1701776547, $18.20+$1.80 USD=
 Hold'em No Limit - Level III (40/80) - 2017/09/13 19:24:15 ET
Table '1701776547 2' 9-max Seat #4 is the button
Seat 1: BobbyGuccina (10000 in chips)=20
Seat 2: jj0420&&78 (8028 in chips)=20
Seat 3: JerseyRU (9089 in chips)=20
Seat 4: helzkitchen (9790 in chips)=20
Seat 5: Ch1no354 (9920 in chips)=20
Seat 6: senor stinks (11410 in chips)=20
Seat 8: JJin91 (9036 in chips)=20
Seat 9: TheBulldawgg (13418 in chips)=20
Ch1no354: posts small blind 40
senor stinks: posts big blind 80
*** HOLE CARDS ***
Dealt to JJin91 [5s 2h]
JJin91: folds=20
TheBulldawgg: folds=20
BobbyGuccina: folds=20
jj0420&&78: calls 80
JerseyRU: folds=20
helzkitchen: raises 240 to 320
Ch1no354: folds=20
senor stinks: calls 240
jj0420&&78: calls 240
*** FLOP *** [Ah 9c 4c]
senor stinks: checks=20
jj0420&&78: checks=20
helzkitchen: bets 560
senor stinks: folds=20
jj0420&&78: folds=20
Uncalled bet (560) returned to helzkitchen
helzkitchen collected 1000 from pot
helzkitchen: doesn't show hand=20
*** SUMMARY ***
Total pot 1000 | Rake 0=20
Board [Ah 9c 4c]
Seat 1: BobbyGuccina folded before Flop (didn't bet)
Seat 2: jj0420&&78 folded on the Flop
Seat 3: JerseyRU folded before Flop (didn't bet)
Seat 4: helzkitchen (button) collected (1000)
Seat 5: Ch1no354 (small blind) folded before Flop
Seat 6: senor stinks (big blind) folded on the Flop
Seat 8: JJin91 folded before Flop (didn't bet)
Seat 9: TheBulldawgg folded before Flop (didn't bet)


*********** # 28 **************
PokerStars Hand #175009028082: Tournament #1701776547, $18.20+$1.80 USD=
 Hold'em No Limit - Level III (40/80) - 2017/09/13 19:25:47 ET
Table '1701776547 5' 9-max Seat #1 is the button
Seat 1: JJin91 (9036 in chips)=20
Seat 2: asremb (14295 in chips)=20
Seat 3: D.Drumpf (11236 in chips)=20
Seat 4: TheBulldawgg (13418 in chips)=20
asremb: posts small blind 40
D.Drumpf: posts big blind 80
*** HOLE CARDS ***
Dealt to JJin91 [2d 4d]
TheBulldawgg is connected=20
TheBulldawgg: folds=20
JJin91: raises 93 to 173
asremb: folds=20
D.Drumpf: calls 93
*** FLOP *** [5d 7d Ac]
D.Drumpf: checks=20
JJin91: bets 282
D.Drumpf: calls 282
*** TURN *** [5d 7d Ac] [Ad]
D.Drumpf: checks=20
JJin91: checks=20
*** RIVER *** [5d 7d Ac Ad] [Qs]
D.Drumpf: checks=20
JJin91: bets 1111
D.Drumpf: folds=20
Uncalled bet (1111) returned to JJin91
JJin91 collected 950 from pot
JJin91: doesn't show hand=20
*** SUMMARY ***
Total pot 950 | Rake 0=20
Board [5d 7d Ac Ad Qs]
Seat 1: JJin91 (button) collected (950)
Seat 2: asremb (small blind) folded before Flop
Seat 3: D.Drumpf (big blind) folded on the River
Seat 4: TheBulldawgg folded before Flop (didn't bet)


*********** # 29 **************
PokerStars Hand #175009028304: Tournament #1701776547, $18.20+$1.80 USD=
 Hold'em No Limit - Level III (40/80) - 2017/09/13 19:26:57 ET
Table '1701776547 5' 9-max Seat #2 is the button
Seat 1: JJin91 (9531 in chips)=20
Seat 2: asremb (14255 in chips)=20
Seat 3: D.Drumpf (10781 in chips)=20
Seat 4: TheBulldawgg (13418 in chips)=20
Seat 5: A A 5454 (10000 in chips)=20
Seat 6: JerseyRU (9209 in chips)=20
D.Drumpf: posts small blind 40
TheBulldawgg: posts big blind 80
*** HOLE CARDS ***
Dealt to JJin91 [6c Kd]
A A 5454: folds=20
JerseyRU: folds=20
JJin91: folds=20
asremb: raises 160 to 240
D.Drumpf: folds=20
TheBulldawgg: folds=20
Uncalled bet (160) returned to asremb
asremb collected 200 from pot
asremb: doesn't show hand=20
*** SUMMARY ***
Total pot 200 | Rake 0=20
Seat 1: JJin91 folded before Flop (didn't bet)
Seat 2: asremb (button) collected (200)
Seat 3: D.Drumpf (small blind) folded before Flop
Seat 4: TheBulldawgg (big blind) folded before Flop
Seat 5: A A 5454 folded before Flop (didn't bet)
Seat 6: JerseyRU folded before Flop (didn't bet)


*********** # 30 **************
PokerStars Hand #175009028389: Tournament #1701776547, $18.20+$1.80 USD=
 Hold'em No Limit - Level III (40/80) - 2017/09/13 19:27:20 ET
Table '1701776547 5' 9-max Seat #3 is the button
Seat 1: JJin91 (9531 in chips)=20
Seat 2: asremb (14375 in chips)=20
Seat 3: D.Drumpf (10741 in chips)=20
Seat 4: TheBulldawgg (13338 in chips)=20
Seat 5: A A 5454 (10000 in chips)=20
Seat 6: JerseyRU (9209 in chips)=20
TheBulldawgg: posts small blind 40
A A 5454: posts big blind 80
*** HOLE CARDS ***
Dealt to JJin91 [5c 3h]
JerseyRU: folds=20
JJin91: folds=20
asremb: folds=20
D.Drumpf: raises 120 to 200
TheBulldawgg: folds=20
A A 5454: calls 120
*** FLOP *** [2h Tc 8h]
A A 5454: checks=20
D.Drumpf: bets 240
A A 5454: calls 240
*** TURN *** [2h Tc 8h] [5s]
A A 5454: bets 920
D.Drumpf: folds=20
Uncalled bet (920) returned to A A 5454
A A 5454 collected 920 from pot
A A 5454: doesn't show hand=20
*** SUMMARY ***
Total pot 920 | Rake 0=20
Board [2h Tc 8h 5s]
Seat 1: JJin91 folded before Flop (didn't bet)
Seat 2: asremb folded before Flop (didn't bet)
Seat 3: D.Drumpf (button) folded on the Turn
Seat 4: TheBulldawgg (small blind) folded before Flop
Seat 5: A A 5454 (big blind) collected (920)
Seat 6: JerseyRU folded before Flop (didn't bet)


*********** # 31 **************
PokerStars Hand #175009028543: Tournament #1701776547, $18.20+$1.80 USD=
 Hold'em No Limit - Level III (40/80) - 2017/09/13 19:28:12 ET
Table '1701776547 5' 9-max Seat #4 is the button
Seat 1: JJin91 (9531 in chips)=20
Seat 2: asremb (14375 in chips)=20
Seat 3: D.Drumpf (10301 in chips)=20
Seat 4: TheBulldawgg (13298 in chips)=20
Seat 5: A A 5454 (10480 in chips)=20
Seat 6: JerseyRU (9209 in chips)=20
A A 5454: posts small blind 40
JerseyRU: posts big blind 80
*** HOLE CARDS ***
Dealt to JJin91 [7h Js]
JJin91: folds=20
asremb: folds=20
D.Drumpf: folds=20
TheBulldawgg: raises 120 to 200
A A 5454: folds=20
JerseyRU: calls 120
*** FLOP *** [5s Th 9c]
JerseyRU: checks=20
TheBulldawgg: bets 275
JerseyRU: folds=20
Uncalled bet (275) returned to TheBulldawgg
TheBulldawgg collected 440 from pot
TheBulldawgg: doesn't show hand=20
*** SUMMARY ***
Total pot 440 | Rake 0=20
Board [5s Th 9c]
Seat 1: JJin91 folded before Flop (didn't bet)
Seat 2: asremb folded before Flop (didn't bet)
Seat 3: D.Drumpf folded before Flop (didn't bet)
Seat 4: TheBulldawgg (button) collected (440)
Seat 5: A A 5454 (small blind) folded before Flop
Seat 6: JerseyRU (big blind) folded on the Flop


*********** # 32 **************
PokerStars Hand #175009028702: Tournament #1701776547, $18.20+$1.80 USD=
 Hold'em No Limit - Level III (40/80) - 2017/09/13 19:29:02 ET
Table '1701776547 5' 9-max Seat #5 is the button
Seat 1: JJin91 (9531 in chips)=20
Seat 2: asremb (14375 in chips)=20
Seat 3: D.Drumpf (10301 in chips)=20
Seat 4: TheBulldawgg (13538 in chips)=20
Seat 5: A A 5454 (10440 in chips)=20
Seat 6: JerseyRU (9009 in chips)=20
Seat 7: hustleflo173 (7808 in chips)=20
Seat 8: WyldCard33 (8833 in chips)=20
Seat 9: Snookers8 (12863 in chips)=20
JerseyRU: posts small blind 40
hustleflo173: posts big blind 80
*** HOLE CARDS ***
Dealt to JJin91 [As 7h]
WyldCard33: folds=20
Snookers8: folds=20
JJin91: folds=20
asremb: folds=20
D.Drumpf: folds=20
TheBulldawgg: calls 80
A A 5454: calls 80
JerseyRU: calls 40
hustleflo173 is disconnected=20
hustleflo173 has timed out while disconnected
hustleflo173: checks=20
*** FLOP *** [6s 6c Td]
JerseyRU: checks=20
hustleflo173 has timed out while disconnected
hustleflo173: checks=20
TheBulldawgg: bets 275
A A 5454: folds=20
JerseyRU: calls 275
hustleflo173 has timed out while disconnected
hustleflo173: folds=20
*** TURN *** [6s 6c Td] [4c]
hustleflo173 is sitting out
JerseyRU: bets 435
TheBulldawgg: folds=20
Uncalled bet (435) returned to JerseyRU
JerseyRU collected 870 from pot
JerseyRU: doesn't show hand=20
*** SUMMARY ***
Total pot 870 | Rake 0=20
Board [6s 6c Td 4c]
Seat 1: JJin91 folded before Flop (didn't bet)
Seat 2: asremb folded before Flop (didn't bet)
Seat 3: D.Drumpf folded before Flop (didn't bet)
Seat 4: TheBulldawgg folded on the Turn
Seat 5: A A 5454 (button) folded on the Flop
Seat 6: JerseyRU (small blind) collected (870)
Seat 7: hustleflo173 (big blind) folded on the Flop
Seat 8: WyldCard33 folded before Flop (didn't bet)
Seat 9: Snookers8 folded before Flop (didn't bet)


*********** # 33 **************
PokerStars Hand #175009029234: Tournament #1701776547, $18.20+$1.80 USD=
 Hold'em No Limit - Level IV (50/100) - 2017/09/13 19:31:40 ET
Table '1701776547 3' 9-max Seat #9 is the button
Seat 1: lennycappy (9870 in chips)=20
Seat 2: mmenz08816 (9765 in chips)=20
Seat 4: mschnides (8822 in chips)=20
Seat 5: JJin91 (9531 in chips)=20
Seat 6: apoch19 (11965 in chips)=20
Seat 8: nwmdnj (29938 in chips)=20
Seat 9: TheFah475 (7960 in chips)=20
lennycappy: posts the ante 10
mmenz08816: posts the ante 10
mschnides: posts the ante 10
JJin91: posts the ante 10
apoch19: posts the ante 10
nwmdnj: posts the ante 10
TheFah475: posts the ante 10
lennycappy: posts small blind 50
mmenz08816: posts big blind 100
*** HOLE CARDS ***
Dealt to JJin91 [3c 8c]
mschnides: raises 250 to 350
JJin91: folds=20
apoch19: folds=20
nwmdnj: folds=20
TheFah475: calls 350
lennycappy: folds=20
mmenz08816: raises 850 to 1200
mschnides: raises 7612 to 8812 and is all-in
TheFah475: folds=20
mmenz08816: calls 7612
*** FLOP *** [Ks 3s 6s]
*** TURN *** [Ks 3s 6s] [Jd]
*** RIVER *** [Ks 3s 6s Jd] [7h]
*** SHOW DOWN ***
mmenz08816: shows [Kd Ad] (a pair of Kings)
mschnides: shows [Ac As] (a pair of Aces)
mschnides collected 18094 from pot
*** SUMMARY ***
Total pot 18094 | Rake 0=20
Board [Ks 3s 6s Jd 7h]
Seat 1: lennycappy (small blind) folded before Flop
Seat 2: mmenz08816 (big blind) showed [Kd Ad] and lost with a pair of K=
ings
Seat 4: mschnides showed [Ac As] and won (18094) with a pair of Aces
Seat 5: JJin91 folded before Flop (didn't bet)
Seat 6: apoch19 folded before Flop (didn't bet)
Seat 8: nwmdnj folded before Flop (didn't bet)
Seat 9: TheFah475 (button) folded before Flop


*********** # 34 **************
PokerStars Hand #175009029378: Tournament #1701776547, $18.20+$1.80 USD=
 Hold'em No Limit - Level IV (50/100) - 2017/09/13 19:32:25 ET
Table '1701776547 3' 9-max Seat #1 is the button
Seat 1: lennycappy (9810 in chips)=20
Seat 2: mmenz08816 (943 in chips)=20
Seat 4: mschnides (18094 in chips)=20
Seat 5: JJin91 (9521 in chips)=20
Seat 6: apoch19 (11955 in chips)=20
Seat 8: nwmdnj (29928 in chips)=20
Seat 9: TheFah475 (7600 in chips)=20
lennycappy: posts the ante 10
mmenz08816: posts the ante 10
mschnides: posts the ante 10
JJin91: posts the ante 10
apoch19: posts the ante 10
nwmdnj: posts the ante 10
TheFah475: posts the ante 10
mmenz08816: posts small blind 50
mschnides: posts big blind 100
*** HOLE CARDS ***
Dealt to JJin91 [2h 3d]
JJin91: folds=20
apoch19: folds=20
nwmdnj: calls 100
TheFah475: calls 100
lennycappy: calls 100
mmenz08816: folds=20
mschnides: checks=20
*** FLOP *** [4s 7d As]
mschnides: checks=20
nwmdnj: checks=20
TheFah475: checks=20
lennycappy: checks=20
*** TURN *** [4s 7d As] [Ad]
mschnides: checks=20
nwmdnj: checks=20
TheFah475: checks=20
lennycappy: checks=20
*** RIVER *** [4s 7d As Ad] [Qh]
mschnides: checks=20
nwmdnj: checks=20
TheFah475: checks=20
lennycappy: checks=20
*** SHOW DOWN ***
mschnides: shows [Qs 3c] (two pair, Aces and Queens)
nwmdnj: mucks hand=20
TheFah475: mucks hand=20
lennycappy: mucks hand=20
mschnides collected 520 from pot
*** SUMMARY ***
Total pot 520 | Rake 0=20
Board [4s 7d As Ad Qh]
Seat 1: lennycappy (button) mucked [8s Ts]
Seat 2: mmenz08816 (small blind) folded before Flop
Seat 4: mschnides (big blind) showed [Qs 3c] and won (520) with two pai=
r, Aces and Queens
Seat 5: JJin91 folded before Flop (didn't bet)
Seat 6: apoch19 folded before Flop (didn't bet)
Seat 8: nwmdnj mucked [7c 6c]
Seat 9: TheFah475 mucked [Jh 9c]


*********** # 35 **************
PokerStars Hand #175009029657: Tournament #1701776547, $18.20+$1.80 USD=
 Hold'em No Limit - Level IV (50/100) - 2017/09/13 19:33:53 ET
Table '1701776547 3' 9-max Seat #2 is the button
Seat 1: lennycappy (9700 in chips)=20
Seat 2: mmenz08816 (883 in chips)=20
Seat 4: mschnides (18504 in chips)=20
Seat 5: JJin91 (9511 in chips)=20
Seat 6: apoch19 (11945 in chips)=20
Seat 7: A A 5454 (10340 in chips)=20
Seat 8: nwmdnj (29818 in chips)=20
Seat 9: TheFah475 (7490 in chips)=20
lennycappy: posts the ante 10
mmenz08816: posts the ante 10
mschnides: posts the ante 10
JJin91: posts the ante 10
apoch19: posts the ante 10
A A 5454: posts the ante 10
nwmdnj: posts the ante 10
TheFah475: posts the ante 10
mschnides: posts small blind 50
JJin91: posts big blind 100
*** HOLE CARDS ***
Dealt to JJin91 [Kc 7c]
apoch19: folds=20
A A 5454: calls 100
nwmdnj: folds=20
TheFah475: folds=20
lennycappy: folds=20
mmenz08816: raises 773 to 873 and is all-in
mschnides: folds=20
JJin91: calls 773
A A 5454: calls 773
*** FLOP *** [9d 3s 6c]
JJin91: checks=20
A A 5454: checks=20
*** TURN *** [9d 3s 6c] [Jc]
JJin91: bets 600
A A 5454: calls 600
*** RIVER *** [9d 3s 6c Jc] [4s]
JJin91: checks=20
A A 5454: bets 1975
JJin91: folds=20
Uncalled bet (1975) returned to A A 5454
*** SHOW DOWN ***
A A 5454: shows [Qc Jh] (a pair of Jacks)
A A 5454 collected 1200 from side pot
mmenz08816: shows [Ac 3d] (a pair of Threes)
mmenz08816 is sitting out
A A 5454 collected 2749 from main pot
mmenz08816 finished the tournament in 106th place
*** SUMMARY ***
Total pot 3949 Main pot 2749. Side pot 1200. | Rake 0=20
Board [9d 3s 6c Jc 4s]
Seat 1: lennycappy folded before Flop (didn't bet)
Seat 2: mmenz08816 (button) showed [Ac 3d] and lost with a pair of Thre=
es
Seat 4: mschnides (small blind) folded before Flop
Seat 5: JJin91 (big blind) folded on the River
Seat 6: apoch19 folded before Flop (didn't bet)
Seat 7: A A 5454 showed [Qc Jh] and won (3949) with a pair of Jacks
Seat 8: nwmdnj folded before Flop (didn't bet)
Seat 9: TheFah475 folded before Flop (didn't bet)


*********** # 36 **************
PokerStars Hand #175009029913: Tournament #1701776547, $18.20+$1.80 USD=
 Hold'em No Limit - Level IV (50/100) - 2017/09/13 19:35:07 ET
Table '1701776547 3' 9-max Seat #4 is the button
Seat 1: lennycappy (9690 in chips)=20
Seat 3: bulibasav (10000 in chips)=20
Seat 4: mschnides (18444 in chips)=20
Seat 5: JJin91 (8028 in chips)=20
Seat 6: apoch19 (11935 in chips)=20
Seat 7: A A 5454 (12806 in chips)=20
Seat 8: nwmdnj (29808 in chips)=20
Seat 9: TheFah475 (7480 in chips)=20
lennycappy: posts the ante 10
bulibasav: posts the ante 10
mschnides: posts the ante 10
JJin91: posts the ante 10
apoch19: posts the ante 10
A A 5454: posts the ante 10
nwmdnj: posts the ante 10
TheFah475: posts the ante 10
JJin91: posts small blind 50
apoch19: posts big blind 100
*** HOLE CARDS ***
Dealt to JJin91 [Kh 3d]
A A 5454: folds=20
nwmdnj: folds=20
TheFah475: calls 100
lennycappy: calls 100
bulibasav: folds=20
mschnides: folds=20
JJin91: folds=20
apoch19: checks=20
*** FLOP *** [8d 6h Kc]
apoch19: checks=20
TheFah475: checks=20
lennycappy: checks=20
*** TURN *** [8d 6h Kc] [9d]
apoch19: checks=20
TheFah475: bets 100
lennycappy: raises 100 to 200
apoch19: calls 200
TheFah475: folds=20
*** RIVER *** [8d 6h Kc 9d] [7h]
apoch19: checks=20
lennycappy: bets 698
apoch19: folds=20
Uncalled bet (698) returned to lennycappy
lennycappy collected 930 from pot
*** SUMMARY ***
Total pot 930 | Rake 0=20
Board [8d 6h Kc 9d 7h]
Seat 1: lennycappy collected (930)
Seat 3: bulibasav folded before Flop (didn't bet)
Seat 4: mschnides (button) folded before Flop (didn't bet)
Seat 5: JJin91 (small blind) folded before Flop
Seat 6: apoch19 (big blind) folded on the River
Seat 7: A A 5454 folded before Flop (didn't bet)
Seat 8: nwmdnj folded before Flop (didn't bet)
Seat 9: TheFah475 folded on the Turn


*********** # 37 **************
PokerStars Hand #175009605135: Tournament #1701776547, $18.20+$1.80 USD=
 Hold'em No Limit - Level IV (50/100) - 2017/09/13 19:36:14 ET
Table '1701776547 3' 9-max Seat #5 is the button
Seat 1: lennycappy (10310 in chips)=20
Seat 3: bulibasav (9990 in chips)=20
Seat 4: mschnides (18434 in chips)=20
Seat 5: JJin91 (7968 in chips)=20
Seat 6: apoch19 (11625 in chips)=20
Seat 7: A A 5454 (12796 in chips)=20
Seat 8: nwmdnj (29798 in chips)=20
Seat 9: TheFah475 (7270 in chips)=20
lennycappy: posts the ante 10
bulibasav: posts the ante 10
mschnides: posts the ante 10
JJin91: posts the ante 10
apoch19: posts the ante 10
A A 5454: posts the ante 10
nwmdnj: posts the ante 10
TheFah475: posts the ante 10
apoch19: posts small blind 50
A A 5454: posts big blind 100
*** HOLE CARDS ***
Dealt to JJin91 [6s 8s]
nwmdnj: folds=20
TheFah475: folds=20
lennycappy: folds=20
bulibasav: raises 120 to 220
mschnides: folds=20
JJin91: folds=20
apoch19: calls 170
A A 5454: calls 120
*** FLOP *** [5c 7c Th]
apoch19: checks=20
A A 5454: checks=20
bulibasav: checks=20
*** TURN *** [5c 7c Th] [Ts]
apoch19: checks=20
A A 5454: bets 740
bulibasav: folds=20
apoch19: folds=20
Uncalled bet (740) returned to A A 5454
A A 5454 collected 740 from pot
A A 5454: doesn't show hand=20
*** SUMMARY ***
Total pot 740 | Rake 0=20
Board [5c 7c Th Ts]
Seat 1: lennycappy folded before Flop (didn't bet)
Seat 3: bulibasav folded on the Turn
Seat 4: mschnides folded before Flop (didn't bet)
Seat 5: JJin91 (button) folded before Flop (didn't bet)
Seat 6: apoch19 (small blind) folded on the Turn
Seat 7: A A 5454 (big blind) collected (740)
Seat 8: nwmdnj folded before Flop (didn't bet)
Seat 9: TheFah475 folded before Flop (didn't bet)


*********** # 38 **************
PokerStars Hand #175009605312: Tournament #1701776547, $18.20+$1.80 USD=
 Hold'em No Limit - Level IV (50/100) - 2017/09/13 19:37:12 ET
Table '1701776547 3' 9-max Seat #6 is the button
Seat 1: lennycappy (10300 in chips)=20
Seat 3: bulibasav (9760 in chips)=20
Seat 4: mschnides (18424 in chips)=20
Seat 5: JJin91 (7958 in chips)=20
Seat 6: apoch19 (11395 in chips)=20
Seat 7: A A 5454 (13306 in chips)=20
Seat 8: nwmdnj (29788 in chips)=20
Seat 9: TheFah475 (7260 in chips)=20
lennycappy: posts the ante 10
bulibasav: posts the ante 10
mschnides: posts the ante 10
JJin91: posts the ante 10
apoch19: posts the ante 10
A A 5454: posts the ante 10
nwmdnj: posts the ante 10
TheFah475: posts the ante 10
A A 5454: posts small blind 50
nwmdnj: posts big blind 100
*** HOLE CARDS ***
Dealt to JJin91 [9s 9h]
TheFah475: folds=20
lennycappy: folds=20
bulibasav: folds=20
mschnides: folds=20
JJin91: raises 117 to 217
apoch19: folds=20
A A 5454: calls 167
nwmdnj: calls 117
*** FLOP *** [8h 5d Ah]
A A 5454: checks=20
nwmdnj: checks=20
JJin91: bets 473
A A 5454: folds=20
nwmdnj: folds=20
Uncalled bet (473) returned to JJin91
JJin91 collected 731 from pot
JJin91: doesn't show hand=20
*** SUMMARY ***
Total pot 731 | Rake 0=20
Board [8h 5d Ah]
Seat 1: lennycappy folded before Flop (didn't bet)
Seat 3: bulibasav folded before Flop (didn't bet)
Seat 4: mschnides folded before Flop (didn't bet)
Seat 5: JJin91 collected (731)
Seat 6: apoch19 (button) folded before Flop (didn't bet)
Seat 7: A A 5454 (small blind) folded on the Flop
Seat 8: nwmdnj (big blind) folded on the Flop
Seat 9: TheFah475 folded before Flop (didn't bet)


*********** # 39 **************
PokerStars Hand #175009605579: Tournament #1701776547, $18.20+$1.80 USD=
 Hold'em No Limit - Level IV (50/100) - 2017/09/13 19:38:35 ET
Table '1701776547 3' 9-max Seat #7 is the button
Seat 1: lennycappy (10290 in chips)=20
Seat 2: IknowHow2pla (10000 in chips)=20
Seat 3: bulibasav (9750 in chips)=20
Seat 4: mschnides (18414 in chips)=20
Seat 5: JJin91 (8462 in chips)=20
Seat 6: apoch19 (11385 in chips)=20
Seat 7: A A 5454 (13079 in chips)=20
Seat 8: nwmdnj (29561 in chips)=20
Seat 9: TheFah475 (7250 in chips)=20
lennycappy: posts the ante 10
IknowHow2pla: posts the ante 10
bulibasav: posts the ante 10
mschnides: posts the ante 10
JJin91: posts the ante 10
apoch19: posts the ante 10
A A 5454: posts the ante 10
nwmdnj: posts the ante 10
TheFah475: posts the ante 10
nwmdnj: posts small blind 50
TheFah475: posts big blind 100
*** HOLE CARDS ***
Dealt to JJin91 [2d Qd]
lennycappy: calls 100
IknowHow2pla: folds=20
bulibasav: raises 260 to 360
mschnides: calls 360
JJin91: folds=20
apoch19: folds=20
A A 5454: calls 360
nwmdnj: raises 1730 to 2090
TheFah475: folds=20
lennycappy: folds=20
bulibasav: folds=20
mschnides has timed out
mschnides: folds=20
mschnides is sitting out
A A 5454: calls 1730
*** FLOP *** [Js Ah 4c]
nwmdnj: bets 2180
A A 5454: calls 2180
*** TURN *** [Js Ah 4c] [Th]
nwmdnj: bets 4966
A A 5454: calls 4966
*** RIVER *** [Js Ah 4c Th] [Jh]
nwmdnj: bets 8182
A A 5454: calls 3833 and is all-in
Uncalled bet (4349) returned to nwmdnj
*** SHOW DOWN ***
nwmdnj: shows [As Kh] (two pair, Aces and Jacks)
A A 5454: shows [9c Jc] (three of a kind, Jacks)
A A 5454 collected 27148 from pot
*** SUMMARY ***
Total pot 27148 | Rake 0=20
Board [Js Ah 4c Th Jh]
Seat 1: lennycappy folded before Flop
Seat 2: IknowHow2pla folded before Flop (didn't bet)
Seat 3: bulibasav folded before Flop
Seat 4: mschnides folded before Flop
Seat 5: JJin91 folded before Flop (didn't bet)
Seat 6: apoch19 folded before Flop (didn't bet)
Seat 7: A A 5454 (button) showed [9c Jc] and won (27148) with three of =
a kind, Jacks
Seat 8: nwmdnj (small blind) showed [As Kh] and lost with two pair, Ace=
s and Jacks
Seat 9: TheFah475 (big blind) folded before Flop


*********** # 40 **************
PokerStars Hand #175009606014: Tournament #1701776547, $18.20+$1.80 USD=
 Hold'em No Limit - Level V (60/120) - 2017/09/13 19:40:38 ET
Table '1701776547 3' 9-max Seat #8 is the button
Seat 2: IknowHow2pla (9990 in chips)=20
Seat 3: bulibasav (9380 in chips)=20
Seat 4: mschnides (18044 in chips) is sitting out
Seat 5: JJin91 (8452 in chips)=20
Seat 6: apoch19 (11375 in chips)=20
Seat 7: A A 5454 (27148 in chips)=20
Seat 8: nwmdnj (16482 in chips)=20
Seat 9: TheFah475 (7140 in chips)=20
IknowHow2pla: posts the ante 15
bulibasav: posts the ante 15
mschnides: posts the ante 15
JJin91: posts the ante 15
apoch19: posts the ante 15
A A 5454: posts the ante 15
nwmdnj: posts the ante 15
TheFah475: posts the ante 15
TheFah475: posts small blind 60
IknowHow2pla: posts big blind 120
*** HOLE CARDS ***
Dealt to JJin91 [Jc Ac]
bulibasav: folds=20
mschnides: folds=20
JJin91: raises 140 to 260
apoch19: folds=20
A A 5454: folds=20
nwmdnj: folds=20
TheFah475: folds=20
IknowHow2pla: calls 140
*** FLOP *** [9d 2s 3s]
IknowHow2pla: checks=20
JJin91: checks=20
*** TURN *** [9d 2s 3s] [2d]
IknowHow2pla: checks=20
JJin91: checks=20
*** RIVER *** [9d 2s 3s 2d] [Ah]
IknowHow2pla: checks=20
JJin91: bets 357
IknowHow2pla: folds=20
Uncalled bet (357) returned to JJin91
JJin91 collected 700 from pot
JJin91: doesn't show hand=20
*** SUMMARY ***
Total pot 700 | Rake 0=20
Board [9d 2s 3s 2d Ah]
Seat 2: IknowHow2pla (big blind) folded on the River
Seat 3: bulibasav folded before Flop (didn't bet)
Seat 4: mschnides folded before Flop (didn't bet)
Seat 5: JJin91 collected (700)
Seat 6: apoch19 folded before Flop (didn't bet)
Seat 7: A A 5454 folded before Flop (didn't bet)
Seat 8: nwmdnj (button) folded before Flop (didn't bet)
Seat 9: TheFah475 (small blind) folded before Flop


*********** # 41 **************
PokerStars Hand #175009606163: Tournament #1701776547, $18.20+$1.80 USD=
 Hold'em No Limit - Level V (60/120) - 2017/09/13 19:41:22 ET
Table '1701776547 3' 9-max Seat #9 is the button
Seat 2: IknowHow2pla (9715 in chips)=20
Seat 4: mschnides (18029 in chips) is sitting out
Seat 5: JJin91 (8877 in chips)=20
Seat 6: apoch19 (11360 in chips)=20
Seat 7: A A 5454 (27133 in chips)=20
Seat 8: nwmdnj (16467 in chips)=20
Seat 9: TheFah475 (7065 in chips)=20
IknowHow2pla: posts the ante 15
mschnides: posts the ante 15
JJin91: posts the ante 15
apoch19: posts the ante 15
A A 5454: posts the ante 15
nwmdnj: posts the ante 15
TheFah475: posts the ante 15
IknowHow2pla: posts small blind 60
mschnides: posts big blind 120
*** HOLE CARDS ***
Dealt to JJin91 [4h 7c]
JJin91: folds=20
apoch19: folds=20
A A 5454: calls 120
nwmdnj: folds=20
TheFah475: folds=20
IknowHow2pla: calls 60
mschnides: folds=20
*** FLOP *** [Ks Ah Qd]
IknowHow2pla: checks=20
mschnides has returned
A A 5454: checks=20
*** TURN *** [Ks Ah Qd] [2h]
IknowHow2pla: checks=20
A A 5454: bets 465
IknowHow2pla: folds=20
Uncalled bet (465) returned to A A 5454
A A 5454 collected 465 from pot
A A 5454: doesn't show hand=20
*** SUMMARY ***
Total pot 465 | Rake 0=20
Board [Ks Ah Qd 2h]
Seat 2: IknowHow2pla (small blind) folded on the Turn
Seat 4: mschnides (big blind) folded before Flop
Seat 5: JJin91 folded before Flop (didn't bet)
Seat 6: apoch19 folded before Flop (didn't bet)
Seat 7: A A 5454 collected (465)
Seat 8: nwmdnj folded before Flop (didn't bet)
Seat 9: TheFah475 (button) folded before Flop (didn't bet)


*********** # 42 **************
PokerStars Hand #175009606272: Tournament #1701776547, $18.20+$1.80 USD=
 Hold'em No Limit - Level V (60/120) - 2017/09/13 19:41:56 ET
Table '1701776547 3' 9-max Seat #2 is the button
Seat 2: IknowHow2pla (9580 in chips)=20
Seat 4: mschnides (17894 in chips)=20
Seat 5: JJin91 (8862 in chips)=20
Seat 6: apoch19 (11345 in chips)=20
Seat 7: A A 5454 (27463 in chips)=20
Seat 8: nwmdnj (16452 in chips)=20
Seat 9: TheFah475 (7050 in chips)=20
IknowHow2pla: posts the ante 15
mschnides: posts the ante 15
JJin91: posts the ante 15
apoch19: posts the ante 15
A A 5454: posts the ante 15
nwmdnj: posts the ante 15
TheFah475: posts the ante 15
mschnides: posts small blind 60
JJin91: posts big blind 120
*** HOLE CARDS ***
Dealt to JJin91 [Td Kd]
apoch19: folds=20
A A 5454: folds=20
nwmdnj: folds=20
TheFah475: folds=20
IknowHow2pla: raises 240 to 360
mschnides: folds=20
JJin91: calls 240
*** FLOP *** [3d 3s 4h]
JJin91: checks=20
IknowHow2pla: checks=20
*** TURN *** [3d 3s 4h] [Tc]
JJin91: bets 327
IknowHow2pla: calls 327
*** RIVER *** [3d 3s 4h Tc] [7s]
JJin91: bets 923
IknowHow2pla: raises 923 to 1846
JJin91: calls 923
*** SHOW DOWN ***
IknowHow2pla: shows [Ac Ah] (two pair, Aces and Threes)
JJin91: mucks hand=20
IknowHow2pla collected 5231 from pot
*** SUMMARY ***
Total pot 5231 | Rake 0=20
Board [3d 3s 4h Tc 7s]
Seat 2: IknowHow2pla (button) showed [Ac Ah] and won (5231) with two pa=
ir, Aces and Threes
Seat 4: mschnides (small blind) folded before Flop
Seat 5: JJin91 (big blind) mucked [Td Kd]
Seat 6: apoch19 folded before Flop (didn't bet)
Seat 7: A A 5454 folded before Flop (didn't bet)
Seat 8: nwmdnj folded before Flop (didn't bet)
Seat 9: TheFah475 folded before Flop (didn't bet)


*********** # 43 **************
PokerStars Hand #175009606627: Tournament #1701776547, $18.20+$1.80 USD=
 Hold'em No Limit - Level V (60/120) - 2017/09/13 19:43:36 ET
Table '1701776547 3' 9-max Seat #4 is the button
Seat 2: IknowHow2pla (12263 in chips)=20
Seat 3: @Bud_Fox0000 (10000 in chips)=20
Seat 4: mschnides (17819 in chips)=20
Seat 5: JJin91 (6314 in chips)=20
Seat 6: apoch19 (11330 in chips)=20
Seat 7: A A 5454 (27448 in chips)=20
Seat 8: nwmdnj (16437 in chips)=20
Seat 9: TheFah475 (7035 in chips)=20
IknowHow2pla: posts the ante 15
@Bud_Fox0000: posts the ante 15
mschnides: posts the ante 15
JJin91: posts the ante 15
apoch19: posts the ante 15
A A 5454: posts the ante 15
nwmdnj: posts the ante 15
TheFah475: posts the ante 15
JJin91: posts small blind 60
apoch19: posts big blind 120
*** HOLE CARDS ***
Dealt to JJin91 [4h 2h]
A A 5454: calls 120
nwmdnj: folds=20
TheFah475: calls 120
IknowHow2pla: folds=20
@Bud_Fox0000: folds=20
mschnides: calls 120
JJin91: folds=20
apoch19: checks=20
*** FLOP *** [4s 8d 3h]
apoch19: checks=20
A A 5454: checks=20
TheFah475: checks=20
mschnides has timed out
mschnides: checks=20
*** TURN *** [4s 8d 3h] [9s]
apoch19: bets 340
A A 5454: folds=20
TheFah475: folds=20
mschnides: calls 340
*** RIVER *** [4s 8d 3h 9s] [9d]
apoch19: bets 780
mschnides: calls 780
*** SHOW DOWN ***
apoch19: shows [9c Th] (three of a kind, Nines)
mschnides: mucks hand=20
apoch19 collected 2900 from pot
*** SUMMARY ***
Total pot 2900 | Rake 0=20
Board [4s 8d 3h 9s 9d]
Seat 2: IknowHow2pla folded before Flop (didn't bet)
Seat 3: @Bud_Fox0000 folded before Flop (didn't bet)
Seat 4: mschnides (button) mucked [8h As]
Seat 5: JJin91 (small blind) folded before Flop
Seat 6: apoch19 (big blind) showed [9c Th] and won (2900) with three of=
 a kind, Nines
Seat 7: A A 5454 folded on the Turn
Seat 8: nwmdnj folded before Flop (didn't bet)
Seat 9: TheFah475 folded on the Turn


*********** # 44 **************
PokerStars Hand #175009606952: Tournament #1701776547, $18.20+$1.80 USD=
 Hold'em No Limit - Level V (60/120) - 2017/09/13 19:45:05 ET
Table '1701776547 3' 9-max Seat #5 is the button
Seat 2: IknowHow2pla (12248 in chips)=20
Seat 3: @Bud_Fox0000 (9985 in chips)=20
Seat 4: mschnides (16564 in chips)=20
Seat 5: JJin91 (6239 in chips)=20
Seat 6: apoch19 (12975 in chips)=20
Seat 7: A A 5454 (27313 in chips)=20
Seat 8: nwmdnj (16422 in chips)=20
Seat 9: TheFah475 (6900 in chips)=20
IknowHow2pla: posts the ante 15
@Bud_Fox0000: posts the ante 15
mschnides: posts the ante 15
JJin91: posts the ante 15
apoch19: posts the ante 15
A A 5454: posts the ante 15
nwmdnj: posts the ante 15
TheFah475: posts the ante 15
apoch19: posts small blind 60
A A 5454: posts big blind 120
*** HOLE CARDS ***
Dealt to JJin91 [4d Ac]
nwmdnj: folds=20
TheFah475: folds=20
IknowHow2pla: calls 120
@Bud_Fox0000: folds=20
mschnides: folds=20
JJin91: folds=20
apoch19: folds=20
A A 5454: checks=20
*** FLOP *** [Jc 2d 6d]
A A 5454: checks=20
IknowHow2pla: bets 120
A A 5454: folds=20
Uncalled bet (120) returned to IknowHow2pla
IknowHow2pla collected 420 from pot
IknowHow2pla: doesn't show hand=20
*** SUMMARY ***
Total pot 420 | Rake 0=20
Board [Jc 2d 6d]
Seat 2: IknowHow2pla collected (420)
Seat 3: @Bud_Fox0000 folded before Flop (didn't bet)
Seat 4: mschnides folded before Flop (didn't bet)
Seat 5: JJin91 (button) folded before Flop (didn't bet)
Seat 6: apoch19 (small blind) folded before Flop
Seat 7: A A 5454 (big blind) folded on the Flop
Seat 8: nwmdnj folded before Flop (didn't bet)
Seat 9: TheFah475 folded before Flop (didn't bet)


*********** # 45 **************
PokerStars Hand #175009607165: Tournament #1701776547, $18.20+$1.80 USD=
 Hold'em No Limit - Level V (60/120) - 2017/09/13 19:46:09 ET
Table '1701776547 3' 9-max Seat #6 is the button
Seat 2: IknowHow2pla (12533 in chips)=20
Seat 3: @Bud_Fox0000 (9970 in chips)=20
Seat 4: mschnides (16549 in chips)=20
Seat 5: JJin91 (6224 in chips)=20
Seat 6: apoch19 (12900 in chips)=20
Seat 7: A A 5454 (27178 in chips)=20
Seat 8: nwmdnj (16407 in chips)=20
Seat 9: TheFah475 (6885 in chips)=20
IknowHow2pla: posts the ante 15
@Bud_Fox0000: posts the ante 15
mschnides: posts the ante 15
JJin91: posts the ante 15
apoch19: posts the ante 15
A A 5454: posts the ante 15
nwmdnj: posts the ante 15
TheFah475: posts the ante 15
A A 5454: posts small blind 60
nwmdnj: posts big blind 120
*** HOLE CARDS ***
Dealt to JJin91 [Ah 7c]
TheFah475: calls 120
IknowHow2pla: folds=20
@Bud_Fox0000: raises 360 to 480
mschnides: folds=20
JJin91: folds=20
apoch19: folds=20
A A 5454: folds=20
nwmdnj: folds=20
TheFah475: folds=20
Uncalled bet (360) returned to @Bud_Fox0000
@Bud_Fox0000 collected 540 from pot
*** SUMMARY ***
Total pot 540 | Rake 0=20
Seat 2: IknowHow2pla folded before Flop (didn't bet)
Seat 3: @Bud_Fox0000 collected (540)
Seat 4: mschnides folded before Flop (didn't bet)
Seat 5: JJin91 folded before Flop (didn't bet)
Seat 6: apoch19 (button) folded before Flop (didn't bet)
Seat 7: A A 5454 (small blind) folded before Flop
Seat 8: nwmdnj (big blind) folded before Flop
Seat 9: TheFah475 folded before Flop


*********** # 46 **************
PokerStars Hand #175009607358: Tournament #1701776547, $18.20+$1.80 USD=
 Hold'em No Limit - Level V (60/120) - 2017/09/13 19:47:05 ET
Table '1701776547 3' 9-max Seat #7 is the button
Seat 2: IknowHow2pla (12518 in chips)=20
Seat 3: @Bud_Fox0000 (10375 in chips)=20
Seat 4: mschnides (16534 in chips)=20
Seat 5: JJin91 (6209 in chips)=20
Seat 6: apoch19 (12885 in chips)=20
Seat 7: A A 5454 (27103 in chips)=20
Seat 8: nwmdnj (16272 in chips)=20
Seat 9: TheFah475 (6750 in chips)=20
IknowHow2pla: posts the ante 15
@Bud_Fox0000: posts the ante 15
mschnides: posts the ante 15
JJin91: posts the ante 15
apoch19: posts the ante 15
A A 5454: posts the ante 15
nwmdnj: posts the ante 15
TheFah475: posts the ante 15
nwmdnj: posts small blind 60
TheFah475: posts big blind 120
*** HOLE CARDS ***
Dealt to JJin91 [Ac 4s]
IknowHow2pla: folds=20
@Bud_Fox0000: calls 120
mschnides: folds=20
JJin91: folds=20
apoch19: folds=20
A A 5454: folds=20
nwmdnj: folds=20
TheFah475: checks=20
*** FLOP *** [Th 8d Jh]
TheFah475: checks=20
@Bud_Fox0000: bets 225
TheFah475: folds=20
Uncalled bet (225) returned to @Bud_Fox0000
@Bud_Fox0000 collected 420 from pot
*** SUMMARY ***
Total pot 420 | Rake 0=20
Board [Th 8d Jh]
Seat 2: IknowHow2pla folded before Flop (didn't bet)
Seat 3: @Bud_Fox0000 collected (420)
Seat 4: mschnides folded before Flop (didn't bet)
Seat 5: JJin91 folded before Flop (didn't bet)
Seat 6: apoch19 folded before Flop (didn't bet)
Seat 7: A A 5454 (button) folded before Flop (didn't bet)
Seat 8: nwmdnj (small blind) folded before Flop
Seat 9: TheFah475 (big blind) folded on the Flop


*********** # 47 **************
PokerStars Hand #175009607484: Tournament #1701776547, $18.20+$1.80 USD=
 Hold'em No Limit - Level V (60/120) - 2017/09/13 19:47:39 ET
Table '1701776547 3' 9-max Seat #8 is the button
Seat 2: IknowHow2pla (12503 in chips)=20
Seat 3: @Bud_Fox0000 (10660 in chips)=20
Seat 4: mschnides (16519 in chips)=20
Seat 5: JJin91 (6194 in chips)=20
Seat 6: apoch19 (12870 in chips)=20
Seat 7: A A 5454 (27088 in chips)=20
Seat 8: nwmdnj (16197 in chips)=20
Seat 9: TheFah475 (6615 in chips)=20
IknowHow2pla: posts the ante 15
@Bud_Fox0000: posts the ante 15
mschnides: posts the ante 15
JJin91: posts the ante 15
apoch19: posts the ante 15
A A 5454: posts the ante 15
nwmdnj: posts the ante 15
TheFah475: posts the ante 15
TheFah475: posts small blind 60
IknowHow2pla: posts big blind 120
*** HOLE CARDS ***
Dealt to JJin91 [5d Td]
@Bud_Fox0000: folds=20
mschnides: folds=20
JJin91: folds=20
apoch19: folds=20
A A 5454: calls 120
nwmdnj: calls 120
TheFah475: calls 60
IknowHow2pla: checks=20
*** FLOP *** [3h 5c 9s]
TheFah475: checks=20
IknowHow2pla: checks=20
A A 5454: checks=20
nwmdnj: checks=20
*** TURN *** [3h 5c 9s] [7c]
TheFah475: checks=20
IknowHow2pla: checks=20
A A 5454: checks=20
nwmdnj: checks=20
*** RIVER *** [3h 5c 9s 7c] [Ks]
TheFah475: checks=20
IknowHow2pla: checks=20
A A 5454: checks=20
nwmdnj: checks=20
*** SHOW DOWN ***
TheFah475: shows [5h As] (a pair of Fives)
IknowHow2pla: mucks hand=20
A A 5454: mucks hand=20
nwmdnj: mucks hand=20
TheFah475 collected 600 from pot
*** SUMMARY ***
Total pot 600 | Rake 0=20
Board [3h 5c 9s 7c Ks]
Seat 2: IknowHow2pla (big blind) mucked [4s Tc]
Seat 3: @Bud_Fox0000 folded before Flop (didn't bet)
Seat 4: mschnides folded before Flop (didn't bet)
Seat 5: JJin91 folded before Flop (didn't bet)
Seat 6: apoch19 folded before Flop (didn't bet)
Seat 7: A A 5454 mucked [Qc Jh]
Seat 8: nwmdnj (button) mucked [2h Ac]
Seat 9: TheFah475 (small blind) showed [5h As] and won (600) with a pai=
r of Fives


*********** # 48 **************
PokerStars Hand #175009607772: Tournament #1701776547, $18.20+$1.80 USD=
 Hold'em No Limit - Level V (60/120) - 2017/09/13 19:48:59 ET
Table '1701776547 3' 9-max Seat #9 is the button
Seat 2: IknowHow2pla (12368 in chips)=20
Seat 3: @Bud_Fox0000 (10645 in chips)=20
Seat 4: mschnides (16504 in chips)=20
Seat 5: JJin91 (6179 in chips)=20
Seat 6: apoch19 (12855 in chips)=20
Seat 7: A A 5454 (26953 in chips)=20
Seat 8: nwmdnj (16062 in chips)=20
Seat 9: TheFah475 (7080 in chips)=20
IknowHow2pla: posts the ante 15
@Bud_Fox0000: posts the ante 15
mschnides: posts the ante 15
JJin91: posts the ante 15
apoch19: posts the ante 15
A A 5454: posts the ante 15
nwmdnj: posts the ante 15
TheFah475: posts the ante 15
IknowHow2pla: posts small blind 60
@Bud_Fox0000: posts big blind 120
*** HOLE CARDS ***
Dealt to JJin91 [Qh 6c]
mschnides: folds=20
JJin91: folds=20
apoch19: folds=20
A A 5454: calls 120
nwmdnj: calls 120
TheFah475: calls 120
IknowHow2pla: raises 360 to 480
@Bud_Fox0000: folds=20
A A 5454: folds=20
nwmdnj: folds=20
TheFah475: folds=20
Uncalled bet (360) returned to IknowHow2pla
IknowHow2pla collected 720 from pot
IknowHow2pla: doesn't show hand=20
*** SUMMARY ***
Total pot 720 | Rake 0=20
Seat 2: IknowHow2pla (small blind) collected (720)
Seat 3: @Bud_Fox0000 (big blind) folded before Flop
Seat 4: mschnides folded before Flop (didn't bet)
Seat 5: JJin91 folded before Flop (didn't bet)
Seat 6: apoch19 folded before Flop (didn't bet)
Seat 7: A A 5454 folded before Flop
Seat 8: nwmdnj folded before Flop
Seat 9: TheFah475 (button) folded before Flop


*********** # 49 **************
PokerStars Hand #175009608033: Tournament #1701776547, $18.20+$1.80 USD=
 Hold'em No Limit - Level V (60/120) - 2017/09/13 19:50:04 ET
Table '1701776547 3' 9-max Seat #2 is the button
Seat 2: IknowHow2pla (12953 in chips)=20
Seat 3: @Bud_Fox0000 (10510 in chips)=20
Seat 4: mschnides (16489 in chips)=20
Seat 5: JJin91 (6164 in chips)=20
Seat 6: apoch19 (12840 in chips)=20
Seat 7: A A 5454 (26818 in chips)=20
Seat 8: nwmdnj (15927 in chips)=20
Seat 9: TheFah475 (6945 in chips)=20
IknowHow2pla: posts the ante 15
@Bud_Fox0000: posts the ante 15
mschnides: posts the ante 15
JJin91: posts the ante 15
apoch19: posts the ante 15
A A 5454: posts the ante 15
nwmdnj: posts the ante 15
TheFah475: posts the ante 15
@Bud_Fox0000: posts small blind 60
mschnides: posts big blind 120
*** HOLE CARDS ***
Dealt to JJin91 [4c 7c]
JJin91: folds=20
apoch19: raises 180 to 300
A A 5454: folds=20
nwmdnj: folds=20
TheFah475: folds=20
IknowHow2pla: calls 300
@Bud_Fox0000: raises 1350 to 1650
mschnides: folds=20
apoch19: folds=20
IknowHow2pla: folds=20
Uncalled bet (1350) returned to @Bud_Fox0000
@Bud_Fox0000 collected 1140 from pot
*** SUMMARY ***
Total pot 1140 | Rake 0=20
Seat 2: IknowHow2pla (button) folded before Flop
Seat 3: @Bud_Fox0000 (small blind) collected (1140)
Seat 4: mschnides (big blind) folded before Flop
Seat 5: JJin91 folded before Flop (didn't bet)
Seat 6: apoch19 folded before Flop
Seat 7: A A 5454 folded before Flop (didn't bet)
Seat 8: nwmdnj folded before Flop (didn't bet)
Seat 9: TheFah475 folded before Flop (didn't bet)


*********** # 50 **************
PokerStars Hand #175009608247: Tournament #1701776547, $18.20+$1.80 USD=
 Hold'em No Limit - Level VI (75/150) - 2017/09/13 19:50:56 ET
Table '1701776547 3' 9-max Seat #3 is the button
Seat 2: IknowHow2pla (12638 in chips)=20
Seat 3: @Bud_Fox0000 (11335 in chips)=20
Seat 4: mschnides (16354 in chips)=20
Seat 5: JJin91 (6149 in chips)=20
Seat 6: apoch19 (12525 in chips)=20
Seat 7: A A 5454 (26803 in chips)=20
Seat 8: nwmdnj (15912 in chips)=20
Seat 9: TheFah475 (6930 in chips)=20
IknowHow2pla: posts the ante 20
@Bud_Fox0000: posts the ante 20
mschnides: posts the ante 20
JJin91: posts the ante 20
apoch19: posts the ante 20
A A 5454: posts the ante 20
nwmdnj: posts the ante 20
TheFah475: posts the ante 20
mschnides: posts small blind 75
JJin91: posts big blind 150
*** HOLE CARDS ***
Dealt to JJin91 [2d 6s]
apoch19: folds=20
A A 5454: folds=20
nwmdnj: folds=20
TheFah475: calls 150
IknowHow2pla: raises 300 to 450
@Bud_Fox0000: folds=20
mschnides: folds=20
JJin91: folds=20
TheFah475: folds=20
Uncalled bet (300) returned to IknowHow2pla
IknowHow2pla collected 685 from pot
IknowHow2pla: doesn't show hand=20
*** SUMMARY ***
Total pot 685 | Rake 0=20
Seat 2: IknowHow2pla collected (685)
Seat 3: @Bud_Fox0000 (button) folded before Flop (didn't bet)
Seat 4: mschnides (small blind) folded before Flop
Seat 5: JJin91 (big blind) folded before Flop
Seat 6: apoch19 folded before Flop (didn't bet)
Seat 7: A A 5454 folded before Flop (didn't bet)
Seat 8: nwmdnj folded before Flop (didn't bet)
Seat 9: TheFah475 folded before Flop


*********** # 51 **************
PokerStars Hand #175009608365: Tournament #1701776547, $18.20+$1.80 USD=
 Hold'em No Limit - Level VI (75/150) - 2017/09/13 19:51:20 ET
Table '1701776547 3' 9-max Seat #4 is the button
Seat 2: IknowHow2pla (13153 in chips)=20
Seat 3: @Bud_Fox0000 (11315 in chips)=20
Seat 4: mschnides (16259 in chips)=20
Seat 5: JJin91 (5979 in chips)=20
Seat 6: apoch19 (12505 in chips)=20
Seat 7: A A 5454 (26783 in chips)=20
Seat 8: nwmdnj (15892 in chips)=20
Seat 9: TheFah475 (6760 in chips)=20
IknowHow2pla: posts the ante 20
@Bud_Fox0000: posts the ante 20
mschnides: posts the ante 20
JJin91: posts the ante 20
apoch19: posts the ante 20
A A 5454: posts the ante 20
nwmdnj: posts the ante 20
TheFah475: posts the ante 20
JJin91: posts small blind 75
apoch19: posts big blind 150
*** HOLE CARDS ***
Dealt to JJin91 [As 4s]
A A 5454: calls 150
nwmdnj: folds=20
TheFah475: folds=20
IknowHow2pla: folds=20
@Bud_Fox0000: folds=20
mschnides: calls 150
JJin91: calls 75
apoch19: checks=20
*** FLOP *** [8s Jh 9d]
JJin91: checks=20
apoch19: checks=20
A A 5454: checks=20
mschnides: checks=20
*** TURN *** [8s Jh 9d] [Td]
JJin91: checks=20
apoch19: checks=20
A A 5454: bets 760
mschnides: folds=20
JJin91: folds=20
apoch19: folds=20
Uncalled bet (760) returned to A A 5454
A A 5454 collected 760 from pot
A A 5454: doesn't show hand=20
*** SUMMARY ***
Total pot 760 | Rake 0=20
Board [8s Jh 9d Td]
Seat 2: IknowHow2pla folded before Flop (didn't bet)
Seat 3: @Bud_Fox0000 folded before Flop (didn't bet)
Seat 4: mschnides (button) folded on the Turn
Seat 5: JJin91 (small blind) folded on the Turn
Seat 6: apoch19 (big blind) folded on the Turn
Seat 7: A A 5454 collected (760)
Seat 8: nwmdnj folded before Flop (didn't bet)
Seat 9: TheFah475 folded before Flop (didn't bet)


*********** # 52 **************
PokerStars Hand #175009608566: Tournament #1701776547, $18.20+$1.80 USD=
 Hold'em No Limit - Level VI (75/150) - 2017/09/13 19:52:14 ET
Table '1701776547 3' 9-max Seat #5 is the button
Seat 2: IknowHow2pla (13133 in chips)=20
Seat 3: @Bud_Fox0000 (11295 in chips)=20
Seat 4: mschnides (16089 in chips)=20
Seat 5: JJin91 (5809 in chips)=20
Seat 6: apoch19 (12335 in chips)=20
Seat 7: A A 5454 (27373 in chips)=20
Seat 8: nwmdnj (15872 in chips)=20
Seat 9: TheFah475 (6740 in chips)=20
IknowHow2pla: posts the ante 20
@Bud_Fox0000: posts the ante 20
mschnides: posts the ante 20
JJin91: posts the ante 20
apoch19: posts the ante 20
A A 5454: posts the ante 20
nwmdnj: posts the ante 20
TheFah475: posts the ante 20
apoch19: posts small blind 75
A A 5454: posts big blind 150
*** HOLE CARDS ***
Dealt to JJin91 [8s Ts]
nwmdnj: folds=20
TheFah475: raises 150 to 300
IknowHow2pla: calls 300
@Bud_Fox0000: folds=20
mschnides: raises 600 to 900
JJin91: folds=20
apoch19: folds=20
A A 5454: folds=20
TheFah475: calls 600
IknowHow2pla: calls 600
*** FLOP *** [Kh 8h Kd]
TheFah475: checks=20
IknowHow2pla: checks=20
mschnides: checks=20
*** TURN *** [Kh 8h Kd] [Td]
TheFah475: bets 450
IknowHow2pla: folds=20
mschnides: calls 450
*** RIVER *** [Kh 8h Kd Td] [7d]
TheFah475: bets 450
mschnides: folds=20
Uncalled bet (450) returned to TheFah475
TheFah475 collected 3985 from pot
TheFah475: doesn't show hand=20
*** SUMMARY ***
Total pot 3985 | Rake 0=20
Board [Kh 8h Kd Td 7d]
Seat 2: IknowHow2pla folded on the Turn
Seat 3: @Bud_Fox0000 folded before Flop (didn't bet)
Seat 4: mschnides folded on the River
Seat 5: JJin91 (button) folded before Flop (didn't bet)
Seat 6: apoch19 (small blind) folded before Flop
Seat 7: A A 5454 (big blind) folded before Flop
Seat 8: nwmdnj folded before Flop (didn't bet)
Seat 9: TheFah475 collected (3985)


*********** # 53 **************
PokerStars Hand #175009608906: Tournament #1701776547, $18.20+$1.80 USD=
 Hold'em No Limit - Level VI (75/150) - 2017/09/13 19:53:43 ET
Table '1701776547 3' 9-max Seat #6 is the button
Seat 1: geedisgood08 (10000 in chips)=20
Seat 2: IknowHow2pla (12213 in chips)=20
Seat 3: @Bud_Fox0000 (11275 in chips)=20
Seat 4: mschnides (14719 in chips)=20
Seat 5: JJin91 (5789 in chips)=20
Seat 6: apoch19 (12240 in chips)=20
Seat 7: A A 5454 (27203 in chips)=20
Seat 9: TheFah475 (9355 in chips)=20
geedisgood08: posts the ante 20
IknowHow2pla: posts the ante 20
@Bud_Fox0000: posts the ante 20
mschnides: posts the ante 20
JJin91: posts the ante 20
apoch19: posts the ante 20
A A 5454: posts the ante 20
TheFah475: posts the ante 20
A A 5454: posts small blind 75
TheFah475: posts big blind 150
*** HOLE CARDS ***
Dealt to JJin91 [Js Jc]
geedisgood08: folds=20
IknowHow2pla: folds=20
@Bud_Fox0000: folds=20
mschnides: folds=20
JJin91: raises 226 to 376
apoch19: folds=20
A A 5454: folds=20
TheFah475: folds=20
Uncalled bet (226) returned to JJin91
JJin91 collected 535 from pot
JJin91: doesn't show hand=20
*** SUMMARY ***
Total pot 535 | Rake 0=20
Seat 1: geedisgood08 folded before Flop (didn't bet)
Seat 2: IknowHow2pla folded before Flop (didn't bet)
Seat 3: @Bud_Fox0000 folded before Flop (didn't bet)
Seat 4: mschnides folded before Flop (didn't bet)
Seat 5: JJin91 collected (535)
Seat 6: apoch19 (button) folded before Flop (didn't bet)
Seat 7: A A 5454 (small blind) folded before Flop
Seat 9: TheFah475 (big blind) folded before Flop


*********** # 54 **************
PokerStars Hand #175009608962: Tournament #1701776547, $18.20+$1.80 USD=
 Hold'em No Limit - Level VI (75/150) - 2017/09/13 19:53:58 ET
Table '1701776547 3' 9-max Seat #7 is the button
Seat 2: IknowHow2pla (12193 in chips)=20
Seat 3: @Bud_Fox0000 (11255 in chips)=20
Seat 4: mschnides (14699 in chips)=20
Seat 5: JJin91 (6154 in chips)=20
Seat 6: apoch19 (12220 in chips)=20
Seat 7: A A 5454 (27108 in chips)=20
Seat 9: TheFah475 (9185 in chips)=20
IknowHow2pla: posts the ante 20
@Bud_Fox0000: posts the ante 20
mschnides: posts the ante 20
JJin91: posts the ante 20
apoch19: posts the ante 20
A A 5454: posts the ante 20
TheFah475: posts the ante 20
TheFah475: posts small blind 75
IknowHow2pla: posts big blind 150
*** HOLE CARDS ***
Dealt to JJin91 [Ac 3d]
@Bud_Fox0000: raises 150 to 300
mschnides: calls 300
JJin91: folds=20
apoch19: folds=20
A A 5454: folds=20
TheFah475: folds=20
IknowHow2pla: calls 150
*** FLOP *** [Qs 6c Jd]
IknowHow2pla: checks=20
@Bud_Fox0000: bets 575
mschnides: folds=20
IknowHow2pla: folds=20
Uncalled bet (575) returned to @Bud_Fox0000
@Bud_Fox0000 collected 1115 from pot
*** SUMMARY ***
Total pot 1115 | Rake 0=20
Board [Qs 6c Jd]
Seat 2: IknowHow2pla (big blind) folded on the Flop
Seat 3: @Bud_Fox0000 collected (1115)
Seat 4: mschnides folded on the Flop
Seat 5: JJin91 folded before Flop (didn't bet)
Seat 6: apoch19 folded before Flop (didn't bet)
Seat 7: A A 5454 (button) folded before Flop (didn't bet)
Seat 9: TheFah475 (small blind) folded before Flop


*********** # 55 **************
PokerStars Hand #175009609097: Tournament #1701776547, $18.20+$1.80 USD=
 Hold'em No Limit - Level VI (75/150) - 2017/09/13 19:54:34 ET
Table '1701776547 3' 9-max Seat #9 is the button
Seat 2: IknowHow2pla (11873 in chips)=20
Seat 3: @Bud_Fox0000 (12050 in chips)=20
Seat 4: mschnides (14379 in chips)=20
Seat 5: JJin91 (6134 in chips)=20
Seat 6: apoch19 (12200 in chips)=20
Seat 7: A A 5454 (27088 in chips)=20
Seat 9: TheFah475 (9090 in chips)=20
IknowHow2pla: posts the ante 20
@Bud_Fox0000: posts the ante 20
mschnides: posts the ante 20
JJin91: posts the ante 20
apoch19: posts the ante 20
A A 5454: posts the ante 20
TheFah475: posts the ante 20
IknowHow2pla: posts small blind 75
@Bud_Fox0000: posts big blind 150
*** HOLE CARDS ***
Dealt to JJin91 [Tc 8s]
mschnides: folds=20
JJin91: folds=20
apoch19: folds=20
A A 5454: calls 150
TheFah475: calls 150
IknowHow2pla: raises 450 to 600
@Bud_Fox0000: folds=20
A A 5454: folds=20
TheFah475: folds=20
Uncalled bet (450) returned to IknowHow2pla
IknowHow2pla collected 740 from pot
IknowHow2pla: doesn't show hand=20
*** SUMMARY ***
Total pot 740 | Rake 0=20
Seat 2: IknowHow2pla (small blind) collected (740)
Seat 3: @Bud_Fox0000 (big blind) folded before Flop
Seat 4: mschnides folded before Flop (didn't bet)
Seat 5: JJin91 folded before Flop (didn't bet)
Seat 6: apoch19 folded before Flop (didn't bet)
Seat 7: A A 5454 folded before Flop
Seat 9: TheFah475 (button) folded before Flop


*********** # 56 **************
PokerStars Hand #175009609219: Tournament #1701776547, $18.20+$1.80 USD=
 Hold'em No Limit - Level VI (75/150) - 2017/09/13 19:55:05 ET
Table '1701776547 3' 9-max Seat #2 is the button
Seat 2: IknowHow2pla (12443 in chips)=20
Seat 3: @Bud_Fox0000 (11880 in chips)=20
Seat 4: mschnides (14359 in chips)=20
Seat 5: JJin91 (6114 in chips)=20
Seat 6: apoch19 (12180 in chips)=20
Seat 7: A A 5454 (26918 in chips)=20
Seat 9: TheFah475 (8920 in chips)=20
IknowHow2pla: posts the ante 20
@Bud_Fox0000: posts the ante 20
mschnides: posts the ante 20
JJin91: posts the ante 20
apoch19: posts the ante 20
A A 5454: posts the ante 20
TheFah475: posts the ante 20
@Bud_Fox0000: posts small blind 75
mschnides: posts big blind 150
*** HOLE CARDS ***
Dealt to JJin91 [Th Qh]
JJin91: raises 175 to 325
apoch19: folds=20
A A 5454: folds=20
TheFah475: calls 325
IknowHow2pla: folds=20
@Bud_Fox0000: calls 250
mschnides: calls 175
*** FLOP *** [3c 9s 7c]
@Bud_Fox0000: checks=20
mschnides: checks=20
JJin91: checks=20
TheFah475: checks=20
*** TURN *** [3c 9s 7c] [Ts]
@Bud_Fox0000: bets 665
mschnides: folds=20
JJin91: raises 1025 to 1690
TheFah475: folds=20
@Bud_Fox0000: folds=20
Uncalled bet (1025) returned to JJin91
JJin91 collected 2770 from pot
JJin91: doesn't show hand=20
*** SUMMARY ***
Total pot 2770 | Rake 0=20
Board [3c 9s 7c Ts]
Seat 2: IknowHow2pla (button) folded before Flop (didn't bet)
Seat 3: @Bud_Fox0000 (small blind) folded on the Turn
Seat 4: mschnides (big blind) folded on the Turn
Seat 5: JJin91 collected (2770)
Seat 6: apoch19 folded before Flop (didn't bet)
Seat 7: A A 5454 folded before Flop (didn't bet)
Seat 9: TheFah475 folded on the Turn


*********** # 57 **************
PokerStars Hand #175009939430: Tournament #1701776547, $18.20+$1.80 USD=
 Hold'em No Limit - Level VI (75/150) - 2017/09/13 20:01:15 ET
Table '1701776547 3' 9-max Seat #3 is the button
Seat 2: IknowHow2pla (12423 in chips)=20
Seat 3: @Bud_Fox0000 (10870 in chips)=20
Seat 4: mschnides (14014 in chips)=20
Seat 5: JJin91 (7874 in chips)=20
Seat 6: apoch19 (12160 in chips)=20
Seat 7: A A 5454 (26898 in chips)=20
Seat 8: Bar.usWYGRAM (10000 in chips)=20
Seat 9: TheFah475 (8575 in chips)=20
IknowHow2pla: posts the ante 20
@Bud_Fox0000: posts the ante 20
mschnides: posts the ante 20
JJin91: posts the ante 20
apoch19: posts the ante 20
A A 5454: posts the ante 20
Bar.usWYGRAM: posts the ante 20
TheFah475: posts the ante 20
mschnides: posts small blind 75
JJin91: posts big blind 150
*** HOLE CARDS ***
Dealt to JJin91 [9h Qs]
apoch19: folds=20
A A 5454 has timed out
A A 5454: folds=20
A A 5454 is sitting out
Bar.usWYGRAM: folds=20
TheFah475: folds=20
IknowHow2pla: folds=20
@Bud_Fox0000: folds=20
mschnides: folds=20
Uncalled bet (75) returned to JJin91
JJin91 collected 310 from pot
JJin91: doesn't show hand=20
*** SUMMARY ***
Total pot 310 | Rake 0=20
Seat 2: IknowHow2pla folded before Flop (didn't bet)
Seat 3: @Bud_Fox0000 (button) folded before Flop (didn't bet)
Seat 4: mschnides (small blind) folded before Flop
Seat 5: JJin91 (big blind) collected (310)
Seat 6: apoch19 folded before Flop (didn't bet)
Seat 7: A A 5454 folded before Flop (didn't bet)
Seat 8: Bar.usWYGRAM folded before Flop (didn't bet)
Seat 9: TheFah475 folded before Flop (didn't bet)


*********** # 58 **************
PokerStars Hand #175009939663: Tournament #1701776547, $18.20+$1.80 USD=
 Hold'em No Limit - Level VI (75/150) - 2017/09/13 20:02:23 ET
Table '1701776547 3' 9-max Seat #4 is the button
Seat 2: IknowHow2pla (12403 in chips)=20
Seat 3: @Bud_Fox0000 (10850 in chips)=20
Seat 4: mschnides (13919 in chips)=20
Seat 5: JJin91 (8089 in chips)=20
Seat 6: apoch19 (12140 in chips)=20
Seat 7: A A 5454 (26878 in chips) is sitting out
Seat 8: Bar.usWYGRAM (9980 in chips)=20
Seat 9: TheFah475 (8555 in chips)=20
IknowHow2pla: posts the ante 20
@Bud_Fox0000: posts the ante 20
mschnides: posts the ante 20
JJin91: posts the ante 20
apoch19: posts the ante 20
A A 5454: posts the ante 20
Bar.usWYGRAM: posts the ante 20
TheFah475: posts the ante 20
JJin91: posts small blind 75
apoch19: posts big blind 150
*** HOLE CARDS ***
Dealt to JJin91 [Jh Qh]
A A 5454: folds=20
A A 5454 has returned
Bar.usWYGRAM: folds=20
TheFah475: folds=20
IknowHow2pla: calls 150
@Bud_Fox0000: folds=20
mschnides: folds=20
JJin91: calls 75
apoch19: checks=20
*** FLOP *** [8s Qd 9s]
JJin91: bets 445
apoch19: folds=20
IknowHow2pla: calls 445
*** TURN *** [8s Qd 9s] [Ah]
JJin91: checks=20
IknowHow2pla: checks=20
*** RIVER *** [8s Qd 9s Ah] [4d]
JJin91: bets 1095
IknowHow2pla: folds=20
Uncalled bet (1095) returned to JJin91
JJin91 collected 1500 from pot
JJin91: doesn't show hand=20
*** SUMMARY ***
Total pot 1500 | Rake 0=20
Board [8s Qd 9s Ah 4d]
Seat 2: IknowHow2pla folded on the River
Seat 3: @Bud_Fox0000 folded before Flop (didn't bet)
Seat 4: mschnides (button) folded before Flop (didn't bet)
Seat 5: JJin91 (small blind) collected (1500)
Seat 6: apoch19 (big blind) folded on the Flop
Seat 7: A A 5454 folded before Flop (didn't bet)
Seat 8: Bar.usWYGRAM folded before Flop (didn't bet)
Seat 9: TheFah475 folded before Flop (didn't bet)


*********** # 59 **************
PokerStars Hand #175009939877: Tournament #1701776547, $18.20+$1.80 USD=
 Hold'em No Limit - Level VI (75/150) - 2017/09/13 20:03:27 ET
Table '1701776547 3' 9-max Seat #5 is the button
Seat 2: IknowHow2pla (11788 in chips)=20
Seat 3: @Bud_Fox0000 (10830 in chips)=20
Seat 4: mschnides (13899 in chips)=20
Seat 5: JJin91 (8974 in chips)=20
Seat 6: apoch19 (11970 in chips)=20
Seat 7: A A 5454 (26858 in chips)=20
Seat 8: Bar.usWYGRAM (9960 in chips)=20
Seat 9: TheFah475 (8535 in chips)=20
IknowHow2pla: posts the ante 20
@Bud_Fox0000: posts the ante 20
mschnides: posts the ante 20
JJin91: posts the ante 20
apoch19: posts the ante 20
A A 5454: posts the ante 20
Bar.usWYGRAM: posts the ante 20
TheFah475: posts the ante 20
apoch19: posts small blind 75
A A 5454: posts big blind 150
*** HOLE CARDS ***
Dealt to JJin91 [Tc 2h]
Bar.usWYGRAM: folds=20
TheFah475: folds=20
IknowHow2pla: raises 150 to 300
@Bud_Fox0000: calls 300
mschnides: folds=20
JJin91: folds=20
apoch19: folds=20
A A 5454: calls 150
*** FLOP *** [Ts 7h 3c]
A A 5454: checks=20
IknowHow2pla: checks=20
@Bud_Fox0000: bets 575
A A 5454: folds=20
IknowHow2pla: folds=20
Uncalled bet (575) returned to @Bud_Fox0000
@Bud_Fox0000 collected 1135 from pot
*** SUMMARY ***
Total pot 1135 | Rake 0=20
Board [Ts 7h 3c]
Seat 2: IknowHow2pla folded on the Flop
Seat 3: @Bud_Fox0000 collected (1135)
Seat 4: mschnides folded before Flop (didn't bet)
Seat 5: JJin91 (button) folded before Flop (didn't bet)
Seat 6: apoch19 (small blind) folded before Flop
Seat 7: A A 5454 (big blind) folded on the Flop
Seat 8: Bar.usWYGRAM folded before Flop (didn't bet)
Seat 9: TheFah475 folded before Flop (didn't bet)


*********** # 60 **************
PokerStars Hand #175010006384: Tournament #1701776547, $18.20+$1.80 USD=
 Hold'em No Limit - Level VI (75/150) - 2017/09/13 20:04:27 ET
Table '1701776547 3' 9-max Seat #6 is the button
Seat 2: IknowHow2pla (11468 in chips)=20
Seat 3: @Bud_Fox0000 (11645 in chips)=20
Seat 4: mschnides (13879 in chips)=20
Seat 5: JJin91 (8954 in chips)=20
Seat 6: apoch19 (11875 in chips)=20
Seat 7: A A 5454 (26538 in chips)=20
Seat 8: Bar.usWYGRAM (9940 in chips)=20
Seat 9: TheFah475 (8515 in chips)=20
IknowHow2pla: posts the ante 20
@Bud_Fox0000: posts the ante 20
mschnides: posts the ante 20
JJin91: posts the ante 20
apoch19: posts the ante 20
A A 5454: posts the ante 20
Bar.usWYGRAM: posts the ante 20
TheFah475: posts the ante 20
A A 5454: posts small blind 75
Bar.usWYGRAM: posts big blind 150
*** HOLE CARDS ***
Dealt to JJin91 [Kc 7c]
TheFah475: folds=20
IknowHow2pla: raises 150 to 300
@Bud_Fox0000: calls 300
mschnides: folds=20
JJin91: folds=20
apoch19: folds=20
A A 5454: folds=20
Bar.usWYGRAM: calls 150
*** FLOP *** [2c 5s 2s]
Bar.usWYGRAM: checks=20
IknowHow2pla: checks=20
@Bud_Fox0000: checks=20
*** TURN *** [2c 5s 2s] [Qh]
Bar.usWYGRAM: bets 397
IknowHow2pla: folds=20
@Bud_Fox0000: calls 397
*** RIVER *** [2c 5s 2s Qh] [7d]
Bar.usWYGRAM: checks=20
@Bud_Fox0000: bets 1225
Bar.usWYGRAM: folds=20
Uncalled bet (1225) returned to @Bud_Fox0000
@Bud_Fox0000 collected 1929 from pot
*** SUMMARY ***
Total pot 1929 | Rake 0=20
Board [2c 5s 2s Qh 7d]
Seat 2: IknowHow2pla folded on the Turn
Seat 3: @Bud_Fox0000 collected (1929)
Seat 4: mschnides folded before Flop (didn't bet)
Seat 5: JJin91 folded before Flop (didn't bet)
Seat 6: apoch19 (button) folded before Flop (didn't bet)
Seat 7: A A 5454 (small blind) folded before Flop
Seat 8: Bar.usWYGRAM (big blind) folded on the River
Seat 9: TheFah475 folded before Flop (didn't bet)


*********** # 61 **************
PokerStars Hand #175010006586: Tournament #1701776547, $18.20+$1.80 USD=
 Hold'em No Limit - Level VI (75/150) - 2017/09/13 20:05:29 ET
Table '1701776547 3' 9-max Seat #7 is the button
Seat 2: IknowHow2pla (11148 in chips)=20
Seat 3: @Bud_Fox0000 (12857 in chips)=20
Seat 4: mschnides (13859 in chips)=20
Seat 5: JJin91 (8934 in chips)=20
Seat 6: apoch19 (11855 in chips)=20
Seat 7: A A 5454 (26443 in chips)=20
Seat 8: Bar.usWYGRAM (9223 in chips)=20
Seat 9: TheFah475 (8495 in chips)=20
IknowHow2pla: posts the ante 20
@Bud_Fox0000: posts the ante 20
mschnides: posts the ante 20
JJin91: posts the ante 20
apoch19: posts the ante 20
A A 5454: posts the ante 20
Bar.usWYGRAM: posts the ante 20
TheFah475: posts the ante 20
Bar.usWYGRAM: posts small blind 75
TheFah475: posts big blind 150
*** HOLE CARDS ***
Dealt to JJin91 [Ts Qc]
IknowHow2pla: calls 150
@Bud_Fox0000: folds=20
mschnides: calls 150
JJin91: folds=20
apoch19: folds=20
A A 5454: folds=20
Bar.usWYGRAM: calls 75
TheFah475: checks=20
*** FLOP *** [Td Tc Ac]
Bar.usWYGRAM: bets 507
TheFah475: folds=20
IknowHow2pla: folds=20
mschnides: calls 507
*** TURN *** [Td Tc Ac] [4c]
Bar.usWYGRAM: checks=20
mschnides: bets 1183
Bar.usWYGRAM: folds [Ah]
Uncalled bet (1183) returned to mschnides
mschnides collected 1774 from pot
*** SUMMARY ***
Total pot 1774 | Rake 0=20
Board [Td Tc Ac 4c]
Seat 2: IknowHow2pla folded on the Flop
Seat 3: @Bud_Fox0000 folded before Flop (didn't bet)
Seat 4: mschnides collected (1774)
Seat 5: JJin91 folded before Flop (didn't bet)
Seat 6: apoch19 folded before Flop (didn't bet)
Seat 7: A A 5454 (button) folded before Flop (didn't bet)
Seat 8: Bar.usWYGRAM (small blind) folded on the Turn
Seat 9: TheFah475 (big blind) folded on the Flop


*********** # 62 **************
PokerStars Hand #175010006918: Tournament #1701776547, $18.20+$1.80 USD=
 Hold'em No Limit - Level VII (100/200) - 2017/09/13 20:07:09 ET
Table '1701776547 3' 9-max Seat #8 is the button
Seat 2: IknowHow2pla (10978 in chips)=20
Seat 3: @Bud_Fox0000 (12837 in chips)=20
Seat 4: mschnides (14956 in chips)=20
Seat 5: JJin91 (8914 in chips)=20
Seat 6: apoch19 (11835 in chips)=20
Seat 7: A A 5454 (26423 in chips)=20
Seat 8: Bar.usWYGRAM (8546 in chips)=20
Seat 9: TheFah475 (8325 in chips)=20
IknowHow2pla: posts the ante 25
@Bud_Fox0000: posts the ante 25
mschnides: posts the ante 25
JJin91: posts the ante 25
apoch19: posts the ante 25
A A 5454: posts the ante 25
Bar.usWYGRAM: posts the ante 25
TheFah475: posts the ante 25
TheFah475: posts small blind 100
IknowHow2pla: posts big blind 200
*** HOLE CARDS ***
Dealt to JJin91 [4s Kc]
Bar.usWYGRAM said, "fuck that pot"
Bar.usWYGRAM said, "too risky"
@Bud_Fox0000: folds=20
Bar.usWYGRAM said, "10 and flush"
mschnides: folds=20
JJin91: folds=20
apoch19: folds=20
A A 5454: folds=20
Bar.usWYGRAM: folds=20
TheFah475: calls 100
IknowHow2pla: checks=20
*** FLOP *** [9d 2s As]
TheFah475: bets 200
IknowHow2pla: folds=20
Uncalled bet (200) returned to TheFah475
TheFah475 collected 600 from pot
TheFah475: doesn't show hand=20
*** SUMMARY ***
Total pot 600 | Rake 0=20
Board [9d 2s As]
Seat 2: IknowHow2pla (big blind) folded on the Flop
Seat 3: @Bud_Fox0000 folded before Flop (didn't bet)
Seat 4: mschnides folded before Flop (didn't bet)
Seat 5: JJin91 folded before Flop (didn't bet)
Seat 6: apoch19 folded before Flop (didn't bet)
Seat 7: A A 5454 folded before Flop (didn't bet)
Seat 8: Bar.usWYGRAM (button) folded before Flop (didn't bet)
Seat 9: TheFah475 (small blind) collected (600)


*********** # 63 **************
PokerStars Hand #175010007024: Tournament #1701776547, $18.20+$1.80 USD=
 Hold'em No Limit - Level VII (100/200) - 2017/09/13 20:07:39 ET
Table '1701776547 3' 9-max Seat #9 is the button
Seat 2: IknowHow2pla (10753 in chips)=20
Seat 3: @Bud_Fox0000 (12812 in chips)=20
Seat 4: mschnides (14931 in chips)=20
Seat 5: JJin91 (8889 in chips)=20
Seat 6: apoch19 (11810 in chips)=20
Seat 7: A A 5454 (26398 in chips)=20
Seat 8: Bar.usWYGRAM (8521 in chips)=20
Seat 9: TheFah475 (8700 in chips)=20
IknowHow2pla: posts the ante 25
@Bud_Fox0000: posts the ante 25
mschnides: posts the ante 25
JJin91: posts the ante 25
apoch19: posts the ante 25
A A 5454: posts the ante 25
Bar.usWYGRAM: posts the ante 25
TheFah475: posts the ante 25
IknowHow2pla: posts small blind 100
@Bud_Fox0000: posts big blind 200
*** HOLE CARDS ***
Dealt to JJin91 [Ts 8h]
mschnides: calls 200
JJin91: folds=20
apoch19: folds=20
A A 5454: folds=20
Bar.usWYGRAM: folds=20
TheFah475: folds=20
IknowHow2pla: folds=20
@Bud_Fox0000: checks=20
*** FLOP *** [Td Kc 2s]
@Bud_Fox0000: bets 200
mschnides: calls 200
*** TURN *** [Td Kc 2s] [Jc]
@Bud_Fox0000: bets 400
mschnides: calls 400
*** RIVER *** [Td Kc 2s Jc] [7d]
@Bud_Fox0000: bets 600
mschnides: raises 600 to 1200
@Bud_Fox0000: calls 600
*** SHOW DOWN ***
mschnides: shows [Kh Kd] (three of a kind, Kings)
@Bud_Fox0000: mucks hand=20
mschnides collected 4300 from pot
*** SUMMARY ***
Total pot 4300 | Rake 0=20
Board [Td Kc 2s Jc 7d]
Seat 2: IknowHow2pla (small blind) folded before Flop
Seat 3: @Bud_Fox0000 (big blind) mucked [5d Ks]
Seat 4: mschnides showed [Kh Kd] and won (4300) with three of a kind, K=
ings
Seat 5: JJin91 folded before Flop (didn't bet)
Seat 6: apoch19 folded before Flop (didn't bet)
Seat 7: A A 5454 folded before Flop (didn't bet)
Seat 8: Bar.usWYGRAM folded before Flop (didn't bet)
Seat 9: TheFah475 (button) folded before Flop (didn't bet)


*********** # 64 **************
PokerStars Hand #175010007169: Tournament #1701776547, $18.20+$1.80 USD=
 Hold'em No Limit - Level VII (100/200) - 2017/09/13 20:08:23 ET
Table '1701776547 3' 9-max Seat #2 is the button
Seat 2: IknowHow2pla (10628 in chips)=20
Seat 3: @Bud_Fox0000 (10787 in chips)=20
Seat 4: mschnides (17206 in chips)=20
Seat 5: JJin91 (8864 in chips)=20
Seat 6: apoch19 (11785 in chips)=20
Seat 7: A A 5454 (26373 in chips)=20
Seat 8: Bar.usWYGRAM (8496 in chips)=20
Seat 9: TheFah475 (8675 in chips)=20
IknowHow2pla: posts the ante 25
@Bud_Fox0000: posts the ante 25
mschnides: posts the ante 25
JJin91: posts the ante 25
apoch19: posts the ante 25
A A 5454: posts the ante 25
Bar.usWYGRAM: posts the ante 25
TheFah475: posts the ante 25
@Bud_Fox0000: posts small blind 100
mschnides: posts big blind 200
*** HOLE CARDS ***
Dealt to JJin91 [Td Tc]
JJin91: raises 234 to 434
apoch19: folds=20
A A 5454: folds=20
Bar.usWYGRAM: calls 434
TheFah475: folds=20
IknowHow2pla: folds=20
@Bud_Fox0000: folds=20
mschnides: folds=20
*** FLOP *** [Ah 3s 2h]
JJin91: bets 506
Bar.usWYGRAM: calls 506
*** TURN *** [Ah 3s 2h] [7c]
JJin91: checks=20
Bar.usWYGRAM: bets 1000
JJin91: folds=20
Uncalled bet (1000) returned to Bar.usWYGRAM
Bar.usWYGRAM collected 2380 from pot
Bar.usWYGRAM: shows [2d]
*** SUMMARY ***
Total pot 2380 | Rake 0=20
Board [Ah 3s 2h 7c]
Seat 2: IknowHow2pla (button) folded before Flop (didn't bet)
Seat 3: @Bud_Fox0000 (small blind) folded before Flop
Seat 4: mschnides (big blind) folded before Flop
Seat 5: JJin91 folded on the Turn
Seat 6: apoch19 folded before Flop (didn't bet)
Seat 7: A A 5454 folded before Flop (didn't bet)
Seat 8: Bar.usWYGRAM collected (2380)
Seat 9: TheFah475 folded before Flop (didn't bet)


*********** # 65 **************
PokerStars Hand #175010007413: Tournament #1701776547, $18.20+$1.80 USD=
 Hold'em No Limit - Level VII (100/200) - 2017/09/13 20:09:33 ET
Table '1701776547 3' 9-max Seat #3 is the button
Seat 2: IknowHow2pla (10603 in chips)=20
Seat 3: @Bud_Fox0000 (10662 in chips)=20
Seat 4: mschnides (16981 in chips)=20
Seat 5: JJin91 (7899 in chips)=20
Seat 6: apoch19 (11760 in chips)=20
Seat 7: A A 5454 (26348 in chips)=20
Seat 8: Bar.usWYGRAM (9911 in chips)=20
Seat 9: TheFah475 (8650 in chips)=20
IknowHow2pla: posts the ante 25
@Bud_Fox0000: posts the ante 25
mschnides: posts the ante 25
JJin91: posts the ante 25
apoch19: posts the ante 25
A A 5454: posts the ante 25
Bar.usWYGRAM: posts the ante 25
TheFah475: posts the ante 25
mschnides: posts small blind 100
JJin91: posts big blind 200
*** HOLE CARDS ***
Dealt to JJin91 [Ac 8c]
apoch19: raises 280 to 480
A A 5454: calls 480
Bar.usWYGRAM: folds=20
TheFah475: folds=20
IknowHow2pla: calls 480
@Bud_Fox0000: folds=20
mschnides: folds=20
JJin91: calls 280
*** FLOP *** [4c Jd 2d]
JJin91: checks=20
apoch19: bets 1420
A A 5454: calls 1420
IknowHow2pla: folds=20
JJin91: folds=20
*** TURN *** [4c Jd 2d] [5h]
apoch19: bets 3200
A A 5454: calls 3200
*** RIVER *** [4c Jd 2d 5h] [Ts]
apoch19: bets 6635 and is all-in
A A 5454: folds=20
Uncalled bet (6635) returned to apoch19
apoch19 collected 11460 from pot
apoch19: doesn't show hand=20
*** SUMMARY ***
Total pot 11460 | Rake 0=20
Board [4c Jd 2d 5h Ts]
Seat 2: IknowHow2pla folded on the Flop
Seat 3: @Bud_Fox0000 (button) folded before Flop (didn't bet)
Seat 4: mschnides (small blind) folded before Flop
Seat 5: JJin91 (big blind) folded on the Flop
Seat 6: apoch19 collected (11460)
Seat 7: A A 5454 folded on the River
Seat 8: Bar.usWYGRAM folded before Flop (didn't bet)
Seat 9: TheFah475 folded before Flop (didn't bet)


*********** # 66 **************
PokerStars Hand #175010007742: Tournament #1701776547, $18.20+$1.80 USD=
 Hold'em No Limit - Level VII (100/200) - 2017/09/13 20:11:04 ET
Table '1701776547 3' 9-max Seat #4 is the button
Seat 2: IknowHow2pla (10098 in chips)=20
Seat 3: @Bud_Fox0000 (10637 in chips)=20
Seat 4: mschnides (16856 in chips)=20
Seat 5: JJin91 (7394 in chips)=20
Seat 6: apoch19 (18095 in chips)=20
Seat 7: A A 5454 (21223 in chips)=20
Seat 8: Bar.usWYGRAM (9886 in chips)=20
Seat 9: TheFah475 (8625 in chips)=20
IknowHow2pla: posts the ante 25
@Bud_Fox0000: posts the ante 25
mschnides: posts the ante 25
JJin91: posts the ante 25
apoch19: posts the ante 25
A A 5454: posts the ante 25
Bar.usWYGRAM: posts the ante 25
TheFah475: posts the ante 25
JJin91: posts small blind 100
apoch19: posts big blind 200
*** HOLE CARDS ***
Dealt to JJin91 [Ks Jd]
A A 5454: calls 200
Bar.usWYGRAM: raises 200 to 400
TheFah475: folds=20
IknowHow2pla: folds=20
@Bud_Fox0000: folds=20
mschnides: calls 400
JJin91: raises 6969 to 7369 and is all-in
apoch19: folds=20
A A 5454: folds=20
Bar.usWYGRAM: folds=20
mschnides: folds=20
Uncalled bet (6969) returned to JJin91
JJin91 collected 1800 from pot
JJin91: doesn't show hand=20
*** SUMMARY ***
Total pot 1800 | Rake 0=20
Seat 2: IknowHow2pla folded before Flop (didn't bet)
Seat 3: @Bud_Fox0000 folded before Flop (didn't bet)
Seat 4: mschnides (button) folded before Flop
Seat 5: JJin91 (small blind) collected (1800)
Seat 6: apoch19 (big blind) folded before Flop
Seat 7: A A 5454 folded before Flop
Seat 8: Bar.usWYGRAM folded before Flop
Seat 9: TheFah475 folded before Flop (didn't bet)


*********** # 67 **************
PokerStars Hand #175010007928: Tournament #1701776547, $18.20+$1.80 USD=
 Hold'em No Limit - Level VII (100/200) - 2017/09/13 20:12:02 ET
Table '1701776547 3' 9-max Seat #5 is the button
Seat 1: vincent329 (10000 in chips)=20
Seat 2: IknowHow2pla (10073 in chips)=20
Seat 3: @Bud_Fox0000 (10612 in chips)=20
Seat 4: mschnides (16431 in chips)=20
Seat 5: JJin91 (8769 in chips)=20
Seat 6: apoch19 (17870 in chips)=20
Seat 8: Bar.usWYGRAM (9461 in chips)=20
Seat 9: TheFah475 (8600 in chips)=20
vincent329: posts the ante 25
IknowHow2pla: posts the ante 25
@Bud_Fox0000: posts the ante 25
mschnides: posts the ante 25
JJin91: posts the ante 25
apoch19: posts the ante 25
Bar.usWYGRAM: posts the ante 25
TheFah475: posts the ante 25
apoch19: posts small blind 100
Bar.usWYGRAM: posts big blind 200
*** HOLE CARDS ***
Dealt to JJin91 [7s 6h]
TheFah475: folds=20
vincent329: calls 200
IknowHow2pla: folds=20
@Bud_Fox0000: folds=20
mschnides: calls 200
JJin91: folds=20
apoch19: calls 100
Bar.usWYGRAM: checks=20
*** FLOP *** [Qs 9d Td]
apoch19: checks=20
Bar.usWYGRAM: bets 1000
vincent329: folds=20
mschnides: calls 1000
apoch19: raises 2300 to 3300
Bar.usWYGRAM: raises 5936 to 9236 and is all-in
mschnides: folds=20
apoch19: calls 5936
Bar.usWYGRAM said, "999q9qq9q9q99q9q9 fullhouse plssss"
Bar.usWYGRAM said, "9q9q9q9"
Bar.usWYGRAM said, "9q9q9q9q"
*** TURN *** [Qs 9d Td] [Js]
Bar.usWYGRAM said, "q9q9q9q9q9q"
*** RIVER *** [Qs 9d Td Js] [6d]
Bar.usWYGRAM said, "q9q9q9q9"
*** SHOW DOWN ***
apoch19: shows [Jc 8h] (a straight, Eight to Queen)
Bar.usWYGRAM: shows [9h Qd] (two pair, Queens and Nines)
Bar.usWYGRAM said, "damn"
apoch19 collected 20472 from pot
Bar.usWYGRAM finished the tournament in 100th place
*** SUMMARY ***
Total pot 20472 | Rake 0=20
Board [Qs 9d Td Js 6d]
Seat 1: vincent329 folded on the Flop
Seat 2: IknowHow2pla folded before Flop (didn't bet)
Seat 3: @Bud_Fox0000 folded before Flop (didn't bet)
Seat 4: mschnides folded on the Flop
Seat 5: JJin91 (button) folded before Flop (didn't bet)
Seat 6: apoch19 (small blind) showed [Jc 8h] and won (20472) with a str=
aight, Eight to Queen
Seat 8: Bar.usWYGRAM (big blind) showed [9h Qd] and lost with two pair,=
 Queens and Nines
Seat 9: TheFah475 folded before Flop (didn't bet)


*********** # 68 **************
PokerStars Hand #175010008259: Tournament #1701776547, $18.20+$1.80 USD=
 Hold'em No Limit - Level VII (100/200) - 2017/09/13 20:13:32 ET
Table '1701776547 3' 9-max Seat #6 is the button
Seat 1: vincent329 (9775 in chips)=20
Seat 2: IknowHow2pla (10048 in chips)=20
Seat 3: @Bud_Fox0000 (10587 in chips)=20
Seat 4: mschnides (15206 in chips)=20
Seat 5: JJin91 (8744 in chips)=20
Seat 6: apoch19 (28881 in chips)=20
Seat 7: Bar.usWYGRAM (10000 in chips) out of hand (moved from another t=
able into small blind)
Seat 9: TheFah475 (8575 in chips)=20
vincent329: posts the ante 25
IknowHow2pla: posts the ante 25
@Bud_Fox0000: posts the ante 25
mschnides: posts the ante 25
JJin91: posts the ante 25
apoch19: posts the ante 25
TheFah475: posts the ante 25
TheFah475: posts small blind 100
vincent329: posts big blind 200
*** HOLE CARDS ***
Dealt to JJin91 [7d Kc]
IknowHow2pla: raises 200 to 400
@Bud_Fox0000: folds=20
mschnides said, "well, i had one of his Qs and one of his 9s lol"
mschnides: folds=20
JJin91: folds=20
apoch19: calls 400
TheFah475: folds=20
vincent329: calls 200
*** FLOP *** [Jh 2s Qc]
mschnides said, "wasnt making a boat on that one haha"
vincent329: checks=20
IknowHow2pla: bets 400
apoch19: calls 400
vincent329: calls 400
*** TURN *** [Jh 2s Qc] [8d]
vincent329: checks=20
IknowHow2pla: checks=20
apoch19: bets 1338
vincent329: folds=20
IknowHow2pla: folds=20
Uncalled bet (1338) returned to apoch19
apoch19 collected 2675 from pot
apoch19: doesn't show hand=20
*** SUMMARY ***
Total pot 2675 | Rake 0=20
Board [Jh 2s Qc 8d]
Seat 1: vincent329 (big blind) folded on the Turn
Seat 2: IknowHow2pla folded on the Turn
Seat 3: @Bud_Fox0000 folded before Flop (didn't bet)
Seat 4: mschnides folded before Flop (didn't bet)
Seat 5: JJin91 folded before Flop (didn't bet)
Seat 6: apoch19 (button) collected (2675)
Seat 9: TheFah475 (small blind) folded before Flop


*********** # 69 **************
PokerStars Hand #175010008438: Tournament #1701776547, $18.20+$1.80 USD=
 Hold'em No Limit - Level VII (100/200) - 2017/09/13 20:14:19 ET
Table '1701776547 3' 9-max Seat #9 is the button
Seat 1: vincent329 (8950 in chips)=20
Seat 2: IknowHow2pla (9223 in chips)=20
Seat 3: @Bud_Fox0000 (10562 in chips)=20
Seat 4: mschnides (15181 in chips)=20
Seat 5: JJin91 (8719 in chips)=20
Seat 6: apoch19 (30731 in chips)=20
Seat 7: Bar.usWYGRAM (10000 in chips)=20
Seat 9: TheFah475 (8450 in chips)=20
vincent329: posts the ante 25
IknowHow2pla: posts the ante 25
@Bud_Fox0000: posts the ante 25
mschnides: posts the ante 25
JJin91: posts the ante 25
apoch19: posts the ante 25
Bar.usWYGRAM: posts the ante 25
TheFah475: posts the ante 25
vincent329: posts small blind 100
IknowHow2pla: posts big blind 200
*** HOLE CARDS ***
Dealt to JJin91 [4h Js]
@Bud_Fox0000: folds=20
mschnides: folds=20
JJin91: folds=20
apoch19: folds=20
Bar.usWYGRAM: raises 200 to 400
TheFah475: folds=20
vincent329: calls 300
IknowHow2pla: calls 200
*** FLOP *** [3s 3d Ac]
vincent329: checks=20
IknowHow2pla: checks=20
Bar.usWYGRAM: bets 933
vincent329: folds=20
IknowHow2pla: folds=20
Uncalled bet (933) returned to Bar.usWYGRAM
Bar.usWYGRAM collected 1400 from pot
Bar.usWYGRAM: shows [As]
*** SUMMARY ***
Total pot 1400 | Rake 0=20
Board [3s 3d Ac]
Seat 1: vincent329 (small blind) folded on the Flop
Seat 2: IknowHow2pla (big blind) folded on the Flop
Seat 3: @Bud_Fox0000 folded before Flop (didn't bet)
Seat 4: mschnides folded before Flop (didn't bet)
Seat 5: JJin91 folded before Flop (didn't bet)
Seat 6: apoch19 folded before Flop (didn't bet)
Seat 7: Bar.usWYGRAM collected (1400)
Seat 9: TheFah475 (button) folded before Flop (didn't bet)


*********** # 70 **************
PokerStars Hand #175010008575: Tournament #1701776547, $18.20+$1.80 USD=
 Hold'em No Limit - Level VII (100/200) - 2017/09/13 20:14:55 ET
Table '1701776547 3' 9-max Seat #1 is the button
Seat 1: vincent329 (8525 in chips)=20
Seat 2: IknowHow2pla (8798 in chips)=20
Seat 3: @Bud_Fox0000 (10537 in chips)=20
Seat 4: mschnides (15156 in chips)=20
Seat 5: JJin91 (8694 in chips)=20
Seat 6: apoch19 (30706 in chips)=20
Seat 7: Bar.usWYGRAM (10975 in chips)=20
Seat 9: TheFah475 (8425 in chips)=20
vincent329: posts the ante 25
IknowHow2pla: posts the ante 25
@Bud_Fox0000: posts the ante 25
mschnides: posts the ante 25
JJin91: posts the ante 25
apoch19: posts the ante 25
Bar.usWYGRAM: posts the ante 25
TheFah475: posts the ante 25
IknowHow2pla: posts small blind 100
@Bud_Fox0000: posts big blind 200
*** HOLE CARDS ***
Dealt to JJin91 [Ts Jc]
mschnides: folds=20
JJin91: folds=20
apoch19: folds=20
Bar.usWYGRAM: folds=20
TheFah475: calls 200
vincent329: calls 200
IknowHow2pla: raises 200 to 400
@Bud_Fox0000: folds=20
TheFah475: folds=20
vincent329: calls 200
*** FLOP *** [Qc 4c 5s]
IknowHow2pla: bets 200
vincent329: raises 400 to 600
IknowHow2pla: calls 400
*** TURN *** [Qc 4c 5s] [Ad]
IknowHow2pla: checks=20
vincent329: checks=20
*** RIVER *** [Qc 4c 5s Ad] [Kd]
IknowHow2pla: checks=20
vincent329: checks=20
*** SHOW DOWN ***
IknowHow2pla: shows [8c 9c] (high card Ace)
vincent329: shows [8h Th] (high card Ace - King+Queen+Ten kicker)
vincent329 collected 2600 from pot
*** SUMMARY ***
Total pot 2600 | Rake 0=20
Board [Qc 4c 5s Ad Kd]
Seat 1: vincent329 (button) showed [8h Th] and won (2600) with high car=
d Ace
Seat 2: IknowHow2pla (small blind) showed [8c 9c] and lost with high ca=
rd Ace
Seat 3: @Bud_Fox0000 (big blind) folded before Flop
Seat 4: mschnides folded before Flop (didn't bet)
Seat 5: JJin91 folded before Flop (didn't bet)
Seat 6: apoch19 folded before Flop (didn't bet)
Seat 7: Bar.usWYGRAM folded before Flop (didn't bet)
Seat 9: TheFah475 folded before Flop


*********** # 71 **************
PokerStars Hand #175010008807: Tournament #1701776547, $18.20+$1.80 USD=
 Hold'em No Limit - Level VII (100/200) - 2017/09/13 20:15:53 ET
Table '1701776547 3' 9-max Seat #2 is the button
Seat 2: IknowHow2pla (7773 in chips)=20
Seat 3: @Bud_Fox0000 (10312 in chips)=20
Seat 4: mschnides (15131 in chips)=20
Seat 5: JJin91 (8669 in chips)=20
Seat 6: apoch19 (30681 in chips)=20
Seat 7: Bar.usWYGRAM (10950 in chips)=20
Seat 9: TheFah475 (8200 in chips)=20
IknowHow2pla: posts the ante 25
@Bud_Fox0000: posts the ante 25
mschnides: posts the ante 25
JJin91: posts the ante 25
apoch19: posts the ante 25
Bar.usWYGRAM: posts the ante 25
TheFah475: posts the ante 25
@Bud_Fox0000: posts small blind 100
mschnides: posts big blind 200
*** HOLE CARDS ***
Dealt to JJin91 [9d Th]
JJin91: folds=20
apoch19: folds=20
Bar.usWYGRAM: raises 300 to 500
TheFah475: folds=20
IknowHow2pla: folds=20
@Bud_Fox0000: folds=20
mschnides: folds=20
Uncalled bet (300) returned to Bar.usWYGRAM
Bar.usWYGRAM collected 675 from pot
*** SUMMARY ***
Total pot 675 | Rake 0=20
Seat 2: IknowHow2pla (button) folded before Flop (didn't bet)
Seat 3: @Bud_Fox0000 (small blind) folded before Flop
Seat 4: mschnides (big blind) folded before Flop
Seat 5: JJin91 folded before Flop (didn't bet)
Seat 6: apoch19 folded before Flop (didn't bet)
Seat 7: Bar.usWYGRAM collected (675)
Seat 9: TheFah475 folded before Flop (didn't bet)


*********** # 72 **************
PokerStars Hand #175010008961: Tournament #1701776547, $18.20+$1.80 USD=
 Hold'em No Limit - Level VIII (125/250) - 2017/09/13 20:16:31 ET
Table '1701776547 3' 9-max Seat #3 is the button
Seat 2: IknowHow2pla (7748 in chips)=20
Seat 3: @Bud_Fox0000 (10187 in chips)=20
Seat 4: mschnides (14906 in chips)=20
Seat 5: JJin91 (8644 in chips)=20
Seat 6: apoch19 (30656 in chips)=20
Seat 7: Bar.usWYGRAM (11400 in chips)=20
Seat 9: TheFah475 (8175 in chips)=20
IknowHow2pla: posts the ante 30
@Bud_Fox0000: posts the ante 30
mschnides: posts the ante 30
JJin91: posts the ante 30
apoch19: posts the ante 30
Bar.usWYGRAM: posts the ante 30
TheFah475: posts the ante 30
mschnides: posts small blind 125
JJin91: posts big blind 250
*** HOLE CARDS ***
Dealt to JJin91 [5s 9d]
apoch19: raises 310 to 560
Bar.usWYGRAM: calls 560
TheFah475: folds=20
IknowHow2pla: folds=20
@Bud_Fox0000: folds=20
mschnides: folds=20
JJin91: calls 310
*** FLOP *** [Kd 8d 4c]
JJin91: checks=20
apoch19: bets 1008
Bar.usWYGRAM: folds=20
JJin91: folds=20
Uncalled bet (1008) returned to apoch19
apoch19 collected 2015 from pot
apoch19: doesn't show hand=20
*** SUMMARY ***
Total pot 2015 | Rake 0=20
Board [Kd 8d 4c]
Seat 2: IknowHow2pla folded before Flop (didn't bet)
Seat 3: @Bud_Fox0000 (button) folded before Flop (didn't bet)
Seat 4: mschnides (small blind) folded before Flop
Seat 5: JJin91 (big blind) folded on the Flop
Seat 6: apoch19 collected (2015)
Seat 7: Bar.usWYGRAM folded on the Flop
Seat 9: TheFah475 folded before Flop (didn't bet)


*********** # 73 **************
PokerStars Hand #175010009116: Tournament #1701776547, $18.20+$1.80 USD=
 Hold'em No Limit - Level VIII (125/250) - 2017/09/13 20:17:12 ET
Table '1701776547 3' 9-max Seat #4 is the button
Seat 2: IknowHow2pla (7718 in chips)=20
Seat 3: @Bud_Fox0000 (10157 in chips)=20
Seat 4: mschnides (14751 in chips)=20
Seat 5: JJin91 (8054 in chips)=20
Seat 6: apoch19 (32081 in chips)=20
Seat 7: Bar.usWYGRAM (10810 in chips)=20
Seat 9: TheFah475 (8145 in chips)=20
IknowHow2pla: posts the ante 30
@Bud_Fox0000: posts the ante 30
mschnides: posts the ante 30
JJin91: posts the ante 30
apoch19: posts the ante 30
Bar.usWYGRAM: posts the ante 30
TheFah475: posts the ante 30
JJin91: posts small blind 125
apoch19: posts big blind 250
*** HOLE CARDS ***
Dealt to JJin91 [Jc 2s]
Bar.usWYGRAM: folds=20
TheFah475: folds=20
IknowHow2pla: calls 250
@Bud_Fox0000: folds=20
mschnides: raises 750 to 1000
JJin91: folds=20
apoch19: folds=20
IknowHow2pla: calls 750
*** FLOP *** [4h 3c 8d]
IknowHow2pla: checks=20
mschnides: bets 2000
IknowHow2pla: folds=20
Uncalled bet (2000) returned to mschnides
mschnides collected 2585 from pot
*** SUMMARY ***
Total pot 2585 | Rake 0=20
Board [4h 3c 8d]
Seat 2: IknowHow2pla folded on the Flop
Seat 3: @Bud_Fox0000 folded before Flop (didn't bet)
Seat 4: mschnides (button) collected (2585)
Seat 5: JJin91 (small blind) folded before Flop
Seat 6: apoch19 (big blind) folded before Flop
Seat 7: Bar.usWYGRAM folded before Flop (didn't bet)
Seat 9: TheFah475 folded before Flop (didn't bet)


*********** # 74 **************
PokerStars Hand #175010009293: Tournament #1701776547, $18.20+$1.80 USD=
 Hold'em No Limit - Level VIII (125/250) - 2017/09/13 20:18:02 ET
Table '1701776547 3' 9-max Seat #5 is the button
Seat 1: CerPrisingLe (34581 in chips)=20
Seat 2: IknowHow2pla (6688 in chips)=20
Seat 3: @Bud_Fox0000 (10127 in chips)=20
Seat 4: mschnides (16306 in chips)=20
Seat 5: JJin91 (7899 in chips)=20
Seat 6: apoch19 (31801 in chips)=20
Seat 7: Bar.usWYGRAM (10780 in chips)=20
Seat 9: TheFah475 (8115 in chips)=20
CerPrisingLe: posts the ante 30
IknowHow2pla: posts the ante 30
@Bud_Fox0000: posts the ante 30
mschnides: posts the ante 30
JJin91: posts the ante 30
apoch19: posts the ante 30
Bar.usWYGRAM: posts the ante 30
TheFah475: posts the ante 30
apoch19: posts small blind 125
Bar.usWYGRAM: posts big blind 250
*** HOLE CARDS ***
Dealt to JJin91 [Qs 4c]
TheFah475: calls 250
CerPrisingLe: raises 1115 to 1365
IknowHow2pla: folds=20
@Bud_Fox0000: folds=20
mschnides: raises 14911 to 16276 and is all-in
JJin91: folds=20
apoch19: folds=20
Bar.usWYGRAM: folds=20
TheFah475: folds=20
CerPrisingLe: calls 14911
*** FLOP *** [9c Jh 4s]
*** TURN *** [9c Jh 4s] [2c]
*** RIVER *** [9c Jh 4s 2c] [9h]
*** SHOW DOWN ***
CerPrisingLe: shows [Kd Ks] (two pair, Kings and Nines)
mschnides: shows [As Kh] (a pair of Nines)
CerPrisingLe collected 33417 from pot
mschnides finished the tournament in 92nd place
*** SUMMARY ***
Total pot 33417 | Rake 0=20
Board [9c Jh 4s 2c 9h]
Seat 1: CerPrisingLe showed [Kd Ks] and won (33417) with two pair, King=
s and Nines
Seat 2: IknowHow2pla folded before Flop (didn't bet)
Seat 3: @Bud_Fox0000 folded before Flop (didn't bet)
Seat 4: mschnides showed [As Kh] and lost with a pair of Nines
Seat 5: JJin91 (button) folded before Flop (didn't bet)
Seat 6: apoch19 (small blind) folded before Flop
Seat 7: Bar.usWYGRAM (big blind) folded before Flop
Seat 9: TheFah475 folded before Flop


*********** # 75 **************
PokerStars Hand #175010009472: Tournament #1701776547, $18.20+$1.80 USD=
 Hold'em No Limit - Level VIII (125/250) - 2017/09/13 20:18:54 ET
Table '1701776547 3' 9-max Seat #6 is the button
Seat 1: CerPrisingLe (51692 in chips)=20
Seat 2: IknowHow2pla (6658 in chips)=20
Seat 3: @Bud_Fox0000 (10097 in chips)=20
Seat 5: JJin91 (7869 in chips)=20
Seat 6: apoch19 (31646 in chips)=20
Seat 7: Bar.usWYGRAM (10500 in chips)=20
Seat 9: TheFah475 (7835 in chips)=20
CerPrisingLe: posts the ante 30
IknowHow2pla: posts the ante 30
@Bud_Fox0000: posts the ante 30
JJin91: posts the ante 30
apoch19: posts the ante 30
Bar.usWYGRAM: posts the ante 30
TheFah475: posts the ante 30
Bar.usWYGRAM: posts small blind 125
TheFah475: posts big blind 250
*** HOLE CARDS ***
Dealt to JJin91 [2d 5d]
CerPrisingLe: raises 500 to 750
IknowHow2pla: folds=20
@Bud_Fox0000: folds=20
JJin91: folds=20
apoch19: folds=20
Bar.usWYGRAM: calls 625
TheFah475: folds=20
*** FLOP *** [3s Jc Th]
Bar.usWYGRAM: checks=20
CerPrisingLe: checks=20
*** TURN *** [3s Jc Th] [9s]
Bar.usWYGRAM: checks=20
CerPrisingLe: bets 1000
Bar.usWYGRAM: calls 1000
*** RIVER *** [3s Jc Th 9s] [Qc]
Bar.usWYGRAM: checks=20
CerPrisingLe: bets 1980
Bar.usWYGRAM: calls 1980
*** SHOW DOWN ***
CerPrisingLe: shows [8s 5h] (a straight, Eight to Queen)
Bar.usWYGRAM: mucks hand=20
CerPrisingLe collected 7920 from pot
*** SUMMARY ***
Total pot 7920 | Rake 0=20
Board [3s Jc Th 9s Qc]
Seat 1: CerPrisingLe showed [8s 5h] and won (7920) with a straight, Eig=
ht to Queen
Seat 2: IknowHow2pla folded before Flop (didn't bet)
Seat 3: @Bud_Fox0000 folded before Flop (didn't bet)
Seat 5: JJin91 folded before Flop (didn't bet)
Seat 6: apoch19 (button) folded before Flop (didn't bet)
Seat 7: Bar.usWYGRAM (small blind) mucked [Qd 4d]
Seat 9: TheFah475 (big blind) folded before Flop


*********** # 76 **************
PokerStars Hand #175010009799: Tournament #1701776547, $18.20+$1.80 USD=
 Hold'em No Limit - Level VIII (125/250) - 2017/09/13 20:20:28 ET
Table '1701776547 3' 9-max Seat #7 is the button
Seat 1: CerPrisingLe (55852 in chips)=20
Seat 2: IknowHow2pla (6628 in chips)=20
Seat 3: @Bud_Fox0000 (10067 in chips)=20
Seat 5: JJin91 (7839 in chips)=20
Seat 6: apoch19 (31616 in chips)=20
Seat 7: Bar.usWYGRAM (6740 in chips)=20
Seat 9: TheFah475 (7555 in chips)=20
CerPrisingLe: posts the ante 30
IknowHow2pla: posts the ante 30
@Bud_Fox0000: posts the ante 30
JJin91: posts the ante 30
apoch19: posts the ante 30
Bar.usWYGRAM: posts the ante 30
TheFah475: posts the ante 30
TheFah475: posts small blind 125
CerPrisingLe: posts big blind 250
*** HOLE CARDS ***
Dealt to JJin91 [6h 7s]
Bar.usWYGRAM said, "fuck u"
IknowHow2pla: calls 250
@Bud_Fox0000: folds=20
JJin91: folds=20
apoch19: folds=20
Bar.usWYGRAM: folds=20
TheFah475: calls 125
CerPrisingLe: checks=20
*** FLOP *** [Js Kd 8h]
TheFah475: bets 250
CerPrisingLe: folds=20
IknowHow2pla: calls 250
*** TURN *** [Js Kd 8h] [5d]
TheFah475: bets 250
IknowHow2pla: calls 250
*** RIVER *** [Js Kd 8h 5d] [9s]
TheFah475: bets 250
IknowHow2pla: calls 250
*** SHOW DOWN ***
TheFah475: shows [Jh 7c] (a pair of Jacks)
IknowHow2pla: shows [Jd Qh] (a pair of Jacks - King+Queen kicker)
IknowHow2pla collected 2460 from pot
*** SUMMARY ***
Total pot 2460 | Rake 0=20
Board [Js Kd 8h 5d 9s]
Seat 1: CerPrisingLe (big blind) folded on the Flop
Seat 2: IknowHow2pla showed [Jd Qh] and won (2460) with a pair of Jacks
Seat 3: @Bud_Fox0000 folded before Flop (didn't bet)
Seat 5: JJin91 folded before Flop (didn't bet)
Seat 6: apoch19 folded before Flop (didn't bet)
Seat 7: Bar.usWYGRAM (button) folded before Flop (didn't bet)
Seat 9: TheFah475 (small blind) showed [Jh 7c] and lost with a pair of =
Jacks


*********** # 77 **************
PokerStars Hand #175010009953: Tournament #1701776547, $18.20+$1.80 USD=
 Hold'em No Limit - Level VIII (125/250) - 2017/09/13 20:21:13 ET
Table '1701776547 3' 9-max Seat #9 is the button
Seat 1: CerPrisingLe (55572 in chips)=20
Seat 2: IknowHow2pla (8058 in chips)=20
Seat 3: @Bud_Fox0000 (10037 in chips)=20
Seat 4: SwissGalileo (10000 in chips)=20
Seat 5: JJin91 (7809 in chips)=20
Seat 6: apoch19 (31586 in chips)=20
Seat 7: Bar.usWYGRAM (6710 in chips)=20
Seat 9: TheFah475 (6525 in chips)=20
CerPrisingLe: posts the ante 30
IknowHow2pla: posts the ante 30
@Bud_Fox0000: posts the ante 30
SwissGalileo: posts the ante 30
JJin91: posts the ante 30
apoch19: posts the ante 30
Bar.usWYGRAM: posts the ante 30
TheFah475: posts the ante 30
CerPrisingLe: posts small blind 125
IknowHow2pla: posts big blind 250
*** HOLE CARDS ***
Dealt to JJin91 [4h Kc]
@Bud_Fox0000: folds=20
SwissGalileo: raises 865 to 1115
JJin91: folds=20
apoch19: folds=20
Bar.usWYGRAM: folds=20
TheFah475: folds=20
CerPrisingLe: folds=20
IknowHow2pla: folds=20
Uncalled bet (865) returned to SwissGalileo
SwissGalileo collected 865 from pot
*** SUMMARY ***
Total pot 865 | Rake 0=20
Seat 1: CerPrisingLe (small blind) folded before Flop
Seat 2: IknowHow2pla (big blind) folded before Flop
Seat 3: @Bud_Fox0000 folded before Flop (didn't bet)
Seat 4: SwissGalileo collected (865)
Seat 5: JJin91 folded before Flop (didn't bet)
Seat 6: apoch19 folded before Flop (didn't bet)
Seat 7: Bar.usWYGRAM folded before Flop (didn't bet)
Seat 9: TheFah475 (button) folded before Flop (didn't bet)


*********** # 78 **************
PokerStars Hand #175010283583: Tournament #1701776547, $18.20+$1.80 USD=
 Hold'em No Limit - Level VIII (125/250) - 2017/09/13 20:21:47 ET
Table '1701776547 3' 9-max Seat #1 is the button
Seat 1: CerPrisingLe (55417 in chips)=20
Seat 2: IknowHow2pla (7778 in chips)=20
Seat 3: @Bud_Fox0000 (10007 in chips)=20
Seat 4: SwissGalileo (10585 in chips)=20
Seat 5: JJin91 (7779 in chips)=20
Seat 6: apoch19 (31556 in chips)=20
Seat 7: Bar.usWYGRAM (6680 in chips)=20
Seat 9: TheFah475 (6495 in chips)=20
CerPrisingLe: posts the ante 30
IknowHow2pla: posts the ante 30
@Bud_Fox0000: posts the ante 30
SwissGalileo: posts the ante 30
JJin91: posts the ante 30
apoch19: posts the ante 30
Bar.usWYGRAM: posts the ante 30
TheFah475: posts the ante 30
IknowHow2pla: posts small blind 125
@Bud_Fox0000: posts big blind 250
*** HOLE CARDS ***
Dealt to JJin91 [Jc Ah]
SwissGalileo: folds=20
JJin91: raises 292 to 542
apoch19: folds=20
Bar.usWYGRAM: raises 458 to 1000
TheFah475: folds=20
CerPrisingLe: folds=20
IknowHow2pla: folds=20
@Bud_Fox0000: folds=20
JJin91: calls 458
*** FLOP *** [Qd Tc 5d]
JJin91: checks=20
Bar.usWYGRAM: bets 1743
JJin91: folds=20
Uncalled bet (1743) returned to Bar.usWYGRAM
Bar.usWYGRAM collected 2615 from pot
Bar.usWYGRAM: shows [Ad As]
*** SUMMARY ***
Total pot 2615 | Rake 0=20
Board [Qd Tc 5d]
Seat 1: CerPrisingLe (button) folded before Flop (didn't bet)
Seat 2: IknowHow2pla (small blind) folded before Flop
Seat 3: @Bud_Fox0000 (big blind) folded before Flop
Seat 4: SwissGalileo folded before Flop (didn't bet)
Seat 5: JJin91 folded on the Flop
Seat 6: apoch19 folded before Flop (didn't bet)
Seat 7: Bar.usWYGRAM collected (2615)
Seat 9: TheFah475 folded before Flop (didn't bet)


*********** # 79 **************
PokerStars Hand #175010283796: Tournament #1701776547, $18.20+$1.80 USD=
 Hold'em No Limit - Level VIII (125/250) - 2017/09/13 20:22:45 ET
Table '1701776547 3' 9-max Seat #2 is the button
Seat 1: CerPrisingLe (55387 in chips)=20
Seat 2: IknowHow2pla (7623 in chips)=20
Seat 3: @Bud_Fox0000 (9727 in chips)=20
Seat 5: JJin91 (6749 in chips)=20
Seat 6: apoch19 (31526 in chips)=20
Seat 7: Bar.usWYGRAM (8265 in chips)=20
Seat 8: nickfanz27 (10000 in chips)=20
Seat 9: TheFah475 (6465 in chips)=20
CerPrisingLe: posts the ante 30
IknowHow2pla: posts the ante 30
@Bud_Fox0000: posts the ante 30
JJin91: posts the ante 30
apoch19: posts the ante 30
Bar.usWYGRAM: posts the ante 30
nickfanz27: posts the ante 30
TheFah475: posts the ante 30
@Bud_Fox0000: posts small blind 125
JJin91: posts big blind 250
*** HOLE CARDS ***
Dealt to JJin91 [2c 8d]
apoch19: folds=20
Bar.usWYGRAM: folds=20
nickfanz27: folds=20
TheFah475: calls 250
CerPrisingLe: folds=20
IknowHow2pla: raises 250 to 500
@Bud_Fox0000: calls 375
JJin91: folds=20
TheFah475: calls 250
*** FLOP *** [9h 9c Qh]
@Bud_Fox0000: checks=20
TheFah475: checks=20
IknowHow2pla: checks=20
*** TURN *** [9h 9c Qh] [Qd]
@Bud_Fox0000: bets 900
TheFah475: folds=20
IknowHow2pla: folds=20
Uncalled bet (900) returned to @Bud_Fox0000
@Bud_Fox0000 collected 1990 from pot
*** SUMMARY ***
Total pot 1990 | Rake 0=20
Board [9h 9c Qh Qd]
Seat 1: CerPrisingLe folded before Flop (didn't bet)
Seat 2: IknowHow2pla (button) folded on the Turn
Seat 3: @Bud_Fox0000 (small blind) collected (1990)
Seat 5: JJin91 (big blind) folded before Flop
Seat 6: apoch19 folded before Flop (didn't bet)
Seat 7: Bar.usWYGRAM folded before Flop (didn't bet)
Seat 8: nickfanz27 folded before Flop (didn't bet)
Seat 9: TheFah475 folded on the Turn


*********** # 80 **************
PokerStars Hand #175010284104: Tournament #1701776547, $18.20+$1.80 USD=
 Hold'em No Limit - Level VIII (125/250) - 2017/09/13 20:23:55 ET
Table '1701776547 3' 9-max Seat #3 is the button
Seat 1: CerPrisingLe (55357 in chips)=20
Seat 2: IknowHow2pla (7093 in chips)=20
Seat 3: @Bud_Fox0000 (11187 in chips)=20
Seat 5: JJin91 (6469 in chips)=20
Seat 6: apoch19 (31496 in chips)=20
Seat 7: Bar.usWYGRAM (8235 in chips)=20
Seat 8: nickfanz27 (9970 in chips)=20
Seat 9: TheFah475 (5935 in chips)=20
CerPrisingLe: posts the ante 30
IknowHow2pla: posts the ante 30
@Bud_Fox0000: posts the ante 30
JJin91: posts the ante 30
apoch19: posts the ante 30
Bar.usWYGRAM: posts the ante 30
nickfanz27: posts the ante 30
TheFah475: posts the ante 30
JJin91: posts small blind 125
apoch19: posts big blind 250
*** HOLE CARDS ***
Dealt to JJin91 [6s Ts]
Bar.usWYGRAM: folds=20
nickfanz27: raises 500 to 750
TheFah475: folds=20
CerPrisingLe: folds=20
IknowHow2pla: folds=20
@Bud_Fox0000: folds=20
JJin91: folds=20
apoch19: calls 500
*** FLOP *** [2h Js Ad]
apoch19: checks=20
nickfanz27: bets 1000
apoch19: folds=20
Uncalled bet (1000) returned to nickfanz27
nickfanz27 collected 1865 from pot
nickfanz27: doesn't show hand=20
*** SUMMARY ***
Total pot 1865 | Rake 0=20
Board [2h Js Ad]
Seat 1: CerPrisingLe folded before Flop (didn't bet)
Seat 2: IknowHow2pla folded before Flop (didn't bet)
Seat 3: @Bud_Fox0000 (button) folded before Flop (didn't bet)
Seat 5: JJin91 (small blind) folded before Flop
Seat 6: apoch19 (big blind) folded on the Flop
Seat 7: Bar.usWYGRAM folded before Flop (didn't bet)
Seat 8: nickfanz27 collected (1865)
Seat 9: TheFah475 folded before Flop (didn't bet)


*********** # 81 **************
PokerStars Hand #175010284347: Tournament #1701776547, $18.20+$1.80 USD=
 Hold'em No Limit - Level VIII (125/250) - 2017/09/13 20:24:50 ET
Table '1701776547 3' 9-max Seat #5 is the button
Seat 1: CerPrisingLe (55327 in chips)=20
Seat 2: IknowHow2pla (7063 in chips)=20
Seat 3: @Bud_Fox0000 (11157 in chips)=20
Seat 5: JJin91 (6314 in chips)=20
Seat 6: apoch19 (30716 in chips)=20
Seat 7: Bar.usWYGRAM (8205 in chips)=20
Seat 8: nickfanz27 (11055 in chips)=20
Seat 9: TheFah475 (5905 in chips)=20
CerPrisingLe: posts the ante 30
IknowHow2pla: posts the ante 30
@Bud_Fox0000: posts the ante 30
JJin91: posts the ante 30
apoch19: posts the ante 30
Bar.usWYGRAM: posts the ante 30
nickfanz27: posts the ante 30
TheFah475: posts the ante 30
apoch19: posts small blind 125
Bar.usWYGRAM: posts big blind 250
*** HOLE CARDS ***
Dealt to JJin91 [8d 5c]
nickfanz27: calls 250
TheFah475: calls 250
CerPrisingLe: raises 1365 to 1615
IknowHow2pla: folds=20
@Bud_Fox0000: folds=20
JJin91: folds=20
apoch19: folds=20
Bar.usWYGRAM: raises 6560 to 8175 and is all-in
nickfanz27: folds=20
TheFah475: folds=20
CerPrisingLe: calls 6560
*** FLOP *** [As 3d 8h]
Bar.usWYGRAM said, "10"
Bar.usWYGRAM said, "10101010"
*** TURN *** [As 3d 8h] [7c]
Bar.usWYGRAM said, "10101010100101010101010101"
*** RIVER *** [As 3d 8h 7c] [4c]
*** SHOW DOWN ***
Bar.usWYGRAM: shows [Ts Ac] (a pair of Aces)
CerPrisingLe: shows [Ks Ah] (a pair of Aces - King kicker)
CerPrisingLe collected 17215 from pot
Bar.usWYGRAM finished the tournament in 89th place
*** SUMMARY ***
Total pot 17215 | Rake 0=20
Board [As 3d 8h 7c 4c]
Seat 1: CerPrisingLe showed [Ks Ah] and won (17215) with a pair of Aces
Seat 2: IknowHow2pla folded before Flop (didn't bet)
Seat 3: @Bud_Fox0000 folded before Flop (didn't bet)
Seat 5: JJin91 (button) folded before Flop (didn't bet)
Seat 6: apoch19 (small blind) folded before Flop
Seat 7: Bar.usWYGRAM (big blind) showed [Ts Ac] and lost with a pair of=
 Aces
Seat 8: nickfanz27 folded before Flop
Seat 9: TheFah475 folded before Flop


*********** # 82 **************
PokerStars Hand #175010284614: Tournament #1701776547, $18.20+$1.80 USD=
 Hold'em No Limit - Level VIII (125/250) - 2017/09/13 20:25:45 ET
Table '1701776547 3' 9-max Seat #6 is the button
Seat 1: CerPrisingLe (64337 in chips)=20
Seat 2: IknowHow2pla (7033 in chips)=20
Seat 3: @Bud_Fox0000 (11127 in chips)=20
Seat 5: JJin91 (6284 in chips)=20
Seat 6: apoch19 (30561 in chips)=20
Seat 8: nickfanz27 (10775 in chips)=20
Seat 9: TheFah475 (5625 in chips)=20
CerPrisingLe: posts the ante 30
IknowHow2pla: posts the ante 30
@Bud_Fox0000: posts the ante 30
JJin91: posts the ante 30
apoch19: posts the ante 30
nickfanz27: posts the ante 30
TheFah475: posts the ante 30
nickfanz27: posts small blind 125
TheFah475: posts big blind 250
*** HOLE CARDS ***
Dealt to JJin91 [7d 4h]
CerPrisingLe: raises 250 to 500
IknowHow2pla: folds=20
@Bud_Fox0000: folds=20
JJin91: folds=20
apoch19: folds=20
nickfanz27: calls 375
TheFah475: folds=20
*** FLOP *** [7h 8h Jh]
nickfanz27: bets 1500
CerPrisingLe: folds=20
Uncalled bet (1500) returned to nickfanz27
nickfanz27 collected 1460 from pot
nickfanz27: doesn't show hand=20
*** SUMMARY ***
Total pot 1460 | Rake 0=20
Board [7h 8h Jh]
Seat 1: CerPrisingLe folded on the Flop
Seat 2: IknowHow2pla folded before Flop (didn't bet)
Seat 3: @Bud_Fox0000 folded before Flop (didn't bet)
Seat 5: JJin91 folded before Flop (didn't bet)
Seat 6: apoch19 (button) folded before Flop (didn't bet)
Seat 8: nickfanz27 (small blind) collected (1460)
Seat 9: TheFah475 (big blind) folded before Flop


*********** # 83 **************
PokerStars Hand #175010284761: Tournament #1701776547, $18.20+$1.80 USD=
 Hold'em No Limit - Level IX (150/300) - 2017/09/13 20:26:21 ET
Table '1701776547 3' 9-max Seat #8 is the button
Seat 1: CerPrisingLe (63807 in chips)=20
Seat 2: IknowHow2pla (7003 in chips)=20
Seat 3: @Bud_Fox0000 (11097 in chips)=20
Seat 4: zBeanHeaDz (10000 in chips)=20
Seat 5: JJin91 (6254 in chips)=20
Seat 6: apoch19 (30531 in chips)=20
Seat 8: nickfanz27 (11705 in chips)=20
Seat 9: TheFah475 (5345 in chips)=20
CerPrisingLe: posts the ante 40
IknowHow2pla: posts the ante 40
@Bud_Fox0000: posts the ante 40
zBeanHeaDz: posts the ante 40
JJin91: posts the ante 40
apoch19: posts the ante 40
nickfanz27: posts the ante 40
TheFah475: posts the ante 40
TheFah475: posts small blind 150
CerPrisingLe: posts big blind 300
*** HOLE CARDS ***
Dealt to JJin91 [9h 4d]
IknowHow2pla: calls 300
@Bud_Fox0000: calls 300
zBeanHeaDz: raises 747 to 1047
JJin91: folds=20
apoch19: folds=20
nickfanz27: folds=20
TheFah475: calls 897
CerPrisingLe: folds=20
IknowHow2pla: raises 5916 to 6963 and is all-in
@Bud_Fox0000: folds=20
zBeanHeaDz: raises 2997 to 9960 and is all-in
TheFah475: folds=20
Uncalled bet (2997) returned to zBeanHeaDz
*** FLOP *** [6d Kc 5s]
*** TURN *** [6d Kc 5s] [3d]
*** RIVER *** [6d Kc 5s 3d] [Ah]
*** SHOW DOWN ***
IknowHow2pla: shows [Th Ts] (a pair of Tens)
zBeanHeaDz: shows [Qd Ad] (a pair of Aces)
zBeanHeaDz collected 15893 from pot
IknowHow2pla finished the tournament in 86th place
*** SUMMARY ***
Total pot 15893 | Rake 0=20
Board [6d Kc 5s 3d Ah]
Seat 1: CerPrisingLe (big blind) folded before Flop
Seat 2: IknowHow2pla showed [Th Ts] and lost with a pair of Tens
Seat 3: @Bud_Fox0000 folded before Flop
Seat 4: zBeanHeaDz showed [Qd Ad] and won (15893) with a pair of Aces
Seat 5: JJin91 folded before Flop (didn't bet)
Seat 6: apoch19 folded before Flop (didn't bet)
Seat 8: nickfanz27 (button) folded before Flop (didn't bet)
Seat 9: TheFah475 (small blind) folded before Flop


*********** # 84 **************
PokerStars Hand #175010285031: Tournament #1701776547, $18.20+$1.80 USD=
 Hold'em No Limit - Level IX (150/300) - 2017/09/13 20:27:29 ET
Table '1701776547 3' 9-max Seat #9 is the button
Seat 1: CerPrisingLe (63467 in chips)=20
Seat 3: @Bud_Fox0000 (10757 in chips)=20
Seat 4: zBeanHeaDz (18890 in chips)=20
Seat 5: JJin91 (6214 in chips)=20
Seat 6: apoch19 (30491 in chips)=20
Seat 8: nickfanz27 (11665 in chips)=20
Seat 9: TheFah475 (4258 in chips)=20
CerPrisingLe: posts the ante 40
@Bud_Fox0000: posts the ante 40
zBeanHeaDz: posts the ante 40
JJin91: posts the ante 40
apoch19: posts the ante 40
nickfanz27: posts the ante 40
TheFah475: posts the ante 40
CerPrisingLe: posts small blind 150
@Bud_Fox0000: posts big blind 300
*** HOLE CARDS ***
Dealt to JJin91 [8h Kh]
zBeanHeaDz: folds=20
JJin91: folds=20
apoch19: folds=20
nickfanz27: calls 300
TheFah475: calls 300
CerPrisingLe: calls 150
@Bud_Fox0000: checks=20
*** FLOP *** [3c Qd 3d]
CerPrisingLe: checks=20
@Bud_Fox0000: checks=20
nickfanz27: bets 600
TheFah475: folds=20
CerPrisingLe: calls 600
@Bud_Fox0000: folds=20
*** TURN *** [3c Qd 3d] [2c]
CerPrisingLe: bets 1340
nickfanz27: calls 1340
*** RIVER *** [3c Qd 3d 2c] [9s]
CerPrisingLe: bets 2680
nickfanz27: calls 2680
*** SHOW DOWN ***
CerPrisingLe: shows [Qs Td] (two pair, Queens and Threes)
nickfanz27: mucks hand=20
CerPrisingLe collected 10720 from pot
*** SUMMARY ***
Total pot 10720 | Rake 0=20
Board [3c Qd 3d 2c 9s]
Seat 1: CerPrisingLe (small blind) showed [Qs Td] and won (10720) with =
two pair, Queens and Threes
Seat 3: @Bud_Fox0000 (big blind) folded on the Flop
Seat 4: zBeanHeaDz folded before Flop (didn't bet)
Seat 5: JJin91 folded before Flop (didn't bet)
Seat 6: apoch19 folded before Flop (didn't bet)
Seat 8: nickfanz27 mucked [4c 9c]
Seat 9: TheFah475 (button) folded on the Flop


*********** # 85 **************
PokerStars Hand #175010285292: Tournament #1701776547, $18.20+$1.80 USD=
 Hold'em No Limit - Level IX (150/300) - 2017/09/13 20:28:37 ET
Table '1701776547 3' 9-max Seat #1 is the button
Seat 1: CerPrisingLe (69227 in chips)=20
Seat 3: @Bud_Fox0000 (10417 in chips)=20
Seat 4: zBeanHeaDz (18850 in chips)=20
Seat 5: JJin91 (6174 in chips)=20
Seat 6: apoch19 (30451 in chips)=20
Seat 7: CaptN421 (10000 in chips)=20
Seat 8: nickfanz27 (6705 in chips)=20
Seat 9: TheFah475 (3918 in chips)=20
CerPrisingLe: posts the ante 40
@Bud_Fox0000: posts the ante 40
zBeanHeaDz: posts the ante 40
JJin91: posts the ante 40
apoch19: posts the ante 40
CaptN421: posts the ante 40
nickfanz27: posts the ante 40
TheFah475: posts the ante 40
@Bud_Fox0000: posts small blind 150
zBeanHeaDz: posts big blind 300
*** HOLE CARDS ***
Dealt to JJin91 [Kd Ad]
JJin91: raises 351 to 651
apoch19: folds=20
CaptN421: folds=20
nickfanz27: calls 651
TheFah475: folds=20
CerPrisingLe: calls 651
@Bud_Fox0000: folds=20
zBeanHeaDz: folds=20
*** FLOP *** [Jd Js Ks]
JJin91: checks=20
nickfanz27: bets 1500
CerPrisingLe: folds=20
JJin91: raises 3983 to 5483 and is all-in
nickfanz27: folds=20
Uncalled bet (3983) returned to JJin91
JJin91 collected 5723 from pot
JJin91: doesn't show hand=20
*** SUMMARY ***
Total pot 5723 | Rake 0=20
Board [Jd Js Ks]
Seat 1: CerPrisingLe (button) folded on the Flop
Seat 3: @Bud_Fox0000 (small blind) folded before Flop
Seat 4: zBeanHeaDz (big blind) folded before Flop
Seat 5: JJin91 collected (5723)
Seat 6: apoch19 folded before Flop (didn't bet)
Seat 7: CaptN421 folded before Flop (didn't bet)
Seat 8: nickfanz27 folded on the Flop
Seat 9: TheFah475 folded before Flop (didn't bet)


*********** # 86 **************
PokerStars Hand #175010285531: Tournament #1701776547, $18.20+$1.80 USD=
 Hold'em No Limit - Level IX (150/300) - 2017/09/13 20:29:42 ET
Table '1701776547 3' 9-max Seat #3 is the button
Seat 1: CerPrisingLe (68536 in chips)=20
Seat 3: @Bud_Fox0000 (10227 in chips)=20
Seat 4: zBeanHeaDz (18510 in chips)=20
Seat 5: JJin91 (9706 in chips)=20
Seat 6: apoch19 (30411 in chips)=20
Seat 7: CaptN421 (9960 in chips)=20
Seat 8: nickfanz27 (4514 in chips)=20
Seat 9: TheFah475 (3878 in chips)=20
CerPrisingLe: posts the ante 40
@Bud_Fox0000: posts the ante 40
zBeanHeaDz: posts the ante 40
JJin91: posts the ante 40
apoch19: posts the ante 40
CaptN421: posts the ante 40
nickfanz27: posts the ante 40
TheFah475: posts the ante 40
zBeanHeaDz: posts small blind 150
JJin91: posts big blind 300
*** HOLE CARDS ***
Dealt to JJin91 [9s 7d]
apoch19: folds=20
CaptN421: folds=20
nickfanz27: folds=20
TheFah475: folds=20
CerPrisingLe: raises 300 to 600
@Bud_Fox0000: folds=20
zBeanHeaDz: folds=20
JJin91: calls 300
*** FLOP *** [5c 4h 3s]
JJin91: bets 618
CerPrisingLe: folds=20
Uncalled bet (618) returned to JJin91
JJin91 collected 1670 from pot
JJin91: doesn't show hand=20
*** SUMMARY ***
Total pot 1670 | Rake 0=20
Board [5c 4h 3s]
Seat 1: CerPrisingLe folded on the Flop
Seat 3: @Bud_Fox0000 (button) folded before Flop (didn't bet)
Seat 4: zBeanHeaDz (small blind) folded before Flop
Seat 5: JJin91 (big blind) collected (1670)
Seat 6: apoch19 folded before Flop (didn't bet)
Seat 7: CaptN421 folded before Flop (didn't bet)
Seat 8: nickfanz27 folded before Flop (didn't bet)
Seat 9: TheFah475 folded before Flop (didn't bet)


*********** # 87 **************
PokerStars Hand #175010285780: Tournament #1701776547, $18.20+$1.80 USD=
 Hold'em No Limit - Level IX (150/300) - 2017/09/13 20:30:43 ET
Table '1701776547 3' 9-max Seat #4 is the button
Seat 1: CerPrisingLe (67896 in chips)=20
Seat 3: @Bud_Fox0000 (10187 in chips)=20
Seat 4: zBeanHeaDz (18320 in chips)=20
Seat 5: JJin91 (10736 in chips)=20
Seat 6: apoch19 (30371 in chips)=20
Seat 7: CaptN421 (9920 in chips)=20
Seat 8: nickfanz27 (4474 in chips)=20
Seat 9: TheFah475 (3838 in chips)=20
CerPrisingLe: posts the ante 40
@Bud_Fox0000: posts the ante 40
zBeanHeaDz: posts the ante 40
JJin91: posts the ante 40
apoch19: posts the ante 40
CaptN421: posts the ante 40
nickfanz27: posts the ante 40
TheFah475: posts the ante 40
JJin91: posts small blind 150
apoch19: posts big blind 300
*** HOLE CARDS ***
Dealt to JJin91 [4s Jh]
CaptN421: folds=20
nickfanz27: folds=20
TheFah475: folds=20
CerPrisingLe: folds=20
@Bud_Fox0000: folds=20
zBeanHeaDz: folds=20
JJin91: folds=20
Uncalled bet (150) returned to apoch19
apoch19 collected 620 from pot
apoch19: doesn't show hand=20
*** SUMMARY ***
Total pot 620 | Rake 0=20
Seat 1: CerPrisingLe folded before Flop (didn't bet)
Seat 3: @Bud_Fox0000 folded before Flop (didn't bet)
Seat 4: zBeanHeaDz (button) folded before Flop (didn't bet)
Seat 5: JJin91 (small blind) folded before Flop
Seat 6: apoch19 (big blind) collected (620)
Seat 7: CaptN421 folded before Flop (didn't bet)
Seat 8: nickfanz27 folded before Flop (didn't bet)
Seat 9: TheFah475 folded before Flop (didn't bet)


*********** # 88 **************
PokerStars Hand #175010285926: Tournament #1701776547, $18.20+$1.80 USD=
 Hold'em No Limit - Level IX (150/300) - 2017/09/13 20:31:19 ET
Table '1701776547 3' 9-max Seat #5 is the button
Seat 1: CerPrisingLe (67856 in chips)=20
Seat 3: @Bud_Fox0000 (10147 in chips)=20
Seat 4: zBeanHeaDz (18280 in chips)=20
Seat 5: JJin91 (10546 in chips)=20
Seat 6: apoch19 (30801 in chips)=20
Seat 7: CaptN421 (9880 in chips)=20
Seat 8: nickfanz27 (4434 in chips)=20
Seat 9: TheFah475 (3798 in chips)=20
CerPrisingLe: posts the ante 40
@Bud_Fox0000: posts the ante 40
zBeanHeaDz: posts the ante 40
JJin91: posts the ante 40
apoch19: posts the ante 40
CaptN421: posts the ante 40
nickfanz27: posts the ante 40
TheFah475: posts the ante 40
apoch19: posts small blind 150
CaptN421: posts big blind 300
*** HOLE CARDS ***
Dealt to JJin91 [3s 5s]
nickfanz27: calls 300
TheFah475: calls 300
CerPrisingLe: folds=20
CerPrisingLe is sitting out
@Bud_Fox0000: folds=20
zBeanHeaDz: folds=20
JJin91: folds=20
apoch19: calls 150
CaptN421: raises 900 to 1200
nickfanz27: calls 900
TheFah475: folds=20
apoch19: calls 900
*** FLOP *** [As 4h Qd]
apoch19: checks=20
CaptN421: bets 3147
nickfanz27: raises 47 to 3194 and is all-in
apoch19: folds=20
CaptN421: calls 47
*** TURN *** [As 4h Qd] [Ah]
*** RIVER *** [As 4h Qd Ah] [Kc]
CerPrisingLe has returned
*** SHOW DOWN ***
CaptN421: shows [Ts 5h] (a pair of Aces)
nickfanz27: shows [4c 6h] (two pair, Aces and Fours)
nickfanz27 collected 10608 from pot
*** SUMMARY ***
Total pot 10608 | Rake 0=20
Board [As 4h Qd Ah Kc]
Seat 1: CerPrisingLe folded before Flop (didn't bet)
Seat 3: @Bud_Fox0000 folded before Flop (didn't bet)
Seat 4: zBeanHeaDz folded before Flop (didn't bet)
Seat 5: JJin91 (button) folded before Flop (didn't bet)
Seat 6: apoch19 (small blind) folded on the Flop
Seat 7: CaptN421 (big blind) showed [Ts 5h] and lost with a pair of Aces
Seat 8: nickfanz27 showed [4c 6h] and won (10608) with two pair, Aces a=
nd Fours
Seat 9: TheFah475 folded before Flop


*********** # 89 **************
PokerStars Hand #175010286170: Tournament #1701776547, $18.20+$1.80 USD=
 Hold'em No Limit - Level IX (150/300) - 2017/09/13 20:32:25 ET
Table '1701776547 3' 9-max Seat #6 is the button
Seat 1: CerPrisingLe (67816 in chips)=20
Seat 3: @Bud_Fox0000 (10107 in chips)=20
Seat 4: zBeanHeaDz (18240 in chips)=20
Seat 5: JJin91 (10506 in chips)=20
Seat 6: apoch19 (29561 in chips)=20
Seat 7: CaptN421 (5446 in chips)=20
Seat 8: nickfanz27 (10608 in chips)=20
Seat 9: TheFah475 (3458 in chips)=20
CerPrisingLe: posts the ante 40
@Bud_Fox0000: posts the ante 40
zBeanHeaDz: posts the ante 40
JJin91: posts the ante 40
apoch19: posts the ante 40
CaptN421: posts the ante 40
nickfanz27: posts the ante 40
TheFah475: posts the ante 40
CaptN421: posts small blind 150
nickfanz27: posts big blind 300
*** HOLE CARDS ***
Dealt to JJin91 [3c Ad]
TheFah475: folds=20
CerPrisingLe: folds=20
@Bud_Fox0000: folds=20
zBeanHeaDz: folds=20
JJin91: folds=20
apoch19: folds=20
CaptN421: raises 5106 to 5406 and is all-in
nickfanz27: calls 5106
*** FLOP *** [6d 6c 3d]
*** TURN *** [6d 6c 3d] [Kh]
*** RIVER *** [6d 6c 3d Kh] [Ah]
*** SHOW DOWN ***
CaptN421: shows [Ac 7d] (two pair, Aces and Sixes)
nickfanz27: shows [Qc Jd] (a pair of Sixes)
CaptN421 collected 11132 from pot
*** SUMMARY ***
Total pot 11132 | Rake 0=20
Board [6d 6c 3d Kh Ah]
Seat 1: CerPrisingLe folded before Flop (didn't bet)
Seat 3: @Bud_Fox0000 folded before Flop (didn't bet)
Seat 4: zBeanHeaDz folded before Flop (didn't bet)
Seat 5: JJin91 folded before Flop (didn't bet)
Seat 6: apoch19 (button) folded before Flop (didn't bet)
Seat 7: CaptN421 (small blind) showed [Ac 7d] and won (11132) with two =
pair, Aces and Sixes
Seat 8: nickfanz27 (big blind) showed [Qc Jd] and lost with a pair of S=
ixes
Seat 9: TheFah475 folded before Flop (didn't bet)


*********** # 90 **************
PokerStars Hand #175010286338: Tournament #1701776547, $18.20+$1.80 USD=
 Hold'em No Limit - Level IX (150/300) - 2017/09/13 20:33:07 ET
Table '1701776547 3' 9-max Seat #7 is the button
Seat 1: CerPrisingLe (67776 in chips)=20
Seat 3: @Bud_Fox0000 (10067 in chips)=20
Seat 4: zBeanHeaDz (18200 in chips)=20
Seat 5: JJin91 (10466 in chips)=20
Seat 6: apoch19 (29521 in chips)=20
Seat 7: CaptN421 (11132 in chips)=20
Seat 8: nickfanz27 (5162 in chips)=20
Seat 9: TheFah475 (3418 in chips)=20
CerPrisingLe: posts the ante 40
@Bud_Fox0000: posts the ante 40
zBeanHeaDz: posts the ante 40
JJin91: posts the ante 40
apoch19: posts the ante 40
CaptN421: posts the ante 40
nickfanz27: posts the ante 40
TheFah475: posts the ante 40
nickfanz27: posts small blind 150
TheFah475: posts big blind 300
*** HOLE CARDS ***
Dealt to JJin91 [3s Ac]
CerPrisingLe: folds=20
@Bud_Fox0000: folds=20
zBeanHeaDz: folds=20
JJin91: folds=20
apoch19: folds=20
CaptN421: folds=20
nickfanz27: calls 150
TheFah475: checks=20
*** FLOP *** [5c As 5d]
nickfanz27: checks=20
TheFah475: checks=20
*** TURN *** [5c As 5d] [Td]
nickfanz27: bets 900
TheFah475: calls 900
*** RIVER *** [5c As 5d Td] [9h]
nickfanz27: bets 1500
TheFah475: folds=20
Uncalled bet (1500) returned to nickfanz27
nickfanz27 collected 2720 from pot
nickfanz27: doesn't show hand=20
*** SUMMARY ***
Total pot 2720 | Rake 0=20
Board [5c As 5d Td 9h]
Seat 1: CerPrisingLe folded before Flop (didn't bet)
Seat 3: @Bud_Fox0000 folded before Flop (didn't bet)
Seat 4: zBeanHeaDz folded before Flop (didn't bet)
Seat 5: JJin91 folded before Flop (didn't bet)
Seat 6: apoch19 folded before Flop (didn't bet)
Seat 7: CaptN421 (button) folded before Flop (didn't bet)
Seat 8: nickfanz27 (small blind) collected (2720)
Seat 9: TheFah475 (big blind) folded on the River


*********** # 91 **************
PokerStars Hand #175010286512: Tournament #1701776547, $18.20+$1.80 USD=
 Hold'em No Limit - Level IX (150/300) - 2017/09/13 20:33:53 ET
Table '1701776547 3' 9-max Seat #8 is the button
Seat 1: CerPrisingLe (67736 in chips)=20
Seat 2: RIVAMONSTAH (10000 in chips)=20
Seat 3: @Bud_Fox0000 (10027 in chips)=20
Seat 4: zBeanHeaDz (18160 in chips)=20
Seat 5: JJin91 (10426 in chips)=20
Seat 6: apoch19 (29481 in chips)=20
Seat 7: CaptN421 (11092 in chips)=20
Seat 8: nickfanz27 (6642 in chips)=20
Seat 9: TheFah475 (2178 in chips)=20
CerPrisingLe: posts the ante 40
RIVAMONSTAH: posts the ante 40
@Bud_Fox0000: posts the ante 40
zBeanHeaDz: posts the ante 40
JJin91: posts the ante 40
apoch19: posts the ante 40
CaptN421: posts the ante 40
nickfanz27: posts the ante 40
TheFah475: posts the ante 40
TheFah475: posts small blind 150
CerPrisingLe: posts big blind 300
*** HOLE CARDS ***
Dealt to JJin91 [Ts Kd]
RIVAMONSTAH: folds=20
@Bud_Fox0000: folds=20
zBeanHeaDz: folds=20
JJin91: folds=20
apoch19: folds=20
CaptN421: calls 300
nickfanz27: calls 300
TheFah475: calls 150
CerPrisingLe: checks=20
*** FLOP *** [3d 9h Jc]
TheFah475: checks=20
CerPrisingLe: checks=20
CaptN421: checks=20
nickfanz27: bets 1500
TheFah475: folds=20
CerPrisingLe: folds=20
CaptN421: calls 1500
*** TURN *** [3d 9h Jc] [2h]
CaptN421: checks=20
nickfanz27: bets 2400
CaptN421: calls 2400
*** RIVER *** [3d 9h Jc 2h] [4s]
CaptN421: checks=20
nickfanz27: checks=20
*** SHOW DOWN ***
CaptN421: shows [3c 4c] (two pair, Fours and Threes)
nickfanz27: mucks hand=20
CaptN421 collected 9360 from pot
*** SUMMARY ***
Total pot 9360 | Rake 0=20
Board [3d 9h Jc 2h 4s]
Seat 1: CerPrisingLe (big blind) folded on the Flop
Seat 2: RIVAMONSTAH folded before Flop (didn't bet)
Seat 3: @Bud_Fox0000 folded before Flop (didn't bet)
Seat 4: zBeanHeaDz folded before Flop (didn't bet)
Seat 5: JJin91 folded before Flop (didn't bet)
Seat 6: apoch19 folded before Flop (didn't bet)
Seat 7: CaptN421 showed [3c 4c] and won (9360) with two pair, Fours and=
 Threes
Seat 8: nickfanz27 (button) mucked [6c Js]
Seat 9: TheFah475 (small blind) folded on the Flop


*********** # 92 **************
PokerStars Hand #175010286876: Tournament #1701776547, $18.20+$1.80 USD=
 Hold'em No Limit - Level IX (150/300) - 2017/09/13 20:35:19 ET
Table '1701776547 3' 9-max Seat #9 is the button
Seat 1: CerPrisingLe (67396 in chips)=20
Seat 2: RIVAMONSTAH (9960 in chips)=20
Seat 3: @Bud_Fox0000 (9987 in chips)=20
Seat 4: zBeanHeaDz (18120 in chips)=20
Seat 5: JJin91 (10386 in chips)=20
Seat 6: apoch19 (29441 in chips)=20
Seat 7: CaptN421 (16212 in chips)=20
Seat 9: TheFah475 (1838 in chips)=20
CerPrisingLe: posts the ante 40
RIVAMONSTAH: posts the ante 40
@Bud_Fox0000: posts the ante 40
zBeanHeaDz: posts the ante 40
JJin91: posts the ante 40
apoch19: posts the ante 40
CaptN421: posts the ante 40
TheFah475: posts the ante 40
CerPrisingLe: posts small blind 150
RIVAMONSTAH: posts big blind 300
*** HOLE CARDS ***
Dealt to JJin91 [Jc 7s]
@Bud_Fox0000: folds=20
zBeanHeaDz: raises 423 to 723
JJin91: folds=20
apoch19: folds=20
CaptN421: folds=20
TheFah475: calls 723
CerPrisingLe: folds=20
RIVAMONSTAH: calls 423
*** FLOP *** [5h 7h Qd]
RIVAMONSTAH: checks=20
zBeanHeaDz: bets 1500
TheFah475: calls 1075 and is all-in
RIVAMONSTAH: folds=20
Uncalled bet (425) returned to zBeanHeaDz
*** TURN *** [5h 7h Qd] [5s]
*** RIVER *** [5h 7h Qd 5s] [2h]
*** SHOW DOWN ***
zBeanHeaDz: shows [Ac As] (two pair, Aces and Fives)
TheFah475: shows [Jh Qs] (two pair, Queens and Fives)
zBeanHeaDz collected 4789 from pot
TheFah475 finished the tournament in 81st place
*** SUMMARY ***
Total pot 4789 | Rake 0=20
Board [5h 7h Qd 5s 2h]
Seat 1: CerPrisingLe (small blind) folded before Flop
Seat 2: RIVAMONSTAH (big blind) folded on the Flop
Seat 3: @Bud_Fox0000 folded before Flop (didn't bet)
Seat 4: zBeanHeaDz showed [Ac As] and won (4789) with two pair, Aces an=
d Fives
Seat 5: JJin91 folded before Flop (didn't bet)
Seat 6: apoch19 folded before Flop (didn't bet)
Seat 7: CaptN421 folded before Flop (didn't bet)
Seat 9: TheFah475 (button) showed [Jh Qs] and lost with two pair, Queen=
s and Fives


*********** # 93 **************
PokerStars Hand #175010287063: Tournament #1701776547, $18.20+$1.80 USD=
 Hold'em No Limit - Level IX (150/300) - 2017/09/13 20:36:09 ET
Table '1701776547 3' 9-max Seat #1 is the button
Seat 1: CerPrisingLe (67206 in chips)=20
Seat 2: RIVAMONSTAH (9197 in chips)=20
Seat 3: @Bud_Fox0000 (9947 in chips)=20
Seat 4: zBeanHeaDz (21071 in chips)=20
Seat 5: JJin91 (10346 in chips)=20
Seat 6: apoch19 (29401 in chips)=20
Seat 7: CaptN421 (16172 in chips)=20
CerPrisingLe: posts the ante 40
RIVAMONSTAH: posts the ante 40
@Bud_Fox0000: posts the ante 40
zBeanHeaDz: posts the ante 40
JJin91: posts the ante 40
apoch19: posts the ante 40
CaptN421: posts the ante 40
RIVAMONSTAH: posts small blind 150
@Bud_Fox0000: posts big blind 300
*** HOLE CARDS ***
Dealt to JJin91 [9h 7d]
zBeanHeaDz: folds=20
JJin91: folds=20
apoch19: folds=20
CaptN421: folds=20
CerPrisingLe: raises 300 to 600
RIVAMONSTAH: folds=20
@Bud_Fox0000: folds=20
Uncalled bet (300) returned to CerPrisingLe
CerPrisingLe collected 1030 from pot
CerPrisingLe: doesn't show hand=20
*** SUMMARY ***
Total pot 1030 | Rake 0=20
Seat 1: CerPrisingLe (button) collected (1030)
Seat 2: RIVAMONSTAH (small blind) folded before Flop
Seat 3: @Bud_Fox0000 (big blind) folded before Flop
Seat 4: zBeanHeaDz folded before Flop (didn't bet)
Seat 5: JJin91 folded before Flop (didn't bet)
Seat 6: apoch19 folded before Flop (didn't bet)
Seat 7: CaptN421 folded before Flop (didn't bet)


*********** # 94 **************
PokerStars Hand #175010287192: Tournament #1701776547, $18.20+$1.80 USD=
 Hold'em No Limit - Level X (200/400) - 2017/09/13 20:36:42 ET
Table '1701776547 3' 9-max Seat #2 is the button
Seat 1: CerPrisingLe (67896 in chips)=20
Seat 2: RIVAMONSTAH (9007 in chips)=20
Seat 3: @Bud_Fox0000 (9607 in chips)=20
Seat 4: zBeanHeaDz (21031 in chips)=20
Seat 5: JJin91 (10306 in chips)=20
Seat 6: apoch19 (29361 in chips)=20
Seat 7: CaptN421 (16132 in chips)=20
Seat 8: malcolmmalco (10000 in chips)=20
CerPrisingLe: posts the ante 50
RIVAMONSTAH: posts the ante 50
@Bud_Fox0000: posts the ante 50
zBeanHeaDz: posts the ante 50
JJin91: posts the ante 50
apoch19: posts the ante 50
CaptN421: posts the ante 50
malcolmmalco: posts the ante 50
@Bud_Fox0000: posts small blind 200
zBeanHeaDz: posts big blind 400
*** HOLE CARDS ***
Dealt to JJin91 [6d Kh]
JJin91: folds=20
apoch19: folds=20
CaptN421: folds=20
malcolmmalco: folds=20
CerPrisingLe: folds=20
RIVAMONSTAH: folds=20
@Bud_Fox0000: calls 200
zBeanHeaDz: checks=20
*** FLOP *** [5h 4d 8d]
@Bud_Fox0000: checks=20
zBeanHeaDz: checks=20
*** TURN *** [5h 4d 8d] [Jd]
@Bud_Fox0000: bets 500
zBeanHeaDz: calls 500
*** RIVER *** [5h 4d 8d Jd] [Th]
@Bud_Fox0000: checks=20
zBeanHeaDz: checks=20
*** SHOW DOWN ***
@Bud_Fox0000: shows [7d 3c] (high card Jack)
zBeanHeaDz: shows [6h Jh] (a pair of Jacks)
zBeanHeaDz collected 2200 from pot
*** SUMMARY ***
Total pot 2200 | Rake 0=20
Board [5h 4d 8d Jd Th]
Seat 1: CerPrisingLe folded before Flop (didn't bet)
Seat 2: RIVAMONSTAH (button) folded before Flop (didn't bet)
Seat 3: @Bud_Fox0000 (small blind) showed [7d 3c] and lost with high ca=
rd Jack
Seat 4: zBeanHeaDz (big blind) showed [6h Jh] and won (2200) with a pai=
r of Jacks
Seat 5: JJin91 folded before Flop (didn't bet)
Seat 6: apoch19 folded before Flop (didn't bet)
Seat 7: CaptN421 folded before Flop (didn't bet)
Seat 8: malcolmmalco folded before Flop (didn't bet)


*********** # 95 **************
PokerStars Hand #175010287371: Tournament #1701776547, $18.20+$1.80 USD=
 Hold'em No Limit - Level X (200/400) - 2017/09/13 20:37:25 ET
Table '1701776547 3' 9-max Seat #3 is the button
Seat 1: CerPrisingLe (67846 in chips)=20
Seat 2: RIVAMONSTAH (8957 in chips)=20
Seat 3: @Bud_Fox0000 (8657 in chips)=20
Seat 4: zBeanHeaDz (22281 in chips)=20
Seat 5: JJin91 (10256 in chips)=20
Seat 6: apoch19 (29311 in chips)=20
Seat 7: CaptN421 (16082 in chips)=20
Seat 8: malcolmmalco (9950 in chips)=20
CerPrisingLe: posts the ante 50
RIVAMONSTAH: posts the ante 50
@Bud_Fox0000: posts the ante 50
zBeanHeaDz: posts the ante 50
JJin91: posts the ante 50
apoch19: posts the ante 50
CaptN421: posts the ante 50
malcolmmalco: posts the ante 50
zBeanHeaDz: posts small blind 200
JJin91: posts big blind 400
*** HOLE CARDS ***
Dealt to JJin91 [7s 6h]
apoch19: folds=20
CaptN421: folds=20
malcolmmalco: folds=20
CerPrisingLe: folds=20
RIVAMONSTAH: folds=20
@Bud_Fox0000: folds=20
zBeanHeaDz: folds=20
Uncalled bet (200) returned to JJin91
JJin91 collected 800 from pot
JJin91: doesn't show hand=20
*** SUMMARY ***
Total pot 800 | Rake 0=20
Seat 1: CerPrisingLe folded before Flop (didn't bet)
Seat 2: RIVAMONSTAH folded before Flop (didn't bet)
Seat 3: @Bud_Fox0000 (button) folded before Flop (didn't bet)
Seat 4: zBeanHeaDz (small blind) folded before Flop
Seat 5: JJin91 (big blind) collected (800)
Seat 6: apoch19 folded before Flop (didn't bet)
Seat 7: CaptN421 folded before Flop (didn't bet)
Seat 8: malcolmmalco folded before Flop (didn't bet)


*********** # 96 **************
PokerStars Hand #175010287474: Tournament #1701776547, $18.20+$1.80 USD=
 Hold'em No Limit - Level X (200/400) - 2017/09/13 20:37:51 ET
Table '1701776547 3' 9-max Seat #4 is the button
Seat 1: CerPrisingLe (67796 in chips)=20
Seat 2: RIVAMONSTAH (8907 in chips)=20
Seat 3: @Bud_Fox0000 (8607 in chips)=20
Seat 4: zBeanHeaDz (22031 in chips)=20
Seat 5: JJin91 (10806 in chips)=20
Seat 6: apoch19 (29261 in chips)=20
Seat 7: CaptN421 (16032 in chips)=20
Seat 8: malcolmmalco (9900 in chips)=20
CerPrisingLe: posts the ante 50
RIVAMONSTAH: posts the ante 50
@Bud_Fox0000: posts the ante 50
zBeanHeaDz: posts the ante 50
JJin91: posts the ante 50
apoch19: posts the ante 50
CaptN421: posts the ante 50
malcolmmalco: posts the ante 50
JJin91: posts small blind 200
apoch19: posts big blind 400
*** HOLE CARDS ***
Dealt to JJin91 [6c Th]
CaptN421: folds=20
malcolmmalco: folds=20
CerPrisingLe: folds=20
RIVAMONSTAH: folds=20
@Bud_Fox0000: folds=20
zBeanHeaDz: folds=20
JJin91: folds=20
Uncalled bet (200) returned to apoch19
apoch19 collected 800 from pot
apoch19: doesn't show hand=20
*** SUMMARY ***
Total pot 800 | Rake 0=20
Seat 1: CerPrisingLe folded before Flop (didn't bet)
Seat 2: RIVAMONSTAH folded before Flop (didn't bet)
Seat 3: @Bud_Fox0000 folded before Flop (didn't bet)
Seat 4: zBeanHeaDz (button) folded before Flop (didn't bet)
Seat 5: JJin91 (small blind) folded before Flop
Seat 6: apoch19 (big blind) collected (800)
Seat 7: CaptN421 folded before Flop (didn't bet)
Seat 8: malcolmmalco folded before Flop (didn't bet)


*********** # 97 **************
PokerStars Hand #175010287662: Tournament #1701776547, $18.20+$1.80 USD=
 Hold'em No Limit - Level X (200/400) - 2017/09/13 20:38:40 ET
Table '1701776547 3' 9-max Seat #5 is the button
Seat 1: CerPrisingLe (67746 in chips)=20
Seat 2: RIVAMONSTAH (8857 in chips)=20
Seat 3: @Bud_Fox0000 (8557 in chips)=20
Seat 4: zBeanHeaDz (21981 in chips)=20
Seat 5: JJin91 (10556 in chips)=20
Seat 6: apoch19 (29811 in chips)=20
Seat 7: CaptN421 (15982 in chips)=20
Seat 8: malcolmmalco (9850 in chips)=20
CerPrisingLe: posts the ante 50
RIVAMONSTAH: posts the ante 50
@Bud_Fox0000: posts the ante 50
zBeanHeaDz: posts the ante 50
JJin91: posts the ante 50
apoch19: posts the ante 50
CaptN421: posts the ante 50
malcolmmalco: posts the ante 50
apoch19: posts small blind 200
CaptN421: posts big blind 400
*** HOLE CARDS ***
Dealt to JJin91 [7h 5s]
malcolmmalco: folds=20
CerPrisingLe: folds=20
RIVAMONSTAH: raises 1400 to 1800
@Bud_Fox0000: folds=20
zBeanHeaDz: folds=20
JJin91: folds=20
apoch19: folds=20
CaptN421: folds=20
Uncalled bet (1400) returned to RIVAMONSTAH
RIVAMONSTAH collected 1400 from pot
RIVAMONSTAH: doesn't show hand=20
*** SUMMARY ***
Total pot 1400 | Rake 0=20
Seat 1: CerPrisingLe folded before Flop (didn't bet)
Seat 2: RIVAMONSTAH collected (1400)
Seat 3: @Bud_Fox0000 folded before Flop (didn't bet)
Seat 4: zBeanHeaDz folded before Flop (didn't bet)
Seat 5: JJin91 (button) folded before Flop (didn't bet)
Seat 6: apoch19 (small blind) folded before Flop
Seat 7: CaptN421 (big blind) folded before Flop
Seat 8: malcolmmalco folded before Flop (didn't bet)


*********** # 98 **************
PokerStars Hand #175010287777: Tournament #1701776547, $18.20+$1.80 USD=
 Hold'em No Limit - Level X (200/400) - 2017/09/13 20:39:10 ET
Table '1701776547 3' 9-max Seat #6 is the button
Seat 1: CerPrisingLe (67696 in chips)=20
Seat 2: RIVAMONSTAH (9807 in chips)=20
Seat 3: @Bud_Fox0000 (8507 in chips)=20
Seat 4: zBeanHeaDz (21931 in chips)=20
Seat 5: JJin91 (10506 in chips)=20
Seat 6: apoch19 (29561 in chips)=20
Seat 7: CaptN421 (15532 in chips)=20
Seat 8: malcolmmalco (9800 in chips)=20
CerPrisingLe: posts the ante 50
RIVAMONSTAH: posts the ante 50
@Bud_Fox0000: posts the ante 50
zBeanHeaDz: posts the ante 50
JJin91: posts the ante 50
apoch19: posts the ante 50
CaptN421: posts the ante 50
malcolmmalco: posts the ante 50
CaptN421: posts small blind 200
malcolmmalco: posts big blind 400
*** HOLE CARDS ***
Dealt to JJin91 [Jh 8c]
CerPrisingLe: raises 1400 to 1800
RIVAMONSTAH: folds=20
@Bud_Fox0000: folds=20
zBeanHeaDz: folds=20
JJin91: folds=20
apoch19: folds=20
CaptN421: folds=20
malcolmmalco: folds=20
Uncalled bet (1400) returned to CerPrisingLe
CerPrisingLe collected 1400 from pot
CerPrisingLe: doesn't show hand=20
*** SUMMARY ***
Total pot 1400 | Rake 0=20
Seat 1: CerPrisingLe collected (1400)
Seat 2: RIVAMONSTAH folded before Flop (didn't bet)
Seat 3: @Bud_Fox0000 folded before Flop (didn't bet)
Seat 4: zBeanHeaDz folded before Flop (didn't bet)
Seat 5: JJin91 folded before Flop (didn't bet)
Seat 6: apoch19 (button) folded before Flop (didn't bet)
Seat 7: CaptN421 (small blind) folded before Flop
Seat 8: malcolmmalco (big blind) folded before Flop


*********** # 99 **************
PokerStars Hand #175010287903: Tournament #1701776547, $18.20+$1.80 USD=
 Hold'em No Limit - Level X (200/400) - 2017/09/13 20:39:43 ET
Table '1701776547 3' 9-max Seat #7 is the button
Seat 1: CerPrisingLe (68646 in chips)=20
Seat 2: RIVAMONSTAH (9757 in chips)=20
Seat 3: @Bud_Fox0000 (8457 in chips)=20
Seat 4: zBeanHeaDz (21881 in chips)=20
Seat 5: JJin91 (10456 in chips)=20
Seat 6: apoch19 (29511 in chips)=20
Seat 7: CaptN421 (15282 in chips)=20
Seat 8: malcolmmalco (9350 in chips)=20
CerPrisingLe: posts the ante 50
RIVAMONSTAH: posts the ante 50
@Bud_Fox0000: posts the ante 50
zBeanHeaDz: posts the ante 50
JJin91: posts the ante 50
apoch19: posts the ante 50
CaptN421: posts the ante 50
malcolmmalco: posts the ante 50
malcolmmalco: posts small blind 200
CerPrisingLe: posts big blind 400
*** HOLE CARDS ***
Dealt to JJin91 [Qc Td]
RIVAMONSTAH: folds=20
@Bud_Fox0000: folds=20
zBeanHeaDz: folds=20
JJin91: folds=20
apoch19: folds=20
CaptN421: folds=20
malcolmmalco: raises 800 to 1200
CerPrisingLe: folds=20
Uncalled bet (800) returned to malcolmmalco
malcolmmalco collected 1200 from pot
malcolmmalco: doesn't show hand=20
*** SUMMARY ***
Total pot 1200 | Rake 0=20
Seat 1: CerPrisingLe (big blind) folded before Flop
Seat 2: RIVAMONSTAH folded before Flop (didn't bet)
Seat 3: @Bud_Fox0000 folded before Flop (didn't bet)
Seat 4: zBeanHeaDz folded before Flop (didn't bet)
Seat 5: JJin91 folded before Flop (didn't bet)
Seat 6: apoch19 folded before Flop (didn't bet)
Seat 7: CaptN421 (button) folded before Flop (didn't bet)
Seat 8: malcolmmalco (small blind) collected (1200)


*********** # 100 **************
PokerStars Hand #175010288010: Tournament #1701776547, $18.20+$1.80 USD=
 Hold'em No Limit - Level X (200/400) - 2017/09/13 20:40:11 ET
Table '1701776547 3' 9-max Seat #8 is the button
Seat 1: CerPrisingLe (68196 in chips)=20
Seat 2: RIVAMONSTAH (9707 in chips)=20
Seat 3: @Bud_Fox0000 (8407 in chips)=20
Seat 4: zBeanHeaDz (21831 in chips)=20
Seat 5: JJin91 (10406 in chips)=20
Seat 6: apoch19 (29461 in chips)=20
Seat 7: CaptN421 (15232 in chips)=20
Seat 8: malcolmmalco (10100 in chips)=20
CerPrisingLe: posts the ante 50
RIVAMONSTAH: posts the ante 50
@Bud_Fox0000: posts the ante 50
zBeanHeaDz: posts the ante 50
JJin91: posts the ante 50
apoch19: posts the ante 50
CaptN421: posts the ante 50
malcolmmalco: posts the ante 50
CerPrisingLe: posts small blind 200
RIVAMONSTAH: posts big blind 400
*** HOLE CARDS ***
Dealt to JJin91 [4s 6d]
@Bud_Fox0000: folds=20
zBeanHeaDz: raises 448 to 848
JJin91: folds=20
apoch19: folds=20
CaptN421: folds=20
malcolmmalco: folds=20
CerPrisingLe: calls 648
RIVAMONSTAH: calls 448
*** FLOP *** [5s 3h 9c]
CerPrisingLe: checks=20
RIVAMONSTAH: checks=20
zBeanHeaDz: bets 1119
CerPrisingLe: calls 1119
RIVAMONSTAH: calls 1119
*** TURN *** [5s 3h 9c] [Kh]
CerPrisingLe: checks=20
RIVAMONSTAH: checks=20
zBeanHeaDz: checks=20
*** RIVER *** [5s 3h 9c Kh] [8s]
CerPrisingLe: bets 4726
RIVAMONSTAH: calls 4726
zBeanHeaDz: folds=20
*** SHOW DOWN ***
CerPrisingLe: shows [8d 5d] (two pair, Eights and Fives)
RIVAMONSTAH: mucks hand=20
CerPrisingLe collected 15753 from pot
*** SUMMARY ***
Total pot 15753 | Rake 0=20
Board [5s 3h 9c Kh 8s]
Seat 1: CerPrisingLe (small blind) showed [8d 5d] and won (15753) with =
two pair, Eights and Fives
Seat 2: RIVAMONSTAH (big blind) mucked [7d 8c]
Seat 3: @Bud_Fox0000 folded before Flop (didn't bet)
Seat 4: zBeanHeaDz folded on the River
Seat 5: JJin91 folded before Flop (didn't bet)
Seat 6: apoch19 folded before Flop (didn't bet)
Seat 7: CaptN421 folded before Flop (didn't bet)
Seat 8: malcolmmalco (button) folded before Flop (didn't bet)


*********** # 101 **************
PokerStars Hand #175010288252: Tournament #1701776547, $18.20+$1.80 USD=
 Hold'em No Limit - Level X (200/400) - 2017/09/13 20:41:10 ET
Table '1701776547 3' 9-max Seat #1 is the button
Seat 1: CerPrisingLe (77206 in chips)=20
Seat 2: RIVAMONSTAH (2964 in chips)=20
Seat 3: @Bud_Fox0000 (8357 in chips)=20
Seat 4: zBeanHeaDz (19814 in chips)=20
Seat 5: JJin91 (10356 in chips)=20
Seat 6: apoch19 (29411 in chips)=20
Seat 7: CaptN421 (15182 in chips)=20
Seat 8: malcolmmalco (10050 in chips)=20
CerPrisingLe: posts the ante 50
RIVAMONSTAH: posts the ante 50
@Bud_Fox0000: posts the ante 50
zBeanHeaDz: posts the ante 50
JJin91: posts the ante 50
apoch19: posts the ante 50
CaptN421: posts the ante 50
malcolmmalco: posts the ante 50
RIVAMONSTAH: posts small blind 200
@Bud_Fox0000: posts big blind 400
*** HOLE CARDS ***
Dealt to JJin91 [Qd 8s]
zBeanHeaDz: folds=20
JJin91: folds=20
apoch19: folds=20
CaptN421: folds=20
malcolmmalco: folds=20
CerPrisingLe: raises 400 to 800
RIVAMONSTAH: raises 2114 to 2914 and is all-in
@Bud_Fox0000: folds=20
CerPrisingLe: calls 2114
*** FLOP *** [9s 6s 6h]
*** TURN *** [9s 6s 6h] [Ts]
*** RIVER *** [9s 6s 6h Ts] [8d]
*** SHOW DOWN ***
RIVAMONSTAH: shows [Jd 2c] (a pair of Sixes)
CerPrisingLe: shows [Qc 4c] (a pair of Sixes - Queen kicker)
CerPrisingLe collected 6628 from pot
RIVAMONSTAH finished the tournament in 76th place
*** SUMMARY ***
Total pot 6628 | Rake 0=20
Board [9s 6s 6h Ts 8d]
Seat 1: CerPrisingLe (button) showed [Qc 4c] and won (6628) with a pair=
 of Sixes
Seat 2: RIVAMONSTAH (small blind) showed [Jd 2c] and lost with a pair o=
f Sixes
Seat 3: @Bud_Fox0000 (big blind) folded before Flop
Seat 4: zBeanHeaDz folded before Flop (didn't bet)
Seat 5: JJin91 folded before Flop (didn't bet)
Seat 6: apoch19 folded before Flop (didn't bet)
Seat 7: CaptN421 folded before Flop (didn't bet)
Seat 8: malcolmmalco folded before Flop (didn't bet)


*********** # 102 **************
PokerStars Hand #175010288439: Tournament #1701776547, $18.20+$1.80 USD=
 Hold'em No Limit - Level X (200/400) - 2017/09/13 20:42:01 ET
Table '1701776547 3' 9-max Seat #3 is the button
Seat 1: CerPrisingLe (80870 in chips)=20
Seat 3: @Bud_Fox0000 (7907 in chips)=20
Seat 4: zBeanHeaDz (19764 in chips)=20
Seat 5: JJin91 (10306 in chips)=20
Seat 6: apoch19 (29361 in chips)=20
Seat 7: CaptN421 (15132 in chips)=20
Seat 8: malcolmmalco (10000 in chips)=20
CerPrisingLe: posts the ante 50
@Bud_Fox0000: posts the ante 50
zBeanHeaDz: posts the ante 50
JJin91: posts the ante 50
apoch19: posts the ante 50
CaptN421: posts the ante 50
malcolmmalco: posts the ante 50
zBeanHeaDz: posts small blind 200
JJin91: posts big blind 400
*** HOLE CARDS ***
Dealt to JJin91 [9h Qd]
apoch19: folds=20
CaptN421: folds=20
malcolmmalco: calls 400
CerPrisingLe: raises 400 to 800
@Bud_Fox0000: folds=20
zBeanHeaDz: folds=20
JJin91: raises 9456 to 10256 and is all-in
malcolmmalco: folds=20
CerPrisingLe: folds=20
Uncalled bet (9456) returned to JJin91
JJin91 collected 2550 from pot
JJin91: doesn't show hand=20
*** SUMMARY ***
Total pot 2550 | Rake 0=20
Seat 1: CerPrisingLe folded before Flop
Seat 3: @Bud_Fox0000 (button) folded before Flop (didn't bet)
Seat 4: zBeanHeaDz (small blind) folded before Flop
Seat 5: JJin91 (big blind) collected (2550)
Seat 6: apoch19 folded before Flop (didn't bet)
Seat 7: CaptN421 folded before Flop (didn't bet)
Seat 8: malcolmmalco folded before Flop


*********** # 103 **************
PokerStars Hand #175010288572: Tournament #1701776547, $18.20+$1.80 USD=
 Hold'em No Limit - Level X (200/400) - 2017/09/13 20:42:33 ET
Table '1701776547 3' 9-max Seat #4 is the button
Seat 1: CerPrisingLe (80020 in chips)=20
Seat 3: @Bud_Fox0000 (7857 in chips)=20
Seat 4: zBeanHeaDz (19514 in chips)=20
Seat 5: JJin91 (12006 in chips)=20
Seat 6: apoch19 (29311 in chips)=20
Seat 7: CaptN421 (15082 in chips)=20
Seat 8: malcolmmalco (9550 in chips)=20
CerPrisingLe: posts the ante 50
@Bud_Fox0000: posts the ante 50
zBeanHeaDz: posts the ante 50
JJin91: posts the ante 50
apoch19: posts the ante 50
CaptN421: posts the ante 50
malcolmmalco: posts the ante 50
JJin91: posts small blind 200
apoch19: posts big blind 400
*** HOLE CARDS ***
Dealt to JJin91 [Ah Qh]
CaptN421: calls 400
malcolmmalco: calls 400
CerPrisingLe: folds=20
@Bud_Fox0000: folds=20
zBeanHeaDz: folds=20
JJin91: raises 11556 to 11956 and is all-in
apoch19: folds=20
CaptN421: folds=20
malcolmmalco: calls 9100 and is all-in
Uncalled bet (2456) returned to JJin91
*** FLOP *** [Qd 6s 6h]
*** TURN *** [Qd 6s 6h] [4c]
*** RIVER *** [Qd 6s 6h 4c] [Qs]
*** SHOW DOWN ***
JJin91: shows [Ah Qh] (a full house, Queens full of Sixes)
malcolmmalco: shows [3s 3d] (two pair, Queens and Sixes)
JJin91 collected 20150 from pot
malcolmmalco finished the tournament in 74th place
*** SUMMARY ***
Total pot 20150 | Rake 0=20
Board [Qd 6s 6h 4c Qs]
Seat 1: CerPrisingLe folded before Flop (didn't bet)
Seat 3: @Bud_Fox0000 folded before Flop (didn't bet)
Seat 4: zBeanHeaDz (button) folded before Flop (didn't bet)
Seat 5: JJin91 (small blind) showed [Ah Qh] and won (20150) with a full=
 house, Queens full of Sixes
Seat 6: apoch19 (big blind) folded before Flop
Seat 7: CaptN421 folded before Flop
Seat 8: malcolmmalco showed [3s 3d] and lost with two pair, Queens and =
Sixes


*********** # 104 **************
PokerStars Hand #175010288743: Tournament #1701776547, $18.20+$1.80 USD=
 Hold'em No Limit - Level X (200/400) - 2017/09/13 20:43:20 ET
Table '1701776547 3' 9-max Seat #5 is the button
Seat 1: CerPrisingLe (79970 in chips)=20
Seat 3: @Bud_Fox0000 (7807 in chips)=20
Seat 4: zBeanHeaDz (19464 in chips)=20
Seat 5: JJin91 (22606 in chips)=20
Seat 6: apoch19 (28861 in chips)=20
Seat 7: CaptN421 (14632 in chips)=20
CerPrisingLe: posts the ante 50
@Bud_Fox0000: posts the ante 50
zBeanHeaDz: posts the ante 50
JJin91: posts the ante 50
apoch19: posts the ante 50
CaptN421: posts the ante 50
apoch19: posts small blind 200
CaptN421: posts big blind 400
*** HOLE CARDS ***
Dealt to JJin91 [9c 4c]
CerPrisingLe: raises 1300 to 1700
@Bud_Fox0000: folds=20
zBeanHeaDz: folds=20
JJin91: folds=20
apoch19: folds=20
CaptN421: raises 12882 to 14582 and is all-in
CerPrisingLe: calls 12882
*** FLOP *** [5c Qc 8s]
*** TURN *** [5c Qc 8s] [As]
*** RIVER *** [5c Qc 8s As] [9s]
*** SHOW DOWN ***
CaptN421: shows [Ad Kc] (a pair of Aces)
CerPrisingLe: shows [Tc Th] (a pair of Tens)
CaptN421 collected 29664 from pot
*** SUMMARY ***
Total pot 29664 | Rake 0=20
Board [5c Qc 8s As 9s]
Seat 1: CerPrisingLe showed [Tc Th] and lost with a pair of Tens
Seat 3: @Bud_Fox0000 folded before Flop (didn't bet)
Seat 4: zBeanHeaDz folded before Flop (didn't bet)
Seat 5: JJin91 (button) folded before Flop (didn't bet)
Seat 6: apoch19 (small blind) folded before Flop
Seat 7: CaptN421 (big blind) showed [Ad Kc] and won (29664) with a pair=
 of Aces


*********** # 105 **************
PokerStars Hand #175010288881: Tournament #1701776547, $18.20+$1.80 USD=
 Hold'em No Limit - Level X (200/400) - 2017/09/13 20:43:53 ET
Table '1701776547 3' 9-max Seat #6 is the button
Seat 1: CerPrisingLe (65338 in chips)=20
Seat 3: @Bud_Fox0000 (7757 in chips)=20
Seat 4: zBeanHeaDz (19414 in chips)=20
Seat 5: JJin91 (22556 in chips)=20
Seat 6: apoch19 (28611 in chips)=20
Seat 7: CaptN421 (29664 in chips)=20
Seat 8: Dominator863 (12070 in chips)=20
CerPrisingLe: posts the ante 50
@Bud_Fox0000: posts the ante 50
zBeanHeaDz: posts the ante 50
JJin91: posts the ante 50
apoch19: posts the ante 50
CaptN421: posts the ante 50
Dominator863: posts the ante 50
CaptN421: posts small blind 200
Dominator863: posts big blind 400
*** HOLE CARDS ***
Dealt to JJin91 [Qd 9c]
CerPrisingLe: folds=20
@Bud_Fox0000: folds=20
zBeanHeaDz: raises 564 to 964
JJin91: folds=20
apoch19: folds=20
CaptN421: folds=20
Dominator863: folds=20
Uncalled bet (564) returned to zBeanHeaDz
zBeanHeaDz collected 1350 from pot
zBeanHeaDz: doesn't show hand=20
*** SUMMARY ***
Total pot 1350 | Rake 0=20
Seat 1: CerPrisingLe folded before Flop (didn't bet)
Seat 3: @Bud_Fox0000 folded before Flop (didn't bet)
Seat 4: zBeanHeaDz collected (1350)
Seat 5: JJin91 folded before Flop (didn't bet)
Seat 6: apoch19 (button) folded before Flop (didn't bet)
Seat 7: CaptN421 (small blind) folded before Flop
Seat 8: Dominator863 (big blind) folded before Flop


*********** # 106 **************
PokerStars Hand #175010288966: Tournament #1701776547, $18.20+$1.80 USD=
 Hold'em No Limit - Level X (200/400) - 2017/09/13 20:44:11 ET
Table '1701776547 3' 9-max Seat #7 is the button
Seat 1: CerPrisingLe (65288 in chips)=20
Seat 3: @Bud_Fox0000 (7707 in chips)=20
Seat 4: zBeanHeaDz (20314 in chips)=20
Seat 5: JJin91 (22506 in chips)=20
Seat 6: apoch19 (28561 in chips)=20
Seat 7: CaptN421 (29414 in chips)=20
Seat 8: Dominator863 (11620 in chips)=20
CerPrisingLe: posts the ante 50
@Bud_Fox0000: posts the ante 50
zBeanHeaDz: posts the ante 50
JJin91: posts the ante 50
apoch19: posts the ante 50
CaptN421: posts the ante 50
Dominator863: posts the ante 50
Dominator863: posts small blind 200
CerPrisingLe: posts big blind 400
*** HOLE CARDS ***
Dealt to JJin91 [7d 6c]
@Bud_Fox0000: folds=20
zBeanHeaDz: folds=20
JJin91: folds=20
apoch19: folds=20
CaptN421: raises 1200 to 1600
Dominator863: folds=20
CerPrisingLe: calls 1200
*** FLOP *** [4s 9d Jh]
CerPrisingLe: checks=20
CaptN421: bets 2247
CerPrisingLe: folds=20
Uncalled bet (2247) returned to CaptN421
CaptN421 collected 3750 from pot
*** SUMMARY ***
Total pot 3750 | Rake 0=20
Board [4s 9d Jh]
Seat 1: CerPrisingLe (big blind) folded on the Flop
Seat 3: @Bud_Fox0000 folded before Flop (didn't bet)
Seat 4: zBeanHeaDz folded before Flop (didn't bet)
Seat 5: JJin91 folded before Flop (didn't bet)
Seat 6: apoch19 folded before Flop (didn't bet)
Seat 7: CaptN421 (button) collected (3750)
Seat 8: Dominator863 (small blind) folded before Flop


*********** # 107 **************
PokerStars Hand #175010289130: Tournament #1701776547, $18.20+$1.80 USD=
 Hold'em No Limit - Level X (200/400) - 2017/09/13 20:44:53 ET
Table '1701776547 3' 9-max Seat #8 is the button
Seat 1: CerPrisingLe (63638 in chips)=20
Seat 3: @Bud_Fox0000 (7657 in chips)=20
Seat 4: zBeanHeaDz (20264 in chips)=20
Seat 5: JJin91 (22456 in chips)=20
Seat 6: apoch19 (28511 in chips)=20
Seat 7: CaptN421 (31514 in chips)=20
Seat 8: Dominator863 (11370 in chips)=20
Seat 9: GetLoose17 (10000 in chips) out of hand (moved from another tab=
le into small blind)
CerPrisingLe: posts the ante 50
@Bud_Fox0000: posts the ante 50
zBeanHeaDz: posts the ante 50
JJin91: posts the ante 50
apoch19: posts the ante 50
CaptN421: posts the ante 50
Dominator863: posts the ante 50
CerPrisingLe: posts small blind 200
@Bud_Fox0000: posts big blind 400
*** HOLE CARDS ***
Dealt to JJin91 [4c 8h]
zBeanHeaDz: folds=20
JJin91: folds=20
apoch19: folds=20
CaptN421: folds=20
Dominator863: folds=20
CerPrisingLe: raises 400 to 800
@Bud_Fox0000: calls 400
*** FLOP *** [4h Js Tc]
CerPrisingLe: bets 1463
@Bud_Fox0000: calls 1463
*** TURN *** [4h Js Tc] [6c]
CerPrisingLe: bets 5600
@Bud_Fox0000: calls 5344 and is all-in
Uncalled bet (256) returned to CerPrisingLe
*** RIVER *** [4h Js Tc 6c] [9s]
*** SHOW DOWN ***
CerPrisingLe: shows [9c Jh] (two pair, Jacks and Nines)
@Bud_Fox0000: shows [7s Th] (a pair of Tens)
CerPrisingLe collected 15564 from pot
@Bud_Fox0000 finished the tournament in 69th place
*** SUMMARY ***
Total pot 15564 | Rake 0=20
Board [4h Js Tc 6c 9s]
Seat 1: CerPrisingLe (small blind) showed [9c Jh] and won (15564) with =
two pair, Jacks and Nines
Seat 3: @Bud_Fox0000 (big blind) showed [7s Th] and lost with a pair of=
 Tens
Seat 4: zBeanHeaDz folded before Flop (didn't bet)
Seat 5: JJin91 folded before Flop (didn't bet)
Seat 6: apoch19 folded before Flop (didn't bet)
Seat 7: CaptN421 folded before Flop (didn't bet)
Seat 8: Dominator863 (button) folded before Flop (didn't bet)


*********** # 108 **************
PokerStars Hand #175010289555: Tournament #1701776547, $18.20+$1.80 USD=
 Hold'em No Limit - Level XI (250/500) - 2017/09/13 20:46:28 ET
Table '1701776547 3' 9-max Seat #1 is the button
Seat 1: CerPrisingLe (71545 in chips)=20
Seat 4: zBeanHeaDz (20214 in chips)=20
Seat 5: JJin91 (22406 in chips)=20
Seat 6: apoch19 (28461 in chips)=20
Seat 7: CaptN421 (31464 in chips)=20
Seat 8: Dominator863 (11320 in chips)=20
Seat 9: GetLoose17 (10000 in chips)=20
CerPrisingLe: posts the ante 60
zBeanHeaDz: posts the ante 60
JJin91: posts the ante 60
apoch19: posts the ante 60
CaptN421: posts the ante 60
Dominator863: posts the ante 60
GetLoose17: posts the ante 60
zBeanHeaDz: posts small blind 250
JJin91: posts big blind 500
*** HOLE CARDS ***
Dealt to JJin91 [8s 9s]
apoch19: folds=20
CaptN421: raises 1000 to 1500
Dominator863: folds=20
GetLoose17: folds=20
CerPrisingLe: folds=20
zBeanHeaDz: folds=20
JJin91: folds=20
Uncalled bet (1000) returned to CaptN421
CaptN421 collected 1670 from pot
*** SUMMARY ***
Total pot 1670 | Rake 0=20
Seat 1: CerPrisingLe (button) folded before Flop (didn't bet)
Seat 4: zBeanHeaDz (small blind) folded before Flop
Seat 5: JJin91 (big blind) folded before Flop
Seat 6: apoch19 folded before Flop (didn't bet)
Seat 7: CaptN421 collected (1670)
Seat 8: Dominator863 folded before Flop (didn't bet)
Seat 9: GetLoose17 folded before Flop (didn't bet)


*********** # 109 **************
PokerStars Hand #175010289695: Tournament #1701776547, $18.20+$1.80 USD=
 Hold'em No Limit - Level XI (250/500) - 2017/09/13 20:46:58 ET
Table '1701776547 3' 9-max Seat #4 is the button
Seat 1: CerPrisingLe (71485 in chips)=20
Seat 2: Thucydides (32677 in chips)=20
Seat 4: zBeanHeaDz (19904 in chips)=20
Seat 5: JJin91 (21846 in chips)=20
Seat 6: apoch19 (28401 in chips)=20
Seat 7: CaptN421 (32574 in chips)=20
Seat 8: Dominator863 (11260 in chips)=20
Seat 9: GetLoose17 (9940 in chips)=20
CerPrisingLe: posts the ante 60
Thucydides: posts the ante 60
zBeanHeaDz: posts the ante 60
JJin91: posts the ante 60
apoch19: posts the ante 60
CaptN421: posts the ante 60
Dominator863: posts the ante 60
GetLoose17: posts the ante 60
JJin91: posts small blind 250
apoch19: posts big blind 500
*** HOLE CARDS ***
Dealt to JJin91 [Kd 7h]
CaptN421: calls 500
Dominator863: folds=20
GetLoose17: folds=20
CerPrisingLe: folds=20
Thucydides: folds=20
zBeanHeaDz: raises 1245 to 1745
JJin91: folds=20
apoch19: folds=20
CaptN421: calls 1245
*** FLOP *** [5s 4h 7s]
CaptN421: checks=20
zBeanHeaDz: bets 1794
CaptN421: calls 1794
*** TURN *** [5s 4h 7s] [6c]
CaptN421: checks=20
zBeanHeaDz: bets 3157
CaptN421: raises 25818 to 28975 and is all-in
zBeanHeaDz: folds=20
Uncalled bet (25818) returned to CaptN421
CaptN421 collected 14622 from pot
*** SUMMARY ***
Total pot 14622 | Rake 0=20
Board [5s 4h 7s 6c]
Seat 1: CerPrisingLe folded before Flop (didn't bet)
Seat 2: Thucydides folded before Flop (didn't bet)
Seat 4: zBeanHeaDz (button) folded on the Turn
Seat 5: JJin91 (small blind) folded before Flop
Seat 6: apoch19 (big blind) folded before Flop
Seat 7: CaptN421 collected (14622)
Seat 8: Dominator863 folded before Flop (didn't bet)
Seat 9: GetLoose17 folded before Flop (didn't bet)


*********** # 110 **************
PokerStars Hand #175010862537: Tournament #1701776547, $18.20+$1.80 USD=
 Hold'em No Limit - Level XI (250/500) - 2017/09/13 20:48:22 ET
Table '1701776547 3' 9-max Seat #5 is the button
Seat 1: CerPrisingLe (71425 in chips)=20
Seat 2: Thucydides (32617 in chips)=20
Seat 4: zBeanHeaDz (13148 in chips)=20
Seat 5: JJin91 (21536 in chips)=20
Seat 6: apoch19 (27841 in chips)=20
Seat 7: CaptN421 (40440 in chips)=20
Seat 8: Dominator863 (11200 in chips)=20
Seat 9: GetLoose17 (9880 in chips)=20
CerPrisingLe: posts the ante 60
Thucydides: posts the ante 60
zBeanHeaDz: posts the ante 60
JJin91: posts the ante 60
apoch19: posts the ante 60
CaptN421: posts the ante 60
Dominator863: posts the ante 60
GetLoose17: posts the ante 60
apoch19: posts small blind 250
CaptN421: posts big blind 500
*** HOLE CARDS ***
Dealt to JJin91 [As 9c]
Dominator863: folds=20
GetLoose17: folds=20
CerPrisingLe: folds=20
Thucydides: folds=20
zBeanHeaDz: folds=20
JJin91: raises 585 to 1085
apoch19: calls 835
CaptN421: calls 585
*** FLOP *** [Qc 2d Js]
apoch19: checks=20
CaptN421: checks=20
JJin91: checks=20
*** TURN *** [Qc 2d Js] [7h]
apoch19: checks=20
CaptN421: checks=20
JJin91: checks=20
*** RIVER *** [Qc 2d Js 7h] [5s]
apoch19: bets 1550
CaptN421: calls 1550
JJin91: folds=20
*** SHOW DOWN ***
apoch19: shows [Jc Kc] (a pair of Jacks)
CaptN421: mucks hand=20
apoch19 collected 6835 from pot
*** SUMMARY ***
Total pot 6835 | Rake 0=20
Board [Qc 2d Js 7h 5s]
Seat 1: CerPrisingLe folded before Flop (didn't bet)
Seat 2: Thucydides folded before Flop (didn't bet)
Seat 4: zBeanHeaDz folded before Flop (didn't bet)
Seat 5: JJin91 (button) folded on the River
Seat 6: apoch19 (small blind) showed [Jc Kc] and won (6835) with a pair=
 of Jacks
Seat 7: CaptN421 (big blind) mucked [7d 4d]
Seat 8: Dominator863 folded before Flop (didn't bet)
Seat 9: GetLoose17 folded before Flop (didn't bet)


*********** # 111 **************
PokerStars Hand #175010862778: Tournament #1701776547, $18.20+$1.80 USD=
 Hold'em No Limit - Level XI (250/500) - 2017/09/13 20:49:29 ET
Table '1701776547 3' 9-max Seat #6 is the button
Seat 1: CerPrisingLe (71365 in chips)=20
Seat 2: Thucydides (32557 in chips)=20
Seat 3: 14k100g (10000 in chips)=20
Seat 4: zBeanHeaDz (13088 in chips)=20
Seat 5: JJin91 (20391 in chips)=20
Seat 6: apoch19 (31981 in chips)=20
Seat 7: CaptN421 (37745 in chips)=20
Seat 8: Dominator863 (11140 in chips)=20
Seat 9: GetLoose17 (9820 in chips)=20
CerPrisingLe: posts the ante 60
Thucydides: posts the ante 60
14k100g: posts the ante 60
zBeanHeaDz: posts the ante 60
JJin91: posts the ante 60
apoch19: posts the ante 60
CaptN421: posts the ante 60
Dominator863: posts the ante 60
GetLoose17: posts the ante 60
CaptN421: posts small blind 250
Dominator863: posts big blind 500
*** HOLE CARDS ***
Dealt to JJin91 [6s 2s]
GetLoose17: folds=20
CerPrisingLe: folds=20
Thucydides: folds=20
14k100g: folds=20
zBeanHeaDz: raises 560 to 1060
JJin91: folds=20
apoch19: calls 1060
CaptN421: calls 810
Dominator863: folds=20
*** FLOP *** [Tc 4d Js]
CaptN421: bets 1500
zBeanHeaDz: calls 1500
apoch19: calls 1500
*** TURN *** [Tc 4d Js] [Qc]
CaptN421: bets 5547
zBeanHeaDz: calls 5547
apoch19: calls 5547
*** RIVER *** [Tc 4d Js Qc] [Ad]
CaptN421: checks=20
zBeanHeaDz: bets 4921 and is all-in
apoch19: calls 4921
CaptN421: folds=20
*** SHOW DOWN ***
zBeanHeaDz: shows [Jd Ks] (a straight, Ten to Ace)
apoch19: shows [Qd Kd] (a straight, Ten to Ace)
zBeanHeaDz collected 17602 from pot
apoch19 collected 17601 from pot
*** SUMMARY ***
Total pot 35203 | Rake 0=20
Board [Tc 4d Js Qc Ad]
Seat 1: CerPrisingLe folded before Flop (didn't bet)
Seat 2: Thucydides folded before Flop (didn't bet)
Seat 3: 14k100g folded before Flop (didn't bet)
Seat 4: zBeanHeaDz showed [Jd Ks] and won (17602) with a straight, Ten =
to Ace
Seat 5: JJin91 folded before Flop (didn't bet)
Seat 6: apoch19 (button) showed [Qd Kd] and won (17601) with a straight=
, Ten to Ace
Seat 7: CaptN421 (small blind) folded on the River
Seat 8: Dominator863 (big blind) folded before Flop
Seat 9: GetLoose17 folded before Flop (didn't bet)


*********** # 112 **************
PokerStars Hand #175010863130: Tournament #1701776547, $18.20+$1.80 USD=
 Hold'em No Limit - Level XI (250/500) - 2017/09/13 20:50:50 ET
Table '1701776547 3' 9-max Seat #7 is the button
Seat 1: CerPrisingLe (71305 in chips)=20
Seat 2: Thucydides (32497 in chips)=20
Seat 3: 14k100g (9940 in chips)=20
Seat 4: zBeanHeaDz (17602 in chips)=20
Seat 5: JJin91 (20331 in chips)=20
Seat 6: apoch19 (36494 in chips)=20
Seat 7: CaptN421 (29578 in chips)=20
Seat 8: Dominator863 (10580 in chips)=20
Seat 9: GetLoose17 (9760 in chips)=20
CerPrisingLe: posts the ante 60
Thucydides: posts the ante 60
14k100g: posts the ante 60
zBeanHeaDz: posts the ante 60
JJin91: posts the ante 60
apoch19: posts the ante 60
CaptN421: posts the ante 60
Dominator863: posts the ante 60
GetLoose17: posts the ante 60
Dominator863: posts small blind 250
GetLoose17: posts big blind 500
*** HOLE CARDS ***
Dealt to JJin91 [7d 9d]
CerPrisingLe: folds=20
Thucydides: raises 750 to 1250
14k100g: folds=20
zBeanHeaDz: folds=20
JJin91: folds=20
apoch19: folds=20
CaptN421: raises 28268 to 29518 and is all-in
Dominator863: folds=20
GetLoose17: folds=20
Thucydides: folds=20
Uncalled bet (28268) returned to CaptN421
CaptN421 collected 3790 from pot
*** SUMMARY ***
Total pot 3790 | Rake 0=20
Seat 1: CerPrisingLe folded before Flop (didn't bet)
Seat 2: Thucydides folded before Flop
Seat 3: 14k100g folded before Flop (didn't bet)
Seat 4: zBeanHeaDz folded before Flop (didn't bet)
Seat 5: JJin91 folded before Flop (didn't bet)
Seat 6: apoch19 folded before Flop (didn't bet)
Seat 7: CaptN421 (button) collected (3790)
Seat 8: Dominator863 (small blind) folded before Flop
Seat 9: GetLoose17 (big blind) folded before Flop


*********** # 113 **************
PokerStars Hand #175010863315: Tournament #1701776547, $18.20+$1.80 USD=
 Hold'em No Limit - Level XI (250/500) - 2017/09/13 20:51:37 ET
Table '1701776547 3' 9-max Seat #8 is the button
Seat 1: CerPrisingLe (71245 in chips)=20
Seat 2: Thucydides (31187 in chips)=20
Seat 3: 14k100g (9880 in chips)=20
Seat 4: zBeanHeaDz (17542 in chips)=20
Seat 5: JJin91 (20271 in chips)=20
Seat 6: apoch19 (36434 in chips)=20
Seat 7: CaptN421 (32058 in chips)=20
Seat 8: Dominator863 (10270 in chips)=20
Seat 9: GetLoose17 (9200 in chips)=20
CerPrisingLe: posts the ante 60
Thucydides: posts the ante 60
14k100g: posts the ante 60
zBeanHeaDz: posts the ante 60
JJin91: posts the ante 60
apoch19: posts the ante 60
CaptN421: posts the ante 60
Dominator863: posts the ante 60
GetLoose17: posts the ante 60
GetLoose17: posts small blind 250
CerPrisingLe: posts big blind 500
*** HOLE CARDS ***
Dealt to JJin91 [9c Jc]
Thucydides: folds=20
14k100g: folds=20
zBeanHeaDz: folds=20
JJin91: folds=20
apoch19: raises 780 to 1280
CaptN421: folds=20
Dominator863: folds=20
GetLoose17: raises 1720 to 3000
CerPrisingLe: folds=20
apoch19: folds=20
Uncalled bet (1720) returned to GetLoose17
GetLoose17 collected 3600 from pot
GetLoose17: doesn't show hand=20
*** SUMMARY ***
Total pot 3600 | Rake 0=20
Seat 1: CerPrisingLe (big blind) folded before Flop
Seat 2: Thucydides folded before Flop (didn't bet)
Seat 3: 14k100g folded before Flop (didn't bet)
Seat 4: zBeanHeaDz folded before Flop (didn't bet)
Seat 5: JJin91 folded before Flop (didn't bet)
Seat 6: apoch19 folded before Flop
Seat 7: CaptN421 folded before Flop (didn't bet)
Seat 8: Dominator863 (button) folded before Flop (didn't bet)
Seat 9: GetLoose17 (small blind) collected (3600)


*********** # 114 **************
PokerStars Hand #175010863560: Tournament #1701776547, $18.20+$1.80 USD=
 Hold'em No Limit - Level XI (250/500) - 2017/09/13 20:52:35 ET
Table '1701776547 3' 9-max Seat #9 is the button
Seat 1: CerPrisingLe (70685 in chips)=20
Seat 2: Thucydides (31127 in chips)=20
Seat 3: 14k100g (9820 in chips)=20
Seat 5: JJin91 (20211 in chips)=20
Seat 6: apoch19 (35094 in chips)=20
Seat 7: CaptN421 (31998 in chips)=20
Seat 8: Dominator863 (10210 in chips)=20
Seat 9: GetLoose17 (11460 in chips)=20
CerPrisingLe: posts the ante 60
Thucydides: posts the ante 60
14k100g: posts the ante 60
JJin91: posts the ante 60
apoch19: posts the ante 60
CaptN421: posts the ante 60
Dominator863: posts the ante 60
GetLoose17: posts the ante 60
CerPrisingLe: posts small blind 250
Thucydides: posts big blind 500
*** HOLE CARDS ***
Dealt to JJin91 [5d 8c]
14k100g: folds=20
JJin91: folds=20
apoch19: folds=20
CaptN421: folds=20
Dominator863: folds=20
GetLoose17: folds=20
CerPrisingLe: raises 500 to 1000
Thucydides: folds=20
Uncalled bet (500) returned to CerPrisingLe
CerPrisingLe collected 1480 from pot
CerPrisingLe: doesn't show hand=20
*** SUMMARY ***
Total pot 1480 | Rake 0=20
Seat 1: CerPrisingLe (small blind) collected (1480)
Seat 2: Thucydides (big blind) folded before Flop
Seat 3: 14k100g folded before Flop (didn't bet)
Seat 5: JJin91 folded before Flop (didn't bet)
Seat 6: apoch19 folded before Flop (didn't bet)
Seat 7: CaptN421 folded before Flop (didn't bet)
Seat 8: Dominator863 folded before Flop (didn't bet)
Seat 9: GetLoose17 (button) folded before Flop (didn't bet)


*********** # 115 **************
PokerStars Hand #175010863896: Tournament #1701776547, $18.20+$1.80 USD=
 Hold'em No Limit - Level XI (250/500) - 2017/09/13 20:53:57 ET
Table '1701776547 3' 9-max Seat #1 is the button
Seat 1: CerPrisingLe (71605 in chips)=20
Seat 2: Thucydides (30567 in chips)=20
Seat 3: 14k100g (9760 in chips)=20
Seat 4: JRoop029 (10000 in chips)=20
Seat 5: JJin91 (20151 in chips)=20
Seat 6: apoch19 (35034 in chips)=20
Seat 7: CaptN421 (31938 in chips)=20
Seat 8: Dominator863 (10150 in chips)=20
Seat 9: GetLoose17 (11400 in chips)=20
CerPrisingLe: posts the ante 60
Thucydides: posts the ante 60
14k100g: posts the ante 60
JRoop029: posts the ante 60
JJin91: posts the ante 60
apoch19: posts the ante 60
CaptN421: posts the ante 60
Dominator863: posts the ante 60
GetLoose17: posts the ante 60
Thucydides: posts small blind 250
14k100g: posts big blind 500
*** HOLE CARDS ***
Dealt to JJin91 [5h Jc]
JRoop029: raises 675 to 1175
JJin91: folds=20
apoch19: folds=20
CaptN421: folds=20
Dominator863: calls 1175
GetLoose17: folds=20
CerPrisingLe: folds=20
Thucydides: folds=20
14k100g: calls 675
*** FLOP *** [4h 9c 3d]
14k100g: checks=20
JRoop029: checks=20
Dominator863: checks=20
*** TURN *** [4h 9c 3d] [Qc]
14k100g: checks=20
JRoop029: checks=20
Dominator863: bets 1000
14k100g: calls 1000
JRoop029: folds=20
*** RIVER *** [4h 9c 3d Qc] [2h]
14k100g: checks=20
Dominator863: checks=20
*** SHOW DOWN ***
14k100g: shows [Td Th] (a pair of Tens)
Dominator863: mucks hand=20
14k100g collected 6315 from pot
*** SUMMARY ***
Total pot 6315 | Rake 0=20
Board [4h 9c 3d Qc 2h]
Seat 1: CerPrisingLe (button) folded before Flop (didn't bet)
Seat 2: Thucydides (small blind) folded before Flop
Seat 3: 14k100g (big blind) showed [Td Th] and won (6315) with a pair o=
f Tens
Seat 4: JRoop029 folded on the Turn
Seat 5: JJin91 folded before Flop (didn't bet)
Seat 6: apoch19 folded before Flop (didn't bet)
Seat 7: CaptN421 folded before Flop (didn't bet)
Seat 8: Dominator863 mucked [Ah 8s]
Seat 9: GetLoose17 folded before Flop (didn't bet)


*********** # 116 **************
PokerStars Hand #175010865490: Tournament #1701776547, $18.20+$1.80 USD=
 Hold'em No Limit - Level XI (250/500) - 2017/09/13 21:00:44 ET
Table '1701776547 3' 9-max Seat #2 is the button
Seat 2: Thucydides (30257 in chips)=20
Seat 3: 14k100g (13840 in chips)=20
Seat 4: JRoop029 (8765 in chips)=20
Seat 5: JJin91 (20091 in chips)=20
Seat 7: CaptN421 (31878 in chips)=20
Seat 8: Dominator863 (7915 in chips)=20
Seat 9: GetLoose17 (11340 in chips)=20
Thucydides: posts the ante 60
14k100g: posts the ante 60
JRoop029: posts the ante 60
JJin91: posts the ante 60
CaptN421: posts the ante 60
Dominator863: posts the ante 60
GetLoose17: posts the ante 60
14k100g: posts small blind 250
JRoop029: posts big blind 500
*** HOLE CARDS ***
Dealt to JJin91 [6s Qs]
JJin91: folds=20
CaptN421: folds=20
Dominator863 has timed out
Dominator863: folds=20
Dominator863 is sitting out
GetLoose17: folds=20
Thucydides: folds=20
14k100g: calls 250
JRoop029: checks=20
*** FLOP *** [4d 2d Ts]
14k100g: bets 500
JRoop029: folds=20
Uncalled bet (500) returned to 14k100g
14k100g collected 1420 from pot
14k100g: doesn't show hand=20
*** SUMMARY ***
Total pot 1420 | Rake 0=20
Board [4d 2d Ts]
Seat 2: Thucydides (button) folded before Flop (didn't bet)
Seat 3: 14k100g (small blind) collected (1420)
Seat 4: JRoop029 (big blind) folded on the Flop
Seat 5: JJin91 folded before Flop (didn't bet)
Seat 7: CaptN421 folded before Flop (didn't bet)
Seat 8: Dominator863 folded before Flop (didn't bet)
Seat 9: GetLoose17 folded before Flop (didn't bet)


*********** # 117 **************
PokerStars Hand #175010865679: Tournament #1701776547, $18.20+$1.80 USD=
 Hold'em No Limit - Level XI (250/500) - 2017/09/13 21:01:32 ET
Table '1701776547 3' 9-max Seat #3 is the button
Seat 1: UncleQuatch (8820 in chips)=20
Seat 2: Thucydides (30197 in chips)=20
Seat 3: 14k100g (14700 in chips)=20
Seat 4: JRoop029 (8205 in chips)=20
Seat 5: JJin91 (20031 in chips)=20
Seat 6: hyerolla777 (9940 in chips)=20
Seat 7: CaptN421 (31818 in chips)=20
Seat 8: Dominator863 (7855 in chips) is sitting out
Seat 9: GetLoose17 (11280 in chips)=20
UncleQuatch: posts the ante 60
Thucydides: posts the ante 60
14k100g: posts the ante 60
JRoop029: posts the ante 60
JJin91: posts the ante 60
hyerolla777: posts the ante 60
CaptN421: posts the ante 60
Dominator863: posts the ante 60
GetLoose17: posts the ante 60
JRoop029: posts small blind 250
JJin91: posts big blind 500
*** HOLE CARDS ***
Dealt to JJin91 [4d 2s]
hyerolla777: folds=20
CaptN421: folds=20
Dominator863: folds=20
GetLoose17: folds=20
UncleQuatch: folds=20
Thucydides: folds=20
14k100g: raises 1000 to 1500
JRoop029: folds=20
JJin91: folds=20
Uncalled bet (1000) returned to 14k100g
14k100g collected 1790 from pot
14k100g: doesn't show hand=20
*** SUMMARY ***
Total pot 1790 | Rake 0=20
Seat 1: UncleQuatch folded before Flop (didn't bet)
Seat 2: Thucydides folded before Flop (didn't bet)
Seat 3: 14k100g (button) collected (1790)
Seat 4: JRoop029 (small blind) folded before Flop
Seat 5: JJin91 (big blind) folded before Flop
Seat 6: hyerolla777 folded before Flop (didn't bet)
Seat 7: CaptN421 folded before Flop (didn't bet)
Seat 8: Dominator863 folded before Flop (didn't bet)
Seat 9: GetLoose17 folded before Flop (didn't bet)


*********** # 118 **************
PokerStars Hand #175010865832: Tournament #1701776547, $18.20+$1.80 USD=
 Hold'em No Limit - Level XII (300/600) - 2017/09/13 21:02:10 ET
Table '1701776547 3' 9-max Seat #4 is the button
Seat 1: UncleQuatch (8760 in chips)=20
Seat 2: Thucydides (30137 in chips)=20
Seat 3: 14k100g (15930 in chips)=20
Seat 4: JRoop029 (7895 in chips)=20
Seat 5: JJin91 (19471 in chips)=20
Seat 6: hyerolla777 (9880 in chips)=20
Seat 7: CaptN421 (31758 in chips)=20
Seat 8: Dominator863 (7795 in chips) is sitting out
Seat 9: GetLoose17 (11220 in chips)=20
UncleQuatch: posts the ante 70
Thucydides: posts the ante 70
14k100g: posts the ante 70
JRoop029: posts the ante 70
JJin91: posts the ante 70
hyerolla777: posts the ante 70
CaptN421: posts the ante 70
Dominator863: posts the ante 70
GetLoose17: posts the ante 70
JJin91: posts small blind 300
hyerolla777: posts big blind 600
*** HOLE CARDS ***
Dealt to JJin91 [Ah Qd]
Dominator863 has returned
CaptN421 has timed out
CaptN421: folds=20
CaptN421 is sitting out
Dominator863 has timed out
Dominator863: folds=20
Dominator863 is sitting out
GetLoose17: folds=20
UncleQuatch: folds=20
Thucydides: folds=20
CaptN421 has returned
14k100g: raises 1200 to 1800
JRoop029: folds=20
JJin91: raises 17601 to 19401 and is all-in
hyerolla777: calls 9210 and is all-in
14k100g: folds=20
Uncalled bet (9591) returned to JJin91
*** FLOP *** [Th 4c 8s]
*** TURN *** [Th 4c 8s] [4d]
*** RIVER *** [Th 4c 8s 4d] [5h]
*** SHOW DOWN ***
JJin91: shows [Ah Qd] (a pair of Fours)
hyerolla777: shows [Kd Qh] (a pair of Fours - lower kicker)
JJin91 collected 22050 from pot
hyerolla777 finished the tournament in 53rd place
*** SUMMARY ***
Total pot 22050 | Rake 0=20
Board [Th 4c 8s 4d 5h]
Seat 1: UncleQuatch folded before Flop (didn't bet)
Seat 2: Thucydides folded before Flop (didn't bet)
Seat 3: 14k100g folded before Flop
Seat 4: JRoop029 (button) folded before Flop (didn't bet)
Seat 5: JJin91 (small blind) showed [Ah Qd] and won (22050) with a pair=
 of Fours
Seat 6: hyerolla777 (big blind) showed [Kd Qh] and lost with a pair of =
Fours
Seat 7: CaptN421 folded before Flop (didn't bet)
Seat 8: Dominator863 folded before Flop (didn't bet)
Seat 9: GetLoose17 folded before Flop (didn't bet)


*********** # 119 **************
PokerStars Hand #175010866294: Tournament #1701776547, $18.20+$1.80 USD=
 Hold'em No Limit - Level XII (300/600) - 2017/09/13 21:04:04 ET
Table '1701776547 3' 9-max Seat #5 is the button
Seat 1: UncleQuatch (8690 in chips)=20
Seat 2: Thucydides (30067 in chips)=20
Seat 3: 14k100g (14060 in chips)=20
Seat 4: JRoop029 (7825 in chips)=20
Seat 5: JJin91 (31641 in chips)=20
Seat 7: CaptN421 (31688 in chips)=20
Seat 8: Dominator863 (7725 in chips) is sitting out
Seat 9: GetLoose17 (11150 in chips)=20
UncleQuatch: posts the ante 70
Thucydides: posts the ante 70
14k100g: posts the ante 70
JRoop029: posts the ante 70
JJin91: posts the ante 70
CaptN421: posts the ante 70
Dominator863: posts the ante 70
GetLoose17: posts the ante 70
CaptN421: posts small blind 300
Dominator863: posts big blind 600
*** HOLE CARDS ***
Dealt to JJin91 [6s 8s]
GetLoose17: folds=20
UncleQuatch: folds=20
Thucydides: folds=20
14k100g: folds=20
JRoop029: folds=20
JJin91: raises 702 to 1302
CaptN421: folds=20
Dominator863: folds=20
Uncalled bet (702) returned to JJin91
Dominator863 has returned
JJin91 collected 2060 from pot
JJin91: doesn't show hand=20
*** SUMMARY ***
Total pot 2060 | Rake 0=20
Seat 1: UncleQuatch folded before Flop (didn't bet)
Seat 2: Thucydides folded before Flop (didn't bet)
Seat 3: 14k100g folded before Flop (didn't bet)
Seat 4: JRoop029 folded before Flop (didn't bet)
Seat 5: JJin91 (button) collected (2060)
Seat 7: CaptN421 (small blind) folded before Flop
Seat 8: Dominator863 (big blind) folded before Flop
Seat 9: GetLoose17 folded before Flop (didn't bet)


*********** # 120 **************
PokerStars Hand #175010866438: Tournament #1701776547, $18.20+$1.80 USD=
 Hold'em No Limit - Level XII (300/600) - 2017/09/13 21:04:37 ET
Table '1701776547 3' 9-max Seat #7 is the button
Seat 1: UncleQuatch (8620 in chips)=20
Seat 2: Thucydides (29997 in chips)=20
Seat 3: 14k100g (13990 in chips)=20
Seat 4: JRoop029 (7755 in chips)=20
Seat 5: JJin91 (33031 in chips)=20
Seat 7: CaptN421 (31318 in chips)=20
Seat 8: Dominator863 (7055 in chips)=20
Seat 9: GetLoose17 (11080 in chips)=20
UncleQuatch: posts the ante 70
Thucydides: posts the ante 70
14k100g: posts the ante 70
JRoop029: posts the ante 70
JJin91: posts the ante 70
CaptN421: posts the ante 70
Dominator863: posts the ante 70
GetLoose17: posts the ante 70
Dominator863: posts small blind 300
GetLoose17: posts big blind 600
*** HOLE CARDS ***
Dealt to JJin91 [9h 3c]
UncleQuatch: folds=20
Thucydides: folds=20
14k100g: raises 1200 to 1800
JRoop029: folds=20
JJin91: folds=20
CaptN421: folds=20
Dominator863: raises 5185 to 6985 and is all-in
GetLoose17: folds=20
14k100g: calls 5185
*** FLOP *** [Kd Ac Qs]
*** TURN *** [Kd Ac Qs] [Qd]
*** RIVER *** [Kd Ac Qs Qd] [Kc]
*** SHOW DOWN ***
Dominator863: shows [7c 7d] (two pair, Kings and Queens)
14k100g: shows [Qh Ad] (a full house, Queens full of Aces)
14k100g collected 15130 from pot
Dominator863 finished the tournament in 51st place
*** SUMMARY ***
Total pot 15130 | Rake 0=20
Board [Kd Ac Qs Qd Kc]
Seat 1: UncleQuatch folded before Flop (didn't bet)
Seat 2: Thucydides folded before Flop (didn't bet)
Seat 3: 14k100g showed [Qh Ad] and won (15130) with a full house, Queen=
s full of Aces
Seat 4: JRoop029 folded before Flop (didn't bet)
Seat 5: JJin91 folded before Flop (didn't bet)
Seat 7: CaptN421 (button) folded before Flop (didn't bet)
Seat 8: Dominator863 (small blind) showed [7c 7d] and lost with two pai=
r, Kings and Queens
Seat 9: GetLoose17 (big blind) folded before Flop


*********** # 121 **************
PokerStars Hand #175010866601: Tournament #1701776547, $18.20+$1.80 USD=
 Hold'em No Limit - Level XII (300/600) - 2017/09/13 21:05:14 ET
Table '1701776547 3' 9-max Seat #9 is the button
Seat 1: UncleQuatch (8550 in chips)=20
Seat 2: Thucydides (29927 in chips)=20
Seat 3: 14k100g (22065 in chips)=20
Seat 4: JRoop029 (7685 in chips)=20
Seat 5: JJin91 (32961 in chips)=20
Seat 7: CaptN421 (31248 in chips)=20
Seat 9: GetLoose17 (10410 in chips)=20
UncleQuatch: posts the ante 70
Thucydides: posts the ante 70
14k100g: posts the ante 70
JRoop029: posts the ante 70
JJin91: posts the ante 70
CaptN421: posts the ante 70
GetLoose17: posts the ante 70
UncleQuatch: posts small blind 300
Thucydides: posts big blind 600
*** HOLE CARDS ***
Dealt to JJin91 [Td Tc]
14k100g: folds=20
JRoop029: folds=20
JJin91: raises 702 to 1302
CaptN421: raises 2443 to 3745
GetLoose17: folds=20
UncleQuatch: folds=20
Thucydides: folds=20
JJin91: raises 3355 to 7100
CaptN421: calls 3355
*** FLOP *** [9d 6h Ac]
JJin91: checks=20
CaptN421: checks=20
*** TURN *** [9d 6h Ac] [Qs]
JJin91: checks=20
CaptN421: bets 6647
JJin91: folds=20
Uncalled bet (6647) returned to CaptN421
CaptN421 collected 15590 from pot
*** SUMMARY ***
Total pot 15590 | Rake 0=20
Board [9d 6h Ac Qs]
Seat 1: UncleQuatch (small blind) folded before Flop
Seat 2: Thucydides (big blind) folded before Flop
Seat 3: 14k100g folded before Flop (didn't bet)
Seat 4: JRoop029 folded before Flop (didn't bet)
Seat 5: JJin91 folded on the Turn
Seat 7: CaptN421 collected (15590)
Seat 9: GetLoose17 (button) folded before Flop (didn't bet)


*********** # 122 **************
PokerStars Hand #175010866998: Tournament #1701776547, $18.20+$1.80 USD=
 Hold'em No Limit - Level XII (300/600) - 2017/09/13 21:06:46 ET
Table '1701776547 3' 9-max Seat #1 is the button
Seat 1: UncleQuatch (8180 in chips)=20
Seat 2: Thucydides (29257 in chips)=20
Seat 3: 14k100g (21995 in chips)=20
Seat 4: JRoop029 (7615 in chips)=20
Seat 5: JJin91 (25791 in chips)=20
Seat 6: CAT@strophe (11765 in chips)=20
Seat 7: CaptN421 (39668 in chips)=20
Seat 9: GetLoose17 (10340 in chips)=20
UncleQuatch: posts the ante 70
Thucydides: posts the ante 70
14k100g: posts the ante 70
JRoop029: posts the ante 70
JJin91: posts the ante 70
CAT@strophe: posts the ante 70
CaptN421: posts the ante 70
GetLoose17: posts the ante 70
Thucydides: posts small blind 300
14k100g: posts big blind 600
*** HOLE CARDS ***
Dealt to JJin91 [9c 2h]
JRoop029: folds=20
JJin91: folds=20
CAT@strophe: folds=20
CaptN421: folds=20
GetLoose17: folds=20
UncleQuatch: raises 7510 to 8110 and is all-in
Thucydides: folds=20
14k100g: calls 7510
*** FLOP *** [Qh 2c 7h]
*** TURN *** [Qh 2c 7h] [9s]
*** RIVER *** [Qh 2c 7h 9s] [5s]
*** SHOW DOWN ***
14k100g: shows [Ah 9h] (a pair of Nines)
UncleQuatch: shows [Tc Td] (a pair of Tens)
UncleQuatch collected 17080 from pot
*** SUMMARY ***
Total pot 17080 | Rake 0=20
Board [Qh 2c 7h 9s 5s]
Seat 1: UncleQuatch (button) showed [Tc Td] and won (17080) with a pair=
 of Tens
Seat 2: Thucydides (small blind) folded before Flop
Seat 3: 14k100g (big blind) showed [Ah 9h] and lost with a pair of Nines
Seat 4: JRoop029 folded before Flop (didn't bet)
Seat 5: JJin91 folded before Flop (didn't bet)
Seat 6: CAT@strophe folded before Flop (didn't bet)
Seat 7: CaptN421 folded before Flop (didn't bet)
Seat 9: GetLoose17 folded before Flop (didn't bet)


*********** # 123 **************
PokerStars Hand #175010867133: Tournament #1701776547, $18.20+$1.80 USD=
 Hold'em No Limit - Level XII (300/600) - 2017/09/13 21:07:18 ET
Table '1701776547 3' 9-max Seat #2 is the button
Seat 1: UncleQuatch (17080 in chips)=20
Seat 2: Thucydides (28887 in chips)=20
Seat 3: 14k100g (13815 in chips)=20
Seat 4: JRoop029 (7545 in chips)=20
Seat 5: JJin91 (25721 in chips)=20
Seat 6: CAT@strophe (11695 in chips)=20
Seat 7: CaptN421 (39598 in chips)=20
Seat 9: GetLoose17 (10270 in chips)=20
UncleQuatch: posts the ante 70
Thucydides: posts the ante 70
14k100g: posts the ante 70
JRoop029: posts the ante 70
JJin91: posts the ante 70
CAT@strophe: posts the ante 70
CaptN421: posts the ante 70
GetLoose17: posts the ante 70
14k100g: posts small blind 300
JRoop029: posts big blind 600
*** HOLE CARDS ***
Dealt to JJin91 [3d Jc]
JJin91: folds=20
CAT@strophe: raises 600 to 1200
CaptN421: folds=20
GetLoose17: folds=20
UncleQuatch: folds=20
Thucydides: calls 1200
14k100g: folds=20
JRoop029: raises 6275 to 7475 and is all-in
CAT@strophe: folds=20
Thucydides: folds=20
Uncalled bet (6275) returned to JRoop029
JRoop029 collected 4460 from pot
JRoop029: doesn't show hand=20
*** SUMMARY ***
Total pot 4460 | Rake 0=20
Seat 1: UncleQuatch folded before Flop (didn't bet)
Seat 2: Thucydides (button) folded before Flop
Seat 3: 14k100g (small blind) folded before Flop
Seat 4: JRoop029 (big blind) collected (4460)
Seat 5: JJin91 folded before Flop (didn't bet)
Seat 6: CAT@strophe folded before Flop
Seat 7: CaptN421 folded before Flop (didn't bet)
Seat 9: GetLoose17 folded before Flop (didn't bet)


*********** # 124 **************
PokerStars Hand #175010867283: Tournament #1701776547, $18.20+$1.80 USD=
 Hold'em No Limit - Level XII (300/600) - 2017/09/13 21:07:54 ET
Table '1701776547 3' 9-max Seat #3 is the button
Seat 1: UncleQuatch (17010 in chips)=20
Seat 2: Thucydides (27617 in chips)=20
Seat 3: 14k100g (13445 in chips)=20
Seat 4: JRoop029 (10735 in chips)=20
Seat 5: JJin91 (25651 in chips)=20
Seat 6: CAT@strophe (10425 in chips)=20
Seat 7: CaptN421 (39528 in chips)=20
Seat 9: GetLoose17 (10200 in chips)=20
UncleQuatch: posts the ante 70
Thucydides: posts the ante 70
14k100g: posts the ante 70
JRoop029: posts the ante 70
JJin91: posts the ante 70
CAT@strophe: posts the ante 70
CaptN421: posts the ante 70
GetLoose17: posts the ante 70
JRoop029: posts small blind 300
JJin91: posts big blind 600
*** HOLE CARDS ***
Dealt to JJin91 [7c Qc]
CAT@strophe: folds=20
CaptN421: folds=20
GetLoose17: folds=20
UncleQuatch: folds=20
Thucydides: raises 800 to 1400
14k100g: folds=20
JRoop029: folds=20
JJin91: folds=20
Uncalled bet (800) returned to Thucydides
Thucydides collected 2060 from pot
Thucydides: doesn't show hand=20
*** SUMMARY ***
Total pot 2060 | Rake 0=20
Seat 1: UncleQuatch folded before Flop (didn't bet)
Seat 2: Thucydides collected (2060)
Seat 3: 14k100g (button) folded before Flop (didn't bet)
Seat 4: JRoop029 (small blind) folded before Flop
Seat 5: JJin91 (big blind) folded before Flop
Seat 6: CAT@strophe folded before Flop (didn't bet)
Seat 7: CaptN421 folded before Flop (didn't bet)
Seat 9: GetLoose17 folded before Flop (didn't bet)


*********** # 125 **************
PokerStars Hand #175010867436: Tournament #1701776547, $18.20+$1.80 USD=
 Hold'em No Limit - Level XII (300/600) - 2017/09/13 21:08:29 ET
Table '1701776547 3' 9-max Seat #4 is the button
Seat 1: UncleQuatch (16940 in chips)=20
Seat 2: Thucydides (29007 in chips)=20
Seat 3: 14k100g (13375 in chips)=20
Seat 4: JRoop029 (10365 in chips)=20
Seat 5: JJin91 (24981 in chips)=20
Seat 6: CAT@strophe (10355 in chips)=20
Seat 7: CaptN421 (39458 in chips)=20
Seat 9: GetLoose17 (10130 in chips)=20
UncleQuatch: posts the ante 70
Thucydides: posts the ante 70
14k100g: posts the ante 70
JRoop029: posts the ante 70
JJin91: posts the ante 70
CAT@strophe: posts the ante 70
CaptN421: posts the ante 70
GetLoose17: posts the ante 70
JJin91: posts small blind 300
CAT@strophe: posts big blind 600
*** HOLE CARDS ***
Dealt to JJin91 [Kd 2s]
CaptN421: folds=20
GetLoose17: folds=20
UncleQuatch: folds=20
Thucydides: folds=20
14k100g: raises 1200 to 1800
JRoop029: folds=20
JJin91: folds=20
CAT@strophe: folds=20
Uncalled bet (1200) returned to 14k100g
14k100g collected 2060 from pot
14k100g: doesn't show hand=20
*** SUMMARY ***
Total pot 2060 | Rake 0=20
Seat 1: UncleQuatch folded before Flop (didn't bet)
Seat 2: Thucydides folded before Flop (didn't bet)
Seat 3: 14k100g collected (2060)
Seat 4: JRoop029 (button) folded before Flop (didn't bet)
Seat 5: JJin91 (small blind) folded before Flop
Seat 6: CAT@strophe (big blind) folded before Flop
Seat 7: CaptN421 folded before Flop (didn't bet)
Seat 9: GetLoose17 folded before Flop (didn't bet)


*********** # 126 **************
PokerStars Hand #175010867508: Tournament #1701776547, $18.20+$1.80 USD=
 Hold'em No Limit - Level XII (300/600) - 2017/09/13 21:08:46 ET
Table '1701776547 3' 9-max Seat #5 is the button
Seat 1: UncleQuatch (16870 in chips)=20
Seat 2: Thucydides (28937 in chips)=20
Seat 3: 14k100g (14765 in chips)=20
Seat 4: JRoop029 (10295 in chips)=20
Seat 5: JJin91 (24611 in chips)=20
Seat 6: CAT@strophe (9685 in chips)=20
Seat 7: CaptN421 (39388 in chips)=20
Seat 9: GetLoose17 (10060 in chips)=20
UncleQuatch: posts the ante 70
Thucydides: posts the ante 70
14k100g: posts the ante 70
JRoop029: posts the ante 70
JJin91: posts the ante 70
CAT@strophe: posts the ante 70
CaptN421: posts the ante 70
GetLoose17: posts the ante 70
CAT@strophe: posts small blind 300
CaptN421: posts big blind 600
*** HOLE CARDS ***
Dealt to JJin91 [5h Kc]
GetLoose17: raises 900 to 1500
UncleQuatch: folds=20
Thucydides: folds=20
14k100g: folds=20
JRoop029: folds=20
JJin91: folds=20
CAT@strophe: folds=20
CaptN421: calls 900
*** FLOP *** [2h Tc Td]
CaptN421: checks=20
GetLoose17: bets 1800
CaptN421: raises 1800 to 3600
GetLoose17: raises 4890 to 8490 and is all-in
CaptN421: folds=20
Uncalled bet (4890) returned to GetLoose17
GetLoose17 collected 11060 from pot
GetLoose17: doesn't show hand=20
*** SUMMARY ***
Total pot 11060 | Rake 0=20
Board [2h Tc Td]
Seat 1: UncleQuatch folded before Flop (didn't bet)
Seat 2: Thucydides folded before Flop (didn't bet)
Seat 3: 14k100g folded before Flop (didn't bet)
Seat 4: JRoop029 folded before Flop (didn't bet)
Seat 5: JJin91 (button) folded before Flop (didn't bet)
Seat 6: CAT@strophe (small blind) folded before Flop
Seat 7: CaptN421 (big blind) folded on the Flop
Seat 9: GetLoose17 collected (11060)


*********** # 127 **************
PokerStars Hand #175010867723: Tournament #1701776547, $18.20+$1.80 USD=
 Hold'em No Limit - Level XII (300/600) - 2017/09/13 21:09:35 ET
Table '1701776547 3' 9-max Seat #6 is the button
Seat 1: UncleQuatch (16800 in chips)=20
Seat 2: Thucydides (28867 in chips)=20
Seat 3: 14k100g (14695 in chips)=20
Seat 4: JRoop029 (10225 in chips)=20
Seat 5: JJin91 (24541 in chips)=20
Seat 6: CAT@strophe (9315 in chips)=20
Seat 7: CaptN421 (34218 in chips)=20
Seat 9: GetLoose17 (15950 in chips)=20
UncleQuatch: posts the ante 70
Thucydides: posts the ante 70
14k100g: posts the ante 70
JRoop029: posts the ante 70
JJin91: posts the ante 70
CAT@strophe: posts the ante 70
CaptN421: posts the ante 70
GetLoose17: posts the ante 70
CaptN421: posts small blind 300
GetLoose17: posts big blind 600
*** HOLE CARDS ***
Dealt to JJin91 [5d 4d]
UncleQuatch: folds=20
Thucydides: folds=20
14k100g: folds=20
JRoop029: folds=20
JJin91: folds=20
CAT@strophe: folds=20
CaptN421: folds=20
Uncalled bet (300) returned to GetLoose17
GetLoose17 collected 1160 from pot
GetLoose17: doesn't show hand=20
*** SUMMARY ***
Total pot 1160 | Rake 0=20
Seat 1: UncleQuatch folded before Flop (didn't bet)
Seat 2: Thucydides folded before Flop (didn't bet)
Seat 3: 14k100g folded before Flop (didn't bet)
Seat 4: JRoop029 folded before Flop (didn't bet)
Seat 5: JJin91 folded before Flop (didn't bet)
Seat 6: CAT@strophe (button) folded before Flop (didn't bet)
Seat 7: CaptN421 (small blind) folded before Flop
Seat 9: GetLoose17 (big blind) collected (1160)


*********** # 128 **************
PokerStars Hand #175010867773: Tournament #1701776547, $18.20+$1.80 USD=
 Hold'em No Limit - Level XII (300/600) - 2017/09/13 21:09:46 ET
Table '1701776547 3' 9-max Seat #7 is the button
Seat 1: UncleQuatch (16730 in chips)=20
Seat 2: Thucydides (28797 in chips)=20
Seat 3: 14k100g (14625 in chips)=20
Seat 4: JRoop029 (10155 in chips)=20
Seat 5: JJin91 (24471 in chips)=20
Seat 6: CAT@strophe (9245 in chips)=20
Seat 7: CaptN421 (33848 in chips)=20
Seat 9: GetLoose17 (16740 in chips)=20
UncleQuatch: posts the ante 70
Thucydides: posts the ante 70
14k100g: posts the ante 70
JRoop029: posts the ante 70
JJin91: posts the ante 70
CAT@strophe: posts the ante 70
CaptN421: posts the ante 70
GetLoose17: posts the ante 70
GetLoose17: posts small blind 300
UncleQuatch: posts big blind 600
*** HOLE CARDS ***
Dealt to JJin91 [5h 6d]
Thucydides: folds=20
14k100g: folds=20
JRoop029: folds=20
JJin91: folds=20
CAT@strophe: folds=20
CaptN421: raises 1200 to 1800
GetLoose17: folds=20
UncleQuatch: raises 4460 to 6260
CaptN421: folds=20
Uncalled bet (4460) returned to UncleQuatch
UncleQuatch collected 4460 from pot
UncleQuatch: doesn't show hand=20
*** SUMMARY ***
Total pot 4460 | Rake 0=20
Seat 1: UncleQuatch (big blind) collected (4460)
Seat 2: Thucydides folded before Flop (didn't bet)
Seat 3: 14k100g folded before Flop (didn't bet)
Seat 4: JRoop029 folded before Flop (didn't bet)
Seat 5: JJin91 folded before Flop (didn't bet)
Seat 6: CAT@strophe folded before Flop (didn't bet)
Seat 7: CaptN421 (button) folded before Flop
Seat 9: GetLoose17 (small blind) folded before Flop


*********** # 129 **************
PokerStars Hand #175010867948: Tournament #1701776547, $18.20+$1.80 USD=
 Hold'em No Limit - Level XII (300/600) - 2017/09/13 21:10:24 ET
Table '1701776547 3' 9-max Seat #9 is the button
Seat 1: UncleQuatch (19320 in chips)=20
Seat 2: Thucydides (28727 in chips)=20
Seat 3: 14k100g (14555 in chips)=20
Seat 4: JRoop029 (10085 in chips)=20
Seat 5: JJin91 (24401 in chips)=20
Seat 6: CAT@strophe (9175 in chips)=20
Seat 7: CaptN421 (31978 in chips)=20
Seat 9: GetLoose17 (16370 in chips)=20
UncleQuatch: posts the ante 70
Thucydides: posts the ante 70
14k100g: posts the ante 70
JRoop029: posts the ante 70
JJin91: posts the ante 70
CAT@strophe: posts the ante 70
CaptN421: posts the ante 70
GetLoose17: posts the ante 70
UncleQuatch: posts small blind 300
Thucydides: posts big blind 600
*** HOLE CARDS ***
Dealt to JJin91 [2s 2d]
14k100g: folds=20
JRoop029: raises 9415 to 10015 and is all-in
JJin91: folds=20
CAT@strophe: calls 9105 and is all-in
CaptN421: folds=20
GetLoose17: folds=20
UncleQuatch: folds=20
Thucydides: folds=20
Uncalled bet (910) returned to JRoop029
*** FLOP *** [Ac 9d 7c]
*** TURN *** [Ac 9d 7c] [3c]
*** RIVER *** [Ac 9d 7c 3c] [Kh]
*** SHOW DOWN ***
JRoop029: shows [8h 8s] (a pair of Eights)
CAT@strophe: shows [Jh Jd] (a pair of Jacks)
CAT@strophe collected 19670 from pot
*** SUMMARY ***
Total pot 19670 | Rake 0=20
Board [Ac 9d 7c 3c Kh]
Seat 1: UncleQuatch (small blind) folded before Flop
Seat 2: Thucydides (big blind) folded before Flop
Seat 3: 14k100g folded before Flop (didn't bet)
Seat 4: JRoop029 showed [8h 8s] and lost with a pair of Eights
Seat 5: JJin91 folded before Flop (didn't bet)
Seat 6: CAT@strophe showed [Jh Jd] and won (19670) with a pair of Jacks
Seat 7: CaptN421 folded before Flop (didn't bet)
Seat 9: GetLoose17 (button) folded before Flop (didn't bet)


*********** # 130 **************
PokerStars Hand #175010868123: Tournament #1701776547, $18.20+$1.80 USD=
 Hold'em No Limit - Level XII (300/600) - 2017/09/13 21:11:06 ET
Table '1701776547 3' 9-max Seat #1 is the button
Seat 1: UncleQuatch (18950 in chips)=20
Seat 2: Thucydides (28057 in chips)=20
Seat 3: 14k100g (14485 in chips)=20
Seat 4: JRoop029 (910 in chips)=20
Seat 5: JJin91 (24331 in chips)=20
Seat 6: CAT@strophe (19670 in chips)=20
Seat 7: CaptN421 (31908 in chips)=20
Seat 9: GetLoose17 (16300 in chips)=20
UncleQuatch: posts the ante 70
Thucydides: posts the ante 70
14k100g: posts the ante 70
JRoop029: posts the ante 70
JJin91: posts the ante 70
CAT@strophe: posts the ante 70
CaptN421: posts the ante 70
GetLoose17: posts the ante 70
Thucydides: posts small blind 300
14k100g: posts big blind 600
*** HOLE CARDS ***
Dealt to JJin91 [Jd Ad]
JRoop029: folds=20
JJin91: raises 702 to 1302
CAT@strophe: folds=20
CaptN421: calls 1302
GetLoose17: calls 1302
UncleQuatch: folds=20
Thucydides: calls 1002
14k100g: calls 702
*** FLOP *** [8d 8h 6c]
Thucydides: checks=20
14k100g: bets 3600
JJin91: folds=20
CaptN421: calls 3600
GetLoose17: folds=20
Thucydides: folds=20
*** TURN *** [8d 8h 6c] [Jh]
14k100g: checks=20
CaptN421: bets 26936 and is all-in
14k100g: calls 9513 and is all-in
Uncalled bet (17423) returned to CaptN421
*** RIVER *** [8d 8h 6c Jh] [8c]
*** SHOW DOWN ***
14k100g: shows [Ah Js] (a full house, Eights full of Jacks)
CaptN421: shows [3c 3h] (a full house, Eights full of Threes)
14k100g collected 33296 from pot
*** SUMMARY ***
Total pot 33296 | Rake 0=20
Board [8d 8h 6c Jh 8c]
Seat 1: UncleQuatch (button) folded before Flop (didn't bet)
Seat 2: Thucydides (small blind) folded on the Flop
Seat 3: 14k100g (big blind) showed [Ah Js] and won (33296) with a full =
house, Eights full of Jacks
Seat 4: JRoop029 folded before Flop (didn't bet)
Seat 5: JJin91 folded on the Flop
Seat 6: CAT@strophe folded before Flop (didn't bet)
Seat 7: CaptN421 showed [3c 3h] and lost with a full house, Eights full=
 of Threes
Seat 9: GetLoose17 folded on the Flop


*********** # 131 **************
PokerStars Hand #175010868432: Tournament #1701776547, $18.20+$1.80 USD=
 Hold'em No Limit - Level XIII (350/700) - 2017/09/13 21:12:22 ET
Table '1701776547 3' 9-max Seat #2 is the button
Seat 1: UncleQuatch (18880 in chips)=20
Seat 2: Thucydides (26685 in chips)=20
Seat 3: 14k100g (33296 in chips)=20
Seat 4: JRoop029 (840 in chips)=20
Seat 5: JJin91 (22959 in chips)=20
Seat 6: CAT@strophe (19600 in chips)=20
Seat 7: CaptN421 (17423 in chips)=20
Seat 8: senor stinks (21972 in chips)=20
Seat 9: GetLoose17 (14928 in chips)=20
UncleQuatch: posts the ante 85
Thucydides: posts the ante 85
14k100g: posts the ante 85
JRoop029: posts the ante 85
JJin91: posts the ante 85
CAT@strophe: posts the ante 85
CaptN421: posts the ante 85
senor stinks: posts the ante 85
GetLoose17: posts the ante 85
14k100g: posts small blind 350
JRoop029: posts big blind 700
*** HOLE CARDS ***
Dealt to JJin91 [8s Qh]
JJin91: folds=20
CAT@strophe: folds=20
CaptN421: folds=20
senor stinks: folds=20
GetLoose17: raises 1050 to 1750
UncleQuatch: folds=20
Thucydides: raises 2560 to 4310
14k100g: folds=20
JRoop029: calls 55 and is all-in
GetLoose17: calls 2560
*** FLOP *** [Kc 3c 7h]
GetLoose17: checks=20
Thucydides: bets 9250
GetLoose17: raises 1283 to 10533 and is all-in
Thucydides: calls 1283
*** TURN *** [Kc 3c 7h] [Th]
*** RIVER *** [Kc 3c 7h Th] [4d]
*** SHOW DOWN ***
GetLoose17: shows [Js Kh] (a pair of Kings)
Thucydides: shows [As Kd] (a pair of Kings - Ace kicker)
Thucydides collected 28176 from side pot
JRoop029: shows [4h 8h] (a pair of Fours)
Thucydides collected 3380 from main pot
GetLoose17 finished the tournament in 43rd place
JRoop029 finished the tournament in 44th place
*** SUMMARY ***
Total pot 31556 Main pot 3380. Side pot 28176. | Rake 0=20
Board [Kc 3c 7h Th 4d]
Seat 1: UncleQuatch folded before Flop (didn't bet)
Seat 2: Thucydides (button) showed [As Kd] and won (31556) with a pair =
of Kings
Seat 3: 14k100g (small blind) folded before Flop
Seat 4: JRoop029 (big blind) showed [4h 8h] and lost with a pair of Fou=
rs
Seat 5: JJin91 folded before Flop (didn't bet)
Seat 6: CAT@strophe folded before Flop (didn't bet)
Seat 7: CaptN421 folded before Flop (didn't bet)
Seat 8: senor stinks folded before Flop (didn't bet)
Seat 9: GetLoose17 showed [Js Kh] and lost with a pair of Kings


*********** # 132 **************
PokerStars Hand #175010868664: Tournament #1701776547, $18.20+$1.80 USD=
 Hold'em No Limit - Level XIII (350/700) - 2017/09/13 21:13:16 ET
Table '1701776547 3' 9-max Seat #3 is the button
Seat 1: UncleQuatch (18795 in chips)=20
Seat 2: Thucydides (43313 in chips)=20
Seat 3: 14k100g (32861 in chips)=20
Seat 5: JJin91 (22874 in chips)=20
Seat 6: CAT@strophe (19515 in chips)=20
Seat 7: CaptN421 (17338 in chips)=20
Seat 8: senor stinks (21887 in chips)=20
UncleQuatch: posts the ante 85
Thucydides: posts the ante 85
14k100g: posts the ante 85
JJin91: posts the ante 85
CAT@strophe: posts the ante 85
CaptN421: posts the ante 85
senor stinks: posts the ante 85
JJin91: posts small blind 350
CAT@strophe: posts big blind 700
*** HOLE CARDS ***
Dealt to JJin91 [Qc Ad]
CaptN421: folds=20
senor stinks: folds=20
UncleQuatch: folds=20
Thucydides: raises 1000 to 1700
14k100g: folds=20
JJin91: calls 1350
CAT@strophe: folds=20
*** FLOP *** [Kh 7c 5d]
JJin91: bets 1888
Thucydides: folds=20
Uncalled bet (1888) returned to JJin91
JJin91 collected 4695 from pot
JJin91: doesn't show hand=20
*** SUMMARY ***
Total pot 4695 | Rake 0=20
Board [Kh 7c 5d]
Seat 1: UncleQuatch folded before Flop (didn't bet)
Seat 2: Thucydides folded on the Flop
Seat 3: 14k100g (button) folded before Flop (didn't bet)
Seat 5: JJin91 (small blind) collected (4695)
Seat 6: CAT@strophe (big blind) folded before Flop
Seat 7: CaptN421 folded before Flop (didn't bet)
Seat 8: senor stinks folded before Flop (didn't bet)


*********** # 133 **************
PokerStars Hand #175010868916: Tournament #1701776547, $18.20+$1.80 USD=
 Hold'em No Limit - Level XIII (350/700) - 2017/09/13 21:14:17 ET
Table '1701776547 3' 9-max Seat #5 is the button
Seat 1: UncleQuatch (18710 in chips)=20
Seat 2: Thucydides (41528 in chips)=20
Seat 3: 14k100g (32776 in chips)=20
Seat 4: Memphis151 (40974 in chips)=20
Seat 5: JJin91 (25784 in chips)=20
Seat 6: CAT@strophe (18730 in chips)=20
Seat 7: CaptN421 (17253 in chips)=20
Seat 8: senor stinks (21802 in chips)=20
UncleQuatch: posts the ante 85
Thucydides: posts the ante 85
14k100g: posts the ante 85
Memphis151: posts the ante 85
JJin91: posts the ante 85
CAT@strophe: posts the ante 85
CaptN421: posts the ante 85
senor stinks: posts the ante 85
CAT@strophe: posts small blind 350
CaptN421: posts big blind 700
*** HOLE CARDS ***
Dealt to JJin91 [5s 4c]
senor stinks: folds=20
UncleQuatch: folds=20
Thucydides: folds=20
14k100g: folds=20
Memphis151: folds=20
JJin91: raises 819 to 1519
CAT@strophe: folds=20
CaptN421: folds=20
Uncalled bet (819) returned to JJin91
JJin91 collected 2430 from pot
JJin91: doesn't show hand=20
*** SUMMARY ***
Total pot 2430 | Rake 0=20
Seat 1: UncleQuatch folded before Flop (didn't bet)
Seat 2: Thucydides folded before Flop (didn't bet)
Seat 3: 14k100g folded before Flop (didn't bet)
Seat 4: Memphis151 folded before Flop (didn't bet)
Seat 5: JJin91 (button) collected (2430)
Seat 6: CAT@strophe (small blind) folded before Flop
Seat 7: CaptN421 (big blind) folded before Flop
Seat 8: senor stinks folded before Flop (didn't bet)


*********** # 134 **************
PokerStars Hand #175010869080: Tournament #1701776547, $18.20+$1.80 USD=
 Hold'em No Limit - Level XIII (350/700) - 2017/09/13 21:14:54 ET
Table '1701776547 3' 9-max Seat #6 is the button
Seat 1: UncleQuatch (18625 in chips)=20
Seat 2: Thucydides (41443 in chips)=20
Seat 3: 14k100g (32691 in chips)=20
Seat 4: Memphis151 (40889 in chips)=20
Seat 5: JJin91 (27429 in chips)=20
Seat 6: CAT@strophe (18295 in chips)=20
Seat 7: CaptN421 (16468 in chips)=20
Seat 8: senor stinks (21717 in chips)=20
UncleQuatch: posts the ante 85
Thucydides: posts the ante 85
14k100g: posts the ante 85
Memphis151: posts the ante 85
JJin91: posts the ante 85
CAT@strophe: posts the ante 85
CaptN421: posts the ante 85
senor stinks: posts the ante 85
CaptN421: posts small blind 350
senor stinks: posts big blind 700
*** HOLE CARDS ***
Dealt to JJin91 [Td Ah]
UncleQuatch: folds=20
Thucydides: raises 1170 to 1870
14k100g: folds=20
Memphis151: folds=20
JJin91: folds=20
CAT@strophe: folds=20
CaptN421: folds=20
senor stinks: folds=20
Uncalled bet (1170) returned to Thucydides
Thucydides collected 2430 from pot
Thucydides: doesn't show hand=20
*** SUMMARY ***
Total pot 2430 | Rake 0=20
Seat 1: UncleQuatch folded before Flop (didn't bet)
Seat 2: Thucydides collected (2430)
Seat 3: 14k100g folded before Flop (didn't bet)
Seat 4: Memphis151 folded before Flop (didn't bet)
Seat 5: JJin91 folded before Flop (didn't bet)
Seat 6: CAT@strophe (button) folded before Flop (didn't bet)
Seat 7: CaptN421 (small blind) folded before Flop
Seat 8: senor stinks (big blind) folded before Flop


*********** # 135 **************
PokerStars Hand #175010869232: Tournament #1701776547, $18.20+$1.80 USD=
 Hold'em No Limit - Level XIII (350/700) - 2017/09/13 21:15:29 ET
Table '1701776547 3' 9-max Seat #7 is the button
Seat 1: UncleQuatch (18540 in chips)=20
Seat 2: Thucydides (43088 in chips)=20
Seat 3: 14k100g (32606 in chips)=20
Seat 4: Memphis151 (40804 in chips)=20
Seat 5: JJin91 (27344 in chips)=20
Seat 6: CAT@strophe (18210 in chips)=20
Seat 7: CaptN421 (16033 in chips)=20
Seat 8: senor stinks (20932 in chips)=20
UncleQuatch: posts the ante 85
Thucydides: posts the ante 85
14k100g: posts the ante 85
Memphis151: posts the ante 85
JJin91: posts the ante 85
CAT@strophe: posts the ante 85
CaptN421: posts the ante 85
senor stinks: posts the ante 85
senor stinks: posts small blind 350
UncleQuatch: posts big blind 700
*** HOLE CARDS ***
Dealt to JJin91 [Jc 2s]
Thucydides: folds=20
14k100g: calls 700
Memphis151: folds=20
JJin91: folds=20
CAT@strophe: folds=20
CaptN421: raises 3130 to 3830
senor stinks: folds=20
UncleQuatch: folds=20
14k100g: calls 3130
*** FLOP *** [3s 6s 9s]
14k100g: bets 28691 and is all-in
CaptN421: calls 12118 and is all-in
Uncalled bet (16573) returned to 14k100g
*** TURN *** [3s 6s 9s] [Ah]
*** RIVER *** [3s 6s 9s Ah] [Ks]
*** SHOW DOWN ***
14k100g: shows [Kd 9h] (two pair, Kings and Nines)
CaptN421: shows [Kh As] (a flush, Ace high)
CaptN421 collected 33626 from pot
*** SUMMARY ***
Total pot 33626 | Rake 0=20
Board [3s 6s 9s Ah Ks]
Seat 1: UncleQuatch (big blind) folded before Flop
Seat 2: Thucydides folded before Flop (didn't bet)
Seat 3: 14k100g showed [Kd 9h] and lost with two pair, Kings and Nines
Seat 4: Memphis151 folded before Flop (didn't bet)
Seat 5: JJin91 folded before Flop (didn't bet)
Seat 6: CAT@strophe folded before Flop (didn't bet)
Seat 7: CaptN421 (button) showed [Kh As] and won (33626) with a flush, =
Ace high
Seat 8: senor stinks (small blind) folded before Flop


*********** # 136 **************
PokerStars Hand #175010869466: Tournament #1701776547, $18.20+$1.80 USD=
 Hold'em No Limit - Level XIII (350/700) - 2017/09/13 21:16:21 ET
Table '1701776547 3' 9-max Seat #8 is the button
Seat 1: UncleQuatch (17755 in chips)=20
Seat 2: Thucydides (43003 in chips)=20
Seat 3: 14k100g (16573 in chips)=20
Seat 4: Memphis151 (40719 in chips)=20
Seat 5: JJin91 (27259 in chips)=20
Seat 6: CAT@strophe (18125 in chips)=20
Seat 7: CaptN421 (33626 in chips)=20
Seat 8: senor stinks (20497 in chips)=20
UncleQuatch: posts the ante 85
Thucydides: posts the ante 85
14k100g: posts the ante 85
Memphis151: posts the ante 85
JJin91: posts the ante 85
CAT@strophe: posts the ante 85
CaptN421: posts the ante 85
senor stinks: posts the ante 85
UncleQuatch: posts small blind 350
Thucydides: posts big blind 700
*** HOLE CARDS ***
Dealt to JJin91 [Jc 8d]
14k100g: folds=20
Memphis151: folds=20
JJin91: folds=20
CAT@strophe: raises 1090 to 1790
CaptN421: folds=20
senor stinks: folds=20
UncleQuatch: folds=20
Thucydides: raises 4510 to 6300
CAT@strophe: folds=20
Uncalled bet (4510) returned to Thucydides
Thucydides collected 4610 from pot
Thucydides: doesn't show hand=20
*** SUMMARY ***
Total pot 4610 | Rake 0=20
Seat 1: UncleQuatch (small blind) folded before Flop
Seat 2: Thucydides (big blind) collected (4610)
Seat 3: 14k100g folded before Flop (didn't bet)
Seat 4: Memphis151 folded before Flop (didn't bet)
Seat 5: JJin91 folded before Flop (didn't bet)
Seat 6: CAT@strophe folded before Flop
Seat 7: CaptN421 folded before Flop (didn't bet)
Seat 8: senor stinks (button) folded before Flop (didn't bet)


*********** # 137 **************
PokerStars Hand #175010869649: Tournament #1701776547, $18.20+$1.80 USD=
 Hold'em No Limit - Level XIII (350/700) - 2017/09/13 21:17:07 ET
Table '1701776547 3' 9-max Seat #1 is the button
Seat 1: UncleQuatch (17320 in chips)=20
Seat 2: Thucydides (45738 in chips)=20
Seat 3: 14k100g (16488 in chips)=20
Seat 4: Memphis151 (40634 in chips)=20
Seat 5: JJin91 (27174 in chips)=20
Seat 6: CAT@strophe (16250 in chips)=20
Seat 7: CaptN421 (33541 in chips)=20
Seat 8: senor stinks (20412 in chips)=20
UncleQuatch: posts the ante 85
Thucydides: posts the ante 85
14k100g: posts the ante 85
Memphis151: posts the ante 85
JJin91: posts the ante 85
CAT@strophe: posts the ante 85
CaptN421: posts the ante 85
senor stinks: posts the ante 85
Thucydides: posts small blind 350
14k100g: posts big blind 700
*** HOLE CARDS ***
Dealt to JJin91 [7d Qs]
Memphis151: raises 700 to 1400
JJin91: folds=20
CAT@strophe: folds=20
CaptN421: folds=20
senor stinks: folds=20
UncleQuatch: folds=20
Thucydides: folds=20
14k100g: folds=20
Uncalled bet (700) returned to Memphis151
Memphis151 collected 2430 from pot
Memphis151: doesn't show hand=20
*** SUMMARY ***
Total pot 2430 | Rake 0=20
Seat 1: UncleQuatch (button) folded before Flop (didn't bet)
Seat 2: Thucydides (small blind) folded before Flop
Seat 3: 14k100g (big blind) folded before Flop
Seat 4: Memphis151 collected (2430)
Seat 5: JJin91 folded before Flop (didn't bet)
Seat 6: CAT@strophe folded before Flop (didn't bet)
Seat 7: CaptN421 folded before Flop (didn't bet)
Seat 8: senor stinks folded before Flop (didn't bet)


*********** # 138 **************
PokerStars Hand #175010869722: Tournament #1701776547, $18.20+$1.80 USD=
 Hold'em No Limit - Level XIII (350/700) - 2017/09/13 21:17:20 ET
Table '1701776547 3' 9-max Seat #2 is the button
Seat 1: UncleQuatch (17235 in chips)=20
Seat 2: Thucydides (45303 in chips)=20
Seat 3: 14k100g (15703 in chips)=20
Seat 4: Memphis151 (42279 in chips)=20
Seat 5: JJin91 (27089 in chips)=20
Seat 6: CAT@strophe (16165 in chips)=20
Seat 7: CaptN421 (33456 in chips)=20
Seat 8: senor stinks (20327 in chips)=20
UncleQuatch: posts the ante 85
Thucydides: posts the ante 85
14k100g: posts the ante 85
Memphis151: posts the ante 85
JJin91: posts the ante 85
CAT@strophe: posts the ante 85
CaptN421: posts the ante 85
senor stinks: posts the ante 85
14k100g: posts small blind 350
Memphis151: posts big blind 700
*** HOLE CARDS ***
Dealt to JJin91 [5h 4d]
JJin91: folds=20
CAT@strophe: raises 1400 to 2100
CaptN421: folds=20
senor stinks: folds=20
UncleQuatch: folds=20
Memphis151 said, "senor stinks pulls on everyone"
Thucydides: folds=20
14k100g: calls 1750
Memphis151: calls 1400
*** FLOP *** [7s Kh 2h]
14k100g: checks=20
Memphis151: checks=20
CAT@strophe: bets 2100
14k100g: calls 2100
Memphis151: raises 3500 to 5600
CAT@strophe: calls 3500
14k100g: folds=20
*** TURN *** [7s Kh 2h] [Qc]
Memphis151: bets 8400
CAT@strophe: calls 8380 and is all-in
Uncalled bet (20) returned to Memphis151
*** RIVER *** [7s Kh 2h Qc] [3h]
*** SHOW DOWN ***
Memphis151: shows [7d 7c] (three of a kind, Sevens)
CAT@strophe: shows [Ah Ac] (a pair of Aces)
CAT@strophe is sitting out
Memphis151 collected 37040 from pot
CAT@strophe finished the tournament in 41st place
*** SUMMARY ***
Total pot 37040 | Rake 0=20
Board [7s Kh 2h Qc 3h]
Seat 1: UncleQuatch folded before Flop (didn't bet)
Seat 2: Thucydides (button) folded before Flop (didn't bet)
Seat 3: 14k100g (small blind) folded on the Flop
Seat 4: Memphis151 (big blind) showed [7d 7c] and won (37040) with thre=
e of a kind, Sevens
Seat 5: JJin91 folded before Flop (didn't bet)
Seat 6: CAT@strophe showed [Ah Ac] and lost with a pair of Aces
Seat 7: CaptN421 folded before Flop (didn't bet)
Seat 8: senor stinks folded before Flop (didn't bet)


*********** # 139 **************
PokerStars Hand #175012037310: Tournament #1701776547, $18.20+$1.80 USD=
 Hold'em No Limit - Level XIII (350/700) - 2017/09/13 21:18:32 ET
Table '1701776547 3' 9-max Seat #3 is the button
Seat 1: UncleQuatch (17150 in chips)=20
Seat 2: Thucydides (45218 in chips)=20
Seat 3: 14k100g (11418 in chips)=20
Seat 4: Memphis151 (63154 in chips)=20
Seat 5: JJin91 (27004 in chips)=20
Seat 7: CaptN421 (33371 in chips)=20
Seat 8: senor stinks (20242 in chips)=20
UncleQuatch: posts the ante 85
Thucydides: posts the ante 85
14k100g: posts the ante 85
Memphis151: posts the ante 85
JJin91: posts the ante 85
CaptN421: posts the ante 85
senor stinks: posts the ante 85
Memphis151: posts small blind 350
JJin91: posts big blind 700
*** HOLE CARDS ***
Dealt to JJin91 [9h 5c]
CaptN421: folds=20
senor stinks: folds=20
UncleQuatch: folds=20
Thucydides: folds=20
14k100g: folds=20
Memphis151: calls 350
JJin91: checks=20
*** FLOP *** [4d Td Qh]
Memphis151: bets 1400
JJin91: folds=20
Uncalled bet (1400) returned to Memphis151
Memphis151 collected 1995 from pot
Memphis151: doesn't show hand=20
*** SUMMARY ***
Total pot 1995 | Rake 0=20
Board [4d Td Qh]
Seat 1: UncleQuatch folded before Flop (didn't bet)
Seat 2: Thucydides folded before Flop (didn't bet)
Seat 3: 14k100g (button) folded before Flop (didn't bet)
Seat 4: Memphis151 (small blind) collected (1995)
Seat 5: JJin91 (big blind) folded on the Flop
Seat 7: CaptN421 folded before Flop (didn't bet)
Seat 8: senor stinks folded before Flop (didn't bet)


*********** # 140 **************
PokerStars Hand #175012037424: Tournament #1701776547, $18.20+$1.80 USD=
 Hold'em No Limit - Level XIII (350/700) - 2017/09/13 21:18:59 ET
Table '1701776547 3' 9-max Seat #4 is the button
Seat 1: UncleQuatch (17065 in chips)=20
Seat 2: Thucydides (45133 in chips)=20
Seat 3: 14k100g (11333 in chips)=20
Seat 4: Memphis151 (64364 in chips)=20
Seat 5: JJin91 (26219 in chips)=20
Seat 7: CaptN421 (33286 in chips)=20
Seat 8: senor stinks (20157 in chips)=20
UncleQuatch: posts the ante 85
Thucydides: posts the ante 85
14k100g: posts the ante 85
Memphis151: posts the ante 85
JJin91: posts the ante 85
CaptN421: posts the ante 85
senor stinks: posts the ante 85
JJin91: posts small blind 350
CaptN421: posts big blind 700
*** HOLE CARDS ***
Dealt to JJin91 [Qh 5h]
senor stinks: folds=20
UncleQuatch: folds=20
Thucydides: folds=20
14k100g: folds=20
Memphis151: calls 700
JJin91: folds=20
CaptN421: checks=20
*** FLOP *** [7d Jc 2d]
CaptN421: checks=20
Memphis151: bets 1400
CaptN421: folds=20
Uncalled bet (1400) returned to Memphis151
Memphis151 collected 2345 from pot
Memphis151: doesn't show hand=20
*** SUMMARY ***
Total pot 2345 | Rake 0=20
Board [7d Jc 2d]
Seat 1: UncleQuatch folded before Flop (didn't bet)
Seat 2: Thucydides folded before Flop (didn't bet)
Seat 3: 14k100g folded before Flop (didn't bet)
Seat 4: Memphis151 (button) collected (2345)
Seat 5: JJin91 (small blind) folded before Flop
Seat 7: CaptN421 (big blind) folded on the Flop
Seat 8: senor stinks folded before Flop (didn't bet)


*********** # 141 **************
PokerStars Hand #175012037543: Tournament #1701776547, $18.20+$1.80 USD=
 Hold'em No Limit - Level XIII (350/700) - 2017/09/13 21:19:26 ET
Table '1701776547 3' 9-max Seat #5 is the button
Seat 1: UncleQuatch (16980 in chips)=20
Seat 2: Thucydides (45048 in chips)=20
Seat 3: 14k100g (11248 in chips)=20
Seat 4: Memphis151 (65924 in chips)=20
Seat 5: JJin91 (25784 in chips)=20
Seat 7: CaptN421 (32501 in chips)=20
Seat 8: senor stinks (20072 in chips)=20
UncleQuatch: posts the ante 85
Thucydides: posts the ante 85
14k100g: posts the ante 85
Memphis151: posts the ante 85
JJin91: posts the ante 85
CaptN421: posts the ante 85
senor stinks: posts the ante 85
CaptN421: posts small blind 350
senor stinks: posts big blind 700
*** HOLE CARDS ***
Dealt to JJin91 [Ah Qd]
UncleQuatch: folds=20
Thucydides: folds=20
14k100g: calls 700
Memphis151: calls 700
JJin91: raises 1755 to 2455
CaptN421: folds=20
senor stinks: folds=20
14k100g: calls 1755
Memphis151: calls 1755
*** FLOP *** [8s 2d Jc]
14k100g: checks=20
Memphis151: checks=20
JJin91: checks=20
*** TURN *** [8s 2d Jc] [Js]
14k100g: bets 4200
Memphis151: raises 4200 to 8400
JJin91: folds=20
14k100g: folds=20
Uncalled bet (4200) returned to Memphis151
Memphis151 collected 17410 from pot
Memphis151: doesn't show hand=20
*** SUMMARY ***
Total pot 17410 | Rake 0=20
Board [8s 2d Jc Js]
Seat 1: UncleQuatch folded before Flop (didn't bet)
Seat 2: Thucydides folded before Flop (didn't bet)
Seat 3: 14k100g folded on the Turn
Seat 4: Memphis151 collected (17410)
Seat 5: JJin91 (button) folded on the Turn
Seat 7: CaptN421 (small blind) folded before Flop
Seat 8: senor stinks (big blind) folded before Flop


*********** # 142 **************
PokerStars Hand #175012037753: Tournament #1701776547, $18.20+$1.80 USD=
 Hold'em No Limit - Level XIII (350/700) - 2017/09/13 21:20:16 ET
Table '1701776547 3' 9-max Seat #7 is the button
Seat 1: UncleQuatch (16895 in chips)=20
Seat 2: Thucydides (44963 in chips)=20
Seat 3: 14k100g (4508 in chips)=20
Seat 4: Memphis151 (76594 in chips)=20
Seat 5: JJin91 (23244 in chips)=20
Seat 7: CaptN421 (32066 in chips)=20
Seat 8: senor stinks (19287 in chips)=20
UncleQuatch: posts the ante 85
Thucydides: posts the ante 85
14k100g: posts the ante 85
Memphis151: posts the ante 85
JJin91: posts the ante 85
CaptN421: posts the ante 85
senor stinks: posts the ante 85
senor stinks: posts small blind 350
UncleQuatch: posts big blind 700
*** HOLE CARDS ***
Dealt to JJin91 [Tc Ks]
Thucydides: raises 1100 to 1800
14k100g: folds=20
Memphis151: folds=20
JJin91: folds=20
CaptN421: raises 1800 to 3600
senor stinks: folds=20
UncleQuatch: folds=20
Thucydides: calls 1800
*** FLOP *** [9c As 2h]
Thucydides: checks=20
CaptN421: bets 6687
Thucydides: calls 6687
*** TURN *** [9c As 2h] [Kc]
Thucydides: checks=20
CaptN421: bets 14422
Thucydides: raises 20169 to 34591 and is all-in
CaptN421: calls 7272 and is all-in
Uncalled bet (12897) returned to Thucydides
*** RIVER *** [9c As 2h Kc] [7c]
*** SHOW DOWN ***
Thucydides: shows [Ah Jd] (a pair of Aces)
CaptN421: shows [Kd 6d] (a pair of Kings)
Thucydides collected 65607 from pot
CaptN421 finished the tournament in 37th place
*** SUMMARY ***
Total pot 65607 | Rake 0=20
Board [9c As 2h Kc 7c]
Seat 1: UncleQuatch (big blind) folded before Flop
Seat 2: Thucydides showed [Ah Jd] and won (65607) with a pair of Aces
Seat 3: 14k100g folded before Flop (didn't bet)
Seat 4: Memphis151 folded before Flop (didn't bet)
Seat 5: JJin91 folded before Flop (didn't bet)
Seat 7: CaptN421 (button) showed [Kd 6d] and lost with a pair of Kings
Seat 8: senor stinks (small blind) folded before Flop


*********** # 143 **************
PokerStars Hand #175012038335: Tournament #1701776547, $18.20+$1.80 USD=
 Hold'em No Limit - Level XIV (400/800) - 2017/09/13 21:22:42 ET
Table '1701776547 9' 9-max Seat #8 is the button
Seat 1: s.l. halper (31603 in chips)=20
Seat 2: TobogganM.D. (15448 in chips)=20
Seat 3: Bsgwolfpack4 (52811 in chips)=20
Seat 4: senor stinks (18852 in chips)=20
Seat 5: JJin91 (23159 in chips)=20
Seat 6: zBeanHeaDz (23004 in chips)=20
Seat 7: SJMayhem11 (17615 in chips)=20
Seat 8: joeyrup (34333 in chips)=20
Seat 9: Bar.usWYGRAM (33233 in chips)=20
s.l. halper: posts the ante 100
TobogganM.D.: posts the ante 100
Bsgwolfpack4: posts the ante 100
senor stinks: posts the ante 100
JJin91: posts the ante 100
zBeanHeaDz: posts the ante 100
SJMayhem11: posts the ante 100
joeyrup: posts the ante 100
Bar.usWYGRAM: posts the ante 100
Bar.usWYGRAM: posts small blind 400
s.l. halper: posts big blind 800
*** HOLE CARDS ***
Dealt to JJin91 [6d As]
TobogganM.D.: folds=20
Bsgwolfpack4: folds=20
senor stinks: raises 1000 to 1800
JJin91: folds=20
zBeanHeaDz: folds=20
SJMayhem11: calls 1800
joeyrup: folds=20
Bar.usWYGRAM: folds=20
s.l. halper: folds=20
*** FLOP *** [Qs Jc Js]
senor stinks: checks=20
SJMayhem11: checks=20
*** TURN *** [Qs Jc Js] [3h]
senor stinks: checks=20
SJMayhem11: bets 1600
senor stinks: folds=20
Uncalled bet (1600) returned to SJMayhem11
SJMayhem11 collected 5700 from pot
SJMayhem11: doesn't show hand=20
*** SUMMARY ***
Total pot 5700 | Rake 0=20
Board [Qs Jc Js 3h]
Seat 1: s.l. halper (big blind) folded before Flop
Seat 2: TobogganM.D. folded before Flop (didn't bet)
Seat 3: Bsgwolfpack4 folded before Flop (didn't bet)
Seat 4: senor stinks folded on the Turn
Seat 5: JJin91 folded before Flop (didn't bet)
Seat 6: zBeanHeaDz folded before Flop (didn't bet)
Seat 7: SJMayhem11 collected (5700)
Seat 8: joeyrup (button) folded before Flop (didn't bet)
Seat 9: Bar.usWYGRAM (small blind) folded before Flop


*********** # 144 **************
PokerStars Hand #175012038567: Tournament #1701776547, $18.20+$1.80 USD=
 Hold'em No Limit - Level XIV (400/800) - 2017/09/13 21:23:41 ET
Table '1701776547 9' 9-max Seat #9 is the button
Seat 1: s.l. halper (30703 in chips)=20
Seat 2: TobogganM.D. (15348 in chips)=20
Seat 3: Bsgwolfpack4 (52711 in chips)=20
Seat 4: senor stinks (16952 in chips)=20
Seat 5: JJin91 (23059 in chips)=20
Seat 6: zBeanHeaDz (22904 in chips)=20
Seat 7: SJMayhem11 (21415 in chips)=20
Seat 8: joeyrup (34233 in chips)=20
Seat 9: Bar.usWYGRAM (32733 in chips)=20
s.l. halper: posts the ante 100
TobogganM.D.: posts the ante 100
Bsgwolfpack4: posts the ante 100
senor stinks: posts the ante 100
JJin91: posts the ante 100
zBeanHeaDz: posts the ante 100
SJMayhem11: posts the ante 100
joeyrup: posts the ante 100
Bar.usWYGRAM: posts the ante 100
s.l. halper: posts small blind 400
TobogganM.D.: posts big blind 800
*** HOLE CARDS ***
Dealt to JJin91 [3c 7s]
Bsgwolfpack4: folds=20
senor stinks: folds=20
JJin91: folds=20
zBeanHeaDz: raises 1128 to 1928
SJMayhem11: folds=20
joeyrup: folds=20
Bar.usWYGRAM: folds=20
s.l. halper: folds=20
TobogganM.D.: calls 1128
*** FLOP *** [4s Ac 5s]
TobogganM.D.: checks=20
zBeanHeaDz: bets 1959
TobogganM.D.: calls 1959
*** TURN *** [4s Ac 5s] [5d]
TobogganM.D.: checks=20
zBeanHeaDz: checks=20
*** RIVER *** [4s Ac 5s 5d] [Kh]
TobogganM.D.: bets 11361 and is all-in
zBeanHeaDz: folds=20
Uncalled bet (11361) returned to TobogganM.D.
TobogganM.D. collected 9074 from pot
TobogganM.D.: doesn't show hand=20
*** SUMMARY ***
Total pot 9074 | Rake 0=20
Board [4s Ac 5s 5d Kh]
Seat 1: s.l. halper (small blind) folded before Flop
Seat 2: TobogganM.D. (big blind) collected (9074)
Seat 3: Bsgwolfpack4 folded before Flop (didn't bet)
Seat 4: senor stinks folded before Flop (didn't bet)
Seat 5: JJin91 folded before Flop (didn't bet)
Seat 6: zBeanHeaDz folded on the River
Seat 7: SJMayhem11 folded before Flop (didn't bet)
Seat 8: joeyrup folded before Flop (didn't bet)
Seat 9: Bar.usWYGRAM (button) folded before Flop (didn't bet)


*********** # 145 **************
PokerStars Hand #175012038920: Tournament #1701776547, $18.20+$1.80 USD=
 Hold'em No Limit - Level XIV (400/800) - 2017/09/13 21:25:08 ET
Table '1701776547 9' 9-max Seat #1 is the button
Seat 1: s.l. halper (30203 in chips)=20
Seat 2: TobogganM.D. (20435 in chips)=20
Seat 3: Bsgwolfpack4 (52611 in chips)=20
Seat 4: senor stinks (16852 in chips)=20
Seat 5: JJin91 (22959 in chips)=20
Seat 6: zBeanHeaDz (18917 in chips)=20
Seat 7: SJMayhem11 (21315 in chips)=20
Seat 8: joeyrup (34133 in chips)=20
Seat 9: Bar.usWYGRAM (32633 in chips)=20
s.l. halper: posts the ante 100
TobogganM.D.: posts the ante 100
Bsgwolfpack4: posts the ante 100
senor stinks: posts the ante 100
JJin91: posts the ante 100
zBeanHeaDz: posts the ante 100
SJMayhem11: posts the ante 100
joeyrup: posts the ante 100
Bar.usWYGRAM: posts the ante 100
TobogganM.D.: posts small blind 400
Bsgwolfpack4: posts big blind 800
*** HOLE CARDS ***
Dealt to JJin91 [5s As]
senor stinks: folds=20
JJin91: folds=20
zBeanHeaDz: folds=20
SJMayhem11: raises 800 to 1600
joeyrup: folds=20
Bar.usWYGRAM: folds=20
s.l. halper: folds=20
TobogganM.D.: folds=20
Bsgwolfpack4: folds=20
Uncalled bet (800) returned to SJMayhem11
SJMayhem11 collected 2900 from pot
SJMayhem11: doesn't show hand=20
*** SUMMARY ***
Total pot 2900 | Rake 0=20
Seat 1: s.l. halper (button) folded before Flop (didn't bet)
Seat 2: TobogganM.D. (small blind) folded before Flop
Seat 3: Bsgwolfpack4 (big blind) folded before Flop
Seat 4: senor stinks folded before Flop (didn't bet)
Seat 5: JJin91 folded before Flop (didn't bet)
Seat 6: zBeanHeaDz folded before Flop (didn't bet)
Seat 7: SJMayhem11 collected (2900)
Seat 8: joeyrup folded before Flop (didn't bet)
Seat 9: Bar.usWYGRAM folded before Flop (didn't bet)


*********** # 146 **************
PokerStars Hand #175012039108: Tournament #1701776547, $18.20+$1.80 USD=
 Hold'em No Limit - Level XIV (400/800) - 2017/09/13 21:25:54 ET
Table '1701776547 9' 9-max Seat #2 is the button
Seat 1: s.l. halper (30103 in chips)=20
Seat 2: TobogganM.D. (19935 in chips)=20
Seat 3: Bsgwolfpack4 (51711 in chips)=20
Seat 4: senor stinks (16752 in chips)=20
Seat 5: JJin91 (22859 in chips)=20
Seat 6: zBeanHeaDz (18817 in chips)=20
Seat 7: SJMayhem11 (23315 in chips)=20
Seat 8: joeyrup (34033 in chips)=20
Seat 9: Bar.usWYGRAM (32533 in chips)=20
s.l. halper: posts the ante 100
TobogganM.D.: posts the ante 100
Bsgwolfpack4: posts the ante 100
senor stinks: posts the ante 100
JJin91: posts the ante 100
zBeanHeaDz: posts the ante 100
SJMayhem11: posts the ante 100
joeyrup: posts the ante 100
Bar.usWYGRAM: posts the ante 100
Bsgwolfpack4: posts small blind 400
senor stinks: posts big blind 800
*** HOLE CARDS ***
Dealt to JJin91 [Kh 6c]
JJin91: folds=20
zBeanHeaDz: folds=20
SJMayhem11: folds=20
joeyrup: folds=20
Bar.usWYGRAM: folds=20
s.l. halper: folds=20
TobogganM.D.: folds=20
Bsgwolfpack4: calls 400
senor stinks: checks=20
*** FLOP *** [8s 2c 4c]
Bsgwolfpack4: checks=20
senor stinks: bets 800
Bsgwolfpack4: folds=20
Uncalled bet (800) returned to senor stinks
senor stinks collected 2500 from pot
senor stinks: doesn't show hand=20
*** SUMMARY ***
Total pot 2500 | Rake 0=20
Board [8s 2c 4c]
Seat 1: s.l. halper folded before Flop (didn't bet)
Seat 2: TobogganM.D. (button) folded before Flop (didn't bet)
Seat 3: Bsgwolfpack4 (small blind) folded on the Flop
Seat 4: senor stinks (big blind) collected (2500)
Seat 5: JJin91 folded before Flop (didn't bet)
Seat 6: zBeanHeaDz folded before Flop (didn't bet)
Seat 7: SJMayhem11 folded before Flop (didn't bet)
Seat 8: joeyrup folded before Flop (didn't bet)
Seat 9: Bar.usWYGRAM folded before Flop (didn't bet)


*********** # 147 **************
PokerStars Hand #175012039268: Tournament #1701776547, $18.20+$1.80 USD=
 Hold'em No Limit - Level XIV (400/800) - 2017/09/13 21:26:32 ET
Table '1701776547 9' 9-max Seat #3 is the button
Seat 1: s.l. halper (30003 in chips)=20
Seat 2: TobogganM.D. (19835 in chips)=20
Seat 3: Bsgwolfpack4 (50811 in chips)=20
Seat 4: senor stinks (18352 in chips)=20
Seat 5: JJin91 (22759 in chips)=20
Seat 6: zBeanHeaDz (18717 in chips)=20
Seat 7: SJMayhem11 (23215 in chips)=20
Seat 8: joeyrup (33933 in chips)=20
Seat 9: Bar.usWYGRAM (32433 in chips)=20
s.l. halper: posts the ante 100
TobogganM.D.: posts the ante 100
Bsgwolfpack4: posts the ante 100
senor stinks: posts the ante 100
JJin91: posts the ante 100
zBeanHeaDz: posts the ante 100
SJMayhem11: posts the ante 100
joeyrup: posts the ante 100
Bar.usWYGRAM: posts the ante 100
senor stinks: posts small blind 400
JJin91: posts big blind 800
*** HOLE CARDS ***
Dealt to JJin91 [2h 5s]
zBeanHeaDz: folds=20
SJMayhem11: folds=20
joeyrup: folds=20
Bar.usWYGRAM: folds=20
s.l. halper: folds=20
TobogganM.D.: folds=20
Bsgwolfpack4: folds=20
senor stinks: calls 400
JJin91: checks=20
*** FLOP *** [2s 3h 9c]
senor stinks: checks=20
JJin91: bets 1275
senor stinks: calls 1275
*** TURN *** [2s 3h 9c] [6d]
senor stinks: checks=20
JJin91: checks=20
*** RIVER *** [2s 3h 9c 6d] [8s]
senor stinks: checks=20
JJin91: checks=20
*** SHOW DOWN ***
senor stinks: shows [Ac 7h] (high card Ace)
JJin91: shows [2h 5s] (a pair of Deuces)
JJin91 collected 5050 from pot
*** SUMMARY ***
Total pot 5050 | Rake 0=20
Board [2s 3h 9c 6d 8s]
Seat 1: s.l. halper folded before Flop (didn't bet)
Seat 2: TobogganM.D. folded before Flop (didn't bet)
Seat 3: Bsgwolfpack4 (button) folded before Flop (didn't bet)
Seat 4: senor stinks (small blind) showed [Ac 7h] and lost with high ca=
rd Ace
Seat 5: JJin91 (big blind) showed [2h 5s] and won (5050) with a pair of=
 Deuces
Seat 6: zBeanHeaDz folded before Flop (didn't bet)
Seat 7: SJMayhem11 folded before Flop (didn't bet)
Seat 8: joeyrup folded before Flop (didn't bet)
Seat 9: Bar.usWYGRAM folded before Flop (didn't bet)


*********** # 148 **************
PokerStars Hand #175012039603: Tournament #1701776547, $18.20+$1.80 USD=
 Hold'em No Limit - Level XIV (400/800) - 2017/09/13 21:27:56 ET
Table '1701776547 9' 9-max Seat #4 is the button
Seat 1: s.l. halper (29903 in chips)=20
Seat 2: TobogganM.D. (19735 in chips)=20
Seat 3: Bsgwolfpack4 (50711 in chips)=20
Seat 4: senor stinks (16177 in chips)=20
Seat 5: JJin91 (25634 in chips)=20
Seat 6: zBeanHeaDz (18617 in chips)=20
Seat 7: SJMayhem11 (23115 in chips)=20
Seat 8: joeyrup (33833 in chips)=20
Seat 9: Bar.usWYGRAM (32333 in chips)=20
s.l. halper: posts the ante 100
TobogganM.D.: posts the ante 100
Bsgwolfpack4: posts the ante 100
senor stinks: posts the ante 100
JJin91: posts the ante 100
zBeanHeaDz: posts the ante 100
SJMayhem11: posts the ante 100
joeyrup: posts the ante 100
Bar.usWYGRAM: posts the ante 100
JJin91: posts small blind 400
zBeanHeaDz: posts big blind 800
*** HOLE CARDS ***
Dealt to JJin91 [6s 2s]
SJMayhem11: calls 800
joeyrup: folds=20
Bar.usWYGRAM: calls 800
s.l. halper: folds=20
TobogganM.D.: folds=20
Bsgwolfpack4: raises 3000 to 3800
senor stinks: folds=20
JJin91: folds=20
zBeanHeaDz: folds=20
SJMayhem11: folds=20
Bar.usWYGRAM: folds=20
Uncalled bet (3000) returned to Bsgwolfpack4
Bsgwolfpack4 collected 4500 from pot
*** SUMMARY ***
Total pot 4500 | Rake 0=20
Seat 1: s.l. halper folded before Flop (didn't bet)
Seat 2: TobogganM.D. folded before Flop (didn't bet)
Seat 3: Bsgwolfpack4 collected (4500)
Seat 4: senor stinks (button) folded before Flop (didn't bet)
Seat 5: JJin91 (small blind) folded before Flop
Seat 6: zBeanHeaDz (big blind) folded before Flop
Seat 7: SJMayhem11 folded before Flop
Seat 8: joeyrup folded before Flop (didn't bet)
Seat 9: Bar.usWYGRAM folded before Flop


*********** # 149 **************
PokerStars Hand #175012039761: Tournament #1701776547, $18.20+$1.80 USD=
 Hold'em No Limit - Level XIV (400/800) - 2017/09/13 21:28:33 ET
Table '1701776547 9' 9-max Seat #5 is the button
Seat 1: s.l. halper (29803 in chips)=20
Seat 2: TobogganM.D. (19635 in chips)=20
Seat 3: Bsgwolfpack4 (54311 in chips)=20
Seat 4: senor stinks (16077 in chips)=20
Seat 5: JJin91 (25134 in chips)=20
Seat 6: zBeanHeaDz (17717 in chips)=20
Seat 7: SJMayhem11 (22215 in chips)=20
Seat 8: joeyrup (33733 in chips)=20
Seat 9: Bar.usWYGRAM (31433 in chips)=20
s.l. halper: posts the ante 100
TobogganM.D.: posts the ante 100
Bsgwolfpack4: posts the ante 100
senor stinks: posts the ante 100
JJin91: posts the ante 100
zBeanHeaDz: posts the ante 100
SJMayhem11: posts the ante 100
joeyrup: posts the ante 100
Bar.usWYGRAM: posts the ante 100
zBeanHeaDz: posts small blind 400
SJMayhem11: posts big blind 800
*** HOLE CARDS ***
Dealt to JJin91 [Js 6d]
joeyrup: folds=20
Bar.usWYGRAM: folds=20
s.l. halper: folds=20
TobogganM.D.: raises 17000 to 17800
Bsgwolfpack4: folds=20
senor stinks: folds=20
JJin91: folds=20
zBeanHeaDz: folds=20
SJMayhem11: folds=20
Uncalled bet (17000) returned to TobogganM.D.
TobogganM.D. collected 2900 from pot
TobogganM.D.: doesn't show hand=20
*** SUMMARY ***
Total pot 2900 | Rake 0=20
Seat 1: s.l. halper folded before Flop (didn't bet)
Seat 2: TobogganM.D. collected (2900)
Seat 3: Bsgwolfpack4 folded before Flop (didn't bet)
Seat 4: senor stinks folded before Flop (didn't bet)
Seat 5: JJin91 (button) folded before Flop (didn't bet)
Seat 6: zBeanHeaDz (small blind) folded before Flop
Seat 7: SJMayhem11 (big blind) folded before Flop
Seat 8: joeyrup folded before Flop (didn't bet)
Seat 9: Bar.usWYGRAM folded before Flop (didn't bet)


*********** # 150 **************
PokerStars Hand #175012039877: Tournament #1701776547, $18.20+$1.80 USD=
 Hold'em No Limit - Level XIV (400/800) - 2017/09/13 21:29:04 ET
Table '1701776547 9' 9-max Seat #6 is the button
Seat 1: s.l. halper (29703 in chips)=20
Seat 2: TobogganM.D. (21635 in chips)=20
Seat 3: Bsgwolfpack4 (54211 in chips)=20
Seat 4: senor stinks (15977 in chips)=20
Seat 5: JJin91 (25034 in chips)=20
Seat 6: zBeanHeaDz (17217 in chips)=20
Seat 7: SJMayhem11 (21315 in chips)=20
Seat 8: joeyrup (33633 in chips)=20
Seat 9: Bar.usWYGRAM (31333 in chips)=20
s.l. halper: posts the ante 100
TobogganM.D.: posts the ante 100
Bsgwolfpack4: posts the ante 100
senor stinks: posts the ante 100
JJin91: posts the ante 100
zBeanHeaDz: posts the ante 100
SJMayhem11: posts the ante 100
joeyrup: posts the ante 100
Bar.usWYGRAM: posts the ante 100
SJMayhem11: posts small blind 400
joeyrup: posts big blind 800
*** HOLE CARDS ***
Dealt to JJin91 [Qh 7d]
Bar.usWYGRAM: folds=20
s.l. halper: folds=20
TobogganM.D.: folds=20
Bsgwolfpack4: folds=20
senor stinks: folds=20
JJin91: folds=20
zBeanHeaDz: folds=20
SJMayhem11: raises 800 to 1600
joeyrup: calls 800
*** FLOP *** [9d Qd Ah]
SJMayhem11: bets 2050
joeyrup: folds=20
Uncalled bet (2050) returned to SJMayhem11
SJMayhem11 collected 4100 from pot
SJMayhem11: doesn't show hand=20
*** SUMMARY ***
Total pot 4100 | Rake 0=20
Board [9d Qd Ah]
Seat 1: s.l. halper folded before Flop (didn't bet)
Seat 2: TobogganM.D. folded before Flop (didn't bet)
Seat 3: Bsgwolfpack4 folded before Flop (didn't bet)
Seat 4: senor stinks folded before Flop (didn't bet)
Seat 5: JJin91 folded before Flop (didn't bet)
Seat 6: zBeanHeaDz (button) folded before Flop (didn't bet)
Seat 7: SJMayhem11 (small blind) collected (4100)
Seat 8: joeyrup (big blind) folded on the Flop
Seat 9: Bar.usWYGRAM folded before Flop (didn't bet)


*********** # 151 **************
PokerStars Hand #175012611786: Tournament #1701776547, $18.20+$1.80 USD=
 Hold'em No Limit - Level XIV (400/800) - 2017/09/13 21:29:52 ET
Table '1701776547 9' 9-max Seat #7 is the button
Seat 1: s.l. halper (29603 in chips)=20
Seat 2: TobogganM.D. (21535 in chips)=20
Seat 3: Bsgwolfpack4 (54111 in chips)=20
Seat 4: senor stinks (15877 in chips)=20
Seat 5: JJin91 (24934 in chips)=20
Seat 6: zBeanHeaDz (17117 in chips)=20
Seat 7: SJMayhem11 (23715 in chips)=20
Seat 8: joeyrup (31933 in chips)=20
Seat 9: Bar.usWYGRAM (31233 in chips)=20
s.l. halper: posts the ante 100
TobogganM.D.: posts the ante 100
Bsgwolfpack4: posts the ante 100
senor stinks: posts the ante 100
JJin91: posts the ante 100
zBeanHeaDz: posts the ante 100
SJMayhem11: posts the ante 100
joeyrup: posts the ante 100
Bar.usWYGRAM: posts the ante 100
joeyrup: posts small blind 400
Bar.usWYGRAM: posts big blind 800
*** HOLE CARDS ***
Dealt to JJin91 [Qc 2c]
s.l. halper: folds=20
TobogganM.D.: folds=20
Bsgwolfpack4: raises 1600 to 2400
senor stinks: folds=20
JJin91: folds=20
zBeanHeaDz: folds=20
SJMayhem11: folds=20
joeyrup: folds=20
Bar.usWYGRAM: folds=20
Uncalled bet (1600) returned to Bsgwolfpack4
Bsgwolfpack4 collected 2900 from pot
*** SUMMARY ***
Total pot 2900 | Rake 0=20
Seat 1: s.l. halper folded before Flop (didn't bet)
Seat 2: TobogganM.D. folded before Flop (didn't bet)
Seat 3: Bsgwolfpack4 collected (2900)
Seat 4: senor stinks folded before Flop (didn't bet)
Seat 5: JJin91 folded before Flop (didn't bet)
Seat 6: zBeanHeaDz folded before Flop (didn't bet)
Seat 7: SJMayhem11 (button) folded before Flop (didn't bet)
Seat 8: joeyrup (small blind) folded before Flop
Seat 9: Bar.usWYGRAM (big blind) folded before Flop


*********** # 152 **************
PokerStars Hand #175012611952: Tournament #1701776547, $18.20+$1.80 USD=
 Hold'em No Limit - Level XIV (400/800) - 2017/09/13 21:30:33 ET
Table '1701776547 9' 9-max Seat #8 is the button
Seat 1: s.l. halper (29503 in chips)=20
Seat 2: TobogganM.D. (21435 in chips)=20
Seat 3: Bsgwolfpack4 (56111 in chips)=20
Seat 4: senor stinks (15777 in chips)=20
Seat 5: JJin91 (24834 in chips)=20
Seat 6: zBeanHeaDz (17017 in chips)=20
Seat 7: SJMayhem11 (23615 in chips)=20
Seat 8: joeyrup (31433 in chips)=20
Seat 9: Bar.usWYGRAM (30333 in chips)=20
s.l. halper: posts the ante 100
TobogganM.D.: posts the ante 100
Bsgwolfpack4: posts the ante 100
senor stinks: posts the ante 100
JJin91: posts the ante 100
zBeanHeaDz: posts the ante 100
SJMayhem11: posts the ante 100
joeyrup: posts the ante 100
Bar.usWYGRAM: posts the ante 100
Bar.usWYGRAM: posts small blind 400
s.l. halper: posts big blind 800
*** HOLE CARDS ***
Dealt to JJin91 [8s 2h]
TobogganM.D.: folds=20
Bsgwolfpack4: folds=20
senor stinks: folds=20
JJin91: folds=20
zBeanHeaDz: folds=20
SJMayhem11: folds=20
joeyrup: raises 1600 to 2400
Bar.usWYGRAM: calls 2000
s.l. halper: folds=20
*** FLOP *** [Jc 9c Tc]
Bar.usWYGRAM: checks=20
joeyrup: bets 4000
Bar.usWYGRAM: calls 4000
*** TURN *** [Jc 9c Tc] [2c]
Bar.usWYGRAM: checks=20
joeyrup: checks=20
*** RIVER *** [Jc 9c Tc 2c] [7s]
Bar.usWYGRAM: checks=20
joeyrup: checks=20
*** SHOW DOWN ***
Bar.usWYGRAM: shows [7c 7h] (a flush, Jack high)
joeyrup: mucks hand=20
Bar.usWYGRAM collected 14500 from pot
*** SUMMARY ***
Total pot 14500 | Rake 0=20
Board [Jc 9c Tc 2c 7s]
Seat 1: s.l. halper (big blind) folded before Flop
Seat 2: TobogganM.D. folded before Flop (didn't bet)
Seat 3: Bsgwolfpack4 folded before Flop (didn't bet)
Seat 4: senor stinks folded before Flop (didn't bet)
Seat 5: JJin91 folded before Flop (didn't bet)
Seat 6: zBeanHeaDz folded before Flop (didn't bet)
Seat 7: SJMayhem11 folded before Flop (didn't bet)
Seat 8: joeyrup (button) mucked [Ts Js]
Seat 9: Bar.usWYGRAM (small blind) showed [7c 7h] and won (14500) with =
a flush, Jack high


*********** # 153 **************
PokerStars Hand #175012612105: Tournament #1701776547, $18.20+$1.80 USD=
 Hold'em No Limit - Level XIV (400/800) - 2017/09/13 21:31:16 ET
Table '1701776547 9' 9-max Seat #9 is the button
Seat 1: s.l. halper (28603 in chips)=20
Seat 2: TobogganM.D. (21335 in chips)=20
Seat 3: Bsgwolfpack4 (56011 in chips)=20
Seat 4: senor stinks (15677 in chips)=20
Seat 5: JJin91 (24734 in chips)=20
Seat 6: zBeanHeaDz (16917 in chips)=20
Seat 7: SJMayhem11 (23515 in chips)=20
Seat 8: joeyrup (24933 in chips)=20
Seat 9: Bar.usWYGRAM (38333 in chips)=20
s.l. halper: posts the ante 100
TobogganM.D.: posts the ante 100
Bsgwolfpack4: posts the ante 100
senor stinks: posts the ante 100
JJin91: posts the ante 100
zBeanHeaDz: posts the ante 100
SJMayhem11: posts the ante 100
joeyrup: posts the ante 100
Bar.usWYGRAM: posts the ante 100
s.l. halper: posts small blind 400
TobogganM.D.: posts big blind 800
*** HOLE CARDS ***
Dealt to JJin91 [7d 8c]
Bsgwolfpack4: folds=20
senor stinks: folds=20
JJin91: folds=20
zBeanHeaDz: folds=20
SJMayhem11: raises 800 to 1600
joeyrup: calls 1600
Bar.usWYGRAM: folds=20
s.l. halper: raises 3455 to 5055
TobogganM.D.: folds=20
SJMayhem11: folds=20
joeyrup: folds=20
Uncalled bet (3455) returned to s.l. halper
s.l. halper collected 6500 from pot
s.l. halper: doesn't show hand=20
*** SUMMARY ***
Total pot 6500 | Rake 0=20
Seat 1: s.l. halper (small blind) collected (6500)
Seat 2: TobogganM.D. (big blind) folded before Flop
Seat 3: Bsgwolfpack4 folded before Flop (didn't bet)
Seat 4: senor stinks folded before Flop (didn't bet)
Seat 5: JJin91 folded before Flop (didn't bet)
Seat 6: zBeanHeaDz folded before Flop (didn't bet)
Seat 7: SJMayhem11 folded before Flop
Seat 8: joeyrup folded before Flop
Seat 9: Bar.usWYGRAM (button) folded before Flop (didn't bet)


*********** # 154 **************
PokerStars Hand #175012612371: Tournament #1701776547, $18.20+$1.80 USD=
 Hold'em No Limit - Level XV (500/1000) - 2017/09/13 21:32:31 ET
Table '1701776547 9' 9-max Seat #1 is the button
Seat 1: s.l. halper (33403 in chips)=20
Seat 2: TobogganM.D. (20435 in chips)=20
Seat 3: Bsgwolfpack4 (55911 in chips)=20
Seat 4: senor stinks (15577 in chips)=20
Seat 5: JJin91 (24634 in chips)=20
Seat 6: zBeanHeaDz (16817 in chips)=20
Seat 7: SJMayhem11 (21815 in chips)=20
Seat 8: joeyrup (23233 in chips)=20
Seat 9: Bar.usWYGRAM (38233 in chips)=20
s.l. halper: posts the ante 125
TobogganM.D.: posts the ante 125
Bsgwolfpack4: posts the ante 125
senor stinks: posts the ante 125
JJin91: posts the ante 125
zBeanHeaDz: posts the ante 125
SJMayhem11: posts the ante 125
joeyrup: posts the ante 125
Bar.usWYGRAM: posts the ante 125
TobogganM.D.: posts small blind 500
Bsgwolfpack4: posts big blind 1000
*** HOLE CARDS ***
Dealt to JJin91 [Qs 7s]
senor stinks: folds=20
JJin91: folds=20
zBeanHeaDz: raises 1120 to 2120
SJMayhem11: folds=20
joeyrup: calls 2120
Bar.usWYGRAM: calls 2120
s.l. halper: folds=20
TobogganM.D.: folds=20
Bsgwolfpack4: calls 1120
*** FLOP *** [8s Jh Jd]
Bsgwolfpack4: checks=20
zBeanHeaDz: checks=20
joeyrup: checks=20
Bar.usWYGRAM: checks=20
*** TURN *** [8s Jh Jd] [5d]
Bsgwolfpack4: checks=20
zBeanHeaDz: checks=20
joeyrup: checks=20
Bar.usWYGRAM: bets 2500
Bsgwolfpack4: folds=20
zBeanHeaDz: folds=20
joeyrup: folds=20
Uncalled bet (2500) returned to Bar.usWYGRAM
Bar.usWYGRAM collected 10105 from pot
Bar.usWYGRAM said, "LOL"
*** SUMMARY ***
Total pot 10105 | Rake 0=20
Board [8s Jh Jd 5d]
Seat 1: s.l. halper (button) folded before Flop (didn't bet)
Seat 2: TobogganM.D. (small blind) folded before Flop
Seat 3: Bsgwolfpack4 (big blind) folded on the Turn
Seat 4: senor stinks folded before Flop (didn't bet)
Seat 5: JJin91 folded before Flop (didn't bet)
Seat 6: zBeanHeaDz folded on the Turn
Seat 7: SJMayhem11 folded before Flop (didn't bet)
Seat 8: joeyrup folded on the Turn
Seat 9: Bar.usWYGRAM collected (10105)


*********** # 155 **************
PokerStars Hand #175012612693: Tournament #1701776547, $18.20+$1.80 USD=
 Hold'em No Limit - Level XV (500/1000) - 2017/09/13 21:33:59 ET
Table '1701776547 9' 9-max Seat #2 is the button
Seat 1: s.l. halper (33278 in chips)=20
Seat 2: TobogganM.D. (19810 in chips)=20
Seat 3: Bsgwolfpack4 (53666 in chips)=20
Seat 4: senor stinks (15452 in chips)=20
Seat 5: JJin91 (24509 in chips)=20
Seat 6: zBeanHeaDz (14572 in chips)=20
Seat 7: SJMayhem11 (21690 in chips)=20
Seat 8: joeyrup (20988 in chips)=20
Seat 9: Bar.usWYGRAM (46093 in chips)=20
s.l. halper: posts the ante 125
TobogganM.D.: posts the ante 125
Bsgwolfpack4: posts the ante 125
senor stinks: posts the ante 125
JJin91: posts the ante 125
zBeanHeaDz: posts the ante 125
SJMayhem11: posts the ante 125
joeyrup: posts the ante 125
Bar.usWYGRAM: posts the ante 125
Bsgwolfpack4: posts small blind 500
senor stinks: posts big blind 1000
*** HOLE CARDS ***
Dealt to JJin91 [6c 2d]
Bar.usWYGRAM said, "I BET TINY"
JJin91: folds=20
zBeanHeaDz: folds=20
SJMayhem11: folds=20
joeyrup: folds=20
Bar.usWYGRAM: raises 1000 to 2000
s.l. halper: folds=20
Bar.usWYGRAM said, "SENOOOOOOOOOR"
TobogganM.D.: raises 17685 to 19685 and is all-in
Bsgwolfpack4: folds=20
senor stinks: folds=20
Bar.usWYGRAM: folds=20
Uncalled bet (17685) returned to TobogganM.D.
TobogganM.D. collected 6625 from pot
TobogganM.D.: doesn't show hand=20
Bar.usWYGRAM said, "DAMN"
*** SUMMARY ***
Total pot 6625 | Rake 0=20
Seat 1: s.l. halper folded before Flop (didn't bet)
Seat 2: TobogganM.D. (button) collected (6625)
Seat 3: Bsgwolfpack4 (small blind) folded before Flop
Seat 4: senor stinks (big blind) folded before Flop
Seat 5: JJin91 folded before Flop (didn't bet)
Seat 6: zBeanHeaDz folded before Flop (didn't bet)
Seat 7: SJMayhem11 folded before Flop (didn't bet)
Seat 8: joeyrup folded before Flop (didn't bet)
Seat 9: Bar.usWYGRAM folded before Flop


*********** # 156 **************
PokerStars Hand #175012612884: Tournament #1701776547, $18.20+$1.80 USD=
 Hold'em No Limit - Level XV (500/1000) - 2017/09/13 21:34:51 ET
Table '1701776547 9' 9-max Seat #3 is the button
Seat 1: s.l. halper (33153 in chips)=20
Seat 2: TobogganM.D. (24310 in chips)=20
Seat 3: Bsgwolfpack4 (53041 in chips)=20
Seat 4: senor stinks (14327 in chips)=20
Seat 5: JJin91 (24384 in chips)=20
Seat 6: zBeanHeaDz (14447 in chips)=20
Seat 7: SJMayhem11 (21565 in chips)=20
Seat 8: joeyrup (20863 in chips)=20
Seat 9: Bar.usWYGRAM (43968 in chips)=20
s.l. halper: posts the ante 125
TobogganM.D.: posts the ante 125
Bsgwolfpack4: posts the ante 125
senor stinks: posts the ante 125
JJin91: posts the ante 125
zBeanHeaDz: posts the ante 125
SJMayhem11: posts the ante 125
joeyrup: posts the ante 125
Bar.usWYGRAM: posts the ante 125
senor stinks: posts small blind 500
JJin91: posts big blind 1000
*** HOLE CARDS ***
Dealt to JJin91 [4c Qd]
zBeanHeaDz: folds=20
SJMayhem11: folds=20
Bar.usWYGRAM said, "WAS HOPING FOR SOME POST FLOP WITH SENOOOOR"
joeyrup: folds=20
Bar.usWYGRAM: raises 1000 to 2000
s.l. halper: folds=20
TobogganM.D.: folds=20
Bsgwolfpack4: raises 3750 to 5750
senor stinks: folds=20
JJin91: folds=20
Bar.usWYGRAM: calls 3750
*** FLOP *** [Qh 5s 7c]
Bar.usWYGRAM: checks=20
Bsgwolfpack4: bets 7980
Bar.usWYGRAM: calls 7980
*** TURN *** [Qh 5s 7c] [Td]
Bar.usWYGRAM: checks=20
Bsgwolfpack4: checks=20
*** RIVER *** [Qh 5s 7c Td] [6s]
Bar.usWYGRAM: bets 9000
Bsgwolfpack4 said, "what do you flat with"
Bar.usWYGRAM said, "CLL"
Bar.usWYGRAM said, "CALL"
Bsgwolfpack4: folds [Kc Ac]
Uncalled bet (9000) returned to Bar.usWYGRAM
Bsgwolfpack4 said, "shut up"
Bar.usWYGRAM collected 30085 from pot
Bar.usWYGRAM: shows [Qs]
*** SUMMARY ***
Total pot 30085 | Rake 0=20
Board [Qh 5s 7c Td 6s]
Seat 1: s.l. halper folded before Flop (didn't bet)
Seat 2: TobogganM.D. folded before Flop (didn't bet)
Seat 3: Bsgwolfpack4 (button) folded on the River
Seat 4: senor stinks (small blind) folded before Flop
Seat 5: JJin91 (big blind) folded before Flop
Seat 6: zBeanHeaDz folded before Flop (didn't bet)
Seat 7: SJMayhem11 folded before Flop (didn't bet)
Seat 8: joeyrup folded before Flop (didn't bet)
Seat 9: Bar.usWYGRAM collected (30085)


*********** # 157 **************
PokerStars Hand #175012613178: Tournament #1701776547, $18.20+$1.80 USD=
 Hold'em No Limit - Level XV (500/1000) - 2017/09/13 21:36:11 ET
Table '1701776547 9' 9-max Seat #4 is the button
Seat 1: s.l. halper (33028 in chips)=20
Seat 2: TobogganM.D. (24185 in chips)=20
Seat 3: Bsgwolfpack4 (39186 in chips)=20
Seat 4: senor stinks (13702 in chips)=20
Seat 5: JJin91 (23259 in chips)=20
Seat 6: zBeanHeaDz (14322 in chips)=20
Seat 7: SJMayhem11 (21440 in chips)=20
Seat 8: joeyrup (20738 in chips)=20
Seat 9: Bar.usWYGRAM (60198 in chips)=20
s.l. halper: posts the ante 125
TobogganM.D.: posts the ante 125
Bsgwolfpack4: posts the ante 125
senor stinks: posts the ante 125
JJin91: posts the ante 125
zBeanHeaDz: posts the ante 125
SJMayhem11: posts the ante 125
joeyrup: posts the ante 125
Bar.usWYGRAM: posts the ante 125
JJin91: posts small blind 500
zBeanHeaDz: posts big blind 1000
*** HOLE CARDS ***
Dealt to JJin91 [6h 8h]
Bar.usWYGRAM said, "BE KIND"
SJMayhem11: folds=20
Bar.usWYGRAM said, "HOE"
joeyrup: folds=20
Bar.usWYGRAM: raises 1000 to 2000
Bsgwolfpack4 said, "not in the mood lol"
s.l. halper: folds=20
Bar.usWYGRAM said, "ME TOO"
Bar.usWYGRAM said, "SUCKER"
TobogganM.D.: folds=20
Bsgwolfpack4: folds=20
senor stinks: folds=20
JJin91: folds=20
zBeanHeaDz: raises 12197 to 14197 and is all-in
Bar.usWYGRAM: calls 12197
Bsgwolfpack4 said, "ill be kinder if you dont outflop me lol"
*** FLOP *** [8s Ah 4s]
Bar.usWYGRAM said, "33333333"
Bar.usWYGRAM said, "3333333333333"
*** TURN *** [8s Ah 4s] [9d]
Bar.usWYGRAM said, "333333333333333333333"
*** RIVER *** [8s Ah 4s 9d] [2h]
*** SHOW DOWN ***
zBeanHeaDz: shows [Jc Jd] (a pair of Jacks)
Bar.usWYGRAM: shows [3c 3d] (a pair of Threes)
zBeanHeaDz collected 30019 from pot
*** SUMMARY ***
Total pot 30019 | Rake 0=20
Board [8s Ah 4s 9d 2h]
Seat 1: s.l. halper folded before Flop (didn't bet)
Seat 2: TobogganM.D. folded before Flop (didn't bet)
Seat 3: Bsgwolfpack4 folded before Flop (didn't bet)
Seat 4: senor stinks (button) folded before Flop (didn't bet)
Seat 5: JJin91 (small blind) folded before Flop
Seat 6: zBeanHeaDz (big blind) showed [Jc Jd] and won (30019) with a pa=
ir of Jacks
Seat 7: SJMayhem11 folded before Flop (didn't bet)
Seat 8: joeyrup folded before Flop (didn't bet)
Seat 9: Bar.usWYGRAM showed [3c 3d] and lost with a pair of Threes


*********** # 158 **************
PokerStars Hand #175012613418: Tournament #1701776547, $18.20+$1.80 USD=
 Hold'em No Limit - Level XV (500/1000) - 2017/09/13 21:37:13 ET
Table '1701776547 9' 9-max Seat #5 is the button
Seat 1: s.l. halper (32903 in chips)=20
Seat 2: TobogganM.D. (24060 in chips)=20
Seat 3: Bsgwolfpack4 (39061 in chips)=20
Seat 4: senor stinks (13577 in chips)=20
Seat 5: JJin91 (22634 in chips)=20
Seat 6: zBeanHeaDz (30019 in chips)=20
Seat 8: joeyrup (20613 in chips)=20
Seat 9: Bar.usWYGRAM (45876 in chips)=20
s.l. halper: posts the ante 125
TobogganM.D.: posts the ante 125
Bsgwolfpack4: posts the ante 125
senor stinks: posts the ante 125
JJin91: posts the ante 125
zBeanHeaDz: posts the ante 125
joeyrup: posts the ante 125
Bar.usWYGRAM: posts the ante 125
zBeanHeaDz: posts small blind 500
joeyrup: posts big blind 1000
*** HOLE CARDS ***
Dealt to JJin91 [9d 7h]
Bar.usWYGRAM said, "DAMN"
Bar.usWYGRAM said, "WAS CLOSE"
Bsgwolfpack4 said, "awwwwwwwwwwww lol"
Bar.usWYGRAM said, "I GOT 2 INSTEAD OF 3"
Bar.usWYGRAM: folds=20
Bsgwolfpack4 said, "good thi9ng you hit a Q last pot huh"
s.l. halper: raises 1155 to 2155
TobogganM.D.: folds=20
Bsgwolfpack4: folds=20
senor stinks: folds=20
JJin91: folds=20
Bar.usWYGRAM said, "YEAH VERY GOOD"
zBeanHeaDz: folds=20
joeyrup: folds=20
Uncalled bet (1155) returned to s.l. halper
Bsgwolfpack4 said, "lol"
s.l. halper collected 3500 from pot
s.l. halper: doesn't show hand=20
*** SUMMARY ***
Total pot 3500 | Rake 0=20
Seat 1: s.l. halper collected (3500)
Seat 2: TobogganM.D. folded before Flop (didn't bet)
Seat 3: Bsgwolfpack4 folded before Flop (didn't bet)
Seat 4: senor stinks folded before Flop (didn't bet)
Seat 5: JJin91 (button) folded before Flop (didn't bet)
Seat 6: zBeanHeaDz (small blind) folded before Flop
Seat 8: joeyrup (big blind) folded before Flop
Seat 9: Bar.usWYGRAM folded before Flop (didn't bet)


*********** # 159 **************
PokerStars Hand #175012613594: Tournament #1701776547, $18.20+$1.80 USD=
 Hold'em No Limit - Level XV (500/1000) - 2017/09/13 21:37:55 ET
Table '1701776547 9' 9-max Seat #6 is the button
Seat 1: s.l. halper (35278 in chips)=20
Seat 2: TobogganM.D. (23935 in chips)=20
Seat 3: Bsgwolfpack4 (38936 in chips)=20
Seat 4: senor stinks (13452 in chips)=20
Seat 5: JJin91 (22509 in chips)=20
Seat 6: zBeanHeaDz (29394 in chips)=20
Seat 8: joeyrup (19488 in chips)=20
Seat 9: Bar.usWYGRAM (45751 in chips)=20
s.l. halper: posts the ante 125
TobogganM.D.: posts the ante 125
Bsgwolfpack4: posts the ante 125
senor stinks: posts the ante 125
JJin91: posts the ante 125
zBeanHeaDz: posts the ante 125
joeyrup: posts the ante 125
Bar.usWYGRAM: posts the ante 125
joeyrup: posts small blind 500
Bar.usWYGRAM: posts big blind 1000
*** HOLE CARDS ***
Dealt to JJin91 [9s 3h]
s.l. halper: folds=20
TobogganM.D.: folds=20
Bsgwolfpack4: folds=20
senor stinks: folds=20
JJin91: folds=20
zBeanHeaDz: raises 1410 to 2410
joeyrup: folds=20
Bar.usWYGRAM said, "AGAIN"
Bar.usWYGRAM said, "BABE"
Bar.usWYGRAM: calls 1410
*** FLOP *** [9c 6c 4c]
Bar.usWYGRAM: bets 1500
zBeanHeaDz: calls 1500
*** TURN *** [9c 6c 4c] [Td]
Bar.usWYGRAM: bets 4500
zBeanHeaDz: calls 4500
*** RIVER *** [9c 6c 4c Td] [Th]
Bar.usWYGRAM: bets 6000
zBeanHeaDz: calls 6000
*** SHOW DOWN ***
Bar.usWYGRAM: shows [Js Tc] (three of a kind, Tens)
zBeanHeaDz: mucks hand=20
Bar.usWYGRAM collected 30320 from pot
*** SUMMARY ***
Total pot 30320 | Rake 0=20
Board [9c 6c 4c Td Th]
Seat 1: s.l. halper folded before Flop (didn't bet)
Seat 2: TobogganM.D. folded before Flop (didn't bet)
Seat 3: Bsgwolfpack4 folded before Flop (didn't bet)
Seat 4: senor stinks folded before Flop (didn't bet)
Seat 5: JJin91 folded before Flop (didn't bet)
Seat 6: zBeanHeaDz (button) mucked [Ac As]
Seat 8: joeyrup (small blind) folded before Flop
Seat 9: Bar.usWYGRAM (big blind) showed [Js Tc] and won (30320) with th=
ree of a kind, Tens


*********** # 160 **************
PokerStars Hand #175012613771: Tournament #1701776547, $18.20+$1.80 USD=
 Hold'em No Limit - Level XV (500/1000) - 2017/09/13 21:38:38 ET
Table '1701776547 9' 9-max Seat #8 is the button
Seat 1: s.l. halper (35153 in chips)=20
Seat 2: TobogganM.D. (23810 in chips)=20
Seat 3: Bsgwolfpack4 (38811 in chips)=20
Seat 4: senor stinks (13327 in chips)=20
Seat 5: JJin91 (22384 in chips)=20
Seat 6: zBeanHeaDz (14859 in chips)=20
Seat 8: joeyrup (18863 in chips)=20
Seat 9: Bar.usWYGRAM (61536 in chips)=20
s.l. halper: posts the ante 125
TobogganM.D.: posts the ante 125
Bsgwolfpack4: posts the ante 125
senor stinks: posts the ante 125
JJin91: posts the ante 125
zBeanHeaDz: posts the ante 125
joeyrup: posts the ante 125
Bar.usWYGRAM: posts the ante 125
Bar.usWYGRAM: posts small blind 500
s.l. halper: posts big blind 1000
*** HOLE CARDS ***
Dealt to JJin91 [8h Jd]
Bar.usWYGRAM said, "HE GAVE ME BACK"
Bar.usWYGRAM said, "MY MONEY !!!!"
TobogganM.D.: folds=20
Bsgwolfpack4: folds=20
senor stinks: folds=20
JJin91: folds=20
Bar.usWYGRAM said, "LOL"
Bsgwolfpack4 said, "oh yeah"
Bar.usWYGRAM said, "HE HAD AA"
zBeanHeaDz said, "lol u got lucky rofl u mean"
zBeanHeaDz: folds=20
Bar.usWYGRAM said, "HE HAD AA"
joeyrup: folds=20
Bar.usWYGRAM said, "U SHOULD FOLD IT PREFLOP"
Bar.usWYGRAM: calls 500
s.l. halper: raises 3765 to 4765
Bar.usWYGRAM said, "I FOLD AA PREFLOP"
Bar.usWYGRAM said, "THERE IS NO CHANCE TO WIN WITH AA"
Bar.usWYGRAM: calls 3765
*** FLOP *** [2c 8d Qs]
Bar.usWYGRAM: checks=20
s.l. halper: checks=20
*** TURN *** [2c 8d Qs] [As]
Bar.usWYGRAM: checks=20
s.l. halper: bets 5263
Bar.usWYGRAM: folds [Kc]
Uncalled bet (5263) returned to s.l. halper
s.l. halper collected 10530 from pot
s.l. halper: doesn't show hand=20
*** SUMMARY ***
Total pot 10530 | Rake 0=20
Board [2c 8d Qs As]
Seat 1: s.l. halper (big blind) collected (10530)
Seat 2: TobogganM.D. folded before Flop (didn't bet)
Seat 3: Bsgwolfpack4 folded before Flop (didn't bet)
Seat 4: senor stinks folded before Flop (didn't bet)
Seat 5: JJin91 folded before Flop (didn't bet)
Seat 6: zBeanHeaDz folded before Flop (didn't bet)
Seat 8: joeyrup (button) folded before Flop (didn't bet)
Seat 9: Bar.usWYGRAM (small blind) folded on the Turn


*********** # 161 **************
PokerStars Hand #175012614037: Tournament #1701776547, $18.20+$1.80 USD=
 Hold'em No Limit - Level XV (500/1000) - 2017/09/13 21:39:47 ET
Table '1701776547 9' 9-max Seat #9 is the button
Seat 1: s.l. halper (40793 in chips)=20
Seat 2: TobogganM.D. (23685 in chips)=20
Seat 3: Bsgwolfpack4 (38686 in chips)=20
Seat 4: senor stinks (13202 in chips)=20
Seat 5: JJin91 (22259 in chips)=20
Seat 6: zBeanHeaDz (14734 in chips)=20
Seat 8: joeyrup (18738 in chips)=20
Seat 9: Bar.usWYGRAM (56646 in chips)=20
s.l. halper: posts the ante 125
TobogganM.D.: posts the ante 125
Bsgwolfpack4: posts the ante 125
senor stinks: posts the ante 125
JJin91: posts the ante 125
zBeanHeaDz: posts the ante 125
joeyrup: posts the ante 125
Bar.usWYGRAM: posts the ante 125
s.l. halper: posts small blind 500
TobogganM.D.: posts big blind 1000
*** HOLE CARDS ***
Dealt to JJin91 [3s 4d]
Bsgwolfpack4: folds=20
senor stinks: folds=20
JJin91: folds=20
zBeanHeaDz: folds=20
joeyrup: folds=20
Bar.usWYGRAM: raises 1500 to 2500
s.l. halper: folds=20
TobogganM.D.: folds=20
Uncalled bet (1500) returned to Bar.usWYGRAM
Bar.usWYGRAM collected 3500 from pot
*** SUMMARY ***
Total pot 3500 | Rake 0=20
Seat 1: s.l. halper (small blind) folded before Flop
Seat 2: TobogganM.D. (big blind) folded before Flop
Seat 3: Bsgwolfpack4 folded before Flop (didn't bet)
Seat 4: senor stinks folded before Flop (didn't bet)
Seat 5: JJin91 folded before Flop (didn't bet)
Seat 6: zBeanHeaDz folded before Flop (didn't bet)
Seat 8: joeyrup folded before Flop (didn't bet)
Seat 9: Bar.usWYGRAM (button) collected (3500)


*********** # 162 **************
PokerStars Hand #175012614152: Tournament #1701776547, $18.20+$1.80 USD=
 Hold'em No Limit - Level XV (500/1000) - 2017/09/13 21:40:14 ET
Table '1701776547 9' 9-max Seat #1 is the button
Seat 1: s.l. halper (40168 in chips)=20
Seat 2: TobogganM.D. (22560 in chips)=20
Seat 3: Bsgwolfpack4 (38561 in chips)=20
Seat 4: senor stinks (13077 in chips)=20
Seat 5: JJin91 (22134 in chips)=20
Seat 6: zBeanHeaDz (14609 in chips)=20
Seat 8: joeyrup (18613 in chips)=20
Seat 9: Bar.usWYGRAM (59021 in chips)=20
s.l. halper: posts the ante 125
TobogganM.D.: posts the ante 125
Bsgwolfpack4: posts the ante 125
senor stinks: posts the ante 125
JJin91: posts the ante 125
zBeanHeaDz: posts the ante 125
joeyrup: posts the ante 125
Bar.usWYGRAM: posts the ante 125
TobogganM.D.: posts small blind 500
Bsgwolfpack4: posts big blind 1000
*** HOLE CARDS ***
Dealt to JJin91 [Kd 9s]
senor stinks: folds=20
JJin91: folds=20
zBeanHeaDz: folds=20
joeyrup: folds=20
Bar.usWYGRAM: raises 1500 to 2500
s.l. halper: folds=20
TobogganM.D.: folds=20
Bsgwolfpack4: folds=20
Uncalled bet (1500) returned to Bar.usWYGRAM
Bar.usWYGRAM collected 3500 from pot
Bar.usWYGRAM: shows [Ks Qs]
*** SUMMARY ***
Total pot 3500 | Rake 0=20
Seat 1: s.l. halper (button) folded before Flop (didn't bet)
Seat 2: TobogganM.D. (small blind) folded before Flop
Seat 3: Bsgwolfpack4 (big blind) folded before Flop
Seat 4: senor stinks folded before Flop (didn't bet)
Seat 5: JJin91 folded before Flop (didn't bet)
Seat 6: zBeanHeaDz folded before Flop (didn't bet)
Seat 8: joeyrup folded before Flop (didn't bet)
Seat 9: Bar.usWYGRAM collected (3500)


*********** # 163 **************
PokerStars Hand #175012614282: Tournament #1701776547, $18.20+$1.80 USD=
 Hold'em No Limit - Level XV (500/1000) - 2017/09/13 21:40:47 ET
Table '1701776547 9' 9-max Seat #2 is the button
Seat 1: s.l. halper (40043 in chips)=20
Seat 2: TobogganM.D. (21935 in chips)=20
Seat 3: Bsgwolfpack4 (37436 in chips)=20
Seat 4: senor stinks (12952 in chips)=20
Seat 5: JJin91 (22009 in chips)=20
Seat 6: zBeanHeaDz (14484 in chips)=20
Seat 8: joeyrup (18488 in chips)=20
Seat 9: Bar.usWYGRAM (61396 in chips)=20
s.l. halper: posts the ante 125
TobogganM.D.: posts the ante 125
Bsgwolfpack4: posts the ante 125
senor stinks: posts the ante 125
JJin91: posts the ante 125
zBeanHeaDz: posts the ante 125
joeyrup: posts the ante 125
Bar.usWYGRAM: posts the ante 125
Bsgwolfpack4: posts small blind 500
senor stinks: posts big blind 1000
*** HOLE CARDS ***
Dealt to JJin91 [8c Ac]
JJin91: raises 1170 to 2170
zBeanHeaDz: folds=20
joeyrup: folds=20
Bar.usWYGRAM: calls 2170
s.l. halper: folds=20
TobogganM.D.: folds=20
Bsgwolfpack4: folds=20
senor stinks: calls 1170
*** FLOP *** [5s 8d Ah]
senor stinks: checks=20
JJin91: bets 2964
Bar.usWYGRAM: calls 2964
senor stinks: folds=20
*** TURN *** [5s 8d Ah] [2s]
JJin91: bets 10175
Bar.usWYGRAM said, "I GOT IT"
Bar.usWYGRAM said, "34"
JJin91 said, "u got it u got it"
Bar.usWYGRAM has timed out
Bar.usWYGRAM: folds=20
Uncalled bet (10175) returned to JJin91
Bar.usWYGRAM is sitting out
Bar.usWYGRAM has returned
JJin91 collected 13938 from pot
JJin91: doesn't show hand=20
*** SUMMARY ***
Total pot 13938 | Rake 0=20
Board [5s 8d Ah 2s]
Seat 1: s.l. halper folded before Flop (didn't bet)
Seat 2: TobogganM.D. (button) folded before Flop (didn't bet)
Seat 3: Bsgwolfpack4 (small blind) folded before Flop
Seat 4: senor stinks (big blind) folded on the Flop
Seat 5: JJin91 collected (13938)
Seat 6: zBeanHeaDz folded before Flop (didn't bet)
Seat 8: joeyrup folded before Flop (didn't bet)
Seat 9: Bar.usWYGRAM folded on the Turn


*********** # 164 **************
PokerStars Hand #175012614573: Tournament #1701776547, $18.20+$1.80 USD=
 Hold'em No Limit - Level XVI (600/1200) - 2017/09/13 21:42:03 ET
Table '1701776547 9' 9-max Seat #3 is the button
Seat 1: s.l. halper (39918 in chips)=20
Seat 2: TobogganM.D. (21810 in chips)=20
Seat 3: Bsgwolfpack4 (36811 in chips)=20
Seat 4: senor stinks (10657 in chips)=20
Seat 5: JJin91 (30688 in chips)=20
Seat 6: zBeanHeaDz (14359 in chips)=20
Seat 8: joeyrup (18363 in chips)=20
Seat 9: Bar.usWYGRAM (56137 in chips)=20
s.l. halper: posts the ante 150
TobogganM.D.: posts the ante 150
Bsgwolfpack4: posts the ante 150
senor stinks: posts the ante 150
JJin91: posts the ante 150
zBeanHeaDz: posts the ante 150
joeyrup: posts the ante 150
Bar.usWYGRAM: posts the ante 150
senor stinks: posts small blind 600
JJin91: posts big blind 1200
*** HOLE CARDS ***
Dealt to JJin91 [Qh Qc]
Bar.usWYGRAM said, "I WAS TO SLOW TO CALL"
zBeanHeaDz: folds=20
joeyrup: raises 17013 to 18213 and is all-in
Bar.usWYGRAM: folds=20
s.l. halper: folds=20
TobogganM.D.: folds=20
Bsgwolfpack4: folds=20
senor stinks: folds=20
JJin91: calls 17013
*** FLOP *** [2d 3c 8h]
*** TURN *** [2d 3c 8h] [9c]
*** RIVER *** [2d 3c 8h 9c] [5c]
*** SHOW DOWN ***
JJin91: shows [Qh Qc] (a pair of Queens)
joeyrup: shows [Kh Ad] (high card Ace)
JJin91 collected 38226 from pot
joeyrup finished the tournament in 31st place
*** SUMMARY ***
Total pot 38226 | Rake 0=20
Board [2d 3c 8h 9c 5c]
Seat 1: s.l. halper folded before Flop (didn't bet)
Seat 2: TobogganM.D. folded before Flop (didn't bet)
Seat 3: Bsgwolfpack4 (button) folded before Flop (didn't bet)
Seat 4: senor stinks (small blind) folded before Flop
Seat 5: JJin91 (big blind) showed [Qh Qc] and won (38226) with a pair o=
f Queens
Seat 6: zBeanHeaDz folded before Flop (didn't bet)
Seat 8: joeyrup showed [Kh Ad] and lost with high card Ace
Seat 9: Bar.usWYGRAM folded before Flop (didn't bet)


*********** # 165 **************
PokerStars Hand #175012614683: Tournament #1701776547, $18.20+$1.80 USD=
 Hold'em No Limit - Level XVI (600/1200) - 2017/09/13 21:42:32 ET
Table '1701776547 9' 9-max Seat #4 is the button
Seat 1: s.l. halper (39768 in chips)=20
Seat 2: TobogganM.D. (21660 in chips)=20
Seat 3: Bsgwolfpack4 (36661 in chips)=20
Seat 4: senor stinks (9907 in chips)=20
Seat 5: JJin91 (50551 in chips)=20
Seat 6: zBeanHeaDz (14209 in chips)=20
Seat 9: Bar.usWYGRAM (55987 in chips)=20
s.l. halper: posts the ante 150
TobogganM.D.: posts the ante 150
Bsgwolfpack4: posts the ante 150
senor stinks: posts the ante 150
JJin91: posts the ante 150
zBeanHeaDz: posts the ante 150
Bar.usWYGRAM: posts the ante 150
JJin91: posts small blind 600
zBeanHeaDz: posts big blind 1200
*** HOLE CARDS ***
Dealt to JJin91 [7h 3h]
Bar.usWYGRAM: raises 1200 to 2400
s.l. halper: folds=20
TobogganM.D.: folds=20
Bsgwolfpack4: folds=20
senor stinks: raises 7357 to 9757 and is all-in
JJin91: folds=20
zBeanHeaDz: folds=20
Bar.usWYGRAM: calls 7357
Bar.usWYGRAM said, "33333333333333333 245322423421"
*** FLOP *** [Ac 4h 3d]
Bar.usWYGRAM said, "2432123"
Bar.usWYGRAM said, "2133123213"
Bar.usWYGRAM said, "23"
Bar.usWYGRAM said, "121"
*** TURN *** [Ac 4h 3d] [4c]
Bar.usWYGRAM said, "323"
Bar.usWYGRAM said, "1213"
Bar.usWYGRAM said, "21"
Bar.usWYGRAM said, "31"
Bar.usWYGRAM said, "32"
Bar.usWYGRAM said, "21"
Bar.usWYGRAM said, "31`"
*** RIVER *** [Ac 4h 3d 4c] [Jd]
Bar.usWYGRAM said, "21NICE"
*** SHOW DOWN ***
Bar.usWYGRAM: shows [3s Ah] (two pair, Aces and Fours)
senor stinks: shows [7c 7s] (two pair, Sevens and Fours)
Bar.usWYGRAM collected 22364 from pot
senor stinks finished the tournament in 30th place
Bar.usWYGRAM said, "NICEEEEEEEEE"
Bar.usWYGRAM said, "NICEEEEEEEEEEEEEE"
*** SUMMARY ***
Total pot 22364 | Rake 0=20
Board [Ac 4h 3d 4c Jd]
Seat 1: s.l. halper folded before Flop (didn't bet)
Seat 2: TobogganM.D. folded before Flop (didn't bet)
Seat 3: Bsgwolfpack4 folded before Flop (didn't bet)
Seat 4: senor stinks (button) showed [7c 7s] and lost with two pair, Se=
vens and Fours
Seat 5: JJin91 (small blind) folded before Flop
Seat 6: zBeanHeaDz (big blind) folded before Flop
Seat 9: Bar.usWYGRAM showed [3s Ah] and won (22364) with two pair, Aces=
 and Fours


*********** # 166 **************
PokerStars Hand #175012614844: Tournament #1701776547, $18.20+$1.80 USD=
 Hold'em No Limit - Level XVI (600/1200) - 2017/09/13 21:43:11 ET
Table '1701776547 9' 9-max Seat #5 is the button
Seat 1: s.l. halper (39618 in chips)=20
Seat 2: TobogganM.D. (21510 in chips)=20
Seat 3: Bsgwolfpack4 (36511 in chips)=20
Seat 5: JJin91 (49801 in chips)=20
Seat 6: zBeanHeaDz (12859 in chips)=20
Seat 9: Bar.usWYGRAM (68444 in chips)=20
s.l. halper: posts the ante 150
TobogganM.D.: posts the ante 150
Bsgwolfpack4: posts the ante 150
JJin91: posts the ante 150
zBeanHeaDz: posts the ante 150
Bar.usWYGRAM: posts the ante 150
zBeanHeaDz: posts small blind 600
Bar.usWYGRAM: posts big blind 1200
*** HOLE CARDS ***
Dealt to JJin91 [3h Jc]
Bar.usWYGRAM said, "SENORRRRRRRRRRRRR"
Bar.usWYGRAM said, "BYE BYE"
s.l. halper: raises 1355 to 2555
TobogganM.D.: folds=20
Bsgwolfpack4: folds=20
JJin91: folds=20
zBeanHeaDz: folds=20
Bar.usWYGRAM: calls 1355
*** FLOP *** [7d Jd 4h]
Bar.usWYGRAM: checks=20
s.l. halper: checks=20
*** TURN *** [7d Jd 4h] [Qd]
Bar.usWYGRAM: bets 2400
s.l. halper: calls 2400
*** RIVER *** [7d Jd 4h Qd] [2s]
Bar.usWYGRAM: checks=20
s.l. halper: checks=20
*** SHOW DOWN ***
Bar.usWYGRAM: shows [Ts 2d] (a pair of Deuces)
s.l. halper: mucks hand=20
Bar.usWYGRAM collected 11410 from pot
*** SUMMARY ***
Total pot 11410 | Rake 0=20
Board [7d Jd 4h Qd 2s]
Seat 1: s.l. halper mucked [Ac 9h]
Seat 2: TobogganM.D. folded before Flop (didn't bet)
Seat 3: Bsgwolfpack4 folded before Flop (didn't bet)
Seat 5: JJin91 (button) folded before Flop (didn't bet)
Seat 6: zBeanHeaDz (small blind) folded before Flop
Seat 9: Bar.usWYGRAM (big blind) showed [Ts 2d] and won (11410) with a =
pair of Deuces


*********** # 167 **************
PokerStars Hand #175012615088: Tournament #1701776547, $18.20+$1.80 USD=
 Hold'em No Limit - Level XVI (600/1200) - 2017/09/13 21:44:08 ET
Table '1701776547 9' 9-max Seat #6 is the button
Seat 1: s.l. halper (34513 in chips)=20
Seat 2: TobogganM.D. (21360 in chips)=20
Seat 3: Bsgwolfpack4 (36361 in chips)=20
Seat 5: JJin91 (49651 in chips)=20
Seat 6: zBeanHeaDz (12109 in chips)=20
Seat 7: 14k100g (9638 in chips) out of hand (moved from another table i=
nto small blind)
Seat 9: Bar.usWYGRAM (74749 in chips)=20
s.l. halper: posts the ante 150
TobogganM.D.: posts the ante 150
Bsgwolfpack4: posts the ante 150
JJin91: posts the ante 150
zBeanHeaDz: posts the ante 150
Bar.usWYGRAM: posts the ante 150
Bar.usWYGRAM: posts small blind 600
s.l. halper: posts big blind 1200
*** HOLE CARDS ***
Dealt to JJin91 [9s Ah]
TobogganM.D.: raises 1470 to 2670
Bsgwolfpack4: folds=20
JJin91: folds=20
zBeanHeaDz: folds=20
Bar.usWYGRAM: folds=20
s.l. halper: calls 1470
*** FLOP *** [2c Js 3c]
s.l. halper: checks=20
TobogganM.D.: checks=20
*** TURN *** [2c Js 3c] [2d]
s.l. halper: checks=20
TobogganM.D.: checks=20
*** RIVER *** [2c Js 3c 2d] [Ts]
s.l. halper: checks=20
TobogganM.D.: checks=20
*** SHOW DOWN ***
s.l. halper: shows [5d Ad] (a pair of Deuces)
TobogganM.D.: mucks hand=20
s.l. halper collected 6840 from pot
*** SUMMARY ***
Total pot 6840 | Rake 0=20
Board [2c Js 3c 2d Ts]
Seat 1: s.l. halper (big blind) showed [5d Ad] and won (6840) with a pa=
ir of Deuces
Seat 2: TobogganM.D. mucked [Qs Ks]
Seat 3: Bsgwolfpack4 folded before Flop (didn't bet)
Seat 5: JJin91 folded before Flop (didn't bet)
Seat 6: zBeanHeaDz (button) folded before Flop (didn't bet)
Seat 9: Bar.usWYGRAM (small blind) folded before Flop


*********** # 168 **************
PokerStars Hand #175012615342: Tournament #1701776547, $18.20+$1.80 USD=
 Hold'em No Limit - Level XVI (600/1200) - 2017/09/13 21:45:06 ET
Table '1701776547 9' 9-max Seat #9 is the button
Seat 1: s.l. halper (38533 in chips)=20
Seat 2: TobogganM.D. (18540 in chips)=20
Seat 3: Bsgwolfpack4 (36211 in chips)=20
Seat 5: JJin91 (49501 in chips)=20
Seat 6: zBeanHeaDz (11959 in chips)=20
Seat 7: 14k100g (9638 in chips)=20
Seat 9: Bar.usWYGRAM (73999 in chips)=20
s.l. halper: posts the ante 150
TobogganM.D.: posts the ante 150
Bsgwolfpack4: posts the ante 150
JJin91: posts the ante 150
zBeanHeaDz: posts the ante 150
14k100g: posts the ante 150
Bar.usWYGRAM: posts the ante 150
s.l. halper: posts small blind 600
TobogganM.D.: posts big blind 1200
*** HOLE CARDS ***
Dealt to JJin91 [9c 7d]
Bsgwolfpack4: folds=20
JJin91: folds=20
zBeanHeaDz: folds=20
14k100g: folds=20
Bar.usWYGRAM: raises 1200 to 2400
s.l. halper: folds=20
TobogganM.D.: raises 15990 to 18390 and is all-in
Bar.usWYGRAM: folds=20
Uncalled bet (15990) returned to TobogganM.D.
TobogganM.D. collected 6450 from pot
TobogganM.D.: doesn't show hand=20
*** SUMMARY ***
Total pot 6450 | Rake 0=20
Seat 1: s.l. halper (small blind) folded before Flop
Seat 2: TobogganM.D. (big blind) collected (6450)
Seat 3: Bsgwolfpack4 folded before Flop (didn't bet)
Seat 5: JJin91 folded before Flop (didn't bet)
Seat 6: zBeanHeaDz folded before Flop (didn't bet)
Seat 7: 14k100g folded before Flop (didn't bet)
Seat 9: Bar.usWYGRAM (button) folded before Flop


*********** # 169 **************
PokerStars Hand #175012615554: Tournament #1701776547, $18.20+$1.80 USD=
 Hold'em No Limit - Level XVI (600/1200) - 2017/09/13 21:45:57 ET
Table '1701776547 9' 9-max Seat #1 is the button
Seat 1: s.l. halper (37783 in chips)=20
Seat 2: TobogganM.D. (22440 in chips)=20
Seat 3: Bsgwolfpack4 (36061 in chips)=20
Seat 5: JJin91 (49351 in chips)=20
Seat 6: zBeanHeaDz (11809 in chips)=20
Seat 7: 14k100g (9488 in chips)=20
Seat 9: Bar.usWYGRAM (71449 in chips)=20
s.l. halper: posts the ante 150
TobogganM.D.: posts the ante 150
Bsgwolfpack4: posts the ante 150
JJin91: posts the ante 150
zBeanHeaDz: posts the ante 150
14k100g: posts the ante 150
Bar.usWYGRAM: posts the ante 150
TobogganM.D.: posts small blind 600
Bsgwolfpack4: posts big blind 1200
*** HOLE CARDS ***
Dealt to JJin91 [2s 8d]
JJin91: folds=20
zBeanHeaDz: raises 10459 to 11659 and is all-in
14k100g: folds=20
Bar.usWYGRAM: folds=20
s.l. halper: folds=20
TobogganM.D.: raises 10631 to 22290 and is all-in
Bsgwolfpack4: folds=20
Uncalled bet (10631) returned to TobogganM.D.
*** FLOP *** [Jc 7d 8h]
*** TURN *** [Jc 7d 8h] [7h]
*** RIVER *** [Jc 7d 8h 7h] [9d]
*** SHOW DOWN ***
TobogganM.D.: shows [Td Ts] (a straight, Seven to Jack)
zBeanHeaDz: shows [Kd Qs] (a pair of Sevens)
TobogganM.D. collected 25568 from pot
zBeanHeaDz finished the tournament in 28th place
*** SUMMARY ***
Total pot 25568 | Rake 0=20
Board [Jc 7d 8h 7h 9d]
Seat 1: s.l. halper (button) folded before Flop (didn't bet)
Seat 2: TobogganM.D. (small blind) showed [Td Ts] and won (25568) with =
a straight, Seven to Jack
Seat 3: Bsgwolfpack4 (big blind) folded before Flop
Seat 5: JJin91 folded before Flop (didn't bet)
Seat 6: zBeanHeaDz showed [Kd Qs] and lost with a pair of Sevens
Seat 7: 14k100g folded before Flop (didn't bet)
Seat 9: Bar.usWYGRAM folded before Flop (didn't bet)


*********** # 170 **************
PokerStars Hand #175012615761: Tournament #1701776547, $18.20+$1.80 USD=
 Hold'em No Limit - Level XVI (600/1200) - 2017/09/13 21:46:48 ET
Table '1701776547 10' 9-max Seat #4 is the button
Seat 1: SwissGalileo (69589 in chips)=20
Seat 2: gator856500 (20185 in chips)=20
Seat 3: nwmdnj (37404 in chips)=20
Seat 4: 4Aces518 (4560 in chips)=20
Seat 5: vincent329 (57758 in chips)=20
Seat 6: JJin91 (49201 in chips)=20
Seat 7: FootPerv (29418 in chips)=20
Seat 8: Paceman2jr (42346 in chips)=20
Seat 9: Bar.usWYGRAM (71299 in chips)=20
SwissGalileo: posts the ante 150
gator856500: posts the ante 150
nwmdnj: posts the ante 150
4Aces518: posts the ante 150
vincent329: posts the ante 150
JJin91: posts the ante 150
FootPerv: posts the ante 150
Paceman2jr: posts the ante 150
Bar.usWYGRAM: posts the ante 150
vincent329: posts small blind 600
JJin91: posts big blind 1200
*** HOLE CARDS ***
Dealt to JJin91 [7s 9d]
FootPerv: folds=20
Paceman2jr: folds=20
Bar.usWYGRAM: raises 1200 to 2400
SwissGalileo: folds=20
gator856500: calls 2400
nwmdnj: folds=20
4Aces518: folds=20
vincent329: calls 1800
JJin91: folds=20
*** FLOP *** [2h Ts 9c]
vincent329: checks=20
Bar.usWYGRAM: checks=20
gator856500: checks=20
*** TURN *** [2h Ts 9c] [7c]
vincent329: bets 3600
Bar.usWYGRAM: folds=20
gator856500: raises 14035 to 17635 and is all-in
vincent329: folds=20
Uncalled bet (14035) returned to gator856500
gator856500 collected 16950 from pot
gator856500: doesn't show hand=20
*** SUMMARY ***
Total pot 16950 | Rake 0=20
Board [2h Ts 9c 7c]
Seat 1: SwissGalileo folded before Flop (didn't bet)
Seat 2: gator856500 collected (16950)
Seat 3: nwmdnj folded before Flop (didn't bet)
Seat 4: 4Aces518 (button) folded before Flop (didn't bet)
Seat 5: vincent329 (small blind) folded on the Turn
Seat 6: JJin91 (big blind) folded before Flop
Seat 7: FootPerv folded before Flop (didn't bet)
Seat 8: Paceman2jr folded before Flop (didn't bet)
Seat 9: Bar.usWYGRAM folded on the Turn


*********** # 171 **************
PokerStars Hand #175012616059: Tournament #1701776547, $18.20+$1.80 USD=
 Hold'em No Limit - Level XVI (600/1200) - 2017/09/13 21:47:57 ET
Table '1701776547 10' 9-max Seat #5 is the button
Seat 1: SwissGalileo (69439 in chips)=20
Seat 2: gator856500 (30985 in chips)=20
Seat 3: nwmdnj (37254 in chips)=20
Seat 4: 4Aces518 (4410 in chips)=20
Seat 5: vincent329 (51608 in chips)=20
Seat 6: JJin91 (47851 in chips)=20
Seat 7: FootPerv (29268 in chips)=20
Seat 8: Paceman2jr (42196 in chips)=20
Seat 9: Bar.usWYGRAM (68749 in chips)=20
SwissGalileo: posts the ante 150
gator856500: posts the ante 150
nwmdnj: posts the ante 150
4Aces518: posts the ante 150
vincent329: posts the ante 150
JJin91: posts the ante 150
FootPerv: posts the ante 150
Paceman2jr: posts the ante 150
Bar.usWYGRAM: posts the ante 150
JJin91: posts small blind 600
FootPerv: posts big blind 1200
*** HOLE CARDS ***
Dealt to JJin91 [7h Qh]
Paceman2jr: folds=20
Bar.usWYGRAM: folds=20
SwissGalileo: folds=20
gator856500: folds=20
nwmdnj: folds=20
4Aces518: folds=20
vincent329: raises 1200 to 2400
JJin91: folds=20
FootPerv: folds=20
Uncalled bet (1200) returned to vincent329
vincent329 collected 4350 from pot
*** SUMMARY ***
Total pot 4350 | Rake 0=20
Seat 1: SwissGalileo folded before Flop (didn't bet)
Seat 2: gator856500 folded before Flop (didn't bet)
Seat 3: nwmdnj folded before Flop (didn't bet)
Seat 4: 4Aces518 folded before Flop (didn't bet)
Seat 5: vincent329 (button) collected (4350)
Seat 6: JJin91 (small blind) folded before Flop
Seat 7: FootPerv (big blind) folded before Flop
Seat 8: Paceman2jr folded before Flop (didn't bet)
Seat 9: Bar.usWYGRAM folded before Flop (didn't bet)


*********** # 172 **************
PokerStars Hand #175012616202: Tournament #1701776547, $18.20+$1.80 USD=
 Hold'em No Limit - Level XVI (600/1200) - 2017/09/13 21:48:31 ET
Table '1701776547 10' 9-max Seat #6 is the button
Seat 1: SwissGalileo (69289 in chips)=20
Seat 2: gator856500 (30835 in chips)=20
Seat 3: nwmdnj (37104 in chips)=20
Seat 4: 4Aces518 (4260 in chips)=20
Seat 5: vincent329 (54608 in chips)=20
Seat 6: JJin91 (47101 in chips)=20
Seat 7: FootPerv (27918 in chips)=20
Seat 8: Paceman2jr (42046 in chips)=20
Seat 9: Bar.usWYGRAM (68599 in chips)=20
SwissGalileo: posts the ante 150
gator856500: posts the ante 150
nwmdnj: posts the ante 150
4Aces518: posts the ante 150
vincent329: posts the ante 150
JJin91: posts the ante 150
FootPerv: posts the ante 150
Paceman2jr: posts the ante 150
Bar.usWYGRAM: posts the ante 150
FootPerv: posts small blind 600
Paceman2jr: posts big blind 1200
*** HOLE CARDS ***
Dealt to JJin91 [Ac 4h]
Bar.usWYGRAM: folds=20
SwissGalileo: folds=20
gator856500: folds=20
nwmdnj: folds=20
4Aces518: folds=20
vincent329: calls 1200
JJin91: folds=20
FootPerv: folds=20
Paceman2jr: checks=20
*** FLOP *** [Kh Ad Jc]
Paceman2jr: checks=20
vincent329: bets 1200
Paceman2jr: folds=20
Uncalled bet (1200) returned to vincent329
vincent329 collected 4350 from pot
*** SUMMARY ***
Total pot 4350 | Rake 0=20
Board [Kh Ad Jc]
Seat 1: SwissGalileo folded before Flop (didn't bet)
Seat 2: gator856500 folded before Flop (didn't bet)
Seat 3: nwmdnj folded before Flop (didn't bet)
Seat 4: 4Aces518 folded before Flop (didn't bet)
Seat 5: vincent329 collected (4350)
Seat 6: JJin91 (button) folded before Flop (didn't bet)
Seat 7: FootPerv (small blind) folded before Flop
Seat 8: Paceman2jr (big blind) folded on the Flop
Seat 9: Bar.usWYGRAM folded before Flop (didn't bet)


*********** # 173 **************
PokerStars Hand #175012616482: Tournament #1701776547, $18.20+$1.80 USD=
 Hold'em No Limit - Level XVI (600/1200) - 2017/09/13 21:49:34 ET
Table '1701776547 10' 9-max Seat #7 is the button
Seat 1: SwissGalileo (69139 in chips)=20
Seat 2: gator856500 (30685 in chips)=20
Seat 3: nwmdnj (36954 in chips)=20
Seat 4: 4Aces518 (4110 in chips)=20
Seat 5: vincent329 (57608 in chips)=20
Seat 6: JJin91 (46951 in chips)=20
Seat 7: FootPerv (27168 in chips)=20
Seat 8: Paceman2jr (40696 in chips)=20
Seat 9: Bar.usWYGRAM (68449 in chips)=20
SwissGalileo: posts the ante 150
gator856500: posts the ante 150
nwmdnj: posts the ante 150
4Aces518: posts the ante 150
vincent329: posts the ante 150
JJin91: posts the ante 150
FootPerv: posts the ante 150
Paceman2jr: posts the ante 150
Bar.usWYGRAM: posts the ante 150
Paceman2jr: posts small blind 600
Bar.usWYGRAM: posts big blind 1200
*** HOLE CARDS ***
Dealt to JJin91 [9h 4c]
SwissGalileo: folds=20
gator856500: folds=20
nwmdnj: folds=20
4Aces518: folds=20
vincent329: folds=20
JJin91: folds=20
FootPerv: raises 1752 to 2952
Paceman2jr: folds=20
Bar.usWYGRAM: calls 1752
*** FLOP *** [Kh Td 9s]
Bar.usWYGRAM: bets 1800
FootPerv: calls 1800
*** TURN *** [Kh Td 9s] [8d]
Bar.usWYGRAM: bets 4009
FootPerv: folds=20
Uncalled bet (4009) returned to Bar.usWYGRAM
Bar.usWYGRAM collected 11454 from pot
*** SUMMARY ***
Total pot 11454 | Rake 0=20
Board [Kh Td 9s 8d]
Seat 1: SwissGalileo folded before Flop (didn't bet)
Seat 2: gator856500 folded before Flop (didn't bet)
Seat 3: nwmdnj folded before Flop (didn't bet)
Seat 4: 4Aces518 folded before Flop (didn't bet)
Seat 5: vincent329 folded before Flop (didn't bet)
Seat 6: JJin91 folded before Flop (didn't bet)
Seat 7: FootPerv (button) folded on the Turn
Seat 8: Paceman2jr (small blind) folded before Flop
Seat 9: Bar.usWYGRAM (big blind) collected (11454)


*********** # 174 **************
PokerStars Hand #175012616771: Tournament #1701776547, $18.20+$1.80 USD=
 Hold'em No Limit - Level XVI (600/1200) - 2017/09/13 21:50:42 ET
Table '1701776547 10' 9-max Seat #8 is the button
Seat 1: SwissGalileo (68989 in chips)=20
Seat 2: gator856500 (30535 in chips)=20
Seat 4: 4Aces518 (3960 in chips)=20
Seat 5: vincent329 (57458 in chips)=20
Seat 6: JJin91 (46801 in chips)=20
Seat 7: FootPerv (22266 in chips)=20
Seat 8: Paceman2jr (39946 in chips)=20
Seat 9: Bar.usWYGRAM (75001 in chips)=20
SwissGalileo: posts the ante 150
gator856500: posts the ante 150
4Aces518: posts the ante 150
vincent329: posts the ante 150
JJin91: posts the ante 150
FootPerv: posts the ante 150
Paceman2jr: posts the ante 150
Bar.usWYGRAM: posts the ante 150
Bar.usWYGRAM: posts small blind 600
SwissGalileo: posts big blind 1200
*** HOLE CARDS ***
Dealt to JJin91 [8d 8s]
gator856500: folds=20
4Aces518: raises 2610 to 3810 and is all-in
vincent329: folds=20
JJin91: calls 3810
FootPerv: folds=20
Paceman2jr: folds=20
Bar.usWYGRAM: calls 3210
SwissGalileo: folds=20
*** FLOP *** [6c Jd 3d]
Bar.usWYGRAM: checks=20
JJin91: checks=20
*** TURN *** [6c Jd 3d] [8c]
Bar.usWYGRAM: bets 3600
JJin91: raises 5288 to 8888
Bar.usWYGRAM: folds=20
Uncalled bet (5288) returned to JJin91
*** RIVER *** [6c Jd 3d 8c] [2h]
*** SHOW DOWN ***
JJin91: shows [8d 8s] (three of a kind, Eights)
JJin91 collected 7200 from side pot
4Aces518: shows [Js Qh] (a pair of Jacks)
JJin91 collected 13830 from main pot
4Aces518 finished the tournament in 24th place
*** SUMMARY ***
Total pot 21030 Main pot 13830. Side pot 7200. | Rake 0=20
Board [6c Jd 3d 8c 2h]
Seat 1: SwissGalileo (big blind) folded before Flop
Seat 2: gator856500 folded before Flop (didn't bet)
Seat 4: 4Aces518 showed [Js Qh] and lost with a pair of Jacks
Seat 5: vincent329 folded before Flop (didn't bet)
Seat 6: JJin91 showed [8d 8s] and won (21030) with three of a kind, Eig=
hts
Seat 7: FootPerv folded before Flop (didn't bet)
Seat 8: Paceman2jr (button) folded before Flop (didn't bet)
Seat 9: Bar.usWYGRAM (small blind) folded on the Turn


*********** # 175 **************
PokerStars Hand #175012617186: Tournament #1701776547, $18.20+$1.80 USD=
 Hold'em No Limit - Level XVII (700/1400) - 2017/09/13 21:52:22 ET
Table '1701776547 10' 9-max Seat #9 is the button
Seat 1: SwissGalileo (67639 in chips)=20
Seat 2: gator856500 (30385 in chips)=20
Seat 5: vincent329 (57308 in chips)=20
Seat 6: JJin91 (60271 in chips)=20
Seat 7: FootPerv (22116 in chips)=20
Seat 8: Paceman2jr (39796 in chips)=20
Seat 9: Bar.usWYGRAM (67441 in chips)=20
SwissGalileo: posts the ante 175
gator856500: posts the ante 175
vincent329: posts the ante 175
JJin91: posts the ante 175
FootPerv: posts the ante 175
Paceman2jr: posts the ante 175
Bar.usWYGRAM: posts the ante 175
SwissGalileo: posts small blind 700
gator856500: posts big blind 1400
*** HOLE CARDS ***
Dealt to JJin91 [7s 3s]
vincent329: folds=20
JJin91: folds=20
FootPerv: folds=20
Paceman2jr: raises 2800 to 4200
Bar.usWYGRAM: folds=20
SwissGalileo: folds=20
gator856500: folds=20
Uncalled bet (2800) returned to Paceman2jr
Paceman2jr collected 4725 from pot
*** SUMMARY ***
Total pot 4725 | Rake 0=20
Seat 1: SwissGalileo (small blind) folded before Flop
Seat 2: gator856500 (big blind) folded before Flop
Seat 5: vincent329 folded before Flop (didn't bet)
Seat 6: JJin91 folded before Flop (didn't bet)
Seat 7: FootPerv folded before Flop (didn't bet)
Seat 8: Paceman2jr collected (4725)
Seat 9: Bar.usWYGRAM (button) folded before Flop (didn't bet)


*********** # 176 **************
PokerStars Hand #175012617251: Tournament #1701776547, $18.20+$1.80 USD=
 Hold'em No Limit - Level XVII (700/1400) - 2017/09/13 21:52:38 ET
Table '1701776547 10' 9-max Seat #1 is the button
Seat 1: SwissGalileo (66764 in chips)=20
Seat 2: gator856500 (28810 in chips)=20
Seat 5: vincent329 (57133 in chips)=20
Seat 6: JJin91 (60096 in chips)=20
Seat 7: FootPerv (21941 in chips)=20
Seat 8: Paceman2jr (42946 in chips)=20
Seat 9: Bar.usWYGRAM (67266 in chips)=20
SwissGalileo: posts the ante 175
gator856500: posts the ante 175
vincent329: posts the ante 175
JJin91: posts the ante 175
FootPerv: posts the ante 175
Paceman2jr: posts the ante 175
Bar.usWYGRAM: posts the ante 175
gator856500: posts small blind 700
vincent329: posts big blind 1400
*** HOLE CARDS ***
Dealt to JJin91 [Qs Qd]
JJin91: raises 1638 to 3038
FootPerv: folds=20
Paceman2jr: folds=20
Bar.usWYGRAM: folds=20
SwissGalileo: folds=20
gator856500: folds=20
vincent329: calls 1638
*** FLOP *** [3d Tc Kd]
vincent329: checks=20
JJin91: bets 3111
vincent329: raises 3111 to 6222
JJin91: calls 3111
*** TURN *** [3d Tc Kd] [7c]
vincent329: bets 7000
JJin91: calls 7000
*** RIVER *** [3d Tc Kd 7c] [As]
vincent329: bets 7000
JJin91: raises 15400 to 22400
vincent329: calls 15400
*** SHOW DOWN ***
JJin91: shows [Qs Qd] (a pair of Queens)
vincent329: shows [Ts 3s] (two pair, Tens and Threes)
vincent329 collected 79245 from pot
*** SUMMARY ***
Total pot 79245 | Rake 0=20
Board [3d Tc Kd 7c As]
Seat 1: SwissGalileo (button) folded before Flop (didn't bet)
Seat 2: gator856500 (small blind) folded before Flop
Seat 5: vincent329 (big blind) showed [Ts 3s] and won (79245) with two =
pair, Tens and Threes
Seat 6: JJin91 showed [Qs Qd] and lost with a pair of Queens
Seat 7: FootPerv folded before Flop (didn't bet)
Seat 8: Paceman2jr folded before Flop (didn't bet)
Seat 9: Bar.usWYGRAM folded before Flop (didn't bet)


*********** # 177 **************
PokerStars Hand #175012617594: Tournament #1701776547, $18.20+$1.80 USD=
 Hold'em No Limit - Level XVII (700/1400) - 2017/09/13 21:54:09 ET
Table '1701776547 10' 9-max Seat #2 is the button
Seat 1: SwissGalileo (66589 in chips)=20
Seat 2: gator856500 (27935 in chips)=20
Seat 5: vincent329 (97543 in chips)=20
Seat 6: JJin91 (21261 in chips)=20
Seat 7: FootPerv (21766 in chips)=20
Seat 8: Paceman2jr (42771 in chips)=20
Seat 9: Bar.usWYGRAM (67091 in chips)=20
SwissGalileo: posts the ante 175
gator856500: posts the ante 175
vincent329: posts the ante 175
JJin91: posts the ante 175
FootPerv: posts the ante 175
Paceman2jr: posts the ante 175
Bar.usWYGRAM: posts the ante 175
vincent329: posts small blind 700
JJin91: posts big blind 1400
*** HOLE CARDS ***
Dealt to JJin91 [Jd Ts]
FootPerv: folds=20
Paceman2jr: folds=20
Bar.usWYGRAM: raises 1400 to 2800
SwissGalileo: folds=20
gator856500: folds=20
vincent329: calls 2100
JJin91: calls 1400
*** FLOP *** [Kc Qc Qs]
Bar.usWYGRAM said, "VINCENT"
Bar.usWYGRAM said, "WHYYYYYYY"
vincent329: checks=20
JJin91: checks=20
Bar.usWYGRAM: bets 2100
vincent329: calls 2100
JJin91: folds=20
*** TURN *** [Kc Qc Qs] [4s]
vincent329: bets 5600
Bar.usWYGRAM: calls 5600
*** RIVER *** [Kc Qc Qs 4s] [3h]
vincent329: bets 5600
Bar.usWYGRAM said, "U GOT Q"
Bar.usWYGRAM said, "SO I FOLD MY aa"
Bar.usWYGRAM: folds [As]
Uncalled bet (5600) returned to vincent329
vincent329 collected 25025 from pot
*** SUMMARY ***
Total pot 25025 | Rake 0=20
Board [Kc Qc Qs 4s 3h]
Seat 1: SwissGalileo folded before Flop (didn't bet)
Seat 2: gator856500 (button) folded before Flop (didn't bet)
Seat 5: vincent329 (small blind) collected (25025)
Seat 6: JJin91 (big blind) folded on the Flop
Seat 7: FootPerv folded before Flop (didn't bet)
Seat 8: Paceman2jr folded before Flop (didn't bet)
Seat 9: Bar.usWYGRAM folded on the River


*********** # 178 **************
PokerStars Hand #175012618995: Tournament #1701776547, $18.20+$1.80 USD=
 Hold'em No Limit - Level XVII (700/1400) - 2017/09/13 22:00:46 ET
Table '1701776547 10' 9-max Seat #5 is the button
Seat 1: SwissGalileo (66414 in chips)=20
Seat 2: gator856500 (27760 in chips)=20
Seat 5: vincent329 (111893 in chips)=20
Seat 6: JJin91 (18286 in chips)=20
Seat 7: FootPerv (21591 in chips)=20
Seat 8: Paceman2jr (42596 in chips)=20
Seat 9: Bar.usWYGRAM (56416 in chips)=20
SwissGalileo: posts the ante 175
gator856500: posts the ante 175
vincent329: posts the ante 175
JJin91: posts the ante 175
FootPerv: posts the ante 175
Paceman2jr: posts the ante 175
Bar.usWYGRAM: posts the ante 175
JJin91: posts small blind 700
FootPerv: posts big blind 1400
*** HOLE CARDS ***
Dealt to JJin91 [8d Jd]
Paceman2jr: folds=20
Bar.usWYGRAM: folds=20
SwissGalileo: folds=20
gator856500: folds=20
Bar.usWYGRAM said, "LETZ DO IT"
vincent329: folds=20
JJin91: raises 16711 to 18111 and is all-in
FootPerv: folds=20
Uncalled bet (16711) returned to JJin91
JJin91 collected 4025 from pot
JJin91: doesn't show hand=20
*** SUMMARY ***
Total pot 4025 | Rake 0=20
Seat 1: SwissGalileo folded before Flop (didn't bet)
Seat 2: gator856500 folded before Flop (didn't bet)
Seat 5: vincent329 (button) folded before Flop (didn't bet)
Seat 6: JJin91 (small blind) collected (4025)
Seat 7: FootPerv (big blind) folded before Flop
Seat 8: Paceman2jr folded before Flop (didn't bet)
Seat 9: Bar.usWYGRAM folded before Flop (didn't bet)


*********** # 179 **************
PokerStars Hand #175012619327: Tournament #1701776547, $18.20+$1.80 USD=
 Hold'em No Limit - Level XVII (700/1400) - 2017/09/13 22:02:02 ET
Table '1701776547 10' 9-max Seat #6 is the button
Seat 1: SwissGalileo (66239 in chips)=20
Seat 2: gator856500 (27585 in chips)=20
Seat 5: vincent329 (111718 in chips)=20
Seat 6: JJin91 (20736 in chips)=20
Seat 7: FootPerv (20016 in chips)=20
Seat 8: Paceman2jr (42421 in chips)=20
Seat 9: Bar.usWYGRAM (56241 in chips)=20
SwissGalileo: posts the ante 175
gator856500: posts the ante 175
vincent329: posts the ante 175
JJin91: posts the ante 175
FootPerv: posts the ante 175
Paceman2jr: posts the ante 175
Bar.usWYGRAM: posts the ante 175
FootPerv: posts small blind 700
Paceman2jr: posts big blind 1400
*** HOLE CARDS ***
Dealt to JJin91 [Tc 4h]
Bar.usWYGRAM: raises 1400 to 2800
SwissGalileo: folds=20
gator856500: folds=20
vincent329: folds=20
JJin91: folds=20
FootPerv: folds=20
Paceman2jr: folds=20
Uncalled bet (1400) returned to Bar.usWYGRAM
Bar.usWYGRAM collected 4725 from pot
*** SUMMARY ***
Total pot 4725 | Rake 0=20
Seat 1: SwissGalileo folded before Flop (didn't bet)
Seat 2: gator856500 folded before Flop (didn't bet)
Seat 5: vincent329 folded before Flop (didn't bet)
Seat 6: JJin91 (button) folded before Flop (didn't bet)
Seat 7: FootPerv (small blind) folded before Flop
Seat 8: Paceman2jr (big blind) folded before Flop
Seat 9: Bar.usWYGRAM collected (4725)


*********** # 180 **************
PokerStars Hand #175012619427: Tournament #1701776547, $18.20+$1.80 USD=
 Hold'em No Limit - Level XVII (700/1400) - 2017/09/13 22:02:27 ET
Table '1701776547 10' 9-max Seat #7 is the button
Seat 1: SwissGalileo (66064 in chips)=20
Seat 2: gator856500 (27410 in chips)=20
Seat 5: vincent329 (111543 in chips)=20
Seat 6: JJin91 (20561 in chips)=20
Seat 7: FootPerv (19141 in chips)=20
Seat 8: Paceman2jr (40846 in chips)=20
Seat 9: Bar.usWYGRAM (59391 in chips)=20
SwissGalileo: posts the ante 175
gator856500: posts the ante 175
vincent329: posts the ante 175
JJin91: posts the ante 175
FootPerv: posts the ante 175
Paceman2jr: posts the ante 175
Bar.usWYGRAM: posts the ante 175
Paceman2jr: posts small blind 700
Bar.usWYGRAM: posts big blind 1400
*** HOLE CARDS ***
Dealt to JJin91 [6h 9c]
SwissGalileo: raises 7525 to 8925
gator856500: folds=20
vincent329: folds=20
JJin91: folds=20
FootPerv: folds=20
Paceman2jr: folds=20
Bar.usWYGRAM: raises 50291 to 59216 and is all-in
SwissGalileo: calls 50291
Bar.usWYGRAM said, "hooooooooold"
*** FLOP *** [4s 3c 9h]
Bar.usWYGRAM said, "GOOOOOOOOOOLD"
*** TURN *** [4s 3c 9h] [Js]
Bar.usWYGRAM said, "HOOOOOOOOOOOOLF"
Bar.usWYGRAM said, "HODLDLSAJ"
*** RIVER *** [4s 3c 9h Js] [3h]
Bar.usWYGRAM said, "G"
*** SHOW DOWN ***
Bar.usWYGRAM: shows [Kc Kh] (two pair, Kings and Threes)
SwissGalileo: shows [Ac Qh] (a pair of Threes)
Bar.usWYGRAM said, "NICEEEEEEEE"
Bar.usWYGRAM collected 120357 from pot
Bar.usWYGRAM said, "<3"
*** SUMMARY ***
Total pot 120357 | Rake 0=20
Board [4s 3c 9h Js 3h]
Seat 1: SwissGalileo showed [Ac Qh] and lost with a pair of Threes
Seat 2: gator856500 folded before Flop (didn't bet)
Seat 5: vincent329 folded before Flop (didn't bet)
Seat 6: JJin91 folded before Flop (didn't bet)
Seat 7: FootPerv (button) folded before Flop (didn't bet)
Seat 8: Paceman2jr (small blind) folded before Flop
Seat 9: Bar.usWYGRAM (big blind) showed [Kc Kh] and won (120357) with t=
wo pair, Kings and Threes


*********** # 181 **************
PokerStars Hand #175012619624: Tournament #1701776547, $18.20+$1.80 USD=
 Hold'em No Limit - Level XVII (700/1400) - 2017/09/13 22:03:11 ET
Table '1701776547 10' 9-max Seat #8 is the button
Seat 1: SwissGalileo (6673 in chips)=20
Seat 2: gator856500 (27235 in chips)=20
Seat 5: vincent329 (111368 in chips)=20
Seat 6: JJin91 (20386 in chips)=20
Seat 7: FootPerv (18966 in chips)=20
Seat 8: Paceman2jr (39971 in chips)=20
Seat 9: Bar.usWYGRAM (120357 in chips)=20
SwissGalileo: posts the ante 175
gator856500: posts the ante 175
vincent329: posts the ante 175
JJin91: posts the ante 175
FootPerv: posts the ante 175
Paceman2jr: posts the ante 175
Bar.usWYGRAM: posts the ante 175
Bar.usWYGRAM: posts small blind 700
SwissGalileo: posts big blind 1400
*** HOLE CARDS ***
Dealt to JJin91 [5h 4h]
gator856500: folds=20
vincent329: raises 2800 to 4200
JJin91: folds=20
FootPerv: folds=20
Paceman2jr: folds=20
Bar.usWYGRAM said, "HOW U CAN CALL THERE WITH AQ ?"
SwissGalileo said, "get cancer"
Bar.usWYGRAM said, "I GOT ALREADY"
Bar.usWYGRAM has timed out
Bar.usWYGRAM: folds=20
Bar.usWYGRAM is sitting out
Bar.usWYGRAM has returned
SwissGalileo: raises 2298 to 6498 and is all-in
vincent329: calls 2298
*** FLOP *** [Tc 6c Ah]
*** TURN *** [Tc 6c Ah] [9c]
Bar.usWYGRAM said, "U GET HIV"
*** RIVER *** [Tc 6c Ah 9c] [9d]
*** SHOW DOWN ***
SwissGalileo: shows [6h Jh] (two pair, Nines and Sixes)
vincent329: shows [8d Ad] (two pair, Aces and Nines)
vincent329 collected 14921 from pot
SwissGalileo finished the tournament in 22nd place
*** SUMMARY ***
Total pot 14921 | Rake 0=20
Board [Tc 6c Ah 9c 9d]
Seat 1: SwissGalileo (big blind) showed [6h Jh] and lost with two pair,=
 Nines and Sixes
Seat 2: gator856500 folded before Flop (didn't bet)
Seat 5: vincent329 showed [8d Ad] and won (14921) with two pair, Aces a=
nd Nines
Seat 6: JJin91 folded before Flop (didn't bet)
Seat 7: FootPerv folded before Flop (didn't bet)
Seat 8: Paceman2jr (button) folded before Flop (didn't bet)
Seat 9: Bar.usWYGRAM (small blind) folded before Flop


*********** # 182 **************
PokerStars Hand #175012619835: Tournament #1701776547, $18.20+$1.80 USD=
 Hold'em No Limit - Level XVII (700/1400) - 2017/09/13 22:04:01 ET
Table '1701776547 10' 9-max Seat #9 is the button
Seat 2: gator856500 (27060 in chips)=20
Seat 5: vincent329 (119616 in chips)=20
Seat 6: JJin91 (20211 in chips)=20
Seat 7: FootPerv (18791 in chips)=20
Seat 8: Paceman2jr (39796 in chips)=20
Seat 9: Bar.usWYGRAM (119482 in chips)=20
gator856500: posts the ante 175
vincent329: posts the ante 175
JJin91: posts the ante 175
FootPerv: posts the ante 175
Paceman2jr: posts the ante 175
Bar.usWYGRAM: posts the ante 175
gator856500: posts small blind 700
vincent329: posts big blind 1400
*** HOLE CARDS ***
Dealt to JJin91 [Jh 6d]
JJin91: folds=20
FootPerv: raises 2044 to 3444
Paceman2jr: folds=20
Bar.usWYGRAM said, "BUT GUYS, U CALL THERE WITH AQ ? WHILE HAVINF 40BB =
?"
Bar.usWYGRAM: folds=20
gator856500: folds=20
vincent329: calls 2044
*** FLOP *** [7d 8d 9c]
vincent329: checks=20
FootPerv: checks=20
*** TURN *** [7d 8d 9c] [4h]
Bar.usWYGRAM said, "AK I CAN CONSIDER"
vincent329: checks=20
Bar.usWYGRAM said, "QQ"
Bar.usWYGRAM said, "AA"
Bar.usWYGRAM said, "NOT AQ"
FootPerv: bets 3714
vincent329: raises 3714 to 7428
FootPerv: raises 7744 to 15172 and is all-in
vincent329: calls 7744
*** RIVER *** [7d 8d 9c 4h] [Td]
*** SHOW DOWN ***
vincent329: shows [5s 6s] (a straight, Six to Ten)
FootPerv: shows [3c 3d] (a pair of Threes)
vincent329 collected 38982 from pot
FootPerv finished the tournament in 21st place
*** SUMMARY ***
Total pot 38982 | Rake 0=20
Board [7d 8d 9c 4h Td]
Seat 2: gator856500 (small blind) folded before Flop
Seat 5: vincent329 (big blind) showed [5s 6s] and won (38982) with a st=
raight, Six to Ten
Seat 6: JJin91 folded before Flop (didn't bet)
Seat 7: FootPerv showed [3c 3d] and lost with a pair of Threes
Seat 8: Paceman2jr folded before Flop (didn't bet)
Seat 9: Bar.usWYGRAM (button) folded before Flop (didn't bet)


*********** # 183 **************
PokerStars Hand #175015253455: Tournament #1701776547, $18.20+$1.80 USD=
 Hold'em No Limit - Level XVII (700/1400) - 2017/09/13 22:05:30 ET
Table '1701776547 10' 9-max Seat #2 is the button
Seat 2: gator856500 (26185 in chips)=20
Seat 3: nwmdnj (41104 in chips) out of hand (moved from another table i=
nto small blind)
Seat 5: vincent329 (139807 in chips)=20
Seat 6: JJin91 (20036 in chips)=20
Seat 8: Paceman2jr (39621 in chips)=20
Seat 9: Bar.usWYGRAM (119307 in chips)=20
gator856500: posts the ante 175
vincent329: posts the ante 175
JJin91: posts the ante 175
Paceman2jr: posts the ante 175
Bar.usWYGRAM: posts the ante 175
vincent329: posts small blind 700
JJin91: posts big blind 1400
*** HOLE CARDS ***
Dealt to JJin91 [5h 9c]
Paceman2jr: raises 4375 to 5775
Bar.usWYGRAM: folds=20
gator856500: folds=20
vincent329: folds=20
JJin91: folds=20
Uncalled bet (4375) returned to Paceman2jr
Paceman2jr collected 4375 from pot
*** SUMMARY ***
Total pot 4375 | Rake 0=20
Seat 2: gator856500 (button) folded before Flop (didn't bet)
Seat 5: vincent329 (small blind) folded before Flop
Seat 6: JJin91 (big blind) folded before Flop
Seat 8: Paceman2jr collected (4375)
Seat 9: Bar.usWYGRAM folded before Flop (didn't bet)


*********** # 184 **************
PokerStars Hand #175015253552: Tournament #1701776547, $18.20+$1.80 USD=
 Hold'em No Limit - Level XVII (700/1400) - 2017/09/13 22:05:51 ET
Table '1701776547 10' 9-max Seat #5 is the button
Seat 2: gator856500 (26010 in chips)=20
Seat 3: nwmdnj (41104 in chips)=20
Seat 5: vincent329 (138932 in chips)=20
Seat 6: JJin91 (18461 in chips)=20
Seat 8: Paceman2jr (42421 in chips)=20
Seat 9: Bar.usWYGRAM (119132 in chips)=20
gator856500: posts the ante 175
nwmdnj: posts the ante 175
vincent329: posts the ante 175
JJin91: posts the ante 175
Paceman2jr: posts the ante 175
Bar.usWYGRAM: posts the ante 175
JJin91: posts small blind 700
Paceman2jr: posts big blind 1400
*** HOLE CARDS ***
Dealt to JJin91 [5d 5s]
Bar.usWYGRAM: calls 1400
gator856500: folds=20
Bar.usWYGRAM said, "IN LAST SECONG"
Bar.usWYGRAM said, "SECONG"
Bar.usWYGRAM said, "SECONF"
nwmdnj: calls 1400
vincent329: folds=20
Bar.usWYGRAM said, "SECOND"
JJin91: raises 16886 to 18286 and is all-in
Paceman2jr: folds=20
Bar.usWYGRAM: folds=20
nwmdnj: folds=20
Uncalled bet (16886) returned to JJin91
JJin91 collected 6650 from pot
JJin91: doesn't show hand=20
*** SUMMARY ***
Total pot 6650 | Rake 0=20
Seat 2: gator856500 folded before Flop (didn't bet)
Seat 3: nwmdnj folded before Flop
Seat 5: vincent329 (button) folded before Flop (didn't bet)
Seat 6: JJin91 (small blind) collected (6650)
Seat 8: Paceman2jr (big blind) folded before Flop
Seat 9: Bar.usWYGRAM folded before Flop


*********** # 185 **************
PokerStars Hand #175015253784: Tournament #1701776547, $18.20+$1.80 USD=
 Hold'em No Limit - Level XVII (700/1400) - 2017/09/13 22:06:45 ET
Table '1701776547 10' 9-max Seat #6 is the button
Seat 2: gator856500 (25835 in chips)=20
Seat 3: nwmdnj (39529 in chips)=20
Seat 5: vincent329 (138757 in chips)=20
Seat 6: JJin91 (23536 in chips)=20
Seat 8: Paceman2jr (40846 in chips)=20
Seat 9: Bar.usWYGRAM (117557 in chips)=20
gator856500: posts the ante 175
nwmdnj: posts the ante 175
vincent329: posts the ante 175
JJin91: posts the ante 175
Paceman2jr: posts the ante 175
Bar.usWYGRAM: posts the ante 175
Paceman2jr: posts small blind 700
Bar.usWYGRAM: posts big blind 1400
*** HOLE CARDS ***
Dealt to JJin91 [3s 5c]
gator856500: folds=20
nwmdnj: folds=20
vincent329: folds=20
JJin91: folds=20
Paceman2jr: raises 2800 to 4200
Bar.usWYGRAM: calls 2800
*** FLOP *** [Ad Qh 7c]
Paceman2jr: bets 9450
Bar.usWYGRAM: calls 9450
*** TURN *** [Ad Qh 7c] [4c]
Paceman2jr: bets 27021 and is all-in
Bar.usWYGRAM: folds=20
Uncalled bet (27021) returned to Paceman2jr
Paceman2jr collected 28350 from pot
*** SUMMARY ***
Total pot 28350 | Rake 0=20
Board [Ad Qh 7c 4c]
Seat 2: gator856500 folded before Flop (didn't bet)
Seat 3: nwmdnj folded before Flop (didn't bet)
Seat 5: vincent329 folded before Flop (didn't bet)
Seat 6: JJin91 (button) folded before Flop (didn't bet)
Seat 8: Paceman2jr (small blind) collected (28350)
Seat 9: Bar.usWYGRAM (big blind) folded on the Turn


*********** # 186 **************
PokerStars Hand #175015254058: Tournament #1701776547, $18.20+$1.80 USD=
 Hold'em No Limit - Level XVIII (800/1600) - 2017/09/13 22:07:45 ET
Table '1701776547 10' 9-max Seat #8 is the button
Seat 2: gator856500 (25660 in chips)=20
Seat 3: nwmdnj (39354 in chips)=20
Seat 5: vincent329 (138582 in chips)=20
Seat 6: JJin91 (23361 in chips)=20
Seat 8: Paceman2jr (55371 in chips)=20
Seat 9: Bar.usWYGRAM (103732 in chips)=20
gator856500: posts the ante 200
nwmdnj: posts the ante 200
vincent329: posts the ante 200
JJin91: posts the ante 200
Paceman2jr: posts the ante 200
Bar.usWYGRAM: posts the ante 200
Bar.usWYGRAM: posts small blind 800
gator856500: posts big blind 1600
*** HOLE CARDS ***
Dealt to JJin91 [2c Jd]
nwmdnj: folds=20
vincent329: calls 1600
JJin91: folds=20
Paceman2jr: folds=20
Bar.usWYGRAM: calls 800
gator856500: checks=20
*** FLOP *** [Ts 9d 2s]
Bar.usWYGRAM: checks=20
gator856500: bets 3000
vincent329: calls 3000
Bar.usWYGRAM: calls 3000
*** TURN *** [Ts 9d 2s] [4c]
Bar.usWYGRAM: checks=20
gator856500: checks=20
vincent329: bets 3200
Bar.usWYGRAM: folds=20
gator856500: calls 3200
*** RIVER *** [Ts 9d 2s 4c] [3h]
gator856500: bets 4800
vincent329: folds=20
Uncalled bet (4800) returned to gator856500
gator856500 collected 21400 from pot
gator856500: doesn't show hand=20
*** SUMMARY ***
Total pot 21400 | Rake 0=20
Board [Ts 9d 2s 4c 3h]
Seat 2: gator856500 (big blind) collected (21400)
Seat 3: nwmdnj folded before Flop (didn't bet)
Seat 5: vincent329 folded on the River
Seat 6: JJin91 folded before Flop (didn't bet)
Seat 8: Paceman2jr (button) folded before Flop (didn't bet)
Seat 9: Bar.usWYGRAM (small blind) folded on the Turn


*********** # 187 **************
PokerStars Hand #175015254301: Tournament #1701776547, $18.20+$1.80 USD=
 Hold'em No Limit - Level XVIII (800/1600) - 2017/09/13 22:08:47 ET
Table '1701776547 10' 9-max Seat #9 is the button
Seat 2: gator856500 (39060 in chips)=20
Seat 3: nwmdnj (39154 in chips)=20
Seat 5: vincent329 (130582 in chips)=20
Seat 6: JJin91 (23161 in chips)=20
Seat 8: Paceman2jr (55171 in chips)=20
Seat 9: Bar.usWYGRAM (98932 in chips)=20
gator856500: posts the ante 200
nwmdnj: posts the ante 200
vincent329: posts the ante 200
JJin91: posts the ante 200
Paceman2jr: posts the ante 200
Bar.usWYGRAM: posts the ante 200
gator856500: posts small blind 800
nwmdnj: posts big blind 1600
*** HOLE CARDS ***
Dealt to JJin91 [7s Th]
vincent329: calls 1600
JJin91: folds=20
Paceman2jr: folds=20
Bar.usWYGRAM: folds=20
gator856500: calls 800
nwmdnj: checks=20
*** FLOP *** [7h 4d 5s]
gator856500: checks=20
nwmdnj: checks=20
vincent329: bets 6000
gator856500: folds=20
nwmdnj: calls 6000
*** TURN *** [7h 4d 5s] [Ks]
nwmdnj: checks=20
vincent329: checks=20
*** RIVER *** [7h 4d 5s Ks] [9s]
nwmdnj: checks=20
vincent329: bets 6400
nwmdnj: folds=20
Uncalled bet (6400) returned to vincent329
vincent329 collected 18000 from pot
*** SUMMARY ***
Total pot 18000 | Rake 0=20
Board [7h 4d 5s Ks 9s]
Seat 2: gator856500 (small blind) folded on the Flop
Seat 3: nwmdnj (big blind) folded on the River
Seat 5: vincent329 collected (18000)
Seat 6: JJin91 folded before Flop (didn't bet)
Seat 8: Paceman2jr folded before Flop (didn't bet)
Seat 9: Bar.usWYGRAM (button) folded before Flop (didn't bet)


*********** # 188 **************
PokerStars Hand #175015254554: Tournament #1701776547, $18.20+$1.80 USD=
 Hold'em No Limit - Level XVIII (800/1600) - 2017/09/13 22:09:46 ET
Table '1701776547 10' 9-max Seat #2 is the button
Seat 2: gator856500 (37260 in chips)=20
Seat 3: nwmdnj (31354 in chips)=20
Seat 5: vincent329 (140782 in chips)=20
Seat 6: JJin91 (22961 in chips)=20
Seat 8: Paceman2jr (54971 in chips)=20
Seat 9: Bar.usWYGRAM (98732 in chips)=20
gator856500: posts the ante 200
nwmdnj: posts the ante 200
vincent329: posts the ante 200
JJin91: posts the ante 200
Paceman2jr: posts the ante 200
Bar.usWYGRAM: posts the ante 200
nwmdnj: posts small blind 800
vincent329: posts big blind 1600
*** HOLE CARDS ***
Dealt to JJin91 [Jc 7h]
JJin91: folds=20
Paceman2jr: folds=20
Bar.usWYGRAM: folds=20
gator856500: calls 1600
nwmdnj: calls 800
vincent329: checks=20
*** FLOP *** [3h 3s Js]
nwmdnj: checks=20
vincent329: checks=20
gator856500: bets 6000
nwmdnj: folds=20
vincent329: folds=20
Uncalled bet (6000) returned to gator856500
gator856500 collected 6000 from pot
gator856500: doesn't show hand=20
*** SUMMARY ***
Total pot 6000 | Rake 0=20
Board [3h 3s Js]
Seat 2: gator856500 (button) collected (6000)
Seat 3: nwmdnj (small blind) folded on the Flop
Seat 5: vincent329 (big blind) folded on the Flop
Seat 6: JJin91 folded before Flop (didn't bet)
Seat 8: Paceman2jr folded before Flop (didn't bet)
Seat 9: Bar.usWYGRAM folded before Flop (didn't bet)


*********** # 189 **************
PokerStars Hand #175015254766: Tournament #1701776547, $18.20+$1.80 USD=
 Hold'em No Limit - Level XVIII (800/1600) - 2017/09/13 22:10:37 ET
Table '1701776547 10' 9-max Seat #3 is the button
Seat 2: gator856500 (41460 in chips)=20
Seat 3: nwmdnj (29554 in chips)=20
Seat 5: vincent329 (138982 in chips)=20
Seat 6: JJin91 (22761 in chips)=20
Seat 8: Paceman2jr (54771 in chips)=20
Seat 9: Bar.usWYGRAM (98532 in chips)=20
gator856500: posts the ante 200
nwmdnj: posts the ante 200
vincent329: posts the ante 200
JJin91: posts the ante 200
Paceman2jr: posts the ante 200
Bar.usWYGRAM: posts the ante 200
vincent329: posts small blind 800
JJin91: posts big blind 1600
*** HOLE CARDS ***
Dealt to JJin91 [7d 7c]
Paceman2jr: folds=20
Bar.usWYGRAM: folds=20
gator856500: folds=20
nwmdnj: raises 1600 to 3200
vincent329: folds=20
JJin91: raises 19361 to 22561 and is all-in
nwmdnj: calls 19361
*** FLOP *** [Ks 3h Jc]
*** TURN *** [Ks 3h Jc] [6c]
*** RIVER *** [Ks 3h Jc 6c] [3d]
*** SHOW DOWN ***
JJin91: shows [7d 7c] (two pair, Sevens and Threes)
nwmdnj: shows [Qc Ad] (a pair of Threes)
JJin91 collected 47122 from pot
*** SUMMARY ***
Total pot 47122 | Rake 0=20
Board [Ks 3h Jc 6c 3d]
Seat 2: gator856500 folded before Flop (didn't bet)
Seat 3: nwmdnj (button) showed [Qc Ad] and lost with a pair of Threes
Seat 5: vincent329 (small blind) folded before Flop
Seat 6: JJin91 (big blind) showed [7d 7c] and won (47122) with two pair=
, Sevens and Threes
Seat 8: Paceman2jr folded before Flop (didn't bet)
Seat 9: Bar.usWYGRAM folded before Flop (didn't bet)


*********** # 190 **************
PokerStars Hand #175015254969: Tournament #1701776547, $18.20+$1.80 USD=
 Hold'em No Limit - Level XVIII (800/1600) - 2017/09/13 22:11:26 ET
Table '1701776547 10' 9-max Seat #5 is the button
Seat 2: gator856500 (41260 in chips)=20
Seat 3: nwmdnj (6793 in chips)=20
Seat 5: vincent329 (137982 in chips)=20
Seat 6: JJin91 (47122 in chips)=20
Seat 8: Paceman2jr (54571 in chips)=20
Seat 9: Bar.usWYGRAM (98332 in chips)=20
gator856500: posts the ante 200
nwmdnj: posts the ante 200
vincent329: posts the ante 200
JJin91: posts the ante 200
Paceman2jr: posts the ante 200
Bar.usWYGRAM: posts the ante 200
JJin91: posts small blind 800
Paceman2jr: posts big blind 1600
*** HOLE CARDS ***
Dealt to JJin91 [Kd Jh]
Bar.usWYGRAM: folds=20
gator856500: folds=20
nwmdnj: raises 4993 to 6593 and is all-in
vincent329: calls 6593
JJin91: folds=20
Paceman2jr: folds=20
*** FLOP *** [6h 9c 2h]
*** TURN *** [6h 9c 2h] [Ac]
*** RIVER *** [6h 9c 2h Ac] [7c]
*** SHOW DOWN ***
nwmdnj: shows [6s 6d] (three of a kind, Sixes)
vincent329: shows [8h Qd] (high card Ace)
nwmdnj collected 16786 from pot
*** SUMMARY ***
Total pot 16786 | Rake 0=20
Board [6h 9c 2h Ac 7c]
Seat 2: gator856500 folded before Flop (didn't bet)
Seat 3: nwmdnj showed [6s 6d] and won (16786) with three of a kind, Six=
es
Seat 5: vincent329 (button) showed [8h Qd] and lost with high card Ace
Seat 6: JJin91 (small blind) folded before Flop
Seat 8: Paceman2jr (big blind) folded before Flop
Seat 9: Bar.usWYGRAM folded before Flop (didn't bet)


*********** # 191 **************
PokerStars Hand #175015255158: Tournament #1701776547, $18.20+$1.80 USD=
 Hold'em No Limit - Level XVIII (800/1600) - 2017/09/13 22:12:13 ET
Table '1701776547 10' 9-max Seat #6 is the button
Seat 2: gator856500 (41060 in chips)=20
Seat 3: nwmdnj (16786 in chips)=20
Seat 5: vincent329 (131189 in chips)=20
Seat 6: JJin91 (46122 in chips)=20
Seat 8: Paceman2jr (52771 in chips)=20
Seat 9: Bar.usWYGRAM (98132 in chips)=20
gator856500: posts the ante 200
nwmdnj: posts the ante 200
vincent329: posts the ante 200
JJin91: posts the ante 200
Paceman2jr: posts the ante 200
Bar.usWYGRAM: posts the ante 200
Paceman2jr: posts small blind 800
Bar.usWYGRAM: posts big blind 1600
*** HOLE CARDS ***
Dealt to JJin91 [2s 5c]
gator856500: raises 3200 to 4800
nwmdnj: folds=20
vincent329: folds=20
JJin91: folds=20
Paceman2jr: folds=20
Bar.usWYGRAM: calls 3200
*** FLOP *** [Jh Qs 8c]
Bar.usWYGRAM: checks=20
gator856500: bets 4800
Bar.usWYGRAM: folds=20
Uncalled bet (4800) returned to gator856500
gator856500 collected 11600 from pot
gator856500: doesn't show hand=20
*** SUMMARY ***
Total pot 11600 | Rake 0=20
Board [Jh Qs 8c]
Seat 2: gator856500 collected (11600)
Seat 3: nwmdnj folded before Flop (didn't bet)
Seat 5: vincent329 folded before Flop (didn't bet)
Seat 6: JJin91 (button) folded before Flop (didn't bet)
Seat 8: Paceman2jr (small blind) folded before Flop
Seat 9: Bar.usWYGRAM (big blind) folded on the Flop


*********** # 192 **************
PokerStars Hand #175015255316: Tournament #1701776547, $18.20+$1.80 USD=
 Hold'em No Limit - Level XVIII (800/1600) - 2017/09/13 22:12:54 ET
Table '1701776547 10' 9-max Seat #8 is the button
Seat 2: gator856500 (47660 in chips)=20
Seat 3: nwmdnj (16586 in chips)=20
Seat 5: vincent329 (130989 in chips)=20
Seat 6: JJin91 (45922 in chips)=20
Seat 8: Paceman2jr (51771 in chips)=20
Seat 9: Bar.usWYGRAM (93132 in chips)=20
gator856500: posts the ante 200
nwmdnj: posts the ante 200
vincent329: posts the ante 200
JJin91: posts the ante 200
Paceman2jr: posts the ante 200
Bar.usWYGRAM: posts the ante 200
Bar.usWYGRAM: posts small blind 800
gator856500: posts big blind 1600
*** HOLE CARDS ***
Dealt to JJin91 [Qd Qh]
nwmdnj: folds=20
vincent329: raises 1600 to 3200
JJin91: raises 4800 to 8000
Paceman2jr: folds=20
Bar.usWYGRAM: folds=20
gator856500: folds=20
vincent329: calls 4800
*** FLOP *** [2s 3h 9c]
vincent329: checks=20
JJin91: bets 19600
vincent329: folds=20
Uncalled bet (19600) returned to JJin91
JJin91 collected 19600 from pot
JJin91: doesn't show hand=20
*** SUMMARY ***
Total pot 19600 | Rake 0=20
Board [2s 3h 9c]
Seat 2: gator856500 (big blind) folded before Flop
Seat 3: nwmdnj folded before Flop (didn't bet)
Seat 5: vincent329 folded on the Flop
Seat 6: JJin91 collected (19600)
Seat 8: Paceman2jr (button) folded before Flop (didn't bet)
Seat 9: Bar.usWYGRAM (small blind) folded before Flop


*********** # 193 **************
PokerStars Hand #175015255437: Tournament #1701776547, $18.20+$1.80 USD=
 Hold'em No Limit - Level XVIII (800/1600) - 2017/09/13 22:13:25 ET
Table '1701776547 10' 9-max Seat #9 is the button
Seat 2: gator856500 (45860 in chips)=20
Seat 3: nwmdnj (16386 in chips)=20
Seat 5: vincent329 (122789 in chips)=20
Seat 6: JJin91 (57322 in chips)=20
Seat 8: Paceman2jr (51571 in chips)=20
Seat 9: Bar.usWYGRAM (92132 in chips)=20
gator856500: posts the ante 200
nwmdnj: posts the ante 200
vincent329: posts the ante 200
JJin91: posts the ante 200
Paceman2jr: posts the ante 200
Bar.usWYGRAM: posts the ante 200
gator856500: posts small blind 800
nwmdnj: posts big blind 1600
*** HOLE CARDS ***
Dealt to JJin91 [4s 7s]
vincent329: folds=20
JJin91: folds=20
Paceman2jr: folds=20
Bar.usWYGRAM: folds=20
gator856500: folds=20
Uncalled bet (800) returned to nwmdnj
nwmdnj collected 2800 from pot
nwmdnj: doesn't show hand=20
*** SUMMARY ***
Total pot 2800 | Rake 0=20
Seat 2: gator856500 (small blind) folded before Flop
Seat 3: nwmdnj (big blind) collected (2800)
Seat 5: vincent329 folded before Flop (didn't bet)
Seat 6: JJin91 folded before Flop (didn't bet)
Seat 8: Paceman2jr folded before Flop (didn't bet)
Seat 9: Bar.usWYGRAM (button) folded before Flop (didn't bet)


*********** # 194 **************
PokerStars Hand #175015255601: Tournament #1701776547, $18.20+$1.80 USD=
 Hold'em No Limit - Level XVIII (800/1600) - 2017/09/13 22:14:09 ET
Table '1701776547 10' 9-max Seat #2 is the button
Seat 2: gator856500 (44860 in chips)=20
Seat 3: nwmdnj (18186 in chips)=20
Seat 5: vincent329 (122589 in chips)=20
Seat 6: JJin91 (57122 in chips)=20
Seat 8: Paceman2jr (51371 in chips)=20
Seat 9: Bar.usWYGRAM (91932 in chips)=20
gator856500: posts the ante 200
nwmdnj: posts the ante 200
vincent329: posts the ante 200
JJin91: posts the ante 200
Paceman2jr: posts the ante 200
Bar.usWYGRAM: posts the ante 200
nwmdnj: posts small blind 800
vincent329: posts big blind 1600
*** HOLE CARDS ***
Dealt to JJin91 [6h 2c]
JJin91: folds=20
Paceman2jr: folds=20
Bar.usWYGRAM: folds=20
gator856500: raises 3200 to 4800
nwmdnj: folds=20
vincent329: calls 3200
*** FLOP *** [2d 6d Qh]
vincent329: checks=20
gator856500: checks=20
*** TURN *** [2d 6d Qh] [6c]
vincent329: bets 4800
gator856500: calls 4800
*** RIVER *** [2d 6d Qh 6c] [3c]
vincent329: bets 6400
gator856500: calls 6400
*** SHOW DOWN ***
vincent329: shows [Kh Jc] (a pair of Sixes)
gator856500: shows [As Tc] (a pair of Sixes - Ace kicker)
gator856500 collected 34000 from pot
*** SUMMARY ***
Total pot 34000 | Rake 0=20
Board [2d 6d Qh 6c 3c]
Seat 2: gator856500 (button) showed [As Tc] and won (34000) with a pair=
 of Sixes
Seat 3: nwmdnj (small blind) folded before Flop
Seat 5: vincent329 (big blind) showed [Kh Jc] and lost with a pair of S=
ixes
Seat 6: JJin91 folded before Flop (didn't bet)
Seat 8: Paceman2jr folded before Flop (didn't bet)
Seat 9: Bar.usWYGRAM folded before Flop (didn't bet)


*********** # 195 **************
PokerStars Hand #175015255826: Tournament #1701776547, $18.20+$1.80 USD=
 Hold'em No Limit - Level XVIII (800/1600) - 2017/09/13 22:15:06 ET
Table '1701776547 10' 9-max Seat #3 is the button
Seat 2: gator856500 (62660 in chips)=20
Seat 3: nwmdnj (17186 in chips)=20
Seat 5: vincent329 (106389 in chips)=20
Seat 6: JJin91 (56922 in chips)=20
Seat 8: Paceman2jr (51171 in chips)=20
Seat 9: Bar.usWYGRAM (91732 in chips)=20
gator856500: posts the ante 200
nwmdnj: posts the ante 200
vincent329: posts the ante 200
JJin91: posts the ante 200
Paceman2jr: posts the ante 200
Bar.usWYGRAM: posts the ante 200
vincent329: posts small blind 800
JJin91: posts big blind 1600
*** HOLE CARDS ***
Dealt to JJin91 [Jd 5s]
Paceman2jr: raises 3200 to 4800
Bar.usWYGRAM: folds=20
gator856500: folds=20
nwmdnj: folds=20
vincent329: folds=20
JJin91: folds=20
Uncalled bet (3200) returned to Paceman2jr
Paceman2jr collected 5200 from pot
*** SUMMARY ***
Total pot 5200 | Rake 0=20
Seat 2: gator856500 folded before Flop (didn't bet)
Seat 3: nwmdnj (button) folded before Flop (didn't bet)
Seat 5: vincent329 (small blind) folded before Flop
Seat 6: JJin91 (big blind) folded before Flop
Seat 8: Paceman2jr collected (5200)
Seat 9: Bar.usWYGRAM folded before Flop (didn't bet)


*********** # 196 **************
PokerStars Hand #175015255947: Tournament #1701776547, $18.20+$1.80 USD=
 Hold'em No Limit - Level XVIII (800/1600) - 2017/09/13 22:15:35 ET
Table '1701776547 10' 9-max Seat #5 is the button
Seat 2: gator856500 (62460 in chips)=20
Seat 3: nwmdnj (16986 in chips)=20
Seat 5: vincent329 (105389 in chips)=20
Seat 6: JJin91 (55122 in chips)=20
Seat 8: Paceman2jr (54571 in chips)=20
Seat 9: Bar.usWYGRAM (91532 in chips)=20
gator856500: posts the ante 200
nwmdnj: posts the ante 200
vincent329: posts the ante 200
JJin91: posts the ante 200
Paceman2jr: posts the ante 200
Bar.usWYGRAM: posts the ante 200
JJin91: posts small blind 800
Paceman2jr: posts big blind 1600
*** HOLE CARDS ***
Dealt to JJin91 [Td 6d]
Bar.usWYGRAM: folds=20
gator856500: folds=20
nwmdnj: folds=20
vincent329: calls 1600
JJin91: folds=20
Paceman2jr: checks=20
*** FLOP *** [3s 2d 3c]
Paceman2jr: checks=20
vincent329: checks=20
*** TURN *** [3s 2d 3c] [Kd]
Paceman2jr: bets 3200
vincent329: raises 3200 to 6400
Paceman2jr: folds=20
Uncalled bet (3200) returned to vincent329
vincent329 collected 11600 from pot
*** SUMMARY ***
Total pot 11600 | Rake 0=20
Board [3s 2d 3c Kd]
Seat 2: gator856500 folded before Flop (didn't bet)
Seat 3: nwmdnj folded before Flop (didn't bet)
Seat 5: vincent329 (button) collected (11600)
Seat 6: JJin91 (small blind) folded before Flop
Seat 8: Paceman2jr (big blind) folded on the Turn
Seat 9: Bar.usWYGRAM folded before Flop (didn't bet)


*********** # 197 **************
PokerStars Hand #175015256194: Tournament #1701776547, $18.20+$1.80 USD=
 Hold'em No Limit - Level XVIII (800/1600) - 2017/09/13 22:16:40 ET
Table '1701776547 10' 9-max Seat #6 is the button
Seat 2: gator856500 (62260 in chips)=20
Seat 3: nwmdnj (16786 in chips)=20
Seat 5: vincent329 (111989 in chips)=20
Seat 6: JJin91 (54122 in chips)=20
Seat 8: Paceman2jr (49571 in chips)=20
Seat 9: Bar.usWYGRAM (91332 in chips)=20
gator856500: posts the ante 200
nwmdnj: posts the ante 200
vincent329: posts the ante 200
JJin91: posts the ante 200
Paceman2jr: posts the ante 200
Bar.usWYGRAM: posts the ante 200
Paceman2jr: posts small blind 800
Bar.usWYGRAM: posts big blind 1600
*** HOLE CARDS ***
Dealt to JJin91 [2d Ad]
gator856500: folds=20
nwmdnj: folds=20
vincent329: calls 1600
JJin91: calls 1600
Paceman2jr: folds=20
Bar.usWYGRAM: checks=20
*** FLOP *** [5c 5s Kc]
Bar.usWYGRAM: checks=20
vincent329: checks=20
JJin91: bets 4444
Bar.usWYGRAM: folds=20
vincent329: folds=20
Uncalled bet (4444) returned to JJin91
JJin91 collected 6800 from pot
JJin91: doesn't show hand=20
*** SUMMARY ***
Total pot 6800 | Rake 0=20
Board [5c 5s Kc]
Seat 2: gator856500 folded before Flop (didn't bet)
Seat 3: nwmdnj folded before Flop (didn't bet)
Seat 5: vincent329 folded on the Flop
Seat 6: JJin91 (button) collected (6800)
Seat 8: Paceman2jr (small blind) folded before Flop
Seat 9: Bar.usWYGRAM (big blind) folded on the Flop


*********** # 198 **************
PokerStars Hand #175015256483: Tournament #1701776547, $18.20+$1.80 USD=
 Hold'em No Limit - Level XIX (1000/2000) - 2017/09/13 22:17:50 ET
Table '1701776547 10' 9-max Seat #8 is the button
Seat 2: gator856500 (62060 in chips)=20
Seat 3: nwmdnj (16586 in chips)=20
Seat 5: vincent329 (110189 in chips)=20
Seat 6: JJin91 (59122 in chips)=20
Seat 8: Paceman2jr (48571 in chips)=20
Seat 9: Bar.usWYGRAM (89532 in chips)=20
gator856500: posts the ante 250
nwmdnj: posts the ante 250
vincent329: posts the ante 250
JJin91: posts the ante 250
Paceman2jr: posts the ante 250
Bar.usWYGRAM: posts the ante 250
Bar.usWYGRAM: posts small blind 1000
gator856500: posts big blind 2000
*** HOLE CARDS ***
Dealt to JJin91 [7h Js]
nwmdnj: folds=20
vincent329: folds=20
JJin91: folds=20
Paceman2jr: folds=20
Bar.usWYGRAM: calls 1000
gator856500: checks=20
*** FLOP *** [3s 9s Ks]
Bar.usWYGRAM: bets 2000
gator856500: calls 2000
*** TURN *** [3s 9s Ks] [2d]
Bar.usWYGRAM: checks=20
gator856500: bets 4000
Bar.usWYGRAM: folds=20
Uncalled bet (4000) returned to gator856500
gator856500 collected 9500 from pot
gator856500: doesn't show hand=20
*** SUMMARY ***
Total pot 9500 | Rake 0=20
Board [3s 9s Ks 2d]
Seat 2: gator856500 (big blind) collected (9500)
Seat 3: nwmdnj folded before Flop (didn't bet)
Seat 5: vincent329 folded before Flop (didn't bet)
Seat 6: JJin91 folded before Flop (didn't bet)
Seat 8: Paceman2jr (button) folded before Flop (didn't bet)
Seat 9: Bar.usWYGRAM (small blind) folded on the Turn


*********** # 199 **************
PokerStars Hand #175015256732: Tournament #1701776547, $18.20+$1.80 USD=
 Hold'em No Limit - Level XIX (1000/2000) - 2017/09/13 22:18:55 ET
Table '1701776547 10' 9-max Seat #9 is the button
Seat 2: gator856500 (67310 in chips)=20
Seat 3: nwmdnj (16336 in chips)=20
Seat 5: vincent329 (109939 in chips)=20
Seat 6: JJin91 (58872 in chips)=20
Seat 8: Paceman2jr (48321 in chips)=20
Seat 9: Bar.usWYGRAM (85282 in chips)=20
gator856500: posts the ante 250
nwmdnj: posts the ante 250
vincent329: posts the ante 250
JJin91: posts the ante 250
Paceman2jr: posts the ante 250
Bar.usWYGRAM: posts the ante 250
gator856500: posts small blind 1000
nwmdnj: posts big blind 2000
*** HOLE CARDS ***
Dealt to JJin91 [5d Ts]
vincent329: raises 4000 to 6000
JJin91: folds=20
Paceman2jr: folds=20
Bar.usWYGRAM: folds=20
gator856500: folds=20
nwmdnj: raises 10086 to 16086 and is all-in
vincent329: calls 10086
*** FLOP *** [7d 5s 9c]
*** TURN *** [7d 5s 9c] [Kc]
*** RIVER *** [7d 5s 9c Kc] [Jc]
*** SHOW DOWN ***
nwmdnj: shows [Qh As] (high card Ace)
vincent329: shows [6h 6s] (a pair of Sixes)
vincent329 collected 34672 from pot
nwmdnj finished the tournament in 19th place
*** SUMMARY ***
Total pot 34672 | Rake 0=20
Board [7d 5s 9c Kc Jc]
Seat 2: gator856500 (small blind) folded before Flop
Seat 3: nwmdnj (big blind) showed [Qh As] and lost with high card Ace
Seat 5: vincent329 showed [6h 6s] and won (34672) with a pair of Sixes
Seat 6: JJin91 folded before Flop (didn't bet)
Seat 8: Paceman2jr folded before Flop (didn't bet)
Seat 9: Bar.usWYGRAM (button) folded before Flop (didn't bet)


*********** # 200 **************
PokerStars Hand #175015256915: Tournament #1701776547, $18.20+$1.80 USD=
 Hold'em No Limit - Level XIX (1000/2000) - 2017/09/13 22:19:39 ET
Table '1701776547 11' 9-max Seat #3 is the button
Seat 1: gator856500 (66060 in chips)=20
Seat 2: Bsgwolfpack4 (33396 in chips)=20
Seat 3: Thucydides (118159 in chips)=20
Seat 4: CerPrisingLe (22173 in chips)=20
Seat 5: bulibasav (48201 in chips)=20
Seat 6: JJin91 (58622 in chips)=20
Seat 7: SJMayhem11 (82812 in chips)=20
Seat 8: apoch19 (39202 in chips)=20
Seat 9: Bar.usWYGRAM (85032 in chips)=20
gator856500: posts the ante 250
Bsgwolfpack4: posts the ante 250
Thucydides: posts the ante 250
CerPrisingLe: posts the ante 250
bulibasav: posts the ante 250
JJin91: posts the ante 250
SJMayhem11: posts the ante 250
apoch19: posts the ante 250
Bar.usWYGRAM: posts the ante 250
CerPrisingLe: posts small blind 1000
bulibasav: posts big blind 2000
*** HOLE CARDS ***
Dealt to JJin91 [5s 2s]
Bsgwolfpack4 said, "oh me"
JJin91: folds=20
SJMayhem11: folds=20
apoch19: folds=20
Bsgwolfpack4 said, "wjhat did you have ?"
Bar.usWYGRAM: raises 3000 to 5000
gator856500: calls 5000
Bsgwolfpack4: folds=20
Thucydides: calls 5000
CerPrisingLe: folds=20
apoch19 said, "K-Q"
bulibasav: folds=20
*** FLOP *** [Ks Jh Td]
Bsgwolfpack4 said, "you were in a flip then"
Bar.usWYGRAM: bets 7000
Bsgwolfpack4 said, "you had 2 overs"
gator856500: raises 17125 to 24125
Thucydides: folds=20
Bar.usWYGRAM: raises 55657 to 79782 and is all-in
gator856500: calls 36685 and is all-in
Uncalled bet (18972) returned to Bar.usWYGRAM
*** TURN *** [Ks Jh Td] [8h]
Bar.usWYGRAM said, "A"
apoch19 said, "yeah, i mean i'n calling there if not bubble"
Bar.usWYGRAM said, "9"
*** RIVER *** [Ks Jh Td 8h] [Js]
*** SHOW DOWN ***
Bar.usWYGRAM: shows [Qh Qc] (two pair, Queens and Jacks)
gator856500: shows [Kh Ah] (two pair, Kings and Jacks)
gator856500 collected 141870 from pot
*** SUMMARY ***
Total pot 141870 | Rake 0=20
Board [Ks Jh Td 8h Js]
Seat 1: gator856500 showed [Kh Ah] and won (141870) with two pair, King=
s and Jacks
Seat 2: Bsgwolfpack4 folded before Flop (didn't bet)
Seat 3: Thucydides (button) folded on the Flop
Seat 4: CerPrisingLe (small blind) folded before Flop
Seat 5: bulibasav (big blind) folded before Flop
Seat 6: JJin91 folded before Flop (didn't bet)
Seat 7: SJMayhem11 folded before Flop (didn't bet)
Seat 8: apoch19 folded before Flop (didn't bet)
Seat 9: Bar.usWYGRAM showed [Qh Qc] and lost with two pair, Queens and =
Jacks


*********** # 201 **************
PokerStars Hand #175015257144: Tournament #1701776547, $18.20+$1.80 USD=
 Hold'em No Limit - Level XIX (1000/2000) - 2017/09/13 22:20:34 ET
Table '1701776547 11' 9-max Seat #4 is the button
Seat 1: gator856500 (141870 in chips)=20
Seat 2: Bsgwolfpack4 (33146 in chips)=20
Seat 3: Thucydides (112909 in chips)=20
Seat 4: CerPrisingLe (20923 in chips)=20
Seat 5: bulibasav (45951 in chips)=20
Seat 6: JJin91 (58372 in chips)=20
Seat 7: SJMayhem11 (82562 in chips)=20
Seat 8: apoch19 (38952 in chips)=20
Seat 9: Bar.usWYGRAM (18972 in chips)=20
gator856500: posts the ante 250
Bsgwolfpack4: posts the ante 250
Thucydides: posts the ante 250
CerPrisingLe: posts the ante 250
bulibasav: posts the ante 250
JJin91: posts the ante 250
SJMayhem11: posts the ante 250
apoch19: posts the ante 250
Bar.usWYGRAM: posts the ante 250
bulibasav: posts small blind 1000
JJin91: posts big blind 2000
*** HOLE CARDS ***
Dealt to JJin91 [2h 7c]
SJMayhem11: folds=20
apoch19: folds=20
Bar.usWYGRAM: folds=20
gator856500: folds=20
Bsgwolfpack4: folds=20
Thucydides: folds=20
CerPrisingLe: folds=20
Bar.usWYGRAM said, "WHY U DIDNT GET ONE MORE ACE THERE"
bulibasav: folds=20
Uncalled bet (1000) returned to JJin91
JJin91 collected 4250 from pot
JJin91: doesn't show hand=20
*** SUMMARY ***
Total pot 4250 | Rake 0=20
Seat 1: gator856500 folded before Flop (didn't bet)
Seat 2: Bsgwolfpack4 folded before Flop (didn't bet)
Seat 3: Thucydides folded before Flop (didn't bet)
Seat 4: CerPrisingLe (button) folded before Flop (didn't bet)
Seat 5: bulibasav (small blind) folded before Flop
Seat 6: JJin91 (big blind) collected (4250)
Seat 7: SJMayhem11 folded before Flop (didn't bet)
Seat 8: apoch19 folded before Flop (didn't bet)
Seat 9: Bar.usWYGRAM folded before Flop (didn't bet)


*********** # 202 **************
PokerStars Hand #175015257245: Tournament #1701776547, $18.20+$1.80 USD=
 Hold'em No Limit - Level XIX (1000/2000) - 2017/09/13 22:21:01 ET
Table '1701776547 11' 9-max Seat #5 is the button
Seat 1: gator856500 (141620 in chips)=20
Seat 2: Bsgwolfpack4 (32896 in chips)=20
Seat 3: Thucydides (112659 in chips)=20
Seat 4: CerPrisingLe (20673 in chips)=20
Seat 5: bulibasav (44701 in chips)=20
Seat 6: JJin91 (61372 in chips)=20
Seat 7: SJMayhem11 (82312 in chips)=20
Seat 8: apoch19 (38702 in chips)=20
Seat 9: Bar.usWYGRAM (18722 in chips)=20
gator856500: posts the ante 250
Bsgwolfpack4: posts the ante 250
Thucydides: posts the ante 250
CerPrisingLe: posts the ante 250
bulibasav: posts the ante 250
JJin91: posts the ante 250
SJMayhem11: posts the ante 250
apoch19: posts the ante 250
Bar.usWYGRAM: posts the ante 250
JJin91: posts small blind 1000
SJMayhem11: posts big blind 2000
*** HOLE CARDS ***
Dealt to JJin91 [Td Qc]
apoch19: folds=20
Bar.usWYGRAM: raises 16472 to 18472 and is all-in
gator856500: folds=20
Bsgwolfpack4: raises 14174 to 32646 and is all-in
Thucydides: folds=20
CerPrisingLe: folds=20
bulibasav: folds=20
JJin91: folds=20
SJMayhem11: folds=20
Uncalled bet (14174) returned to Bsgwolfpack4
Bar.usWYGRAM said, "AAAAAAAAAA4444444444"
*** FLOP *** [9d 2c Th]
Bar.usWYGRAM said, "44444444444"
Bar.usWYGRAM said, "4444444444444444444"
*** TURN *** [9d 2c Th] [7s]
Bar.usWYGRAM said, "44444444444444444444444444444"
*** RIVER *** [9d 2c Th 7s] [6c]
*** SHOW DOWN ***
Bar.usWYGRAM: shows [Ah 4c] (high card Ace)
Bsgwolfpack4: shows [Ks Ac] (high card Ace - King kicker)
Bsgwolfpack4 collected 42194 from pot
Bar.usWYGRAM finished the tournament in 17th place and received $41.41.
*** SUMMARY ***
Total pot 42194 | Rake 0=20
Board [9d 2c Th 7s 6c]
Seat 1: gator856500 folded before Flop (didn't bet)
Seat 2: Bsgwolfpack4 showed [Ks Ac] and won (42194) with high card Ace
Seat 3: Thucydides folded before Flop (didn't bet)
Seat 4: CerPrisingLe folded before Flop (didn't bet)
Seat 5: bulibasav (button) folded before Flop (didn't bet)
Seat 6: JJin91 (small blind) folded before Flop
Seat 7: SJMayhem11 (big blind) folded before Flop
Seat 8: apoch19 folded before Flop (didn't bet)
Seat 9: Bar.usWYGRAM showed [Ah 4c] and lost with high card Ace


*********** # 203 **************
PokerStars Hand #175015257380: Tournament #1701776547, $18.20+$1.80 USD=
 Hold'em No Limit - Level XIX (1000/2000) - 2017/09/13 22:21:30 ET
Table '1701776547 11' 9-max Seat #6 is the button
Seat 1: gator856500 (141370 in chips)=20
Seat 2: Bsgwolfpack4 (56368 in chips)=20
Seat 3: Thucydides (112409 in chips)=20
Seat 4: CerPrisingLe (20423 in chips)=20
Seat 5: bulibasav (44451 in chips)=20
Seat 6: JJin91 (60122 in chips)=20
Seat 7: SJMayhem11 (80062 in chips)=20
Seat 8: apoch19 (38452 in chips)=20
gator856500: posts the ante 250
Bsgwolfpack4: posts the ante 250
Thucydides: posts the ante 250
CerPrisingLe: posts the ante 250
bulibasav: posts the ante 250
JJin91: posts the ante 250
SJMayhem11: posts the ante 250
apoch19: posts the ante 250
SJMayhem11: posts small blind 1000
apoch19: posts big blind 2000
*** HOLE CARDS ***
Dealt to JJin91 [2h 8c]
gator856500: folds=20
Bsgwolfpack4: folds=20
Thucydides: folds=20
CerPrisingLe: folds=20
bulibasav: folds=20
JJin91: raises 2340 to 4340
SJMayhem11: folds=20
apoch19: raises 33862 to 38202 and is all-in
JJin91: folds=20
Uncalled bet (33862) returned to apoch19
apoch19 collected 11680 from pot
apoch19: doesn't show hand=20
*** SUMMARY ***
Total pot 11680 | Rake 0=20
Seat 1: gator856500 folded before Flop (didn't bet)
Seat 2: Bsgwolfpack4 folded before Flop (didn't bet)
Seat 3: Thucydides folded before Flop (didn't bet)
Seat 4: CerPrisingLe folded before Flop (didn't bet)
Seat 5: bulibasav folded before Flop (didn't bet)
Seat 6: JJin91 (button) folded before Flop
Seat 7: SJMayhem11 (small blind) folded before Flop
Seat 8: apoch19 (big blind) collected (11680)


*********** # 204 **************
PokerStars Hand #175015257500: Tournament #1701776547, $18.20+$1.80 USD=
 Hold'em No Limit - Level XIX (1000/2000) - 2017/09/13 22:22:04 ET
Table '1701776547 11' 9-max Seat #7 is the button
Seat 1: gator856500 (141120 in chips)=20
Seat 2: Bsgwolfpack4 (56118 in chips)=20
Seat 3: Thucydides (112159 in chips)=20
Seat 4: CerPrisingLe (20173 in chips)=20
Seat 5: bulibasav (44201 in chips)=20
Seat 6: JJin91 (55532 in chips)=20
Seat 7: SJMayhem11 (78812 in chips)=20
Seat 8: apoch19 (45542 in chips)=20
gator856500: posts the ante 250
Bsgwolfpack4: posts the ante 250
Thucydides: posts the ante 250
CerPrisingLe: posts the ante 250
bulibasav: posts the ante 250
JJin91: posts the ante 250
SJMayhem11: posts the ante 250
apoch19: posts the ante 250
apoch19: posts small blind 1000
gator856500: posts big blind 2000
*** HOLE CARDS ***
Dealt to JJin91 [2c Kd]
Bsgwolfpack4: folds=20
Thucydides: folds=20
CerPrisingLe: folds=20
bulibasav: folds=20
JJin91: folds=20
SJMayhem11: raises 2500 to 4500
apoch19: folds=20
gator856500: folds=20
Uncalled bet (2500) returned to SJMayhem11
SJMayhem11 collected 7000 from pot
SJMayhem11: doesn't show hand=20
*** SUMMARY ***
Total pot 7000 | Rake 0=20
Seat 1: gator856500 (big blind) folded before Flop
Seat 2: Bsgwolfpack4 folded before Flop (didn't bet)
Seat 3: Thucydides folded before Flop (didn't bet)
Seat 4: CerPrisingLe folded before Flop (didn't bet)
Seat 5: bulibasav folded before Flop (didn't bet)
Seat 6: JJin91 folded before Flop (didn't bet)
Seat 7: SJMayhem11 (button) collected (7000)
Seat 8: apoch19 (small blind) folded before Flop


*********** # 205 **************
PokerStars Hand #175015257606: Tournament #1701776547, $18.20+$1.80 USD=
 Hold'em No Limit - Level XIX (1000/2000) - 2017/09/13 22:22:29 ET
Table '1701776547 11' 9-max Seat #8 is the button
Seat 1: gator856500 (138870 in chips)=20
Seat 2: Bsgwolfpack4 (55868 in chips)=20
Seat 3: Thucydides (111909 in chips)=20
Seat 4: CerPrisingLe (19923 in chips)=20
Seat 5: bulibasav (43951 in chips)=20
Seat 6: JJin91 (55282 in chips)=20
Seat 7: SJMayhem11 (83562 in chips)=20
Seat 8: apoch19 (44292 in chips)=20
gator856500: posts the ante 250
Bsgwolfpack4: posts the ante 250
Thucydides: posts the ante 250
CerPrisingLe: posts the ante 250
bulibasav: posts the ante 250
JJin91: posts the ante 250
SJMayhem11: posts the ante 250
apoch19: posts the ante 250
gator856500: posts small blind 1000
Bsgwolfpack4: posts big blind 2000
*** HOLE CARDS ***
Dealt to JJin91 [Qc 7s]
Thucydides: folds=20
CerPrisingLe: folds=20
bulibasav: folds=20
JJin91: folds=20
SJMayhem11: calls 2000
apoch19: folds=20
gator856500: folds=20
Bsgwolfpack4: raises 6400 to 8400
SJMayhem11: folds=20
Uncalled bet (6400) returned to Bsgwolfpack4
Bsgwolfpack4 collected 7000 from pot
Bsgwolfpack4: doesn't show hand=20
*** SUMMARY ***
Total pot 7000 | Rake 0=20
Seat 1: gator856500 (small blind) folded before Flop
Seat 2: Bsgwolfpack4 (big blind) collected (7000)
Seat 3: Thucydides folded before Flop (didn't bet)
Seat 4: CerPrisingLe folded before Flop (didn't bet)
Seat 5: bulibasav folded before Flop (didn't bet)
Seat 6: JJin91 folded before Flop (didn't bet)
Seat 7: SJMayhem11 folded before Flop
Seat 8: apoch19 (button) folded before Flop (didn't bet)


*********** # 206 **************
PokerStars Hand #175015257759: Tournament #1701776547, $18.20+$1.80 USD=
 Hold'em No Limit - Level XIX (1000/2000) - 2017/09/13 22:23:09 ET
Table '1701776547 11' 9-max Seat #1 is the button
Seat 1: gator856500 (137620 in chips)=20
Seat 2: Bsgwolfpack4 (60618 in chips)=20
Seat 3: Thucydides (111659 in chips)=20
Seat 4: CerPrisingLe (19673 in chips)=20
Seat 5: bulibasav (43701 in chips)=20
Seat 6: JJin91 (55032 in chips)=20
Seat 7: SJMayhem11 (81312 in chips)=20
Seat 8: apoch19 (44042 in chips)=20
gator856500: posts the ante 250
Bsgwolfpack4: posts the ante 250
Thucydides: posts the ante 250
CerPrisingLe: posts the ante 250
bulibasav: posts the ante 250
JJin91: posts the ante 250
SJMayhem11: posts the ante 250
apoch19: posts the ante 250
Bsgwolfpack4: posts small blind 1000
Thucydides: posts big blind 2000
*** HOLE CARDS ***
Dealt to JJin91 [6s 7h]
CerPrisingLe: folds=20
bulibasav: folds=20
JJin91: folds=20
SJMayhem11: folds=20
apoch19: folds=20
gator856500: folds=20
Bsgwolfpack4: folds=20
Uncalled bet (1000) returned to Thucydides
Thucydides collected 4000 from pot
Thucydides: doesn't show hand=20
*** SUMMARY ***
Total pot 4000 | Rake 0=20
Seat 1: gator856500 (button) folded before Flop (didn't bet)
Seat 2: Bsgwolfpack4 (small blind) folded before Flop
Seat 3: Thucydides (big blind) collected (4000)
Seat 4: CerPrisingLe folded before Flop (didn't bet)
Seat 5: bulibasav folded before Flop (didn't bet)
Seat 6: JJin91 folded before Flop (didn't bet)
Seat 7: SJMayhem11 folded before Flop (didn't bet)
Seat 8: apoch19 folded before Flop (didn't bet)


*********** # 207 **************
PokerStars Hand #175015257822: Tournament #1701776547, $18.20+$1.80 USD=
 Hold'em No Limit - Level XIX (1000/2000) - 2017/09/13 22:23:25 ET
Table '1701776547 11' 9-max Seat #2 is the button
Seat 1: gator856500 (137370 in chips)=20
Seat 2: Bsgwolfpack4 (59368 in chips)=20
Seat 3: Thucydides (114409 in chips)=20
Seat 4: CerPrisingLe (19423 in chips)=20
Seat 5: bulibasav (43451 in chips)=20
Seat 6: JJin91 (54782 in chips)=20
Seat 7: SJMayhem11 (81062 in chips)=20
Seat 8: apoch19 (43792 in chips)=20
gator856500: posts the ante 250
Bsgwolfpack4: posts the ante 250
Thucydides: posts the ante 250
CerPrisingLe: posts the ante 250
bulibasav: posts the ante 250
JJin91: posts the ante 250
SJMayhem11: posts the ante 250
apoch19: posts the ante 250
Thucydides: posts small blind 1000
CerPrisingLe: posts big blind 2000
*** HOLE CARDS ***
Dealt to JJin91 [As 3d]
bulibasav: folds=20
JJin91: folds=20
SJMayhem11: folds=20
apoch19: folds=20
gator856500: calls 2000
Bsgwolfpack4: folds=20
Thucydides: calls 1000
CerPrisingLe: checks=20
*** FLOP *** [Qh Td Th]
Thucydides: checks=20
CerPrisingLe: checks=20
gator856500: bets 4000
Thucydides: folds=20
CerPrisingLe: folds=20
Uncalled bet (4000) returned to gator856500
gator856500 collected 8000 from pot
gator856500: doesn't show hand=20
*** SUMMARY ***
Total pot 8000 | Rake 0=20
Board [Qh Td Th]
Seat 1: gator856500 collected (8000)
Seat 2: Bsgwolfpack4 (button) folded before Flop (didn't bet)
Seat 3: Thucydides (small blind) folded on the Flop
Seat 4: CerPrisingLe (big blind) folded on the Flop
Seat 5: bulibasav folded before Flop (didn't bet)
Seat 6: JJin91 folded before Flop (didn't bet)
Seat 7: SJMayhem11 folded before Flop (didn't bet)
Seat 8: apoch19 folded before Flop (didn't bet)


*********** # 208 **************
PokerStars Hand #175015257936: Tournament #1701776547, $18.20+$1.80 USD=
 Hold'em No Limit - Level XIX (1000/2000) - 2017/09/13 22:23:56 ET
Table '1701776547 11' 9-max Seat #3 is the button
Seat 1: gator856500 (143120 in chips)=20
Seat 2: Bsgwolfpack4 (59118 in chips)=20
Seat 3: Thucydides (112159 in chips)=20
Seat 4: CerPrisingLe (17173 in chips)=20
Seat 5: bulibasav (43201 in chips)=20
Seat 6: JJin91 (54532 in chips)=20
Seat 7: SJMayhem11 (80812 in chips)=20
Seat 8: apoch19 (43542 in chips)=20
gator856500: posts the ante 250
Bsgwolfpack4: posts the ante 250
Thucydides: posts the ante 250
CerPrisingLe: posts the ante 250
bulibasav: posts the ante 250
JJin91: posts the ante 250
SJMayhem11: posts the ante 250
apoch19: posts the ante 250
CerPrisingLe: posts small blind 1000
bulibasav: posts big blind 2000
*** HOLE CARDS ***
Dealt to JJin91 [Kc 2d]
JJin91: folds=20
SJMayhem11: folds=20
apoch19: folds=20
gator856500: raises 7000 to 9000
Bsgwolfpack4: folds=20
Thucydides: folds=20
CerPrisingLe: folds=20
bulibasav: folds=20
Uncalled bet (7000) returned to gator856500
gator856500 collected 7000 from pot
gator856500: doesn't show hand=20
*** SUMMARY ***
Total pot 7000 | Rake 0=20
Seat 1: gator856500 collected (7000)
Seat 2: Bsgwolfpack4 folded before Flop (didn't bet)
Seat 3: Thucydides (button) folded before Flop (didn't bet)
Seat 4: CerPrisingLe (small blind) folded before Flop
Seat 5: bulibasav (big blind) folded before Flop
Seat 6: JJin91 folded before Flop (didn't bet)
Seat 7: SJMayhem11 folded before Flop (didn't bet)
Seat 8: apoch19 folded before Flop (didn't bet)


*********** # 209 **************
PokerStars Hand #175015257991: Tournament #1701776547, $18.20+$1.80 USD=
 Hold'em No Limit - Level XIX (1000/2000) - 2017/09/13 22:24:11 ET
Table '1701776547 11' 9-max Seat #4 is the button
Seat 1: gator856500 (147870 in chips)=20
Seat 2: Bsgwolfpack4 (58868 in chips)=20
Seat 3: Thucydides (111909 in chips)=20
Seat 4: CerPrisingLe (15923 in chips)=20
Seat 5: bulibasav (40951 in chips)=20
Seat 6: JJin91 (54282 in chips)=20
Seat 7: SJMayhem11 (80562 in chips)=20
Seat 8: apoch19 (43292 in chips)=20
gator856500: posts the ante 250
Bsgwolfpack4: posts the ante 250
Thucydides: posts the ante 250
CerPrisingLe: posts the ante 250
bulibasav: posts the ante 250
JJin91: posts the ante 250
SJMayhem11: posts the ante 250
apoch19: posts the ante 250
bulibasav: posts small blind 1000
JJin91: posts big blind 2000
*** HOLE CARDS ***
Dealt to JJin91 [Jh 5c]
SJMayhem11: folds=20
apoch19: folds=20
gator856500: calls 2000
Bsgwolfpack4: folds=20
Thucydides: folds=20
CerPrisingLe: folds=20
bulibasav: calls 1000
JJin91: checks=20
*** FLOP *** [Ad Kh Ts]
bulibasav: checks=20
JJin91: checks=20
gator856500: bets 8000
bulibasav: folds=20
JJin91: folds=20
Uncalled bet (8000) returned to gator856500
gator856500 collected 8000 from pot
gator856500: doesn't show hand=20
*** SUMMARY ***
Total pot 8000 | Rake 0=20
Board [Ad Kh Ts]
Seat 1: gator856500 collected (8000)
Seat 2: Bsgwolfpack4 folded before Flop (didn't bet)
Seat 3: Thucydides folded before Flop (didn't bet)
Seat 4: CerPrisingLe (button) folded before Flop (didn't bet)
Seat 5: bulibasav (small blind) folded on the Flop
Seat 6: JJin91 (big blind) folded on the Flop
Seat 7: SJMayhem11 folded before Flop (didn't bet)
Seat 8: apoch19 folded before Flop (didn't bet)


*********** # 210 **************
PokerStars Hand #175015258182: Tournament #1701776547, $18.20+$1.80 USD=
 Hold'em No Limit - Level XIX (1000/2000) - 2017/09/13 22:25:01 ET
Table '1701776547 11' 9-max Seat #5 is the button
Seat 1: gator856500 (153620 in chips)=20
Seat 2: Bsgwolfpack4 (58618 in chips)=20
Seat 3: Thucydides (111659 in chips)=20
Seat 4: CerPrisingLe (15673 in chips)=20
Seat 5: bulibasav (38701 in chips)=20
Seat 6: JJin91 (52032 in chips)=20
Seat 7: SJMayhem11 (80312 in chips)=20
Seat 8: apoch19 (43042 in chips)=20
gator856500: posts the ante 250
Bsgwolfpack4: posts the ante 250
Thucydides: posts the ante 250
CerPrisingLe: posts the ante 250
bulibasav: posts the ante 250
JJin91: posts the ante 250
SJMayhem11: posts the ante 250
apoch19: posts the ante 250
JJin91: posts small blind 1000
SJMayhem11: posts big blind 2000
*** HOLE CARDS ***
Dealt to JJin91 [4h 8d]
apoch19: folds=20
gator856500: folds=20
Bsgwolfpack4: folds=20
Thucydides: folds=20
CerPrisingLe: folds=20
bulibasav: folds=20
JJin91: folds=20
Uncalled bet (1000) returned to SJMayhem11
SJMayhem11 collected 4000 from pot
*** SUMMARY ***
Total pot 4000 | Rake 0=20
Seat 1: gator856500 folded before Flop (didn't bet)
Seat 2: Bsgwolfpack4 folded before Flop (didn't bet)
Seat 3: Thucydides folded before Flop (didn't bet)
Seat 4: CerPrisingLe folded before Flop (didn't bet)
Seat 5: bulibasav (button) folded before Flop (didn't bet)
Seat 6: JJin91 (small blind) folded before Flop
Seat 7: SJMayhem11 (big blind) collected (4000)
Seat 8: apoch19 folded before Flop (didn't bet)


*********** # 211 **************
PokerStars Hand #175015258234: Tournament #1701776547, $18.20+$1.80 USD=
 Hold'em No Limit - Level XIX (1000/2000) - 2017/09/13 22:25:14 ET
Table '1701776547 11' 9-max Seat #6 is the button
Seat 1: gator856500 (153370 in chips)=20
Seat 2: Bsgwolfpack4 (58368 in chips)=20
Seat 3: Thucydides (111409 in chips)=20
Seat 4: CerPrisingLe (15423 in chips)=20
Seat 5: bulibasav (38451 in chips)=20
Seat 6: JJin91 (50782 in chips)=20
Seat 7: SJMayhem11 (83062 in chips)=20
Seat 8: apoch19 (42792 in chips)=20
gator856500: posts the ante 250
Bsgwolfpack4: posts the ante 250
Thucydides: posts the ante 250
CerPrisingLe: posts the ante 250
bulibasav: posts the ante 250
JJin91: posts the ante 250
SJMayhem11: posts the ante 250
apoch19: posts the ante 250
SJMayhem11: posts small blind 1000
apoch19: posts big blind 2000
*** HOLE CARDS ***
Dealt to JJin91 [8d Kd]
gator856500: folds=20
Bsgwolfpack4: folds=20
Thucydides: raises 3000 to 5000
CerPrisingLe: folds=20
bulibasav: folds=20
JJin91: calls 5000
SJMayhem11: calls 4000
apoch19: folds=20
*** FLOP *** [6s 4c Tc]
SJMayhem11: checks=20
Thucydides: bets 11700
JJin91: folds=20
SJMayhem11: calls 11700
*** TURN *** [6s 4c Tc] [Ah]
SJMayhem11: checks=20
Thucydides: checks=20
*** RIVER *** [6s 4c Tc Ah] [7d]
SJMayhem11: bets 11700
Thucydides: folds=20
Uncalled bet (11700) returned to SJMayhem11
SJMayhem11 collected 42400 from pot
SJMayhem11: doesn't show hand=20
*** SUMMARY ***
Total pot 42400 | Rake 0=20
Board [6s 4c Tc Ah 7d]
Seat 1: gator856500 folded before Flop (didn't bet)
Seat 2: Bsgwolfpack4 folded before Flop (didn't bet)
Seat 3: Thucydides folded on the River
Seat 4: CerPrisingLe folded before Flop (didn't bet)
Seat 5: bulibasav folded before Flop (didn't bet)
Seat 6: JJin91 (button) folded on the Flop
Seat 7: SJMayhem11 (small blind) collected (42400)
Seat 8: apoch19 (big blind) folded before Flop


*********** # 212 **************
PokerStars Hand #175015258583: Tournament #1701776547, $18.20+$1.80 USD=
 Hold'em No Limit - Level XIX (1000/2000) - 2017/09/13 22:26:41 ET
Table '1701776547 11' 9-max Seat #7 is the button
Seat 1: gator856500 (153120 in chips)=20
Seat 2: Bsgwolfpack4 (58118 in chips)=20
Seat 3: Thucydides (94459 in chips)=20
Seat 4: CerPrisingLe (15173 in chips)=20
Seat 5: bulibasav (38201 in chips)=20
Seat 6: JJin91 (45532 in chips)=20
Seat 7: SJMayhem11 (108512 in chips)=20
Seat 8: apoch19 (40542 in chips)=20
gator856500: posts the ante 250
Bsgwolfpack4: posts the ante 250
Thucydides: posts the ante 250
CerPrisingLe: posts the ante 250
bulibasav: posts the ante 250
JJin91: posts the ante 250
SJMayhem11: posts the ante 250
apoch19: posts the ante 250
apoch19: posts small blind 1000
gator856500: posts big blind 2000
*** HOLE CARDS ***
Dealt to JJin91 [5s Kh]
Bsgwolfpack4: folds=20
Thucydides: folds=20
CerPrisingLe: folds=20
bulibasav: raises 3400 to 5400
JJin91: folds=20
SJMayhem11: raises 15800 to 21200
apoch19: folds=20
gator856500: folds=20
bulibasav: raises 16751 to 37951 and is all-in
SJMayhem11: calls 16751
*** FLOP *** [8s Ks 3c]
*** TURN *** [8s Ks 3c] [Jh]
*** RIVER *** [8s Ks 3c Jh] [2d]
*** SHOW DOWN ***
bulibasav: shows [Ac As] (a pair of Aces)
SJMayhem11: shows [Qc Qd] (a pair of Queens)
bulibasav collected 80902 from pot
SJMayhem11 said, "nh"
*** SUMMARY ***
Total pot 80902 | Rake 0=20
Board [8s Ks 3c Jh 2d]
Seat 1: gator856500 (big blind) folded before Flop
Seat 2: Bsgwolfpack4 folded before Flop (didn't bet)
Seat 3: Thucydides folded before Flop (didn't bet)
Seat 4: CerPrisingLe folded before Flop (didn't bet)
Seat 5: bulibasav showed [Ac As] and won (80902) with a pair of Aces
Seat 6: JJin91 folded before Flop (didn't bet)
Seat 7: SJMayhem11 (button) showed [Qc Qd] and lost with a pair of Quee=
ns
Seat 8: apoch19 (small blind) folded before Flop


*********** # 213 **************
PokerStars Hand #175015258778: Tournament #1701776547, $18.20+$1.80 USD=
 Hold'em No Limit - Level XIX (1000/2000) - 2017/09/13 22:27:31 ET
Table '1701776547 11' 9-max Seat #8 is the button
Seat 1: gator856500 (150870 in chips)=20
Seat 2: Bsgwolfpack4 (57868 in chips)=20
Seat 3: Thucydides (94209 in chips)=20
Seat 4: CerPrisingLe (14923 in chips)=20
Seat 5: bulibasav (80902 in chips)=20
Seat 6: JJin91 (45282 in chips)=20
Seat 7: SJMayhem11 (70311 in chips)=20
Seat 8: apoch19 (39292 in chips)=20
gator856500: posts the ante 250
Bsgwolfpack4: posts the ante 250
Thucydides: posts the ante 250
CerPrisingLe: posts the ante 250
bulibasav: posts the ante 250
JJin91: posts the ante 250
SJMayhem11: posts the ante 250
apoch19: posts the ante 250
gator856500: posts small blind 1000
Bsgwolfpack4: posts big blind 2000
*** HOLE CARDS ***
Dealt to JJin91 [Qs 6d]
Thucydides: folds=20
CerPrisingLe: folds=20
bulibasav said, "thx"
bulibasav said, "bad timing for oyu"
SJMayhem11 said, "yeah"
bulibasav: folds=20
SJMayhem11 said, "tough"
JJin91: folds=20
SJMayhem11: raises 4000 to 6000
apoch19: folds=20
gator856500: folds=20
Bsgwolfpack4: folds=20
Uncalled bet (4000) returned to SJMayhem11
SJMayhem11 collected 7000 from pot
*** SUMMARY ***
Total pot 7000 | Rake 0=20
Seat 1: gator856500 (small blind) folded before Flop
Seat 2: Bsgwolfpack4 (big blind) folded before Flop
Seat 3: Thucydides folded before Flop (didn't bet)
Seat 4: CerPrisingLe folded before Flop (didn't bet)
Seat 5: bulibasav folded before Flop (didn't bet)
Seat 6: JJin91 folded before Flop (didn't bet)
Seat 7: SJMayhem11 collected (7000)
Seat 8: apoch19 (button) folded before Flop (didn't bet)


*********** # 214 **************
PokerStars Hand #175015258913: Tournament #1701776547, $18.20+$1.80 USD=
 Hold'em No Limit - Level XX (1250/2500) - 2017/09/13 22:28:05 ET
Table '1701776547 11' 9-max Seat #1 is the button
Seat 1: gator856500 (149620 in chips)=20
Seat 2: Bsgwolfpack4 (55618 in chips)=20
Seat 3: Thucydides (93959 in chips)=20
Seat 4: CerPrisingLe (14673 in chips)=20
Seat 5: bulibasav (80652 in chips)=20
Seat 6: JJin91 (45032 in chips)=20
Seat 7: SJMayhem11 (75061 in chips)=20
Seat 8: apoch19 (39042 in chips)=20
gator856500: posts the ante 325
Bsgwolfpack4: posts the ante 325
Thucydides: posts the ante 325
CerPrisingLe: posts the ante 325
bulibasav: posts the ante 325
JJin91: posts the ante 325
SJMayhem11: posts the ante 325
apoch19: posts the ante 325
Bsgwolfpack4: posts small blind 1250
Thucydides: posts big blind 2500
*** HOLE CARDS ***
Dealt to JJin91 [3c Ac]
CerPrisingLe: folds=20
bulibasav: folds=20
JJin91: folds=20
SJMayhem11: raises 5125 to 7625
apoch19: folds=20
gator856500: calls 7625
Bsgwolfpack4: folds=20
Thucydides: folds=20
*** FLOP *** [Ks 3s Jc]
SJMayhem11: checks=20
gator856500: bets 10800
SJMayhem11: folds=20
Uncalled bet (10800) returned to gator856500
gator856500 collected 21600 from pot
gator856500: doesn't show hand=20
*** SUMMARY ***
Total pot 21600 | Rake 0=20
Board [Ks 3s Jc]
Seat 1: gator856500 (button) collected (21600)
Seat 2: Bsgwolfpack4 (small blind) folded before Flop
Seat 3: Thucydides (big blind) folded before Flop
Seat 4: CerPrisingLe folded before Flop (didn't bet)
Seat 5: bulibasav folded before Flop (didn't bet)
Seat 6: JJin91 folded before Flop (didn't bet)
Seat 7: SJMayhem11 folded on the Flop
Seat 8: apoch19 folded before Flop (didn't bet)


*********** # 215 **************
PokerStars Hand #175015259148: Tournament #1701776547, $18.20+$1.80 USD=
 Hold'em No Limit - Level XX (1250/2500) - 2017/09/13 22:29:12 ET
Table '1701776547 11' 9-max Seat #2 is the button
Seat 1: gator856500 (163270 in chips)=20
Seat 2: Bsgwolfpack4 (54043 in chips)=20
Seat 3: Thucydides (91134 in chips)=20
Seat 4: CerPrisingLe (14348 in chips)=20
Seat 5: bulibasav (80327 in chips)=20
Seat 6: JJin91 (44707 in chips)=20
Seat 7: SJMayhem11 (67111 in chips)=20
Seat 8: apoch19 (38717 in chips)=20
gator856500: posts the ante 325
Bsgwolfpack4: posts the ante 325
Thucydides: posts the ante 325
CerPrisingLe: posts the ante 325
bulibasav: posts the ante 325
JJin91: posts the ante 325
SJMayhem11: posts the ante 325
apoch19: posts the ante 325
Thucydides: posts small blind 1250
CerPrisingLe: posts big blind 2500
*** HOLE CARDS ***
Dealt to JJin91 [5c 5h]
bulibasav: folds=20
JJin91: raises 2925 to 5425
SJMayhem11: folds=20
apoch19: folds=20
gator856500: calls 5425
Bsgwolfpack4: folds=20
Thucydides: folds=20
CerPrisingLe: calls 2925
*** FLOP *** [9s Qd 2c]
CerPrisingLe: checks=20
JJin91: bets 7446
gator856500: raises 7446 to 14892
CerPrisingLe: folds=20
JJin91: folds=20
Uncalled bet (7446) returned to gator856500
gator856500 collected 35017 from pot
gator856500: doesn't show hand=20
*** SUMMARY ***
Total pot 35017 | Rake 0=20
Board [9s Qd 2c]
Seat 1: gator856500 collected (35017)
Seat 2: Bsgwolfpack4 (button) folded before Flop (didn't bet)
Seat 3: Thucydides (small blind) folded before Flop
Seat 4: CerPrisingLe (big blind) folded on the Flop
Seat 5: bulibasav folded before Flop (didn't bet)
Seat 6: JJin91 folded on the Flop
Seat 7: SJMayhem11 folded before Flop (didn't bet)
Seat 8: apoch19 folded before Flop (didn't bet)


*********** # 216 **************
PokerStars Hand #175015259403: Tournament #1701776547, $18.20+$1.80 USD=
 Hold'em No Limit - Level XX (1250/2500) - 2017/09/13 22:30:30 ET
Table '1701776547 11' 9-max Seat #3 is the button
Seat 1: gator856500 (185091 in chips)=20
Seat 2: Bsgwolfpack4 (53718 in chips)=20
Seat 3: Thucydides (89559 in chips)=20
Seat 4: CerPrisingLe (8598 in chips)=20
Seat 5: bulibasav (80002 in chips)=20
Seat 6: JJin91 (31511 in chips)=20
Seat 7: SJMayhem11 (66786 in chips)=20
Seat 8: apoch19 (38392 in chips)=20
gator856500: posts the ante 325
Bsgwolfpack4: posts the ante 325
Thucydides: posts the ante 325
CerPrisingLe: posts the ante 325
bulibasav: posts the ante 325
JJin91: posts the ante 325
SJMayhem11: posts the ante 325
apoch19: posts the ante 325
CerPrisingLe: posts small blind 1250
bulibasav: posts big blind 2500
*** HOLE CARDS ***
Dealt to JJin91 [Kc 9d]
JJin91: folds=20
SJMayhem11: folds=20
apoch19: raises 3350 to 5850
gator856500: folds=20
Bsgwolfpack4: folds=20
Thucydides: folds=20
CerPrisingLe: folds=20
bulibasav: folds=20
Uncalled bet (3350) returned to apoch19
apoch19 collected 8850 from pot
apoch19: doesn't show hand=20
*** SUMMARY ***
Total pot 8850 | Rake 0=20
Seat 1: gator856500 folded before Flop (didn't bet)
Seat 2: Bsgwolfpack4 folded before Flop (didn't bet)
Seat 3: Thucydides (button) folded before Flop (didn't bet)
Seat 4: CerPrisingLe (small blind) folded before Flop
Seat 5: bulibasav (big blind) folded before Flop
Seat 6: JJin91 folded before Flop (didn't bet)
Seat 7: SJMayhem11 folded before Flop (didn't bet)
Seat 8: apoch19 collected (8850)


*********** # 217 **************
PokerStars Hand #175015259548: Tournament #1701776547, $18.20+$1.80 USD=
 Hold'em No Limit - Level XX (1250/2500) - 2017/09/13 22:31:09 ET
Table '1701776547 11' 9-max Seat #4 is the button
Seat 1: gator856500 (184766 in chips)=20
Seat 2: Bsgwolfpack4 (53393 in chips)=20
Seat 3: Thucydides (89234 in chips)=20
Seat 4: CerPrisingLe (7023 in chips)=20
Seat 5: bulibasav (77177 in chips)=20
Seat 6: JJin91 (31186 in chips)=20
Seat 7: SJMayhem11 (66461 in chips)=20
Seat 8: apoch19 (44417 in chips)=20
gator856500: posts the ante 325
Bsgwolfpack4: posts the ante 325
Thucydides: posts the ante 325
CerPrisingLe: posts the ante 325
bulibasav: posts the ante 325
JJin91: posts the ante 325
SJMayhem11: posts the ante 325
apoch19: posts the ante 325
bulibasav: posts small blind 1250
JJin91: posts big blind 2500
*** HOLE CARDS ***
Dealt to JJin91 [3s 6c]
SJMayhem11: folds=20
apoch19: folds=20
gator856500: folds=20
Bsgwolfpack4: folds=20
Thucydides: folds=20
CerPrisingLe: folds=20
bulibasav: calls 1250
JJin91: checks=20
*** FLOP *** [Ah 6h Ks]
bulibasav: checks=20
JJin91: bets 7600
bulibasav: folds=20
Uncalled bet (7600) returned to JJin91
JJin91 collected 7600 from pot
JJin91: doesn't show hand=20
*** SUMMARY ***
Total pot 7600 | Rake 0=20
Board [Ah 6h Ks]
Seat 1: gator856500 folded before Flop (didn't bet)
Seat 2: Bsgwolfpack4 folded before Flop (didn't bet)
Seat 3: Thucydides folded before Flop (didn't bet)
Seat 4: CerPrisingLe (button) folded before Flop (didn't bet)
Seat 5: bulibasav (small blind) folded on the Flop
Seat 6: JJin91 (big blind) collected (7600)
Seat 7: SJMayhem11 folded before Flop (didn't bet)
Seat 8: apoch19 folded before Flop (didn't bet)


*********** # 218 **************
PokerStars Hand #175015259715: Tournament #1701776547, $18.20+$1.80 USD=
 Hold'em No Limit - Level XX (1250/2500) - 2017/09/13 22:31:51 ET
Table '1701776547 11' 9-max Seat #5 is the button
Seat 1: gator856500 (184441 in chips)=20
Seat 2: Bsgwolfpack4 (53068 in chips)=20
Seat 3: Thucydides (88909 in chips)=20
Seat 4: CerPrisingLe (6698 in chips)=20
Seat 5: bulibasav (74352 in chips)=20
Seat 6: JJin91 (35961 in chips)=20
Seat 7: SJMayhem11 (66136 in chips)=20
Seat 8: apoch19 (44092 in chips)=20
gator856500: posts the ante 325
Bsgwolfpack4: posts the ante 325
Thucydides: posts the ante 325
CerPrisingLe: posts the ante 325
bulibasav: posts the ante 325
JJin91: posts the ante 325
SJMayhem11: posts the ante 325
apoch19: posts the ante 325
JJin91: posts small blind 1250
SJMayhem11: posts big blind 2500
*** HOLE CARDS ***
Dealt to JJin91 [9d 6d]
apoch19: folds=20
gator856500: folds=20
Bsgwolfpack4: raises 5000 to 7500
Thucydides: folds=20
CerPrisingLe: folds=20
bulibasav: folds=20
JJin91: folds=20
SJMayhem11: folds=20
Uncalled bet (5000) returned to Bsgwolfpack4
Bsgwolfpack4 collected 8850 from pot
Bsgwolfpack4: doesn't show hand=20
*** SUMMARY ***
Total pot 8850 | Rake 0=20
Seat 1: gator856500 folded before Flop (didn't bet)
Seat 2: Bsgwolfpack4 collected (8850)
Seat 3: Thucydides folded before Flop (didn't bet)
Seat 4: CerPrisingLe folded before Flop (didn't bet)
Seat 5: bulibasav (button) folded before Flop (didn't bet)
Seat 6: JJin91 (small blind) folded before Flop
Seat 7: SJMayhem11 (big blind) folded before Flop
Seat 8: apoch19 folded before Flop (didn't bet)


*********** # 219 **************
PokerStars Hand #175015259838: Tournament #1701776547, $18.20+$1.80 USD=
 Hold'em No Limit - Level XX (1250/2500) - 2017/09/13 22:32:21 ET
Table '1701776547 11' 9-max Seat #6 is the button
Seat 1: gator856500 (184116 in chips)=20
Seat 2: Bsgwolfpack4 (59093 in chips)=20
Seat 3: Thucydides (88584 in chips)=20
Seat 4: CerPrisingLe (6373 in chips)=20
Seat 5: bulibasav (74027 in chips)=20
Seat 6: JJin91 (34386 in chips)=20
Seat 7: SJMayhem11 (63311 in chips)=20
Seat 8: apoch19 (43767 in chips)=20
gator856500: posts the ante 325
Bsgwolfpack4: posts the ante 325
Thucydides: posts the ante 325
CerPrisingLe: posts the ante 325
bulibasav: posts the ante 325
JJin91: posts the ante 325
SJMayhem11: posts the ante 325
apoch19: posts the ante 325
SJMayhem11: posts small blind 1250
apoch19: posts big blind 2500
*** HOLE CARDS ***
Dealt to JJin91 [Jh 9c]
gator856500: folds=20
Bsgwolfpack4: folds=20
Thucydides: folds=20
CerPrisingLe: folds=20
bulibasav: folds=20
JJin91: folds=20
SJMayhem11: raises 2500 to 5000
apoch19: calls 2500
*** FLOP *** [Qs 3c 2d]
SJMayhem11: bets 2500
apoch19: calls 2500
*** TURN *** [Qs 3c 2d] [Qc]
SJMayhem11: bets 5700
apoch19: calls 5700
*** RIVER *** [Qs 3c 2d Qc] [6s]
SJMayhem11: checks=20
apoch19: checks=20
*** SHOW DOWN ***
SJMayhem11: shows [8d 6c] (two pair, Queens and Sixes)
apoch19: mucks hand=20
SJMayhem11 collected 29000 from pot
*** SUMMARY ***
Total pot 29000 | Rake 0=20
Board [Qs 3c 2d Qc 6s]
Seat 1: gator856500 folded before Flop (didn't bet)
Seat 2: Bsgwolfpack4 folded before Flop (didn't bet)
Seat 3: Thucydides folded before Flop (didn't bet)
Seat 4: CerPrisingLe folded before Flop (didn't bet)
Seat 5: bulibasav folded before Flop (didn't bet)
Seat 6: JJin91 (button) folded before Flop (didn't bet)
Seat 7: SJMayhem11 (small blind) showed [8d 6c] and won (29000) with tw=
o pair, Queens and Sixes
Seat 8: apoch19 (big blind) mucked [4s 3s]


*********** # 220 **************
PokerStars Hand #175017643714: Tournament #1701776547, $18.20+$1.80 USD=
 Hold'em No Limit - Level XX (1250/2500) - 2017/09/13 22:33:31 ET
Table '1701776547 11' 9-max Seat #7 is the button
Seat 1: gator856500 (183791 in chips)=20
Seat 2: Bsgwolfpack4 (58768 in chips)=20
Seat 3: Thucydides (88259 in chips)=20
Seat 4: CerPrisingLe (6048 in chips)=20
Seat 5: bulibasav (73702 in chips)=20
Seat 6: JJin91 (34061 in chips)=20
Seat 7: SJMayhem11 (78786 in chips)=20
Seat 8: apoch19 (30242 in chips)=20
gator856500: posts the ante 325
Bsgwolfpack4: posts the ante 325
Thucydides: posts the ante 325
CerPrisingLe: posts the ante 325
bulibasav: posts the ante 325
JJin91: posts the ante 325
SJMayhem11: posts the ante 325
apoch19: posts the ante 325
apoch19: posts small blind 1250
gator856500: posts big blind 2500
*** HOLE CARDS ***
Dealt to JJin91 [9h 8c]
Bsgwolfpack4: folds=20
Thucydides: folds=20
CerPrisingLe has timed out
CerPrisingLe: folds=20
CerPrisingLe is sitting out
CerPrisingLe has returned
bulibasav: raises 4000 to 6500
JJin91: folds=20
SJMayhem11: folds=20
apoch19: folds=20
gator856500: folds=20
Uncalled bet (4000) returned to bulibasav
bulibasav collected 8850 from pot
*** SUMMARY ***
Total pot 8850 | Rake 0=20
Seat 1: gator856500 (big blind) folded before Flop
Seat 2: Bsgwolfpack4 folded before Flop (didn't bet)
Seat 3: Thucydides folded before Flop (didn't bet)
Seat 4: CerPrisingLe folded before Flop (didn't bet)
Seat 5: bulibasav collected (8850)
Seat 6: JJin91 folded before Flop (didn't bet)
Seat 7: SJMayhem11 (button) folded before Flop (didn't bet)
Seat 8: apoch19 (small blind) folded before Flop


*********** # 221 **************
PokerStars Hand #175017643929: Tournament #1701776547, $18.20+$1.80 USD=
 Hold'em No Limit - Level XX (1250/2500) - 2017/09/13 22:34:24 ET
Table '1701776547 11' 9-max Seat #8 is the button
Seat 1: gator856500 (180966 in chips)=20
Seat 2: Bsgwolfpack4 (58443 in chips)=20
Seat 3: Thucydides (87934 in chips)=20
Seat 4: CerPrisingLe (5723 in chips)=20
Seat 5: bulibasav (79727 in chips)=20
Seat 6: JJin91 (33736 in chips)=20
Seat 7: SJMayhem11 (78461 in chips)=20
Seat 8: apoch19 (28667 in chips)=20
gator856500: posts the ante 325
Bsgwolfpack4: posts the ante 325
Thucydides: posts the ante 325
CerPrisingLe: posts the ante 325
bulibasav: posts the ante 325
JJin91: posts the ante 325
SJMayhem11: posts the ante 325
apoch19: posts the ante 325
gator856500: posts small blind 1250
Bsgwolfpack4: posts big blind 2500
*** HOLE CARDS ***
Dealt to JJin91 [8s Th]
Thucydides: folds=20
CerPrisingLe: folds=20
bulibasav: folds=20
JJin91: folds=20
SJMayhem11: raises 3950 to 6450
apoch19: folds=20
gator856500: folds=20
Bsgwolfpack4: folds=20
Uncalled bet (3950) returned to SJMayhem11
SJMayhem11 collected 8850 from pot
*** SUMMARY ***
Total pot 8850 | Rake 0=20
Seat 1: gator856500 (small blind) folded before Flop
Seat 2: Bsgwolfpack4 (big blind) folded before Flop
Seat 3: Thucydides folded before Flop (didn't bet)
Seat 4: CerPrisingLe folded before Flop (didn't bet)
Seat 5: bulibasav folded before Flop (didn't bet)
Seat 6: JJin91 folded before Flop (didn't bet)
Seat 7: SJMayhem11 collected (8850)
Seat 8: apoch19 (button) folded before Flop (didn't bet)


*********** # 222 **************
PokerStars Hand #175017644024: Tournament #1701776547, $18.20+$1.80 USD=
 Hold'em No Limit - Level XX (1250/2500) - 2017/09/13 22:34:50 ET
Table '1701776547 11' 9-max Seat #1 is the button
Seat 1: gator856500 (179391 in chips)=20
Seat 2: Bsgwolfpack4 (55618 in chips)=20
Seat 3: Thucydides (87609 in chips)=20
Seat 4: CerPrisingLe (5398 in chips)=20
Seat 5: bulibasav (79402 in chips)=20
Seat 6: JJin91 (33411 in chips)=20
Seat 7: SJMayhem11 (84486 in chips)=20
Seat 8: apoch19 (28342 in chips)=20
gator856500: posts the ante 325
Bsgwolfpack4: posts the ante 325
Thucydides: posts the ante 325
CerPrisingLe: posts the ante 325
bulibasav: posts the ante 325
JJin91: posts the ante 325
SJMayhem11: posts the ante 325
apoch19: posts the ante 325
Bsgwolfpack4: posts small blind 1250
Thucydides: posts big blind 2500
*** HOLE CARDS ***
Dealt to JJin91 [5h 6s]
CerPrisingLe: raises 2573 to 5073 and is all-in
bulibasav: folds=20
JJin91: folds=20
SJMayhem11: raises 2573 to 7646
apoch19: folds=20
gator856500: folds=20
Bsgwolfpack4: folds=20
Thucydides: folds=20
Uncalled bet (2573) returned to SJMayhem11
*** FLOP *** [Jd 5c 4s]
*** TURN *** [Jd 5c 4s] [Qc]
*** RIVER *** [Jd 5c 4s Qc] [Ad]
*** SHOW DOWN ***
CerPrisingLe: shows [As 5d] (two pair, Aces and Fives)
SJMayhem11: shows [Qh Jh] (two pair, Queens and Jacks)
CerPrisingLe collected 16496 from pot
*** SUMMARY ***
Total pot 16496 | Rake 0=20
Board [Jd 5c 4s Qc Ad]
Seat 1: gator856500 (button) folded before Flop (didn't bet)
Seat 2: Bsgwolfpack4 (small blind) folded before Flop
Seat 3: Thucydides (big blind) folded before Flop
Seat 4: CerPrisingLe showed [As 5d] and won (16496) with two pair, Aces=
 and Fives
Seat 5: bulibasav folded before Flop (didn't bet)
Seat 6: JJin91 folded before Flop (didn't bet)
Seat 7: SJMayhem11 showed [Qh Jh] and lost with two pair, Queens and Ja=
cks
Seat 8: apoch19 folded before Flop (didn't bet)


*********** # 223 **************
PokerStars Hand #175017644162: Tournament #1701776547, $18.20+$1.80 USD=
 Hold'em No Limit - Level XX (1250/2500) - 2017/09/13 22:35:23 ET
Table '1701776547 11' 9-max Seat #2 is the button
Seat 1: gator856500 (179066 in chips)=20
Seat 2: Bsgwolfpack4 (54043 in chips)=20
Seat 3: Thucydides (84784 in chips)=20
Seat 4: CerPrisingLe (16496 in chips)=20
Seat 5: bulibasav (79077 in chips)=20
Seat 6: JJin91 (33086 in chips)=20
Seat 7: SJMayhem11 (79088 in chips)=20
Seat 8: apoch19 (28017 in chips)=20
gator856500: posts the ante 325
Bsgwolfpack4: posts the ante 325
Thucydides: posts the ante 325
CerPrisingLe: posts the ante 325
bulibasav: posts the ante 325
JJin91: posts the ante 325
SJMayhem11: posts the ante 325
apoch19: posts the ante 325
Thucydides: posts small blind 1250
CerPrisingLe: posts big blind 2500
*** HOLE CARDS ***
Dealt to JJin91 [8s 8c]
bulibasav: folds=20
JJin91: raises 30261 to 32761 and is all-in
SJMayhem11: folds=20
apoch19: folds=20
gator856500: folds=20
Bsgwolfpack4: folds=20
Thucydides: folds=20
CerPrisingLe: folds=20
Uncalled bet (30261) returned to JJin91
JJin91 collected 8850 from pot
JJin91: doesn't show hand=20
*** SUMMARY ***
Total pot 8850 | Rake 0=20
Seat 1: gator856500 folded before Flop (didn't bet)
Seat 2: Bsgwolfpack4 (button) folded before Flop (didn't bet)
Seat 3: Thucydides (small blind) folded before Flop
Seat 4: CerPrisingLe (big blind) folded before Flop
Seat 5: bulibasav folded before Flop (didn't bet)
Seat 6: JJin91 collected (8850)
Seat 7: SJMayhem11 folded before Flop (didn't bet)
Seat 8: apoch19 folded before Flop (didn't bet)


*********** # 224 **************
PokerStars Hand #175017644302: Tournament #1701776547, $18.20+$1.80 USD=
 Hold'em No Limit - Level XX (1250/2500) - 2017/09/13 22:35:58 ET
Table '1701776547 11' 9-max Seat #3 is the button
Seat 1: gator856500 (178741 in chips)=20
Seat 2: Bsgwolfpack4 (53718 in chips)=20
Seat 3: Thucydides (83209 in chips)=20
Seat 4: CerPrisingLe (13671 in chips)=20
Seat 5: bulibasav (78752 in chips)=20
Seat 6: JJin91 (39111 in chips)=20
Seat 7: SJMayhem11 (78763 in chips)=20
Seat 8: apoch19 (27692 in chips)=20
gator856500: posts the ante 325
Bsgwolfpack4: posts the ante 325
Thucydides: posts the ante 325
CerPrisingLe: posts the ante 325
bulibasav: posts the ante 325
JJin91: posts the ante 325
SJMayhem11: posts the ante 325
apoch19: posts the ante 325
CerPrisingLe: posts small blind 1250
bulibasav: posts big blind 2500
*** HOLE CARDS ***
Dealt to JJin91 [8c 9h]
JJin91: folds=20
SJMayhem11: folds=20
apoch19: folds=20
gator856500: folds=20
Bsgwolfpack4: raises 5000 to 7500
Thucydides: folds=20
CerPrisingLe: folds=20
bulibasav: folds=20
Uncalled bet (5000) returned to Bsgwolfpack4
Bsgwolfpack4 collected 8850 from pot
*** SUMMARY ***
Total pot 8850 | Rake 0=20
Seat 1: gator856500 folded before Flop (didn't bet)
Seat 2: Bsgwolfpack4 collected (8850)
Seat 3: Thucydides (button) folded before Flop (didn't bet)
Seat 4: CerPrisingLe (small blind) folded before Flop
Seat 5: bulibasav (big blind) folded before Flop
Seat 6: JJin91 folded before Flop (didn't bet)
Seat 7: SJMayhem11 folded before Flop (didn't bet)
Seat 8: apoch19 folded before Flop (didn't bet)


*********** # 225 **************
PokerStars Hand #175017644415: Tournament #1701776547, $18.20+$1.80 USD=
 Hold'em No Limit - Level XX (1250/2500) - 2017/09/13 22:36:29 ET
Table '1701776547 11' 9-max Seat #4 is the button
Seat 1: gator856500 (178416 in chips)=20
Seat 2: Bsgwolfpack4 (59743 in chips)=20
Seat 3: Thucydides (82884 in chips)=20
Seat 4: CerPrisingLe (12096 in chips)=20
Seat 5: bulibasav (75927 in chips)=20
Seat 6: JJin91 (38786 in chips)=20
Seat 7: SJMayhem11 (78438 in chips)=20
Seat 8: apoch19 (27367 in chips)=20
gator856500: posts the ante 325
Bsgwolfpack4: posts the ante 325
Thucydides: posts the ante 325
CerPrisingLe: posts the ante 325
bulibasav: posts the ante 325
JJin91: posts the ante 325
SJMayhem11: posts the ante 325
apoch19: posts the ante 325
bulibasav: posts small blind 1250
JJin91: posts big blind 2500
*** HOLE CARDS ***
Dealt to JJin91 [Ts 7h]
SJMayhem11: folds=20
apoch19: folds=20
gator856500: folds=20
Bsgwolfpack4: raises 5000 to 7500
Thucydides: folds=20
CerPrisingLe: folds=20
bulibasav: folds=20
JJin91: folds=20
Uncalled bet (5000) returned to Bsgwolfpack4
Bsgwolfpack4 collected 8850 from pot
Bsgwolfpack4: shows [Kc Ad] (high card Ace)
*** SUMMARY ***
Total pot 8850 | Rake 0=20
Seat 1: gator856500 folded before Flop (didn't bet)
Seat 2: Bsgwolfpack4 collected (8850)
Seat 3: Thucydides folded before Flop (didn't bet)
Seat 4: CerPrisingLe (button) folded before Flop (didn't bet)
Seat 5: bulibasav (small blind) folded before Flop
Seat 6: JJin91 (big blind) folded before Flop
Seat 7: SJMayhem11 folded before Flop (didn't bet)
Seat 8: apoch19 folded before Flop (didn't bet)


*********** # 226 **************
PokerStars Hand #175017644526: Tournament #1701776547, $18.20+$1.80 USD=
 Hold'em No Limit - Level XX (1250/2500) - 2017/09/13 22:36:56 ET
Table '1701776547 11' 9-max Seat #5 is the button
Seat 1: gator856500 (178091 in chips)=20
Seat 2: Bsgwolfpack4 (65768 in chips)=20
Seat 3: Thucydides (82559 in chips)=20
Seat 4: CerPrisingLe (11771 in chips)=20
Seat 5: bulibasav (74352 in chips)=20
Seat 6: JJin91 (35961 in chips)=20
Seat 7: SJMayhem11 (78113 in chips)=20
Seat 8: apoch19 (27042 in chips)=20
gator856500: posts the ante 325
Bsgwolfpack4: posts the ante 325
Thucydides: posts the ante 325
CerPrisingLe: posts the ante 325
bulibasav: posts the ante 325
JJin91: posts the ante 325
SJMayhem11: posts the ante 325
apoch19: posts the ante 325
JJin91: posts small blind 1250
SJMayhem11: posts big blind 2500
*** HOLE CARDS ***
Dealt to JJin91 [Kd Qs]
apoch19: folds=20
gator856500: folds=20
Bsgwolfpack4: folds=20
Thucydides: folds=20
CerPrisingLe has timed out
CerPrisingLe: folds=20
CerPrisingLe is sitting out
CerPrisingLe has returned
bulibasav: raises 4250 to 6750
JJin91: raises 28886 to 35636 and is all-in
SJMayhem11: folds=20
bulibasav: calls 28886
*** FLOP *** [Ad 6d 6s]
*** TURN *** [Ad 6d 6s] [6h]
*** RIVER *** [Ad 6d 6s 6h] [Jd]
*** SHOW DOWN ***
JJin91: shows [Kd Qs] (three of a kind, Sixes)
bulibasav: shows [7s 7d] (a full house, Sixes full of Sevens)
bulibasav collected 76372 from pot
JJin91 finished the tournament in 15th place and received $43.43.
*** SUMMARY ***
Total pot 76372 | Rake 0=20
Board [Ad 6d 6s 6h Jd]
Seat 1: gator856500 folded before Flop (didn't bet)
Seat 2: Bsgwolfpack4 folded before Flop (didn't bet)
Seat 3: Thucydides folded before Flop (didn't bet)
Seat 4: CerPrisingLe folded before Flop (didn't bet)
Seat 5: bulibasav (button) showed [7s 7d] and won (76372) with a full h=
ouse, Sixes full of Sevens
Seat 6: JJin91 (small blind) showed [Kd Qs] and lost with three of a ki=
nd, Sixes
Seat 7: SJMayhem11 (big blind) folded before Flop
Seat 8: apoch19 folded before Flop (didn't bet)



If you have any questions, please contact us at "PokerStars Support" <s=
upport@pokerstarsnj.com>


