Delivered-To: jamiejin91@gmail.com
Transcript for tournament #1701793695 requested by JJin91 (jamiejin91@g=
mail.com)

*********** # 1 **************
PokerStars Hand #175469496406: Tournament #1701793695, $9.10+$0.90 USD =
Hold'em No Limit - Level I (25/50) - 2017/09/24 17:00:06 ET
Table '1701793695 7' 6-max Seat #1 is the button
Seat 1: JJin91 (20000 in chips)=20
Seat 2: CR8TVT2 (20000 in chips)=20
Seat 3: CatKilla13 (20000 in chips) is sitting out
Seat 4: Mnthn3 (20000 in chips)=20
Seat 5: 22dancerr (20000 in chips)=20
Seat 6: lok_dawg420 (20000 in chips)=20
CR8TVT2: posts small blind 25
CatKilla13: posts big blind 50
*** HOLE CARDS ***
Dealt to JJin91 [5s Tc]
Mnthn3 has timed out
Mnthn3: folds=20
Mnthn3 is sitting out
22dancerr: folds=20
lok_dawg420: folds=20
JJin91: raises 75 to 125
CR8TVT2: calls 100
CatKilla13: folds=20
*** FLOP *** [8c 9d 7c]
CR8TVT2: checks=20
JJin91: bets 219
CR8TVT2: calls 219
*** TURN *** [8c 9d 7c] [8h]
CR8TVT2: checks=20
JJin91: checks=20
*** RIVER *** [8c 9d 7c 8h] [4d]
CR8TVT2: bets 200
JJin91: folds=20
Uncalled bet (200) returned to CR8TVT2
CR8TVT2 collected 738 from pot
*** SUMMARY ***
Total pot 738 | Rake 0=20
Board [8c 9d 7c 8h 4d]
Seat 1: JJin91 (button) folded on the River
Seat 2: CR8TVT2 (small blind) collected (738)
Seat 3: CatKilla13 (big blind) folded before Flop
Seat 4: Mnthn3 folded before Flop (didn't bet)
Seat 5: 22dancerr folded before Flop (didn't bet)
Seat 6: lok_dawg420 folded before Flop (didn't bet)


*********** # 2 **************
PokerStars Hand #175469496714: Tournament #1701793695, $9.10+$0.90 USD =
Hold'em No Limit - Level I (25/50) - 2017/09/24 17:01:28 ET
Table '1701793695 7' 6-max Seat #2 is the button
Seat 1: JJin91 (19656 in chips)=20
Seat 2: CR8TVT2 (20394 in chips)=20
Seat 3: CatKilla13 (19950 in chips) is sitting out
Seat 4: Mnthn3 (20000 in chips) is sitting out
Seat 5: 22dancerr (20000 in chips)=20
Seat 6: lok_dawg420 (20000 in chips)=20
CatKilla13: posts small blind 25
Mnthn3: posts big blind 50
*** HOLE CARDS ***
Dealt to JJin91 [8h 2d]
22dancerr: folds=20
CatKilla13 has returned
lok_dawg420: folds=20
JJin91: folds=20
CR8TVT2: raises 200 to 250
CatKilla13: folds=20
Mnthn3: folds=20
Uncalled bet (200) returned to CR8TVT2
CR8TVT2 collected 125 from pot
*** SUMMARY ***
Total pot 125 | Rake 0=20
Seat 1: JJin91 folded before Flop (didn't bet)
Seat 2: CR8TVT2 (button) collected (125)
Seat 3: CatKilla13 (small blind) folded before Flop
Seat 4: Mnthn3 (big blind) folded before Flop
Seat 5: 22dancerr folded before Flop (didn't bet)
Seat 6: lok_dawg420 folded before Flop (didn't bet)


*********** # 3 **************
PokerStars Hand #175469496785: Tournament #1701793695, $9.10+$0.90 USD =
Hold'em No Limit - Level I (25/50) - 2017/09/24 17:01:48 ET
Table '1701793695 7' 6-max Seat #3 is the button
Seat 1: JJin91 (19656 in chips)=20
Seat 2: CR8TVT2 (20469 in chips)=20
Seat 3: CatKilla13 (19925 in chips)=20
Seat 4: Mnthn3 (19950 in chips) is sitting out
Seat 5: 22dancerr (20000 in chips)=20
Seat 6: lok_dawg420 (20000 in chips)=20
Mnthn3: posts small blind 25
22dancerr: posts big blind 50
*** HOLE CARDS ***
Dealt to JJin91 [7h Ah]
lok_dawg420: folds=20
JJin91: raises 58 to 108
CR8TVT2: calls 108
CatKilla13: folds=20
Mnthn3: folds=20
22dancerr: calls 58
*** FLOP *** [5c 2d 8s]
22dancerr: bets 150
JJin91: folds=20
CR8TVT2: calls 150
*** TURN *** [5c 2d 8s] [8d]
22dancerr: bets 300
CR8TVT2: folds=20
Uncalled bet (300) returned to 22dancerr
22dancerr collected 649 from pot
22dancerr: doesn't show hand=20
*** SUMMARY ***
Total pot 649 | Rake 0=20
Board [5c 2d 8s 8d]
Seat 1: JJin91 folded on the Flop
Seat 2: CR8TVT2 folded on the Turn
Seat 3: CatKilla13 (button) folded before Flop (didn't bet)
Seat 4: Mnthn3 (small blind) folded before Flop
Seat 5: 22dancerr (big blind) collected (649)
Seat 6: lok_dawg420 folded before Flop (didn't bet)


*********** # 4 **************
PokerStars Hand #175469496957: Tournament #1701793695, $9.10+$0.90 USD =
Hold'em No Limit - Level I (25/50) - 2017/09/24 17:02:29 ET
Table '1701793695 7' 6-max Seat #4 is the button
Seat 1: JJin91 (19548 in chips)=20
Seat 2: CR8TVT2 (20211 in chips)=20
Seat 3: CatKilla13 (19925 in chips)=20
Seat 4: Mnthn3 (19925 in chips) is sitting out
Seat 5: 22dancerr (20391 in chips)=20
Seat 6: lok_dawg420 (20000 in chips)=20
22dancerr: posts small blind 25
lok_dawg420: posts big blind 50
*** HOLE CARDS ***
Dealt to JJin91 [6c 4c]
JJin91: folds=20
CR8TVT2: folds=20
Mnthn3 has returned
CatKilla13: folds=20
Mnthn3: raises 75 to 125
22dancerr: folds=20
lok_dawg420: calls 75
*** FLOP *** [6s 5h Ah]
lok_dawg420: checks=20
Mnthn3: bets 150
CatKilla13 said, "whatta game lok dawg!"
lok_dawg420: folds=20
Uncalled bet (150) returned to Mnthn3
Mnthn3 collected 275 from pot
Mnthn3: doesn't show hand=20
*** SUMMARY ***
Total pot 275 | Rake 0=20
Board [6s 5h Ah]
Seat 1: JJin91 folded before Flop (didn't bet)
Seat 2: CR8TVT2 folded before Flop (didn't bet)
Seat 3: CatKilla13 folded before Flop (didn't bet)
Seat 4: Mnthn3 (button) collected (275)
Seat 5: 22dancerr (small blind) folded before Flop
Seat 6: lok_dawg420 (big blind) folded on the Flop


*********** # 5 **************
PokerStars Hand #175469497091: Tournament #1701793695, $9.10+$0.90 USD =
Hold'em No Limit - Level I (25/50) - 2017/09/24 17:03:04 ET
Table '1701793695 7' 6-max Seat #5 is the button
Seat 1: JJin91 (19548 in chips)=20
Seat 2: CR8TVT2 (20211 in chips)=20
Seat 3: CatKilla13 (19925 in chips)=20
Seat 4: Mnthn3 (20075 in chips)=20
Seat 5: 22dancerr (20366 in chips)=20
Seat 6: lok_dawg420 (19875 in chips)=20
lok_dawg420: posts small blind 25
JJin91: posts big blind 50
*** HOLE CARDS ***
Dealt to JJin91 [2c 6c]
CR8TVT2: folds=20
CatKilla13: calls 50
Mnthn3: calls 50
22dancerr: calls 50
lok_dawg420: raises 250 to 300
JJin91: folds=20
CatKilla13: calls 250
Mnthn3: folds=20
22dancerr: folds=20
*** FLOP *** [Qs Ac Jd]
lok_dawg420: bets 400
CatKilla13: folds=20
Uncalled bet (400) returned to lok_dawg420
lok_dawg420 collected 750 from pot
lok_dawg420: doesn't show hand=20
*** SUMMARY ***
Total pot 750 | Rake 0=20
Board [Qs Ac Jd]
Seat 1: JJin91 (big blind) folded before Flop
Seat 2: CR8TVT2 folded before Flop (didn't bet)
Seat 3: CatKilla13 folded on the Flop
Seat 4: Mnthn3 folded before Flop
Seat 5: 22dancerr (button) folded before Flop
Seat 6: lok_dawg420 (small blind) collected (750)


*********** # 6 **************
PokerStars Hand #175469497273: Tournament #1701793695, $9.10+$0.90 USD =
Hold'em No Limit - Level I (25/50) - 2017/09/24 17:03:51 ET
Table '1701793695 7' 6-max Seat #6 is the button
Seat 1: JJin91 (19498 in chips)=20
Seat 2: CR8TVT2 (20211 in chips)=20
Seat 3: CatKilla13 (19625 in chips)=20
Seat 4: Mnthn3 (20025 in chips)=20
Seat 5: 22dancerr (20316 in chips)=20
Seat 6: lok_dawg420 (20325 in chips)=20
JJin91: posts small blind 25
CR8TVT2: posts big blind 50
*** HOLE CARDS ***
Dealt to JJin91 [Js 5c]
CatKilla13: folds=20
Mnthn3: raises 50 to 100
22dancerr: raises 250 to 350
lok_dawg420: folds=20
JJin91: folds=20
CR8TVT2: folds=20
Mnthn3: calls 250
*** FLOP *** [6h 5s 2d]
Mnthn3: checks=20
22dancerr: bets 350
Mnthn3: folds=20
Uncalled bet (350) returned to 22dancerr
22dancerr collected 775 from pot
22dancerr: doesn't show hand=20
*** SUMMARY ***
Total pot 775 | Rake 0=20
Board [6h 5s 2d]
Seat 1: JJin91 (small blind) folded before Flop
Seat 2: CR8TVT2 (big blind) folded before Flop
Seat 3: CatKilla13 folded before Flop (didn't bet)
Seat 4: Mnthn3 folded on the Flop
Seat 5: 22dancerr collected (775)
Seat 6: lok_dawg420 (button) folded before Flop (didn't bet)


*********** # 7 **************
PokerStars Hand #175469497383: Tournament #1701793695, $9.10+$0.90 USD =
Hold'em No Limit - Level I (25/50) - 2017/09/24 17:04:20 ET
Table '1701793695 7' 6-max Seat #1 is the button
Seat 1: JJin91 (19473 in chips)=20
Seat 2: CR8TVT2 (20161 in chips)=20
Seat 3: CatKilla13 (19625 in chips)=20
Seat 4: Mnthn3 (19675 in chips)=20
Seat 5: 22dancerr (20741 in chips)=20
Seat 6: lok_dawg420 (20325 in chips)=20
CR8TVT2: posts small blind 25
CatKilla13: posts big blind 50
*** HOLE CARDS ***
Dealt to JJin91 [Ad 5h]
Mnthn3: raises 105 to 155
22dancerr: calls 155
lok_dawg420: folds=20
JJin91: folds=20
CR8TVT2: folds=20
CatKilla13: folds=20
*** FLOP *** [Ac As 3c]
Mnthn3: bets 150
22dancerr: folds=20
Uncalled bet (150) returned to Mnthn3
Mnthn3 collected 385 from pot
*** SUMMARY ***
Total pot 385 | Rake 0=20
Board [Ac As 3c]
Seat 1: JJin91 (button) folded before Flop (didn't bet)
Seat 2: CR8TVT2 (small blind) folded before Flop
Seat 3: CatKilla13 (big blind) folded before Flop
Seat 4: Mnthn3 collected (385)
Seat 5: 22dancerr folded on the Flop
Seat 6: lok_dawg420 folded before Flop (didn't bet)


*********** # 8 **************
PokerStars Hand #175469497478: Tournament #1701793695, $9.10+$0.90 USD =
Hold'em No Limit - Level I (25/50) - 2017/09/24 17:04:44 ET
Table '1701793695 7' 6-max Seat #2 is the button
Seat 1: JJin91 (19473 in chips)=20
Seat 2: CR8TVT2 (20136 in chips)=20
Seat 3: CatKilla13 (19575 in chips)=20
Seat 5: 22dancerr (20586 in chips)=20
Seat 6: lok_dawg420 (20325 in chips)=20
CatKilla13: posts small blind 25
22dancerr: posts big blind 50
*** HOLE CARDS ***
Dealt to JJin91 [3h Jd]
lok_dawg420: folds=20
JJin91: folds=20
CR8TVT2: folds=20
CatKilla13: calls 25
22dancerr: raises 150 to 200
CatKilla13: calls 150
*** FLOP *** [8h Tc Ts]
CatKilla13: checks=20
22dancerr: checks=20
*** TURN *** [8h Tc Ts] [6s]
CatKilla13: checks=20
22dancerr: bets 200
CatKilla13: folds=20
Uncalled bet (200) returned to 22dancerr
22dancerr collected 400 from pot
22dancerr: doesn't show hand=20
*** SUMMARY ***
Total pot 400 | Rake 0=20
Board [8h Tc Ts 6s]
Seat 1: JJin91 folded before Flop (didn't bet)
Seat 2: CR8TVT2 (button) folded before Flop (didn't bet)
Seat 3: CatKilla13 (small blind) folded on the Turn
Seat 5: 22dancerr (big blind) collected (400)
Seat 6: lok_dawg420 folded before Flop (didn't bet)


*********** # 9 **************
PokerStars Hand #175469497635: Tournament #1701793695, $9.10+$0.90 USD =
Hold'em No Limit - Level II (50/100) - 2017/09/24 17:05:27 ET
Table '1701793695 7' 6-max Seat #3 is the button
Seat 1: JJin91 (19473 in chips)=20
Seat 2: CR8TVT2 (20136 in chips)=20
Seat 3: CatKilla13 (19375 in chips)=20
Seat 5: 22dancerr (20786 in chips)=20
Seat 6: lok_dawg420 (20325 in chips)=20
JJin91: posts the ante 10
CR8TVT2: posts the ante 10
CatKilla13: posts the ante 10
22dancerr: posts the ante 10
lok_dawg420: posts the ante 10
22dancerr: posts small blind 50
lok_dawg420: posts big blind 100
*** HOLE CARDS ***
Dealt to JJin91 [Td Js]
JJin91: folds=20
CR8TVT2: calls 100
CatKilla13: calls 100
22dancerr: raises 400 to 500
lok_dawg420: folds=20
CR8TVT2: folds=20
CatKilla13: calls 400
*** FLOP *** [3h 3d 7c]
22dancerr: checks=20
CatKilla13: checks=20
*** TURN *** [3h 3d 7c] [4h]
22dancerr: bets 400
CatKilla13: folds=20
Uncalled bet (400) returned to 22dancerr
22dancerr collected 1250 from pot
22dancerr: doesn't show hand=20
*** SUMMARY ***
Total pot 1250 | Rake 0=20
Board [3h 3d 7c 4h]
Seat 1: JJin91 folded before Flop (didn't bet)
Seat 2: CR8TVT2 folded before Flop
Seat 3: CatKilla13 (button) folded on the Turn
Seat 5: 22dancerr (small blind) collected (1250)
Seat 6: lok_dawg420 (big blind) folded before Flop


*********** # 10 **************
PokerStars Hand #175469497828: Tournament #1701793695, $9.10+$0.90 USD =
Hold'em No Limit - Level II (50/100) - 2017/09/24 17:06:22 ET
Table '1701793695 7' 6-max Seat #5 is the button
Seat 1: JJin91 (19463 in chips)=20
Seat 2: CR8TVT2 (20026 in chips)=20
Seat 3: CatKilla13 (18865 in chips)=20
Seat 4: dakota0414 (20000 in chips)=20
Seat 5: 22dancerr (21526 in chips)=20
Seat 6: lok_dawg420 (20215 in chips)=20
JJin91: posts the ante 10
CR8TVT2: posts the ante 10
CatKilla13: posts the ante 10
dakota0414: posts the ante 10
22dancerr: posts the ante 10
lok_dawg420: posts the ante 10
lok_dawg420: posts small blind 50
JJin91: posts big blind 100
*** HOLE CARDS ***
Dealt to JJin91 [7c 6d]
CR8TVT2: folds=20
CatKilla13: folds=20
dakota0414: folds=20
22dancerr: raises 300 to 400
lok_dawg420: folds=20
JJin91: folds=20
Uncalled bet (300) returned to 22dancerr
22dancerr collected 310 from pot
22dancerr: doesn't show hand=20
*** SUMMARY ***
Total pot 310 | Rake 0=20
Seat 1: JJin91 (big blind) folded before Flop
Seat 2: CR8TVT2 folded before Flop (didn't bet)
Seat 3: CatKilla13 folded before Flop (didn't bet)
Seat 4: dakota0414 folded before Flop (didn't bet)
Seat 5: 22dancerr (button) collected (310)
Seat 6: lok_dawg420 (small blind) folded before Flop


*********** # 11 **************
PokerStars Hand #175469497946: Tournament #1701793695, $9.10+$0.90 USD =
Hold'em No Limit - Level II (50/100) - 2017/09/24 17:06:56 ET
Table '1701793695 7' 6-max Seat #6 is the button
Seat 1: JJin91 (19353 in chips)=20
Seat 2: CR8TVT2 (20016 in chips)=20
Seat 3: CatKilla13 (18855 in chips)=20
Seat 4: dakota0414 (19990 in chips)=20
Seat 5: 22dancerr (21726 in chips)=20
Seat 6: lok_dawg420 (20155 in chips)=20
JJin91: posts the ante 10
CR8TVT2: posts the ante 10
CatKilla13: posts the ante 10
dakota0414: posts the ante 10
22dancerr: posts the ante 10
lok_dawg420: posts the ante 10
JJin91: posts small blind 50
CR8TVT2: posts big blind 100
*** HOLE CARDS ***
Dealt to JJin91 [Ts 6h]
CatKilla13 is disconnected=20
CatKilla13 is connected=20
CatKilla13: calls 100
dakota0414: raises 600 to 700
22dancerr: folds=20
lok_dawg420: folds=20
JJin91: folds=20
CR8TVT2: folds=20
CatKilla13: calls 600
*** FLOP *** [3s 9h 9d]
CatKilla13: checks=20
dakota0414: bets 1610
CatKilla13: folds=20
Uncalled bet (1610) returned to dakota0414
dakota0414 collected 1610 from pot
dakota0414: doesn't show hand=20
*** SUMMARY ***
Total pot 1610 | Rake 0=20
Board [3s 9h 9d]
Seat 1: JJin91 (small blind) folded before Flop
Seat 2: CR8TVT2 (big blind) folded before Flop
Seat 3: CatKilla13 folded on the Flop
Seat 4: dakota0414 collected (1610)
Seat 5: 22dancerr folded before Flop (didn't bet)
Seat 6: lok_dawg420 (button) folded before Flop (didn't bet)


*********** # 12 **************
PokerStars Hand #175469498199: Tournament #1701793695, $9.10+$0.90 USD =
Hold'em No Limit - Level II (50/100) - 2017/09/24 17:08:10 ET
Table '1701793695 7' 6-max Seat #1 is the button
Seat 1: JJin91 (19293 in chips)=20
Seat 2: CR8TVT2 (19906 in chips)=20
Seat 3: CatKilla13 (18145 in chips)=20
Seat 4: dakota0414 (20890 in chips)=20
Seat 5: 22dancerr (21716 in chips)=20
Seat 6: lok_dawg420 (20145 in chips)=20
JJin91: posts the ante 10
CR8TVT2: posts the ante 10
CatKilla13: posts the ante 10
dakota0414: posts the ante 10
22dancerr: posts the ante 10
lok_dawg420: posts the ante 10
CR8TVT2: posts small blind 50
CatKilla13: posts big blind 100
*** HOLE CARDS ***
Dealt to JJin91 [Kh 7h]
dakota0414: calls 100
22dancerr: folds=20
lok_dawg420: calls 100
JJin91: raises 356 to 456
CR8TVT2: folds=20
CatKilla13: folds=20
dakota0414: calls 356
lok_dawg420: calls 356
*** FLOP *** [9s 7d 7c]
dakota0414: checks=20
lok_dawg420: checks=20
JJin91: bets 666
dakota0414: folds=20
lok_dawg420: folds=20
Uncalled bet (666) returned to JJin91
JJin91 collected 1578 from pot
JJin91: doesn't show hand=20
*** SUMMARY ***
Total pot 1578 | Rake 0=20
Board [9s 7d 7c]
Seat 1: JJin91 (button) collected (1578)
Seat 2: CR8TVT2 (small blind) folded before Flop
Seat 3: CatKilla13 (big blind) folded before Flop
Seat 4: dakota0414 folded on the Flop
Seat 5: 22dancerr folded before Flop (didn't bet)
Seat 6: lok_dawg420 folded on the Flop


*********** # 13 **************
PokerStars Hand #175469498483: Tournament #1701793695, $9.10+$0.90 USD =
Hold'em No Limit - Level II (50/100) - 2017/09/24 17:09:29 ET
Table '1701793695 7' 6-max Seat #2 is the button
Seat 1: JJin91 (20405 in chips)=20
Seat 2: CR8TVT2 (19846 in chips)=20
Seat 3: CatKilla13 (18035 in chips)=20
Seat 4: dakota0414 (20424 in chips)=20
Seat 5: 22dancerr (21706 in chips)=20
Seat 6: lok_dawg420 (19679 in chips)=20
JJin91: posts the ante 10
CR8TVT2: posts the ante 10
CatKilla13: posts the ante 10
dakota0414: posts the ante 10
22dancerr: posts the ante 10
lok_dawg420: posts the ante 10
CatKilla13: posts small blind 50
dakota0414: posts big blind 100
*** HOLE CARDS ***
Dealt to JJin91 [9d 7d]
22dancerr: raises 200 to 300
lok_dawg420: folds=20
JJin91: folds=20
CR8TVT2: folds=20
CatKilla13: raises 200 to 500
dakota0414: calls 400
22dancerr: calls 200
*** FLOP *** [Qh Tc 7h]
CatKilla13: checks=20
dakota0414: checks=20
22dancerr: bets 1000
CatKilla13: calls 1000
dakota0414: folds=20
*** TURN *** [Qh Tc 7h] [3h]
CatKilla13: checks=20
22dancerr: bets 1800
CatKilla13: folds=20
Uncalled bet (1800) returned to 22dancerr
22dancerr collected 3560 from pot
22dancerr: doesn't show hand=20
*** SUMMARY ***
Total pot 3560 | Rake 0=20
Board [Qh Tc 7h 3h]
Seat 1: JJin91 folded before Flop (didn't bet)
Seat 2: CR8TVT2 (button) folded before Flop (didn't bet)
Seat 3: CatKilla13 (small blind) folded on the Turn
Seat 4: dakota0414 (big blind) folded on the Flop
Seat 5: 22dancerr collected (3560)
Seat 6: lok_dawg420 folded before Flop (didn't bet)


*********** # 14 **************
PokerStars Hand #175469498686: Tournament #1701793695, $9.10+$0.90 USD =
Hold'em No Limit - Level III (75/150) - 2017/09/24 17:10:24 ET
Table '1701793695 7' 6-max Seat #3 is the button
Seat 1: JJin91 (20395 in chips)=20
Seat 2: CR8TVT2 (19836 in chips)=20
Seat 3: CatKilla13 (16525 in chips)=20
Seat 4: dakota0414 (19914 in chips)=20
Seat 5: 22dancerr (23756 in chips)=20
Seat 6: lok_dawg420 (19669 in chips)=20
JJin91: posts the ante 20
CR8TVT2: posts the ante 20
CatKilla13: posts the ante 20
dakota0414: posts the ante 20
22dancerr: posts the ante 20
lok_dawg420: posts the ante 20
dakota0414: posts small blind 75
22dancerr: posts big blind 150
*** HOLE CARDS ***
Dealt to JJin91 [5s 9s]
lok_dawg420: folds=20
JJin91: folds=20
CR8TVT2: folds=20
CatKilla13: calls 150
dakota0414: calls 75
22dancerr: raises 450 to 600
CatKilla13: calls 450
dakota0414: calls 450
*** FLOP *** [Js 7c Th]
dakota0414: checks=20
22dancerr: checks=20
CatKilla13: bets 900
dakota0414: folds=20
22dancerr: calls 900
*** TURN *** [Js 7c Th] [Td]
22dancerr: checks=20
CatKilla13: bets 1800
22dancerr: calls 1800
*** RIVER *** [Js 7c Th Td] [9c]
22dancerr: bets 6900
CatKilla13: folds=20
Uncalled bet (6900) returned to 22dancerr
22dancerr collected 7320 from pot
22dancerr: doesn't show hand=20
*** SUMMARY ***
Total pot 7320 | Rake 0=20
Board [Js 7c Th Td 9c]
Seat 1: JJin91 folded before Flop (didn't bet)
Seat 2: CR8TVT2 folded before Flop (didn't bet)
Seat 3: CatKilla13 (button) folded on the River
Seat 4: dakota0414 (small blind) folded on the Flop
Seat 5: 22dancerr (big blind) collected (7320)
Seat 6: lok_dawg420 folded before Flop (didn't bet)


*********** # 15 **************
PokerStars Hand #175469498911: Tournament #1701793695, $9.10+$0.90 USD =
Hold'em No Limit - Level III (75/150) - 2017/09/24 17:11:34 ET
Table '1701793695 7' 6-max Seat #4 is the button
Seat 1: JJin91 (20375 in chips)=20
Seat 2: CR8TVT2 (19816 in chips)=20
Seat 3: CatKilla13 (13205 in chips)=20
Seat 4: dakota0414 (19294 in chips)=20
Seat 5: 22dancerr (27756 in chips)=20
Seat 6: lok_dawg420 (19649 in chips)=20
JJin91: posts the ante 20
CR8TVT2: posts the ante 20
CatKilla13: posts the ante 20
dakota0414: posts the ante 20
22dancerr: posts the ante 20
lok_dawg420: posts the ante 20
22dancerr: posts small blind 75
lok_dawg420: posts big blind 150
*** HOLE CARDS ***
Dealt to JJin91 [5h Th]
JJin91: folds=20
CR8TVT2: calls 150
CatKilla13: folds=20
dakota0414: calls 150
22dancerr: calls 75
lok_dawg420: checks=20
*** FLOP *** [Kd Td 3c]
22dancerr: checks=20
lok_dawg420: checks=20
CR8TVT2: checks=20
dakota0414: checks=20
*** TURN *** [Kd Td 3c] [2s]
22dancerr: bets 150
lok_dawg420: folds=20
CR8TVT2: calls 150
dakota0414: calls 150
*** RIVER *** [Kd Td 3c 2s] [6c]
22dancerr: checks=20
CR8TVT2: bets 585
dakota0414: folds=20
22dancerr: folds=20
Uncalled bet (585) returned to CR8TVT2
CR8TVT2 collected 1170 from pot
*** SUMMARY ***
Total pot 1170 | Rake 0=20
Board [Kd Td 3c 2s 6c]
Seat 1: JJin91 folded before Flop (didn't bet)
Seat 2: CR8TVT2 collected (1170)
Seat 3: CatKilla13 folded before Flop (didn't bet)
Seat 4: dakota0414 (button) folded on the River
Seat 5: 22dancerr (small blind) folded on the River
Seat 6: lok_dawg420 (big blind) folded on the Turn


*********** # 16 **************
PokerStars Hand #175469499119: Tournament #1701793695, $9.10+$0.90 USD =
Hold'em No Limit - Level III (75/150) - 2017/09/24 17:12:33 ET
Table '1701793695 7' 6-max Seat #5 is the button
Seat 1: JJin91 (20355 in chips)=20
Seat 2: CR8TVT2 (20666 in chips)=20
Seat 3: CatKilla13 (13185 in chips)=20
Seat 4: dakota0414 (18974 in chips)=20
Seat 5: 22dancerr (27436 in chips)=20
Seat 6: lok_dawg420 (19479 in chips)=20
JJin91: posts the ante 20
CR8TVT2: posts the ante 20
CatKilla13: posts the ante 20
dakota0414: posts the ante 20
22dancerr: posts the ante 20
lok_dawg420: posts the ante 20
lok_dawg420: posts small blind 75
JJin91: posts big blind 150
*** HOLE CARDS ***
Dealt to JJin91 [8s Ks]
CR8TVT2: folds=20
CatKilla13: raises 300 to 450
dakota0414: folds=20
22dancerr: folds=20
lok_dawg420: folds=20
JJin91: calls 300
*** FLOP *** [Jc 4d 2s]
JJin91: bets 405
CatKilla13: calls 405
*** TURN *** [Jc 4d 2s] [Ts]
JJin91: bets 1234
CatKilla13: folds=20
Uncalled bet (1234) returned to JJin91
JJin91 collected 1905 from pot
JJin91: doesn't show hand=20
*** SUMMARY ***
Total pot 1905 | Rake 0=20
Board [Jc 4d 2s Ts]
Seat 1: JJin91 (big blind) collected (1905)
Seat 2: CR8TVT2 folded before Flop (didn't bet)
Seat 3: CatKilla13 folded on the Turn
Seat 4: dakota0414 folded before Flop (didn't bet)
Seat 5: 22dancerr (button) folded before Flop (didn't bet)
Seat 6: lok_dawg420 (small blind) folded before Flop


*********** # 17 **************
PokerStars Hand #175469499300: Tournament #1701793695, $9.10+$0.90 USD =
Hold'em No Limit - Level III (75/150) - 2017/09/24 17:13:31 ET
Table '1701793695 7' 6-max Seat #6 is the button
Seat 1: JJin91 (21385 in chips)=20
Seat 2: CR8TVT2 (20646 in chips)=20
Seat 3: CatKilla13 (12310 in chips)=20
Seat 4: dakota0414 (18954 in chips)=20
Seat 5: 22dancerr (27416 in chips)=20
Seat 6: lok_dawg420 (19384 in chips)=20
JJin91: posts the ante 20
CR8TVT2: posts the ante 20
CatKilla13: posts the ante 20
dakota0414: posts the ante 20
22dancerr: posts the ante 20
lok_dawg420: posts the ante 20
JJin91: posts small blind 75
CR8TVT2: posts big blind 150
*** HOLE CARDS ***
Dealt to JJin91 [4s 5d]
CatKilla13: calls 150
dakota0414: raises 645 to 795
22dancerr: folds=20
lok_dawg420: folds=20
JJin91: folds=20
CR8TVT2: folds=20
CatKilla13: calls 645
*** FLOP *** [5s 2h Jc]
CatKilla13: checks=20
dakota0414: checks=20
*** TURN *** [5s 2h Jc] [3d]
CatKilla13: bets 900
dakota0414: raises 3735 to 4635
CatKilla13: folds=20
Uncalled bet (3735) returned to dakota0414
dakota0414 collected 3735 from pot
dakota0414: doesn't show hand=20
*** SUMMARY ***
Total pot 3735 | Rake 0=20
Board [5s 2h Jc 3d]
Seat 1: JJin91 (small blind) folded before Flop
Seat 2: CR8TVT2 (big blind) folded before Flop
Seat 3: CatKilla13 folded on the Turn
Seat 4: dakota0414 collected (3735)
Seat 5: 22dancerr folded before Flop (didn't bet)
Seat 6: lok_dawg420 (button) folded before Flop (didn't bet)


*********** # 18 **************
PokerStars Hand #175469499481: Tournament #1701793695, $9.10+$0.90 USD =
Hold'em No Limit - Level III (75/150) - 2017/09/24 17:14:24 ET
Table '1701793695 7' 6-max Seat #1 is the button
Seat 1: JJin91 (21290 in chips)=20
Seat 2: CR8TVT2 (20476 in chips)=20
Seat 3: CatKilla13 (10595 in chips)=20
Seat 4: dakota0414 (20974 in chips)=20
Seat 5: 22dancerr (27396 in chips)=20
Seat 6: lok_dawg420 (19364 in chips)=20
JJin91: posts the ante 20
CR8TVT2: posts the ante 20
CatKilla13: posts the ante 20
dakota0414: posts the ante 20
22dancerr: posts the ante 20
lok_dawg420: posts the ante 20
CR8TVT2: posts small blind 75
CatKilla13: posts big blind 150
*** HOLE CARDS ***
Dealt to JJin91 [Ks Jh]
dakota0414: folds=20
22dancerr: raises 300 to 450
lok_dawg420: folds=20
JJin91: calls 450
CR8TVT2: calls 375
CatKilla13: calls 300
*** FLOP *** [Kc 9c 3d]
CR8TVT2: checks=20
CatKilla13: checks=20
22dancerr: checks=20
JJin91: checks=20
*** TURN *** [Kc 9c 3d] [Kh]
CR8TVT2: checks=20
CatKilla13: checks=20
22dancerr: bets 900
JJin91: calls 900
CR8TVT2: folds=20
CatKilla13: folds=20
*** RIVER *** [Kc 9c 3d Kh] [Jc]
22dancerr: checks=20
JJin91: bets 1376
22dancerr: calls 1376
*** SHOW DOWN ***
JJin91: shows [Ks Jh] (a full house, Kings full of Jacks)
22dancerr: mucks hand=20
JJin91 collected 6472 from pot
*** SUMMARY ***
Total pot 6472 | Rake 0=20
Board [Kc 9c 3d Kh Jc]
Seat 1: JJin91 (button) showed [Ks Jh] and won (6472) with a full house=
, Kings full of Jacks
Seat 2: CR8TVT2 (small blind) folded on the Turn
Seat 3: CatKilla13 (big blind) folded on the Turn
Seat 4: dakota0414 folded before Flop (didn't bet)
Seat 5: 22dancerr mucked [Qs Qh]
Seat 6: lok_dawg420 folded before Flop (didn't bet)


*********** # 19 **************
PokerStars Hand #175469499846: Tournament #1701793695, $9.10+$0.90 USD =
Hold'em No Limit - Level IV (100/200) - 2017/09/24 17:16:08 ET
Table '1701793695 7' 6-max Seat #2 is the button
Seat 1: JJin91 (25016 in chips)=20
Seat 2: CR8TVT2 (20006 in chips)=20
Seat 3: CatKilla13 (10125 in chips)=20
Seat 4: dakota0414 (20954 in chips)=20
Seat 5: 22dancerr (24650 in chips)=20
Seat 6: lok_dawg420 (19344 in chips)=20
JJin91: posts the ante 25
CR8TVT2: posts the ante 25
CatKilla13: posts the ante 25
dakota0414: posts the ante 25
22dancerr: posts the ante 25
lok_dawg420: posts the ante 25
CatKilla13: posts small blind 100
dakota0414: posts big blind 200
*** HOLE CARDS ***
Dealt to JJin91 [Qc 9c]
22dancerr: folds=20
lok_dawg420: folds=20
JJin91: raises 234 to 434
CR8TVT2: folds=20
CatKilla13: folds=20
dakota0414: folds=20
Uncalled bet (234) returned to JJin91
JJin91 collected 650 from pot
JJin91: doesn't show hand=20
*** SUMMARY ***
Total pot 650 | Rake 0=20
Seat 1: JJin91 collected (650)
Seat 2: CR8TVT2 (button) folded before Flop (didn't bet)
Seat 3: CatKilla13 (small blind) folded before Flop
Seat 4: dakota0414 (big blind) folded before Flop
Seat 5: 22dancerr folded before Flop (didn't bet)
Seat 6: lok_dawg420 folded before Flop (didn't bet)


*********** # 20 **************
PokerStars Hand #175469499931: Tournament #1701793695, $9.10+$0.90 USD =
Hold'em No Limit - Level IV (100/200) - 2017/09/24 17:16:30 ET
Table '1701793695 7' 6-max Seat #3 is the button
Seat 1: JJin91 (25441 in chips)=20
Seat 2: CR8TVT2 (19981 in chips)=20
Seat 3: CatKilla13 (10000 in chips)=20
Seat 4: dakota0414 (20729 in chips)=20
Seat 5: 22dancerr (24625 in chips)=20
Seat 6: lok_dawg420 (19319 in chips)=20
JJin91: posts the ante 25
CR8TVT2: posts the ante 25
CatKilla13: posts the ante 25
dakota0414: posts the ante 25
22dancerr: posts the ante 25
lok_dawg420: posts the ante 25
dakota0414: posts small blind 100
22dancerr: posts big blind 200
*** HOLE CARDS ***
Dealt to JJin91 [7s Kd]
lok_dawg420: calls 200
JJin91: folds=20
CR8TVT2: folds=20
CatKilla13: calls 200
dakota0414: raises 950 to 1150
22dancerr: calls 950
lok_dawg420: folds=20
CatKilla13: calls 950
*** FLOP *** [Qh 4c 7c]
dakota0414: checks=20
22dancerr: checks=20
CatKilla13: bets 8825 and is all-in
dakota0414: folds=20
22dancerr: folds=20
Uncalled bet (8825) returned to CatKilla13
CatKilla13 collected 3800 from pot
CatKilla13: doesn't show hand=20
*** SUMMARY ***
Total pot 3800 | Rake 0=20
Board [Qh 4c 7c]
Seat 1: JJin91 folded before Flop (didn't bet)
Seat 2: CR8TVT2 folded before Flop (didn't bet)
Seat 3: CatKilla13 (button) collected (3800)
Seat 4: dakota0414 (small blind) folded on the Flop
Seat 5: 22dancerr (big blind) folded on the Flop
Seat 6: lok_dawg420 folded before Flop


*********** # 21 **************
PokerStars Hand #175471998652: Tournament #1701793695, $9.10+$0.90 USD =
Hold'em No Limit - Level IV (100/200) - 2017/09/24 17:17:28 ET
Table '1701793695 7' 6-max Seat #4 is the button
Seat 1: JJin91 (25416 in chips)=20
Seat 2: CR8TVT2 (19956 in chips)=20
Seat 3: CatKilla13 (12625 in chips)=20
Seat 4: dakota0414 (19554 in chips)=20
Seat 5: 22dancerr (23450 in chips)=20
Seat 6: lok_dawg420 (19094 in chips)=20
JJin91: posts the ante 25
CR8TVT2: posts the ante 25
CatKilla13: posts the ante 25
dakota0414: posts the ante 25
22dancerr: posts the ante 25
lok_dawg420: posts the ante 25
22dancerr: posts small blind 100
lok_dawg420: posts big blind 200
*** HOLE CARDS ***
Dealt to JJin91 [8s 6c]
JJin91: folds=20
CatKilla13 said, "first pot!"
CR8TVT2: folds=20
CatKilla13: raises 200 to 400
dakota0414: calls 400
22dancerr: folds=20
lok_dawg420: folds=20
*** FLOP *** [6d 8d 9c]
CatKilla13: bets 200
dakota0414: folds=20
Uncalled bet (200) returned to CatKilla13
CatKilla13 collected 1250 from pot
CatKilla13: doesn't show hand=20
*** SUMMARY ***
Total pot 1250 | Rake 0=20
Board [6d 8d 9c]
Seat 1: JJin91 folded before Flop (didn't bet)
Seat 2: CR8TVT2 folded before Flop (didn't bet)
Seat 3: CatKilla13 collected (1250)
Seat 4: dakota0414 (button) folded on the Flop
Seat 5: 22dancerr (small blind) folded before Flop
Seat 6: lok_dawg420 (big blind) folded before Flop


*********** # 22 **************
PokerStars Hand #175471998769: Tournament #1701793695, $9.10+$0.90 USD =
Hold'em No Limit - Level IV (100/200) - 2017/09/24 17:18:00 ET
Table '1701793695 7' 6-max Seat #5 is the button
Seat 1: JJin91 (25391 in chips)=20
Seat 2: CR8TVT2 (19931 in chips)=20
Seat 3: CatKilla13 (13450 in chips)=20
Seat 4: dakota0414 (19129 in chips)=20
Seat 5: 22dancerr (23325 in chips)=20
Seat 6: lok_dawg420 (18869 in chips)=20
JJin91: posts the ante 25
CR8TVT2: posts the ante 25
CatKilla13: posts the ante 25
dakota0414: posts the ante 25
22dancerr: posts the ante 25
lok_dawg420: posts the ante 25
lok_dawg420: posts small blind 100
JJin91: posts big blind 200
*** HOLE CARDS ***
Dealt to JJin91 [Td 7s]
CR8TVT2: calls 200
CatKilla13: calls 200
dakota0414: raises 1050 to 1250
22dancerr: calls 1250
lok_dawg420: folds=20
JJin91: folds=20
CR8TVT2: calls 1050
CatKilla13: folds=20
*** FLOP *** [Ks Ac 5c]
CR8TVT2: checks=20
dakota0414: bets 17854 and is all-in
22dancerr: folds=20
CR8TVT2: folds=20
Uncalled bet (17854) returned to dakota0414
dakota0414 collected 4400 from pot
*** SUMMARY ***
Total pot 4400 | Rake 0=20
Board [Ks Ac 5c]
Seat 1: JJin91 (big blind) folded before Flop
Seat 2: CR8TVT2 folded on the Flop
Seat 3: CatKilla13 folded before Flop
Seat 4: dakota0414 collected (4400)
Seat 5: 22dancerr (button) folded on the Flop
Seat 6: lok_dawg420 (small blind) folded before Flop


*********** # 23 **************
PokerStars Hand #175471999056: Tournament #1701793695, $9.10+$0.90 USD =
Hold'em No Limit - Level IV (100/200) - 2017/09/24 17:19:18 ET
Table '1701793695 7' 6-max Seat #6 is the button
Seat 1: JJin91 (25166 in chips)=20
Seat 2: CR8TVT2 (18656 in chips)=20
Seat 3: CatKilla13 (13225 in chips)=20
Seat 4: dakota0414 (22254 in chips)=20
Seat 5: 22dancerr (22050 in chips)=20
Seat 6: lok_dawg420 (18744 in chips)=20
JJin91: posts the ante 25
CR8TVT2: posts the ante 25
CatKilla13: posts the ante 25
dakota0414: posts the ante 25
22dancerr: posts the ante 25
lok_dawg420: posts the ante 25
JJin91: posts small blind 100
CR8TVT2: posts big blind 200
*** HOLE CARDS ***
Dealt to JJin91 [5d 5h]
CatKilla13: raises 200 to 400
dakota0414: calls 400
22dancerr: folds=20
lok_dawg420: calls 400
JJin91: calls 300
CR8TVT2: calls 200
*** FLOP *** [Jc Ad 3c]
JJin91: checks=20
CR8TVT2: bets 1000
CatKilla13: calls 1000
dakota0414: folds=20
lok_dawg420: folds=20
JJin91: folds=20
*** TURN *** [Jc Ad 3c] [8h]
CR8TVT2: bets 2075
CatKilla13: folds=20
Uncalled bet (2075) returned to CR8TVT2
CR8TVT2 collected 4150 from pot
*** SUMMARY ***
Total pot 4150 | Rake 0=20
Board [Jc Ad 3c 8h]
Seat 1: JJin91 (small blind) folded on the Flop
Seat 2: CR8TVT2 (big blind) collected (4150)
Seat 3: CatKilla13 folded on the Turn
Seat 4: dakota0414 folded on the Flop
Seat 5: 22dancerr folded before Flop (didn't bet)
Seat 6: lok_dawg420 (button) folded on the Flop


*********** # 24 **************
PokerStars Hand #175471999405: Tournament #1701793695, $9.10+$0.90 USD =
Hold'em No Limit - Level V (125/250) - 2017/09/24 17:20:59 ET
Table '1701793695 7' 6-max Seat #1 is the button
Seat 1: JJin91 (24741 in chips)=20
Seat 2: CR8TVT2 (21381 in chips)=20
Seat 3: CatKilla13 (11800 in chips)=20
Seat 4: dakota0414 (21829 in chips)=20
Seat 5: 22dancerr (22025 in chips)=20
Seat 6: lok_dawg420 (18319 in chips)=20
JJin91: posts the ante 30
CR8TVT2: posts the ante 30
CatKilla13: posts the ante 30
dakota0414: posts the ante 30
22dancerr: posts the ante 30
lok_dawg420: posts the ante 30
CR8TVT2: posts small blind 125
CatKilla13: posts big blind 250
*** HOLE CARDS ***
Dealt to JJin91 [Th 2c]
dakota0414: calls 250
22dancerr: folds=20
lok_dawg420: folds=20
JJin91: folds=20
CR8TVT2: folds=20
CatKilla13: checks=20
*** FLOP *** [3h As 5s]
CatKilla13: checks=20
dakota0414: checks=20
*** TURN *** [3h As 5s] [Jd]
CatKilla13: checks=20
dakota0414: bets 750
CatKilla13: folds=20
Uncalled bet (750) returned to dakota0414
dakota0414 collected 805 from pot
dakota0414: doesn't show hand=20
*** SUMMARY ***
Total pot 805 | Rake 0=20
Board [3h As 5s Jd]
Seat 1: JJin91 (button) folded before Flop (didn't bet)
Seat 2: CR8TVT2 (small blind) folded before Flop
Seat 3: CatKilla13 (big blind) folded on the Turn
Seat 4: dakota0414 collected (805)
Seat 5: 22dancerr folded before Flop (didn't bet)
Seat 6: lok_dawg420 folded before Flop (didn't bet)


*********** # 25 **************
PokerStars Hand #175471999610: Tournament #1701793695, $9.10+$0.90 USD =
Hold'em No Limit - Level V (125/250) - 2017/09/24 17:21:59 ET
Table '1701793695 7' 6-max Seat #2 is the button
Seat 1: JJin91 (24711 in chips)=20
Seat 2: CR8TVT2 (21226 in chips)=20
Seat 3: CatKilla13 (11520 in chips)=20
Seat 4: dakota0414 (22354 in chips)=20
Seat 5: 22dancerr (21995 in chips)=20
Seat 6: lok_dawg420 (18289 in chips)=20
JJin91: posts the ante 30
CR8TVT2: posts the ante 30
CatKilla13: posts the ante 30
dakota0414: posts the ante 30
22dancerr: posts the ante 30
lok_dawg420: posts the ante 30
CatKilla13: posts small blind 125
dakota0414: posts big blind 250
*** HOLE CARDS ***
Dealt to JJin91 [9s 6d]
22dancerr: raises 500 to 750
lok_dawg420: folds=20
JJin91: folds=20
CR8TVT2: folds=20
CatKilla13: folds=20
dakota0414: folds=20
Uncalled bet (500) returned to 22dancerr
22dancerr collected 805 from pot
22dancerr: doesn't show hand=20
*** SUMMARY ***
Total pot 805 | Rake 0=20
Seat 1: JJin91 folded before Flop (didn't bet)
Seat 2: CR8TVT2 (button) folded before Flop (didn't bet)
Seat 3: CatKilla13 (small blind) folded before Flop
Seat 4: dakota0414 (big blind) folded before Flop
Seat 5: 22dancerr collected (805)
Seat 6: lok_dawg420 folded before Flop (didn't bet)


*********** # 26 **************
PokerStars Hand #175471999693: Tournament #1701793695, $9.10+$0.90 USD =
Hold'em No Limit - Level V (125/250) - 2017/09/24 17:22:19 ET
Table '1701793695 7' 6-max Seat #3 is the button
Seat 1: JJin91 (24681 in chips)=20
Seat 2: CR8TVT2 (21196 in chips)=20
Seat 3: CatKilla13 (11365 in chips)=20
Seat 4: dakota0414 (22074 in chips)=20
Seat 5: 22dancerr (22520 in chips)=20
Seat 6: lok_dawg420 (18259 in chips)=20
JJin91: posts the ante 30
CR8TVT2: posts the ante 30
CatKilla13: posts the ante 30
dakota0414: posts the ante 30
22dancerr: posts the ante 30
lok_dawg420: posts the ante 30
dakota0414: posts small blind 125
22dancerr: posts big blind 250
*** HOLE CARDS ***
Dealt to JJin91 [2s Jh]
lok_dawg420: folds=20
JJin91: folds=20
CR8TVT2: folds=20
CatKilla13: raises 805 to 1055
dakota0414: folds=20
22dancerr: calls 805
*** FLOP *** [7c 2c 2h]
22dancerr: checks=20
CatKilla13: bets 2500
22dancerr: raises 18935 to 21435 and is all-in
CatKilla13: calls 7780 and is all-in
Uncalled bet (11155) returned to 22dancerr
*** TURN *** [7c 2c 2h] [4h]
*** RIVER *** [7c 2c 2h 4h] [7s]
*** SHOW DOWN ***
22dancerr: shows [Jd Ac] (two pair, Sevens and Deuces)
CatKilla13: shows [As Ad] (two pair, Aces and Sevens)
CatKilla13 collected 22975 from pot
*** SUMMARY ***
Total pot 22975 | Rake 0=20
Board [7c 2c 2h 4h 7s]
Seat 1: JJin91 folded before Flop (didn't bet)
Seat 2: CR8TVT2 folded before Flop (didn't bet)
Seat 3: CatKilla13 (button) showed [As Ad] and won (22975) with two pai=
r, Aces and Sevens
Seat 4: dakota0414 (small blind) folded before Flop
Seat 5: 22dancerr (big blind) showed [Jd Ac] and lost with two pair, Se=
vens and Deuces
Seat 6: lok_dawg420 folded before Flop (didn't bet)


*********** # 27 **************
PokerStars Hand #175471999870: Tournament #1701793695, $9.10+$0.90 USD =
Hold'em No Limit - Level V (125/250) - 2017/09/24 17:23:07 ET
Table '1701793695 7' 6-max Seat #4 is the button
Seat 1: JJin91 (24651 in chips)=20
Seat 2: CR8TVT2 (21166 in chips)=20
Seat 3: CatKilla13 (22975 in chips)=20
Seat 4: dakota0414 (21919 in chips)=20
Seat 5: 22dancerr (11155 in chips)=20
Seat 6: lok_dawg420 (18229 in chips)=20
JJin91: posts the ante 30
CR8TVT2: posts the ante 30
CatKilla13: posts the ante 30
dakota0414: posts the ante 30
22dancerr: posts the ante 30
lok_dawg420: posts the ante 30
22dancerr: posts small blind 125
lok_dawg420: posts big blind 250
*** HOLE CARDS ***
Dealt to JJin91 [Qc Ah]
JJin91: raises 292 to 542
CR8TVT2: folds=20
CatKilla13: folds=20
dakota0414: folds=20
22dancerr: folds=20
lok_dawg420: folds=20
Uncalled bet (292) returned to JJin91
JJin91 collected 805 from pot
JJin91: doesn't show hand=20
*** SUMMARY ***
Total pot 805 | Rake 0=20
Seat 1: JJin91 collected (805)
Seat 2: CR8TVT2 folded before Flop (didn't bet)
Seat 3: CatKilla13 folded before Flop (didn't bet)
Seat 4: dakota0414 (button) folded before Flop (didn't bet)
Seat 5: 22dancerr (small blind) folded before Flop
Seat 6: lok_dawg420 (big blind) folded before Flop


*********** # 28 **************
PokerStars Hand #175471999951: Tournament #1701793695, $9.10+$0.90 USD =
Hold'em No Limit - Level V (125/250) - 2017/09/24 17:23:30 ET
Table '1701793695 7' 6-max Seat #5 is the button
Seat 1: JJin91 (25176 in chips)=20
Seat 2: CR8TVT2 (21136 in chips)=20
Seat 3: CatKilla13 (22945 in chips)=20
Seat 4: dakota0414 (21889 in chips)=20
Seat 5: 22dancerr (11000 in chips)=20
Seat 6: lok_dawg420 (17949 in chips)=20
JJin91: posts the ante 30
CR8TVT2: posts the ante 30
CatKilla13: posts the ante 30
dakota0414: posts the ante 30
22dancerr: posts the ante 30
lok_dawg420: posts the ante 30
lok_dawg420: posts small blind 125
JJin91: posts big blind 250
*** HOLE CARDS ***
Dealt to JJin91 [5c 9s]
CR8TVT2: folds=20
CatKilla13: folds=20
dakota0414: raises 250 to 500
22dancerr: raises 750 to 1250
lok_dawg420: folds=20
JJin91: folds=20
dakota0414: calls 750
*** FLOP *** [As Qs 6d]
dakota0414: checks=20
22dancerr: checks=20
*** TURN *** [As Qs 6d] [2s]
dakota0414: bets 10000
22dancerr: folds=20
Uncalled bet (10000) returned to dakota0414
dakota0414 collected 3055 from pot
dakota0414: doesn't show hand=20
*** SUMMARY ***
Total pot 3055 | Rake 0=20
Board [As Qs 6d 2s]
Seat 1: JJin91 (big blind) folded before Flop
Seat 2: CR8TVT2 folded before Flop (didn't bet)
Seat 3: CatKilla13 folded before Flop (didn't bet)
Seat 4: dakota0414 collected (3055)
Seat 5: 22dancerr (button) folded on the Turn
Seat 6: lok_dawg420 (small blind) folded before Flop


*********** # 29 **************
PokerStars Hand #175472567003: Tournament #1701793695, $9.10+$0.90 USD =
Hold'em No Limit - Level V (125/250) - 2017/09/24 17:24:12 ET
Table '1701793695 7' 6-max Seat #6 is the button
Seat 1: JJin91 (24896 in chips)=20
Seat 2: CR8TVT2 (21106 in chips)=20
Seat 3: CatKilla13 (22915 in chips)=20
Seat 4: dakota0414 (23664 in chips)=20
Seat 5: 22dancerr (9720 in chips)=20
Seat 6: lok_dawg420 (17794 in chips)=20
JJin91: posts the ante 30
CR8TVT2: posts the ante 30
CatKilla13: posts the ante 30
dakota0414: posts the ante 30
22dancerr: posts the ante 30
lok_dawg420: posts the ante 30
JJin91: posts small blind 125
CR8TVT2: posts big blind 250
*** HOLE CARDS ***
Dealt to JJin91 [9h Jc]
CatKilla13: calls 250
dakota0414: calls 250
22dancerr: folds=20
lok_dawg420: folds=20
JJin91: folds=20
CR8TVT2: checks=20
*** FLOP *** [Qh Ac 6h]
CR8TVT2: checks=20
CatKilla13: checks=20
dakota0414: checks=20
*** TURN *** [Qh Ac 6h] [Qd]
CR8TVT2: checks=20
CatKilla13: bets 250
dakota0414: folds=20
CR8TVT2: folds=20
Uncalled bet (250) returned to CatKilla13
CatKilla13 collected 1055 from pot
CatKilla13: doesn't show hand=20
*** SUMMARY ***
Total pot 1055 | Rake 0=20
Board [Qh Ac 6h Qd]
Seat 1: JJin91 (small blind) folded before Flop
Seat 2: CR8TVT2 (big blind) folded on the Turn
Seat 3: CatKilla13 collected (1055)
Seat 4: dakota0414 folded on the Turn
Seat 5: 22dancerr folded before Flop (didn't bet)
Seat 6: lok_dawg420 (button) folded before Flop (didn't bet)


*********** # 30 **************
PokerStars Hand #175472567234: Tournament #1701793695, $9.10+$0.90 USD =
Hold'em No Limit - Level VI (150/300) - 2017/09/24 17:25:20 ET
Table '1701793695 7' 6-max Seat #1 is the button
Seat 1: JJin91 (24741 in chips)=20
Seat 2: CR8TVT2 (20826 in chips)=20
Seat 3: CatKilla13 (23690 in chips)=20
Seat 4: dakota0414 (23384 in chips)=20
Seat 5: 22dancerr (9690 in chips)=20
Seat 6: lok_dawg420 (17764 in chips)=20
JJin91: posts the ante 40
CR8TVT2: posts the ante 40
CatKilla13: posts the ante 40
dakota0414: posts the ante 40
22dancerr: posts the ante 40
lok_dawg420: posts the ante 40
CR8TVT2: posts small blind 150
CatKilla13: posts big blind 300
*** HOLE CARDS ***
Dealt to JJin91 [7s 8c]
dakota0414: folds=20
22dancerr: raises 600 to 900
lok_dawg420: folds=20
JJin91: folds=20
CR8TVT2: folds=20
CatKilla13: calls 600
*** FLOP *** [6s 6h 5s]
CatKilla13: checks=20
22dancerr: checks=20
*** TURN *** [6s 6h 5s] [Ah]
CatKilla13: checks=20
22dancerr: bets 900
CatKilla13: folds=20
Uncalled bet (900) returned to 22dancerr
22dancerr collected 2190 from pot
22dancerr: doesn't show hand=20
*** SUMMARY ***
Total pot 2190 | Rake 0=20
Board [6s 6h 5s Ah]
Seat 1: JJin91 (button) folded before Flop (didn't bet)
Seat 2: CR8TVT2 (small blind) folded before Flop
Seat 3: CatKilla13 (big blind) folded on the Turn
Seat 4: dakota0414 folded before Flop (didn't bet)
Seat 5: 22dancerr collected (2190)
Seat 6: lok_dawg420 folded before Flop (didn't bet)


*********** # 31 **************
PokerStars Hand #175472567356: Tournament #1701793695, $9.10+$0.90 USD =
Hold'em No Limit - Level VI (150/300) - 2017/09/24 17:25:55 ET
Table '1701793695 7' 6-max Seat #2 is the button
Seat 1: JJin91 (24701 in chips)=20
Seat 2: CR8TVT2 (20636 in chips)=20
Seat 3: CatKilla13 (22750 in chips)=20
Seat 4: dakota0414 (23344 in chips)=20
Seat 5: 22dancerr (10940 in chips)=20
Seat 6: lok_dawg420 (17724 in chips)=20
JJin91: posts the ante 40
CR8TVT2: posts the ante 40
CatKilla13: posts the ante 40
dakota0414: posts the ante 40
22dancerr: posts the ante 40
lok_dawg420: posts the ante 40
CatKilla13: posts small blind 150
dakota0414: posts big blind 300
*** HOLE CARDS ***
Dealt to JJin91 [9s Ks]
22dancerr: folds=20
lok_dawg420: folds=20
JJin91: raises 351 to 651
CR8TVT2: folds=20
CatKilla13: folds=20
dakota0414: folds=20
Uncalled bet (351) returned to JJin91
JJin91 collected 990 from pot
JJin91: doesn't show hand=20
*** SUMMARY ***
Total pot 990 | Rake 0=20
Seat 1: JJin91 collected (990)
Seat 2: CR8TVT2 (button) folded before Flop (didn't bet)
Seat 3: CatKilla13 (small blind) folded before Flop
Seat 4: dakota0414 (big blind) folded before Flop
Seat 5: 22dancerr folded before Flop (didn't bet)
Seat 6: lok_dawg420 folded before Flop (didn't bet)


*********** # 32 **************
PokerStars Hand #175472567441: Tournament #1701793695, $9.10+$0.90 USD =
Hold'em No Limit - Level VI (150/300) - 2017/09/24 17:26:19 ET
Table '1701793695 7' 6-max Seat #3 is the button
Seat 1: JJin91 (25351 in chips)=20
Seat 2: CR8TVT2 (20596 in chips)=20
Seat 3: CatKilla13 (22560 in chips)=20
Seat 4: dakota0414 (23004 in chips)=20
Seat 5: 22dancerr (10900 in chips)=20
Seat 6: lok_dawg420 (17684 in chips)=20
JJin91: posts the ante 40
CR8TVT2: posts the ante 40
CatKilla13: posts the ante 40
dakota0414: posts the ante 40
22dancerr: posts the ante 40
lok_dawg420: posts the ante 40
dakota0414: posts small blind 150
22dancerr: posts big blind 300
*** HOLE CARDS ***
Dealt to JJin91 [Ac 6c]
lok_dawg420: calls 300
JJin91: folds=20
CR8TVT2: folds=20
CatKilla13: calls 300
dakota0414: folds=20
22dancerr: checks=20
*** FLOP *** [5c 4c Qc]
22dancerr: checks=20
lok_dawg420: checks=20
CatKilla13: bets 300
22dancerr: calls 300
lok_dawg420: calls 300
*** TURN *** [5c 4c Qc] [3d]
22dancerr: checks=20
lok_dawg420: checks=20
CatKilla13: checks=20
*** RIVER *** [5c 4c Qc 3d] [Ts]
22dancerr: bets 1800
lok_dawg420: calls 1800
CatKilla13: folds=20
*** SHOW DOWN ***
22dancerr: shows [3s Kc] (a pair of Threes)
lok_dawg420: shows [Qs 9s] (a pair of Queens)
lok_dawg420 collected 5790 from pot
*** SUMMARY ***
Total pot 5790 | Rake 0=20
Board [5c 4c Qc 3d Ts]
Seat 1: JJin91 folded before Flop (didn't bet)
Seat 2: CR8TVT2 folded before Flop (didn't bet)
Seat 3: CatKilla13 (button) folded on the River
Seat 4: dakota0414 (small blind) folded before Flop
Seat 5: 22dancerr (big blind) showed [3s Kc] and lost with a pair of Th=
rees
Seat 6: lok_dawg420 showed [Qs 9s] and won (5790) with a pair of Queens


*********** # 33 **************
PokerStars Hand #175472567833: Tournament #1701793695, $9.10+$0.90 USD =
Hold'em No Limit - Level VI (150/300) - 2017/09/24 17:28:03 ET
Table '1701793695 7' 6-max Seat #4 is the button
Seat 1: JJin91 (25311 in chips)=20
Seat 2: CR8TVT2 (20556 in chips)=20
Seat 3: CatKilla13 (21920 in chips)=20
Seat 4: dakota0414 (22814 in chips)=20
Seat 5: 22dancerr (8460 in chips)=20
Seat 6: lok_dawg420 (21034 in chips)=20
JJin91: posts the ante 40
CR8TVT2: posts the ante 40
CatKilla13: posts the ante 40
dakota0414: posts the ante 40
22dancerr: posts the ante 40
lok_dawg420: posts the ante 40
22dancerr: posts small blind 150
lok_dawg420: posts big blind 300
*** HOLE CARDS ***
Dealt to JJin91 [9s 8d]
JJin91: folds=20
CR8TVT2: folds=20
CatKilla13: folds=20
CatKilla13 is sitting out
dakota0414: calls 300
22dancerr: raises 900 to 1200
lok_dawg420: folds=20
dakota0414: folds=20
Uncalled bet (900) returned to 22dancerr
22dancerr collected 1140 from pot
22dancerr: doesn't show hand=20
*** SUMMARY ***
Total pot 1140 | Rake 0=20
Seat 1: JJin91 folded before Flop (didn't bet)
Seat 2: CR8TVT2 folded before Flop (didn't bet)
Seat 3: CatKilla13 folded before Flop (didn't bet)
Seat 4: dakota0414 (button) folded before Flop
Seat 5: 22dancerr (small blind) collected (1140)
Seat 6: lok_dawg420 (big blind) folded before Flop


*********** # 34 **************
PokerStars Hand #175472567957: Tournament #1701793695, $9.10+$0.90 USD =
Hold'em No Limit - Level VI (150/300) - 2017/09/24 17:28:33 ET
Table '1701793695 7' 6-max Seat #5 is the button
Seat 1: JJin91 (25271 in chips)=20
Seat 2: CR8TVT2 (20516 in chips)=20
Seat 3: CatKilla13 (21880 in chips) is sitting out
Seat 5: 22dancerr (9260 in chips)=20
Seat 6: lok_dawg420 (20694 in chips)=20
JJin91: posts the ante 40
CR8TVT2: posts the ante 40
CatKilla13: posts the ante 40
22dancerr: posts the ante 40
lok_dawg420: posts the ante 40
lok_dawg420: posts small blind 150
JJin91: posts big blind 300
*** HOLE CARDS ***
Dealt to JJin91 [3c 2s]
CR8TVT2: folds=20
CatKilla13: folds=20
22dancerr: raises 600 to 900
lok_dawg420: folds=20
CatKilla13 has returned
CatKilla13 is sitting out
CatKilla13 has returned
JJin91: folds=20
Uncalled bet (600) returned to 22dancerr
22dancerr collected 950 from pot
22dancerr: doesn't show hand=20
*** SUMMARY ***
Total pot 950 | Rake 0=20
Seat 1: JJin91 (big blind) folded before Flop
Seat 2: CR8TVT2 folded before Flop (didn't bet)
Seat 3: CatKilla13 folded before Flop (didn't bet)
Seat 5: 22dancerr (button) collected (950)
Seat 6: lok_dawg420 (small blind) folded before Flop


*********** # 35 **************
PokerStars Hand #175472568056: Tournament #1701793695, $9.10+$0.90 USD =
Hold'em No Limit - Level VI (150/300) - 2017/09/24 17:29:01 ET
Table '1701793695 7' 6-max Seat #6 is the button
Seat 1: JJin91 (24931 in chips)=20
Seat 2: CR8TVT2 (20476 in chips)=20
Seat 3: CatKilla13 (21840 in chips)=20
Seat 5: 22dancerr (9870 in chips)=20
Seat 6: lok_dawg420 (20504 in chips)=20
JJin91: posts the ante 40
CR8TVT2: posts the ante 40
CatKilla13: posts the ante 40
22dancerr: posts the ante 40
lok_dawg420: posts the ante 40
JJin91: posts small blind 150
CR8TVT2: posts big blind 300
*** HOLE CARDS ***
Dealt to JJin91 [3d 5d]
CatKilla13: raises 300 to 600
22dancerr: calls 600
lok_dawg420: calls 600
JJin91: folds=20
CR8TVT2: calls 300
*** FLOP *** [5s Jh 7d]
CR8TVT2: checks=20
CatKilla13: checks=20
22dancerr: bets 1500
lok_dawg420: folds=20
CR8TVT2: folds=20
CatKilla13: calls 1500
*** TURN *** [5s Jh 7d] [Jd]
CatKilla13: checks=20
22dancerr: bets 2400
CatKilla13: folds=20
Uncalled bet (2400) returned to 22dancerr
22dancerr collected 5750 from pot
22dancerr: doesn't show hand=20
*** SUMMARY ***
Total pot 5750 | Rake 0=20
Board [5s Jh 7d Jd]
Seat 1: JJin91 (small blind) folded before Flop
Seat 2: CR8TVT2 (big blind) folded on the Flop
Seat 3: CatKilla13 folded on the Turn
Seat 5: 22dancerr collected (5750)
Seat 6: lok_dawg420 (button) folded on the Flop


*********** # 36 **************
PokerStars Hand #175472568229: Tournament #1701793695, $9.10+$0.90 USD =
Hold'em No Limit - Level VI (150/300) - 2017/09/24 17:29:48 ET
Table '1701793695 7' 6-max Seat #1 is the button
Seat 1: JJin91 (24741 in chips)=20
Seat 2: CR8TVT2 (19836 in chips)=20
Seat 3: CatKilla13 (19700 in chips)=20
Seat 5: 22dancerr (13480 in chips)=20
Seat 6: lok_dawg420 (19864 in chips)=20
JJin91: posts the ante 40
CR8TVT2: posts the ante 40
CatKilla13: posts the ante 40
22dancerr: posts the ante 40
lok_dawg420: posts the ante 40
CR8TVT2: posts small blind 150
CatKilla13: posts big blind 300
*** HOLE CARDS ***
Dealt to JJin91 [3h Jc]
22dancerr: folds=20
lok_dawg420: folds=20
JJin91: raises 351 to 651
CR8TVT2: calls 501
CatKilla13: raises 19009 to 19660 and is all-in
JJin91: folds=20
CR8TVT2: folds=20
Uncalled bet (19009) returned to CatKilla13
CatKilla13 collected 2153 from pot
CatKilla13: doesn't show hand=20
*** SUMMARY ***
Total pot 2153 | Rake 0=20
Seat 1: JJin91 (button) folded before Flop
Seat 2: CR8TVT2 (small blind) folded before Flop
Seat 3: CatKilla13 (big blind) collected (2153)
Seat 5: 22dancerr folded before Flop (didn't bet)
Seat 6: lok_dawg420 folded before Flop (didn't bet)


*********** # 37 **************
PokerStars Hand #175472568410: Tournament #1701793695, $9.10+$0.90 USD =
Hold'em No Limit - Level VII (200/400) - 2017/09/24 17:30:32 ET
Table '1701793695 7' 6-max Seat #2 is the button
Seat 1: JJin91 (24050 in chips)=20
Seat 2: CR8TVT2 (19145 in chips)=20
Seat 3: CatKilla13 (21162 in chips)=20
Seat 5: 22dancerr (13440 in chips)=20
Seat 6: lok_dawg420 (19824 in chips)=20
JJin91: posts the ante 50
CR8TVT2: posts the ante 50
CatKilla13: posts the ante 50
22dancerr: posts the ante 50
lok_dawg420: posts the ante 50
CatKilla13: posts small blind 200
22dancerr: posts big blind 400
*** HOLE CARDS ***
Dealt to JJin91 [6h As]
lok_dawg420: folds=20
JJin91: raises 468 to 868
CR8TVT2: folds=20
CatKilla13: folds=20
22dancerr: calls 468
*** FLOP *** [7d Ah 3c]
22dancerr: checks=20
JJin91: bets 1323
22dancerr: calls 1323
*** TURN *** [7d Ah 3c] [7c]
22dancerr: checks=20
JJin91: checks=20
*** RIVER *** [7d Ah 3c 7c] [7h]
22dancerr: bets 11199 and is all-in
JJin91: calls 11199
*** SHOW DOWN ***
22dancerr: shows [5c 7s] (four of a kind, Sevens)
JJin91: shows [6h As] (a full house, Sevens full of Aces)
22dancerr collected 27230 from pot
*** SUMMARY ***
Total pot 27230 | Rake 0=20
Board [7d Ah 3c 7c 7h]
Seat 1: JJin91 showed [6h As] and lost with a full house, Sevens full o=
f Aces
Seat 2: CR8TVT2 (button) folded before Flop (didn't bet)
Seat 3: CatKilla13 (small blind) folded before Flop
Seat 5: 22dancerr (big blind) showed [5c 7s] and won (27230) with four =
of a kind, Sevens
Seat 6: lok_dawg420 folded before Flop (didn't bet)


*********** # 38 **************
PokerStars Hand #175472568650: Tournament #1701793695, $9.10+$0.90 USD =
Hold'em No Limit - Level VII (200/400) - 2017/09/24 17:31:29 ET
Table '1701793695 7' 6-max Seat #3 is the button
Seat 1: JJin91 (10610 in chips)=20
Seat 2: CR8TVT2 (19095 in chips)=20
Seat 3: CatKilla13 (20912 in chips)=20
Seat 5: 22dancerr (27230 in chips)=20
Seat 6: lok_dawg420 (19774 in chips)=20
JJin91: posts the ante 50
CR8TVT2: posts the ante 50
CatKilla13: posts the ante 50
22dancerr: posts the ante 50
lok_dawg420: posts the ante 50
22dancerr: posts small blind 200
lok_dawg420: posts big blind 400
*** HOLE CARDS ***
Dealt to JJin91 [Ac 6h]
JJin91: folds=20
CR8TVT2: calls 400
CatKilla13: calls 400
22dancerr: raises 1200 to 1600
lok_dawg420: folds=20
CR8TVT2: calls 1200
CatKilla13: calls 1200
*** FLOP *** [3s 8d 4h]
22dancerr: bets 3200
CR8TVT2: folds=20
CatKilla13: folds=20
Uncalled bet (3200) returned to 22dancerr
22dancerr collected 5450 from pot
22dancerr: doesn't show hand=20
*** SUMMARY ***
Total pot 5450 | Rake 0=20
Board [3s 8d 4h]
Seat 1: JJin91 folded before Flop (didn't bet)
Seat 2: CR8TVT2 folded on the Flop
Seat 3: CatKilla13 (button) folded on the Flop
Seat 5: 22dancerr (small blind) collected (5450)
Seat 6: lok_dawg420 (big blind) folded before Flop


*********** # 39 **************
PokerStars Hand #175472568924: Tournament #1701793695, $9.10+$0.90 USD =
Hold'em No Limit - Level VII (200/400) - 2017/09/24 17:32:35 ET
Table '1701793695 7' 6-max Seat #5 is the button
Seat 1: JJin91 (10560 in chips)=20
Seat 2: CR8TVT2 (17445 in chips)=20
Seat 3: CatKilla13 (19262 in chips)=20
Seat 4: jaysu (20000 in chips)=20
Seat 5: 22dancerr (31030 in chips)=20
Seat 6: lok_dawg420 (19324 in chips)=20
JJin91: posts the ante 50
CR8TVT2: posts the ante 50
CatKilla13: posts the ante 50
jaysu: posts the ante 50
22dancerr: posts the ante 50
lok_dawg420: posts the ante 50
lok_dawg420: posts small blind 200
JJin91: posts big blind 400
*** HOLE CARDS ***
Dealt to JJin91 [Qd 7d]
CR8TVT2: folds=20
CatKilla13: raises 1300 to 1700
jaysu: folds=20
22dancerr: folds=20
lok_dawg420: folds=20
JJin91: folds=20
Uncalled bet (1300) returned to CatKilla13
CatKilla13 collected 1300 from pot
CatKilla13: doesn't show hand=20
*** SUMMARY ***
Total pot 1300 | Rake 0=20
Seat 1: JJin91 (big blind) folded before Flop
Seat 2: CR8TVT2 folded before Flop (didn't bet)
Seat 3: CatKilla13 collected (1300)
Seat 4: jaysu folded before Flop (didn't bet)
Seat 5: 22dancerr (button) folded before Flop (didn't bet)
Seat 6: lok_dawg420 (small blind) folded before Flop


*********** # 40 **************
PokerStars Hand #175472569069: Tournament #1701793695, $9.10+$0.90 USD =
Hold'em No Limit - Level VII (200/400) - 2017/09/24 17:33:08 ET
Table '1701793695 7' 6-max Seat #6 is the button
Seat 1: JJin91 (10110 in chips)=20
Seat 2: CR8TVT2 (17395 in chips)=20
Seat 3: CatKilla13 (20112 in chips)=20
Seat 4: jaysu (19950 in chips)=20
Seat 5: 22dancerr (30980 in chips)=20
Seat 6: lok_dawg420 (19074 in chips)=20
JJin91: posts the ante 50
CR8TVT2: posts the ante 50
CatKilla13: posts the ante 50
jaysu: posts the ante 50
22dancerr: posts the ante 50
lok_dawg420: posts the ante 50
JJin91: posts small blind 200
CR8TVT2: posts big blind 400
*** HOLE CARDS ***
Dealt to JJin91 [6d 8d]
CatKilla13: folds=20
jaysu: raises 400 to 800
22dancerr: folds=20
lok_dawg420: folds=20
JJin91: folds=20
CR8TVT2: folds=20
Uncalled bet (400) returned to jaysu
jaysu collected 1300 from pot
jaysu: doesn't show hand=20
*** SUMMARY ***
Total pot 1300 | Rake 0=20
Seat 1: JJin91 (small blind) folded before Flop
Seat 2: CR8TVT2 (big blind) folded before Flop
Seat 3: CatKilla13 folded before Flop (didn't bet)
Seat 4: jaysu collected (1300)
Seat 5: 22dancerr folded before Flop (didn't bet)
Seat 6: lok_dawg420 (button) folded before Flop (didn't bet)


*********** # 41 **************
PokerStars Hand #175472569166: Tournament #1701793695, $9.10+$0.90 USD =
Hold'em No Limit - Level VII (200/400) - 2017/09/24 17:33:31 ET
Table '1701793695 7' 6-max Seat #1 is the button
Seat 1: JJin91 (9860 in chips)=20
Seat 2: CR8TVT2 (16945 in chips)=20
Seat 3: CatKilla13 (20062 in chips)=20
Seat 4: jaysu (20800 in chips)=20
Seat 5: 22dancerr (30930 in chips)=20
Seat 6: lok_dawg420 (19024 in chips)=20
JJin91: posts the ante 50
CR8TVT2: posts the ante 50
CatKilla13: posts the ante 50
jaysu: posts the ante 50
22dancerr: posts the ante 50
lok_dawg420: posts the ante 50
CR8TVT2: posts small blind 200
CatKilla13: posts big blind 400
*** HOLE CARDS ***
Dealt to JJin91 [Ts 2s]
jaysu: folds=20
22dancerr: folds=20
lok_dawg420: raises 1300 to 1700
JJin91: folds=20
CR8TVT2: folds=20
CatKilla13 is disconnected=20
CatKilla13 is connected=20
CatKilla13: folds=20
Uncalled bet (1300) returned to lok_dawg420
lok_dawg420 collected 1300 from pot
lok_dawg420: doesn't show hand=20
*** SUMMARY ***
Total pot 1300 | Rake 0=20
Seat 1: JJin91 (button) folded before Flop (didn't bet)
Seat 2: CR8TVT2 (small blind) folded before Flop
Seat 3: CatKilla13 (big blind) folded before Flop
Seat 4: jaysu folded before Flop (didn't bet)
Seat 5: 22dancerr folded before Flop (didn't bet)
Seat 6: lok_dawg420 collected (1300)


*********** # 42 **************
PokerStars Hand #175472569384: Tournament #1701793695, $9.10+$0.90 USD =
Hold'em No Limit - Level VII (200/400) - 2017/09/24 17:34:22 ET
Table '1701793695 7' 6-max Seat #2 is the button
Seat 1: JJin91 (9810 in chips)=20
Seat 2: CR8TVT2 (16695 in chips)=20
Seat 3: CatKilla13 (19612 in chips)=20
Seat 4: jaysu (20750 in chips)=20
Seat 5: 22dancerr (30880 in chips)=20
Seat 6: lok_dawg420 (19874 in chips)=20
JJin91: posts the ante 50
CR8TVT2: posts the ante 50
CatKilla13: posts the ante 50
jaysu: posts the ante 50
22dancerr: posts the ante 50
lok_dawg420: posts the ante 50
CatKilla13: posts small blind 200
jaysu: posts big blind 400
*** HOLE CARDS ***
Dealt to JJin91 [4h 4d]
22dancerr: folds=20
lok_dawg420: raises 1300 to 1700
JJin91: raises 8060 to 9760 and is all-in
CR8TVT2: folds=20
CatKilla13: folds=20
jaysu: folds=20
lok_dawg420: calls 8060
*** FLOP *** [4s 8d Js]
*** TURN *** [4s 8d Js] [8h]
*** RIVER *** [4s 8d Js 8h] [3d]
*** SHOW DOWN ***
lok_dawg420: shows [Kh Kc] (two pair, Kings and Eights)
JJin91: shows [4h 4d] (a full house, Fours full of Eights)
JJin91 collected 20420 from pot
*** SUMMARY ***
Total pot 20420 | Rake 0=20
Board [4s 8d Js 8h 3d]
Seat 1: JJin91 showed [4h 4d] and won (20420) with a full house, Fours =
full of Eights
Seat 2: CR8TVT2 (button) folded before Flop (didn't bet)
Seat 3: CatKilla13 (small blind) folded before Flop
Seat 4: jaysu (big blind) folded before Flop
Seat 5: 22dancerr folded before Flop (didn't bet)
Seat 6: lok_dawg420 showed [Kh Kc] and lost with two pair, Kings and Ei=
ghts


*********** # 43 **************
PokerStars Hand #175472569545: Tournament #1701793695, $9.10+$0.90 USD =
Hold'em No Limit - Level VII (200/400) - 2017/09/24 17:34:59 ET
Table '1701793695 7' 6-max Seat #3 is the button
Seat 1: JJin91 (20420 in chips)=20
Seat 2: CR8TVT2 (16645 in chips)=20
Seat 3: CatKilla13 (19362 in chips)=20
Seat 4: jaysu (20300 in chips)=20
Seat 5: 22dancerr (30830 in chips)=20
Seat 6: lok_dawg420 (10064 in chips)=20
JJin91: posts the ante 50
CR8TVT2: posts the ante 50
CatKilla13: posts the ante 50
jaysu: posts the ante 50
22dancerr: posts the ante 50
lok_dawg420: posts the ante 50
jaysu: posts small blind 200
22dancerr: posts big blind 400
*** HOLE CARDS ***
Dealt to JJin91 [2d Ks]
lok_dawg420: folds=20
JJin91: folds=20
CR8TVT2: calls 400
CatKilla13: calls 400
jaysu: calls 200
22dancerr: raises 1600 to 2000
CR8TVT2: folds=20
CatKilla13: folds=20
jaysu: folds=20
Uncalled bet (1600) returned to 22dancerr
22dancerr collected 1900 from pot
22dancerr: doesn't show hand=20
*** SUMMARY ***
Total pot 1900 | Rake 0=20
Seat 1: JJin91 folded before Flop (didn't bet)
Seat 2: CR8TVT2 folded before Flop
Seat 3: CatKilla13 (button) folded before Flop
Seat 4: jaysu (small blind) folded before Flop
Seat 5: 22dancerr (big blind) collected (1900)
Seat 6: lok_dawg420 folded before Flop (didn't bet)


*********** # 44 **************
PokerStars Hand #175472569734: Tournament #1701793695, $9.10+$0.90 USD =
Hold'em No Limit - Level VIII (250/500) - 2017/09/24 17:35:43 ET
Table '1701793695 7' 6-max Seat #4 is the button
Seat 1: JJin91 (20370 in chips)=20
Seat 2: CR8TVT2 (16195 in chips)=20
Seat 3: CatKilla13 (18912 in chips)=20
Seat 4: jaysu (19850 in chips)=20
Seat 5: 22dancerr (32280 in chips)=20
Seat 6: lok_dawg420 (10014 in chips)=20
JJin91: posts the ante 60
CR8TVT2: posts the ante 60
CatKilla13: posts the ante 60
jaysu: posts the ante 60
22dancerr: posts the ante 60
lok_dawg420: posts the ante 60
22dancerr: posts small blind 250
lok_dawg420: posts big blind 500
*** HOLE CARDS ***
Dealt to JJin91 [5h 7s]
JJin91: folds=20
CR8TVT2: folds=20
CatKilla13: folds=20
jaysu: folds=20
22dancerr: calls 250
lok_dawg420: checks=20
*** FLOP *** [8h 7c 4d]
22dancerr: checks=20
lok_dawg420: bets 1000
22dancerr: folds=20
Uncalled bet (1000) returned to lok_dawg420
lok_dawg420 collected 1360 from pot
lok_dawg420: doesn't show hand=20
*** SUMMARY ***
Total pot 1360 | Rake 0=20
Board [8h 7c 4d]
Seat 1: JJin91 folded before Flop (didn't bet)
Seat 2: CR8TVT2 folded before Flop (didn't bet)
Seat 3: CatKilla13 folded before Flop (didn't bet)
Seat 4: jaysu (button) folded before Flop (didn't bet)
Seat 5: 22dancerr (small blind) folded on the Flop
Seat 6: lok_dawg420 (big blind) collected (1360)


*********** # 45 **************
PokerStars Hand #175472569828: Tournament #1701793695, $9.10+$0.90 USD =
Hold'em No Limit - Level VIII (250/500) - 2017/09/24 17:36:09 ET
Table '1701793695 7' 6-max Seat #5 is the button
Seat 1: JJin91 (20310 in chips)=20
Seat 2: CR8TVT2 (16135 in chips)=20
Seat 3: CatKilla13 (18852 in chips)=20
Seat 4: jaysu (19790 in chips)=20
Seat 5: 22dancerr (31720 in chips)=20
Seat 6: lok_dawg420 (10814 in chips)=20
JJin91: posts the ante 60
CR8TVT2: posts the ante 60
CatKilla13: posts the ante 60
jaysu: posts the ante 60
22dancerr: posts the ante 60
lok_dawg420: posts the ante 60
lok_dawg420: posts small blind 250
JJin91: posts big blind 500
*** HOLE CARDS ***
Dealt to JJin91 [Kc Td]
CR8TVT2: folds=20
CatKilla13: folds=20
jaysu: folds=20
22dancerr: raises 1500 to 2000
lok_dawg420: folds=20
JJin91: raises 18250 to 20250 and is all-in
22dancerr: folds=20
Uncalled bet (18250) returned to JJin91
JJin91 collected 4610 from pot
JJin91: doesn't show hand=20
*** SUMMARY ***
Total pot 4610 | Rake 0=20
Seat 1: JJin91 (big blind) collected (4610)
Seat 2: CR8TVT2 folded before Flop (didn't bet)
Seat 3: CatKilla13 folded before Flop (didn't bet)
Seat 4: jaysu folded before Flop (didn't bet)
Seat 5: 22dancerr (button) folded before Flop
Seat 6: lok_dawg420 (small blind) folded before Flop


*********** # 46 **************
PokerStars Hand #175473897812: Tournament #1701793695, $9.10+$0.90 USD =
Hold'em No Limit - Level VIII (250/500) - 2017/09/24 17:36:58 ET
Table '1701793695 7' 6-max Seat #6 is the button
Seat 1: JJin91 (22860 in chips)=20
Seat 2: CR8TVT2 (16075 in chips)=20
Seat 3: CatKilla13 (18792 in chips)=20
Seat 4: jaysu (19730 in chips)=20
Seat 5: 22dancerr (29660 in chips)=20
Seat 6: lok_dawg420 (10504 in chips)=20
JJin91: posts the ante 60
CR8TVT2: posts the ante 60
CatKilla13: posts the ante 60
jaysu: posts the ante 60
22dancerr: posts the ante 60
lok_dawg420: posts the ante 60
JJin91: posts small blind 250
CR8TVT2: posts big blind 500
*** HOLE CARDS ***
Dealt to JJin91 [Tc 4s]
CatKilla13: folds=20
jaysu: folds=20
22dancerr: folds=20
lok_dawg420: calls 500
JJin91: folds=20
CR8TVT2: checks=20
*** FLOP *** [Ts 6d Ks]
CR8TVT2: checks=20
lok_dawg420: bets 1000
CR8TVT2: folds=20
Uncalled bet (1000) returned to lok_dawg420
lok_dawg420 collected 1610 from pot
lok_dawg420: doesn't show hand=20
*** SUMMARY ***
Total pot 1610 | Rake 0=20
Board [Ts 6d Ks]
Seat 1: JJin91 (small blind) folded before Flop
Seat 2: CR8TVT2 (big blind) folded on the Flop
Seat 3: CatKilla13 folded before Flop (didn't bet)
Seat 4: jaysu folded before Flop (didn't bet)
Seat 5: 22dancerr folded before Flop (didn't bet)
Seat 6: lok_dawg420 (button) collected (1610)


*********** # 47 **************
PokerStars Hand #175473898154: Tournament #1701793695, $9.10+$0.90 USD =
Hold'em No Limit - Level VIII (250/500) - 2017/09/24 17:38:24 ET
Table '1701793695 7' 6-max Seat #1 is the button
Seat 1: JJin91 (22550 in chips)=20
Seat 2: CR8TVT2 (15515 in chips)=20
Seat 3: CatKilla13 (18732 in chips)=20
Seat 4: jaysu (19670 in chips)=20
Seat 5: 22dancerr (29600 in chips)=20
Seat 6: lok_dawg420 (11554 in chips)=20
JJin91: posts the ante 60
CR8TVT2: posts the ante 60
CatKilla13: posts the ante 60
jaysu: posts the ante 60
22dancerr: posts the ante 60
lok_dawg420: posts the ante 60
CR8TVT2: posts small blind 250
CatKilla13: posts big blind 500
*** HOLE CARDS ***
Dealt to JJin91 [Qc Qs]
jaysu: folds=20
22dancerr: raises 1000 to 1500
lok_dawg420: folds=20
JJin91: raises 20990 to 22490 and is all-in
CR8TVT2: folds=20
CatKilla13: folds=20
22dancerr: calls 20990
*** FLOP *** [6s Ts Js]
*** TURN *** [6s Ts Js] [4s]
*** RIVER *** [6s Ts Js 4s] [7c]
*** SHOW DOWN ***
22dancerr: shows [8s 8d] (a flush, Jack high)
JJin91: shows [Qc Qs] (a flush, Queen high)
JJin91 collected 46090 from pot
*** SUMMARY ***
Total pot 46090 | Rake 0=20
Board [6s Ts Js 4s 7c]
Seat 1: JJin91 (button) showed [Qc Qs] and won (46090) with a flush, Qu=
een high
Seat 2: CR8TVT2 (small blind) folded before Flop
Seat 3: CatKilla13 (big blind) folded before Flop
Seat 4: jaysu folded before Flop (didn't bet)
Seat 5: 22dancerr showed [8s 8d] and lost with a flush, Jack high
Seat 6: lok_dawg420 folded before Flop (didn't bet)


*********** # 48 **************
PokerStars Hand #175473898281: Tournament #1701793695, $9.10+$0.90 USD =
Hold'em No Limit - Level VIII (250/500) - 2017/09/24 17:38:54 ET
Table '1701793695 7' 6-max Seat #2 is the button
Seat 1: JJin91 (46090 in chips)=20
Seat 2: CR8TVT2 (15205 in chips)=20
Seat 3: CatKilla13 (18172 in chips)=20
Seat 4: jaysu (19610 in chips)=20
Seat 5: 22dancerr (7050 in chips)=20
Seat 6: lok_dawg420 (11494 in chips)=20
JJin91: posts the ante 60
CR8TVT2: posts the ante 60
CatKilla13: posts the ante 60
jaysu: posts the ante 60
22dancerr: posts the ante 60
lok_dawg420: posts the ante 60
CatKilla13: posts small blind 250
jaysu: posts big blind 500
*** HOLE CARDS ***
Dealt to JJin91 [Th 5c]
22dancerr: folds=20
lok_dawg420: folds=20
JJin91: folds=20
CR8TVT2: folds=20
CatKilla13: calls 250
jaysu: raises 1000 to 1500
CatKilla13: folds=20
Uncalled bet (1000) returned to jaysu
jaysu collected 1360 from pot
jaysu: doesn't show hand=20
*** SUMMARY ***
Total pot 1360 | Rake 0=20
Seat 1: JJin91 folded before Flop (didn't bet)
Seat 2: CR8TVT2 (button) folded before Flop (didn't bet)
Seat 3: CatKilla13 (small blind) folded before Flop
Seat 4: jaysu (big blind) collected (1360)
Seat 5: 22dancerr folded before Flop (didn't bet)
Seat 6: lok_dawg420 folded before Flop (didn't bet)


*********** # 49 **************
PokerStars Hand #175473898439: Tournament #1701793695, $9.10+$0.90 USD =
Hold'em No Limit - Level VIII (250/500) - 2017/09/24 17:39:31 ET
Table '1701793695 7' 6-max Seat #3 is the button
Seat 1: JJin91 (46030 in chips)=20
Seat 2: CR8TVT2 (15145 in chips)=20
Seat 3: CatKilla13 (17612 in chips)=20
Seat 4: jaysu (20410 in chips)=20
Seat 5: 22dancerr (6990 in chips)=20
Seat 6: lok_dawg420 (11434 in chips)=20
JJin91: posts the ante 60
CR8TVT2: posts the ante 60
CatKilla13: posts the ante 60
jaysu: posts the ante 60
22dancerr: posts the ante 60
lok_dawg420: posts the ante 60
jaysu: posts small blind 250
22dancerr: posts big blind 500
*** HOLE CARDS ***
Dealt to JJin91 [4d 4c]
lok_dawg420: folds=20
JJin91: raises 585 to 1085
CR8TVT2: folds=20
CatKilla13 is connected=20
CatKilla13: folds=20
jaysu: folds=20
22dancerr: calls 585
*** FLOP *** [2d 7d 6h]
22dancerr: checks=20
JJin91: checks=20
*** TURN *** [2d 7d 6h] [Jh]
22dancerr: bets 1000
JJin91: folds=20
Uncalled bet (1000) returned to 22dancerr
22dancerr collected 2780 from pot
22dancerr: doesn't show hand=20
*** SUMMARY ***
Total pot 2780 | Rake 0=20
Board [2d 7d 6h Jh]
Seat 1: JJin91 folded on the Turn
Seat 2: CR8TVT2 folded before Flop (didn't bet)
Seat 3: CatKilla13 (button) folded before Flop (didn't bet)
Seat 4: jaysu (small blind) folded before Flop
Seat 5: 22dancerr (big blind) collected (2780)
Seat 6: lok_dawg420 folded before Flop (didn't bet)


*********** # 50 **************
PokerStars Hand #175473898721: Tournament #1701793695, $9.10+$0.90 USD =
Hold'em No Limit - Level IX (300/600) - 2017/09/24 17:40:39 ET
Table '1701793695 7' 6-max Seat #4 is the button
Seat 1: JJin91 (44885 in chips)=20
Seat 2: CR8TVT2 (15085 in chips)=20
Seat 3: CatKilla13 (17552 in chips)=20
Seat 4: jaysu (20100 in chips)=20
Seat 5: 22dancerr (8625 in chips)=20
Seat 6: lok_dawg420 (11374 in chips)=20
JJin91: posts the ante 70
CR8TVT2: posts the ante 70
CatKilla13: posts the ante 70
jaysu: posts the ante 70
22dancerr: posts the ante 70
lok_dawg420: posts the ante 70
22dancerr: posts small blind 300
lok_dawg420: posts big blind 600
*** HOLE CARDS ***
Dealt to JJin91 [6s 5d]
JJin91: folds=20
CR8TVT2: calls 600
CatKilla13: folds=20
jaysu: folds=20
22dancerr: calls 300
lok_dawg420: checks=20
*** FLOP *** [6d 2c 9h]
22dancerr: checks=20
lok_dawg420: checks=20
CR8TVT2: bets 1200
22dancerr: folds=20
lok_dawg420: folds=20
Uncalled bet (1200) returned to CR8TVT2
CR8TVT2 collected 2220 from pot
*** SUMMARY ***
Total pot 2220 | Rake 0=20
Board [6d 2c 9h]
Seat 1: JJin91 folded before Flop (didn't bet)
Seat 2: CR8TVT2 collected (2220)
Seat 3: CatKilla13 folded before Flop (didn't bet)
Seat 4: jaysu (button) folded before Flop (didn't bet)
Seat 5: 22dancerr (small blind) folded on the Flop
Seat 6: lok_dawg420 (big blind) folded on the Flop


*********** # 51 **************
PokerStars Hand #175473898858: Tournament #1701793695, $9.10+$0.90 USD =
Hold'em No Limit - Level IX (300/600) - 2017/09/24 17:41:13 ET
Table '1701793695 7' 6-max Seat #5 is the button
Seat 1: JJin91 (44815 in chips)=20
Seat 2: CR8TVT2 (16635 in chips)=20
Seat 3: CatKilla13 (17482 in chips)=20
Seat 4: jaysu (20030 in chips)=20
Seat 5: 22dancerr (7955 in chips)=20
Seat 6: lok_dawg420 (10704 in chips)=20
JJin91: posts the ante 70
CR8TVT2: posts the ante 70
CatKilla13: posts the ante 70
jaysu: posts the ante 70
22dancerr: posts the ante 70
lok_dawg420: posts the ante 70
lok_dawg420: posts small blind 300
JJin91: posts big blind 600
*** HOLE CARDS ***
Dealt to JJin91 [Kc 2s]
CR8TVT2: folds=20
CatKilla13: folds=20
jaysu: folds=20
22dancerr: raises 7285 to 7885 and is all-in
lok_dawg420: folds=20
JJin91: folds=20
Uncalled bet (7285) returned to 22dancerr
22dancerr collected 1920 from pot
22dancerr: doesn't show hand=20
*** SUMMARY ***
Total pot 1920 | Rake 0=20
Seat 1: JJin91 (big blind) folded before Flop
Seat 2: CR8TVT2 folded before Flop (didn't bet)
Seat 3: CatKilla13 folded before Flop (didn't bet)
Seat 4: jaysu folded before Flop (didn't bet)
Seat 5: 22dancerr (button) collected (1920)
Seat 6: lok_dawg420 (small blind) folded before Flop


*********** # 52 **************
PokerStars Hand #175473898966: Tournament #1701793695, $9.10+$0.90 USD =
Hold'em No Limit - Level IX (300/600) - 2017/09/24 17:41:38 ET
Table '1701793695 7' 6-max Seat #6 is the button
Seat 1: JJin91 (44145 in chips)=20
Seat 2: CR8TVT2 (16565 in chips)=20
Seat 3: CatKilla13 (17412 in chips)=20
Seat 4: jaysu (19960 in chips)=20
Seat 5: 22dancerr (9205 in chips)=20
Seat 6: lok_dawg420 (10334 in chips)=20
JJin91: posts the ante 70
CR8TVT2: posts the ante 70
CatKilla13: posts the ante 70
jaysu: posts the ante 70
22dancerr: posts the ante 70
lok_dawg420: posts the ante 70
JJin91: posts small blind 300
CR8TVT2: posts big blind 600
*** HOLE CARDS ***
Dealt to JJin91 [7h 6d]
CatKilla13: folds=20
jaysu: folds=20
22dancerr: raises 8535 to 9135 and is all-in
lok_dawg420: folds=20
JJin91: folds=20
CR8TVT2: folds=20
Uncalled bet (8535) returned to 22dancerr
22dancerr collected 1920 from pot
22dancerr: doesn't show hand=20
*** SUMMARY ***
Total pot 1920 | Rake 0=20
Seat 1: JJin91 (small blind) folded before Flop
Seat 2: CR8TVT2 (big blind) folded before Flop
Seat 3: CatKilla13 folded before Flop (didn't bet)
Seat 4: jaysu folded before Flop (didn't bet)
Seat 5: 22dancerr collected (1920)
Seat 6: lok_dawg420 (button) folded before Flop (didn't bet)


*********** # 53 **************
PokerStars Hand #175473899064: Tournament #1701793695, $9.10+$0.90 USD =
Hold'em No Limit - Level IX (300/600) - 2017/09/24 17:42:01 ET
Table '1701793695 7' 6-max Seat #1 is the button
Seat 1: JJin91 (43775 in chips)=20
Seat 2: CR8TVT2 (15895 in chips)=20
Seat 3: CatKilla13 (17342 in chips)=20
Seat 4: jaysu (19890 in chips)=20
Seat 5: 22dancerr (10455 in chips)=20
Seat 6: lok_dawg420 (10264 in chips)=20
JJin91: posts the ante 70
CR8TVT2: posts the ante 70
CatKilla13: posts the ante 70
jaysu: posts the ante 70
22dancerr: posts the ante 70
lok_dawg420: posts the ante 70
CR8TVT2: posts small blind 300
CatKilla13: posts big blind 600
*** HOLE CARDS ***
Dealt to JJin91 [6d Ac]
jaysu: raises 688 to 1288
22dancerr: folds=20
lok_dawg420: folds=20
JJin91: folds=20
CR8TVT2: folds=20
CatKilla13: calls 688
*** FLOP *** [Td 2c Qd]
CatKilla13: checks=20
jaysu: bets 1475
CatKilla13: calls 1475
*** TURN *** [Td 2c Qd] [4s]
CatKilla13: checks=20
jaysu: bets 3850
CatKilla13: folds=20
Uncalled bet (3850) returned to jaysu
jaysu collected 6246 from pot
jaysu: doesn't show hand=20
*** SUMMARY ***
Total pot 6246 | Rake 0=20
Board [Td 2c Qd 4s]
Seat 1: JJin91 (button) folded before Flop (didn't bet)
Seat 2: CR8TVT2 (small blind) folded before Flop
Seat 3: CatKilla13 (big blind) folded on the Turn
Seat 4: jaysu collected (6246)
Seat 5: 22dancerr folded before Flop (didn't bet)
Seat 6: lok_dawg420 folded before Flop (didn't bet)


*********** # 54 **************
PokerStars Hand #175473899295: Tournament #1701793695, $9.10+$0.90 USD =
Hold'em No Limit - Level IX (300/600) - 2017/09/24 17:42:55 ET
Table '1701793695 7' 6-max Seat #2 is the button
Seat 1: JJin91 (43705 in chips)=20
Seat 2: CR8TVT2 (15525 in chips)=20
Seat 3: CatKilla13 (14509 in chips)=20
Seat 4: jaysu (23303 in chips)=20
Seat 5: 22dancerr (10385 in chips)=20
Seat 6: lok_dawg420 (10194 in chips)=20
JJin91: posts the ante 70
CR8TVT2: posts the ante 70
CatKilla13: posts the ante 70
jaysu: posts the ante 70
22dancerr: posts the ante 70
lok_dawg420: posts the ante 70
CatKilla13: posts small blind 300
jaysu: posts big blind 600
*** HOLE CARDS ***
Dealt to JJin91 [9c Kc]
22dancerr: folds=20
lok_dawg420: folds=20
JJin91: raises 702 to 1302
CR8TVT2: calls 1302
CatKilla13: calls 1002
jaysu: calls 702
*** FLOP *** [Qc 5d 7h]
CatKilla13: checks=20
jaysu: checks=20
JJin91: bets 2333
CR8TVT2: calls 2333
CatKilla13: folds=20
jaysu: folds=20
*** TURN *** [Qc 5d 7h] [3h]
JJin91: checks=20
CR8TVT2: bets 10294
JJin91: folds=20
Uncalled bet (10294) returned to CR8TVT2
CR8TVT2 collected 10294 from pot
*** SUMMARY ***
Total pot 10294 | Rake 0=20
Board [Qc 5d 7h 3h]
Seat 1: JJin91 folded on the Turn
Seat 2: CR8TVT2 (button) collected (10294)
Seat 3: CatKilla13 (small blind) folded on the Flop
Seat 4: jaysu (big blind) folded on the Flop
Seat 5: 22dancerr folded before Flop (didn't bet)
Seat 6: lok_dawg420 folded before Flop (didn't bet)


*********** # 55 **************
PokerStars Hand #175473899625: Tournament #1701793695, $9.10+$0.90 USD =
Hold'em No Limit - Level IX (300/600) - 2017/09/24 17:44:12 ET
Table '1701793695 7' 6-max Seat #3 is the button
Seat 1: JJin91 (40000 in chips)=20
Seat 2: CR8TVT2 (22114 in chips)=20
Seat 3: CatKilla13 (13137 in chips)=20
Seat 4: jaysu (21931 in chips)=20
Seat 5: 22dancerr (10315 in chips)=20
Seat 6: lok_dawg420 (10124 in chips)=20
JJin91: posts the ante 70
CR8TVT2: posts the ante 70
CatKilla13: posts the ante 70
jaysu: posts the ante 70
22dancerr: posts the ante 70
lok_dawg420: posts the ante 70
jaysu: posts small blind 300
22dancerr: posts big blind 600
*** HOLE CARDS ***
Dealt to JJin91 [3c Qd]
lok_dawg420: folds=20
JJin91: folds=20
CR8TVT2: folds=20
CatKilla13: folds=20
jaysu: raises 900 to 1500
22dancerr: calls 900
*** FLOP *** [Tc 6s 4d]
jaysu: checks=20
22dancerr: bets 1800
jaysu: folds=20
Uncalled bet (1800) returned to 22dancerr
22dancerr collected 3420 from pot
22dancerr: doesn't show hand=20
*** SUMMARY ***
Total pot 3420 | Rake 0=20
Board [Tc 6s 4d]
Seat 1: JJin91 folded before Flop (didn't bet)
Seat 2: CR8TVT2 folded before Flop (didn't bet)
Seat 3: CatKilla13 (button) folded before Flop (didn't bet)
Seat 4: jaysu (small blind) folded on the Flop
Seat 5: 22dancerr (big blind) collected (3420)
Seat 6: lok_dawg420 folded before Flop (didn't bet)


*********** # 56 **************
PokerStars Hand #175473899833: Tournament #1701793695, $9.10+$0.90 USD =
Hold'em No Limit - Level IX (300/600) - 2017/09/24 17:44:58 ET
Table '1701793695 7' 6-max Seat #4 is the button
Seat 1: JJin91 (39930 in chips)=20
Seat 2: CR8TVT2 (22044 in chips)=20
Seat 3: CatKilla13 (13067 in chips)=20
Seat 4: jaysu (20361 in chips)=20
Seat 5: 22dancerr (12165 in chips)=20
Seat 6: lok_dawg420 (10054 in chips)=20
JJin91: posts the ante 70
CR8TVT2: posts the ante 70
CatKilla13: posts the ante 70
jaysu: posts the ante 70
22dancerr: posts the ante 70
lok_dawg420: posts the ante 70
22dancerr: posts small blind 300
lok_dawg420: posts big blind 600
*** HOLE CARDS ***
Dealt to JJin91 [7s 9s]
JJin91: folds=20
CR8TVT2: raises 600 to 1200
CatKilla13: calls 1200
jaysu: folds=20
22dancerr: folds=20
lok_dawg420: calls 600
*** FLOP *** [2c 9d Th]
lok_dawg420: checks=20
CR8TVT2: bets 1200
CatKilla13: folds=20
lok_dawg420: calls 1200
*** TURN *** [2c 9d Th] [3c]
lok_dawg420: checks=20
CR8TVT2: checks=20
*** RIVER *** [2c 9d Th 3c] [Qs]
lok_dawg420: checks=20
CR8TVT2: checks=20
*** SHOW DOWN ***
lok_dawg420: shows [Kd Ts] (a pair of Tens)
CR8TVT2: mucks hand=20
lok_dawg420 collected 6720 from pot
*** SUMMARY ***
Total pot 6720 | Rake 0=20
Board [2c 9d Th 3c Qs]
Seat 1: JJin91 folded before Flop (didn't bet)
Seat 2: CR8TVT2 mucked [Ac Jh]
Seat 3: CatKilla13 folded on the Flop
Seat 4: jaysu (button) folded before Flop (didn't bet)
Seat 5: 22dancerr (small blind) folded before Flop
Seat 6: lok_dawg420 (big blind) showed [Kd Ts] and won (6720) with a pa=
ir of Tens


*********** # 57 **************
PokerStars Hand #175474853463: Tournament #1701793695, $9.10+$0.90 USD =
Hold'em No Limit - Level X (350/700) - 2017/09/24 17:46:12 ET
Table '1701793695 7' 6-max Seat #5 is the button
Seat 1: JJin91 (39860 in chips)=20
Seat 2: CR8TVT2 (19574 in chips)=20
Seat 3: CatKilla13 (11797 in chips)=20
Seat 4: jaysu (20291 in chips)=20
Seat 5: 22dancerr (11795 in chips)=20
Seat 6: lok_dawg420 (14304 in chips)=20
JJin91: posts the ante 85
CR8TVT2: posts the ante 85
CatKilla13: posts the ante 85
jaysu: posts the ante 85
22dancerr: posts the ante 85
lok_dawg420: posts the ante 85
lok_dawg420: posts small blind 350
JJin91: posts big blind 700
*** HOLE CARDS ***
Dealt to JJin91 [5d 4s]
CR8TVT2: folds=20
CatKilla13: folds=20
jaysu: folds=20
22dancerr: raises 1400 to 2100
lok_dawg420: folds=20
JJin91: folds=20
Uncalled bet (1400) returned to 22dancerr
22dancerr collected 2260 from pot
22dancerr: doesn't show hand=20
*** SUMMARY ***
Total pot 2260 | Rake 0=20
Seat 1: JJin91 (big blind) folded before Flop
Seat 2: CR8TVT2 folded before Flop (didn't bet)
Seat 3: CatKilla13 folded before Flop (didn't bet)
Seat 4: jaysu folded before Flop (didn't bet)
Seat 5: 22dancerr (button) collected (2260)
Seat 6: lok_dawg420 (small blind) folded before Flop


*********** # 58 **************
PokerStars Hand #175474853560: Tournament #1701793695, $9.10+$0.90 USD =
Hold'em No Limit - Level X (350/700) - 2017/09/24 17:46:38 ET
Table '1701793695 7' 6-max Seat #6 is the button
Seat 1: JJin91 (39075 in chips)=20
Seat 2: CR8TVT2 (19489 in chips)=20
Seat 3: CatKilla13 (11712 in chips)=20
Seat 4: jaysu (20206 in chips)=20
Seat 5: 22dancerr (13270 in chips)=20
Seat 6: lok_dawg420 (13869 in chips)=20
JJin91: posts the ante 85
CR8TVT2: posts the ante 85
CatKilla13: posts the ante 85
jaysu: posts the ante 85
22dancerr: posts the ante 85
lok_dawg420: posts the ante 85
JJin91: posts small blind 350
CR8TVT2: posts big blind 700
*** HOLE CARDS ***
Dealt to JJin91 [5s 4d]
CatKilla13: raises 700 to 1400
jaysu: calls 1400
22dancerr: calls 1400
lok_dawg420: folds=20
JJin91: folds=20
CR8TVT2: folds=20
*** FLOP *** [4s Th 3s]
CatKilla13: bets 10227 and is all-in
jaysu: raises 8494 to 18721 and is all-in
22dancerr: folds=20
Uncalled bet (8494) returned to jaysu
*** TURN *** [4s Th 3s] [2c]
*** RIVER *** [4s Th 3s 2c] [Jh]
*** SHOW DOWN ***
CatKilla13: shows [As 4h] (a pair of Fours)
jaysu: shows [Ah Ad] (a pair of Aces)
jaysu collected 26214 from pot
CatKilla13 finished the tournament in 485th place
*** SUMMARY ***
Total pot 26214 | Rake 0=20
Board [4s Th 3s 2c Jh]
Seat 1: JJin91 (small blind) folded before Flop
Seat 2: CR8TVT2 (big blind) folded before Flop
Seat 3: CatKilla13 showed [As 4h] and lost with a pair of Fours
Seat 4: jaysu showed [Ah Ad] and won (26214) with a pair of Aces
Seat 5: 22dancerr folded on the Flop
Seat 6: lok_dawg420 (button) folded before Flop (didn't bet)


*********** # 59 **************
PokerStars Hand #175474853779: Tournament #1701793695, $9.10+$0.90 USD =
Hold'em No Limit - Level X (350/700) - 2017/09/24 17:47:31 ET
Table '1701793695 7' 6-max Seat #1 is the button
Seat 1: JJin91 (38640 in chips)=20
Seat 2: CR8TVT2 (18704 in chips)=20
Seat 4: jaysu (34708 in chips)=20
Seat 5: 22dancerr (11785 in chips)=20
Seat 6: lok_dawg420 (13784 in chips)=20
JJin91: posts the ante 85
CR8TVT2: posts the ante 85
jaysu: posts the ante 85
22dancerr: posts the ante 85
lok_dawg420: posts the ante 85
CR8TVT2: posts small blind 350
jaysu: posts big blind 700
*** HOLE CARDS ***
Dealt to JJin91 [6d Td]
22dancerr: folds=20
lok_dawg420: folds=20
JJin91: folds=20
CatKilla13 [observer] said, "nh"
CR8TVT2: calls 350
jaysu: checks=20
*** FLOP *** [5s 4c 8h]
CR8TVT2: checks=20
jaysu: checks=20
*** TURN *** [5s 4c 8h] [Ac]
CR8TVT2: bets 1400
jaysu: folds=20
Uncalled bet (1400) returned to CR8TVT2
CR8TVT2 collected 1825 from pot
*** SUMMARY ***
Total pot 1825 | Rake 0=20
Board [5s 4c 8h Ac]
Seat 1: JJin91 (button) folded before Flop (didn't bet)
Seat 2: CR8TVT2 (small blind) collected (1825)
Seat 4: jaysu (big blind) folded on the Turn
Seat 5: 22dancerr folded before Flop (didn't bet)
Seat 6: lok_dawg420 folded before Flop (didn't bet)


*********** # 60 **************
PokerStars Hand #175474853945: Tournament #1701793695, $9.10+$0.90 USD =
Hold'em No Limit - Level X (350/700) - 2017/09/24 17:48:11 ET
Table '1701793695 7' 6-max Seat #2 is the button
Seat 1: JJin91 (38555 in chips)=20
Seat 2: CR8TVT2 (19744 in chips)=20
Seat 4: jaysu (33923 in chips)=20
Seat 5: 22dancerr (11700 in chips)=20
Seat 6: lok_dawg420 (13699 in chips)=20
JJin91: posts the ante 85
CR8TVT2: posts the ante 85
jaysu: posts the ante 85
22dancerr: posts the ante 85
lok_dawg420: posts the ante 85
jaysu: posts small blind 350
22dancerr: posts big blind 700
*** HOLE CARDS ***
Dealt to JJin91 [9h 8s]
lok_dawg420: folds=20
JJin91: folds=20
CR8TVT2: folds=20
jaysu: raises 33138 to 33838 and is all-in
22dancerr: folds=20
Uncalled bet (33138) returned to jaysu
jaysu collected 1825 from pot
jaysu: doesn't show hand=20
*** SUMMARY ***
Total pot 1825 | Rake 0=20
Seat 1: JJin91 folded before Flop (didn't bet)
Seat 2: CR8TVT2 (button) folded before Flop (didn't bet)
Seat 4: jaysu (small blind) collected (1825)
Seat 5: 22dancerr (big blind) folded before Flop
Seat 6: lok_dawg420 folded before Flop (didn't bet)


*********** # 61 **************
PokerStars Hand #175474854065: Tournament #1701793695, $9.10+$0.90 USD =
Hold'em No Limit - Level X (350/700) - 2017/09/24 17:48:38 ET
Table '1701793695 7' 6-max Seat #4 is the button
Seat 1: JJin91 (38470 in chips)=20
Seat 2: CR8TVT2 (19659 in chips)=20
Seat 4: jaysu (34963 in chips)=20
Seat 5: 22dancerr (10915 in chips)=20
Seat 6: lok_dawg420 (13614 in chips)=20
JJin91: posts the ante 85
CR8TVT2: posts the ante 85
jaysu: posts the ante 85
22dancerr: posts the ante 85
lok_dawg420: posts the ante 85
22dancerr: posts small blind 350
lok_dawg420: posts big blind 700
*** HOLE CARDS ***
Dealt to JJin91 [8s 7d]
JJin91: folds=20
CR8TVT2: folds=20
jaysu: folds=20
22dancerr: folds=20
Uncalled bet (350) returned to lok_dawg420
lok_dawg420 collected 1125 from pot
lok_dawg420: doesn't show hand=20
*** SUMMARY ***
Total pot 1125 | Rake 0=20
Seat 1: JJin91 folded before Flop (didn't bet)
Seat 2: CR8TVT2 folded before Flop (didn't bet)
Seat 4: jaysu (button) folded before Flop (didn't bet)
Seat 5: 22dancerr (small blind) folded before Flop
Seat 6: lok_dawg420 (big blind) collected (1125)


*********** # 62 **************
PokerStars Hand #175474854135: Tournament #1701793695, $9.10+$0.90 USD =
Hold'em No Limit - Level X (350/700) - 2017/09/24 17:48:55 ET
Table '1701793695 7' 6-max Seat #5 is the button
Seat 1: JJin91 (38385 in chips)=20
Seat 2: CR8TVT2 (19574 in chips)=20
Seat 3: PokerPayman (20000 in chips)=20
Seat 4: jaysu (34878 in chips)=20
Seat 5: 22dancerr (10480 in chips)=20
Seat 6: lok_dawg420 (14304 in chips)=20
JJin91: posts the ante 85
CR8TVT2: posts the ante 85
PokerPayman: posts the ante 85
jaysu: posts the ante 85
22dancerr: posts the ante 85
lok_dawg420: posts the ante 85
lok_dawg420: posts small blind 350
JJin91: posts big blind 700
*** HOLE CARDS ***
Dealt to JJin91 [Qc Tc]
CR8TVT2: folds=20
PokerPayman: raises 700 to 1400
jaysu: folds=20
22dancerr: raises 8995 to 10395 and is all-in
lok_dawg420: folds=20
JJin91: folds=20
PokerPayman: calls 8995
*** FLOP *** [Kd 7h Ah]
*** TURN *** [Kd 7h Ah] [8h]
*** RIVER *** [Kd 7h Ah 8h] [7s]
*** SHOW DOWN ***
PokerPayman: shows [Ac Ad] (a full house, Aces full of Sevens)
22dancerr: shows [8c Ks] (two pair, Kings and Eights)
PokerPayman collected 22350 from pot
22dancerr finished the tournament in 479th place
*** SUMMARY ***
Total pot 22350 | Rake 0=20
Board [Kd 7h Ah 8h 7s]
Seat 1: JJin91 (big blind) folded before Flop
Seat 2: CR8TVT2 folded before Flop (didn't bet)
Seat 3: PokerPayman showed [Ac Ad] and won (22350) with a full house, A=
ces full of Sevens
Seat 4: jaysu folded before Flop (didn't bet)
Seat 5: 22dancerr (button) showed [8c Ks] and lost with two pair, Kings=
 and Eights
Seat 6: lok_dawg420 (small blind) folded before Flop


*********** # 63 **************
PokerStars Hand #175474854313: Tournament #1701793695, $9.10+$0.90 USD =
Hold'em No Limit - Level X (350/700) - 2017/09/24 17:49:38 ET
Table '1701793695 7' 6-max Seat #6 is the button
Seat 1: JJin91 (37600 in chips)=20
Seat 2: CR8TVT2 (19489 in chips)=20
Seat 3: PokerPayman (31870 in chips)=20
Seat 4: jaysu (34793 in chips)=20
Seat 6: lok_dawg420 (13869 in chips)=20
JJin91: posts the ante 85
CR8TVT2: posts the ante 85
PokerPayman: posts the ante 85
jaysu: posts the ante 85
lok_dawg420: posts the ante 85
JJin91: posts small blind 350
CR8TVT2: posts big blind 700
*** HOLE CARDS ***
Dealt to JJin91 [Ts Ah]
PokerPayman: folds=20
jaysu: folds=20
lok_dawg420: folds=20
JJin91: raises 1057 to 1757
CR8TVT2: folds=20
Uncalled bet (1057) returned to JJin91
JJin91 collected 1825 from pot
JJin91: doesn't show hand=20
*** SUMMARY ***
Total pot 1825 | Rake 0=20
Seat 1: JJin91 (small blind) collected (1825)
Seat 2: CR8TVT2 (big blind) folded before Flop
Seat 3: PokerPayman folded before Flop (didn't bet)
Seat 4: jaysu folded before Flop (didn't bet)
Seat 6: lok_dawg420 (button) folded before Flop (didn't bet)


*********** # 64 **************
PokerStars Hand #175474854766: Tournament #1701793695, $9.10+$0.90 USD =
Hold'em No Limit - Level XI (400/800) - 2017/09/24 17:51:16 ET
Table '1701793695 7' 6-max Seat #1 is the button
Seat 1: JJin91 (38640 in chips)=20
Seat 2: CR8TVT2 (18704 in chips)=20
Seat 3: PokerPayman (31785 in chips)=20
Seat 4: jaysu (34708 in chips)=20
Seat 5: WhiteIce0328 (20000 in chips)=20
Seat 6: lok_dawg420 (13784 in chips)=20
JJin91: posts the ante 100
CR8TVT2: posts the ante 100
PokerPayman: posts the ante 100
jaysu: posts the ante 100
WhiteIce0328: posts the ante 100
lok_dawg420: posts the ante 100
CR8TVT2: posts small blind 400
PokerPayman: posts big blind 800
*** HOLE CARDS ***
Dealt to JJin91 [2c Ks]
jaysu: raises 950 to 1750
WhiteIce0328: calls 1750
lok_dawg420: folds=20
JJin91: folds=20
CR8TVT2: folds=20
PokerPayman: folds=20
*** FLOP *** [9s Td 9d]
jaysu: bets 2175
WhiteIce0328: calls 2175
*** TURN *** [9s Td 9d] [2d]
jaysu: checks=20
WhiteIce0328: bets 4825
jaysu: raises 25858 to 30683 and is all-in
WhiteIce0328: calls 11150 and is all-in
Uncalled bet (14708) returned to jaysu
*** RIVER *** [9s Td 9d 2d] [3c]
*** SHOW DOWN ***
jaysu: shows [Th Qh] (two pair, Tens and Nines)
WhiteIce0328: shows [Ad Qd] (a flush, Ace high)
WhiteIce0328 collected 41600 from pot
*** SUMMARY ***
Total pot 41600 | Rake 0=20
Board [9s Td 9d 2d 3c]
Seat 1: JJin91 (button) folded before Flop (didn't bet)
Seat 2: CR8TVT2 (small blind) folded before Flop
Seat 3: PokerPayman (big blind) folded before Flop
Seat 4: jaysu showed [Th Qh] and lost with two pair, Tens and Nines
Seat 5: WhiteIce0328 showed [Ad Qd] and won (41600) with a flush, Ace h=
igh
Seat 6: lok_dawg420 folded before Flop (didn't bet)


*********** # 65 **************
PokerStars Hand #175474855091: Tournament #1701793695, $9.10+$0.90 USD =
Hold'em No Limit - Level XI (400/800) - 2017/09/24 17:52:39 ET
Table '1701793695 7' 6-max Seat #2 is the button
Seat 1: JJin91 (38540 in chips)=20
Seat 2: CR8TVT2 (18204 in chips)=20
Seat 3: PokerPayman (30885 in chips)=20
Seat 4: jaysu (14708 in chips)=20
Seat 5: WhiteIce0328 (41600 in chips)=20
Seat 6: lok_dawg420 (13684 in chips)=20
JJin91: posts the ante 100
CR8TVT2: posts the ante 100
PokerPayman: posts the ante 100
jaysu: posts the ante 100
WhiteIce0328: posts the ante 100
lok_dawg420: posts the ante 100
PokerPayman: posts small blind 400
jaysu: posts big blind 800
*** HOLE CARDS ***
Dealt to JJin91 [Kc 3c]
WhiteIce0328: folds=20
lok_dawg420: folds=20
JJin91: raises 936 to 1736
CR8TVT2: folds=20
PokerPayman: folds=20
jaysu: calls 936
*** FLOP *** [Ah 2d 7d]
jaysu: checks=20
JJin91: bets 2111
jaysu: folds=20
Uncalled bet (2111) returned to JJin91
JJin91 collected 4472 from pot
JJin91: doesn't show hand=20
*** SUMMARY ***
Total pot 4472 | Rake 0=20
Board [Ah 2d 7d]
Seat 1: JJin91 collected (4472)
Seat 2: CR8TVT2 (button) folded before Flop (didn't bet)
Seat 3: PokerPayman (small blind) folded before Flop
Seat 4: jaysu (big blind) folded on the Flop
Seat 5: WhiteIce0328 folded before Flop (didn't bet)
Seat 6: lok_dawg420 folded before Flop (didn't bet)


*********** # 66 **************
PokerStars Hand #175474855248: Tournament #1701793695, $9.10+$0.90 USD =
Hold'em No Limit - Level XI (400/800) - 2017/09/24 17:53:16 ET
Table '1701793695 7' 6-max Seat #3 is the button
Seat 1: JJin91 (41176 in chips)=20
Seat 2: CR8TVT2 (18104 in chips)=20
Seat 3: PokerPayman (30385 in chips)=20
Seat 4: jaysu (12872 in chips)=20
Seat 5: WhiteIce0328 (41500 in chips)=20
Seat 6: lok_dawg420 (13584 in chips)=20
JJin91: posts the ante 100
CR8TVT2: posts the ante 100
PokerPayman: posts the ante 100
jaysu: posts the ante 100
WhiteIce0328: posts the ante 100
lok_dawg420: posts the ante 100
jaysu: posts small blind 400
WhiteIce0328: posts big blind 800
*** HOLE CARDS ***
Dealt to JJin91 [Qd 8d]
lok_dawg420: folds=20
JJin91: folds=20
CR8TVT2: calls 800
PokerPayman: folds=20
jaysu: folds=20
WhiteIce0328: checks=20
*** FLOP *** [Jd Ks Th]
WhiteIce0328: checks=20
CR8TVT2: bets 1600
WhiteIce0328: folds=20
Uncalled bet (1600) returned to CR8TVT2
CR8TVT2 collected 2600 from pot
*** SUMMARY ***
Total pot 2600 | Rake 0=20
Board [Jd Ks Th]
Seat 1: JJin91 folded before Flop (didn't bet)
Seat 2: CR8TVT2 collected (2600)
Seat 3: PokerPayman (button) folded before Flop (didn't bet)
Seat 4: jaysu (small blind) folded before Flop
Seat 5: WhiteIce0328 (big blind) folded on the Flop
Seat 6: lok_dawg420 folded before Flop (didn't bet)


*********** # 67 **************
PokerStars Hand #175474855357: Tournament #1701793695, $9.10+$0.90 USD =
Hold'em No Limit - Level XI (400/800) - 2017/09/24 17:53:42 ET
Table '1701793695 7' 6-max Seat #4 is the button
Seat 1: JJin91 (41076 in chips)=20
Seat 2: CR8TVT2 (19804 in chips)=20
Seat 3: PokerPayman (30285 in chips)=20
Seat 4: jaysu (12372 in chips)=20
Seat 5: WhiteIce0328 (40600 in chips)=20
Seat 6: lok_dawg420 (13484 in chips)=20
JJin91: posts the ante 100
CR8TVT2: posts the ante 100
PokerPayman: posts the ante 100
jaysu: posts the ante 100
WhiteIce0328: posts the ante 100
lok_dawg420: posts the ante 100
WhiteIce0328: posts small blind 400
lok_dawg420: posts big blind 800
*** HOLE CARDS ***
Dealt to JJin91 [Ah 9d]
JJin91: raises 936 to 1736
CR8TVT2: folds=20
PokerPayman: folds=20
jaysu: folds=20
WhiteIce0328: folds=20
lok_dawg420: folds=20
Uncalled bet (936) returned to JJin91
JJin91 collected 2600 from pot
JJin91: doesn't show hand=20
*** SUMMARY ***
Total pot 2600 | Rake 0=20
Seat 1: JJin91 collected (2600)
Seat 2: CR8TVT2 folded before Flop (didn't bet)
Seat 3: PokerPayman folded before Flop (didn't bet)
Seat 4: jaysu (button) folded before Flop (didn't bet)
Seat 5: WhiteIce0328 (small blind) folded before Flop
Seat 6: lok_dawg420 (big blind) folded before Flop


*********** # 68 **************
PokerStars Hand #175474855479: Tournament #1701793695, $9.10+$0.90 USD =
Hold'em No Limit - Level XI (400/800) - 2017/09/24 17:54:10 ET
Table '1701793695 7' 6-max Seat #5 is the button
Seat 1: JJin91 (42776 in chips)=20
Seat 2: CR8TVT2 (19704 in chips)=20
Seat 3: PokerPayman (30185 in chips)=20
Seat 4: jaysu (12272 in chips)=20
Seat 5: WhiteIce0328 (40100 in chips)=20
Seat 6: lok_dawg420 (12584 in chips)=20
JJin91: posts the ante 100
CR8TVT2: posts the ante 100
PokerPayman: posts the ante 100
jaysu: posts the ante 100
WhiteIce0328: posts the ante 100
lok_dawg420: posts the ante 100
lok_dawg420: posts small blind 400
JJin91: posts big blind 800
*** HOLE CARDS ***
Dealt to JJin91 [Qd As]
CR8TVT2: calls 800
PokerPayman: calls 800
jaysu: folds=20
WhiteIce0328: folds=20
lok_dawg420: folds=20
JJin91: raises 2088 to 2888
CR8TVT2: calls 2088
PokerPayman: calls 2088
*** FLOP *** [8c Qs 5c]
JJin91: checks=20
CR8TVT2: checks=20
PokerPayman: bets 27197 and is all-in
JJin91: raises 12591 to 39788 and is all-in
CR8TVT2: folds=20
Uncalled bet (12591) returned to JJin91
*** TURN *** [8c Qs 5c] [Ah]
*** RIVER *** [8c Qs 5c Ah] [6s]
*** SHOW DOWN ***
JJin91: shows [Qd As] (two pair, Aces and Queens)
PokerPayman: shows [Tc 4c] (high card Ace)
JJin91 collected 64058 from pot
PokerPayman finished the tournament in 462nd place
*** SUMMARY ***
Total pot 64058 | Rake 0=20
Board [8c Qs 5c Ah 6s]
Seat 1: JJin91 (big blind) showed [Qd As] and won (64058) with two pair=
, Aces and Queens
Seat 2: CR8TVT2 folded on the Flop
Seat 3: PokerPayman showed [Tc 4c] and lost with high card Ace
Seat 4: jaysu folded before Flop (didn't bet)
Seat 5: WhiteIce0328 (button) folded before Flop (didn't bet)
Seat 6: lok_dawg420 (small blind) folded before Flop


*********** # 69 **************
PokerStars Hand #175474856987: Tournament #1701793695, $9.10+$0.90 USD =
Hold'em No Limit - Level XI (400/800) - 2017/09/24 18:01:21 ET
Table '1701793695 7' 6-max Seat #6 is the button
Seat 1: JJin91 (76649 in chips)=20
Seat 2: CR8TVT2 (16716 in chips)=20
Seat 3: PokerPayman (20000 in chips)=20
Seat 4: jaysu (12172 in chips)=20
Seat 5: WhiteIce0328 (40000 in chips)=20
Seat 6: lok_dawg420 (12084 in chips)=20
JJin91: posts the ante 100
CR8TVT2: posts the ante 100
PokerPayman: posts the ante 100
jaysu: posts the ante 100
WhiteIce0328: posts the ante 100
lok_dawg420: posts the ante 100
JJin91: posts small blind 400
CR8TVT2: posts big blind 800
*** HOLE CARDS ***
Dealt to JJin91 [4d Qc]
PokerPayman: folds=20
jaysu: raises 888 to 1688
WhiteIce0328: folds=20
lok_dawg420: folds=20
JJin91: folds=20
CR8TVT2: folds=20
Uncalled bet (888) returned to jaysu
jaysu collected 2600 from pot
jaysu: doesn't show hand=20
*** SUMMARY ***
Total pot 2600 | Rake 0=20
Seat 1: JJin91 (small blind) folded before Flop
Seat 2: CR8TVT2 (big blind) folded before Flop
Seat 3: PokerPayman folded before Flop (didn't bet)
Seat 4: jaysu collected (2600)
Seat 5: WhiteIce0328 folded before Flop (didn't bet)
Seat 6: lok_dawg420 (button) folded before Flop (didn't bet)


*********** # 70 **************
PokerStars Hand #175474857103: Tournament #1701793695, $9.10+$0.90 USD =
Hold'em No Limit - Level XI (400/800) - 2017/09/24 18:01:43 ET
Table '1701793695 7' 6-max Seat #1 is the button
Seat 1: JJin91 (76149 in chips)=20
Seat 2: CR8TVT2 (15816 in chips)=20
Seat 3: PokerPayman (19900 in chips)=20
Seat 4: jaysu (13872 in chips)=20
Seat 5: WhiteIce0328 (39900 in chips)=20
Seat 6: lok_dawg420 (11984 in chips)=20
JJin91: posts the ante 100
CR8TVT2: posts the ante 100
PokerPayman: posts the ante 100
jaysu: posts the ante 100
WhiteIce0328: posts the ante 100
lok_dawg420: posts the ante 100
CR8TVT2: posts small blind 400
PokerPayman: posts big blind 800
*** HOLE CARDS ***
Dealt to JJin91 [3h Th]
jaysu: folds=20
WhiteIce0328: folds=20
lok_dawg420: calls 800
JJin91: folds=20
CR8TVT2: calls 400
PokerPayman: raises 1600 to 2400
lok_dawg420: folds=20
CR8TVT2: folds=20
Uncalled bet (1600) returned to PokerPayman
PokerPayman collected 3000 from pot
PokerPayman: doesn't show hand=20
*** SUMMARY ***
Total pot 3000 | Rake 0=20
Seat 1: JJin91 (button) folded before Flop (didn't bet)
Seat 2: CR8TVT2 (small blind) folded before Flop
Seat 3: PokerPayman (big blind) collected (3000)
Seat 4: jaysu folded before Flop (didn't bet)
Seat 5: WhiteIce0328 folded before Flop (didn't bet)
Seat 6: lok_dawg420 folded before Flop


*********** # 71 **************
PokerStars Hand #175474857325: Tournament #1701793695, $9.10+$0.90 USD =
Hold'em No Limit - Level XI (400/800) - 2017/09/24 18:02:28 ET
Table '1701793695 7' 6-max Seat #2 is the button
Seat 1: JJin91 (76049 in chips)=20
Seat 2: CR8TVT2 (14916 in chips)=20
Seat 3: PokerPayman (22000 in chips)=20
Seat 4: jaysu (13772 in chips)=20
Seat 5: WhiteIce0328 (39800 in chips)=20
Seat 6: lok_dawg420 (11084 in chips)=20
JJin91: posts the ante 100
CR8TVT2: posts the ante 100
PokerPayman: posts the ante 100
jaysu: posts the ante 100
WhiteIce0328: posts the ante 100
lok_dawg420: posts the ante 100
PokerPayman: posts small blind 400
jaysu: posts big blind 800
*** HOLE CARDS ***
Dealt to JJin91 [5s 5d]
WhiteIce0328: raises 1600 to 2400
lok_dawg420: folds=20
JJin91: folds=20
CR8TVT2: folds=20
PokerPayman: folds=20
jaysu: folds=20
Uncalled bet (1600) returned to WhiteIce0328
WhiteIce0328 collected 2600 from pot
WhiteIce0328: doesn't show hand=20
*** SUMMARY ***
Total pot 2600 | Rake 0=20
Seat 1: JJin91 folded before Flop (didn't bet)
Seat 2: CR8TVT2 (button) folded before Flop (didn't bet)
Seat 3: PokerPayman (small blind) folded before Flop
Seat 4: jaysu (big blind) folded before Flop
Seat 5: WhiteIce0328 collected (2600)
Seat 6: lok_dawg420 folded before Flop (didn't bet)


*********** # 72 **************
PokerStars Hand #175474857537: Tournament #1701793695, $9.10+$0.90 USD =
Hold'em No Limit - Level XI (400/800) - 2017/09/24 18:03:09 ET
Table '1701793695 7' 6-max Seat #3 is the button
Seat 1: JJin91 (75949 in chips)=20
Seat 2: CR8TVT2 (14816 in chips)=20
Seat 3: PokerPayman (21500 in chips)=20
Seat 4: jaysu (12872 in chips)=20
Seat 5: WhiteIce0328 (41500 in chips)=20
Seat 6: lok_dawg420 (10984 in chips)=20
JJin91: posts the ante 100
CR8TVT2: posts the ante 100
PokerPayman: posts the ante 100
jaysu: posts the ante 100
WhiteIce0328: posts the ante 100
lok_dawg420: posts the ante 100
jaysu: posts small blind 400
WhiteIce0328: posts big blind 800
*** HOLE CARDS ***
Dealt to JJin91 [9c 4d]
lok_dawg420: calls 800
JJin91: folds=20
CR8TVT2: folds=20
PokerPayman: raises 20600 to 21400 and is all-in
jaysu: folds=20
WhiteIce0328: raises 20000 to 41400 and is all-in
lok_dawg420: folds=20
Uncalled bet (20000) returned to WhiteIce0328
*** FLOP *** [Jh 9d 3s]
*** TURN *** [Jh 9d 3s] [Kc]
*** RIVER *** [Jh 9d 3s Kc] [Jc]
*** SHOW DOWN ***
WhiteIce0328: shows [Kd Ad] (two pair, Kings and Jacks)
PokerPayman: shows [As 7c] (a pair of Jacks)
WhiteIce0328 collected 44600 from pot
PokerPayman finished the tournament in 458th place
*** SUMMARY ***
Total pot 44600 | Rake 0=20
Board [Jh 9d 3s Kc Jc]
Seat 1: JJin91 folded before Flop (didn't bet)
Seat 2: CR8TVT2 folded before Flop (didn't bet)
Seat 3: PokerPayman (button) showed [As 7c] and lost with a pair of Jac=
ks
Seat 4: jaysu (small blind) folded before Flop
Seat 5: WhiteIce0328 (big blind) showed [Kd Ad] and won (44600) with tw=
o pair, Kings and Jacks
Seat 6: lok_dawg420 folded before Flop


*********** # 73 **************
PokerStars Hand #175474857743: Tournament #1701793695, $9.10+$0.90 USD =
Hold'em No Limit - Level XI (400/800) - 2017/09/24 18:03:49 ET
Table '1701793695 7' 6-max Seat #4 is the button
Seat 1: JJin91 (75849 in chips)=20
Seat 2: CR8TVT2 (14716 in chips)=20
Seat 4: jaysu (12372 in chips)=20
Seat 5: WhiteIce0328 (64600 in chips)=20
Seat 6: lok_dawg420 (10084 in chips)=20
JJin91: posts the ante 100
CR8TVT2: posts the ante 100
jaysu: posts the ante 100
WhiteIce0328: posts the ante 100
lok_dawg420: posts the ante 100
WhiteIce0328: posts small blind 400
lok_dawg420: posts big blind 800
*** HOLE CARDS ***
Dealt to JJin91 [9s Qc]
JJin91: folds=20
CR8TVT2: folds=20
jaysu: raises 888 to 1688
WhiteIce0328: folds=20
lok_dawg420: folds=20
Uncalled bet (888) returned to jaysu
jaysu collected 2500 from pot
jaysu: doesn't show hand=20
*** SUMMARY ***
Total pot 2500 | Rake 0=20
Seat 1: JJin91 folded before Flop (didn't bet)
Seat 2: CR8TVT2 folded before Flop (didn't bet)
Seat 4: jaysu (button) collected (2500)
Seat 5: WhiteIce0328 (small blind) folded before Flop
Seat 6: lok_dawg420 (big blind) folded before Flop


*********** # 74 **************
PokerStars Hand #175474857869: Tournament #1701793695, $9.10+$0.90 USD =
Hold'em No Limit - Level XI (400/800) - 2017/09/24 18:04:17 ET
Table '1701793695 7' 6-max Seat #5 is the button
Seat 1: JJin91 (75749 in chips)=20
Seat 2: CR8TVT2 (14616 in chips)=20
Seat 4: jaysu (13972 in chips)=20
Seat 5: WhiteIce0328 (64100 in chips)=20
Seat 6: lok_dawg420 (9184 in chips)=20
JJin91: posts the ante 100
CR8TVT2: posts the ante 100
jaysu: posts the ante 100
WhiteIce0328: posts the ante 100
lok_dawg420: posts the ante 100
lok_dawg420: posts small blind 400
JJin91: posts big blind 800
*** HOLE CARDS ***
Dealt to JJin91 [Js Ad]
CR8TVT2: folds=20
jaysu: raises 13072 to 13872 and is all-in
WhiteIce0328: folds=20
lok_dawg420: folds=20
JJin91: calls 13072
*** FLOP *** [9h 8s Ac]
*** TURN *** [9h 8s Ac] [9c]
*** RIVER *** [9h 8s Ac 9c] [8d]
*** SHOW DOWN ***
JJin91: shows [Js Ad] (two pair, Aces and Nines)
jaysu: shows [As 7c] (two pair, Aces and Nines - lower kicker)
JJin91 collected 28644 from pot
jaysu finished the tournament in 455th place
*** SUMMARY ***
Total pot 28644 | Rake 0=20
Board [9h 8s Ac 9c 8d]
Seat 1: JJin91 (big blind) showed [Js Ad] and won (28644) with two pair=
, Aces and Nines
Seat 2: CR8TVT2 folded before Flop (didn't bet)
Seat 4: jaysu showed [As 7c] and lost with two pair, Aces and Nines
Seat 5: WhiteIce0328 (button) folded before Flop (didn't bet)
Seat 6: lok_dawg420 (small blind) folded before Flop


*********** # 75 **************
PokerStars Hand #175474858071: Tournament #1701793695, $9.10+$0.90 USD =
Hold'em No Limit - Level XII (500/1000) - 2017/09/24 18:05:00 ET
Table '1701793695 7' 6-max Seat #6 is the button
Seat 1: JJin91 (90421 in chips)=20
Seat 3: @Bud_Fox0000 (20000 in chips)=20
Seat 5: WhiteIce0328 (64000 in chips)=20
Seat 6: lok_dawg420 (8684 in chips)=20
JJin91: posts the ante 125
@Bud_Fox0000: posts the ante 125
WhiteIce0328: posts the ante 125
lok_dawg420: posts the ante 125
JJin91: posts small blind 500
@Bud_Fox0000: posts big blind 1000
*** HOLE CARDS ***
Dealt to JJin91 [3s Qc]
WhiteIce0328: folds=20
lok_dawg420: folds=20
JJin91: folds=20
Uncalled bet (500) returned to @Bud_Fox0000
@Bud_Fox0000 collected 1500 from pot
*** SUMMARY ***
Total pot 1500 | Rake 0=20
Seat 1: JJin91 (small blind) folded before Flop
Seat 3: @Bud_Fox0000 (big blind) collected (1500)
Seat 5: WhiteIce0328 folded before Flop (didn't bet)
Seat 6: lok_dawg420 (button) folded before Flop (didn't bet)


*********** # 76 **************
PokerStars Hand #175474858196: Tournament #1701793695, $9.10+$0.90 USD =
Hold'em No Limit - Level XII (500/1000) - 2017/09/24 18:05:26 ET
Table '1701793695 7' 6-max Seat #1 is the button
Seat 1: JJin91 (89796 in chips)=20
Seat 3: @Bud_Fox0000 (20875 in chips)=20
Seat 4: StephGod30 (19980 in chips)=20
Seat 5: WhiteIce0328 (63875 in chips)=20
Seat 6: lok_dawg420 (8559 in chips)=20
JJin91: posts the ante 125
@Bud_Fox0000: posts the ante 125
StephGod30: posts the ante 125
WhiteIce0328: posts the ante 125
lok_dawg420: posts the ante 125
@Bud_Fox0000: posts small blind 500
StephGod30: posts big blind 1000
*** HOLE CARDS ***
Dealt to JJin91 [2h 3d]
WhiteIce0328: folds=20
lok_dawg420: folds=20
JJin91: folds=20
@Bud_Fox0000: calls 500
StephGod30: checks=20
*** FLOP *** [Qd Qc 7h]
@Bud_Fox0000: checks=20
StephGod30: bets 1000
@Bud_Fox0000: folds=20
Uncalled bet (1000) returned to StephGod30
StephGod30 collected 2625 from pot
StephGod30: doesn't show hand=20
*** SUMMARY ***
Total pot 2625 | Rake 0=20
Board [Qd Qc 7h]
Seat 1: JJin91 (button) folded before Flop (didn't bet)
Seat 3: @Bud_Fox0000 (small blind) folded on the Flop
Seat 4: StephGod30 (big blind) collected (2625)
Seat 5: WhiteIce0328 folded before Flop (didn't bet)
Seat 6: lok_dawg420 folded before Flop (didn't bet)


*********** # 77 **************
PokerStars Hand #175474858462: Tournament #1701793695, $9.10+$0.90 USD =
Hold'em No Limit - Level XII (500/1000) - 2017/09/24 18:06:19 ET
Table '1701793695 7' 6-max Seat #3 is the button
Seat 1: JJin91 (89671 in chips)=20
Seat 2: N0InBetween (20000 in chips)=20
Seat 3: @Bud_Fox0000 (19750 in chips)=20
Seat 4: StephGod30 (21480 in chips)=20
Seat 5: WhiteIce0328 (63750 in chips)=20
Seat 6: lok_dawg420 (8434 in chips)=20
JJin91: posts the ante 125
N0InBetween: posts the ante 125
@Bud_Fox0000: posts the ante 125
StephGod30: posts the ante 125
WhiteIce0328: posts the ante 125
lok_dawg420: posts the ante 125
StephGod30: posts small blind 500
WhiteIce0328: posts big blind 1000
*** HOLE CARDS ***
Dealt to JJin91 [Qh 5s]
lok_dawg420: raises 7309 to 8309 and is all-in
JJin91: folds=20
N0InBetween: folds=20
@Bud_Fox0000: folds=20
StephGod30: folds=20
WhiteIce0328: calls 7309
*** FLOP *** [4h 8d 8h]
*** TURN *** [4h 8d 8h] [6h]
*** RIVER *** [4h 8d 8h 6h] [4c]
*** SHOW DOWN ***
WhiteIce0328: shows [8c Kc] (a full house, Eights full of Fours)
lok_dawg420: shows [Ad 6d] (two pair, Eights and Sixes)
WhiteIce0328 collected 17868 from pot
lok_dawg420 finished the tournament in 443rd place
*** SUMMARY ***
Total pot 17868 | Rake 0=20
Board [4h 8d 8h 6h 4c]
Seat 1: JJin91 folded before Flop (didn't bet)
Seat 2: N0InBetween folded before Flop (didn't bet)
Seat 3: @Bud_Fox0000 (button) folded before Flop (didn't bet)
Seat 4: StephGod30 (small blind) folded before Flop
Seat 5: WhiteIce0328 (big blind) showed [8c Kc] and won (17868) with a =
full house, Eights full of Fours
Seat 6: lok_dawg420 showed [Ad 6d] and lost with two pair, Eights and S=
ixes


*********** # 78 **************
PokerStars Hand #175474858591: Tournament #1701793695, $9.10+$0.90 USD =
Hold'em No Limit - Level XII (500/1000) - 2017/09/24 18:06:48 ET
Table '1701793695 7' 6-max Seat #4 is the button
Seat 1: JJin91 (89546 in chips)=20
Seat 2: N0InBetween (19875 in chips)=20
Seat 3: @Bud_Fox0000 (19625 in chips)=20
Seat 4: StephGod30 (20855 in chips)=20
Seat 5: WhiteIce0328 (73184 in chips)=20
JJin91: posts the ante 125
N0InBetween: posts the ante 125
@Bud_Fox0000: posts the ante 125
StephGod30: posts the ante 125
WhiteIce0328: posts the ante 125
WhiteIce0328: posts small blind 500
JJin91: posts big blind 1000
*** HOLE CARDS ***
Dealt to JJin91 [6s 5d]
N0InBetween: folds=20
@Bud_Fox0000: raises 1075 to 2075
StephGod30: folds=20
WhiteIce0328: calls 1575
JJin91: folds=20
*** FLOP *** [Jd 6h Kh]
WhiteIce0328: checks=20
@Bud_Fox0000: bets 3255
WhiteIce0328: calls 3255
*** TURN *** [Jd 6h Kh] [Ks]
WhiteIce0328: checks=20
@Bud_Fox0000: bets 5900
WhiteIce0328: calls 5900
*** RIVER *** [Jd 6h Kh Ks] [Th]
WhiteIce0328: checks=20
@Bud_Fox0000: bets 8270 and is all-in
WhiteIce0328: folds=20
Uncalled bet (8270) returned to @Bud_Fox0000
@Bud_Fox0000 collected 24085 from pot
*** SUMMARY ***
Total pot 24085 | Rake 0=20
Board [Jd 6h Kh Ks Th]
Seat 1: JJin91 (big blind) folded before Flop
Seat 2: N0InBetween folded before Flop (didn't bet)
Seat 3: @Bud_Fox0000 collected (24085)
Seat 4: StephGod30 (button) folded before Flop (didn't bet)
Seat 5: WhiteIce0328 (small blind) folded on the River


*********** # 79 **************
PokerStars Hand #175474858799: Tournament #1701793695, $9.10+$0.90 USD =
Hold'em No Limit - Level XII (500/1000) - 2017/09/24 18:07:30 ET
Table '1701793695 7' 6-max Seat #5 is the button
Seat 1: JJin91 (88421 in chips)=20
Seat 2: N0InBetween (19750 in chips)=20
Seat 3: @Bud_Fox0000 (32355 in chips)=20
Seat 4: StephGod30 (20730 in chips)=20
Seat 5: WhiteIce0328 (61829 in chips)=20
Seat 6: nwmdnj (20000 in chips) out of hand (moved from another table i=
nto small blind)
JJin91: posts the ante 125
N0InBetween: posts the ante 125
@Bud_Fox0000: posts the ante 125
StephGod30: posts the ante 125
WhiteIce0328: posts the ante 125
JJin91: posts small blind 500
N0InBetween: posts big blind 1000
*** HOLE CARDS ***
Dealt to JJin91 [5s 7c]
@Bud_Fox0000: calls 1000
StephGod30: folds=20
WhiteIce0328: folds=20
JJin91: folds=20
N0InBetween: checks=20
*** FLOP *** [3c Ts Th]
N0InBetween: checks=20
@Bud_Fox0000: bets 1800
N0InBetween: folds=20
Uncalled bet (1800) returned to @Bud_Fox0000
@Bud_Fox0000 collected 3125 from pot
*** SUMMARY ***
Total pot 3125 | Rake 0=20
Board [3c Ts Th]
Seat 1: JJin91 (small blind) folded before Flop
Seat 2: N0InBetween (big blind) folded on the Flop
Seat 3: @Bud_Fox0000 collected (3125)
Seat 4: StephGod30 folded before Flop (didn't bet)
Seat 5: WhiteIce0328 (button) folded before Flop (didn't bet)


*********** # 80 **************
PokerStars Hand #175474858924: Tournament #1701793695, $9.10+$0.90 USD =
Hold'em No Limit - Level XII (500/1000) - 2017/09/24 18:07:53 ET
Table '1701793695 7' 6-max Seat #1 is the button
Seat 1: JJin91 (87796 in chips)=20
Seat 2: N0InBetween (18625 in chips)=20
Seat 3: @Bud_Fox0000 (34355 in chips)=20
Seat 4: StephGod30 (20605 in chips)=20
Seat 5: WhiteIce0328 (61704 in chips)=20
Seat 6: nwmdnj (20000 in chips)=20
JJin91: posts the ante 125
N0InBetween: posts the ante 125
@Bud_Fox0000: posts the ante 125
StephGod30: posts the ante 125
WhiteIce0328: posts the ante 125
nwmdnj: posts the ante 125
N0InBetween: posts small blind 500
@Bud_Fox0000: posts big blind 1000
*** HOLE CARDS ***
Dealt to JJin91 [5d 5c]
StephGod30: folds=20
WhiteIce0328: folds=20
nwmdnj: folds=20
JJin91: raises 1170 to 2170
N0InBetween: folds=20
@Bud_Fox0000: folds=20
Uncalled bet (1170) returned to JJin91
JJin91 collected 3250 from pot
JJin91: doesn't show hand=20
*** SUMMARY ***
Total pot 3250 | Rake 0=20
Seat 1: JJin91 (button) collected (3250)
Seat 2: N0InBetween (small blind) folded before Flop
Seat 3: @Bud_Fox0000 (big blind) folded before Flop
Seat 4: StephGod30 folded before Flop (didn't bet)
Seat 5: WhiteIce0328 folded before Flop (didn't bet)
Seat 6: nwmdnj folded before Flop (didn't bet)


*********** # 81 **************
PokerStars Hand #175474859050: Tournament #1701793695, $9.10+$0.90 USD =
Hold'em No Limit - Level XII (500/1000) - 2017/09/24 18:08:19 ET
Table '1701793695 7' 6-max Seat #2 is the button
Seat 1: JJin91 (89921 in chips)=20
Seat 2: N0InBetween (18000 in chips)=20
Seat 3: @Bud_Fox0000 (33230 in chips)=20
Seat 4: StephGod30 (20480 in chips)=20
Seat 5: WhiteIce0328 (61579 in chips)=20
Seat 6: nwmdnj (19875 in chips)=20
JJin91: posts the ante 125
N0InBetween: posts the ante 125
@Bud_Fox0000: posts the ante 125
StephGod30: posts the ante 125
WhiteIce0328: posts the ante 125
nwmdnj: posts the ante 125
@Bud_Fox0000: posts small blind 500
StephGod30: posts big blind 1000
*** HOLE CARDS ***
Dealt to JJin91 [Js Ts]
WhiteIce0328: folds=20
nwmdnj: folds=20
JJin91: raises 1170 to 2170
N0InBetween: folds=20
@Bud_Fox0000: folds=20
StephGod30: folds=20
Uncalled bet (1170) returned to JJin91
JJin91 collected 3250 from pot
JJin91: doesn't show hand=20
*** SUMMARY ***
Total pot 3250 | Rake 0=20
Seat 1: JJin91 collected (3250)
Seat 2: N0InBetween (button) folded before Flop (didn't bet)
Seat 3: @Bud_Fox0000 (small blind) folded before Flop
Seat 4: StephGod30 (big blind) folded before Flop
Seat 5: WhiteIce0328 folded before Flop (didn't bet)
Seat 6: nwmdnj folded before Flop (didn't bet)


*********** # 82 **************
PokerStars Hand #175474859164: Tournament #1701793695, $9.10+$0.90 USD =
Hold'em No Limit - Level XII (500/1000) - 2017/09/24 18:08:41 ET
Table '1701793695 7' 6-max Seat #3 is the button
Seat 1: JJin91 (92046 in chips)=20
Seat 2: N0InBetween (17875 in chips)=20
Seat 3: @Bud_Fox0000 (32605 in chips)=20
Seat 4: StephGod30 (19355 in chips)=20
Seat 5: WhiteIce0328 (61454 in chips)=20
Seat 6: nwmdnj (19750 in chips)=20
JJin91: posts the ante 125
N0InBetween: posts the ante 125
@Bud_Fox0000: posts the ante 125
StephGod30: posts the ante 125
WhiteIce0328: posts the ante 125
nwmdnj: posts the ante 125
StephGod30: posts small blind 500
WhiteIce0328: posts big blind 1000
*** HOLE CARDS ***
Dealt to JJin91 [7c Jd]
nwmdnj: folds=20
JJin91: folds=20
N0InBetween: folds=20
@Bud_Fox0000: raises 1245 to 2245
StephGod30: folds=20
WhiteIce0328: folds=20
Uncalled bet (1245) returned to @Bud_Fox0000
@Bud_Fox0000 collected 3250 from pot
*** SUMMARY ***
Total pot 3250 | Rake 0=20
Seat 1: JJin91 folded before Flop (didn't bet)
Seat 2: N0InBetween folded before Flop (didn't bet)
Seat 3: @Bud_Fox0000 (button) collected (3250)
Seat 4: StephGod30 (small blind) folded before Flop
Seat 5: WhiteIce0328 (big blind) folded before Flop
Seat 6: nwmdnj folded before Flop (didn't bet)


*********** # 83 **************
PokerStars Hand #175474859343: Tournament #1701793695, $9.10+$0.90 USD =
Hold'em No Limit - Level XII (500/1000) - 2017/09/24 18:09:18 ET
Table '1701793695 7' 6-max Seat #4 is the button
Seat 1: JJin91 (91921 in chips)=20
Seat 2: N0InBetween (17750 in chips)=20
Seat 3: @Bud_Fox0000 (34730 in chips)=20
Seat 4: StephGod30 (18730 in chips)=20
Seat 5: WhiteIce0328 (60329 in chips)=20
Seat 6: nwmdnj (19625 in chips)=20
JJin91: posts the ante 125
N0InBetween: posts the ante 125
@Bud_Fox0000: posts the ante 125
StephGod30: posts the ante 125
WhiteIce0328: posts the ante 125
nwmdnj: posts the ante 125
WhiteIce0328: posts small blind 500
nwmdnj: posts big blind 1000
*** HOLE CARDS ***
Dealt to JJin91 [Ah 7h]
JJin91: raises 1170 to 2170
N0InBetween: folds=20
@Bud_Fox0000: folds=20
StephGod30: folds=20
WhiteIce0328: calls 1670
nwmdnj: folds=20
*** FLOP *** [3h 7d Qs]
WhiteIce0328: checks=20
JJin91: bets 3106
WhiteIce0328: folds=20
Uncalled bet (3106) returned to JJin91
JJin91 collected 6090 from pot
JJin91: doesn't show hand=20
*** SUMMARY ***
Total pot 6090 | Rake 0=20
Board [3h 7d Qs]
Seat 1: JJin91 collected (6090)
Seat 2: N0InBetween folded before Flop (didn't bet)
Seat 3: @Bud_Fox0000 folded before Flop (didn't bet)
Seat 4: StephGod30 (button) folded before Flop (didn't bet)
Seat 5: WhiteIce0328 (small blind) folded on the Flop
Seat 6: nwmdnj (big blind) folded before Flop


*********** # 84 **************
PokerStars Hand #175474859493: Tournament #1701793695, $9.10+$0.90 USD =
Hold'em No Limit - Level XII (500/1000) - 2017/09/24 18:09:45 ET
Table '1701793695 7' 6-max Seat #5 is the button
Seat 1: JJin91 (95716 in chips)=20
Seat 2: N0InBetween (17625 in chips)=20
Seat 3: @Bud_Fox0000 (34605 in chips)=20
Seat 4: StephGod30 (18605 in chips)=20
Seat 5: WhiteIce0328 (58034 in chips)=20
Seat 6: nwmdnj (18500 in chips)=20
JJin91: posts the ante 125
N0InBetween: posts the ante 125
@Bud_Fox0000: posts the ante 125
StephGod30: posts the ante 125
WhiteIce0328: posts the ante 125
nwmdnj: posts the ante 125
nwmdnj: posts small blind 500
JJin91: posts big blind 1000
*** HOLE CARDS ***
Dealt to JJin91 [Qc 6s]
N0InBetween: raises 2000 to 3000
@Bud_Fox0000: folds=20
StephGod30: folds=20
WhiteIce0328: folds=20
nwmdnj: folds=20
JJin91: folds=20
Uncalled bet (2000) returned to N0InBetween
N0InBetween collected 3250 from pot
N0InBetween: doesn't show hand=20
*** SUMMARY ***
Total pot 3250 | Rake 0=20
Seat 1: JJin91 (big blind) folded before Flop
Seat 2: N0InBetween collected (3250)
Seat 3: @Bud_Fox0000 folded before Flop (didn't bet)
Seat 4: StephGod30 folded before Flop (didn't bet)
Seat 5: WhiteIce0328 (button) folded before Flop (didn't bet)
Seat 6: nwmdnj (small blind) folded before Flop


*********** # 85 **************
PokerStars Hand #175474859595: Tournament #1701793695, $9.10+$0.90 USD =
Hold'em No Limit - Level XII (500/1000) - 2017/09/24 18:10:05 ET
Table '1701793695 7' 6-max Seat #6 is the button
Seat 1: JJin91 (94591 in chips)=20
Seat 2: N0InBetween (19750 in chips)=20
Seat 3: @Bud_Fox0000 (34480 in chips)=20
Seat 4: StephGod30 (18480 in chips)=20
Seat 5: WhiteIce0328 (57909 in chips)=20
Seat 6: nwmdnj (17875 in chips)=20
JJin91: posts the ante 125
N0InBetween: posts the ante 125
@Bud_Fox0000: posts the ante 125
StephGod30: posts the ante 125
WhiteIce0328: posts the ante 125
nwmdnj: posts the ante 125
JJin91: posts small blind 500
N0InBetween: posts big blind 1000
*** HOLE CARDS ***
Dealt to JJin91 [3d 8c]
@Bud_Fox0000: raises 1466 to 2466
StephGod30: raises 15889 to 18355 and is all-in
WhiteIce0328: folds=20
nwmdnj: folds=20
JJin91: folds=20
N0InBetween: folds=20
@Bud_Fox0000: folds=20
Uncalled bet (15889) returned to StephGod30
StephGod30 collected 7182 from pot
StephGod30: doesn't show hand=20
*** SUMMARY ***
Total pot 7182 | Rake 0=20
Seat 1: JJin91 (small blind) folded before Flop
Seat 2: N0InBetween (big blind) folded before Flop
Seat 3: @Bud_Fox0000 folded before Flop
Seat 4: StephGod30 collected (7182)
Seat 5: WhiteIce0328 folded before Flop (didn't bet)
Seat 6: nwmdnj (button) folded before Flop (didn't bet)


*********** # 86 **************
PokerStars Hand #175474859774: Tournament #1701793695, $9.10+$0.90 USD =
Hold'em No Limit - Level XII (500/1000) - 2017/09/24 18:10:41 ET
Table '1701793695 7' 6-max Seat #1 is the button
Seat 1: JJin91 (93966 in chips)=20
Seat 2: N0InBetween (18625 in chips)=20
Seat 3: @Bud_Fox0000 (31889 in chips)=20
Seat 4: StephGod30 (23071 in chips)=20
Seat 5: WhiteIce0328 (57784 in chips)=20
Seat 6: nwmdnj (17750 in chips)=20
JJin91: posts the ante 125
N0InBetween: posts the ante 125
@Bud_Fox0000: posts the ante 125
StephGod30: posts the ante 125
WhiteIce0328: posts the ante 125
nwmdnj: posts the ante 125
N0InBetween: posts small blind 500
@Bud_Fox0000: posts big blind 1000
*** HOLE CARDS ***
Dealt to JJin91 [9d 8h]
StephGod30: folds=20
WhiteIce0328: folds=20
nwmdnj: folds=20
JJin91: folds=20
N0InBetween: folds=20
Uncalled bet (500) returned to @Bud_Fox0000
@Bud_Fox0000 collected 1750 from pot
*** SUMMARY ***
Total pot 1750 | Rake 0=20
Seat 1: JJin91 (button) folded before Flop (didn't bet)
Seat 2: N0InBetween (small blind) folded before Flop
Seat 3: @Bud_Fox0000 (big blind) collected (1750)
Seat 4: StephGod30 folded before Flop (didn't bet)
Seat 5: WhiteIce0328 folded before Flop (didn't bet)
Seat 6: nwmdnj folded before Flop (didn't bet)


*********** # 87 **************
PokerStars Hand #175474859835: Tournament #1701793695, $9.10+$0.90 USD =
Hold'em No Limit - Level XII (500/1000) - 2017/09/24 18:10:57 ET
Table '1701793695 7' 6-max Seat #2 is the button
Seat 1: JJin91 (93841 in chips)=20
Seat 2: N0InBetween (18000 in chips)=20
Seat 3: @Bud_Fox0000 (33014 in chips)=20
Seat 4: StephGod30 (22946 in chips)=20
Seat 5: WhiteIce0328 (57659 in chips)=20
Seat 6: nwmdnj (17625 in chips)=20
JJin91: posts the ante 125
N0InBetween: posts the ante 125
@Bud_Fox0000: posts the ante 125
StephGod30: posts the ante 125
WhiteIce0328: posts the ante 125
nwmdnj: posts the ante 125
@Bud_Fox0000: posts small blind 500
StephGod30: posts big blind 1000
*** HOLE CARDS ***
Dealt to JJin91 [3c Tc]
WhiteIce0328: folds=20
nwmdnj: raises 1000 to 2000
JJin91: folds=20
N0InBetween: folds=20
@Bud_Fox0000: folds=20
StephGod30: calls 1000
*** FLOP *** [Qc 6d Js]
StephGod30: checks=20
nwmdnj: checks=20
*** TURN *** [Qc 6d Js] [As]
StephGod30: checks=20
nwmdnj: checks=20
*** RIVER *** [Qc 6d Js As] [Ks]
StephGod30: bets 2000
nwmdnj: folds=20
Uncalled bet (2000) returned to StephGod30
StephGod30 collected 5250 from pot
StephGod30: doesn't show hand=20
*** SUMMARY ***
Total pot 5250 | Rake 0=20
Board [Qc 6d Js As Ks]
Seat 1: JJin91 folded before Flop (didn't bet)
Seat 2: N0InBetween (button) folded before Flop (didn't bet)
Seat 3: @Bud_Fox0000 (small blind) folded before Flop
Seat 4: StephGod30 (big blind) collected (5250)
Seat 5: WhiteIce0328 folded before Flop (didn't bet)
Seat 6: nwmdnj folded on the River


*********** # 88 **************
PokerStars Hand #175477392521: Tournament #1701793695, $9.10+$0.90 USD =
Hold'em No Limit - Level XIII (600/1200) - 2017/09/24 18:12:33 ET
Table '1701793695 7' 6-max Seat #3 is the button
Seat 1: JJin91 (93716 in chips)=20
Seat 2: N0InBetween (17875 in chips)=20
Seat 3: @Bud_Fox0000 (32389 in chips)=20
Seat 4: StephGod30 (26071 in chips)=20
Seat 5: WhiteIce0328 (57534 in chips)=20
Seat 6: nwmdnj (15500 in chips)=20
JJin91: posts the ante 150
N0InBetween: posts the ante 150
@Bud_Fox0000: posts the ante 150
StephGod30: posts the ante 150
WhiteIce0328: posts the ante 150
nwmdnj: posts the ante 150
StephGod30: posts small blind 600
WhiteIce0328: posts big blind 1200
*** HOLE CARDS ***
Dealt to JJin91 [Qs Kh]
nwmdnj: folds=20
JJin91: raises 1404 to 2604
N0InBetween: folds=20
@Bud_Fox0000: folds=20
StephGod30: raises 23317 to 25921 and is all-in
WhiteIce0328: folds=20
JJin91: folds=20
Uncalled bet (23317) returned to StephGod30
StephGod30 collected 7308 from pot
StephGod30: doesn't show hand=20
*** SUMMARY ***
Total pot 7308 | Rake 0=20
Seat 1: JJin91 folded before Flop
Seat 2: N0InBetween folded before Flop (didn't bet)
Seat 3: @Bud_Fox0000 (button) folded before Flop (didn't bet)
Seat 4: StephGod30 (small blind) collected (7308)
Seat 5: WhiteIce0328 (big blind) folded before Flop
Seat 6: nwmdnj folded before Flop (didn't bet)


*********** # 89 **************
PokerStars Hand #175477392704: Tournament #1701793695, $9.10+$0.90 USD =
Hold'em No Limit - Level XIII (600/1200) - 2017/09/24 18:13:15 ET
Table '1701793695 7' 6-max Seat #4 is the button
Seat 1: JJin91 (90962 in chips)=20
Seat 2: N0InBetween (17725 in chips)=20
Seat 3: @Bud_Fox0000 (32239 in chips)=20
Seat 4: StephGod30 (30625 in chips)=20
Seat 5: WhiteIce0328 (56184 in chips)=20
Seat 6: nwmdnj (15350 in chips)=20
JJin91: posts the ante 150
N0InBetween: posts the ante 150
@Bud_Fox0000: posts the ante 150
StephGod30: posts the ante 150
WhiteIce0328: posts the ante 150
nwmdnj: posts the ante 150
WhiteIce0328: posts small blind 600
nwmdnj: posts big blind 1200
*** HOLE CARDS ***
Dealt to JJin91 [Qd 5c]
JJin91: folds=20
N0InBetween: folds=20
@Bud_Fox0000: folds=20
StephGod30: folds=20
WhiteIce0328: calls 600
nwmdnj: checks=20
*** FLOP *** [3s Qh Ac]
WhiteIce0328: bets 1650
nwmdnj: folds=20
Uncalled bet (1650) returned to WhiteIce0328
WhiteIce0328 collected 3300 from pot
WhiteIce0328: doesn't show hand=20
*** SUMMARY ***
Total pot 3300 | Rake 0=20
Board [3s Qh Ac]
Seat 1: JJin91 folded before Flop (didn't bet)
Seat 2: N0InBetween folded before Flop (didn't bet)
Seat 3: @Bud_Fox0000 folded before Flop (didn't bet)
Seat 4: StephGod30 (button) folded before Flop (didn't bet)
Seat 5: WhiteIce0328 (small blind) collected (3300)
Seat 6: nwmdnj (big blind) folded on the Flop


*********** # 90 **************
PokerStars Hand #175477392894: Tournament #1701793695, $9.10+$0.90 USD =
Hold'em No Limit - Level XIII (600/1200) - 2017/09/24 18:13:55 ET
Table '1701793695 7' 6-max Seat #5 is the button
Seat 1: JJin91 (90812 in chips)=20
Seat 2: N0InBetween (17575 in chips)=20
Seat 3: @Bud_Fox0000 (32089 in chips)=20
Seat 4: StephGod30 (30475 in chips)=20
Seat 5: WhiteIce0328 (58134 in chips)=20
Seat 6: nwmdnj (14000 in chips)=20
JJin91: posts the ante 150
N0InBetween: posts the ante 150
@Bud_Fox0000: posts the ante 150
StephGod30: posts the ante 150
WhiteIce0328: posts the ante 150
nwmdnj: posts the ante 150
nwmdnj: posts small blind 600
JJin91: posts big blind 1200
*** HOLE CARDS ***
Dealt to JJin91 [3h Qc]
N0InBetween: folds=20
@Bud_Fox0000: folds=20
StephGod30: folds=20
WhiteIce0328: raises 1200 to 2400
nwmdnj: raises 11450 to 13850 and is all-in
JJin91: folds=20
WhiteIce0328: folds=20
Uncalled bet (11450) returned to nwmdnj
nwmdnj collected 6900 from pot
nwmdnj: doesn't show hand=20
*** SUMMARY ***
Total pot 6900 | Rake 0=20
Seat 1: JJin91 (big blind) folded before Flop
Seat 2: N0InBetween folded before Flop (didn't bet)
Seat 3: @Bud_Fox0000 folded before Flop (didn't bet)
Seat 4: StephGod30 folded before Flop (didn't bet)
Seat 5: WhiteIce0328 (button) folded before Flop
Seat 6: nwmdnj (small blind) collected (6900)


*********** # 91 **************
PokerStars Hand #175477393026: Tournament #1701793695, $9.10+$0.90 USD =
Hold'em No Limit - Level XIII (600/1200) - 2017/09/24 18:14:28 ET
Table '1701793695 7' 6-max Seat #6 is the button
Seat 1: JJin91 (89462 in chips)=20
Seat 2: N0InBetween (17425 in chips)=20
Seat 3: @Bud_Fox0000 (31939 in chips)=20
Seat 4: StephGod30 (30325 in chips)=20
Seat 5: WhiteIce0328 (55584 in chips)=20
Seat 6: nwmdnj (18350 in chips)=20
JJin91: posts the ante 150
N0InBetween: posts the ante 150
@Bud_Fox0000: posts the ante 150
StephGod30: posts the ante 150
WhiteIce0328: posts the ante 150
nwmdnj: posts the ante 150
JJin91: posts small blind 600
N0InBetween: posts big blind 1200
*** HOLE CARDS ***
Dealt to JJin91 [5h Ks]
@Bud_Fox0000: raises 1505 to 2705
StephGod30: calls 2705
WhiteIce0328: folds=20
nwmdnj: folds=20
JJin91: folds=20
N0InBetween: calls 1505
*** FLOP *** [Kc 8s 3c]
N0InBetween: checks=20
@Bud_Fox0000: bets 3250
StephGod30: raises 5640 to 8890
N0InBetween: folds=20
@Bud_Fox0000: folds=20
Uncalled bet (5640) returned to StephGod30
StephGod30 collected 16115 from pot
StephGod30: doesn't show hand=20
*** SUMMARY ***
Total pot 16115 | Rake 0=20
Board [Kc 8s 3c]
Seat 1: JJin91 (small blind) folded before Flop
Seat 2: N0InBetween (big blind) folded on the Flop
Seat 3: @Bud_Fox0000 folded on the Flop
Seat 4: StephGod30 collected (16115)
Seat 5: WhiteIce0328 folded before Flop (didn't bet)
Seat 6: nwmdnj (button) folded before Flop (didn't bet)


*********** # 92 **************
PokerStars Hand #175477393312: Tournament #1701793695, $9.10+$0.90 USD =
Hold'em No Limit - Level XIII (600/1200) - 2017/09/24 18:15:41 ET
Table '1701793695 7' 6-max Seat #1 is the button
Seat 1: JJin91 (88712 in chips)=20
Seat 2: N0InBetween (14570 in chips)=20
Seat 3: @Bud_Fox0000 (25834 in chips)=20
Seat 4: StephGod30 (40335 in chips)=20
Seat 5: WhiteIce0328 (55434 in chips)=20
Seat 6: nwmdnj (18200 in chips)=20
JJin91: posts the ante 150
N0InBetween: posts the ante 150
@Bud_Fox0000: posts the ante 150
StephGod30: posts the ante 150
WhiteIce0328: posts the ante 150
nwmdnj: posts the ante 150
N0InBetween: posts small blind 600
@Bud_Fox0000: posts big blind 1200
*** HOLE CARDS ***
Dealt to JJin91 [9h 2s]
StephGod30: folds=20
WhiteIce0328: raises 1200 to 2400
nwmdnj: calls 2400
JJin91: folds=20
N0InBetween: folds=20
@Bud_Fox0000: raises 6000 to 8400
WhiteIce0328: calls 6000
nwmdnj: folds=20
*** FLOP *** [6d 4s 7h]
@Bud_Fox0000: bets 12755
WhiteIce0328: raises 12755 to 25510
@Bud_Fox0000: calls 4529 and is all-in
Uncalled bet (8226) returned to WhiteIce0328
*** TURN *** [6d 4s 7h] [8s]
*** RIVER *** [6d 4s 7h 8s] [4d]
*** SHOW DOWN ***
@Bud_Fox0000: shows [Jh Ad] (a pair of Fours)
WhiteIce0328: shows [8d 8c] (a full house, Eights full of Fours)
WhiteIce0328 collected 55268 from pot
@Bud_Fox0000 finished the tournament in 410th place
*** SUMMARY ***
Total pot 55268 | Rake 0=20
Board [6d 4s 7h 8s 4d]
Seat 1: JJin91 (button) folded before Flop (didn't bet)
Seat 2: N0InBetween (small blind) folded before Flop
Seat 3: @Bud_Fox0000 (big blind) showed [Jh Ad] and lost with a pair of=
 Fours
Seat 4: StephGod30 folded before Flop (didn't bet)
Seat 5: WhiteIce0328 showed [8d 8c] and won (55268) with a full house, =
Eights full of Fours
Seat 6: nwmdnj folded before Flop


*********** # 93 **************
PokerStars Hand #175477393546: Tournament #1701793695, $9.10+$0.90 USD =
Hold'em No Limit - Level XIII (600/1200) - 2017/09/24 18:16:35 ET
Table '1701793695 7' 6-max Seat #2 is the button
Seat 1: JJin91 (88562 in chips)=20
Seat 2: N0InBetween (13820 in chips)=20
Seat 4: StephGod30 (40185 in chips)=20
Seat 5: WhiteIce0328 (84868 in chips)=20
Seat 6: nwmdnj (15650 in chips)=20
JJin91: posts the ante 150
N0InBetween: posts the ante 150
StephGod30: posts the ante 150
WhiteIce0328: posts the ante 150
nwmdnj: posts the ante 150
StephGod30: posts small blind 600
WhiteIce0328: posts big blind 1200
*** HOLE CARDS ***
Dealt to JJin91 [Ts Ad]
nwmdnj: folds=20
JJin91: raises 1404 to 2604
N0InBetween: folds=20
StephGod30: folds=20
WhiteIce0328: folds=20
Uncalled bet (1404) returned to JJin91
JJin91 collected 3750 from pot
JJin91: doesn't show hand=20
*** SUMMARY ***
Total pot 3750 | Rake 0=20
Seat 1: JJin91 collected (3750)
Seat 2: N0InBetween (button) folded before Flop (didn't bet)
Seat 4: StephGod30 (small blind) folded before Flop
Seat 5: WhiteIce0328 (big blind) folded before Flop
Seat 6: nwmdnj folded before Flop (didn't bet)


*********** # 94 **************
PokerStars Hand #175477393623: Tournament #1701793695, $9.10+$0.90 USD =
Hold'em No Limit - Level XIII (600/1200) - 2017/09/24 18:16:53 ET
Table '1701793695 7' 6-max Seat #4 is the button
Seat 1: JJin91 (90962 in chips)=20
Seat 2: N0InBetween (13670 in chips)=20
Seat 4: StephGod30 (39435 in chips)=20
Seat 5: WhiteIce0328 (83518 in chips)=20
Seat 6: nwmdnj (15500 in chips)=20
JJin91: posts the ante 150
N0InBetween: posts the ante 150
StephGod30: posts the ante 150
WhiteIce0328: posts the ante 150
nwmdnj: posts the ante 150
WhiteIce0328: posts small blind 600
nwmdnj: posts big blind 1200
*** HOLE CARDS ***
Dealt to JJin91 [5d Kc]
JJin91: folds=20
N0InBetween: folds=20
StephGod30: folds=20
WhiteIce0328: raises 82168 to 83368 and is all-in
nwmdnj: folds=20
Uncalled bet (82168) returned to WhiteIce0328
WhiteIce0328 collected 3150 from pot
WhiteIce0328: doesn't show hand=20
*** SUMMARY ***
Total pot 3150 | Rake 0=20
Seat 1: JJin91 folded before Flop (didn't bet)
Seat 2: N0InBetween folded before Flop (didn't bet)
Seat 4: StephGod30 (button) folded before Flop (didn't bet)
Seat 5: WhiteIce0328 (small blind) collected (3150)
Seat 6: nwmdnj (big blind) folded before Flop


*********** # 95 **************
PokerStars Hand #175477393759: Tournament #1701793695, $9.10+$0.90 USD =
Hold'em No Limit - Level XIII (600/1200) - 2017/09/24 18:17:21 ET
Table '1701793695 7' 6-max Seat #5 is the button
Seat 1: JJin91 (90812 in chips)=20
Seat 2: N0InBetween (13520 in chips)=20
Seat 3: urmomislag (20000 in chips)=20
Seat 4: StephGod30 (39285 in chips)=20
Seat 5: WhiteIce0328 (85318 in chips)=20
Seat 6: nwmdnj (14150 in chips)=20
JJin91: posts the ante 150
N0InBetween: posts the ante 150
urmomislag: posts the ante 150
StephGod30: posts the ante 150
WhiteIce0328: posts the ante 150
nwmdnj: posts the ante 150
nwmdnj: posts small blind 600
JJin91: posts big blind 1200
*** HOLE CARDS ***
Dealt to JJin91 [5s 8c]
N0InBetween: folds=20
urmomislag: raises 18650 to 19850 and is all-in
StephGod30: folds=20
WhiteIce0328: folds=20
nwmdnj: folds=20
JJin91: folds=20
Uncalled bet (18650) returned to urmomislag
urmomislag collected 3900 from pot
urmomislag: doesn't show hand=20
*** SUMMARY ***
Total pot 3900 | Rake 0=20
Seat 1: JJin91 (big blind) folded before Flop
Seat 2: N0InBetween folded before Flop (didn't bet)
Seat 3: urmomislag collected (3900)
Seat 4: StephGod30 folded before Flop (didn't bet)
Seat 5: WhiteIce0328 (button) folded before Flop (didn't bet)
Seat 6: nwmdnj (small blind) folded before Flop


*********** # 96 **************
PokerStars Hand #175477393881: Tournament #1701793695, $9.10+$0.90 USD =
Hold'em No Limit - Level XIII (600/1200) - 2017/09/24 18:17:48 ET
Table '1701793695 7' 6-max Seat #6 is the button
Seat 1: JJin91 (89462 in chips)=20
Seat 2: N0InBetween (13370 in chips)=20
Seat 3: urmomislag (22550 in chips)=20
Seat 4: StephGod30 (39135 in chips)=20
Seat 5: WhiteIce0328 (85168 in chips)=20
Seat 6: nwmdnj (13400 in chips)=20
JJin91: posts the ante 150
N0InBetween: posts the ante 150
urmomislag: posts the ante 150
StephGod30: posts the ante 150
WhiteIce0328: posts the ante 150
nwmdnj: posts the ante 150
JJin91: posts small blind 600
N0InBetween: posts big blind 1200
*** HOLE CARDS ***
Dealt to JJin91 [7d Ks]
urmomislag: folds=20
StephGod30: raises 1200 to 2400
WhiteIce0328: folds=20
nwmdnj: folds=20
JJin91: folds=20
N0InBetween: folds=20
Uncalled bet (1200) returned to StephGod30
StephGod30 collected 3900 from pot
StephGod30: doesn't show hand=20
*** SUMMARY ***
Total pot 3900 | Rake 0=20
Seat 1: JJin91 (small blind) folded before Flop
Seat 2: N0InBetween (big blind) folded before Flop
Seat 3: urmomislag folded before Flop (didn't bet)
Seat 4: StephGod30 collected (3900)
Seat 5: WhiteIce0328 folded before Flop (didn't bet)
Seat 6: nwmdnj (button) folded before Flop (didn't bet)


*********** # 97 **************
PokerStars Hand #175477393971: Tournament #1701793695, $9.10+$0.90 USD =
Hold'em No Limit - Level XIII (600/1200) - 2017/09/24 18:18:11 ET
Table '1701793695 7' 6-max Seat #1 is the button
Seat 1: JJin91 (88712 in chips)=20
Seat 2: N0InBetween (12020 in chips)=20
Seat 3: urmomislag (22400 in chips)=20
Seat 4: StephGod30 (41685 in chips)=20
Seat 5: WhiteIce0328 (85018 in chips)=20
Seat 6: nwmdnj (13250 in chips)=20
JJin91: posts the ante 150
N0InBetween: posts the ante 150
urmomislag: posts the ante 150
StephGod30: posts the ante 150
WhiteIce0328: posts the ante 150
nwmdnj: posts the ante 150
N0InBetween: posts small blind 600
urmomislag: posts big blind 1200
*** HOLE CARDS ***
Dealt to JJin91 [9s Js]
StephGod30: folds=20
WhiteIce0328: folds=20
nwmdnj: raises 11900 to 13100 and is all-in
JJin91: folds=20
N0InBetween: folds=20
urmomislag: folds=20
Uncalled bet (11900) returned to nwmdnj
nwmdnj collected 3900 from pot
nwmdnj: doesn't show hand=20
*** SUMMARY ***
Total pot 3900 | Rake 0=20
Seat 1: JJin91 (button) folded before Flop (didn't bet)
Seat 2: N0InBetween (small blind) folded before Flop
Seat 3: urmomislag (big blind) folded before Flop
Seat 4: StephGod30 folded before Flop (didn't bet)
Seat 5: WhiteIce0328 folded before Flop (didn't bet)
Seat 6: nwmdnj collected (3900)


*********** # 98 **************
PokerStars Hand #175477394084: Tournament #1701793695, $9.10+$0.90 USD =
Hold'em No Limit - Level XIII (600/1200) - 2017/09/24 18:18:36 ET
Table '1701793695 7' 6-max Seat #2 is the button
Seat 1: JJin91 (88562 in chips)=20
Seat 2: N0InBetween (11270 in chips)=20
Seat 3: urmomislag (21050 in chips)=20
Seat 4: StephGod30 (41535 in chips)=20
Seat 5: WhiteIce0328 (84868 in chips)=20
Seat 6: nwmdnj (15800 in chips)=20
JJin91: posts the ante 150
N0InBetween: posts the ante 150
urmomislag: posts the ante 150
StephGod30: posts the ante 150
WhiteIce0328: posts the ante 150
nwmdnj: posts the ante 150
urmomislag: posts small blind 600
StephGod30: posts big blind 1200
*** HOLE CARDS ***
Dealt to JJin91 [6h 2d]
WhiteIce0328: raises 1200 to 2400
nwmdnj: folds=20
JJin91: folds=20
N0InBetween: raises 8720 to 11120 and is all-in
urmomislag: folds=20
StephGod30: folds=20
WhiteIce0328: calls 8720
*** FLOP *** [3d Kc 7s]
*** TURN *** [3d Kc 7s] [7h]
*** RIVER *** [3d Kc 7s 7h] [5s]
*** SHOW DOWN ***
WhiteIce0328: shows [Ah Qs] (a pair of Sevens)
N0InBetween: shows [Qh Js] (a pair of Sevens - lower kicker)
WhiteIce0328 collected 24940 from pot
N0InBetween finished the tournament in 397th place
*** SUMMARY ***
Total pot 24940 | Rake 0=20
Board [3d Kc 7s 7h 5s]
Seat 1: JJin91 folded before Flop (didn't bet)
Seat 2: N0InBetween (button) showed [Qh Js] and lost with a pair of Sev=
ens
Seat 3: urmomislag (small blind) folded before Flop
Seat 4: StephGod30 (big blind) folded before Flop
Seat 5: WhiteIce0328 showed [Ah Qs] and won (24940) with a pair of Seve=
ns
Seat 6: nwmdnj folded before Flop (didn't bet)


*********** # 99 **************
PokerStars Hand #175477394252: Tournament #1701793695, $9.10+$0.90 USD =
Hold'em No Limit - Level XIII (600/1200) - 2017/09/24 18:19:12 ET
Table '1701793695 7' 6-max Seat #3 is the button
Seat 1: JJin91 (88412 in chips)=20
Seat 3: urmomislag (20300 in chips)=20
Seat 4: StephGod30 (40185 in chips)=20
Seat 5: WhiteIce0328 (98538 in chips)=20
Seat 6: nwmdnj (15650 in chips)=20
JJin91: posts the ante 150
urmomislag: posts the ante 150
StephGod30: posts the ante 150
WhiteIce0328: posts the ante 150
nwmdnj: posts the ante 150
StephGod30: posts small blind 600
WhiteIce0328: posts big blind 1200
*** HOLE CARDS ***
Dealt to JJin91 [5c 3d]
nwmdnj: raises 14300 to 15500 and is all-in
JJin91: folds=20
urmomislag: folds=20
StephGod30: folds=20
WhiteIce0328: folds=20
Uncalled bet (14300) returned to nwmdnj
nwmdnj collected 3750 from pot
nwmdnj: doesn't show hand=20
*** SUMMARY ***
Total pot 3750 | Rake 0=20
Seat 1: JJin91 folded before Flop (didn't bet)
Seat 3: urmomislag (button) folded before Flop (didn't bet)
Seat 4: StephGod30 (small blind) folded before Flop
Seat 5: WhiteIce0328 (big blind) folded before Flop
Seat 6: nwmdnj collected (3750)


*********** # 100 **************
PokerStars Hand #175477394341: Tournament #1701793695, $9.10+$0.90 USD =
Hold'em No Limit - Level XIII (600/1200) - 2017/09/24 18:19:31 ET
Table '1701793695 7' 6-max Seat #4 is the button
Seat 1: JJin91 (88262 in chips)=20
Seat 3: urmomislag (20150 in chips)=20
Seat 4: StephGod30 (39435 in chips)=20
Seat 5: WhiteIce0328 (97188 in chips)=20
Seat 6: nwmdnj (18050 in chips)=20
JJin91: posts the ante 150
urmomislag: posts the ante 150
StephGod30: posts the ante 150
WhiteIce0328: posts the ante 150
nwmdnj: posts the ante 150
WhiteIce0328: posts small blind 600
nwmdnj: posts big blind 1200
*** HOLE CARDS ***
Dealt to JJin91 [Th Kh]
JJin91: raises 1404 to 2604
urmomislag: folds=20
StephGod30: folds=20
WhiteIce0328: folds=20
nwmdnj: folds=20
Uncalled bet (1404) returned to JJin91
JJin91 collected 3750 from pot
JJin91: doesn't show hand=20
*** SUMMARY ***
Total pot 3750 | Rake 0=20
Seat 1: JJin91 collected (3750)
Seat 3: urmomislag folded before Flop (didn't bet)
Seat 4: StephGod30 (button) folded before Flop (didn't bet)
Seat 5: WhiteIce0328 (small blind) folded before Flop
Seat 6: nwmdnj (big blind) folded before Flop


*********** # 101 **************
PokerStars Hand #175477394512: Tournament #1701793695, $9.10+$0.90 USD =
Hold'em No Limit - Level XIII (600/1200) - 2017/09/24 18:20:12 ET
Table '1701793695 7' 6-max Seat #5 is the button
Seat 1: JJin91 (90662 in chips)=20
Seat 3: urmomislag (20000 in chips)=20
Seat 4: StephGod30 (39285 in chips)=20
Seat 5: WhiteIce0328 (96438 in chips)=20
Seat 6: nwmdnj (16700 in chips)=20
JJin91: posts the ante 150
urmomislag: posts the ante 150
StephGod30: posts the ante 150
WhiteIce0328: posts the ante 150
nwmdnj: posts the ante 150
nwmdnj: posts small blind 600
JJin91: posts big blind 1200
*** HOLE CARDS ***
Dealt to JJin91 [8d 9d]
urmomislag: folds=20
StephGod30: folds=20
WhiteIce0328: folds=20
nwmdnj: folds=20
Uncalled bet (600) returned to JJin91
JJin91 collected 1950 from pot
JJin91: doesn't show hand=20
*** SUMMARY ***
Total pot 1950 | Rake 0=20
Seat 1: JJin91 (big blind) collected (1950)
Seat 3: urmomislag folded before Flop (didn't bet)
Seat 4: StephGod30 folded before Flop (didn't bet)
Seat 5: WhiteIce0328 (button) folded before Flop (didn't bet)
Seat 6: nwmdnj (small blind) folded before Flop


*********** # 102 **************
PokerStars Hand #175477394664: Tournament #1701793695, $9.10+$0.90 USD =
Hold'em No Limit - Level XIV (700/1400) - 2017/09/24 18:20:47 ET
Table '1701793695 7' 6-max Seat #6 is the button
Seat 1: JJin91 (91862 in chips)=20
Seat 3: urmomislag (19850 in chips)=20
Seat 4: StephGod30 (39135 in chips)=20
Seat 5: WhiteIce0328 (96288 in chips)=20
Seat 6: nwmdnj (15950 in chips)=20
JJin91: posts the ante 175
urmomislag: posts the ante 175
StephGod30: posts the ante 175
WhiteIce0328: posts the ante 175
nwmdnj: posts the ante 175
JJin91: posts small blind 700
urmomislag: posts big blind 1400
*** HOLE CARDS ***
Dealt to JJin91 [7h Qs]
StephGod30: raises 2100 to 3500
WhiteIce0328: folds=20
nwmdnj: folds=20
JJin91: folds=20
urmomislag: folds=20
Uncalled bet (2100) returned to StephGod30
StephGod30 collected 4375 from pot
StephGod30: doesn't show hand=20
*** SUMMARY ***
Total pot 4375 | Rake 0=20
Seat 1: JJin91 (small blind) folded before Flop
Seat 3: urmomislag (big blind) folded before Flop
Seat 4: StephGod30 collected (4375)
Seat 5: WhiteIce0328 folded before Flop (didn't bet)
Seat 6: nwmdnj (button) folded before Flop (didn't bet)


*********** # 103 **************
PokerStars Hand #175477394745: Tournament #1701793695, $9.10+$0.90 USD =
Hold'em No Limit - Level XIV (700/1400) - 2017/09/24 18:21:06 ET
Table '1701793695 7' 6-max Seat #1 is the button
Seat 1: JJin91 (90987 in chips)=20
Seat 3: urmomislag (18275 in chips)=20
Seat 4: StephGod30 (41935 in chips)=20
Seat 5: WhiteIce0328 (96113 in chips)=20
Seat 6: nwmdnj (15775 in chips)=20
JJin91: posts the ante 175
urmomislag: posts the ante 175
StephGod30: posts the ante 175
WhiteIce0328: posts the ante 175
nwmdnj: posts the ante 175
urmomislag: posts small blind 700
StephGod30: posts big blind 1400
*** HOLE CARDS ***
Dealt to JJin91 [4s 5c]
WhiteIce0328: folds=20
nwmdnj: folds=20
JJin91: folds=20
urmomislag: folds=20
Uncalled bet (700) returned to StephGod30
StephGod30 collected 2275 from pot
StephGod30: doesn't show hand=20
*** SUMMARY ***
Total pot 2275 | Rake 0=20
Seat 1: JJin91 (button) folded before Flop (didn't bet)
Seat 3: urmomislag (small blind) folded before Flop
Seat 4: StephGod30 (big blind) collected (2275)
Seat 5: WhiteIce0328 folded before Flop (didn't bet)
Seat 6: nwmdnj folded before Flop (didn't bet)


*********** # 104 **************
PokerStars Hand #175477394851: Tournament #1701793695, $9.10+$0.90 USD =
Hold'em No Limit - Level XIV (700/1400) - 2017/09/24 18:21:27 ET
Table '1701793695 7' 6-max Seat #3 is the button
Seat 1: JJin91 (90812 in chips)=20
Seat 3: urmomislag (17400 in chips)=20
Seat 4: StephGod30 (43335 in chips)=20
Seat 5: WhiteIce0328 (95938 in chips)=20
Seat 6: nwmdnj (15600 in chips)=20
JJin91: posts the ante 175
urmomislag: posts the ante 175
StephGod30: posts the ante 175
WhiteIce0328: posts the ante 175
nwmdnj: posts the ante 175
StephGod30: posts small blind 700
WhiteIce0328: posts big blind 1400
*** HOLE CARDS ***
Dealt to JJin91 [2s 3d]
nwmdnj: folds=20
JJin91: folds=20
urmomislag: raises 15825 to 17225 and is all-in
StephGod30: folds=20
WhiteIce0328: folds=20
Uncalled bet (15825) returned to urmomislag
urmomislag collected 4375 from pot
urmomislag: doesn't show hand=20
*** SUMMARY ***
Total pot 4375 | Rake 0=20
Seat 1: JJin91 folded before Flop (didn't bet)
Seat 3: urmomislag (button) collected (4375)
Seat 4: StephGod30 (small blind) folded before Flop
Seat 5: WhiteIce0328 (big blind) folded before Flop
Seat 6: nwmdnj folded before Flop (didn't bet)


*********** # 105 **************
PokerStars Hand #175477394930: Tournament #1701793695, $9.10+$0.90 USD =
Hold'em No Limit - Level XIV (700/1400) - 2017/09/24 18:21:46 ET
Table '1701793695 7' 6-max Seat #4 is the button
Seat 1: JJin91 (90637 in chips)=20
Seat 3: urmomislag (20200 in chips)=20
Seat 4: StephGod30 (42460 in chips)=20
Seat 5: WhiteIce0328 (94363 in chips)=20
Seat 6: nwmdnj (15425 in chips)=20
JJin91: posts the ante 175
urmomislag: posts the ante 175
StephGod30: posts the ante 175
WhiteIce0328: posts the ante 175
nwmdnj: posts the ante 175
WhiteIce0328: posts small blind 700
nwmdnj: posts big blind 1400
*** HOLE CARDS ***
Dealt to JJin91 [5s 8d]
JJin91: folds=20
urmomislag: raises 18625 to 20025 and is all-in
StephGod30: folds=20
WhiteIce0328: folds=20
nwmdnj: folds=20
Uncalled bet (18625) returned to urmomislag
urmomislag collected 4375 from pot
urmomislag: doesn't show hand=20
*** SUMMARY ***
Total pot 4375 | Rake 0=20
Seat 1: JJin91 folded before Flop (didn't bet)
Seat 3: urmomislag collected (4375)
Seat 4: StephGod30 (button) folded before Flop (didn't bet)
Seat 5: WhiteIce0328 (small blind) folded before Flop
Seat 6: nwmdnj (big blind) folded before Flop


*********** # 106 **************
PokerStars Hand #175477395024: Tournament #1701793695, $9.10+$0.90 USD =
Hold'em No Limit - Level XIV (700/1400) - 2017/09/24 18:22:05 ET
Table '1701793695 7' 6-max Seat #5 is the button
Seat 1: JJin91 (90462 in chips)=20
Seat 3: urmomislag (23000 in chips)=20
Seat 4: StephGod30 (42285 in chips)=20
Seat 5: WhiteIce0328 (93488 in chips)=20
Seat 6: nwmdnj (13850 in chips)=20
JJin91: posts the ante 175
urmomislag: posts the ante 175
StephGod30: posts the ante 175
WhiteIce0328: posts the ante 175
nwmdnj: posts the ante 175
nwmdnj: posts small blind 700
JJin91: posts big blind 1400
*** HOLE CARDS ***
Dealt to JJin91 [6d Td]
urmomislag: folds=20
StephGod30: folds=20
WhiteIce0328: folds=20
nwmdnj: folds=20
Uncalled bet (700) returned to JJin91
JJin91 collected 2275 from pot
JJin91: doesn't show hand=20
*** SUMMARY ***
Total pot 2275 | Rake 0=20
Seat 1: JJin91 (big blind) collected (2275)
Seat 3: urmomislag folded before Flop (didn't bet)
Seat 4: StephGod30 folded before Flop (didn't bet)
Seat 5: WhiteIce0328 (button) folded before Flop (didn't bet)
Seat 6: nwmdnj (small blind) folded before Flop


*********** # 107 **************
PokerStars Hand #175477395063: Tournament #1701793695, $9.10+$0.90 USD =
Hold'em No Limit - Level XIV (700/1400) - 2017/09/24 18:22:16 ET
Table '1701793695 7' 6-max Seat #6 is the button
Seat 1: JJin91 (91862 in chips)=20
Seat 3: urmomislag (22825 in chips)=20
Seat 4: StephGod30 (42110 in chips)=20
Seat 5: WhiteIce0328 (93313 in chips)=20
Seat 6: nwmdnj (12975 in chips)=20
JJin91: posts the ante 175
urmomislag: posts the ante 175
StephGod30: posts the ante 175
WhiteIce0328: posts the ante 175
nwmdnj: posts the ante 175
JJin91: posts small blind 700
urmomislag: posts big blind 1400
*** HOLE CARDS ***
Dealt to JJin91 [Qs 5h]
StephGod30: folds=20
WhiteIce0328: folds=20
nwmdnj: raises 11400 to 12800 and is all-in
JJin91: folds=20
urmomislag: calls 11400
*** FLOP *** [9c Ad Ah]
*** TURN *** [9c Ad Ah] [Ac]
*** RIVER *** [9c Ad Ah Ac] [3s]
*** SHOW DOWN ***
urmomislag: shows [6h Kh] (three of a kind, Aces)
nwmdnj: shows [7d 7c] (a full house, Aces full of Sevens)
nwmdnj collected 27175 from pot
*** SUMMARY ***
Total pot 27175 | Rake 0=20
Board [9c Ad Ah Ac 3s]
Seat 1: JJin91 (small blind) folded before Flop
Seat 3: urmomislag (big blind) showed [6h Kh] and lost with three of a =
kind, Aces
Seat 4: StephGod30 folded before Flop (didn't bet)
Seat 5: WhiteIce0328 folded before Flop (didn't bet)
Seat 6: nwmdnj (button) showed [7d 7c] and won (27175) with a full hous=
e, Aces full of Sevens


*********** # 108 **************
PokerStars Hand #175477395296: Tournament #1701793695, $9.10+$0.90 USD =
Hold'em No Limit - Level XIV (700/1400) - 2017/09/24 18:23:05 ET
Table '1701793695 7' 6-max Seat #1 is the button
Seat 1: JJin91 (90987 in chips)=20
Seat 3: urmomislag (9850 in chips)=20
Seat 4: StephGod30 (41935 in chips)=20
Seat 5: WhiteIce0328 (93138 in chips)=20
Seat 6: nwmdnj (27175 in chips)=20
JJin91: posts the ante 175
urmomislag: posts the ante 175
StephGod30: posts the ante 175
WhiteIce0328: posts the ante 175
nwmdnj: posts the ante 175
urmomislag: posts small blind 700
StephGod30: posts big blind 1400
*** HOLE CARDS ***
Dealt to JJin91 [5c Kh]
WhiteIce0328: raises 1400 to 2800
nwmdnj: folds=20
JJin91: folds=20
urmomislag: folds=20
StephGod30: folds=20
Uncalled bet (1400) returned to WhiteIce0328
WhiteIce0328 collected 4375 from pot
WhiteIce0328: doesn't show hand=20
*** SUMMARY ***
Total pot 4375 | Rake 0=20
Seat 1: JJin91 (button) folded before Flop (didn't bet)
Seat 3: urmomislag (small blind) folded before Flop
Seat 4: StephGod30 (big blind) folded before Flop
Seat 5: WhiteIce0328 collected (4375)
Seat 6: nwmdnj folded before Flop (didn't bet)


*********** # 109 **************
PokerStars Hand #175477395496: Tournament #1701793695, $9.10+$0.90 USD =
Hold'em No Limit - Level XIV (700/1400) - 2017/09/24 18:23:48 ET
Table '1701793695 7' 6-max Seat #3 is the button
Seat 1: JJin91 (90812 in chips)=20
Seat 3: urmomislag (8975 in chips)=20
Seat 4: StephGod30 (40360 in chips)=20
Seat 5: WhiteIce0328 (95938 in chips)=20
Seat 6: nwmdnj (27000 in chips)=20
JJin91: posts the ante 175
urmomislag: posts the ante 175
StephGod30: posts the ante 175
WhiteIce0328: posts the ante 175
nwmdnj: posts the ante 175
StephGod30: posts small blind 700
WhiteIce0328: posts big blind 1400
*** HOLE CARDS ***
Dealt to JJin91 [6s Tc]
nwmdnj: folds=20
JJin91: raises 1638 to 3038
urmomislag: folds=20
StephGod30: folds=20
WhiteIce0328: folds=20
Uncalled bet (1638) returned to JJin91
JJin91 collected 4375 from pot
JJin91: doesn't show hand=20
*** SUMMARY ***
Total pot 4375 | Rake 0=20
Seat 1: JJin91 collected (4375)
Seat 3: urmomislag (button) folded before Flop (didn't bet)
Seat 4: StephGod30 (small blind) folded before Flop
Seat 5: WhiteIce0328 (big blind) folded before Flop
Seat 6: nwmdnj folded before Flop (didn't bet)


*********** # 110 **************
PokerStars Hand #175477395639: Tournament #1701793695, $9.10+$0.90 USD =
Hold'em No Limit - Level XIV (700/1400) - 2017/09/24 18:24:17 ET
Table '1701793695 7' 6-max Seat #4 is the button
Seat 1: JJin91 (93612 in chips)=20
Seat 2: Batzz88 (148034 in chips)=20
Seat 3: urmomislag (8800 in chips)=20
Seat 4: StephGod30 (39485 in chips)=20
Seat 5: WhiteIce0328 (94363 in chips)=20
Seat 6: nwmdnj (26825 in chips)=20
JJin91: posts the ante 175
Batzz88: posts the ante 175
urmomislag: posts the ante 175
StephGod30: posts the ante 175
WhiteIce0328: posts the ante 175
nwmdnj: posts the ante 175
WhiteIce0328: posts small blind 700
nwmdnj: posts big blind 1400
*** HOLE CARDS ***
Dealt to JJin91 [6s 9s]
JJin91: folds=20
Batzz88: folds=20
urmomislag: raises 7225 to 8625 and is all-in
StephGod30: folds=20
WhiteIce0328: folds=20
nwmdnj: calls 7225
*** FLOP *** [Td 9c 3d]
*** TURN *** [Td 9c 3d] [8d]
*** RIVER *** [Td 9c 3d 8d] [Ac]
*** SHOW DOWN ***
nwmdnj: shows [Ks 9d] (a pair of Nines)
urmomislag: shows [As 7c] (a pair of Aces)
urmomislag collected 19000 from pot
*** SUMMARY ***
Total pot 19000 | Rake 0=20
Board [Td 9c 3d 8d Ac]
Seat 1: JJin91 folded before Flop (didn't bet)
Seat 2: Batzz88 folded before Flop (didn't bet)
Seat 3: urmomislag showed [As 7c] and won (19000) with a pair of Aces
Seat 4: StephGod30 (button) folded before Flop (didn't bet)
Seat 5: WhiteIce0328 (small blind) folded before Flop
Seat 6: nwmdnj (big blind) showed [Ks 9d] and lost with a pair of Nines


*********** # 111 **************
PokerStars Hand #175477396004: Tournament #1701793695, $9.10+$0.90 USD =
Hold'em No Limit - Level XIV (700/1400) - 2017/09/24 18:25:34 ET
Table '1701793695 7' 6-max Seat #5 is the button
Seat 1: JJin91 (93437 in chips)=20
Seat 2: Batzz88 (147859 in chips)=20
Seat 3: urmomislag (19000 in chips)=20
Seat 4: StephGod30 (39310 in chips)=20
Seat 5: WhiteIce0328 (93488 in chips)=20
Seat 6: nwmdnj (18025 in chips)=20
JJin91: posts the ante 175
Batzz88: posts the ante 175
urmomislag: posts the ante 175
StephGod30: posts the ante 175
WhiteIce0328: posts the ante 175
nwmdnj: posts the ante 175
nwmdnj: posts small blind 700
JJin91: posts big blind 1400
*** HOLE CARDS ***
Dealt to JJin91 [Jd Qc]
Batzz88: folds=20
urmomislag: folds=20
StephGod30: folds=20
WhiteIce0328: raises 1400 to 2800
nwmdnj: folds=20
JJin91: raises 7000 to 9800
WhiteIce0328: calls 7000
*** FLOP *** [9h Kd 4s]
JJin91: bets 10889
WhiteIce0328: folds [As]
Uncalled bet (10889) returned to JJin91
JJin91 collected 21350 from pot
JJin91: doesn't show hand=20
*** SUMMARY ***
Total pot 21350 | Rake 0=20
Board [9h Kd 4s]
Seat 1: JJin91 (big blind) collected (21350)
Seat 2: Batzz88 folded before Flop (didn't bet)
Seat 3: urmomislag folded before Flop (didn't bet)
Seat 4: StephGod30 folded before Flop (didn't bet)
Seat 5: WhiteIce0328 (button) folded on the Flop
Seat 6: nwmdnj (small blind) folded before Flop


*********** # 112 **************
PokerStars Hand #175477396215: Tournament #1701793695, $9.10+$0.90 USD =
Hold'em No Limit - Level XIV (700/1400) - 2017/09/24 18:26:22 ET
Table '1701793695 7' 6-max Seat #6 is the button
Seat 1: JJin91 (104812 in chips)=20
Seat 2: Batzz88 (147684 in chips)=20
Seat 3: urmomislag (18825 in chips)=20
Seat 4: StephGod30 (39135 in chips)=20
Seat 5: WhiteIce0328 (83513 in chips)=20
Seat 6: nwmdnj (17150 in chips)=20
JJin91: posts the ante 175
Batzz88: posts the ante 175
urmomislag: posts the ante 175
StephGod30: posts the ante 175
WhiteIce0328: posts the ante 175
nwmdnj: posts the ante 175
JJin91: posts small blind 700
Batzz88: posts big blind 1400
*** HOLE CARDS ***
Dealt to JJin91 [4s Ad]
urmomislag: folds=20
StephGod30: folds=20
WhiteIce0328: folds=20
nwmdnj: folds=20
JJin91: calls 700
Batzz88: raises 2800 to 4200
JJin91: calls 2800
*** FLOP *** [8d Qh Th]
JJin91: checks=20
Batzz88: bets 2800
JJin91: calls 2800
*** TURN *** [8d Qh Th] [4c]
JJin91: checks=20
Batzz88: checks=20
*** RIVER *** [8d Qh Th 4c] [3s]
JJin91: checks=20
Batzz88: checks=20
*** SHOW DOWN ***
JJin91: shows [4s Ad] (a pair of Fours)
Batzz88: mucks hand=20
JJin91 collected 15050 from pot
*** SUMMARY ***
Total pot 15050 | Rake 0=20
Board [8d Qh Th 4c 3s]
Seat 1: JJin91 (small blind) showed [4s Ad] and won (15050) with a pair=
 of Fours
Seat 2: Batzz88 (big blind) mucked [Jh Kd]
Seat 3: urmomislag folded before Flop (didn't bet)
Seat 4: StephGod30 folded before Flop (didn't bet)
Seat 5: WhiteIce0328 folded before Flop (didn't bet)
Seat 6: nwmdnj (button) folded before Flop (didn't bet)


*********** # 113 **************
PokerStars Hand #175477396520: Tournament #1701793695, $9.10+$0.90 USD =
Hold'em No Limit - Level XIV (700/1400) - 2017/09/24 18:27:33 ET
Table '1701793695 7' 6-max Seat #1 is the button
Seat 1: JJin91 (112687 in chips)=20
Seat 2: Batzz88 (140509 in chips)=20
Seat 3: urmomislag (18650 in chips)=20
Seat 4: StephGod30 (38960 in chips)=20
Seat 5: WhiteIce0328 (83338 in chips)=20
Seat 6: nwmdnj (16975 in chips)=20
JJin91: posts the ante 175
Batzz88: posts the ante 175
urmomislag: posts the ante 175
StephGod30: posts the ante 175
WhiteIce0328: posts the ante 175
nwmdnj: posts the ante 175
Batzz88: posts small blind 700
urmomislag: posts big blind 1400
*** HOLE CARDS ***
Dealt to JJin91 [Kc Tc]
StephGod30: raises 1400 to 2800
WhiteIce0328: folds=20
nwmdnj: folds=20
JJin91: calls 2800
Batzz88: folds=20
urmomislag: calls 1400
*** FLOP *** [3d 4s Qc]
urmomislag: checks=20
StephGod30: bets 5075
JJin91: calls 5075
urmomislag: calls 5075
*** TURN *** [3d 4s Qc] [3s]
urmomislag: checks=20
StephGod30: bets 30910 and is all-in
JJin91: folds=20
urmomislag: folds=20
Uncalled bet (30910) returned to StephGod30
StephGod30 collected 25375 from pot
StephGod30: doesn't show hand=20
*** SUMMARY ***
Total pot 25375 | Rake 0=20
Board [3d 4s Qc 3s]
Seat 1: JJin91 (button) folded on the Turn
Seat 2: Batzz88 (small blind) folded before Flop
Seat 3: urmomislag (big blind) folded on the Turn
Seat 4: StephGod30 collected (25375)
Seat 5: WhiteIce0328 folded before Flop (didn't bet)
Seat 6: nwmdnj folded before Flop (didn't bet)


*********** # 114 **************
PokerStars Hand #175477396845: Tournament #1701793695, $9.10+$0.90 USD =
Hold'em No Limit - Level XV (800/1600) - 2017/09/24 18:28:48 ET
Table '1701793695 7' 6-max Seat #2 is the button
Seat 1: JJin91 (104637 in chips)=20
Seat 2: Batzz88 (139634 in chips)=20
Seat 3: urmomislag (10600 in chips)=20
Seat 4: StephGod30 (56285 in chips)=20
Seat 5: WhiteIce0328 (83163 in chips)=20
Seat 6: nwmdnj (16800 in chips)=20
JJin91: posts the ante 200
Batzz88: posts the ante 200
urmomislag: posts the ante 200
StephGod30: posts the ante 200
WhiteIce0328: posts the ante 200
nwmdnj: posts the ante 200
urmomislag: posts small blind 800
StephGod30: posts big blind 1600
*** HOLE CARDS ***
Dealt to JJin91 [8c 3d]
WhiteIce0328: raises 1600 to 3200
nwmdnj: folds=20
JJin91: folds=20
Batzz88: raises 6400 to 9600
urmomislag: folds=20
StephGod30: folds=20
WhiteIce0328: calls 6400
*** FLOP *** [6h Tc 4c]
WhiteIce0328: checks=20
Batzz88: bets 8900
WhiteIce0328: calls 8900
*** TURN *** [6h Tc 4c] [Ts]
WhiteIce0328: checks=20
Batzz88: checks=20
*** RIVER *** [6h Tc 4c Ts] [3c]
WhiteIce0328: bets 20300
Batzz88: calls 20300
*** SHOW DOWN ***
WhiteIce0328: shows [Jh Th] (three of a kind, Tens)
Batzz88: mucks hand=20
WhiteIce0328 collected 81200 from pot
*** SUMMARY ***
Total pot 81200 | Rake 0=20
Board [6h Tc 4c Ts 3c]
Seat 1: JJin91 folded before Flop (didn't bet)
Seat 2: Batzz88 (button) mucked [Qh Qd]
Seat 3: urmomislag (small blind) folded before Flop
Seat 4: StephGod30 (big blind) folded before Flop
Seat 5: WhiteIce0328 showed [Jh Th] and won (81200) with three of a kin=
d, Tens
Seat 6: nwmdnj folded before Flop (didn't bet)


*********** # 115 **************
PokerStars Hand #175477397164: Tournament #1701793695, $9.10+$0.90 USD =
Hold'em No Limit - Level XV (800/1600) - 2017/09/24 18:30:03 ET
Table '1701793695 7' 6-max Seat #3 is the button
Seat 1: JJin91 (104437 in chips)=20
Seat 2: Batzz88 (100634 in chips)=20
Seat 3: urmomislag (9600 in chips)=20
Seat 4: StephGod30 (54485 in chips)=20
Seat 5: WhiteIce0328 (125363 in chips)=20
Seat 6: nwmdnj (16600 in chips)=20
JJin91: posts the ante 200
Batzz88: posts the ante 200
urmomislag: posts the ante 200
StephGod30: posts the ante 200
WhiteIce0328: posts the ante 200
nwmdnj: posts the ante 200
StephGod30: posts small blind 800
WhiteIce0328: posts big blind 1600
*** HOLE CARDS ***
Dealt to JJin91 [5s Ad]
nwmdnj: folds=20
JJin91: raises 1872 to 3472
Batzz88: folds=20
urmomislag: folds=20
StephGod30: folds=20
WhiteIce0328: folds=20
Uncalled bet (1872) returned to JJin91
JJin91 collected 5200 from pot
JJin91: doesn't show hand=20
*** SUMMARY ***
Total pot 5200 | Rake 0=20
Seat 1: JJin91 collected (5200)
Seat 2: Batzz88 folded before Flop (didn't bet)
Seat 3: urmomislag (button) folded before Flop (didn't bet)
Seat 4: StephGod30 (small blind) folded before Flop
Seat 5: WhiteIce0328 (big blind) folded before Flop
Seat 6: nwmdnj folded before Flop (didn't bet)


*********** # 116 **************
PokerStars Hand #175477397270: Tournament #1701793695, $9.10+$0.90 USD =
Hold'em No Limit - Level XV (800/1600) - 2017/09/24 18:30:26 ET
Table '1701793695 7' 6-max Seat #4 is the button
Seat 1: JJin91 (107837 in chips)=20
Seat 2: Batzz88 (100434 in chips)=20
Seat 3: urmomislag (9400 in chips)=20
Seat 4: StephGod30 (53485 in chips)=20
Seat 5: WhiteIce0328 (123563 in chips)=20
Seat 6: nwmdnj (16400 in chips)=20
JJin91: posts the ante 200
Batzz88: posts the ante 200
urmomislag: posts the ante 200
StephGod30: posts the ante 200
WhiteIce0328: posts the ante 200
nwmdnj: posts the ante 200
WhiteIce0328: posts small blind 800
nwmdnj: posts big blind 1600
*** HOLE CARDS ***
Dealt to JJin91 [9d Qc]
JJin91: folds=20
Batzz88: folds=20
urmomislag: raises 7600 to 9200 and is all-in
StephGod30: folds=20
WhiteIce0328: folds=20
nwmdnj: folds=20
Uncalled bet (7600) returned to urmomislag
urmomislag collected 5200 from pot
urmomislag: doesn't show hand=20
*** SUMMARY ***
Total pot 5200 | Rake 0=20
Seat 1: JJin91 folded before Flop (didn't bet)
Seat 2: Batzz88 folded before Flop (didn't bet)
Seat 3: urmomislag collected (5200)
Seat 4: StephGod30 (button) folded before Flop (didn't bet)
Seat 5: WhiteIce0328 (small blind) folded before Flop
Seat 6: nwmdnj (big blind) folded before Flop


*********** # 117 **************
PokerStars Hand #175477397351: Tournament #1701793695, $9.10+$0.90 USD =
Hold'em No Limit - Level XV (800/1600) - 2017/09/24 18:30:44 ET
Table '1701793695 7' 6-max Seat #5 is the button
Seat 1: JJin91 (107637 in chips)=20
Seat 2: Batzz88 (100234 in chips)=20
Seat 3: urmomislag (12800 in chips)=20
Seat 4: StephGod30 (53285 in chips)=20
Seat 5: WhiteIce0328 (122563 in chips)=20
Seat 6: nwmdnj (14600 in chips)=20
JJin91: posts the ante 200
Batzz88: posts the ante 200
urmomislag: posts the ante 200
StephGod30: posts the ante 200
WhiteIce0328: posts the ante 200
nwmdnj: posts the ante 200
nwmdnj: posts small blind 800
JJin91: posts big blind 1600
*** HOLE CARDS ***
Dealt to JJin91 [3h 3d]
Batzz88: folds=20
urmomislag: folds=20
StephGod30: raises 1600 to 3200
WhiteIce0328: folds=20
nwmdnj: folds=20
JJin91: calls 1600
*** FLOP *** [Kd 4d 6d]
JJin91: checks=20
StephGod30: checks=20
*** TURN *** [Kd 4d 6d] [5h]
JJin91: checks=20
StephGod30: bets 4200
JJin91: folds=20
Uncalled bet (4200) returned to StephGod30
StephGod30 collected 8400 from pot
StephGod30: doesn't show hand=20
*** SUMMARY ***
Total pot 8400 | Rake 0=20
Board [Kd 4d 6d 5h]
Seat 1: JJin91 (big blind) folded on the Turn
Seat 2: Batzz88 folded before Flop (didn't bet)
Seat 3: urmomislag folded before Flop (didn't bet)
Seat 4: StephGod30 collected (8400)
Seat 5: WhiteIce0328 (button) folded before Flop (didn't bet)
Seat 6: nwmdnj (small blind) folded before Flop


*********** # 118 **************
PokerStars Hand #175477397576: Tournament #1701793695, $9.10+$0.90 USD =
Hold'em No Limit - Level XV (800/1600) - 2017/09/24 18:31:32 ET
Table '1701793695 7' 6-max Seat #6 is the button
Seat 1: JJin91 (104237 in chips)=20
Seat 2: Batzz88 (100034 in chips)=20
Seat 3: urmomislag (12600 in chips)=20
Seat 4: StephGod30 (58285 in chips)=20
Seat 5: WhiteIce0328 (122363 in chips)=20
Seat 6: nwmdnj (13600 in chips)=20
JJin91: posts the ante 200
Batzz88: posts the ante 200
urmomislag: posts the ante 200
StephGod30: posts the ante 200
WhiteIce0328: posts the ante 200
nwmdnj: posts the ante 200
JJin91: posts small blind 800
Batzz88: posts big blind 1600
*** HOLE CARDS ***
Dealt to JJin91 [Jd 5h]
urmomislag: raises 10800 to 12400 and is all-in
StephGod30: folds=20
WhiteIce0328: folds=20
nwmdnj: folds=20
JJin91: folds=20
Batzz88: folds=20
Uncalled bet (10800) returned to urmomislag
urmomislag collected 5200 from pot
urmomislag: doesn't show hand=20
*** SUMMARY ***
Total pot 5200 | Rake 0=20
Seat 1: JJin91 (small blind) folded before Flop
Seat 2: Batzz88 (big blind) folded before Flop
Seat 3: urmomislag collected (5200)
Seat 4: StephGod30 folded before Flop (didn't bet)
Seat 5: WhiteIce0328 folded before Flop (didn't bet)
Seat 6: nwmdnj (button) folded before Flop (didn't bet)


*********** # 119 **************
PokerStars Hand #175477397692: Tournament #1701793695, $9.10+$0.90 USD =
Hold'em No Limit - Level XV (800/1600) - 2017/09/24 18:32:01 ET
Table '1701793695 7' 6-max Seat #1 is the button
Seat 1: JJin91 (103237 in chips)=20
Seat 2: Batzz88 (98234 in chips)=20
Seat 3: urmomislag (16000 in chips)=20
Seat 4: StephGod30 (58085 in chips)=20
Seat 5: WhiteIce0328 (122163 in chips)=20
Seat 6: nwmdnj (13400 in chips)=20
JJin91: posts the ante 200
Batzz88: posts the ante 200
urmomislag: posts the ante 200
StephGod30: posts the ante 200
WhiteIce0328: posts the ante 200
nwmdnj: posts the ante 200
Batzz88: posts small blind 800
urmomislag: posts big blind 1600
*** HOLE CARDS ***
Dealt to JJin91 [6c Qd]
StephGod30: folds=20
WhiteIce0328: folds=20
nwmdnj: folds=20
JJin91: folds=20
Batzz88: raises 96434 to 98034 and is all-in
urmomislag: folds=20
Uncalled bet (96434) returned to Batzz88
Batzz88 collected 4400 from pot
Batzz88: doesn't show hand=20
*** SUMMARY ***
Total pot 4400 | Rake 0=20
Seat 1: JJin91 (button) folded before Flop (didn't bet)
Seat 2: Batzz88 (small blind) collected (4400)
Seat 3: urmomislag (big blind) folded before Flop
Seat 4: StephGod30 folded before Flop (didn't bet)
Seat 5: WhiteIce0328 folded before Flop (didn't bet)
Seat 6: nwmdnj folded before Flop (didn't bet)


*********** # 120 **************
PokerStars Hand #175477397795: Tournament #1701793695, $9.10+$0.90 USD =
Hold'em No Limit - Level XV (800/1600) - 2017/09/24 18:32:21 ET
Table '1701793695 7' 6-max Seat #2 is the button
Seat 1: JJin91 (103037 in chips)=20
Seat 2: Batzz88 (100834 in chips)=20
Seat 3: urmomislag (14200 in chips)=20
Seat 4: StephGod30 (57885 in chips)=20
Seat 5: WhiteIce0328 (121963 in chips)=20
Seat 6: nwmdnj (13200 in chips)=20
JJin91: posts the ante 200
Batzz88: posts the ante 200
urmomislag: posts the ante 200
StephGod30: posts the ante 200
WhiteIce0328: posts the ante 200
nwmdnj: posts the ante 200
urmomislag: posts small blind 800
StephGod30: posts big blind 1600
*** HOLE CARDS ***
Dealt to JJin91 [Jc Jh]
WhiteIce0328: raises 1600 to 3200
nwmdnj: folds=20
JJin91: raises 8000 to 11200
Batzz88: folds=20
urmomislag: folds=20
StephGod30: folds=20
WhiteIce0328: folds=20
Uncalled bet (8000) returned to JJin91
JJin91 collected 10000 from pot
JJin91: doesn't show hand=20
*** SUMMARY ***
Total pot 10000 | Rake 0=20
Seat 1: JJin91 collected (10000)
Seat 2: Batzz88 (button) folded before Flop (didn't bet)
Seat 3: urmomislag (small blind) folded before Flop
Seat 4: StephGod30 (big blind) folded before Flop
Seat 5: WhiteIce0328 folded before Flop
Seat 6: nwmdnj folded before Flop (didn't bet)


*********** # 121 **************
PokerStars Hand #175477397943: Tournament #1701793695, $9.10+$0.90 USD =
Hold'em No Limit - Level XV (800/1600) - 2017/09/24 18:32:55 ET
Table '1701793695 7' 6-max Seat #3 is the button
Seat 1: JJin91 (109637 in chips)=20
Seat 2: Batzz88 (100634 in chips)=20
Seat 3: urmomislag (13200 in chips)=20
Seat 4: StephGod30 (56085 in chips)=20
Seat 5: WhiteIce0328 (118563 in chips)=20
Seat 6: nwmdnj (13000 in chips)=20
JJin91: posts the ante 200
Batzz88: posts the ante 200
urmomislag: posts the ante 200
StephGod30: posts the ante 200
WhiteIce0328: posts the ante 200
nwmdnj: posts the ante 200
StephGod30: posts small blind 800
WhiteIce0328: posts big blind 1600
*** HOLE CARDS ***
Dealt to JJin91 [Th 3s]
nwmdnj: folds=20
JJin91: folds=20
Batzz88: folds=20
urmomislag: folds=20
StephGod30: folds=20
Uncalled bet (800) returned to WhiteIce0328
WhiteIce0328 collected 2800 from pot
WhiteIce0328: doesn't show hand=20
*** SUMMARY ***
Total pot 2800 | Rake 0=20
Seat 1: JJin91 folded before Flop (didn't bet)
Seat 2: Batzz88 folded before Flop (didn't bet)
Seat 3: urmomislag (button) folded before Flop (didn't bet)
Seat 4: StephGod30 (small blind) folded before Flop
Seat 5: WhiteIce0328 (big blind) collected (2800)
Seat 6: nwmdnj folded before Flop (didn't bet)


*********** # 122 **************
PokerStars Hand #175477398026: Tournament #1701793695, $9.10+$0.90 USD =
Hold'em No Limit - Level XV (800/1600) - 2017/09/24 18:33:15 ET
Table '1701793695 7' 6-max Seat #4 is the button
Seat 1: JJin91 (109437 in chips)=20
Seat 2: Batzz88 (100434 in chips)=20
Seat 3: urmomislag (13000 in chips)=20
Seat 4: StephGod30 (55085 in chips)=20
Seat 5: WhiteIce0328 (120363 in chips)=20
Seat 6: nwmdnj (12800 in chips)=20
JJin91: posts the ante 200
Batzz88: posts the ante 200
urmomislag: posts the ante 200
StephGod30: posts the ante 200
WhiteIce0328: posts the ante 200
nwmdnj: posts the ante 200
WhiteIce0328: posts small blind 800
nwmdnj: posts big blind 1600
*** HOLE CARDS ***
Dealt to JJin91 [Td Th]
JJin91: raises 1872 to 3472
Batzz88: raises 6128 to 9600
urmomislag: folds=20
StephGod30: folds=20
WhiteIce0328: folds=20
nwmdnj: folds=20
JJin91: calls 6128
*** FLOP *** [6h Js 2c]
JJin91: bets 7998
Batzz88: folds=20
Uncalled bet (7998) returned to JJin91
JJin91 collected 22800 from pot
JJin91: doesn't show hand=20
*** SUMMARY ***
Total pot 22800 | Rake 0=20
Board [6h Js 2c]
Seat 1: JJin91 collected (22800)
Seat 2: Batzz88 folded on the Flop
Seat 3: urmomislag folded before Flop (didn't bet)
Seat 4: StephGod30 (button) folded before Flop (didn't bet)
Seat 5: WhiteIce0328 (small blind) folded before Flop
Seat 6: nwmdnj (big blind) folded before Flop


*********** # 123 **************
PokerStars Hand #175477398271: Tournament #1701793695, $9.10+$0.90 USD =
Hold'em No Limit - Level XV (800/1600) - 2017/09/24 18:34:10 ET
Table '1701793695 7' 6-max Seat #5 is the button
Seat 1: JJin91 (122437 in chips)=20
Seat 2: Batzz88 (90634 in chips)=20
Seat 3: urmomislag (12800 in chips)=20
Seat 4: StephGod30 (54885 in chips)=20
Seat 5: WhiteIce0328 (119363 in chips)=20
Seat 6: nwmdnj (11000 in chips)=20
JJin91: posts the ante 200
Batzz88: posts the ante 200
urmomislag: posts the ante 200
StephGod30: posts the ante 200
WhiteIce0328: posts the ante 200
nwmdnj: posts the ante 200
nwmdnj: posts small blind 800
JJin91: posts big blind 1600
*** HOLE CARDS ***
Dealt to JJin91 [9d Ks]
Batzz88: raises 2400 to 4000
urmomislag: folds=20
StephGod30: folds=20
WhiteIce0328: calls 4000
nwmdnj: folds=20
JJin91: calls 2400
*** FLOP *** [8h Qh 6d]
JJin91: checks=20
Batzz88: bets 6400
WhiteIce0328: folds=20
JJin91: folds=20
Uncalled bet (6400) returned to Batzz88
Batzz88 collected 14000 from pot
Batzz88: doesn't show hand=20
*** SUMMARY ***
Total pot 14000 | Rake 0=20
Board [8h Qh 6d]
Seat 1: JJin91 (big blind) folded on the Flop
Seat 2: Batzz88 collected (14000)
Seat 3: urmomislag folded before Flop (didn't bet)
Seat 4: StephGod30 folded before Flop (didn't bet)
Seat 5: WhiteIce0328 (button) folded on the Flop
Seat 6: nwmdnj (small blind) folded before Flop


*********** # 124 **************
PokerStars Hand #175477398458: Tournament #1701793695, $9.10+$0.90 USD =
Hold'em No Limit - Level XV (800/1600) - 2017/09/24 18:34:54 ET
Table '1701793695 7' 6-max Seat #6 is the button
Seat 1: JJin91 (118237 in chips)=20
Seat 2: Batzz88 (100434 in chips)=20
Seat 3: urmomislag (12600 in chips)=20
Seat 4: StephGod30 (54685 in chips)=20
Seat 6: nwmdnj (10000 in chips)=20
JJin91: posts the ante 200
Batzz88: posts the ante 200
urmomislag: posts the ante 200
StephGod30: posts the ante 200
nwmdnj: posts the ante 200
JJin91: posts small blind 800
Batzz88: posts big blind 1600
*** HOLE CARDS ***
Dealt to JJin91 [7d 6c]
urmomislag: folds=20
StephGod30: raises 1600 to 3200
nwmdnj: folds=20
JJin91: folds=20
Batzz88: calls 1600
*** FLOP *** [6d 3d 6h]
Batzz88: checks=20
StephGod30: bets 2870
Batzz88: calls 2870
*** TURN *** [6d 3d 6h] [3c]
Batzz88: checks=20
StephGod30: bets 8000
Batzz88: calls 8000
*** RIVER *** [6d 3d 6h 3c] [Js]
Batzz88: checks=20
StephGod30: bets 14970
Batzz88: calls 14970
*** SHOW DOWN ***
StephGod30: shows [Th Qh] (two pair, Sixes and Threes)
Batzz88: shows [Jc Ad] (two pair, Jacks and Sixes)
Batzz88 collected 59880 from pot
*** SUMMARY ***
Total pot 59880 | Rake 0=20
Board [6d 3d 6h 3c Js]
Seat 1: JJin91 (small blind) folded before Flop
Seat 2: Batzz88 (big blind) showed [Jc Ad] and won (59880) with two pai=
r, Jacks and Sixes
Seat 3: urmomislag folded before Flop (didn't bet)
Seat 4: StephGod30 showed [Th Qh] and lost with two pair, Sixes and Thr=
ees
Seat 6: nwmdnj (button) folded before Flop (didn't bet)


*********** # 125 **************
PokerStars Hand #175477398770: Tournament #1701793695, $9.10+$0.90 USD =
Hold'em No Limit - Level XV (800/1600) - 2017/09/24 18:36:09 ET
Table '1701793695 7' 6-max Seat #1 is the button
Seat 1: JJin91 (117237 in chips)=20
Seat 2: Batzz88 (131074 in chips)=20
Seat 3: urmomislag (12400 in chips)=20
Seat 4: StephGod30 (25445 in chips)=20
Seat 6: nwmdnj (9800 in chips)=20
JJin91: posts the ante 200
Batzz88: posts the ante 200
urmomislag: posts the ante 200
StephGod30: posts the ante 200
nwmdnj: posts the ante 200
Batzz88: posts small blind 800
urmomislag: posts big blind 1600
*** HOLE CARDS ***
Dealt to JJin91 [3s 5s]
StephGod30: folds=20
nwmdnj: raises 8000 to 9600 and is all-in
JJin91: folds=20
Batzz88: calls 8800
urmomislag: folds=20
*** FLOP *** [Jd Kd 3c]
*** TURN *** [Jd Kd 3c] [Kc]
*** RIVER *** [Jd Kd 3c Kc] [Ts]
*** SHOW DOWN ***
Batzz88: shows [Qc Qs] (two pair, Kings and Queens)
nwmdnj: shows [5h Ah] (a pair of Kings)
Batzz88 collected 21800 from pot
nwmdnj finished the tournament in 334th place
*** SUMMARY ***
Total pot 21800 | Rake 0=20
Board [Jd Kd 3c Kc Ts]
Seat 1: JJin91 (button) folded before Flop (didn't bet)
Seat 2: Batzz88 (small blind) showed [Qc Qs] and won (21800) with two p=
air, Kings and Queens
Seat 3: urmomislag (big blind) folded before Flop
Seat 4: StephGod30 folded before Flop (didn't bet)
Seat 6: nwmdnj showed [5h Ah] and lost with a pair of Kings


*********** # 126 **************
PokerStars Hand #175477398913: Tournament #1701793695, $9.10+$0.90 USD =
Hold'em No Limit - Level XVI (900/1800) - 2017/09/24 18:36:44 ET
Table '1701793695 7' 6-max Seat #2 is the button
Seat 1: JJin91 (117037 in chips)=20
Seat 2: Batzz88 (143074 in chips)=20
Seat 3: urmomislag (10600 in chips)=20
Seat 4: StephGod30 (25245 in chips)=20
Seat 5: PokerPayman (20000 in chips)=20
JJin91: posts the ante 225
Batzz88: posts the ante 225
urmomislag: posts the ante 225
StephGod30: posts the ante 225
PokerPayman: posts the ante 225
urmomislag: posts small blind 900
StephGod30: posts big blind 1800
*** HOLE CARDS ***
Dealt to JJin91 [8c Jc]
PokerPayman: folds=20
JJin91: raises 2106 to 3906
Batzz88: folds=20
urmomislag: raises 6469 to 10375 and is all-in
StephGod30: folds=20
JJin91: calls 6469
*** FLOP *** [5s Qh 9c]
*** TURN *** [5s Qh 9c] [Qs]
*** RIVER *** [5s Qh 9c Qs] [6s]
*** SHOW DOWN ***
urmomislag: shows [7d Ad] (a pair of Queens)
JJin91: shows [8c Jc] (a pair of Queens - lower kicker)
urmomislag collected 23675 from pot
*** SUMMARY ***
Total pot 23675 | Rake 0=20
Board [5s Qh 9c Qs 6s]
Seat 1: JJin91 showed [8c Jc] and lost with a pair of Queens
Seat 2: Batzz88 (button) folded before Flop (didn't bet)
Seat 3: urmomislag (small blind) showed [7d Ad] and won (23675) with a =
pair of Queens
Seat 4: StephGod30 (big blind) folded before Flop
Seat 5: PokerPayman folded before Flop (didn't bet)


*********** # 127 **************
PokerStars Hand #175477399069: Tournament #1701793695, $9.10+$0.90 USD =
Hold'em No Limit - Level XVI (900/1800) - 2017/09/24 18:37:27 ET
Table '1701793695 7' 6-max Seat #3 is the button
Seat 1: JJin91 (106437 in chips)=20
Seat 2: Batzz88 (142849 in chips)=20
Seat 3: urmomislag (23675 in chips)=20
Seat 4: StephGod30 (23220 in chips)=20
Seat 5: PokerPayman (19775 in chips)=20
JJin91: posts the ante 225
Batzz88: posts the ante 225
urmomislag: posts the ante 225
StephGod30: posts the ante 225
PokerPayman: posts the ante 225
StephGod30: posts small blind 900
PokerPayman: posts big blind 1800
*** HOLE CARDS ***
Dealt to JJin91 [Kh 5s]
JJin91: folds=20
Batzz88: folds=20
urmomislag: raises 21650 to 23450 and is all-in
StephGod30: calls 22095 and is all-in
PokerPayman: folds=20
Uncalled bet (455) returned to urmomislag
*** FLOP *** [5c Td 6s]
*** TURN *** [5c Td 6s] [Ks]
*** RIVER *** [5c Td 6s Ks] [7d]
*** SHOW DOWN ***
StephGod30: shows [Ad Kc] (a pair of Kings)
urmomislag: shows [Ah Th] (a pair of Tens)
StephGod30 collected 48915 from pot
*** SUMMARY ***
Total pot 48915 | Rake 0=20
Board [5c Td 6s Ks 7d]
Seat 1: JJin91 folded before Flop (didn't bet)
Seat 2: Batzz88 folded before Flop (didn't bet)
Seat 3: urmomislag (button) showed [Ah Th] and lost with a pair of Tens
Seat 4: StephGod30 (small blind) showed [Ad Kc] and won (48915) with a =
pair of Kings
Seat 5: PokerPayman (big blind) folded before Flop


*********** # 128 **************
PokerStars Hand #175477399185: Tournament #1701793695, $9.10+$0.90 USD =
Hold'em No Limit - Level XVI (900/1800) - 2017/09/24 18:37:54 ET
Table '1701793695 7' 6-max Seat #4 is the button
Seat 1: JJin91 (106212 in chips)=20
Seat 2: Batzz88 (142624 in chips)=20
Seat 3: urmomislag (455 in chips)=20
Seat 4: StephGod30 (48915 in chips)=20
Seat 5: PokerPayman (17750 in chips)=20
JJin91: posts the ante 225
Batzz88: posts the ante 225
urmomislag: posts the ante 225
StephGod30: posts the ante 225
PokerPayman: posts the ante 225
PokerPayman: posts small blind 900
JJin91: posts big blind 1800
*** HOLE CARDS ***
Dealt to JJin91 [Qd Kd]
Batzz88: folds=20
urmomislag: calls 230 and is all-in
StephGod30: folds=20
PokerPayman: calls 900
JJin91: checks=20
*** FLOP *** [2d 9d 4s]
PokerPayman: bets 2478
JJin91: raises 9911 to 12389
PokerPayman: folds=20
Uncalled bet (9911) returned to JJin91
*** TURN *** [2d 9d 4s] [Jh]
*** RIVER *** [2d 9d 4s Jh] [4d]
*** SHOW DOWN ***
JJin91: shows [Qd Kd] (a flush, King high)
JJin91 collected 8096 from side pot
urmomislag: shows [Kc 9c] (two pair, Nines and Fours)
JJin91 collected 1815 from main pot
urmomislag finished the tournament in 323rd place
*** SUMMARY ***
Total pot 9911 Main pot 1815. Side pot 8096. | Rake 0=20
Board [2d 9d 4s Jh 4d]
Seat 1: JJin91 (big blind) showed [Qd Kd] and won (9911) with a flush, =
King high
Seat 2: Batzz88 folded before Flop (didn't bet)
Seat 3: urmomislag showed [Kc 9c] and lost with two pair, Nines and Fou=
rs
Seat 4: StephGod30 (button) folded before Flop (didn't bet)
Seat 5: PokerPayman (small blind) folded on the Flop


*********** # 129 **************
PokerStars Hand #175477399375: Tournament #1701793695, $9.10+$0.90 USD =
Hold'em No Limit - Level XVI (900/1800) - 2017/09/24 18:38:45 ET
Table '1701793695 7' 6-max Seat #5 is the button
Seat 1: JJin91 (111620 in chips)=20
Seat 2: Batzz88 (142399 in chips)=20
Seat 4: StephGod30 (48690 in chips)=20
Seat 5: PokerPayman (13247 in chips)=20
Seat 6: senor stinks (13952 in chips) out of hand (moved from another t=
able into small blind)
JJin91: posts the ante 225
Batzz88: posts the ante 225
StephGod30: posts the ante 225
PokerPayman: posts the ante 225
JJin91: posts small blind 900
Batzz88: posts big blind 1800
*** HOLE CARDS ***
Dealt to JJin91 [Qs 3s]
StephGod30: raises 1800 to 3600
PokerPayman: folds=20
JJin91: folds=20
Batzz88: folds=20
Uncalled bet (1800) returned to StephGod30
StephGod30 collected 5400 from pot
StephGod30: doesn't show hand=20
*** SUMMARY ***
Total pot 5400 | Rake 0=20
Seat 1: JJin91 (small blind) folded before Flop
Seat 2: Batzz88 (big blind) folded before Flop
Seat 4: StephGod30 collected (5400)
Seat 5: PokerPayman (button) folded before Flop (didn't bet)


*********** # 130 **************
PokerStars Hand #175477399481: Tournament #1701793695, $9.10+$0.90 USD =
Hold'em No Limit - Level XVI (900/1800) - 2017/09/24 18:39:13 ET
Table '1701793695 7' 6-max Seat #1 is the button
Seat 1: JJin91 (110495 in chips)=20
Seat 2: Batzz88 (140374 in chips)=20
Seat 4: StephGod30 (52065 in chips)=20
Seat 5: PokerPayman (13022 in chips)=20
Seat 6: senor stinks (13952 in chips)=20
JJin91: posts the ante 225
Batzz88: posts the ante 225
StephGod30: posts the ante 225
PokerPayman: posts the ante 225
senor stinks: posts the ante 225
Batzz88: posts small blind 900
StephGod30: posts big blind 1800
*** HOLE CARDS ***
Dealt to JJin91 [7d 3c]
PokerPayman: raises 10997 to 12797 and is all-in
senor stinks: folds=20
JJin91: folds=20
Batzz88: calls 11897
StephGod30: folds=20
*** FLOP *** [2s 4s 9s]
*** TURN *** [2s 4s 9s] [9c]
*** RIVER *** [2s 4s 9s 9c] [4h]
*** SHOW DOWN ***
Batzz88: shows [9d 9h] (four of a kind, Nines)
PokerPayman: shows [8h 8d] (two pair, Nines and Eights)
Batzz88 collected 28519 from pot
PokerPayman finished the tournament in 320th place
*** SUMMARY ***
Total pot 28519 | Rake 0=20
Board [2s 4s 9s 9c 4h]
Seat 1: JJin91 (button) folded before Flop (didn't bet)
Seat 2: Batzz88 (small blind) showed [9d 9h] and won (28519) with four =
of a kind, Nines
Seat 4: StephGod30 (big blind) folded before Flop
Seat 5: PokerPayman showed [8h 8d] and lost with two pair, Nines and Ei=
ghts
Seat 6: senor stinks folded before Flop (didn't bet)


*********** # 131 **************
PokerStars Hand #175477399618: Tournament #1701793695, $9.10+$0.90 USD =
Hold'em No Limit - Level XVI (900/1800) - 2017/09/24 18:39:49 ET
Table '1701793695 7' 6-max Seat #2 is the button
Seat 1: JJin91 (110270 in chips)=20
Seat 2: Batzz88 (155871 in chips)=20
Seat 4: StephGod30 (50040 in chips)=20
Seat 6: senor stinks (13727 in chips)=20
JJin91: posts the ante 225
Batzz88: posts the ante 225
StephGod30: posts the ante 225
senor stinks: posts the ante 225
StephGod30: posts small blind 900
senor stinks: posts big blind 1800
*** HOLE CARDS ***
Dealt to JJin91 [8d 2c]
JJin91: folds=20
Batzz88: raises 1800 to 3600
StephGod30: folds=20
senor stinks: calls 1800
*** FLOP *** [Kh Th 8s]
senor stinks: checks=20
Batzz88: checks=20
*** TURN *** [Kh Th 8s] [2h]
senor stinks: bets 9902 and is all-in
Batzz88: calls 9902
*** RIVER *** [Kh Th 8s 2h] [As]
*** SHOW DOWN ***
senor stinks: shows [6s 9h] (high card Ace)
Batzz88: shows [7s 7h] (a pair of Sevens)
Batzz88 collected 28804 from pot
senor stinks finished the tournament in 316th place
*** SUMMARY ***
Total pot 28804 | Rake 0=20
Board [Kh Th 8s 2h As]
Seat 1: JJin91 folded before Flop (didn't bet)
Seat 2: Batzz88 (button) showed [7s 7h] and won (28804) with a pair of =
Sevens
Seat 4: StephGod30 (small blind) folded before Flop
Seat 6: senor stinks (big blind) showed [6s 9h] and lost with high card=
 Ace


*********** # 132 **************
PokerStars Hand #175477399802: Tournament #1701793695, $9.10+$0.90 USD =
Hold'em No Limit - Level XVI (900/1800) - 2017/09/24 18:40:38 ET
Table '1701793695 7' 6-max Seat #4 is the button
Seat 1: JJin91 (110045 in chips)=20
Seat 2: Batzz88 (170948 in chips)=20
Seat 3: CrazyCatGent (20000 in chips)=20
Seat 4: StephGod30 (48915 in chips)=20
Seat 5: PureWizardry (75878 in chips) out of hand (moved from another t=
able into small blind)
JJin91: posts the ante 225
Batzz88: posts the ante 225
CrazyCatGent: posts the ante 225
StephGod30: posts the ante 225
JJin91: posts small blind 900
Batzz88: posts big blind 1800
*** HOLE CARDS ***
Dealt to JJin91 [Ks 3d]
CrazyCatGent: folds=20
StephGod30: raises 1800 to 3600
JJin91: folds=20
Batzz88: calls 1800
*** FLOP *** [7s 6h 9d]
Batzz88: checks=20
StephGod30: checks=20
*** TURN *** [7s 6h 9d] [Jd]
Batzz88: checks=20
StephGod30: bets 4500
Batzz88: folds=20
Uncalled bet (4500) returned to StephGod30
StephGod30 collected 9000 from pot
StephGod30: doesn't show hand=20
*** SUMMARY ***
Total pot 9000 | Rake 0=20
Board [7s 6h 9d Jd]
Seat 1: JJin91 (small blind) folded before Flop
Seat 2: Batzz88 (big blind) folded on the Turn
Seat 3: CrazyCatGent folded before Flop (didn't bet)
Seat 4: StephGod30 (button) collected (9000)


*********** # 133 **************
PokerStars Hand #175477399968: Tournament #1701793695, $9.10+$0.90 USD =
Hold'em No Limit - Level XVI (900/1800) - 2017/09/24 18:41:21 ET
Table '1701793695 7' 6-max Seat #1 is the button
Seat 1: JJin91 (108920 in chips)=20
Seat 2: Batzz88 (167123 in chips)=20
Seat 3: CrazyCatGent (19775 in chips)=20
Seat 4: StephGod30 (54090 in chips)=20
Seat 5: PureWizardry (75878 in chips)=20
Seat 6: Seppy8 (20000 in chips)=20
JJin91: posts the ante 225
Batzz88: posts the ante 225
CrazyCatGent: posts the ante 225
StephGod30: posts the ante 225
PureWizardry: posts the ante 225
Seppy8: posts the ante 225
Batzz88: posts small blind 900
CrazyCatGent: posts big blind 1800
*** HOLE CARDS ***
Dealt to JJin91 [Kh Ks]
StephGod30: folds=20
PureWizardry: folds=20
Seppy8: raises 17975 to 19775 and is all-in
JJin91: calls 19775
Batzz88: folds=20
CrazyCatGent: calls 17750 and is all-in
*** FLOP *** [Js As 5c]
*** TURN *** [Js As 5c] [9h]
*** RIVER *** [Js As 5c 9h] [Kc]
*** SHOW DOWN ***
Seppy8: shows [Jc Jd] (three of a kind, Jacks)
JJin91: shows [Kh Ks] (three of a kind, Kings)
JJin91 collected 450 from side pot
CrazyCatGent: shows [7c 7d] (a pair of Sevens)
JJin91 collected 60900 from main pot
Seppy8 finished the tournament in 309th place
CrazyCatGent finished the tournament in 310th place
*** SUMMARY ***
Total pot 61350 Main pot 60900. Side pot 450. | Rake 0=20
Board [Js As 5c 9h Kc]
Seat 1: JJin91 (button) showed [Kh Ks] and won (61350) with three of a =
kind, Kings
Seat 2: Batzz88 (small blind) folded before Flop
Seat 3: CrazyCatGent (big blind) showed [7c 7d] and lost with a pair of=
 Sevens
Seat 4: StephGod30 folded before Flop (didn't bet)
Seat 5: PureWizardry folded before Flop (didn't bet)
Seat 6: Seppy8 showed [Jc Jd] and lost with three of a kind, Jacks


*********** # 134 **************
PokerStars Hand #175479432125: Tournament #1701793695, $9.10+$0.90 USD =
Hold'em No Limit - Level XVI (900/1800) - 2017/09/24 18:42:01 ET
Table '1701793695 7' 6-max Seat #2 is the button
Seat 1: JJin91 (150270 in chips)=20
Seat 2: Batzz88 (165998 in chips)=20
Seat 4: StephGod30 (53865 in chips)=20
Seat 5: PureWizardry (75653 in chips)=20
JJin91: posts the ante 225
Batzz88: posts the ante 225
StephGod30: posts the ante 225
PureWizardry: posts the ante 225
StephGod30: posts small blind 900
PureWizardry: posts big blind 1800
*** HOLE CARDS ***
Dealt to JJin91 [3c 4s]
JJin91: folds=20
Batzz88: raises 1800 to 3600
StephGod30: folds=20
PureWizardry: calls 1800
*** FLOP *** [6s 8c Tc]
PureWizardry: checks=20
Batzz88: checks=20
*** TURN *** [6s 8c Tc] [Qc]
PureWizardry: checks=20
Batzz88: checks=20
*** RIVER *** [6s 8c Tc Qc] [3h]
PureWizardry: checks=20
Batzz88: checks=20
*** SHOW DOWN ***
PureWizardry: shows [3s Ks] (a pair of Threes)
Batzz88: mucks hand=20
PureWizardry collected 9000 from pot
*** SUMMARY ***
Total pot 9000 | Rake 0=20
Board [6s 8c Tc Qc 3h]
Seat 1: JJin91 folded before Flop (didn't bet)
Seat 2: Batzz88 (button) mucked [9s As]
Seat 4: StephGod30 (small blind) folded before Flop
Seat 5: PureWizardry (big blind) showed [3s Ks] and won (9000) with a p=
air of Threes


*********** # 135 **************
PokerStars Hand #175479432235: Tournament #1701793695, $9.10+$0.90 USD =
Hold'em No Limit - Level XVI (900/1800) - 2017/09/24 18:42:29 ET
Table '1701793695 7' 6-max Seat #4 is the button
Seat 1: JJin91 (150045 in chips)=20
Seat 2: Batzz88 (162173 in chips)=20
Seat 3: CrazyCatGent (20000 in chips)=20
Seat 4: StephGod30 (52740 in chips)=20
Seat 5: PureWizardry (80828 in chips)=20
JJin91: posts the ante 225
Batzz88: posts the ante 225
CrazyCatGent: posts the ante 225
StephGod30: posts the ante 225
PureWizardry: posts the ante 225
PureWizardry: posts small blind 900
JJin91: posts big blind 1800
*** HOLE CARDS ***
Dealt to JJin91 [2s 3s]
Batzz88: folds=20
CrazyCatGent: raises 17975 to 19775 and is all-in
StephGod30: folds=20
PureWizardry: folds=20
JJin91: folds=20
Uncalled bet (17975) returned to CrazyCatGent
CrazyCatGent collected 5625 from pot
CrazyCatGent: doesn't show hand=20
*** SUMMARY ***
Total pot 5625 | Rake 0=20
Seat 1: JJin91 (big blind) folded before Flop
Seat 2: Batzz88 folded before Flop (didn't bet)
Seat 3: CrazyCatGent collected (5625)
Seat 4: StephGod30 (button) folded before Flop (didn't bet)
Seat 5: PureWizardry (small blind) folded before Flop


*********** # 136 **************
PokerStars Hand #175479432333: Tournament #1701793695, $9.10+$0.90 USD =
Hold'em No Limit - Level XVI (900/1800) - 2017/09/24 18:42:54 ET
Table '1701793695 7' 6-max Seat #5 is the button
Seat 1: JJin91 (148020 in chips)=20
Seat 2: Batzz88 (161948 in chips)=20
Seat 3: CrazyCatGent (23600 in chips)=20
Seat 4: StephGod30 (52515 in chips)=20
Seat 5: PureWizardry (79703 in chips)=20
JJin91: posts the ante 225
Batzz88: posts the ante 225
CrazyCatGent: posts the ante 225
StephGod30: posts the ante 225
PureWizardry: posts the ante 225
JJin91: posts small blind 900
Batzz88: posts big blind 1800
*** HOLE CARDS ***
Dealt to JJin91 [6d 8c]
CrazyCatGent: folds=20
StephGod30: folds=20
PureWizardry: raises 2520 to 4320
JJin91: folds=20
Batzz88: calls 2520
*** FLOP *** [Tc 9c 8d]
Batzz88: checks=20
PureWizardry: bets 6612
Batzz88: calls 6612
*** TURN *** [Tc 9c 8d] [Ks]
Batzz88: checks=20
PureWizardry: bets 14400
Batzz88: folds=20
Uncalled bet (14400) returned to PureWizardry
PureWizardry collected 23889 from pot
PureWizardry: doesn't show hand=20
*** SUMMARY ***
Total pot 23889 | Rake 0=20
Board [Tc 9c 8d Ks]
Seat 1: JJin91 (small blind) folded before Flop
Seat 2: Batzz88 (big blind) folded on the Turn
Seat 3: CrazyCatGent folded before Flop (didn't bet)
Seat 4: StephGod30 folded before Flop (didn't bet)
Seat 5: PureWizardry (button) collected (23889)


*********** # 137 **************
PokerStars Hand #175479432556: Tournament #1701793695, $9.10+$0.90 USD =
Hold'em No Limit - Level XVI (900/1800) - 2017/09/24 18:43:54 ET
Table '1701793695 7' 6-max Seat #1 is the button
Seat 1: JJin91 (146895 in chips)=20
Seat 2: Batzz88 (150791 in chips)=20
Seat 3: CrazyCatGent (23375 in chips)=20
Seat 4: StephGod30 (52290 in chips)=20
Seat 5: PureWizardry (92435 in chips)=20
Seat 6: Musketqueer3 (20000 in chips)=20
JJin91: posts the ante 225
Batzz88: posts the ante 225
CrazyCatGent: posts the ante 225
StephGod30: posts the ante 225
PureWizardry: posts the ante 225
Musketqueer3: posts the ante 225
Batzz88: posts small blind 900
CrazyCatGent: posts big blind 1800
*** HOLE CARDS ***
Dealt to JJin91 [Th Qd]
StephGod30: folds=20
PureWizardry: folds=20
Musketqueer3: folds=20
JJin91: raises 2106 to 3906
Batzz88: raises 10494 to 14400
CrazyCatGent: folds=20
JJin91: folds=20
Uncalled bet (10494) returned to Batzz88
Batzz88 collected 10962 from pot
Batzz88: doesn't show hand=20
*** SUMMARY ***
Total pot 10962 | Rake 0=20
Seat 1: JJin91 (button) folded before Flop
Seat 2: Batzz88 (small blind) collected (10962)
Seat 3: CrazyCatGent (big blind) folded before Flop
Seat 4: StephGod30 folded before Flop (didn't bet)
Seat 5: PureWizardry folded before Flop (didn't bet)
Seat 6: Musketqueer3 folded before Flop (didn't bet)


*********** # 138 **************
PokerStars Hand #175479432687: Tournament #1701793695, $9.10+$0.90 USD =
Hold'em No Limit - Level XVII (1000/2000) - 2017/09/24 18:44:30 ET
Table '1701793695 7' 6-max Seat #2 is the button
Seat 1: JJin91 (142764 in chips)=20
Seat 2: Batzz88 (157622 in chips)=20
Seat 3: CrazyCatGent (21350 in chips)=20
Seat 4: StephGod30 (52065 in chips)=20
Seat 5: PureWizardry (92210 in chips)=20
Seat 6: Musketqueer3 (19775 in chips)=20
JJin91: posts the ante 250
Batzz88: posts the ante 250
CrazyCatGent: posts the ante 250
StephGod30: posts the ante 250
PureWizardry: posts the ante 250
Musketqueer3: posts the ante 250
CrazyCatGent: posts small blind 1000
StephGod30: posts big blind 2000
*** HOLE CARDS ***
Dealt to JJin91 [4d 8c]
PureWizardry: folds=20
Musketqueer3: folds=20
JJin91: folds=20
Batzz88: folds=20
CrazyCatGent: folds=20
Uncalled bet (1000) returned to StephGod30
StephGod30 collected 3500 from pot
StephGod30: doesn't show hand=20
*** SUMMARY ***
Total pot 3500 | Rake 0=20
Seat 1: JJin91 folded before Flop (didn't bet)
Seat 2: Batzz88 (button) folded before Flop (didn't bet)
Seat 3: CrazyCatGent (small blind) folded before Flop
Seat 4: StephGod30 (big blind) collected (3500)
Seat 5: PureWizardry folded before Flop (didn't bet)
Seat 6: Musketqueer3 folded before Flop (didn't bet)


*********** # 139 **************
PokerStars Hand #175479432749: Tournament #1701793695, $9.10+$0.90 USD =
Hold'em No Limit - Level XVII (1000/2000) - 2017/09/24 18:44:47 ET
Table '1701793695 7' 6-max Seat #3 is the button
Seat 1: JJin91 (142514 in chips)=20
Seat 2: Batzz88 (157372 in chips)=20
Seat 3: CrazyCatGent (20100 in chips)=20
Seat 4: StephGod30 (54315 in chips)=20
Seat 5: PureWizardry (91960 in chips)=20
Seat 6: Musketqueer3 (19525 in chips)=20
JJin91: posts the ante 250
Batzz88: posts the ante 250
CrazyCatGent: posts the ante 250
StephGod30: posts the ante 250
PureWizardry: posts the ante 250
Musketqueer3: posts the ante 250
StephGod30: posts small blind 1000
PureWizardry: posts big blind 2000
*** HOLE CARDS ***
Dealt to JJin91 [5d 8s]
Musketqueer3: raises 2000 to 4000
JJin91: folds=20
Batzz88: raises 4000 to 8000
CrazyCatGent: raises 11850 to 19850 and is all-in
StephGod30: folds=20
PureWizardry: folds=20
Musketqueer3: calls 15275 and is all-in
Batzz88: calls 11850
*** FLOP *** [4s Ad Qh]
*** TURN *** [4s Ad Qh] [4d]
*** RIVER *** [4s Ad Qh 4d] [6d]
*** SHOW DOWN ***
Batzz88: shows [Kd As] (two pair, Aces and Fours)
CrazyCatGent: shows [7d 7s] (two pair, Sevens and Fours)
Batzz88 collected 1150 from side pot
Musketqueer3: shows [Jh Ah] (two pair, Aces and Fours - lower kicker)
Batzz88 collected 62325 from main pot
CrazyCatGent finished the tournament in 294th place
Musketqueer3 finished the tournament in 295th place
*** SUMMARY ***
Total pot 63475 Main pot 62325. Side pot 1150. | Rake 0=20
Board [4s Ad Qh 4d 6d]
Seat 1: JJin91 folded before Flop (didn't bet)
Seat 2: Batzz88 showed [Kd As] and won (63475) with two pair, Aces and =
Fours
Seat 3: CrazyCatGent (button) showed [7d 7s] and lost with two pair, Se=
vens and Fours
Seat 4: StephGod30 (small blind) folded before Flop
Seat 5: PureWizardry (big blind) folded before Flop
Seat 6: Musketqueer3 showed [Jh Ah] and lost with two pair, Aces and Fo=
urs


*********** # 140 **************
PokerStars Hand #175479432896: Tournament #1701793695, $9.10+$0.90 USD =
Hold'em No Limit - Level XVII (1000/2000) - 2017/09/24 18:45:25 ET
Table '1701793695 3' 6-max Seat #5 is the button
Seat 1: CR8TVT2 (16675 in chips)=20
Seat 2: JJin91 (142264 in chips)=20
Seat 3: TobogganM.D. (31739 in chips)=20
Seat 4: nwmdnj (16600 in chips)=20
Seat 5: pokerMJ (116273 in chips)=20
Seat 6: YogaGrandma (33625 in chips)=20
CR8TVT2: posts the ante 250
JJin91: posts the ante 250
TobogganM.D.: posts the ante 250
nwmdnj: posts the ante 250
pokerMJ: posts the ante 250
YogaGrandma: posts the ante 250
YogaGrandma: posts small blind 1000
CR8TVT2: posts big blind 2000
*** HOLE CARDS ***
Dealt to JJin91 [5d Qs]
JJin91: folds=20
TobogganM.D.: folds=20
nwmdnj: folds=20
pokerMJ: folds=20
YogaGrandma: raises 31375 to 33375 and is all-in
CR8TVT2: folds=20
Uncalled bet (31375) returned to YogaGrandma
YogaGrandma collected 5500 from pot
YogaGrandma: doesn't show hand=20
*** SUMMARY ***
Total pot 5500 | Rake 0=20
Seat 1: CR8TVT2 (big blind) folded before Flop
Seat 2: JJin91 folded before Flop (didn't bet)
Seat 3: TobogganM.D. folded before Flop (didn't bet)
Seat 4: nwmdnj folded before Flop (didn't bet)
Seat 5: pokerMJ (button) folded before Flop (didn't bet)
Seat 6: YogaGrandma (small blind) collected (5500)


*********** # 141 **************
PokerStars Hand #175479432997: Tournament #1701793695, $9.10+$0.90 USD =
Hold'em No Limit - Level XVII (1000/2000) - 2017/09/24 18:45:53 ET
Table '1701793695 3' 6-max Seat #6 is the button
Seat 1: CR8TVT2 (14425 in chips)=20
Seat 2: JJin91 (142014 in chips)=20
Seat 3: TobogganM.D. (31489 in chips)=20
Seat 4: nwmdnj (16350 in chips)=20
Seat 5: pokerMJ (116023 in chips)=20
Seat 6: YogaGrandma (36875 in chips)=20
CR8TVT2: posts the ante 250
JJin91: posts the ante 250
TobogganM.D.: posts the ante 250
nwmdnj: posts the ante 250
pokerMJ: posts the ante 250
YogaGrandma: posts the ante 250
CR8TVT2: posts small blind 1000
JJin91: posts big blind 2000
*** HOLE CARDS ***
Dealt to JJin91 [5s Qh]
TobogganM.D.: folds=20
nwmdnj: folds=20
pokerMJ: folds=20
YogaGrandma: folds=20
CR8TVT2: calls 1000
JJin91: checks=20
*** FLOP *** [Kh 2c Js]
CR8TVT2: bets 2000
JJin91: calls 2000
*** TURN *** [Kh 2c Js] [4h]
CR8TVT2: bets 10175 and is all-in
JJin91: folds=20
Uncalled bet (10175) returned to CR8TVT2
CR8TVT2 collected 9500 from pot
*** SUMMARY ***
Total pot 9500 | Rake 0=20
Board [Kh 2c Js 4h]
Seat 1: CR8TVT2 (small blind) collected (9500)
Seat 2: JJin91 (big blind) folded on the Turn
Seat 3: TobogganM.D. folded before Flop (didn't bet)
Seat 4: nwmdnj folded before Flop (didn't bet)
Seat 5: pokerMJ folded before Flop (didn't bet)
Seat 6: YogaGrandma (button) folded before Flop (didn't bet)


*********** # 142 **************
PokerStars Hand #175479433242: Tournament #1701793695, $9.10+$0.90 USD =
Hold'em No Limit - Level XVII (1000/2000) - 2017/09/24 18:46:57 ET
Table '1701793695 3' 6-max Seat #1 is the button
Seat 1: CR8TVT2 (19675 in chips)=20
Seat 2: JJin91 (137764 in chips)=20
Seat 4: nwmdnj (16100 in chips)=20
Seat 5: pokerMJ (115773 in chips)=20
Seat 6: YogaGrandma (36625 in chips)=20
CR8TVT2: posts the ante 250
JJin91: posts the ante 250
nwmdnj: posts the ante 250
pokerMJ: posts the ante 250
YogaGrandma: posts the ante 250
JJin91: posts small blind 1000
nwmdnj: posts big blind 2000
*** HOLE CARDS ***
Dealt to JJin91 [Js 7d]
pokerMJ: folds=20
YogaGrandma: folds=20
CR8TVT2: folds=20
JJin91: raises 135514 to 137514 and is all-in
nwmdnj: folds=20
Uncalled bet (135514) returned to JJin91
JJin91 collected 5250 from pot
JJin91: doesn't show hand=20
*** SUMMARY ***
Total pot 5250 | Rake 0=20
Seat 1: CR8TVT2 (button) folded before Flop (didn't bet)
Seat 2: JJin91 (small blind) collected (5250)
Seat 4: nwmdnj (big blind) folded before Flop
Seat 5: pokerMJ folded before Flop (didn't bet)
Seat 6: YogaGrandma folded before Flop (didn't bet)


*********** # 143 **************
PokerStars Hand #175479433384: Tournament #1701793695, $9.10+$0.90 USD =
Hold'em No Limit - Level XVII (1000/2000) - 2017/09/24 18:47:33 ET
Table '1701793695 3' 6-max Seat #2 is the button
Seat 1: CR8TVT2 (19425 in chips)=20
Seat 2: JJin91 (140764 in chips)=20
Seat 4: nwmdnj (13850 in chips)=20
Seat 5: pokerMJ (115523 in chips)=20
Seat 6: YogaGrandma (36375 in chips)=20
CR8TVT2: posts the ante 250
JJin91: posts the ante 250
nwmdnj: posts the ante 250
pokerMJ: posts the ante 250
YogaGrandma: posts the ante 250
nwmdnj: posts small blind 1000
pokerMJ: posts big blind 2000
*** HOLE CARDS ***
Dealt to JJin91 [2c 5d]
YogaGrandma: folds=20
CR8TVT2: folds=20
JJin91: folds=20
nwmdnj: raises 11600 to 13600 and is all-in
pokerMJ: folds=20
Uncalled bet (11600) returned to nwmdnj
nwmdnj collected 5250 from pot
nwmdnj: doesn't show hand=20
*** SUMMARY ***
Total pot 5250 | Rake 0=20
Seat 1: CR8TVT2 folded before Flop (didn't bet)
Seat 2: JJin91 (button) folded before Flop (didn't bet)
Seat 4: nwmdnj (small blind) collected (5250)
Seat 5: pokerMJ (big blind) folded before Flop
Seat 6: YogaGrandma folded before Flop (didn't bet)


*********** # 144 **************
PokerStars Hand #175479433506: Tournament #1701793695, $9.10+$0.90 USD =
Hold'em No Limit - Level XVII (1000/2000) - 2017/09/24 18:48:02 ET
Table '1701793695 3' 6-max Seat #4 is the button
Seat 1: CR8TVT2 (19175 in chips)=20
Seat 2: JJin91 (140514 in chips)=20
Seat 3: dcspada (66925 in chips)=20
Seat 4: nwmdnj (16850 in chips)=20
Seat 5: pokerMJ (113273 in chips)=20
Seat 6: YogaGrandma (36125 in chips)=20
CR8TVT2: posts the ante 250
JJin91: posts the ante 250
dcspada: posts the ante 250
nwmdnj: posts the ante 250
pokerMJ: posts the ante 250
YogaGrandma: posts the ante 250
pokerMJ: posts small blind 1000
YogaGrandma: posts big blind 2000
*** HOLE CARDS ***
Dealt to JJin91 [Kc 4s]
CR8TVT2: calls 2000
JJin91: folds=20
dcspada: folds=20
nwmdnj: folds=20
pokerMJ: folds=20
YogaGrandma: raises 4000 to 6000
CR8TVT2: raises 12925 to 18925 and is all-in
YogaGrandma: calls 12925
*** FLOP *** [4c 7c 6d]
*** TURN *** [4c 7c 6d] [Ts]
*** RIVER *** [4c 7c 6d Ts] [4h]
*** SHOW DOWN ***
YogaGrandma: shows [Ah Ac] (two pair, Aces and Fours)
CR8TVT2: shows [9c 9h] (two pair, Nines and Fours)
YogaGrandma collected 40350 from pot
CR8TVT2 finished the tournament in 275th place
*** SUMMARY ***
Total pot 40350 | Rake 0=20
Board [4c 7c 6d Ts 4h]
Seat 1: CR8TVT2 showed [9c 9h] and lost with two pair, Nines and Fours
Seat 2: JJin91 folded before Flop (didn't bet)
Seat 3: dcspada folded before Flop (didn't bet)
Seat 4: nwmdnj (button) folded before Flop (didn't bet)
Seat 5: pokerMJ (small blind) folded before Flop
Seat 6: YogaGrandma (big blind) showed [Ah Ac] and won (40350) with two=
 pair, Aces and Fours


*********** # 145 **************
PokerStars Hand #175479433855: Tournament #1701793695, $9.10+$0.90 USD =
Hold'em No Limit - Level XVII (1000/2000) - 2017/09/24 18:49:25 ET
Table '1701793695 3' 6-max Seat #5 is the button
Seat 2: JJin91 (140264 in chips)=20
Seat 3: dcspada (66675 in chips)=20
Seat 4: nwmdnj (16600 in chips)=20
Seat 5: pokerMJ (112023 in chips)=20
Seat 6: YogaGrandma (57300 in chips)=20
JJin91: posts the ante 250
dcspada: posts the ante 250
nwmdnj: posts the ante 250
pokerMJ: posts the ante 250
YogaGrandma: posts the ante 250
YogaGrandma: posts small blind 1000
JJin91: posts big blind 2000
*** HOLE CARDS ***
Dealt to JJin91 [9h Th]
dcspada: folds=20
nwmdnj: folds=20
pokerMJ: raises 2000 to 4000
YogaGrandma: folds=20
JJin91: calls 2000
*** FLOP *** [3d 7c 6c]
JJin91: bets 3793
pokerMJ: raises 12873 to 16666
JJin91: folds=20
Uncalled bet (12873) returned to pokerMJ
pokerMJ collected 17836 from pot
pokerMJ: doesn't show hand=20
*** SUMMARY ***
Total pot 17836 | Rake 0=20
Board [3d 7c 6c]
Seat 2: JJin91 (big blind) folded on the Flop
Seat 3: dcspada folded before Flop (didn't bet)
Seat 4: nwmdnj folded before Flop (didn't bet)
Seat 5: pokerMJ (button) collected (17836)
Seat 6: YogaGrandma (small blind) folded before Flop


*********** # 146 **************
PokerStars Hand #175479434012: Tournament #1701793695, $9.10+$0.90 USD =
Hold'em No Limit - Level XVII (1000/2000) - 2017/09/24 18:50:07 ET
Table '1701793695 3' 6-max Seat #6 is the button
Seat 2: JJin91 (132221 in chips)=20
Seat 3: dcspada (66425 in chips)=20
Seat 4: nwmdnj (16350 in chips)=20
Seat 5: pokerMJ (121816 in chips)=20
Seat 6: YogaGrandma (56050 in chips)=20
JJin91: posts the ante 250
dcspada: posts the ante 250
nwmdnj: posts the ante 250
pokerMJ: posts the ante 250
YogaGrandma: posts the ante 250
JJin91: posts small blind 1000
dcspada: posts big blind 2000
*** HOLE CARDS ***
Dealt to JJin91 [3s 4h]
nwmdnj: folds=20
pokerMJ: folds=20
YogaGrandma: folds=20
JJin91: folds=20
Uncalled bet (1000) returned to dcspada
dcspada collected 3250 from pot
dcspada: doesn't show hand=20
*** SUMMARY ***
Total pot 3250 | Rake 0=20
Seat 2: JJin91 (small blind) folded before Flop
Seat 3: dcspada (big blind) collected (3250)
Seat 4: nwmdnj folded before Flop (didn't bet)
Seat 5: pokerMJ folded before Flop (didn't bet)
Seat 6: YogaGrandma (button) folded before Flop (didn't bet)


*********** # 147 **************
PokerStars Hand #175479434078: Tournament #1701793695, $9.10+$0.90 USD =
Hold'em No Limit - Level XVII (1000/2000) - 2017/09/24 18:50:23 ET
Table '1701793695 3' 6-max Seat #2 is the button
Seat 2: JJin91 (130971 in chips)=20
Seat 3: dcspada (68425 in chips)=20
Seat 4: nwmdnj (16100 in chips)=20
Seat 5: pokerMJ (121566 in chips)=20
Seat 6: YogaGrandma (55800 in chips)=20
JJin91: posts the ante 250
dcspada: posts the ante 250
nwmdnj: posts the ante 250
pokerMJ: posts the ante 250
YogaGrandma: posts the ante 250
dcspada: posts small blind 1000
nwmdnj: posts big blind 2000
*** HOLE CARDS ***
Dealt to JJin91 [Th 3s]
pokerMJ: raises 2000 to 4000
YogaGrandma: folds=20
JJin91: folds=20
dcspada: folds=20
nwmdnj: folds=20
Uncalled bet (2000) returned to pokerMJ
pokerMJ collected 6250 from pot
pokerMJ: doesn't show hand=20
*** SUMMARY ***
Total pot 6250 | Rake 0=20
Seat 2: JJin91 (button) folded before Flop (didn't bet)
Seat 3: dcspada (small blind) folded before Flop
Seat 4: nwmdnj (big blind) folded before Flop
Seat 5: pokerMJ collected (6250)
Seat 6: YogaGrandma folded before Flop (didn't bet)


*********** # 148 **************
PokerStars Hand #175479434183: Tournament #1701793695, $9.10+$0.90 USD =
Hold'em No Limit - Level XVII (1000/2000) - 2017/09/24 18:50:48 ET
Table '1701793695 3' 6-max Seat #3 is the button
Seat 2: JJin91 (130721 in chips)=20
Seat 3: dcspada (67175 in chips)=20
Seat 4: nwmdnj (13850 in chips)=20
Seat 5: pokerMJ (125566 in chips)=20
Seat 6: YogaGrandma (55550 in chips)=20
JJin91: posts the ante 250
dcspada: posts the ante 250
nwmdnj: posts the ante 250
pokerMJ: posts the ante 250
YogaGrandma: posts the ante 250
nwmdnj: posts small blind 1000
pokerMJ: posts big blind 2000
*** HOLE CARDS ***
Dealt to JJin91 [4s Kh]
YogaGrandma: raises 3000 to 5000
JJin91: folds=20
dcspada: folds=20
nwmdnj: folds=20
pokerMJ: folds=20
Uncalled bet (3000) returned to YogaGrandma
YogaGrandma collected 6250 from pot
YogaGrandma: doesn't show hand=20
*** SUMMARY ***
Total pot 6250 | Rake 0=20
Seat 2: JJin91 folded before Flop (didn't bet)
Seat 3: dcspada (button) folded before Flop (didn't bet)
Seat 4: nwmdnj (small blind) folded before Flop
Seat 5: pokerMJ (big blind) folded before Flop
Seat 6: YogaGrandma collected (6250)


*********** # 149 **************
PokerStars Hand #175479434264: Tournament #1701793695, $9.10+$0.90 USD =
Hold'em No Limit - Level XVII (1000/2000) - 2017/09/24 18:51:10 ET
Table '1701793695 3' 6-max Seat #4 is the button
Seat 2: JJin91 (130471 in chips)=20
Seat 3: dcspada (66925 in chips)=20
Seat 4: nwmdnj (12600 in chips)=20
Seat 5: pokerMJ (123316 in chips)=20
Seat 6: YogaGrandma (59550 in chips)=20
JJin91: posts the ante 250
dcspada: posts the ante 250
nwmdnj: posts the ante 250
pokerMJ: posts the ante 250
YogaGrandma: posts the ante 250
pokerMJ: posts small blind 1000
YogaGrandma: posts big blind 2000
*** HOLE CARDS ***
Dealt to JJin91 [Qc Qd]
JJin91: raises 2340 to 4340
dcspada: folds=20
nwmdnj: folds=20
pokerMJ: folds=20
YogaGrandma: calls 2340
*** FLOP *** [3c 2h Qs]
YogaGrandma: checks=20
JJin91: checks=20
*** TURN *** [3c 2h Qs] [9c]
YogaGrandma: bets 3826
JJin91: calls 3826
*** RIVER *** [3c 2h Qs 9c] [4d]
YogaGrandma: checks=20
JJin91: bets 15555
YogaGrandma: calls 15555
*** SHOW DOWN ***
JJin91: shows [Qc Qd] (three of a kind, Queens)
YogaGrandma: mucks hand=20
JJin91 collected 49692 from pot
*** SUMMARY ***
Total pot 49692 | Rake 0=20
Board [3c 2h Qs 9c 4d]
Seat 2: JJin91 showed [Qc Qd] and won (49692) with three of a kind, Que=
ens
Seat 3: dcspada folded before Flop (didn't bet)
Seat 4: nwmdnj (button) folded before Flop (didn't bet)
Seat 5: pokerMJ (small blind) folded before Flop
Seat 6: YogaGrandma (big blind) mucked [7h 7d]


*********** # 150 **************
PokerStars Hand #175479434470: Tournament #1701793695, $9.10+$0.90 USD =
Hold'em No Limit - Level XVII (1000/2000) - 2017/09/24 18:52:05 ET
Table '1701793695 3' 6-max Seat #5 is the button
Seat 2: JJin91 (156192 in chips)=20
Seat 3: dcspada (66675 in chips)=20
Seat 4: nwmdnj (12350 in chips)=20
Seat 5: pokerMJ (122066 in chips)=20
Seat 6: YogaGrandma (35579 in chips)=20
JJin91: posts the ante 250
dcspada: posts the ante 250
nwmdnj: posts the ante 250
pokerMJ: posts the ante 250
YogaGrandma: posts the ante 250
YogaGrandma: posts small blind 1000
JJin91: posts big blind 2000
*** HOLE CARDS ***
Dealt to JJin91 [2s 9c]
dcspada: folds=20
nwmdnj: folds=20
pokerMJ: raises 2000 to 4000
YogaGrandma: raises 31329 to 35329 and is all-in
JJin91: folds=20
pokerMJ: folds=20
Uncalled bet (31329) returned to YogaGrandma
YogaGrandma collected 11250 from pot
*** SUMMARY ***
Total pot 11250 | Rake 0=20
Seat 2: JJin91 (big blind) folded before Flop
Seat 3: dcspada folded before Flop (didn't bet)
Seat 4: nwmdnj folded before Flop (didn't bet)
Seat 5: pokerMJ (button) folded before Flop
Seat 6: YogaGrandma (small blind) collected (11250)


*********** # 151 **************
PokerStars Hand #175479434550: Tournament #1701793695, $9.10+$0.90 USD =
Hold'em No Limit - Level XVIII (1200/2400) - 2017/09/24 18:52:26 ET
Table '1701793695 3' 6-max Seat #6 is the button
Seat 1: mocbel (20000 in chips) out of hand (moved from another table i=
nto small blind)
Seat 2: JJin91 (153942 in chips)=20
Seat 3: dcspada (66425 in chips)=20
Seat 4: nwmdnj (12100 in chips)=20
Seat 5: pokerMJ (117816 in chips)=20
Seat 6: YogaGrandma (42579 in chips)=20
JJin91: posts the ante 300
dcspada: posts the ante 300
nwmdnj: posts the ante 300
pokerMJ: posts the ante 300
YogaGrandma: posts the ante 300
JJin91: posts small blind 1200
dcspada: posts big blind 2400
*** HOLE CARDS ***
Dealt to JJin91 [6h As]
nwmdnj: folds=20
pokerMJ: folds=20
YogaGrandma: folds=20
JJin91: calls 1200
dcspada: checks=20
*** FLOP *** [Tc Js Td]
JJin91: checks=20
dcspada: checks=20
*** TURN *** [Tc Js Td] [Jc]
JJin91: checks=20
dcspada: bets 2400
JJin91: calls 2400
*** RIVER *** [Tc Js Td Jc] [Ac]
JJin91: checks=20
dcspada: bets 7200
JJin91: calls 7200
*** SHOW DOWN ***
dcspada: shows [6d Jd] (a full house, Jacks full of Tens)
JJin91: mucks hand=20
dcspada collected 25500 from pot
*** SUMMARY ***
Total pot 25500 | Rake 0=20
Board [Tc Js Td Jc Ac]
Seat 2: JJin91 (small blind) mucked [6h As]
Seat 3: dcspada (big blind) showed [6d Jd] and won (25500) with a full =
house, Jacks full of Tens
Seat 4: nwmdnj folded before Flop (didn't bet)
Seat 5: pokerMJ folded before Flop (didn't bet)
Seat 6: YogaGrandma (button) folded before Flop (didn't bet)


*********** # 152 **************
PokerStars Hand #175479434835: Tournament #1701793695, $9.10+$0.90 USD =
Hold'em No Limit - Level XVIII (1200/2400) - 2017/09/24 18:53:37 ET
Table '1701793695 3' 6-max Seat #2 is the button
Seat 1: mocbel (20000 in chips)=20
Seat 2: JJin91 (141642 in chips)=20
Seat 3: dcspada (79625 in chips)=20
Seat 4: nwmdnj (11800 in chips)=20
Seat 5: pokerMJ (117516 in chips)=20
Seat 6: YogaGrandma (42279 in chips)=20
mocbel: posts the ante 300
JJin91: posts the ante 300
dcspada: posts the ante 300
nwmdnj: posts the ante 300
pokerMJ: posts the ante 300
YogaGrandma: posts the ante 300
dcspada: posts small blind 1200
nwmdnj: posts big blind 2400
*** HOLE CARDS ***
Dealt to JJin91 [4d Qd]
pokerMJ: folds=20
YogaGrandma: folds=20
mocbel: raises 17300 to 19700 and is all-in
JJin91: folds=20
dcspada: folds=20
nwmdnj: folds=20
Uncalled bet (17300) returned to mocbel
mocbel collected 7800 from pot
*** SUMMARY ***
Total pot 7800 | Rake 0=20
Seat 1: mocbel collected (7800)
Seat 2: JJin91 (button) folded before Flop (didn't bet)
Seat 3: dcspada (small blind) folded before Flop
Seat 4: nwmdnj (big blind) folded before Flop
Seat 5: pokerMJ folded before Flop (didn't bet)
Seat 6: YogaGrandma folded before Flop (didn't bet)


*********** # 153 **************
PokerStars Hand #175479434979: Tournament #1701793695, $9.10+$0.90 USD =
Hold'em No Limit - Level XVIII (1200/2400) - 2017/09/24 18:54:16 ET
Table '1701793695 3' 6-max Seat #3 is the button
Seat 1: mocbel (25100 in chips)=20
Seat 2: JJin91 (141342 in chips)=20
Seat 3: dcspada (78125 in chips)=20
Seat 4: nwmdnj (9100 in chips)=20
Seat 5: pokerMJ (117216 in chips)=20
Seat 6: YogaGrandma (41979 in chips)=20
mocbel: posts the ante 300
JJin91: posts the ante 300
dcspada: posts the ante 300
nwmdnj: posts the ante 300
pokerMJ: posts the ante 300
YogaGrandma: posts the ante 300
nwmdnj: posts small blind 1200
pokerMJ: posts big blind 2400
*** HOLE CARDS ***
Dealt to JJin91 [2s 7c]
YogaGrandma: folds=20
mocbel: folds=20
JJin91: folds=20
dcspada: folds=20
nwmdnj: raises 6400 to 8800 and is all-in
pokerMJ: calls 6400
*** FLOP *** [7h 8c 3h]
*** TURN *** [7h 8c 3h] [3d]
*** RIVER *** [7h 8c 3h 3d] [Qd]
*** SHOW DOWN ***
nwmdnj: shows [Tc Ks] (a pair of Threes)
pokerMJ: shows [Ad Jc] (a pair of Threes - Ace kicker)
pokerMJ collected 19400 from pot
nwmdnj finished the tournament in 251st place
*** SUMMARY ***
Total pot 19400 | Rake 0=20
Board [7h 8c 3h 3d Qd]
Seat 1: mocbel folded before Flop (didn't bet)
Seat 2: JJin91 folded before Flop (didn't bet)
Seat 3: dcspada (button) folded before Flop (didn't bet)
Seat 4: nwmdnj (small blind) showed [Tc Ks] and lost with a pair of Thr=
ees
Seat 5: pokerMJ (big blind) showed [Ad Jc] and won (19400) with a pair =
of Threes
Seat 6: YogaGrandma folded before Flop (didn't bet)


*********** # 154 **************
PokerStars Hand #175479435094: Tournament #1701793695, $9.10+$0.90 USD =
Hold'em No Limit - Level XVIII (1200/2400) - 2017/09/24 18:54:43 ET
Table '1701793695 3' 6-max Seat #5 is the button
Seat 1: mocbel (24800 in chips)=20
Seat 2: JJin91 (141042 in chips)=20
Seat 3: dcspada (77825 in chips)=20
Seat 5: pokerMJ (127516 in chips)=20
Seat 6: YogaGrandma (41679 in chips)=20
mocbel: posts the ante 300
JJin91: posts the ante 300
dcspada: posts the ante 300
pokerMJ: posts the ante 300
YogaGrandma: posts the ante 300
YogaGrandma: posts small blind 1200
mocbel: posts big blind 2400
*** HOLE CARDS ***
Dealt to JJin91 [Th 6s]
JJin91: folds=20
dcspada: raises 2400 to 4800
pokerMJ: folds=20
YogaGrandma: folds=20
mocbel: calls 2400
*** FLOP *** [Qh Ks 2c]
mocbel: checks=20
dcspada: bets 4800
mocbel: folds=20
Uncalled bet (4800) returned to dcspada
dcspada collected 12300 from pot
dcspada: doesn't show hand=20
*** SUMMARY ***
Total pot 12300 | Rake 0=20
Board [Qh Ks 2c]
Seat 1: mocbel (big blind) folded on the Flop
Seat 2: JJin91 folded before Flop (didn't bet)
Seat 3: dcspada collected (12300)
Seat 5: pokerMJ (button) folded before Flop (didn't bet)
Seat 6: YogaGrandma (small blind) folded before Flop


*********** # 155 **************
PokerStars Hand #175479435173: Tournament #1701793695, $9.10+$0.90 USD =
Hold'em No Limit - Level XVIII (1200/2400) - 2017/09/24 18:55:05 ET
Table '1701793695 3' 6-max Seat #6 is the button
Seat 1: mocbel (19700 in chips)=20
Seat 2: JJin91 (140742 in chips)=20
Seat 3: dcspada (85025 in chips)=20
Seat 4: BENZBMW (20000 in chips)=20
Seat 5: pokerMJ (127216 in chips)=20
Seat 6: YogaGrandma (40179 in chips)=20
mocbel: posts the ante 300
JJin91: posts the ante 300
dcspada: posts the ante 300
BENZBMW: posts the ante 300
pokerMJ: posts the ante 300
YogaGrandma: posts the ante 300
mocbel: posts small blind 1200
JJin91: posts big blind 2400
*** HOLE CARDS ***
Dealt to JJin91 [As Kh]
dcspada: folds=20
BENZBMW: calls 2400
pokerMJ: folds=20
YogaGrandma: folds=20
mocbel: calls 1200
JJin91: raises 138042 to 140442 and is all-in
BENZBMW: folds=20
mocbel: folds=20
Uncalled bet (138042) returned to JJin91
JJin91 collected 9000 from pot
JJin91: doesn't show hand=20
*** SUMMARY ***
Total pot 9000 | Rake 0=20
Seat 1: mocbel (small blind) folded before Flop
Seat 2: JJin91 (big blind) collected (9000)
Seat 3: dcspada folded before Flop (didn't bet)
Seat 4: BENZBMW folded before Flop
Seat 5: pokerMJ folded before Flop (didn't bet)
Seat 6: YogaGrandma (button) folded before Flop (didn't bet)


*********** # 156 **************
PokerStars Hand #175479436106: Tournament #1701793695, $9.10+$0.90 USD =
Hold'em No Limit - Level XVIII (1200/2400) - 2017/09/24 19:00:50 ET
Table '1701793695 3' 6-max Seat #1 is the button
Seat 1: mocbel (17000 in chips)=20
Seat 2: JJin91 (147042 in chips)=20
Seat 3: dcspada (84725 in chips)=20
Seat 4: BENZBMW (17300 in chips)=20
Seat 5: pokerMJ (126916 in chips)=20
Seat 6: YogaGrandma (39879 in chips)=20
mocbel: posts the ante 300
JJin91: posts the ante 300
dcspada: posts the ante 300
BENZBMW: posts the ante 300
pokerMJ: posts the ante 300
YogaGrandma: posts the ante 300
JJin91: posts small blind 1200
dcspada: posts big blind 2400
*** HOLE CARDS ***
Dealt to JJin91 [Kc 5d]
BENZBMW: calls 2400
pokerMJ: folds=20
YogaGrandma: folds=20
mocbel: folds=20
JJin91: folds=20
dcspada: checks=20
*** FLOP *** [6s 4h Qh]
dcspada: checks=20
BENZBMW: bets 14600 and is all-in
dcspada: folds=20
Uncalled bet (14600) returned to BENZBMW
BENZBMW collected 7800 from pot
*** SUMMARY ***
Total pot 7800 | Rake 0=20
Board [6s 4h Qh]
Seat 1: mocbel (button) folded before Flop (didn't bet)
Seat 2: JJin91 (small blind) folded before Flop
Seat 3: dcspada (big blind) folded on the Flop
Seat 4: BENZBMW collected (7800)
Seat 5: pokerMJ folded before Flop (didn't bet)
Seat 6: YogaGrandma folded before Flop (didn't bet)


*********** # 157 **************
PokerStars Hand #175479436263: Tournament #1701793695, $9.10+$0.90 USD =
Hold'em No Limit - Level XVIII (1200/2400) - 2017/09/24 19:01:28 ET
Table '1701793695 3' 6-max Seat #2 is the button
Seat 1: mocbel (16700 in chips)=20
Seat 2: JJin91 (145542 in chips)=20
Seat 3: dcspada (82025 in chips)=20
Seat 4: BENZBMW (22400 in chips)=20
Seat 5: pokerMJ (126616 in chips)=20
Seat 6: YogaGrandma (39579 in chips)=20
mocbel: posts the ante 300
JJin91: posts the ante 300
dcspada: posts the ante 300
BENZBMW: posts the ante 300
pokerMJ: posts the ante 300
YogaGrandma: posts the ante 300
dcspada: posts small blind 1200
BENZBMW: posts big blind 2400
*** HOLE CARDS ***
Dealt to JJin91 [8d 7h]
pokerMJ: folds=20
YogaGrandma: folds=20
mocbel: raises 14000 to 16400 and is all-in
JJin91: folds=20
dcspada: folds=20
BENZBMW: folds=20
Uncalled bet (14000) returned to mocbel
mocbel collected 7800 from pot
*** SUMMARY ***
Total pot 7800 | Rake 0=20
Seat 1: mocbel collected (7800)
Seat 2: JJin91 (button) folded before Flop (didn't bet)
Seat 3: dcspada (small blind) folded before Flop
Seat 4: BENZBMW (big blind) folded before Flop
Seat 5: pokerMJ folded before Flop (didn't bet)
Seat 6: YogaGrandma folded before Flop (didn't bet)


*********** # 158 **************
PokerStars Hand #175479436404: Tournament #1701793695, $9.10+$0.90 USD =
Hold'em No Limit - Level XVIII (1200/2400) - 2017/09/24 19:02:01 ET
Table '1701793695 3' 6-max Seat #3 is the button
Seat 1: mocbel (21800 in chips)=20
Seat 2: JJin91 (145242 in chips)=20
Seat 3: dcspada (80525 in chips)=20
Seat 4: BENZBMW (19700 in chips)=20
Seat 5: pokerMJ (126316 in chips)=20
Seat 6: YogaGrandma (39279 in chips)=20
mocbel: posts the ante 300
JJin91: posts the ante 300
dcspada: posts the ante 300
BENZBMW: posts the ante 300
pokerMJ: posts the ante 300
YogaGrandma: posts the ante 300
BENZBMW: posts small blind 1200
pokerMJ: posts big blind 2400
*** HOLE CARDS ***
Dealt to JJin91 [Ac Jh]
YogaGrandma: folds=20
mocbel: folds=20
JJin91: raises 2808 to 5208
dcspada: folds=20
BENZBMW: raises 14192 to 19400 and is all-in
pokerMJ: calls 17000
JJin91: calls 14192
*** FLOP *** [7d Th 8h]
pokerMJ: checks=20
JJin91: checks=20
*** TURN *** [7d Th 8h] [Js]
pokerMJ: checks=20
JJin91: bets 22200
pokerMJ: folds=20
Uncalled bet (22200) returned to JJin91
*** RIVER *** [7d Th 8h Js] [7c]
*** SHOW DOWN ***
BENZBMW: shows [Ah Tc] (two pair, Tens and Sevens)
JJin91: shows [Ac Jh] (two pair, Jacks and Sevens)
JJin91 collected 60000 from pot
BENZBMW finished the tournament in 236th place
*** SUMMARY ***
Total pot 60000 | Rake 0=20
Board [7d Th 8h Js 7c]
Seat 1: mocbel folded before Flop (didn't bet)
Seat 2: JJin91 showed [Ac Jh] and won (60000) with two pair, Jacks and =
Sevens
Seat 3: dcspada (button) folded before Flop (didn't bet)
Seat 4: BENZBMW (small blind) showed [Ah Tc] and lost with two pair, Te=
ns and Sevens
Seat 5: pokerMJ (big blind) folded on the Turn
Seat 6: YogaGrandma folded before Flop (didn't bet)


*********** # 159 **************
PokerStars Hand #175479436640: Tournament #1701793695, $9.10+$0.90 USD =
Hold'em No Limit - Level XVIII (1200/2400) - 2017/09/24 19:02:53 ET
Table '1701793695 3' 6-max Seat #5 is the button
Seat 1: mocbel (21500 in chips)=20
Seat 2: JJin91 (185542 in chips)=20
Seat 3: dcspada (80225 in chips)=20
Seat 5: pokerMJ (106616 in chips)=20
Seat 6: YogaGrandma (38979 in chips)=20
mocbel: posts the ante 300
JJin91: posts the ante 300
dcspada: posts the ante 300
pokerMJ: posts the ante 300
YogaGrandma: posts the ante 300
YogaGrandma: posts small blind 1200
mocbel: posts big blind 2400
*** HOLE CARDS ***
Dealt to JJin91 [4s 9c]
JJin91: folds=20
dcspada: raises 4800 to 7200
pokerMJ: folds=20
YogaGrandma: folds=20
mocbel: folds=20
Uncalled bet (4800) returned to dcspada
dcspada collected 7500 from pot
dcspada: doesn't show hand=20
*** SUMMARY ***
Total pot 7500 | Rake 0=20
Seat 1: mocbel (big blind) folded before Flop
Seat 2: JJin91 folded before Flop (didn't bet)
Seat 3: dcspada collected (7500)
Seat 5: pokerMJ (button) folded before Flop (didn't bet)
Seat 6: YogaGrandma (small blind) folded before Flop


*********** # 160 **************
PokerStars Hand #175479436735: Tournament #1701793695, $9.10+$0.90 USD =
Hold'em No Limit - Level XVIII (1200/2400) - 2017/09/24 19:03:16 ET
Table '1701793695 3' 6-max Seat #6 is the button
Seat 1: mocbel (18800 in chips)=20
Seat 2: JJin91 (185242 in chips)=20
Seat 3: dcspada (85025 in chips)=20
Seat 5: pokerMJ (106316 in chips)=20
Seat 6: YogaGrandma (37479 in chips)=20
mocbel: posts the ante 300
JJin91: posts the ante 300
dcspada: posts the ante 300
pokerMJ: posts the ante 300
YogaGrandma: posts the ante 300
mocbel: posts small blind 1200
JJin91: posts big blind 2400
*** HOLE CARDS ***
Dealt to JJin91 [Ks 3c]
dcspada: calls 2400
pokerMJ: calls 2400
YogaGrandma: folds=20
mocbel: calls 1200
JJin91: checks=20
*** FLOP *** [4h 9s Jd]
mocbel: checks=20
JJin91: checks=20
dcspada: checks=20
pokerMJ: checks=20
*** TURN *** [4h 9s Jd] [Kh]
mocbel: checks=20
JJin91: checks=20
dcspada: bets 4800
pokerMJ: calls 4800
mocbel: folds=20
JJin91: folds=20
*** RIVER *** [4h 9s Jd Kh] [Tc]
dcspada: checks=20
pokerMJ: checks=20
*** SHOW DOWN ***
dcspada: shows [5s 5c] (a pair of Fives)
pokerMJ: mucks hand=20
dcspada collected 20700 from pot
*** SUMMARY ***
Total pot 20700 | Rake 0=20
Board [4h 9s Jd Kh Tc]
Seat 1: mocbel (small blind) folded on the Turn
Seat 2: JJin91 (big blind) folded on the Turn
Seat 3: dcspada showed [5s 5c] and won (20700) with a pair of Fives
Seat 5: pokerMJ mucked [5h Ah]
Seat 6: YogaGrandma (button) folded before Flop (didn't bet)


*********** # 161 **************
PokerStars Hand #175479436946: Tournament #1701793695, $9.10+$0.90 USD =
Hold'em No Limit - Level XVIII (1200/2400) - 2017/09/24 19:04:08 ET
Table '1701793695 3' 6-max Seat #1 is the button
Seat 1: mocbel (16100 in chips)=20
Seat 2: JJin91 (182542 in chips)=20
Seat 3: dcspada (98225 in chips)=20
Seat 5: pokerMJ (98816 in chips)=20
Seat 6: YogaGrandma (37179 in chips)=20
mocbel: posts the ante 300
JJin91: posts the ante 300
dcspada: posts the ante 300
pokerMJ: posts the ante 300
YogaGrandma: posts the ante 300
JJin91: posts small blind 1200
dcspada: posts big blind 2400
*** HOLE CARDS ***
Dealt to JJin91 [Jc Th]
pokerMJ: raises 2400 to 4800
YogaGrandma: folds=20
mocbel: folds=20
JJin91: folds=20
dcspada: folds=20
Uncalled bet (2400) returned to pokerMJ
pokerMJ collected 7500 from pot
pokerMJ: doesn't show hand=20
*** SUMMARY ***
Total pot 7500 | Rake 0=20
Seat 1: mocbel (button) folded before Flop (didn't bet)
Seat 2: JJin91 (small blind) folded before Flop
Seat 3: dcspada (big blind) folded before Flop
Seat 5: pokerMJ collected (7500)
Seat 6: YogaGrandma folded before Flop (didn't bet)


*********** # 162 **************
PokerStars Hand #175479436999: Tournament #1701793695, $9.10+$0.90 USD =
Hold'em No Limit - Level XVIII (1200/2400) - 2017/09/24 19:04:21 ET
Table '1701793695 3' 6-max Seat #2 is the button
Seat 1: mocbel (15800 in chips)=20
Seat 2: JJin91 (181042 in chips)=20
Seat 3: dcspada (95525 in chips)=20
Seat 5: pokerMJ (103616 in chips)=20
Seat 6: YogaGrandma (36879 in chips)=20
mocbel: posts the ante 300
JJin91: posts the ante 300
dcspada: posts the ante 300
pokerMJ: posts the ante 300
YogaGrandma: posts the ante 300
dcspada: posts small blind 1200
pokerMJ: posts big blind 2400
*** HOLE CARDS ***
Dealt to JJin91 [Tc Jc]
YogaGrandma: raises 2400 to 4800
mocbel: folds=20
JJin91: raises 6400 to 11200
dcspada: folds=20
pokerMJ: folds=20
YogaGrandma: raises 25379 to 36579 and is all-in
JJin91: calls 25379
*** FLOP *** [Th 8d 3s]
*** TURN *** [Th 8d 3s] [As]
*** RIVER *** [Th 8d 3s As] [Js]
*** SHOW DOWN ***
YogaGrandma: shows [Kd Kc] (a pair of Kings)
JJin91: shows [Tc Jc] (two pair, Jacks and Tens)
JJin91 collected 78258 from pot
YogaGrandma finished the tournament in 226th place
*** SUMMARY ***
Total pot 78258 | Rake 0=20
Board [Th 8d 3s As Js]
Seat 1: mocbel folded before Flop (didn't bet)
Seat 2: JJin91 (button) showed [Tc Jc] and won (78258) with two pair, J=
acks and Tens
Seat 3: dcspada (small blind) folded before Flop
Seat 5: pokerMJ (big blind) folded before Flop
Seat 6: YogaGrandma showed [Kd Kc] and lost with a pair of Kings


*********** # 163 **************
PokerStars Hand #175479437180: Tournament #1701793695, $9.10+$0.90 USD =
Hold'em No Limit - Level XVIII (1200/2400) - 2017/09/24 19:05:07 ET
Table '1701793695 3' 6-max Seat #3 is the button
Seat 1: mocbel (15500 in chips)=20
Seat 2: JJin91 (222421 in chips)=20
Seat 3: dcspada (94025 in chips)=20
Seat 4: Becka10597 (37396 in chips) out of hand (moved from another tab=
le into small blind)
Seat 5: pokerMJ (100916 in chips)=20
mocbel: posts the ante 300
JJin91: posts the ante 300
dcspada: posts the ante 300
pokerMJ: posts the ante 300
pokerMJ: posts small blind 1200
mocbel: posts big blind 2400
*** HOLE CARDS ***
Dealt to JJin91 [Tc 9s]
JJin91: folds=20
dcspada: folds=20
pokerMJ: raises 98216 to 100616 and is all-in
mocbel: folds=20
Uncalled bet (98216) returned to pokerMJ
pokerMJ collected 6000 from pot
pokerMJ: doesn't show hand=20
*** SUMMARY ***
Total pot 6000 | Rake 0=20
Seat 1: mocbel (big blind) folded before Flop
Seat 2: JJin91 folded before Flop (didn't bet)
Seat 3: dcspada (button) folded before Flop (didn't bet)
Seat 5: pokerMJ (small blind) collected (6000)


*********** # 164 **************
PokerStars Hand #175479437271: Tournament #1701793695, $9.10+$0.90 USD =
Hold'em No Limit - Level XVIII (1200/2400) - 2017/09/24 19:05:29 ET
Table '1701793695 3' 6-max Seat #5 is the button
Seat 1: mocbel (12800 in chips)=20
Seat 2: JJin91 (222121 in chips)=20
Seat 3: dcspada (93725 in chips)=20
Seat 4: Becka10597 (37396 in chips)=20
Seat 5: pokerMJ (104216 in chips)=20
mocbel: posts the ante 300
JJin91: posts the ante 300
dcspada: posts the ante 300
Becka10597: posts the ante 300
pokerMJ: posts the ante 300
mocbel: posts small blind 1200
JJin91: posts big blind 2400
*** HOLE CARDS ***
Dealt to JJin91 [6c Kh]
dcspada: folds=20
Becka10597: folds=20
pokerMJ: folds=20
mocbel: folds=20
Uncalled bet (1200) returned to JJin91
JJin91 collected 3900 from pot
JJin91: doesn't show hand=20
*** SUMMARY ***
Total pot 3900 | Rake 0=20
Seat 1: mocbel (small blind) folded before Flop
Seat 2: JJin91 (big blind) collected (3900)
Seat 3: dcspada folded before Flop (didn't bet)
Seat 4: Becka10597 folded before Flop (didn't bet)
Seat 5: pokerMJ (button) folded before Flop (didn't bet)


*********** # 165 **************
PokerStars Hand #175479437341: Tournament #1701793695, $9.10+$0.90 USD =
Hold'em No Limit - Level XVIII (1200/2400) - 2017/09/24 19:05:47 ET
Table '1701793695 3' 6-max Seat #1 is the button
Seat 1: mocbel (11300 in chips)=20
Seat 2: JJin91 (224521 in chips)=20
Seat 3: dcspada (93425 in chips)=20
Seat 4: Becka10597 (37096 in chips)=20
Seat 5: pokerMJ (103916 in chips)=20
mocbel: posts the ante 300
JJin91: posts the ante 300
dcspada: posts the ante 300
Becka10597: posts the ante 300
pokerMJ: posts the ante 300
JJin91: posts small blind 1200
dcspada: posts big blind 2400
*** HOLE CARDS ***
Dealt to JJin91 [4h Ks]
Becka10597: raises 2400 to 4800
pokerMJ: folds=20
mocbel: folds=20
JJin91: folds=20
dcspada: folds=20
Uncalled bet (2400) returned to Becka10597
Becka10597 collected 7500 from pot
Becka10597: doesn't show hand=20
*** SUMMARY ***
Total pot 7500 | Rake 0=20
Seat 1: mocbel (button) folded before Flop (didn't bet)
Seat 2: JJin91 (small blind) folded before Flop
Seat 3: dcspada (big blind) folded before Flop
Seat 4: Becka10597 collected (7500)
Seat 5: pokerMJ folded before Flop (didn't bet)


*********** # 166 **************
PokerStars Hand #175479437483: Tournament #1701793695, $9.10+$0.90 USD =
Hold'em No Limit - Level XIX (1400/2800) - 2017/09/24 19:06:19 ET
Table '1701793695 3' 6-max Seat #2 is the button
Seat 1: mocbel (11000 in chips)=20
Seat 2: JJin91 (223021 in chips)=20
Seat 3: dcspada (90725 in chips)=20
Seat 4: Becka10597 (41896 in chips)=20
Seat 5: pokerMJ (103616 in chips)=20
mocbel: posts the ante 350
JJin91: posts the ante 350
dcspada: posts the ante 350
Becka10597: posts the ante 350
pokerMJ: posts the ante 350
dcspada: posts small blind 1400
Becka10597: posts big blind 2800
*** HOLE CARDS ***
Dealt to JJin91 [8s Td]
pokerMJ: folds=20
mocbel: raises 7850 to 10650 and is all-in
JJin91: folds=20
dcspada: folds=20
Becka10597: folds=20
Uncalled bet (7850) returned to mocbel
mocbel collected 8750 from pot
*** SUMMARY ***
Total pot 8750 | Rake 0=20
Seat 1: mocbel collected (8750)
Seat 2: JJin91 (button) folded before Flop (didn't bet)
Seat 3: dcspada (small blind) folded before Flop
Seat 4: Becka10597 (big blind) folded before Flop
Seat 5: pokerMJ folded before Flop (didn't bet)


*********** # 167 **************
PokerStars Hand #175479437544: Tournament #1701793695, $9.10+$0.90 USD =
Hold'em No Limit - Level XIX (1400/2800) - 2017/09/24 19:06:34 ET
Table '1701793695 3' 6-max Seat #3 is the button
Seat 1: mocbel (16600 in chips)=20
Seat 2: JJin91 (222671 in chips)=20
Seat 3: dcspada (88975 in chips)=20
Seat 4: Becka10597 (38746 in chips)=20
Seat 5: pokerMJ (103266 in chips)=20
mocbel: posts the ante 350
JJin91: posts the ante 350
dcspada: posts the ante 350
Becka10597: posts the ante 350
pokerMJ: posts the ante 350
Becka10597: posts small blind 1400
pokerMJ: posts big blind 2800
*** HOLE CARDS ***
Dealt to JJin91 [Qh Jh]
mocbel: folds=20
JJin91: raises 3276 to 6076
dcspada: folds=20
Becka10597: folds=20
pokerMJ: folds=20
Uncalled bet (3276) returned to JJin91
JJin91 collected 8750 from pot
JJin91: doesn't show hand=20
*** SUMMARY ***
Total pot 8750 | Rake 0=20
Seat 1: mocbel folded before Flop (didn't bet)
Seat 2: JJin91 collected (8750)
Seat 3: dcspada (button) folded before Flop (didn't bet)
Seat 4: Becka10597 (small blind) folded before Flop
Seat 5: pokerMJ (big blind) folded before Flop


*********** # 168 **************
PokerStars Hand #175479437648: Tournament #1701793695, $9.10+$0.90 USD =
Hold'em No Limit - Level XIX (1400/2800) - 2017/09/24 19:06:59 ET
Table '1701793695 3' 6-max Seat #4 is the button
Seat 1: mocbel (16250 in chips)=20
Seat 2: JJin91 (228271 in chips)=20
Seat 3: dcspada (88625 in chips)=20
Seat 4: Becka10597 (36996 in chips)=20
Seat 5: pokerMJ (100116 in chips)=20
mocbel: posts the ante 350
JJin91: posts the ante 350
dcspada: posts the ante 350
Becka10597: posts the ante 350
pokerMJ: posts the ante 350
pokerMJ: posts small blind 1400
mocbel: posts big blind 2800
*** HOLE CARDS ***
Dealt to JJin91 [9h 8s]
JJin91: folds=20
dcspada: folds=20
Becka10597: folds=20
pokerMJ: folds=20
Uncalled bet (1400) returned to mocbel
mocbel collected 4550 from pot
*** SUMMARY ***
Total pot 4550 | Rake 0=20
Seat 1: mocbel (big blind) collected (4550)
Seat 2: JJin91 folded before Flop (didn't bet)
Seat 3: dcspada folded before Flop (didn't bet)
Seat 4: Becka10597 (button) folded before Flop (didn't bet)
Seat 5: pokerMJ (small blind) folded before Flop


*********** # 169 **************
PokerStars Hand #175479437715: Tournament #1701793695, $9.10+$0.90 USD =
Hold'em No Limit - Level XIX (1400/2800) - 2017/09/24 19:07:16 ET
Table '1701793695 3' 6-max Seat #5 is the button
Seat 1: mocbel (19050 in chips)=20
Seat 2: JJin91 (227921 in chips)=20
Seat 3: dcspada (88275 in chips)=20
Seat 4: Becka10597 (36646 in chips)=20
Seat 5: pokerMJ (98366 in chips)=20
mocbel: posts the ante 350
JJin91: posts the ante 350
dcspada: posts the ante 350
Becka10597: posts the ante 350
pokerMJ: posts the ante 350
mocbel: posts small blind 1400
JJin91: posts big blind 2800
*** HOLE CARDS ***
Dealt to JJin91 [2h Ts]
dcspada: folds=20
Becka10597: folds=20
pokerMJ: raises 2800 to 5600
mocbel: folds=20
JJin91: folds=20
Uncalled bet (2800) returned to pokerMJ
pokerMJ collected 8750 from pot
pokerMJ: doesn't show hand=20
*** SUMMARY ***
Total pot 8750 | Rake 0=20
Seat 1: mocbel (small blind) folded before Flop
Seat 2: JJin91 (big blind) folded before Flop
Seat 3: dcspada folded before Flop (didn't bet)
Seat 4: Becka10597 folded before Flop (didn't bet)
Seat 5: pokerMJ (button) collected (8750)


*********** # 170 **************
PokerStars Hand #175479437781: Tournament #1701793695, $9.10+$0.90 USD =
Hold'em No Limit - Level XIX (1400/2800) - 2017/09/24 19:07:33 ET
Table '1701793695 3' 6-max Seat #1 is the button
Seat 1: mocbel (17300 in chips)=20
Seat 2: JJin91 (224771 in chips)=20
Seat 3: dcspada (87925 in chips)=20
Seat 4: Becka10597 (36296 in chips)=20
Seat 5: pokerMJ (103966 in chips)=20
mocbel: posts the ante 350
JJin91: posts the ante 350
dcspada: posts the ante 350
Becka10597: posts the ante 350
pokerMJ: posts the ante 350
JJin91: posts small blind 1400
dcspada: posts big blind 2800
*** HOLE CARDS ***
Dealt to JJin91 [7h 7c]
Becka10597: raises 5600 to 8400
pokerMJ: folds=20
mocbel: folds=20
JJin91: calls 7000
dcspada: folds=20
*** FLOP *** [4d 9h 3s]
JJin91: checks=20
Becka10597: bets 11200
JJin91: raises 43750 to 54950
Becka10597: calls 16346 and is all-in
Uncalled bet (27404) returned to JJin91
*** TURN *** [4d 9h 3s] [5d]
*** RIVER *** [4d 9h 3s 5d] [5c]
*** SHOW DOWN ***
JJin91: shows [7h 7c] (two pair, Sevens and Fives)
Becka10597: shows [As 4s] (two pair, Fives and Fours)
JJin91 collected 76442 from pot
Becka10597 finished the tournament in 215th place
*** SUMMARY ***
Total pot 76442 | Rake 0=20
Board [4d 9h 3s 5d 5c]
Seat 1: mocbel (button) folded before Flop (didn't bet)
Seat 2: JJin91 (small blind) showed [7h 7c] and won (76442) with two pa=
ir, Sevens and Fives
Seat 3: dcspada (big blind) folded before Flop
Seat 4: Becka10597 showed [As 4s] and lost with two pair, Fives and Fou=
rs
Seat 5: pokerMJ folded before Flop (didn't bet)


*********** # 171 **************
PokerStars Hand #175479437941: Tournament #1701793695, $9.10+$0.90 USD =
Hold'em No Limit - Level XIX (1400/2800) - 2017/09/24 19:08:11 ET
Table '1701793695 3' 6-max Seat #2 is the button
Seat 1: mocbel (16950 in chips)=20
Seat 2: JJin91 (264917 in chips)=20
Seat 3: dcspada (84775 in chips)=20
Seat 4: liakenzie (72469 in chips)=20
Seat 5: pokerMJ (103616 in chips)=20
Seat 6: munsy2 (60400 in chips)=20
mocbel: posts the ante 350
JJin91: posts the ante 350
dcspada: posts the ante 350
liakenzie: posts the ante 350
pokerMJ: posts the ante 350
munsy2: posts the ante 350
dcspada: posts small blind 1400
liakenzie: posts big blind 2800
*** HOLE CARDS ***
Dealt to JJin91 [2h Kd]
pokerMJ: folds=20
munsy2: folds=20
mocbel: folds=20
JJin91: raises 3276 to 6076
dcspada: folds=20
liakenzie: raises 15652 to 21728
JJin91: folds=20
Uncalled bet (15652) returned to liakenzie
liakenzie collected 15652 from pot
*** SUMMARY ***
Total pot 15652 | Rake 0=20
Seat 1: mocbel folded before Flop (didn't bet)
Seat 2: JJin91 (button) folded before Flop
Seat 3: dcspada (small blind) folded before Flop
Seat 4: liakenzie (big blind) collected (15652)
Seat 5: pokerMJ folded before Flop (didn't bet)
Seat 6: munsy2 folded before Flop (didn't bet)


*********** # 172 **************
PokerStars Hand #175479438097: Tournament #1701793695, $9.10+$0.90 USD =
Hold'em No Limit - Level XIX (1400/2800) - 2017/09/24 19:08:50 ET
Table '1701793695 3' 6-max Seat #3 is the button
Seat 1: mocbel (16600 in chips)=20
Seat 2: JJin91 (258491 in chips)=20
Seat 3: dcspada (83025 in chips)=20
Seat 4: liakenzie (81695 in chips)=20
Seat 5: pokerMJ (103266 in chips)=20
Seat 6: munsy2 (60050 in chips)=20
mocbel: posts the ante 350
JJin91: posts the ante 350
dcspada: posts the ante 350
liakenzie: posts the ante 350
pokerMJ: posts the ante 350
munsy2: posts the ante 350
liakenzie: posts small blind 1400
pokerMJ: posts big blind 2800
*** HOLE CARDS ***
Dealt to JJin91 [Kd 9s]
munsy2: folds=20
mocbel: raises 13450 to 16250 and is all-in
JJin91: folds=20
dcspada: folds=20
liakenzie: folds=20
pokerMJ: folds=20
Uncalled bet (13450) returned to mocbel
mocbel collected 9100 from pot
*** SUMMARY ***
Total pot 9100 | Rake 0=20
Seat 1: mocbel collected (9100)
Seat 2: JJin91 folded before Flop (didn't bet)
Seat 3: dcspada (button) folded before Flop (didn't bet)
Seat 4: liakenzie (small blind) folded before Flop
Seat 5: pokerMJ (big blind) folded before Flop
Seat 6: munsy2 folded before Flop (didn't bet)


*********** # 173 **************
PokerStars Hand #175479438232: Tournament #1701793695, $9.10+$0.90 USD =
Hold'em No Limit - Level XIX (1400/2800) - 2017/09/24 19:09:22 ET
Table '1701793695 3' 6-max Seat #4 is the button
Seat 1: mocbel (22550 in chips)=20
Seat 2: JJin91 (258141 in chips)=20
Seat 3: dcspada (82675 in chips)=20
Seat 4: liakenzie (79945 in chips)=20
Seat 5: pokerMJ (100116 in chips)=20
Seat 6: munsy2 (59700 in chips)=20
mocbel: posts the ante 350
JJin91: posts the ante 350
dcspada: posts the ante 350
liakenzie: posts the ante 350
pokerMJ: posts the ante 350
munsy2: posts the ante 350
pokerMJ: posts small blind 1400
munsy2: posts big blind 2800
*** HOLE CARDS ***
Dealt to JJin91 [Ah Ad]
mocbel: folds=20
JJin91: raises 3276 to 6076
dcspada: folds=20
liakenzie: folds=20
pokerMJ: folds=20
munsy2: folds=20
Uncalled bet (3276) returned to JJin91
JJin91 collected 9100 from pot
JJin91: doesn't show hand=20
*** SUMMARY ***
Total pot 9100 | Rake 0=20
Seat 1: mocbel folded before Flop (didn't bet)
Seat 2: JJin91 collected (9100)
Seat 3: dcspada folded before Flop (didn't bet)
Seat 4: liakenzie (button) folded before Flop (didn't bet)
Seat 5: pokerMJ (small blind) folded before Flop
Seat 6: munsy2 (big blind) folded before Flop


*********** # 174 **************
PokerStars Hand #175479438375: Tournament #1701793695, $9.10+$0.90 USD =
Hold'em No Limit - Level XIX (1400/2800) - 2017/09/24 19:09:54 ET
Table '1701793695 3' 6-max Seat #5 is the button
Seat 1: mocbel (22200 in chips)=20
Seat 2: JJin91 (264091 in chips)=20
Seat 3: dcspada (82325 in chips)=20
Seat 4: liakenzie (79595 in chips)=20
Seat 5: pokerMJ (98366 in chips)=20
Seat 6: munsy2 (56550 in chips)=20
mocbel: posts the ante 350
JJin91: posts the ante 350
dcspada: posts the ante 350
liakenzie: posts the ante 350
pokerMJ: posts the ante 350
munsy2: posts the ante 350
munsy2: posts small blind 1400
mocbel: posts big blind 2800
*** HOLE CARDS ***
Dealt to JJin91 [Ks 8c]
JJin91: folds=20
dcspada: folds=20
liakenzie: raises 2800 to 5600
pokerMJ: folds=20
munsy2: folds=20
mocbel: folds=20
Uncalled bet (2800) returned to liakenzie
liakenzie collected 9100 from pot
*** SUMMARY ***
Total pot 9100 | Rake 0=20
Seat 1: mocbel (big blind) folded before Flop
Seat 2: JJin91 folded before Flop (didn't bet)
Seat 3: dcspada folded before Flop (didn't bet)
Seat 4: liakenzie collected (9100)
Seat 5: pokerMJ (button) folded before Flop (didn't bet)
Seat 6: munsy2 (small blind) folded before Flop


*********** # 175 **************
PokerStars Hand #175479438474: Tournament #1701793695, $9.10+$0.90 USD =
Hold'em No Limit - Level XIX (1400/2800) - 2017/09/24 19:10:18 ET
Table '1701793695 3' 6-max Seat #6 is the button
Seat 1: mocbel (19050 in chips)=20
Seat 2: JJin91 (263741 in chips)=20
Seat 3: dcspada (81975 in chips)=20
Seat 4: liakenzie (85545 in chips)=20
Seat 5: pokerMJ (98016 in chips)=20
Seat 6: munsy2 (54800 in chips)=20
mocbel: posts the ante 350
JJin91: posts the ante 350
dcspada: posts the ante 350
liakenzie: posts the ante 350
pokerMJ: posts the ante 350
munsy2: posts the ante 350
mocbel: posts small blind 1400
JJin91: posts big blind 2800
*** HOLE CARDS ***
Dealt to JJin91 [6c 8s]
dcspada: calls 2800
liakenzie: raises 5600 to 8400
pokerMJ: folds=20
munsy2: folds=20
mocbel: folds=20
JJin91: folds=20
dcspada: folds=20
Uncalled bet (5600) returned to liakenzie
liakenzie collected 11900 from pot
*** SUMMARY ***
Total pot 11900 | Rake 0=20
Seat 1: mocbel (small blind) folded before Flop
Seat 2: JJin91 (big blind) folded before Flop
Seat 3: dcspada folded before Flop
Seat 4: liakenzie collected (11900)
Seat 5: pokerMJ folded before Flop (didn't bet)
Seat 6: munsy2 (button) folded before Flop (didn't bet)


*********** # 176 **************
PokerStars Hand #175479438628: Tournament #1701793695, $9.10+$0.90 USD =
Hold'em No Limit - Level XIX (1400/2800) - 2017/09/24 19:10:53 ET
Table '1701793695 3' 6-max Seat #1 is the button
Seat 1: mocbel (17300 in chips)=20
Seat 2: JJin91 (260591 in chips)=20
Seat 3: dcspada (78825 in chips)=20
Seat 4: liakenzie (94295 in chips)=20
Seat 5: pokerMJ (97666 in chips)=20
Seat 6: munsy2 (54450 in chips)=20
mocbel: posts the ante 350
JJin91: posts the ante 350
dcspada: posts the ante 350
liakenzie: posts the ante 350
pokerMJ: posts the ante 350
munsy2: posts the ante 350
JJin91: posts small blind 1400
dcspada: posts big blind 2800
*** HOLE CARDS ***
Dealt to JJin91 [9c 5d]
liakenzie: folds=20
pokerMJ: raises 2800 to 5600
munsy2: folds=20
mocbel: folds=20
JJin91: folds=20
dcspada: folds=20
Uncalled bet (2800) returned to pokerMJ
pokerMJ collected 9100 from pot
pokerMJ: doesn't show hand=20
*** SUMMARY ***
Total pot 9100 | Rake 0=20
Seat 1: mocbel (button) folded before Flop (didn't bet)
Seat 2: JJin91 (small blind) folded before Flop
Seat 3: dcspada (big blind) folded before Flop
Seat 4: liakenzie folded before Flop (didn't bet)
Seat 5: pokerMJ collected (9100)
Seat 6: munsy2 folded before Flop (didn't bet)


*********** # 177 **************
PokerStars Hand #175479438727: Tournament #1701793695, $9.10+$0.90 USD =
Hold'em No Limit - Level XIX (1400/2800) - 2017/09/24 19:11:13 ET
Table '1701793695 3' 6-max Seat #2 is the button
Seat 1: mocbel (16950 in chips)=20
Seat 2: JJin91 (258841 in chips)=20
Seat 3: dcspada (75675 in chips)=20
Seat 4: liakenzie (93945 in chips)=20
Seat 5: pokerMJ (103616 in chips)=20
Seat 6: munsy2 (54100 in chips)=20
mocbel: posts the ante 350
JJin91: posts the ante 350
dcspada: posts the ante 350
liakenzie: posts the ante 350
pokerMJ: posts the ante 350
munsy2: posts the ante 350
dcspada: posts small blind 1400
liakenzie: posts big blind 2800
*** HOLE CARDS ***
Dealt to JJin91 [6c 3h]
pokerMJ: folds=20
munsy2: folds=20
mocbel: folds=20
JJin91: folds=20
dcspada: folds=20
Uncalled bet (1400) returned to liakenzie
liakenzie collected 4900 from pot
*** SUMMARY ***
Total pot 4900 | Rake 0=20
Seat 1: mocbel folded before Flop (didn't bet)
Seat 2: JJin91 (button) folded before Flop (didn't bet)
Seat 3: dcspada (small blind) folded before Flop
Seat 4: liakenzie (big blind) collected (4900)
Seat 5: pokerMJ folded before Flop (didn't bet)
Seat 6: munsy2 folded before Flop (didn't bet)


*********** # 178 **************
PokerStars Hand #175479438794: Tournament #1701793695, $9.10+$0.90 USD =
Hold'em No Limit - Level XIX (1400/2800) - 2017/09/24 19:11:31 ET
Table '1701793695 3' 6-max Seat #3 is the button
Seat 1: mocbel (16600 in chips)=20
Seat 2: JJin91 (258491 in chips)=20
Seat 3: dcspada (73925 in chips)=20
Seat 4: liakenzie (97095 in chips)=20
Seat 5: pokerMJ (103266 in chips)=20
Seat 6: munsy2 (53750 in chips)=20
mocbel: posts the ante 350
JJin91: posts the ante 350
dcspada: posts the ante 350
liakenzie: posts the ante 350
pokerMJ: posts the ante 350
munsy2: posts the ante 350
liakenzie: posts small blind 1400
pokerMJ: posts big blind 2800
*** HOLE CARDS ***
Dealt to JJin91 [6h Js]
munsy2: folds=20
mocbel: folds=20
JJin91: folds=20
dcspada: folds=20
liakenzie: calls 1400
pokerMJ: raises 5600 to 8400
liakenzie: raises 88345 to 96745 and is all-in
pokerMJ: folds=20
Uncalled bet (88345) returned to liakenzie
liakenzie collected 18900 from pot
*** SUMMARY ***
Total pot 18900 | Rake 0=20
Seat 1: mocbel folded before Flop (didn't bet)
Seat 2: JJin91 folded before Flop (didn't bet)
Seat 3: dcspada (button) folded before Flop (didn't bet)
Seat 4: liakenzie (small blind) collected (18900)
Seat 5: pokerMJ (big blind) folded before Flop
Seat 6: munsy2 folded before Flop (didn't bet)


*********** # 179 **************
PokerStars Hand #175479439020: Tournament #1701793695, $9.10+$0.90 USD =
Hold'em No Limit - Level XIX (1400/2800) - 2017/09/24 19:12:16 ET
Table '1701793695 3' 6-max Seat #4 is the button
Seat 1: mocbel (16250 in chips)=20
Seat 2: JJin91 (258141 in chips)=20
Seat 3: dcspada (73575 in chips)=20
Seat 4: liakenzie (107245 in chips)=20
Seat 5: pokerMJ (94516 in chips)=20
Seat 6: munsy2 (53400 in chips)=20
mocbel: posts the ante 350
JJin91: posts the ante 350
dcspada: posts the ante 350
liakenzie: posts the ante 350
pokerMJ: posts the ante 350
munsy2: posts the ante 350
pokerMJ: posts small blind 1400
munsy2: posts big blind 2800
*** HOLE CARDS ***
Dealt to JJin91 [7d 7h]
mocbel: raises 11700 to 14500
JJin91: calls 14500
dcspada: raises 58725 to 73225 and is all-in
liakenzie: folds=20
pokerMJ: folds=20
munsy2: folds=20
mocbel: calls 1400 and is all-in
JJin91: calls 58725
*** FLOP *** [7c Qs Ad]
*** TURN *** [7c Qs Ad] [9c]
*** RIVER *** [7c Qs Ad 9c] [6c]
*** SHOW DOWN ***
JJin91: shows [7d 7h] (three of a kind, Sevens)
dcspada: shows [Kd Ac] (a pair of Aces)
JJin91 collected 114650 from side pot
mocbel: shows [Jc 9s] (a pair of Nines)
JJin91 collected 54000 from main pot
dcspada finished the tournament in 192nd place
mocbel finished the tournament in 193rd place
*** SUMMARY ***
Total pot 168650 Main pot 54000. Side pot 114650. | Rake 0=20
Board [7c Qs Ad 9c 6c]
Seat 1: mocbel showed [Jc 9s] and lost with a pair of Nines
Seat 2: JJin91 showed [7d 7h] and won (168650) with three of a kind, Se=
vens
Seat 3: dcspada showed [Kd Ac] and lost with a pair of Aces
Seat 4: liakenzie (button) folded before Flop (didn't bet)
Seat 5: pokerMJ (small blind) folded before Flop
Seat 6: munsy2 (big blind) folded before Flop


*********** # 180 **************
PokerStars Hand #175479439241: Tournament #1701793695, $9.10+$0.90 USD =
Hold'em No Limit - Level XIX (1400/2800) - 2017/09/24 19:13:06 ET
Table '1701793695 17' 6-max Seat #2 is the button
Seat 1: CNA151 (53978 in chips)=20
Seat 2: sellycube (71941 in chips)=20
Seat 3: YourRobotDad (34050 in chips)=20
Seat 4: slochan82 (55980 in chips)=20
Seat 5: JJin91 (353216 in chips)=20
Seat 6: FizzEdJohn (64976 in chips)=20
CNA151: posts the ante 350
sellycube: posts the ante 350
YourRobotDad: posts the ante 350
slochan82: posts the ante 350
JJin91: posts the ante 350
FizzEdJohn: posts the ante 350
YourRobotDad: posts small blind 1400
slochan82: posts big blind 2800
*** HOLE CARDS ***
Dealt to JJin91 [5d 3d]
JJin91: folds=20
FizzEdJohn: folds=20
CNA151: folds=20
sellycube: folds=20
YourRobotDad: raises 30900 to 33700 and is all-in
slochan82: folds=20
Uncalled bet (30900) returned to YourRobotDad
YourRobotDad collected 7700 from pot
*** SUMMARY ***
Total pot 7700 | Rake 0=20
Seat 1: CNA151 folded before Flop (didn't bet)
Seat 2: sellycube (button) folded before Flop (didn't bet)
Seat 3: YourRobotDad (small blind) collected (7700)
Seat 4: slochan82 (big blind) folded before Flop
Seat 5: JJin91 folded before Flop (didn't bet)
Seat 6: FizzEdJohn folded before Flop (didn't bet)


*********** # 181 **************
PokerStars Hand #175479439328: Tournament #1701793695, $9.10+$0.90 USD =
Hold'em No Limit - Level XIX (1400/2800) - 2017/09/24 19:13:27 ET
Table '1701793695 17' 6-max Seat #3 is the button
Seat 1: CNA151 (53628 in chips)=20
Seat 2: sellycube (71591 in chips)=20
Seat 3: YourRobotDad (38600 in chips)=20
Seat 4: slochan82 (52830 in chips)=20
Seat 5: JJin91 (352866 in chips)=20
Seat 6: FizzEdJohn (64626 in chips)=20
CNA151: posts the ante 350
sellycube: posts the ante 350
YourRobotDad: posts the ante 350
slochan82: posts the ante 350
JJin91: posts the ante 350
FizzEdJohn: posts the ante 350
slochan82: posts small blind 1400
JJin91: posts big blind 2800
*** HOLE CARDS ***
Dealt to JJin91 [4c Td]
FizzEdJohn: folds=20
CNA151: folds=20
sellycube: folds=20
YourRobotDad: folds=20
slochan82: calls 1400
JJin91: checks=20
*** FLOP *** [Qh 4s 2s]
slochan82: bets 2800
JJin91: calls 2800
*** TURN *** [Qh 4s 2s] [5s]
slochan82: bets 2800
JJin91: calls 2800
*** RIVER *** [Qh 4s 2s 5s] [Jd]
slochan82: checks=20
JJin91: checks=20
*** SHOW DOWN ***
slochan82: shows [8c 8s] (a pair of Eights)
JJin91: mucks hand=20
slochan82 collected 18900 from pot
*** SUMMARY ***
Total pot 18900 | Rake 0=20
Board [Qh 4s 2s 5s Jd]
Seat 1: CNA151 folded before Flop (didn't bet)
Seat 2: sellycube folded before Flop (didn't bet)
Seat 3: YourRobotDad (button) folded before Flop (didn't bet)
Seat 4: slochan82 (small blind) showed [8c 8s] and won (18900) with a p=
air of Eights
Seat 5: JJin91 (big blind) mucked [4c Td]
Seat 6: FizzEdJohn folded before Flop (didn't bet)


*********** # 182 **************
PokerStars Hand #175479439667: Tournament #1701793695, $9.10+$0.90 USD =
Hold'em No Limit - Level XX (1600/3200) - 2017/09/24 19:14:43 ET
Table '1701793695 17' 6-max Seat #4 is the button
Seat 1: CNA151 (53278 in chips)=20
Seat 2: sellycube (71241 in chips)=20
Seat 3: YourRobotDad (38250 in chips)=20
Seat 4: slochan82 (62980 in chips)=20
Seat 5: JJin91 (344116 in chips)=20
Seat 6: FizzEdJohn (64276 in chips)=20
CNA151: posts the ante 400
sellycube: posts the ante 400
YourRobotDad: posts the ante 400
slochan82: posts the ante 400
JJin91: posts the ante 400
FizzEdJohn: posts the ante 400
JJin91: posts small blind 1600
FizzEdJohn: posts big blind 3200
*** HOLE CARDS ***
Dealt to JJin91 [Qs Ac]
CNA151: folds=20
sellycube: folds=20
YourRobotDad: folds=20
slochan82: folds=20
JJin91: calls 1600
FizzEdJohn: checks=20
*** FLOP *** [Qc Jh 6s]
JJin91: checks=20
FizzEdJohn: bets 3200
JJin91: calls 3200
*** TURN *** [Qc Jh 6s] [8s]
JJin91: checks=20
FizzEdJohn: bets 6400
JJin91: calls 6400
*** RIVER *** [Qc Jh 6s 8s] [2c]
JJin91: checks=20
FizzEdJohn: bets 11200
JJin91: calls 11200
*** SHOW DOWN ***
FizzEdJohn: shows [Th Qd] (a pair of Queens)
JJin91: shows [Qs Ac] (a pair of Queens - Ace kicker)
JJin91 collected 50400 from pot
*** SUMMARY ***
Total pot 50400 | Rake 0=20
Board [Qc Jh 6s 8s 2c]
Seat 1: CNA151 folded before Flop (didn't bet)
Seat 2: sellycube folded before Flop (didn't bet)
Seat 3: YourRobotDad folded before Flop (didn't bet)
Seat 4: slochan82 (button) folded before Flop (didn't bet)
Seat 5: JJin91 (small blind) showed [Qs Ac] and won (50400) with a pair=
 of Queens
Seat 6: FizzEdJohn (big blind) showed [Th Qd] and lost with a pair of Q=
ueens


*********** # 183 **************
PokerStars Hand #175481013208: Tournament #1701793695, $9.10+$0.90 USD =
Hold'em No Limit - Level XX (1600/3200) - 2017/09/24 19:17:29 ET
Table '1701793695 17' 6-max Seat #5 is the button
Seat 1: CNA151 (52878 in chips)=20
Seat 2: sellycube (70841 in chips)=20
Seat 3: YourRobotDad (37850 in chips)=20
Seat 4: slochan82 (62580 in chips)=20
Seat 5: JJin91 (370116 in chips)=20
Seat 6: FizzEdJohn (39876 in chips)=20
CNA151: posts the ante 400
sellycube: posts the ante 400
YourRobotDad: posts the ante 400
slochan82: posts the ante 400
JJin91: posts the ante 400
FizzEdJohn: posts the ante 400
FizzEdJohn: posts small blind 1600
CNA151: posts big blind 3200
*** HOLE CARDS ***
Dealt to JJin91 [Kd 9s]
sellycube: raises 3200 to 6400
YourRobotDad: folds=20
slochan82: folds=20
JJin91: folds=20
FizzEdJohn: folds=20
CNA151: folds=20
Uncalled bet (3200) returned to sellycube
sellycube collected 10400 from pot
sellycube: doesn't show hand=20
*** SUMMARY ***
Total pot 10400 | Rake 0=20
Seat 1: CNA151 (big blind) folded before Flop
Seat 2: sellycube collected (10400)
Seat 3: YourRobotDad folded before Flop (didn't bet)
Seat 4: slochan82 folded before Flop (didn't bet)
Seat 5: JJin91 (button) folded before Flop (didn't bet)
Seat 6: FizzEdJohn (small blind) folded before Flop


*********** # 184 **************
PokerStars Hand #175481013287: Tournament #1701793695, $9.10+$0.90 USD =
Hold'em No Limit - Level XX (1600/3200) - 2017/09/24 19:17:47 ET
Table '1701793695 17' 6-max Seat #6 is the button
Seat 1: CNA151 (49278 in chips)=20
Seat 2: sellycube (77641 in chips)=20
Seat 3: YourRobotDad (37450 in chips)=20
Seat 4: slochan82 (62180 in chips)=20
Seat 5: JJin91 (369716 in chips)=20
Seat 6: FizzEdJohn (37876 in chips)=20
CNA151: posts the ante 400
sellycube: posts the ante 400
YourRobotDad: posts the ante 400
slochan82: posts the ante 400
JJin91: posts the ante 400
FizzEdJohn: posts the ante 400
CNA151: posts small blind 1600
sellycube: posts big blind 3200
*** HOLE CARDS ***
Dealt to JJin91 [Th Ks]
YourRobotDad: raises 33850 to 37050 and is all-in
slochan82: folds=20
JJin91: folds=20
FizzEdJohn: folds=20
CNA151: folds=20
sellycube: folds=20
Uncalled bet (33850) returned to YourRobotDad
YourRobotDad collected 10400 from pot
*** SUMMARY ***
Total pot 10400 | Rake 0=20
Seat 1: CNA151 (small blind) folded before Flop
Seat 2: sellycube (big blind) folded before Flop
Seat 3: YourRobotDad collected (10400)
Seat 4: slochan82 folded before Flop (didn't bet)
Seat 5: JJin91 folded before Flop (didn't bet)
Seat 6: FizzEdJohn (button) folded before Flop (didn't bet)


*********** # 185 **************
PokerStars Hand #175481013373: Tournament #1701793695, $9.10+$0.90 USD =
Hold'em No Limit - Level XX (1600/3200) - 2017/09/24 19:18:07 ET
Table '1701793695 17' 6-max Seat #2 is the button
Seat 2: sellycube (74041 in chips)=20
Seat 3: YourRobotDad (44250 in chips)=20
Seat 4: slochan82 (61780 in chips)=20
Seat 5: JJin91 (369316 in chips)=20
Seat 6: FizzEdJohn (37476 in chips)=20
sellycube: posts the ante 400
YourRobotDad: posts the ante 400
slochan82: posts the ante 400
JJin91: posts the ante 400
FizzEdJohn: posts the ante 400
YourRobotDad: posts small blind 1600
slochan82: posts big blind 3200
*** HOLE CARDS ***
Dealt to JJin91 [6d As]
JJin91: folds=20
FizzEdJohn: folds=20
sellycube: folds=20
YourRobotDad: raises 6400 to 9600
slochan82: folds=20
Uncalled bet (6400) returned to YourRobotDad
YourRobotDad collected 8400 from pot
*** SUMMARY ***
Total pot 8400 | Rake 0=20
Seat 2: sellycube (button) folded before Flop (didn't bet)
Seat 3: YourRobotDad (small blind) collected (8400)
Seat 4: slochan82 (big blind) folded before Flop
Seat 5: JJin91 folded before Flop (didn't bet)
Seat 6: FizzEdJohn folded before Flop (didn't bet)


*********** # 186 **************
PokerStars Hand #175481013461: Tournament #1701793695, $9.10+$0.90 USD =
Hold'em No Limit - Level XX (1600/3200) - 2017/09/24 19:18:27 ET
Table '1701793695 17' 6-max Seat #3 is the button
Seat 2: sellycube (73641 in chips)=20
Seat 3: YourRobotDad (49050 in chips)=20
Seat 4: slochan82 (58180 in chips)=20
Seat 5: JJin91 (368916 in chips)=20
Seat 6: FizzEdJohn (37076 in chips)=20
sellycube: posts the ante 400
YourRobotDad: posts the ante 400
slochan82: posts the ante 400
JJin91: posts the ante 400
FizzEdJohn: posts the ante 400
slochan82: posts small blind 1600
JJin91: posts big blind 3200
*** HOLE CARDS ***
Dealt to JJin91 [9s 9h]
FizzEdJohn: folds=20
sellycube: folds=20
YourRobotDad: folds=20
slochan82: calls 1600
JJin91: checks=20
*** FLOP *** [Kc 5h Jh]
slochan82: bets 3200
JJin91: calls 3200
*** TURN *** [Kc 5h Jh] [Qd]
slochan82: checks=20
JJin91: bets 7548
slochan82: folds=20
Uncalled bet (7548) returned to JJin91
JJin91 collected 14800 from pot
JJin91: doesn't show hand=20
*** SUMMARY ***
Total pot 14800 | Rake 0=20
Board [Kc 5h Jh Qd]
Seat 2: sellycube folded before Flop (didn't bet)
Seat 3: YourRobotDad (button) folded before Flop (didn't bet)
Seat 4: slochan82 (small blind) folded on the Turn
Seat 5: JJin91 (big blind) collected (14800)
Seat 6: FizzEdJohn folded before Flop (didn't bet)


*********** # 187 **************
PokerStars Hand #175481013725: Tournament #1701793695, $9.10+$0.90 USD =
Hold'em No Limit - Level XX (1600/3200) - 2017/09/24 19:19:32 ET
Table '1701793695 17' 6-max Seat #4 is the button
Seat 1: joerodgers7 (20000 in chips)=20
Seat 2: sellycube (73241 in chips)=20
Seat 3: YourRobotDad (48650 in chips)=20
Seat 4: slochan82 (51380 in chips)=20
Seat 5: JJin91 (376916 in chips)=20
Seat 6: FizzEdJohn (36676 in chips)=20
joerodgers7: posts the ante 400
sellycube: posts the ante 400
YourRobotDad: posts the ante 400
slochan82: posts the ante 400
JJin91: posts the ante 400
FizzEdJohn: posts the ante 400
JJin91: posts small blind 1600
FizzEdJohn: posts big blind 3200
*** HOLE CARDS ***
Dealt to JJin91 [5c 7d]
joerodgers7: folds=20
sellycube: folds=20
YourRobotDad: folds=20
slochan82: folds=20
JJin91: folds=20
Uncalled bet (1600) returned to FizzEdJohn
FizzEdJohn collected 5600 from pot
FizzEdJohn: doesn't show hand=20
*** SUMMARY ***
Total pot 5600 | Rake 0=20
Seat 1: joerodgers7 folded before Flop (didn't bet)
Seat 2: sellycube folded before Flop (didn't bet)
Seat 3: YourRobotDad folded before Flop (didn't bet)
Seat 4: slochan82 (button) folded before Flop (didn't bet)
Seat 5: JJin91 (small blind) folded before Flop
Seat 6: FizzEdJohn (big blind) collected (5600)


*********** # 188 **************
PokerStars Hand #175481013778: Tournament #1701793695, $9.10+$0.90 USD =
Hold'em No Limit - Level XX (1600/3200) - 2017/09/24 19:19:44 ET
Table '1701793695 17' 6-max Seat #5 is the button
Seat 1: joerodgers7 (19600 in chips)=20
Seat 2: sellycube (72841 in chips)=20
Seat 3: YourRobotDad (48250 in chips)=20
Seat 4: slochan82 (50980 in chips)=20
Seat 5: JJin91 (374916 in chips)=20
Seat 6: FizzEdJohn (40276 in chips)=20
joerodgers7: posts the ante 400
sellycube: posts the ante 400
YourRobotDad: posts the ante 400
slochan82: posts the ante 400
JJin91: posts the ante 400
FizzEdJohn: posts the ante 400
FizzEdJohn: posts small blind 1600
joerodgers7: posts big blind 3200
*** HOLE CARDS ***
Dealt to JJin91 [4h Qc]
sellycube: folds=20
YourRobotDad: folds=20
slochan82: calls 3200
JJin91: folds=20
FizzEdJohn: folds=20
joerodgers7: raises 16000 to 19200 and is all-in
slochan82: calls 16000
*** FLOP *** [4c 7h Js]
*** TURN *** [4c 7h Js] [3d]
*** RIVER *** [4c 7h Js 3d] [5h]
*** SHOW DOWN ***
joerodgers7: shows [7s Ts] (a pair of Sevens)
slochan82: shows [As 8s] (high card Ace)
joerodgers7 collected 42400 from pot
*** SUMMARY ***
Total pot 42400 | Rake 0=20
Board [4c 7h Js 3d 5h]
Seat 1: joerodgers7 (big blind) showed [7s Ts] and won (42400) with a p=
air of Sevens
Seat 2: sellycube folded before Flop (didn't bet)
Seat 3: YourRobotDad folded before Flop (didn't bet)
Seat 4: slochan82 showed [As 8s] and lost with high card Ace
Seat 5: JJin91 (button) folded before Flop (didn't bet)
Seat 6: FizzEdJohn (small blind) folded before Flop


*********** # 189 **************
PokerStars Hand #175481013943: Tournament #1701793695, $9.10+$0.90 USD =
Hold'em No Limit - Level XX (1600/3200) - 2017/09/24 19:20:28 ET
Table '1701793695 17' 6-max Seat #6 is the button
Seat 1: joerodgers7 (42400 in chips)=20
Seat 2: sellycube (72441 in chips)=20
Seat 3: YourRobotDad (47850 in chips)=20
Seat 4: slochan82 (31380 in chips)=20
Seat 5: JJin91 (374516 in chips)=20
Seat 6: FizzEdJohn (38276 in chips)=20
joerodgers7: posts the ante 400
sellycube: posts the ante 400
YourRobotDad: posts the ante 400
slochan82: posts the ante 400
JJin91: posts the ante 400
FizzEdJohn: posts the ante 400
joerodgers7: posts small blind 1600
sellycube: posts big blind 3200
*** HOLE CARDS ***
Dealt to JJin91 [Jh 4c]
YourRobotDad: raises 3200 to 6400
slochan82: folds=20
JJin91: folds=20
FizzEdJohn: folds=20
joerodgers7: folds=20
sellycube: calls 3200
*** FLOP *** [9s 2d 6c]
sellycube: checks=20
YourRobotDad: checks=20
*** TURN *** [9s 2d 6c] [7h]
sellycube: bets 8400
YourRobotDad: raises 8400 to 16800
sellycube: calls 8400
*** RIVER *** [9s 2d 6c 7h] [Td]
sellycube: checks=20
YourRobotDad: checks=20
*** SHOW DOWN ***
sellycube: shows [7c Qh] (a pair of Sevens)
YourRobotDad: shows [6h 6d] (three of a kind, Sixes)
YourRobotDad collected 50400 from pot
*** SUMMARY ***
Total pot 50400 | Rake 0=20
Board [9s 2d 6c 7h Td]
Seat 1: joerodgers7 (small blind) folded before Flop
Seat 2: sellycube (big blind) showed [7c Qh] and lost with a pair of Se=
vens
Seat 3: YourRobotDad showed [6h 6d] and won (50400) with three of a kin=
d, Sixes
Seat 4: slochan82 folded before Flop (didn't bet)
Seat 5: JJin91 folded before Flop (didn't bet)
Seat 6: FizzEdJohn (button) folded before Flop (didn't bet)


*********** # 190 **************
PokerStars Hand #175481014163: Tournament #1701793695, $9.10+$0.90 USD =
Hold'em No Limit - Level XX (1600/3200) - 2017/09/24 19:21:16 ET
Table '1701793695 17' 6-max Seat #1 is the button
Seat 1: joerodgers7 (40400 in chips)=20
Seat 2: sellycube (48841 in chips)=20
Seat 3: YourRobotDad (74650 in chips)=20
Seat 4: slochan82 (30980 in chips)=20
Seat 5: JJin91 (374116 in chips)=20
Seat 6: FizzEdJohn (37876 in chips)=20
joerodgers7: posts the ante 400
sellycube: posts the ante 400
YourRobotDad: posts the ante 400
slochan82: posts the ante 400
JJin91: posts the ante 400
FizzEdJohn: posts the ante 400
sellycube: posts small blind 1600
YourRobotDad: posts big blind 3200
*** HOLE CARDS ***
Dealt to JJin91 [5h 7c]
slochan82: raises 3200 to 6400
JJin91: folds=20
FizzEdJohn: folds=20
joerodgers7: folds=20
sellycube: folds=20
YourRobotDad: folds=20
Uncalled bet (3200) returned to slochan82
slochan82 collected 10400 from pot
*** SUMMARY ***
Total pot 10400 | Rake 0=20
Seat 1: joerodgers7 (button) folded before Flop (didn't bet)
Seat 2: sellycube (small blind) folded before Flop
Seat 3: YourRobotDad (big blind) folded before Flop
Seat 4: slochan82 collected (10400)
Seat 5: JJin91 folded before Flop (didn't bet)
Seat 6: FizzEdJohn folded before Flop (didn't bet)


*********** # 191 **************
PokerStars Hand #175481014291: Tournament #1701793695, $9.10+$0.90 USD =
Hold'em No Limit - Level XX (1600/3200) - 2017/09/24 19:21:47 ET
Table '1701793695 17' 6-max Seat #2 is the button
Seat 1: joerodgers7 (40000 in chips)=20
Seat 2: sellycube (46841 in chips)=20
Seat 3: YourRobotDad (71050 in chips)=20
Seat 4: slochan82 (37780 in chips)=20
Seat 5: JJin91 (373716 in chips)=20
Seat 6: FizzEdJohn (37476 in chips)=20
joerodgers7: posts the ante 400
sellycube: posts the ante 400
YourRobotDad: posts the ante 400
slochan82: posts the ante 400
JJin91: posts the ante 400
FizzEdJohn: posts the ante 400
YourRobotDad: posts small blind 1600
slochan82: posts big blind 3200
*** HOLE CARDS ***
Dealt to JJin91 [Ks 8s]
JJin91: folds=20
FizzEdJohn: folds=20
joerodgers7: folds=20
sellycube: calls 3200
YourRobotDad: folds=20
slochan82: checks=20
*** FLOP *** [Kd 8d 5d]
slochan82: checks=20
sellycube: checks=20
*** TURN *** [Kd 8d 5d] [Qd]
slochan82: bets 3200
sellycube: calls 3200
*** RIVER *** [Kd 8d 5d Qd] [5h]
slochan82: checks=20
sellycube: bets 16800
slochan82: folds=20
Uncalled bet (16800) returned to sellycube
sellycube collected 16800 from pot
sellycube: doesn't show hand=20
*** SUMMARY ***
Total pot 16800 | Rake 0=20
Board [Kd 8d 5d Qd 5h]
Seat 1: joerodgers7 folded before Flop (didn't bet)
Seat 2: sellycube (button) collected (16800)
Seat 3: YourRobotDad (small blind) folded before Flop
Seat 4: slochan82 (big blind) folded on the River
Seat 5: JJin91 folded before Flop (didn't bet)
Seat 6: FizzEdJohn folded before Flop (didn't bet)


*********** # 192 **************
PokerStars Hand #175481014517: Tournament #1701793695, $9.10+$0.90 USD =
Hold'em No Limit - Level XXI (1800/3600) - 2017/09/24 19:22:44 ET
Table '1701793695 17' 6-max Seat #3 is the button
Seat 1: joerodgers7 (39600 in chips)=20
Seat 2: sellycube (56841 in chips)=20
Seat 3: YourRobotDad (69050 in chips)=20
Seat 4: slochan82 (30980 in chips)=20
Seat 5: JJin91 (373316 in chips)=20
Seat 6: FizzEdJohn (37076 in chips)=20
joerodgers7: posts the ante 450
sellycube: posts the ante 450
YourRobotDad: posts the ante 450
slochan82: posts the ante 450
JJin91: posts the ante 450
FizzEdJohn: posts the ante 450
slochan82: posts small blind 1800
JJin91: posts big blind 3600
*** HOLE CARDS ***
Dealt to JJin91 [6s 7d]
FizzEdJohn: folds=20
joerodgers7: folds=20
sellycube: folds=20
YourRobotDad: folds=20
slochan82: folds=20
Uncalled bet (1800) returned to JJin91
JJin91 collected 6300 from pot
JJin91: doesn't show hand=20
*** SUMMARY ***
Total pot 6300 | Rake 0=20
Seat 1: joerodgers7 folded before Flop (didn't bet)
Seat 2: sellycube folded before Flop (didn't bet)
Seat 3: YourRobotDad (button) folded before Flop (didn't bet)
Seat 4: slochan82 (small blind) folded before Flop
Seat 5: JJin91 (big blind) collected (6300)
Seat 6: FizzEdJohn folded before Flop (didn't bet)


*********** # 193 **************
PokerStars Hand #175481014579: Tournament #1701793695, $9.10+$0.90 USD =
Hold'em No Limit - Level XXI (1800/3600) - 2017/09/24 19:23:00 ET
Table '1701793695 17' 6-max Seat #4 is the button
Seat 1: joerodgers7 (39150 in chips)=20
Seat 2: sellycube (56391 in chips)=20
Seat 3: YourRobotDad (68600 in chips)=20
Seat 4: slochan82 (28730 in chips)=20
Seat 5: JJin91 (377366 in chips)=20
Seat 6: FizzEdJohn (36626 in chips)=20
joerodgers7: posts the ante 450
sellycube: posts the ante 450
YourRobotDad: posts the ante 450
slochan82: posts the ante 450
JJin91: posts the ante 450
FizzEdJohn: posts the ante 450
JJin91: posts small blind 1800
FizzEdJohn: posts big blind 3600
*** HOLE CARDS ***
Dealt to JJin91 [As Td]
joerodgers7: folds=20
sellycube: raises 3600 to 7200
YourRobotDad: folds=20
slochan82: raises 21080 to 28280 and is all-in
JJin91: raises 21080 to 49360
FizzEdJohn: folds=20
sellycube: folds=20
Uncalled bet (21080) returned to JJin91
*** FLOP *** [2d 5h Js]
*** TURN *** [2d 5h Js] [3c]
*** RIVER *** [2d 5h Js 3c] [2c]
*** SHOW DOWN ***
JJin91: shows [As Td] (a pair of Deuces)
slochan82: shows [5d 5s] (a full house, Fives full of Deuces)
slochan82 collected 70060 from pot
*** SUMMARY ***
Total pot 70060 | Rake 0=20
Board [2d 5h Js 3c 2c]
Seat 1: joerodgers7 folded before Flop (didn't bet)
Seat 2: sellycube folded before Flop
Seat 3: YourRobotDad folded before Flop (didn't bet)
Seat 4: slochan82 (button) showed [5d 5s] and won (70060) with a full h=
ouse, Fives full of Deuces
Seat 5: JJin91 (small blind) showed [As Td] and lost with a pair of Deu=
ces
Seat 6: FizzEdJohn (big blind) folded before Flop


*********** # 194 **************
PokerStars Hand #175481014792: Tournament #1701793695, $9.10+$0.90 USD =
Hold'em No Limit - Level XXI (1800/3600) - 2017/09/24 19:23:55 ET
Table '1701793695 17' 6-max Seat #5 is the button
Seat 1: joerodgers7 (38700 in chips)=20
Seat 2: sellycube (48741 in chips)=20
Seat 3: YourRobotDad (68150 in chips)=20
Seat 4: slochan82 (70060 in chips)=20
Seat 5: JJin91 (348636 in chips)=20
Seat 6: FizzEdJohn (32576 in chips)=20
joerodgers7: posts the ante 450
sellycube: posts the ante 450
YourRobotDad: posts the ante 450
slochan82: posts the ante 450
JJin91: posts the ante 450
FizzEdJohn: posts the ante 450
FizzEdJohn: posts small blind 1800
joerodgers7: posts big blind 3600
*** HOLE CARDS ***
Dealt to JJin91 [Js Qd]
sellycube: folds=20
YourRobotDad: raises 3600 to 7200
slochan82: calls 7200
JJin91: folds=20
FizzEdJohn: raises 24926 to 32126 and is all-in
joerodgers7: folds=20
YourRobotDad: calls 24926
slochan82: folds=20
*** FLOP *** [Ks 3h Qs]
*** TURN *** [Ks 3h Qs] [6d]
*** RIVER *** [Ks 3h Qs 6d] [2h]
*** SHOW DOWN ***
FizzEdJohn: shows [Th Ts] (a pair of Tens)
YourRobotDad: shows [9h 9c] (a pair of Nines)
FizzEdJohn collected 77752 from pot
*** SUMMARY ***
Total pot 77752 | Rake 0=20
Board [Ks 3h Qs 6d 2h]
Seat 1: joerodgers7 (big blind) folded before Flop
Seat 2: sellycube folded before Flop (didn't bet)
Seat 3: YourRobotDad showed [9h 9c] and lost with a pair of Nines
Seat 4: slochan82 folded before Flop
Seat 5: JJin91 (button) folded before Flop (didn't bet)
Seat 6: FizzEdJohn (small blind) showed [Th Ts] and won (77752) with a =
pair of Tens


*********** # 195 **************
PokerStars Hand #175481015132: Tournament #1701793695, $9.10+$0.90 USD =
Hold'em No Limit - Level XXI (1800/3600) - 2017/09/24 19:25:11 ET
Table '1701793695 17' 6-max Seat #6 is the button
Seat 1: joerodgers7 (34650 in chips)=20
Seat 2: sellycube (48291 in chips)=20
Seat 3: YourRobotDad (35574 in chips)=20
Seat 4: slochan82 (62410 in chips)=20
Seat 5: JJin91 (348186 in chips)=20
Seat 6: FizzEdJohn (77752 in chips)=20
joerodgers7: posts the ante 450
sellycube: posts the ante 450
YourRobotDad: posts the ante 450
slochan82: posts the ante 450
JJin91: posts the ante 450
FizzEdJohn: posts the ante 450
joerodgers7: posts small blind 1800
sellycube: posts big blind 3600
*** HOLE CARDS ***
Dealt to JJin91 [3h Td]
YourRobotDad: folds=20
slochan82: folds=20
JJin91: folds=20
FizzEdJohn: raises 73702 to 77302 and is all-in
joerodgers7: folds=20
sellycube: folds=20
Uncalled bet (73702) returned to FizzEdJohn
FizzEdJohn collected 11700 from pot
FizzEdJohn: doesn't show hand=20
*** SUMMARY ***
Total pot 11700 | Rake 0=20
Seat 1: joerodgers7 (small blind) folded before Flop
Seat 2: sellycube (big blind) folded before Flop
Seat 3: YourRobotDad folded before Flop (didn't bet)
Seat 4: slochan82 folded before Flop (didn't bet)
Seat 5: JJin91 folded before Flop (didn't bet)
Seat 6: FizzEdJohn (button) collected (11700)


*********** # 196 **************
PokerStars Hand #175481015264: Tournament #1701793695, $9.10+$0.90 USD =
Hold'em No Limit - Level XXI (1800/3600) - 2017/09/24 19:25:42 ET
Table '1701793695 17' 6-max Seat #1 is the button
Seat 1: joerodgers7 (32400 in chips)=20
Seat 2: sellycube (44241 in chips)=20
Seat 3: YourRobotDad (35124 in chips)=20
Seat 4: slochan82 (61960 in chips)=20
Seat 5: JJin91 (347736 in chips)=20
Seat 6: FizzEdJohn (85402 in chips)=20
joerodgers7: posts the ante 450
sellycube: posts the ante 450
YourRobotDad: posts the ante 450
slochan82: posts the ante 450
JJin91: posts the ante 450
FizzEdJohn: posts the ante 450
sellycube: posts small blind 1800
YourRobotDad: posts big blind 3600
*** HOLE CARDS ***
Dealt to JJin91 [Jd Tc]
slochan82: folds=20
JJin91: folds=20
FizzEdJohn: folds=20
joerodgers7: folds=20
sellycube: folds=20
Uncalled bet (1800) returned to YourRobotDad
YourRobotDad collected 6300 from pot
*** SUMMARY ***
Total pot 6300 | Rake 0=20
Seat 1: joerodgers7 (button) folded before Flop (didn't bet)
Seat 2: sellycube (small blind) folded before Flop
Seat 3: YourRobotDad (big blind) collected (6300)
Seat 4: slochan82 folded before Flop (didn't bet)
Seat 5: JJin91 folded before Flop (didn't bet)
Seat 6: FizzEdJohn folded before Flop (didn't bet)


*********** # 197 **************
PokerStars Hand #175481015509: Tournament #1701793695, $9.10+$0.90 USD =
Hold'em No Limit - Level XXI (1800/3600) - 2017/09/24 19:26:42 ET
Table '1701793695 17' 6-max Seat #2 is the button
Seat 1: joerodgers7 (31950 in chips)=20
Seat 2: sellycube (41991 in chips)=20
Seat 3: YourRobotDad (39174 in chips)=20
Seat 4: slochan82 (61510 in chips)=20
Seat 5: JJin91 (347286 in chips)=20
joerodgers7: posts the ante 450
sellycube: posts the ante 450
YourRobotDad: posts the ante 450
slochan82: posts the ante 450
JJin91: posts the ante 450
YourRobotDad: posts small blind 1800
slochan82: posts big blind 3600
*** HOLE CARDS ***
Dealt to JJin91 [Kd Ad]
JJin91: raises 4212 to 7812
joerodgers7: folds=20
sellycube: calls 7812
YourRobotDad: folds=20
slochan82: folds=20
*** FLOP *** [9d As 7s]
JJin91: checks=20
sellycube: checks=20
*** TURN *** [9d As 7s] [Th]
JJin91: bets 8611
sellycube: calls 8611
*** RIVER *** [9d As 7s Th] [Kh]
JJin91: bets 40496
sellycube: calls 25118 and is all-in
Uncalled bet (15378) returned to JJin91
*** SHOW DOWN ***
JJin91: shows [Kd Ad] (two pair, Aces and Kings)
sellycube: shows [Ks 7d] (two pair, Kings and Sevens)
JJin91 collected 90732 from pot
sellycube finished the tournament in 144th place
*** SUMMARY ***
Total pot 90732 | Rake 0=20
Board [9d As 7s Th Kh]
Seat 1: joerodgers7 folded before Flop (didn't bet)
Seat 2: sellycube (button) showed [Ks 7d] and lost with two pair, Kings=
 and Sevens
Seat 3: YourRobotDad (small blind) folded before Flop
Seat 4: slochan82 (big blind) folded before Flop
Seat 5: JJin91 showed [Kd Ad] and won (90732) with two pair, Aces and K=
ings


*********** # 198 **************
PokerStars Hand #175481015698: Tournament #1701793695, $9.10+$0.90 USD =
Hold'em No Limit - Level XXI (1800/3600) - 2017/09/24 19:27:28 ET
Table '1701793695 17' 6-max Seat #3 is the button
Seat 1: joerodgers7 (31500 in chips)=20
Seat 3: YourRobotDad (36924 in chips)=20
Seat 4: slochan82 (57460 in chips)=20
Seat 5: JJin91 (396027 in chips)=20
joerodgers7: posts the ante 450
YourRobotDad: posts the ante 450
slochan82: posts the ante 450
JJin91: posts the ante 450
slochan82: posts small blind 1800
JJin91: posts big blind 3600
*** HOLE CARDS ***
Dealt to JJin91 [Tc 3s]
joerodgers7: raises 27450 to 31050 and is all-in
YourRobotDad: folds=20
slochan82: folds=20
JJin91: calls 27450
*** FLOP *** [4h 3d 5c]
*** TURN *** [4h 3d 5c] [Ac]
*** RIVER *** [4h 3d 5c Ac] [9s]
*** SHOW DOWN ***
JJin91: shows [Tc 3s] (a pair of Threes)
joerodgers7: shows [Qh Kd] (high card Ace)
JJin91 collected 65700 from pot
joerodgers7 finished the tournament in 141st place
*** SUMMARY ***
Total pot 65700 | Rake 0=20
Board [4h 3d 5c Ac 9s]
Seat 1: joerodgers7 showed [Qh Kd] and lost with high card Ace
Seat 3: YourRobotDad (button) folded before Flop (didn't bet)
Seat 4: slochan82 (small blind) folded before Flop
Seat 5: JJin91 (big blind) showed [Tc 3s] and won (65700) with a pair o=
f Threes


*********** # 199 **************
PokerStars Hand #175481015800: Tournament #1701793695, $9.10+$0.90 USD =
Hold'em No Limit - Level XXI (1800/3600) - 2017/09/24 19:27:51 ET
Table '1701793695 17' 6-max Seat #4 is the button
Seat 3: YourRobotDad (36474 in chips)=20
Seat 4: slochan82 (55210 in chips)=20
Seat 5: JJin91 (430227 in chips)=20
Seat 6: trizkelion10 (52898 in chips)=20
YourRobotDad: posts the ante 450
slochan82: posts the ante 450
JJin91: posts the ante 450
trizkelion10: posts the ante 450
JJin91: posts small blind 1800
trizkelion10: posts big blind 3600
*** HOLE CARDS ***
Dealt to JJin91 [Kd 7s]
YourRobotDad: raises 7200 to 10800
slochan82: folds=20
JJin91: folds=20
trizkelion10: folds=20
Uncalled bet (7200) returned to YourRobotDad
YourRobotDad collected 10800 from pot
*** SUMMARY ***
Total pot 10800 | Rake 0=20
Seat 3: YourRobotDad collected (10800)
Seat 4: slochan82 (button) folded before Flop (didn't bet)
Seat 5: JJin91 (small blind) folded before Flop
Seat 6: trizkelion10 (big blind) folded before Flop


*********** # 200 **************
PokerStars Hand #175481015935: Tournament #1701793695, $9.10+$0.90 USD =
Hold'em No Limit - Level XXI (1800/3600) - 2017/09/24 19:28:23 ET
Table '1701793695 17' 6-max Seat #5 is the button
Seat 1: CNA151 (49084 in chips)=20
Seat 3: YourRobotDad (43224 in chips)=20
Seat 4: slochan82 (54760 in chips)=20
Seat 5: JJin91 (427977 in chips)=20
Seat 6: trizkelion10 (48848 in chips)=20
CNA151: posts the ante 450
YourRobotDad: posts the ante 450
slochan82: posts the ante 450
JJin91: posts the ante 450
trizkelion10: posts the ante 450
trizkelion10: posts small blind 1800
CNA151: posts big blind 3600
*** HOLE CARDS ***
Dealt to JJin91 [Qd Ah]
YourRobotDad: raises 7200 to 10800
slochan82: calls 10800
JJin91: raises 416727 to 427527 and is all-in
trizkelion10: folds=20
CNA151: folds=20
YourRobotDad: calls 31974 and is all-in
slochan82: calls 43510 and is all-in
Uncalled bet (373217) returned to JJin91
*** FLOP *** [7h 2s Jh]
*** TURN *** [7h 2s Jh] [7c]
*** RIVER *** [7h 2s Jh 7c] [Ts]
*** SHOW DOWN ***
slochan82: shows [Ad Qh] (a pair of Sevens)
JJin91: shows [Qd Ah] (a pair of Sevens)
slochan82 collected 11536 from side pot
JJin91 collected 11536 from side pot
YourRobotDad: shows [Js Jd] (a full house, Jacks full of Sevens)
YourRobotDad collected 135972 from main pot
*** SUMMARY ***
Total pot 159044 Main pot 135972. Side pot 23072. | Rake 0=20
Board [7h 2s Jh 7c Ts]
Seat 1: CNA151 (big blind) folded before Flop
Seat 3: YourRobotDad showed [Js Jd] and won (135972) with a full house,=
 Jacks full of Sevens
Seat 4: slochan82 showed [Ad Qh] and won (11536) with a pair of Sevens
Seat 5: JJin91 (button) showed [Qd Ah] and won (11536) with a pair of S=
evens
Seat 6: trizkelion10 (small blind) folded before Flop


*********** # 201 **************
PokerStars Hand #175481016091: Tournament #1701793695, $9.10+$0.90 USD =
Hold'em No Limit - Level XXI (1800/3600) - 2017/09/24 19:29:04 ET
Table '1701793695 17' 6-max Seat #6 is the button
Seat 1: CNA151 (45034 in chips)=20
Seat 3: YourRobotDad (135972 in chips)=20
Seat 4: slochan82 (11536 in chips)=20
Seat 5: JJin91 (384753 in chips)=20
Seat 6: trizkelion10 (46598 in chips)=20
CNA151: posts the ante 450
YourRobotDad: posts the ante 450
slochan82: posts the ante 450
JJin91: posts the ante 450
trizkelion10: posts the ante 450
CNA151: posts small blind 1800
YourRobotDad: posts big blind 3600
*** HOLE CARDS ***
Dealt to JJin91 [4c Tc]
slochan82: raises 7486 to 11086 and is all-in
JJin91: folds=20
trizkelion10: folds=20
CNA151: folds=20
YourRobotDad: folds=20
Uncalled bet (7486) returned to slochan82
slochan82 collected 11250 from pot
*** SUMMARY ***
Total pot 11250 | Rake 0=20
Seat 1: CNA151 (small blind) folded before Flop
Seat 3: YourRobotDad (big blind) folded before Flop
Seat 4: slochan82 collected (11250)
Seat 5: JJin91 folded before Flop (didn't bet)
Seat 6: trizkelion10 (button) folded before Flop (didn't bet)


*********** # 202 **************
PokerStars Hand #175481016154: Tournament #1701793695, $9.10+$0.90 USD =
Hold'em No Limit - Level XXI (1800/3600) - 2017/09/24 19:29:21 ET
Table '1701793695 17' 6-max Seat #1 is the button
Seat 1: CNA151 (42784 in chips)=20
Seat 3: YourRobotDad (131922 in chips)=20
Seat 4: slochan82 (18736 in chips)=20
Seat 5: JJin91 (384303 in chips)=20
Seat 6: trizkelion10 (46148 in chips)=20
CNA151: posts the ante 450
YourRobotDad: posts the ante 450
slochan82: posts the ante 450
JJin91: posts the ante 450
trizkelion10: posts the ante 450
YourRobotDad: posts small blind 1800
slochan82: posts big blind 3600
*** HOLE CARDS ***
Dealt to JJin91 [Ks 6s]
JJin91: folds=20
trizkelion10: folds=20
CNA151: folds=20
YourRobotDad: raises 7200 to 10800
slochan82: folds=20
Uncalled bet (7200) returned to YourRobotDad
YourRobotDad collected 9450 from pot
*** SUMMARY ***
Total pot 9450 | Rake 0=20
Seat 1: CNA151 (button) folded before Flop (didn't bet)
Seat 3: YourRobotDad (small blind) collected (9450)
Seat 4: slochan82 (big blind) folded before Flop
Seat 5: JJin91 folded before Flop (didn't bet)
Seat 6: trizkelion10 folded before Flop (didn't bet)


*********** # 203 **************
PokerStars Hand #175481016243: Tournament #1701793695, $9.10+$0.90 USD =
Hold'em No Limit - Level XXI (1800/3600) - 2017/09/24 19:29:44 ET
Table '1701793695 17' 6-max Seat #3 is the button
Seat 1: CNA151 (42334 in chips)=20
Seat 3: YourRobotDad (137322 in chips)=20
Seat 4: slochan82 (14686 in chips)=20
Seat 5: JJin91 (383853 in chips)=20
Seat 6: trizkelion10 (45698 in chips)=20
CNA151: posts the ante 450
YourRobotDad: posts the ante 450
slochan82: posts the ante 450
JJin91: posts the ante 450
trizkelion10: posts the ante 450
slochan82: posts small blind 1800
JJin91: posts big blind 3600
*** HOLE CARDS ***
Dealt to JJin91 [Td Jd]
trizkelion10: calls 3600
CNA151: raises 38284 to 41884 and is all-in
YourRobotDad: folds=20
slochan82: folds=20
JJin91: folds=20
trizkelion10: folds=20
Uncalled bet (38284) returned to CNA151
CNA151 collected 14850 from pot
CNA151: doesn't show hand=20
*** SUMMARY ***
Total pot 14850 | Rake 0=20
Seat 1: CNA151 collected (14850)
Seat 3: YourRobotDad (button) folded before Flop (didn't bet)
Seat 4: slochan82 (small blind) folded before Flop
Seat 5: JJin91 (big blind) folded before Flop
Seat 6: trizkelion10 folded before Flop


*********** # 204 **************
PokerStars Hand #175481016316: Tournament #1701793695, $9.10+$0.90 USD =
Hold'em No Limit - Level XXI (1800/3600) - 2017/09/24 19:30:03 ET
Table '1701793695 17' 6-max Seat #4 is the button
Seat 1: CNA151 (53134 in chips)=20
Seat 3: YourRobotDad (136872 in chips)=20
Seat 4: slochan82 (12436 in chips)=20
Seat 5: JJin91 (379803 in chips)=20
Seat 6: trizkelion10 (41648 in chips)=20
CNA151: posts the ante 450
YourRobotDad: posts the ante 450
slochan82: posts the ante 450
JJin91: posts the ante 450
trizkelion10: posts the ante 450
JJin91: posts small blind 1800
trizkelion10: posts big blind 3600
*** HOLE CARDS ***
Dealt to JJin91 [5c Qd]
CNA151: folds=20
YourRobotDad: folds=20
slochan82: raises 8386 to 11986 and is all-in
JJin91: folds=20
trizkelion10: calls 8386
*** FLOP *** [Qc Js Ks]
*** TURN *** [Qc Js Ks] [Kc]
*** RIVER *** [Qc Js Ks Kc] [4h]
*** SHOW DOWN ***
trizkelion10: shows [8d 9s] (a pair of Kings)
slochan82: shows [As 9d] (a pair of Kings - Ace kicker)
slochan82 collected 28022 from pot
*** SUMMARY ***
Total pot 28022 | Rake 0=20
Board [Qc Js Ks Kc 4h]
Seat 1: CNA151 folded before Flop (didn't bet)
Seat 3: YourRobotDad folded before Flop (didn't bet)
Seat 4: slochan82 (button) showed [As 9d] and won (28022) with a pair o=
f Kings
Seat 5: JJin91 (small blind) folded before Flop
Seat 6: trizkelion10 (big blind) showed [8d 9s] and lost with a pair of=
 Kings


*********** # 205 **************
PokerStars Hand #175481016531: Tournament #1701793695, $9.10+$0.90 USD =
Hold'em No Limit - Level XXII (2000/4000) - 2017/09/24 19:30:45 ET
Table '1701793695 17' 6-max Seat #5 is the button
Seat 1: CNA151 (52684 in chips)=20
Seat 3: YourRobotDad (136422 in chips)=20
Seat 4: slochan82 (28022 in chips)=20
Seat 5: JJin91 (377553 in chips)=20
Seat 6: trizkelion10 (29212 in chips)=20
CNA151: posts the ante 500
YourRobotDad: posts the ante 500
slochan82: posts the ante 500
JJin91: posts the ante 500
trizkelion10: posts the ante 500
trizkelion10: posts small blind 2000
CNA151: posts big blind 4000
*** HOLE CARDS ***
Dealt to JJin91 [Jd Kd]
YourRobotDad: folds=20
slochan82: folds=20
JJin91: raises 373053 to 377053 and is all-in
trizkelion10: folds=20
CNA151: folds=20
Uncalled bet (373053) returned to JJin91
JJin91 collected 12500 from pot
JJin91: doesn't show hand=20
*** SUMMARY ***
Total pot 12500 | Rake 0=20
Seat 1: CNA151 (big blind) folded before Flop
Seat 3: YourRobotDad folded before Flop (didn't bet)
Seat 4: slochan82 folded before Flop (didn't bet)
Seat 5: JJin91 (button) collected (12500)
Seat 6: trizkelion10 (small blind) folded before Flop


*********** # 206 **************
PokerStars Hand #175481016830: Tournament #1701793695, $9.10+$0.90 USD =
Hold'em No Limit - Level XXII (2000/4000) - 2017/09/24 19:31:35 ET
Table '1701793695 17' 6-max Seat #6 is the button
Seat 1: CNA151 (48184 in chips)=20
Seat 2: runner85 (78082 in chips)=20
Seat 3: YourRobotDad (135922 in chips)=20
Seat 4: slochan82 (27522 in chips)=20
Seat 5: JJin91 (385553 in chips)=20
Seat 6: trizkelion10 (26712 in chips)=20
CNA151: posts the ante 500
runner85: posts the ante 500
YourRobotDad: posts the ante 500
slochan82: posts the ante 500
JJin91: posts the ante 500
trizkelion10: posts the ante 500
CNA151: posts small blind 2000
runner85: posts big blind 4000
*** HOLE CARDS ***
Dealt to JJin91 [Kd 5c]
YourRobotDad: folds=20
slochan82: folds=20
JJin91: folds=20
trizkelion10: folds=20
CNA151: folds=20
Uncalled bet (2000) returned to runner85
runner85 collected 7000 from pot
*** SUMMARY ***
Total pot 7000 | Rake 0=20
Seat 1: CNA151 (small blind) folded before Flop
Seat 2: runner85 (big blind) collected (7000)
Seat 3: YourRobotDad folded before Flop (didn't bet)
Seat 4: slochan82 folded before Flop (didn't bet)
Seat 5: JJin91 folded before Flop (didn't bet)
Seat 6: trizkelion10 (button) folded before Flop (didn't bet)


*********** # 207 **************
PokerStars Hand #175481016983: Tournament #1701793695, $9.10+$0.90 USD =
Hold'em No Limit - Level XXII (2000/4000) - 2017/09/24 19:31:52 ET
Table '1701793695 17' 6-max Seat #1 is the button
Seat 1: CNA151 (45684 in chips)=20
Seat 2: runner85 (82582 in chips)=20
Seat 3: YourRobotDad (135422 in chips)=20
Seat 4: slochan82 (27022 in chips)=20
Seat 5: JJin91 (385053 in chips)=20
Seat 6: trizkelion10 (26212 in chips)=20
CNA151: posts the ante 500
runner85: posts the ante 500
YourRobotDad: posts the ante 500
slochan82: posts the ante 500
JJin91: posts the ante 500
trizkelion10: posts the ante 500
runner85: posts small blind 2000
YourRobotDad: posts big blind 4000
*** HOLE CARDS ***
Dealt to JJin91 [Ah 9c]
slochan82: folds=20
JJin91: raises 4680 to 8680
trizkelion10: raises 17032 to 25712 and is all-in
CNA151: folds=20
runner85: raises 56370 to 82082 and is all-in
YourRobotDad: folds=20
JJin91: folds=20
Uncalled bet (56370) returned to runner85
*** FLOP *** [2h Qd 4h]
*** TURN *** [2h Qd 4h] [9h]
*** RIVER *** [2h Qd 4h 9h] [2c]
*** SHOW DOWN ***
runner85: shows [Kd Kh] (two pair, Kings and Deuces)
trizkelion10: shows [Ts Th] (two pair, Tens and Deuces)
runner85 collected 67104 from pot
trizkelion10 finished the tournament in 123rd place
*** SUMMARY ***
Total pot 67104 | Rake 0=20
Board [2h Qd 4h 9h 2c]
Seat 1: CNA151 (button) folded before Flop (didn't bet)
Seat 2: runner85 (small blind) showed [Kd Kh] and won (67104) with two =
pair, Kings and Deuces
Seat 3: YourRobotDad (big blind) folded before Flop
Seat 4: slochan82 folded before Flop (didn't bet)
Seat 5: JJin91 folded before Flop
Seat 6: trizkelion10 showed [Ts Th] and lost with two pair, Tens and De=
uces


*********** # 208 **************
PokerStars Hand #175481017259: Tournament #1701793695, $9.10+$0.90 USD =
Hold'em No Limit - Level XXII (2000/4000) - 2017/09/24 19:32:26 ET
Table '1701793695 17' 6-max Seat #2 is the button
Seat 1: CNA151 (45184 in chips)=20
Seat 2: runner85 (123474 in chips)=20
Seat 3: YourRobotDad (130922 in chips)=20
Seat 4: slochan82 (26522 in chips)=20
Seat 5: JJin91 (375873 in chips)=20
CNA151: posts the ante 500
runner85: posts the ante 500
YourRobotDad: posts the ante 500
slochan82: posts the ante 500
JJin91: posts the ante 500
YourRobotDad: posts small blind 2000
slochan82: posts big blind 4000
*** HOLE CARDS ***
Dealt to JJin91 [3s 8s]
JJin91: folds=20
CNA151: folds=20
runner85: folds=20
YourRobotDad: raises 10500 to 14500
slochan82: raises 11522 to 26022 and is all-in
YourRobotDad: calls 11522
*** FLOP *** [8h 6h Ts]
*** TURN *** [8h 6h Ts] [Tc]
*** RIVER *** [8h 6h Ts Tc] [6d]
*** SHOW DOWN ***
YourRobotDad: shows [5h Ac] (two pair, Tens and Sixes)
slochan82: shows [2h Ah] (two pair, Tens and Sixes)
YourRobotDad collected 27272 from pot
slochan82 collected 27272 from pot
*** SUMMARY ***
Total pot 54544 | Rake 0=20
Board [8h 6h Ts Tc 6d]
Seat 1: CNA151 folded before Flop (didn't bet)
Seat 2: runner85 (button) folded before Flop (didn't bet)
Seat 3: YourRobotDad (small blind) showed [5h Ac] and won (27272) with =
two pair, Tens and Sixes
Seat 4: slochan82 (big blind) showed [2h Ah] and won (27272) with two p=
air, Tens and Sixes
Seat 5: JJin91 folded before Flop (didn't bet)


*********** # 209 **************
PokerStars Hand #175481017558: Tournament #1701793695, $9.10+$0.90 USD =
Hold'em No Limit - Level XXII (2000/4000) - 2017/09/24 19:33:02 ET
Table '1701793695 17' 6-max Seat #3 is the button
Seat 1: CNA151 (44684 in chips)=20
Seat 2: runner85 (122974 in chips)=20
Seat 3: YourRobotDad (131672 in chips)=20
Seat 4: slochan82 (27272 in chips)=20
Seat 5: JJin91 (375373 in chips)=20
CNA151: posts the ante 500
runner85: posts the ante 500
YourRobotDad: posts the ante 500
slochan82: posts the ante 500
JJin91: posts the ante 500
slochan82: posts small blind 2000
JJin91: posts big blind 4000
*** HOLE CARDS ***
Dealt to JJin91 [8h Qd]
CNA151: folds=20
runner85: raises 5000 to 9000
YourRobotDad: folds=20
slochan82: folds=20
JJin91: calls 5000
*** FLOP *** [9c Qh Ah]
JJin91: checks=20
runner85: bets 8000
JJin91: calls 8000
*** TURN *** [9c Qh Ah] [3c]
JJin91: checks=20
runner85: bets 12000
JJin91: calls 12000
*** RIVER *** [9c Qh Ah 3c] [6c]
JJin91: bets 21113
runner85: folds=20
Uncalled bet (21113) returned to JJin91
JJin91 collected 62500 from pot
JJin91: doesn't show hand=20
*** SUMMARY ***
Total pot 62500 | Rake 0=20
Board [9c Qh Ah 3c 6c]
Seat 1: CNA151 folded before Flop (didn't bet)
Seat 2: runner85 folded on the River
Seat 3: YourRobotDad (button) folded before Flop (didn't bet)
Seat 4: slochan82 (small blind) folded before Flop
Seat 5: JJin91 (big blind) collected (62500)


*********** # 210 **************
PokerStars Hand #175481018133: Tournament #1701793695, $9.10+$0.90 USD =
Hold'em No Limit - Level XXII (2000/4000) - 2017/09/24 19:34:09 ET
Table '1701793695 17' 6-max Seat #4 is the button
Seat 1: CNA151 (44184 in chips)=20
Seat 2: runner85 (93474 in chips)=20
Seat 3: YourRobotDad (131172 in chips)=20
Seat 4: slochan82 (24772 in chips)=20
Seat 5: JJin91 (408373 in chips)=20
Seat 6: JonnyKakes59 (20000 in chips)=20
CNA151: posts the ante 500
runner85: posts the ante 500
YourRobotDad: posts the ante 500
slochan82: posts the ante 500
JJin91: posts the ante 500
JonnyKakes59: posts the ante 500
JJin91: posts small blind 2000
JonnyKakes59: posts big blind 4000
*** HOLE CARDS ***
Dealt to JJin91 [8s Ts]
CNA151: folds=20
runner85: folds=20
YourRobotDad: folds=20
slochan82: folds=20
JJin91: raises 403873 to 407873 and is all-in
JonnyKakes59: calls 15500 and is all-in
Uncalled bet (388373) returned to JJin91
*** FLOP *** [5s Ad As]
*** TURN *** [5s Ad As] [3c]
*** RIVER *** [5s Ad As 3c] [7c]
*** SHOW DOWN ***
JJin91: shows [8s Ts] (a pair of Aces)
JonnyKakes59: shows [Qd 9d] (a pair of Aces - Queen kicker)
JonnyKakes59 collected 42000 from pot
*** SUMMARY ***
Total pot 42000 | Rake 0=20
Board [5s Ad As 3c 7c]
Seat 1: CNA151 folded before Flop (didn't bet)
Seat 2: runner85 folded before Flop (didn't bet)
Seat 3: YourRobotDad folded before Flop (didn't bet)
Seat 4: slochan82 (button) folded before Flop (didn't bet)
Seat 5: JJin91 (small blind) showed [8s Ts] and lost with a pair of Aces
Seat 6: JonnyKakes59 (big blind) showed [Qd 9d] and won (42000) with a =
pair of Aces


*********** # 211 **************
PokerStars Hand #175481018338: Tournament #1701793695, $9.10+$0.90 USD =
Hold'em No Limit - Level XXII (2000/4000) - 2017/09/24 19:34:34 ET
Table '1701793695 17' 6-max Seat #5 is the button
Seat 1: CNA151 (43684 in chips)=20
Seat 2: runner85 (92974 in chips)=20
Seat 3: YourRobotDad (130672 in chips)=20
Seat 4: slochan82 (24272 in chips)=20
Seat 5: JJin91 (388373 in chips)=20
Seat 6: JonnyKakes59 (42000 in chips)=20
CNA151: posts the ante 500
runner85: posts the ante 500
YourRobotDad: posts the ante 500
slochan82: posts the ante 500
JJin91: posts the ante 500
JonnyKakes59: posts the ante 500
JonnyKakes59: posts small blind 2000
CNA151: posts big blind 4000
*** HOLE CARDS ***
Dealt to JJin91 [6c 6s]
runner85: folds=20
YourRobotDad: folds=20
slochan82: raises 19772 to 23772 and is all-in
JJin91: raises 19772 to 43544
JonnyKakes59: folds=20
CNA151: folds=20
Uncalled bet (19772) returned to JJin91
*** FLOP *** [Qh 3s Th]
*** TURN *** [Qh 3s Th] [3d]
*** RIVER *** [Qh 3s Th 3d] [2c]
*** SHOW DOWN ***
slochan82: shows [Ac Kc] (a pair of Threes)
JJin91: shows [6c 6s] (two pair, Sixes and Threes)
JJin91 collected 56544 from pot
slochan82 finished the tournament in 117th place
*** SUMMARY ***
Total pot 56544 | Rake 0=20
Board [Qh 3s Th 3d 2c]
Seat 1: CNA151 (big blind) folded before Flop
Seat 2: runner85 folded before Flop (didn't bet)
Seat 3: YourRobotDad folded before Flop (didn't bet)
Seat 4: slochan82 showed [Ac Kc] and lost with a pair of Threes
Seat 5: JJin91 (button) showed [6c 6s] and won (56544) with two pair, S=
ixes and Threes
Seat 6: JonnyKakes59 (small blind) folded before Flop


*********** # 212 **************
PokerStars Hand #175481018577: Tournament #1701793695, $9.10+$0.90 USD =
Hold'em No Limit - Level XXII (2000/4000) - 2017/09/24 19:35:02 ET
Table '1701793695 17' 6-max Seat #6 is the button
Seat 1: CNA151 (39184 in chips)=20
Seat 2: runner85 (92474 in chips)=20
Seat 3: YourRobotDad (130172 in chips)=20
Seat 5: JJin91 (420645 in chips)=20
Seat 6: JonnyKakes59 (39500 in chips)=20
CNA151: posts the ante 500
runner85: posts the ante 500
YourRobotDad: posts the ante 500
JJin91: posts the ante 500
JonnyKakes59: posts the ante 500
CNA151: posts small blind 2000
runner85: posts big blind 4000
*** HOLE CARDS ***
Dealt to JJin91 [5s Js]
YourRobotDad: folds=20
JJin91: folds=20
JonnyKakes59: raises 8000 to 12000
CNA151: folds=20
runner85: folds=20
Uncalled bet (8000) returned to JonnyKakes59
JonnyKakes59 collected 12500 from pot
JonnyKakes59: doesn't show hand=20
*** SUMMARY ***
Total pot 12500 | Rake 0=20
Seat 1: CNA151 (small blind) folded before Flop
Seat 2: runner85 (big blind) folded before Flop
Seat 3: YourRobotDad folded before Flop (didn't bet)
Seat 5: JJin91 folded before Flop (didn't bet)
Seat 6: JonnyKakes59 (button) collected (12500)


*********** # 213 **************
PokerStars Hand #175481018736: Tournament #1701793695, $9.10+$0.90 USD =
Hold'em No Limit - Level XXII (2000/4000) - 2017/09/24 19:35:20 ET
Table '1701793695 17' 6-max Seat #1 is the button
Seat 1: CNA151 (36684 in chips)=20
Seat 2: runner85 (87974 in chips)=20
Seat 3: YourRobotDad (129672 in chips)=20
Seat 4: andypants8 (20000 in chips)=20
Seat 5: JJin91 (420145 in chips)=20
Seat 6: JonnyKakes59 (47500 in chips)=20
CNA151: posts the ante 500
runner85: posts the ante 500
YourRobotDad: posts the ante 500
andypants8: posts the ante 500
JJin91: posts the ante 500
JonnyKakes59: posts the ante 500
runner85: posts small blind 2000
YourRobotDad: posts big blind 4000
*** HOLE CARDS ***
Dealt to JJin91 [6d 7s]
andypants8: folds=20
JJin91: folds=20
JonnyKakes59: folds=20
CNA151: folds=20
runner85: calls 2000
YourRobotDad: raises 4000 to 8000
runner85: folds=20
Uncalled bet (4000) returned to YourRobotDad
YourRobotDad collected 11000 from pot
*** SUMMARY ***
Total pot 11000 | Rake 0=20
Seat 1: CNA151 (button) folded before Flop (didn't bet)
Seat 2: runner85 (small blind) folded before Flop
Seat 3: YourRobotDad (big blind) collected (11000)
Seat 4: andypants8 folded before Flop (didn't bet)
Seat 5: JJin91 folded before Flop (didn't bet)
Seat 6: JonnyKakes59 folded before Flop (didn't bet)


*********** # 214 **************
PokerStars Hand #175481018968: Tournament #1701793695, $9.10+$0.90 USD =
Hold'em No Limit - Level XXII (2000/4000) - 2017/09/24 19:35:48 ET
Table '1701793695 17' 6-max Seat #2 is the button
Seat 1: CNA151 (36184 in chips)=20
Seat 2: runner85 (83474 in chips)=20
Seat 3: YourRobotDad (136172 in chips)=20
Seat 4: andypants8 (19500 in chips)=20
Seat 5: JJin91 (419645 in chips)=20
Seat 6: JonnyKakes59 (47000 in chips)=20
CNA151: posts the ante 500
runner85: posts the ante 500
YourRobotDad: posts the ante 500
andypants8: posts the ante 500
JJin91: posts the ante 500
JonnyKakes59: posts the ante 500
YourRobotDad: posts small blind 2000
andypants8: posts big blind 4000
*** HOLE CARDS ***
Dealt to JJin91 [Jh Jc]
JJin91: raises 4680 to 8680
JonnyKakes59: folds=20
CNA151: folds=20
runner85: folds=20
YourRobotDad: folds=20
andypants8: folds=20
Uncalled bet (4680) returned to JJin91
JJin91 collected 13000 from pot
JJin91: doesn't show hand=20
*** SUMMARY ***
Total pot 13000 | Rake 0=20
Seat 1: CNA151 folded before Flop (didn't bet)
Seat 2: runner85 (button) folded before Flop (didn't bet)
Seat 3: YourRobotDad (small blind) folded before Flop
Seat 4: andypants8 (big blind) folded before Flop
Seat 5: JJin91 collected (13000)
Seat 6: JonnyKakes59 folded before Flop (didn't bet)


*********** # 215 **************
PokerStars Hand #175481019154: Tournament #1701793695, $9.10+$0.90 USD =
Hold'em No Limit - Level XXII (2000/4000) - 2017/09/24 19:36:10 ET
Table '1701793695 17' 6-max Seat #3 is the button
Seat 1: CNA151 (35684 in chips)=20
Seat 2: runner85 (82974 in chips)=20
Seat 3: YourRobotDad (133672 in chips)=20
Seat 4: andypants8 (15000 in chips)=20
Seat 5: JJin91 (428145 in chips)=20
Seat 6: JonnyKakes59 (46500 in chips)=20
CNA151: posts the ante 500
runner85: posts the ante 500
YourRobotDad: posts the ante 500
andypants8: posts the ante 500
JJin91: posts the ante 500
JonnyKakes59: posts the ante 500
andypants8: posts small blind 2000
JJin91: posts big blind 4000
*** HOLE CARDS ***
Dealt to JJin91 [8h Ah]
JonnyKakes59: folds=20
CNA151: folds=20
runner85: folds=20
YourRobotDad: folds=20
andypants8: raises 10500 to 14500 and is all-in
JJin91: calls 10500
*** FLOP *** [6h 4c 6s]
*** TURN *** [6h 4c 6s] [4d]
*** RIVER *** [6h 4c 6s 4d] [Kh]
*** SHOW DOWN ***
andypants8: shows [Td 4s] (a full house, Fours full of Sixes)
JJin91: shows [8h Ah] (two pair, Sixes and Fours)
andypants8 collected 32000 from pot
*** SUMMARY ***
Total pot 32000 | Rake 0=20
Board [6h 4c 6s 4d Kh]
Seat 1: CNA151 folded before Flop (didn't bet)
Seat 2: runner85 folded before Flop (didn't bet)
Seat 3: YourRobotDad (button) folded before Flop (didn't bet)
Seat 4: andypants8 (small blind) showed [Td 4s] and won (32000) with a =
full house, Fours full of Sixes
Seat 5: JJin91 (big blind) showed [8h Ah] and lost with two pair, Sixes=
 and Fours
Seat 6: JonnyKakes59 folded before Flop (didn't bet)


*********** # 216 **************
PokerStars Hand #175481019537: Tournament #1701793695, $9.10+$0.90 USD =
Hold'em No Limit - Level XXII (2000/4000) - 2017/09/24 19:36:56 ET
Table '1701793695 17' 6-max Seat #4 is the button
Seat 1: CNA151 (35184 in chips)=20
Seat 2: runner85 (82474 in chips)=20
Seat 3: YourRobotDad (133172 in chips)=20
Seat 4: andypants8 (32000 in chips)=20
Seat 5: JJin91 (413145 in chips)=20
Seat 6: JonnyKakes59 (46000 in chips)=20
CNA151: posts the ante 500
runner85: posts the ante 500
YourRobotDad: posts the ante 500
andypants8: posts the ante 500
JJin91: posts the ante 500
JonnyKakes59: posts the ante 500
JJin91: posts small blind 2000
JonnyKakes59: posts big blind 4000
*** HOLE CARDS ***
Dealt to JJin91 [2c Th]
CNA151: folds=20
runner85: folds=20
YourRobotDad: folds=20
andypants8: folds=20
JJin91: folds=20
Uncalled bet (2000) returned to JonnyKakes59
JonnyKakes59 collected 7000 from pot
JonnyKakes59: doesn't show hand=20
*** SUMMARY ***
Total pot 7000 | Rake 0=20
Seat 1: CNA151 folded before Flop (didn't bet)
Seat 2: runner85 folded before Flop (didn't bet)
Seat 3: YourRobotDad folded before Flop (didn't bet)
Seat 4: andypants8 (button) folded before Flop (didn't bet)
Seat 5: JJin91 (small blind) folded before Flop
Seat 6: JonnyKakes59 (big blind) collected (7000)


*********** # 217 **************
PokerStars Hand #175481019734: Tournament #1701793695, $9.10+$0.90 USD =
Hold'em No Limit - Level XXII (2000/4000) - 2017/09/24 19:37:21 ET
Table '1701793695 17' 6-max Seat #5 is the button
Seat 1: CNA151 (34684 in chips)=20
Seat 2: runner85 (81974 in chips)=20
Seat 4: andypants8 (31500 in chips)=20
Seat 5: JJin91 (410645 in chips)=20
Seat 6: JonnyKakes59 (50500 in chips)=20
CNA151: posts the ante 500
runner85: posts the ante 500
andypants8: posts the ante 500
JJin91: posts the ante 500
JonnyKakes59: posts the ante 500
JonnyKakes59: posts small blind 2000
CNA151: posts big blind 4000
*** HOLE CARDS ***
Dealt to JJin91 [5d Tc]
runner85: raises 4000 to 8000
andypants8: folds=20
JJin91: folds=20
JonnyKakes59: folds=20
CNA151: folds=20
Uncalled bet (4000) returned to runner85
runner85 collected 12500 from pot
*** SUMMARY ***
Total pot 12500 | Rake 0=20
Seat 1: CNA151 (big blind) folded before Flop
Seat 2: runner85 collected (12500)
Seat 4: andypants8 folded before Flop (didn't bet)
Seat 5: JJin91 (button) folded before Flop (didn't bet)
Seat 6: JonnyKakes59 (small blind) folded before Flop


*********** # 218 **************
PokerStars Hand #175481019904: Tournament #1701793695, $9.10+$0.90 USD =
Hold'em No Limit - Level XXII (2000/4000) - 2017/09/24 19:37:41 ET
Table '1701793695 17' 6-max Seat #6 is the button
Seat 1: CNA151 (30184 in chips)=20
Seat 2: runner85 (89974 in chips)=20
Seat 3: JohnnyMania (20000 in chips)=20
Seat 4: andypants8 (31000 in chips)=20
Seat 5: JJin91 (410145 in chips)=20
Seat 6: JonnyKakes59 (48000 in chips)=20
CNA151: posts the ante 500
runner85: posts the ante 500
JohnnyMania: posts the ante 500
andypants8: posts the ante 500
JJin91: posts the ante 500
JonnyKakes59: posts the ante 500
CNA151: posts small blind 2000
runner85: posts big blind 4000
*** HOLE CARDS ***
Dealt to JJin91 [As Qh]
JohnnyMania: folds=20
andypants8: folds=20
JJin91: raises 4680 to 8680
JonnyKakes59: raises 38820 to 47500 and is all-in
CNA151: folds=20
runner85: folds=20
JJin91: calls 38820
*** FLOP *** [Kh 4s Td]
*** TURN *** [Kh 4s Td] [Qs]
*** RIVER *** [Kh 4s Td Qs] [2s]
*** SHOW DOWN ***
JJin91: shows [As Qh] (a pair of Queens)
JonnyKakes59: shows [9c 9d] (a pair of Nines)
JJin91 collected 104000 from pot
JonnyKakes59 finished the tournament in 98th place
*** SUMMARY ***
Total pot 104000 | Rake 0=20
Board [Kh 4s Td Qs 2s]
Seat 1: CNA151 (small blind) folded before Flop
Seat 2: runner85 (big blind) folded before Flop
Seat 3: JohnnyMania folded before Flop (didn't bet)
Seat 4: andypants8 folded before Flop (didn't bet)
Seat 5: JJin91 showed [As Qh] and won (104000) with a pair of Queens
Seat 6: JonnyKakes59 (button) showed [9c 9d] and lost with a pair of Ni=
nes


*********** # 219 **************
PokerStars Hand #175482178207: Tournament #1701793695, $9.10+$0.90 USD =
Hold'em No Limit - Level XXIII (2400/4800) - 2017/09/24 19:38:18 ET
Table '1701793695 17' 6-max Seat #1 is the button
Seat 1: CNA151 (27684 in chips)=20
Seat 2: runner85 (85474 in chips)=20
Seat 3: JohnnyMania (19500 in chips)=20
Seat 4: andypants8 (30500 in chips)=20
Seat 5: JJin91 (466145 in chips)=20
CNA151: posts the ante 600
runner85: posts the ante 600
JohnnyMania: posts the ante 600
andypants8: posts the ante 600
JJin91: posts the ante 600
runner85: posts small blind 2400
JohnnyMania: posts big blind 4800
*** HOLE CARDS ***
Dealt to JJin91 [Qc Js]
andypants8: folds=20
JJin91: folds=20
CNA151: folds=20
runner85: folds=20
Uncalled bet (2400) returned to JohnnyMania
JohnnyMania collected 7800 from pot
JohnnyMania: doesn't show hand=20
*** SUMMARY ***
Total pot 7800 | Rake 0=20
Seat 1: CNA151 (button) folded before Flop (didn't bet)
Seat 2: runner85 (small blind) folded before Flop
Seat 3: JohnnyMania (big blind) collected (7800)
Seat 4: andypants8 folded before Flop (didn't bet)
Seat 5: JJin91 folded before Flop (didn't bet)


*********** # 220 **************
PokerStars Hand #175482178332: Tournament #1701793695, $9.10+$0.90 USD =
Hold'em No Limit - Level XXIII (2400/4800) - 2017/09/24 19:38:34 ET
Table '1701793695 17' 6-max Seat #2 is the button
Seat 1: CNA151 (27084 in chips)=20
Seat 2: runner85 (82474 in chips)=20
Seat 3: JohnnyMania (24300 in chips)=20
Seat 4: andypants8 (29900 in chips)=20
Seat 5: JJin91 (465545 in chips)=20
CNA151: posts the ante 600
runner85: posts the ante 600
JohnnyMania: posts the ante 600
andypants8: posts the ante 600
JJin91: posts the ante 600
JohnnyMania: posts small blind 2400
andypants8: posts big blind 4800
*** HOLE CARDS ***
Dealt to JJin91 [7c Ts]
JJin91: folds=20
CNA151: raises 21684 to 26484 and is all-in
runner85: folds=20
JohnnyMania: folds=20
andypants8: folds=20
Uncalled bet (21684) returned to CNA151
CNA151 collected 15000 from pot
CNA151: doesn't show hand=20
*** SUMMARY ***
Total pot 15000 | Rake 0=20
Seat 1: CNA151 collected (15000)
Seat 2: runner85 (button) folded before Flop (didn't bet)
Seat 3: JohnnyMania (small blind) folded before Flop
Seat 4: andypants8 (big blind) folded before Flop
Seat 5: JJin91 folded before Flop (didn't bet)


*********** # 221 **************
PokerStars Hand #175482178514: Tournament #1701793695, $9.10+$0.90 USD =
Hold'em No Limit - Level XXIII (2400/4800) - 2017/09/24 19:38:57 ET
Table '1701793695 17' 6-max Seat #3 is the button
Seat 1: CNA151 (36684 in chips)=20
Seat 2: runner85 (81874 in chips)=20
Seat 3: JohnnyMania (21300 in chips)=20
Seat 4: andypants8 (24500 in chips)=20
Seat 5: JJin91 (464945 in chips)=20
CNA151: posts the ante 600
runner85: posts the ante 600
JohnnyMania: posts the ante 600
andypants8: posts the ante 600
JJin91: posts the ante 600
andypants8: posts small blind 2400
JJin91: posts big blind 4800
*** HOLE CARDS ***
Dealt to JJin91 [Kc Ts]
CNA151: folds=20
runner85: raises 4800 to 9600
JohnnyMania: raises 11100 to 20700 and is all-in
andypants8: folds=20
JJin91: folds=20
runner85: calls 11100
*** FLOP *** [7s Ad 6c]
*** TURN *** [7s Ad 6c] [6d]
*** RIVER *** [7s Ad 6c 6d] [Qh]
*** SHOW DOWN ***
runner85: shows [Th Jh] (a pair of Sixes)
JohnnyMania: shows [5c Ah] (two pair, Aces and Sixes)
JohnnyMania collected 51600 from pot
*** SUMMARY ***
Total pot 51600 | Rake 0=20
Board [7s Ad 6c 6d Qh]
Seat 1: CNA151 folded before Flop (didn't bet)
Seat 2: runner85 showed [Th Jh] and lost with a pair of Sixes
Seat 3: JohnnyMania (button) showed [5c Ah] and won (51600) with two pa=
ir, Aces and Sixes
Seat 4: andypants8 (small blind) folded before Flop
Seat 5: JJin91 (big blind) folded before Flop


*********** # 222 **************
PokerStars Hand #175482178709: Tournament #1701793695, $9.10+$0.90 USD =
Hold'em No Limit - Level XXIII (2400/4800) - 2017/09/24 19:39:22 ET
Table '1701793695 17' 6-max Seat #4 is the button
Seat 1: CNA151 (36084 in chips)=20
Seat 2: runner85 (60574 in chips)=20
Seat 3: JohnnyMania (51600 in chips)=20
Seat 4: andypants8 (21500 in chips)=20
Seat 5: JJin91 (459545 in chips)=20
CNA151: posts the ante 600
runner85: posts the ante 600
JohnnyMania: posts the ante 600
andypants8: posts the ante 600
JJin91: posts the ante 600
JJin91: posts small blind 2400
CNA151: posts big blind 4800
*** HOLE CARDS ***
Dealt to JJin91 [7s 7c]
runner85: folds=20
JohnnyMania: folds=20
andypants8: raises 16100 to 20900 and is all-in
JJin91: raises 438045 to 458945 and is all-in
CNA151: folds=20
Uncalled bet (438045) returned to JJin91
*** FLOP *** [7h 5s 3d]
*** TURN *** [7h 5s 3d] [4h]
*** RIVER *** [7h 5s 3d 4h] [6c]
*** SHOW DOWN ***
JJin91: shows [7s 7c] (a straight, Three to Seven)
andypants8: shows [Qs Ad] (a straight, Three to Seven)
JJin91 collected 24800 from pot
andypants8 collected 24800 from pot
*** SUMMARY ***
Total pot 49600 | Rake 0=20
Board [7h 5s 3d 4h 6c]
Seat 1: CNA151 (big blind) folded before Flop
Seat 2: runner85 folded before Flop (didn't bet)
Seat 3: JohnnyMania folded before Flop (didn't bet)
Seat 4: andypants8 (button) showed [Qs Ad] and won (24800) with a strai=
ght, Three to Seven
Seat 5: JJin91 (small blind) showed [7s 7c] and won (24800) with a stra=
ight, Three to Seven


*********** # 223 **************
PokerStars Hand #175482178930: Tournament #1701793695, $9.10+$0.90 USD =
Hold'em No Limit - Level XXIII (2400/4800) - 2017/09/24 19:39:51 ET
Table '1701793695 17' 6-max Seat #5 is the button
Seat 1: CNA151 (30684 in chips)=20
Seat 2: runner85 (59974 in chips)=20
Seat 3: JohnnyMania (51000 in chips)=20
Seat 4: andypants8 (24800 in chips)=20
Seat 5: JJin91 (462845 in chips)=20
CNA151: posts the ante 600
runner85: posts the ante 600
JohnnyMania: posts the ante 600
andypants8: posts the ante 600
JJin91: posts the ante 600
CNA151: posts small blind 2400
runner85: posts big blind 4800
*** HOLE CARDS ***
Dealt to JJin91 [Jc 3h]
JohnnyMania: folds=20
andypants8: folds=20
JJin91: folds=20
CNA151: raises 25284 to 30084 and is all-in
runner85: folds=20
Uncalled bet (25284) returned to CNA151
CNA151 collected 12600 from pot
CNA151: doesn't show hand=20
*** SUMMARY ***
Total pot 12600 | Rake 0=20
Seat 1: CNA151 (small blind) collected (12600)
Seat 2: runner85 (big blind) folded before Flop
Seat 3: JohnnyMania folded before Flop (didn't bet)
Seat 4: andypants8 folded before Flop (didn't bet)
Seat 5: JJin91 (button) folded before Flop (didn't bet)


*********** # 224 **************
PokerStars Hand #175482179091: Tournament #1701793695, $9.10+$0.90 USD =
Hold'em No Limit - Level XXIII (2400/4800) - 2017/09/24 19:40:11 ET
Table '1701793695 17' 6-max Seat #1 is the button
Seat 1: CNA151 (37884 in chips)=20
Seat 2: runner85 (54574 in chips)=20
Seat 3: JohnnyMania (50400 in chips)=20
Seat 4: andypants8 (24200 in chips)=20
Seat 5: JJin91 (462245 in chips)=20
CNA151: posts the ante 600
runner85: posts the ante 600
JohnnyMania: posts the ante 600
andypants8: posts the ante 600
JJin91: posts the ante 600
runner85: posts small blind 2400
JohnnyMania: posts big blind 4800
*** HOLE CARDS ***
Dealt to JJin91 [7c 3c]
andypants8: folds=20
JJin91: folds=20
CNA151: raises 32484 to 37284 and is all-in
runner85: folds=20
JohnnyMania: folds=20
Uncalled bet (32484) returned to CNA151
CNA151 collected 15000 from pot
CNA151: doesn't show hand=20
*** SUMMARY ***
Total pot 15000 | Rake 0=20
Seat 1: CNA151 (button) collected (15000)
Seat 2: runner85 (small blind) folded before Flop
Seat 3: JohnnyMania (big blind) folded before Flop
Seat 4: andypants8 folded before Flop (didn't bet)
Seat 5: JJin91 folded before Flop (didn't bet)


*********** # 225 **************
PokerStars Hand #175482179244: Tournament #1701793695, $9.10+$0.90 USD =
Hold'em No Limit - Level XXIII (2400/4800) - 2017/09/24 19:40:33 ET
Table '1701793695 17' 6-max Seat #2 is the button
Seat 1: CNA151 (47484 in chips)=20
Seat 2: runner85 (51574 in chips)=20
Seat 3: JohnnyMania (45000 in chips)=20
Seat 4: andypants8 (23600 in chips)=20
Seat 5: JJin91 (461645 in chips)=20
CNA151: posts the ante 600
runner85: posts the ante 600
JohnnyMania: posts the ante 600
andypants8: posts the ante 600
JJin91: posts the ante 600
JohnnyMania: posts small blind 2400
andypants8: posts big blind 4800
*** HOLE CARDS ***
Dealt to JJin91 [4d 2s]
JJin91: folds=20
CNA151: folds=20
runner85: folds=20
JohnnyMania: raises 39600 to 44400 and is all-in
andypants8: calls 18200 and is all-in
Uncalled bet (21400) returned to JohnnyMania
*** FLOP *** [Qh 7s 5s]
*** TURN *** [Qh 7s 5s] [3d]
*** RIVER *** [Qh 7s 5s 3d] [6d]
*** SHOW DOWN ***
JohnnyMania: shows [9h 9d] (a pair of Nines)
andypants8: shows [9c Ad] (high card Ace)
JohnnyMania collected 49000 from pot
andypants8 finished the tournament in 88th place
*** SUMMARY ***
Total pot 49000 | Rake 0=20
Board [Qh 7s 5s 3d 6d]
Seat 1: CNA151 folded before Flop (didn't bet)
Seat 2: runner85 (button) folded before Flop (didn't bet)
Seat 3: JohnnyMania (small blind) showed [9h 9d] and won (49000) with a=
 pair of Nines
Seat 4: andypants8 (big blind) showed [9c Ad] and lost with high card A=
ce
Seat 5: JJin91 folded before Flop (didn't bet)


*********** # 226 **************
PokerStars Hand #175482179417: Tournament #1701793695, $9.10+$0.90 USD =
Hold'em No Limit - Level XXIII (2400/4800) - 2017/09/24 19:40:56 ET
Table '1701793695 17' 6-max Seat #3 is the button
Seat 1: CNA151 (46884 in chips)=20
Seat 2: runner85 (50974 in chips)=20
Seat 3: JohnnyMania (70400 in chips)=20
Seat 4: AcPoker0271 (11000 in chips) out of hand (moved from another ta=
ble into small blind)
Seat 5: JJin91 (461045 in chips)=20
CNA151: posts the ante 600
runner85: posts the ante 600
JohnnyMania: posts the ante 600
JJin91: posts the ante 600
JJin91: posts small blind 2400
CNA151: posts big blind 4800
*** HOLE CARDS ***
Dealt to JJin91 [7h 5h]
runner85: folds=20
JohnnyMania: raises 4800 to 9600
JJin91: folds=20
CNA151: folds=20
Uncalled bet (4800) returned to JohnnyMania
JohnnyMania collected 14400 from pot
JohnnyMania: doesn't show hand=20
*** SUMMARY ***
Total pot 14400 | Rake 0=20
Seat 1: CNA151 (big blind) folded before Flop
Seat 2: runner85 folded before Flop (didn't bet)
Seat 3: JohnnyMania (button) collected (14400)
Seat 5: JJin91 (small blind) folded before Flop


*********** # 227 **************
PokerStars Hand #175482179616: Tournament #1701793695, $9.10+$0.90 USD =
Hold'em No Limit - Level XXIII (2400/4800) - 2017/09/24 19:41:20 ET
Table '1701793695 17' 6-max Seat #5 is the button
Seat 1: CNA151 (41484 in chips)=20
Seat 2: runner85 (50374 in chips)=20
Seat 3: JohnnyMania (79400 in chips)=20
Seat 4: AcPoker0271 (11000 in chips)=20
Seat 5: JJin91 (458045 in chips)=20
CNA151: posts the ante 600
runner85: posts the ante 600
JohnnyMania: posts the ante 600
AcPoker0271: posts the ante 600
JJin91: posts the ante 600
CNA151: posts small blind 2400
runner85: posts big blind 4800
*** HOLE CARDS ***
Dealt to JJin91 [3h Kc]
JohnnyMania: raises 74000 to 78800 and is all-in
AcPoker0271: folds=20
JJin91: folds=20
CNA151: folds=20
runner85: folds=20
Uncalled bet (74000) returned to JohnnyMania
JohnnyMania collected 15000 from pot
JohnnyMania: doesn't show hand=20
*** SUMMARY ***
Total pot 15000 | Rake 0=20
Seat 1: CNA151 (small blind) folded before Flop
Seat 2: runner85 (big blind) folded before Flop
Seat 3: JohnnyMania collected (15000)
Seat 4: AcPoker0271 folded before Flop (didn't bet)
Seat 5: JJin91 (button) folded before Flop (didn't bet)


*********** # 228 **************
PokerStars Hand #175482179801: Tournament #1701793695, $9.10+$0.90 USD =
Hold'em No Limit - Level XXIII (2400/4800) - 2017/09/24 19:41:42 ET
Table '1701793695 17' 6-max Seat #1 is the button
Seat 1: CNA151 (38484 in chips)=20
Seat 2: runner85 (44974 in chips)=20
Seat 3: JohnnyMania (89000 in chips)=20
Seat 4: AcPoker0271 (10400 in chips)=20
Seat 5: JJin91 (457445 in chips)=20
CNA151: posts the ante 600
runner85: posts the ante 600
JohnnyMania: posts the ante 600
AcPoker0271: posts the ante 600
JJin91: posts the ante 600
runner85: posts small blind 2400
JohnnyMania: posts big blind 4800
*** HOLE CARDS ***
Dealt to JJin91 [9h 8s]
AcPoker0271: raises 5000 to 9800 and is all-in
JJin91: folds=20
CNA151: folds=20
runner85: calls 7400
JohnnyMania: calls 5000
*** FLOP *** [4c 3d 5h]
runner85: checks=20
JohnnyMania: checks=20
*** TURN *** [4c 3d 5h] [Td]
runner85: checks=20
JohnnyMania: bets 14400
runner85: folds=20
Uncalled bet (14400) returned to JohnnyMania
*** RIVER *** [4c 3d 5h Td] [9c]
*** SHOW DOWN ***
JohnnyMania: shows [Ah 2d] (a straight, Ace to Five)
AcPoker0271: shows [Qc 7d] (high card Queen)
JohnnyMania collected 32400 from pot
AcPoker0271 finished the tournament in 85th place
*** SUMMARY ***
Total pot 32400 | Rake 0=20
Board [4c 3d 5h Td 9c]
Seat 1: CNA151 (button) folded before Flop (didn't bet)
Seat 2: runner85 (small blind) folded on the Turn
Seat 3: JohnnyMania (big blind) showed [Ah 2d] and won (32400) with a s=
traight, Ace to Five
Seat 4: AcPoker0271 showed [Qc 7d] and lost with high card Queen
Seat 5: JJin91 folded before Flop (didn't bet)


*********** # 229 **************
PokerStars Hand #175482470652: Tournament #1701793695, $9.10+$0.90 USD =
Hold'em No Limit - Level XXIII (2400/4800) - 2017/09/24 19:42:15 ET
Table '1701793695 17' 6-max Seat #2 is the button
Seat 1: CNA151 (37884 in chips)=20
Seat 2: runner85 (34574 in chips)=20
Seat 3: JohnnyMania (111000 in chips)=20
Seat 4: andypants8 (29600 in chips)=20
Seat 5: JJin91 (456845 in chips)=20
CNA151: posts the ante 600
runner85: posts the ante 600
JohnnyMania: posts the ante 600
andypants8: posts the ante 600
JJin91: posts the ante 600
JohnnyMania: posts small blind 2400
andypants8: posts big blind 4800
*** HOLE CARDS ***
Dealt to JJin91 [4s 7c]
JJin91: folds=20
CNA151: folds=20
runner85: folds=20
JohnnyMania: raises 105600 to 110400 and is all-in
andypants8: folds=20
Uncalled bet (105600) returned to JohnnyMania
JohnnyMania collected 12600 from pot
JohnnyMania: doesn't show hand=20
*** SUMMARY ***
Total pot 12600 | Rake 0=20
Seat 1: CNA151 folded before Flop (didn't bet)
Seat 2: runner85 (button) folded before Flop (didn't bet)
Seat 3: JohnnyMania (small blind) collected (12600)
Seat 4: andypants8 (big blind) folded before Flop
Seat 5: JJin91 folded before Flop (didn't bet)


*********** # 230 **************
PokerStars Hand #175482470740: Tournament #1701793695, $9.10+$0.90 USD =
Hold'em No Limit - Level XXIII (2400/4800) - 2017/09/24 19:42:27 ET
Table '1701793695 17' 6-max Seat #3 is the button
Seat 1: CNA151 (37284 in chips)=20
Seat 2: runner85 (33974 in chips)=20
Seat 3: JohnnyMania (118200 in chips)=20
Seat 4: andypants8 (24200 in chips)=20
Seat 5: JJin91 (456245 in chips)=20
CNA151: posts the ante 600
runner85: posts the ante 600
JohnnyMania: posts the ante 600
andypants8: posts the ante 600
JJin91: posts the ante 600
andypants8: posts small blind 2400
JJin91: posts big blind 4800
*** HOLE CARDS ***
Dealt to JJin91 [Jc Ac]
CNA151: folds=20
runner85: raises 28574 to 33374 and is all-in
JohnnyMania: folds=20
andypants8: folds=20
JJin91: calls 28574
*** FLOP *** [4h 2s 9c]
*** TURN *** [4h 2s 9c] [Qs]
*** RIVER *** [4h 2s 9c Qs] [2c]
*** SHOW DOWN ***
JJin91: shows [Jc Ac] (a pair of Deuces)
runner85: shows [6d 6c] (two pair, Sixes and Deuces)
runner85 collected 72148 from pot
*** SUMMARY ***
Total pot 72148 | Rake 0=20
Board [4h 2s 9c Qs 2c]
Seat 1: CNA151 folded before Flop (didn't bet)
Seat 2: runner85 showed [6d 6c] and won (72148) with two pair, Sixes an=
d Deuces
Seat 3: JohnnyMania (button) folded before Flop (didn't bet)
Seat 4: andypants8 (small blind) folded before Flop
Seat 5: JJin91 (big blind) showed [Jc Ac] and lost with a pair of Deuces


*********** # 231 **************
PokerStars Hand #175482470959: Tournament #1701793695, $9.10+$0.90 USD =
Hold'em No Limit - Level XXIII (2400/4800) - 2017/09/24 19:42:54 ET
Table '1701793695 17' 6-max Seat #4 is the button
Seat 1: CNA151 (36684 in chips)=20
Seat 2: runner85 (72148 in chips)=20
Seat 3: JohnnyMania (117600 in chips)=20
Seat 4: andypants8 (21200 in chips)=20
Seat 5: JJin91 (422271 in chips)=20
CNA151: posts the ante 600
runner85: posts the ante 600
JohnnyMania: posts the ante 600
andypants8: posts the ante 600
JJin91: posts the ante 600
JJin91: posts small blind 2400
CNA151: posts big blind 4800
*** HOLE CARDS ***
Dealt to JJin91 [Ks 6c]
runner85: folds=20
JohnnyMania: folds=20
andypants8: raises 15000 to 19800
JJin91: raises 401871 to 421671 and is all-in
CNA151: folds=20
andypants8: calls 800 and is all-in
Uncalled bet (401071) returned to JJin91
*** FLOP *** [Qc 4d Tc]
*** TURN *** [Qc 4d Tc] [7h]
*** RIVER *** [Qc 4d Tc 7h] [2c]
*** SHOW DOWN ***
JJin91: shows [Ks 6c] (high card King)
andypants8: shows [9s Jc] (high card Queen)
JJin91 collected 49000 from pot
andypants8 finished the tournament in 81st place
*** SUMMARY ***
Total pot 49000 | Rake 0=20
Board [Qc 4d Tc 7h 2c]
Seat 1: CNA151 (big blind) folded before Flop
Seat 2: runner85 folded before Flop (didn't bet)
Seat 3: JohnnyMania folded before Flop (didn't bet)
Seat 4: andypants8 (button) showed [9s Jc] and lost with high card Queen
Seat 5: JJin91 (small blind) showed [Ks 6c] and won (49000) with high c=
ard King


*********** # 232 **************
PokerStars Hand #175482471102: Tournament #1701793695, $9.10+$0.90 USD =
Hold'em No Limit - Level XXIII (2400/4800) - 2017/09/24 19:43:12 ET
Table '1701793695 17' 6-max Seat #5 is the button
Seat 1: CNA151 (31284 in chips)=20
Seat 2: runner85 (71548 in chips)=20
Seat 3: JohnnyMania (117000 in chips)=20
Seat 5: JJin91 (450071 in chips)=20
CNA151: posts the ante 600
runner85: posts the ante 600
JohnnyMania: posts the ante 600
JJin91: posts the ante 600
CNA151: posts small blind 2400
runner85: posts big blind 4800
*** HOLE CARDS ***
Dealt to JJin91 [Ad 9s]
JohnnyMania: raises 5280 to 10080
JJin91: calls 10080
CNA151: folds=20
runner85: folds=20
*** FLOP *** [6d Ac 7d]
JohnnyMania: bets 11606
JJin91: calls 11606
*** TURN *** [6d Ac 7d] [9h]
JohnnyMania: bets 19200
JJin91: calls 19200
*** RIVER *** [6d Ac 7d 9h] [4c]
JohnnyMania: checks=20
JJin91: bets 91372
JohnnyMania: folds=20
Uncalled bet (91372) returned to JJin91
JJin91 collected 91372 from pot
JJin91: doesn't show hand=20
*** SUMMARY ***
Total pot 91372 | Rake 0=20
Board [6d Ac 7d 9h 4c]
Seat 1: CNA151 (small blind) folded before Flop
Seat 2: runner85 (big blind) folded before Flop
Seat 3: JohnnyMania folded on the River
Seat 5: JJin91 (button) collected (91372)


*********** # 233 **************
PokerStars Hand #175482471509: Tournament #1701793695, $9.10+$0.90 USD =
Hold'em No Limit - Level XXIII (2400/4800) - 2017/09/24 19:44:03 ET
Table '1701793695 17' 6-max Seat #1 is the button
Seat 1: CNA151 (28284 in chips)=20
Seat 2: runner85 (66148 in chips)=20
Seat 3: JohnnyMania (75514 in chips)=20
Seat 5: JJin91 (499957 in chips)=20
Seat 6: MattEMenz (132787 in chips)=20
CNA151: posts the ante 600
runner85: posts the ante 600
JohnnyMania: posts the ante 600
JJin91: posts the ante 600
MattEMenz: posts the ante 600
runner85: posts small blind 2400
JohnnyMania: posts big blind 4800
*** HOLE CARDS ***
Dealt to JJin91 [9d 8h]
JJin91: folds=20
MattEMenz: folds=20
CNA151: folds=20
runner85: folds=20
Uncalled bet (2400) returned to JohnnyMania
JohnnyMania collected 7800 from pot
JohnnyMania: doesn't show hand=20
*** SUMMARY ***
Total pot 7800 | Rake 0=20
Seat 1: CNA151 (button) folded before Flop (didn't bet)
Seat 2: runner85 (small blind) folded before Flop
Seat 3: JohnnyMania (big blind) collected (7800)
Seat 5: JJin91 folded before Flop (didn't bet)
Seat 6: MattEMenz folded before Flop (didn't bet)


*********** # 234 **************
PokerStars Hand #175482471701: Tournament #1701793695, $9.10+$0.90 USD =
Hold'em No Limit - Level XXIII (2400/4800) - 2017/09/24 19:44:25 ET
Table '1701793695 17' 6-max Seat #2 is the button
Seat 1: CNA151 (27684 in chips)=20
Seat 2: runner85 (63148 in chips)=20
Seat 3: JohnnyMania (80314 in chips)=20
Seat 5: JJin91 (499357 in chips)=20
Seat 6: MattEMenz (132187 in chips)=20
CNA151: posts the ante 600
runner85: posts the ante 600
JohnnyMania: posts the ante 600
JJin91: posts the ante 600
MattEMenz: posts the ante 600
JohnnyMania: posts small blind 2400
JJin91: posts big blind 4800
*** HOLE CARDS ***
Dealt to JJin91 [Kc Ac]
MattEMenz: folds=20
CNA151: folds=20
runner85: folds=20
JohnnyMania: raises 74914 to 79714 and is all-in
JJin91: calls 74914
*** FLOP *** [Th Qc Kh]
*** TURN *** [Th Qc Kh] [Ts]
*** RIVER *** [Th Qc Kh Ts] [7s]
*** SHOW DOWN ***
JohnnyMania: shows [Jh Qh] (two pair, Queens and Tens)
JJin91: shows [Kc Ac] (two pair, Kings and Tens)
JJin91 collected 162428 from pot
JohnnyMania finished the tournament in 75th place
*** SUMMARY ***
Total pot 162428 | Rake 0=20
Board [Th Qc Kh Ts 7s]
Seat 1: CNA151 folded before Flop (didn't bet)
Seat 2: runner85 (button) folded before Flop (didn't bet)
Seat 3: JohnnyMania (small blind) showed [Jh Qh] and lost with two pair=
, Queens and Tens
Seat 5: JJin91 (big blind) showed [Kc Ac] and won (162428) with two pai=
r, Kings and Tens
Seat 6: MattEMenz folded before Flop (didn't bet)


*********** # 235 **************
PokerStars Hand #175482471875: Tournament #1701793695, $9.10+$0.90 USD =
Hold'em No Limit - Level XXIII (2400/4800) - 2017/09/24 19:44:47 ET
Table '1701793695 17' 6-max Seat #5 is the button
Seat 1: CNA151 (27084 in chips)=20
Seat 2: runner85 (62548 in chips)=20
Seat 5: JJin91 (581471 in chips)=20
Seat 6: MattEMenz (131587 in chips)=20
CNA151: posts the ante 600
runner85: posts the ante 600
JJin91: posts the ante 600
MattEMenz: posts the ante 600
MattEMenz: posts small blind 2400
CNA151: posts big blind 4800
*** HOLE CARDS ***
Dealt to JJin91 [9s 9d]
runner85: folds=20
JJin91: raises 576071 to 580871 and is all-in
MattEMenz: calls 128587 and is all-in
CNA151: folds=20
Uncalled bet (449884) returned to JJin91
*** FLOP *** [Qc 5d 8d]
*** TURN *** [Qc 5d 8d] [Td]
*** RIVER *** [Qc 5d 8d Td] [Kd]
*** SHOW DOWN ***
MattEMenz: shows [Ac Qs] (a pair of Queens)
JJin91: shows [9s 9d] (a flush, King high)
JJin91 collected 269174 from pot
MattEMenz finished the tournament in 72nd place
*** SUMMARY ***
Total pot 269174 | Rake 0=20
Board [Qc 5d 8d Td Kd]
Seat 1: CNA151 (big blind) folded before Flop
Seat 2: runner85 folded before Flop (didn't bet)
Seat 5: JJin91 (button) showed [9s 9d] and won (269174) with a flush, K=
ing high
Seat 6: MattEMenz (small blind) showed [Ac Qs] and lost with a pair of =
Queens


*********** # 236 **************
PokerStars Hand #175482472171: Tournament #1701793695, $9.10+$0.90 USD =
Hold'em No Limit - Level XXIII (2400/4800) - 2017/09/24 19:45:23 ET
Table '1701793695 17' 6-max Seat #1 is the button
Seat 1: CNA151 (21684 in chips)=20
Seat 2: runner85 (61948 in chips)=20
Seat 3: MwaTheMighty (19400 in chips)=20
Seat 4: JohnnyMania (20000 in chips)=20
Seat 5: JJin91 (719058 in chips)=20
CNA151: posts the ante 600
runner85: posts the ante 600
MwaTheMighty: posts the ante 600
JohnnyMania: posts the ante 600
JJin91: posts the ante 600
runner85: posts small blind 2400
MwaTheMighty: posts big blind 4800
*** HOLE CARDS ***
Dealt to JJin91 [8c Jh]
JohnnyMania: folds=20
JJin91: folds=20
CNA151: folds=20
runner85: raises 56548 to 61348 and is all-in
MwaTheMighty: folds=20
Uncalled bet (56548) returned to runner85
runner85 collected 12600 from pot
*** SUMMARY ***
Total pot 12600 | Rake 0=20
Seat 1: CNA151 (button) folded before Flop (didn't bet)
Seat 2: runner85 (small blind) collected (12600)
Seat 3: MwaTheMighty (big blind) folded before Flop
Seat 4: JohnnyMania folded before Flop (didn't bet)
Seat 5: JJin91 folded before Flop (didn't bet)


*********** # 237 **************
PokerStars Hand #175482472547: Tournament #1701793695, $9.10+$0.90 USD =
Hold'em No Limit - Level XXIV (2800/5600) - 2017/09/24 19:46:10 ET
Table '1701793695 17' 6-max Seat #2 is the button
Seat 1: CNA151 (21084 in chips)=20
Seat 2: runner85 (69148 in chips)=20
Seat 3: MwaTheMighty (14000 in chips)=20
Seat 4: JohnnyMania (19400 in chips)=20
Seat 5: JJin91 (718458 in chips)=20
Seat 6: pokerMJ (96652 in chips)=20
CNA151: posts the ante 700
runner85: posts the ante 700
MwaTheMighty: posts the ante 700
JohnnyMania: posts the ante 700
JJin91: posts the ante 700
pokerMJ: posts the ante 700
MwaTheMighty: posts small blind 2800
JohnnyMania: posts big blind 5600
*** HOLE CARDS ***
Dealt to JJin91 [Jc Ac]
JJin91: raises 6552 to 12152
pokerMJ: folds=20
CNA151: folds=20
runner85: folds=20
MwaTheMighty: folds=20
JohnnyMania: raises 6548 to 18700 and is all-in
JJin91: calls 6548
*** FLOP *** [4c 9s Ts]
*** TURN *** [4c 9s Ts] [Ks]
*** RIVER *** [4c 9s Ts Ks] [4d]
*** SHOW DOWN ***
JohnnyMania: shows [Ah 6d] (a pair of Fours)
JJin91: shows [Jc Ac] (a pair of Fours - Ace+King+Jack kicker)
JJin91 collected 44400 from pot
JohnnyMania finished the tournament in 68th place
*** SUMMARY ***
Total pot 44400 | Rake 0=20
Board [4c 9s Ts Ks 4d]
Seat 1: CNA151 folded before Flop (didn't bet)
Seat 2: runner85 (button) folded before Flop (didn't bet)
Seat 3: MwaTheMighty (small blind) folded before Flop
Seat 4: JohnnyMania (big blind) showed [Ah 6d] and lost with a pair of =
Fours
Seat 5: JJin91 showed [Jc Ac] and won (44400) with a pair of Fours
Seat 6: pokerMJ folded before Flop (didn't bet)


*********** # 238 **************
PokerStars Hand #175482472830: Tournament #1701793695, $9.10+$0.90 USD =
Hold'em No Limit - Level XXIV (2800/5600) - 2017/09/24 19:46:46 ET
Table '1701793695 17' 6-max Seat #3 is the button
Seat 1: CNA151 (20384 in chips)=20
Seat 2: runner85 (68448 in chips)=20
Seat 3: MwaTheMighty (10500 in chips)=20
Seat 5: JJin91 (743458 in chips)=20
Seat 6: pokerMJ (95952 in chips)=20
CNA151: posts the ante 700
runner85: posts the ante 700
MwaTheMighty: posts the ante 700
JJin91: posts the ante 700
pokerMJ: posts the ante 700
JJin91: posts small blind 2800
pokerMJ: posts big blind 5600
*** HOLE CARDS ***
Dealt to JJin91 [4d 6d]
CNA151: folds=20
runner85: folds=20
MwaTheMighty: folds=20
JJin91: folds=20
Uncalled bet (2800) returned to pokerMJ
pokerMJ collected 9100 from pot
pokerMJ: doesn't show hand=20
*** SUMMARY ***
Total pot 9100 | Rake 0=20
Seat 1: CNA151 folded before Flop (didn't bet)
Seat 2: runner85 folded before Flop (didn't bet)
Seat 3: MwaTheMighty (button) folded before Flop (didn't bet)
Seat 5: JJin91 (small blind) folded before Flop
Seat 6: pokerMJ (big blind) collected (9100)


*********** # 239 **************
PokerStars Hand #175482473158: Tournament #1701793695, $9.10+$0.90 USD =
Hold'em No Limit - Level XXIV (2800/5600) - 2017/09/24 19:47:30 ET
Table '1701793695 17' 6-max Seat #5 is the button
Seat 1: CNA151 (19684 in chips)=20
Seat 2: runner85 (67748 in chips)=20
Seat 3: MwaTheMighty (9800 in chips)=20
Seat 5: JJin91 (739958 in chips)=20
Seat 6: pokerMJ (101552 in chips)=20
CNA151: posts the ante 700
runner85: posts the ante 700
MwaTheMighty: posts the ante 700
JJin91: posts the ante 700
pokerMJ: posts the ante 700
pokerMJ: posts small blind 2800
CNA151: posts big blind 5600
*** HOLE CARDS ***
Dealt to JJin91 [4s Ah]
runner85: folds=20
MwaTheMighty: folds=20
JJin91: raises 6552 to 12152
pokerMJ: folds=20
CNA151: folds=20
Uncalled bet (6552) returned to JJin91
JJin91 collected 17500 from pot
JJin91: doesn't show hand=20
*** SUMMARY ***
Total pot 17500 | Rake 0=20
Seat 1: CNA151 (big blind) folded before Flop
Seat 2: runner85 folded before Flop (didn't bet)
Seat 3: MwaTheMighty folded before Flop (didn't bet)
Seat 5: JJin91 (button) collected (17500)
Seat 6: pokerMJ (small blind) folded before Flop


*********** # 240 **************
PokerStars Hand #175482473695: Tournament #1701793695, $9.10+$0.90 USD =
Hold'em No Limit - Level XXIV (2800/5600) - 2017/09/24 19:48:47 ET
Table '1701793695 17' 6-max Seat #6 is the button
Seat 1: CNA151 (13384 in chips)=20
Seat 2: runner85 (67048 in chips)=20
Seat 3: MwaTheMighty (9100 in chips)=20
Seat 5: JJin91 (751158 in chips)=20
Seat 6: pokerMJ (98052 in chips)=20
CNA151: posts the ante 700
runner85: posts the ante 700
MwaTheMighty: posts the ante 700
JJin91: posts the ante 700
pokerMJ: posts the ante 700
CNA151: posts small blind 2800
runner85: posts big blind 5600
*** HOLE CARDS ***
Dealt to JJin91 [Jd 9s]
MwaTheMighty: folds=20
JJin91: folds=20
pokerMJ: folds=20
CNA151: raises 7084 to 12684 and is all-in
runner85: calls 7084
*** FLOP *** [2d Qs 3d]
*** TURN *** [2d Qs 3d] [5s]
*** RIVER *** [2d Qs 3d 5s] [3s]
*** SHOW DOWN ***
CNA151: shows [Jc As] (a pair of Threes)
runner85: shows [Kh 7d] (a pair of Threes - lower kicker)
CNA151 collected 28868 from pot
*** SUMMARY ***
Total pot 28868 | Rake 0=20
Board [2d Qs 3d 5s 3s]
Seat 1: CNA151 (small blind) showed [Jc As] and won (28868) with a pair=
 of Threes
Seat 2: runner85 (big blind) showed [Kh 7d] and lost with a pair of Thr=
ees
Seat 3: MwaTheMighty folded before Flop (didn't bet)
Seat 5: JJin91 folded before Flop (didn't bet)
Seat 6: pokerMJ (button) folded before Flop (didn't bet)


*********** # 241 **************
PokerStars Hand #175482474225: Tournament #1701793695, $9.10+$0.90 USD =
Hold'em No Limit - Level XXIV (2800/5600) - 2017/09/24 19:49:58 ET
Table '1701793695 17' 6-max Seat #1 is the button
Seat 1: CNA151 (28868 in chips)=20
Seat 2: runner85 (53664 in chips)=20
Seat 3: MwaTheMighty (8400 in chips)=20
Seat 5: JJin91 (750458 in chips)=20
Seat 6: pokerMJ (97352 in chips)=20
CNA151: posts the ante 700
runner85: posts the ante 700
MwaTheMighty: posts the ante 700
JJin91: posts the ante 700
pokerMJ: posts the ante 700
runner85: posts small blind 2800
MwaTheMighty: posts big blind 5600
*** HOLE CARDS ***
Dealt to JJin91 [6h 8d]
JJin91: folds=20
pokerMJ: folds=20
CNA151: folds=20
runner85: raises 5600 to 11200
MwaTheMighty: calls 2100 and is all-in
Uncalled bet (3500) returned to runner85
*** FLOP *** [2h Kd 4d]
*** TURN *** [2h Kd 4d] [5d]
*** RIVER *** [2h Kd 4d 5d] [Qs]
*** SHOW DOWN ***
runner85: shows [Tc Js] (high card King)
MwaTheMighty: shows [6d 8h] (high card King - lower kicker)
runner85 collected 18900 from pot
MwaTheMighty finished the tournament in 67th place
*** SUMMARY ***
Total pot 18900 | Rake 0=20
Board [2h Kd 4d 5d Qs]
Seat 1: CNA151 (button) folded before Flop (didn't bet)
Seat 2: runner85 (small blind) showed [Tc Js] and won (18900) with high=
 card King
Seat 3: MwaTheMighty (big blind) showed [6d 8h] and lost with high card=
 King
Seat 5: JJin91 folded before Flop (didn't bet)
Seat 6: pokerMJ folded before Flop (didn't bet)


*********** # 242 **************
PokerStars Hand #175482474767: Tournament #1701793695, $9.10+$0.90 USD =
Hold'em No Limit - Level XXIV (2800/5600) - 2017/09/24 19:51:15 ET
Table '1701793695 16' 6-max Seat #2 is the button
Seat 1: JJin91 (749758 in chips)=20
Seat 2: All4Cocoa (43700 in chips)=20
Seat 3: donkeynutz44 (130108 in chips)=20
Seat 4: Burassi (259246 in chips)=20
Seat 5: PureWizardry (58500 in chips)=20
Seat 6: barhoper732 (39488 in chips)=20
JJin91: posts the ante 700
All4Cocoa: posts the ante 700
donkeynutz44: posts the ante 700
Burassi: posts the ante 700
PureWizardry: posts the ante 700
barhoper732: posts the ante 700
donkeynutz44: posts small blind 2800
Burassi: posts big blind 5600
*** HOLE CARDS ***
Dealt to JJin91 [4d Ad]
PureWizardry: raises 52200 to 57800 and is all-in
barhoper732: folds=20
JJin91: folds=20
All4Cocoa: folds=20
donkeynutz44: folds=20
Burassi: folds=20
Uncalled bet (52200) returned to PureWizardry
PureWizardry collected 18200 from pot
PureWizardry: doesn't show hand=20
*** SUMMARY ***
Total pot 18200 | Rake 0=20
Seat 1: JJin91 folded before Flop (didn't bet)
Seat 2: All4Cocoa (button) folded before Flop (didn't bet)
Seat 3: donkeynutz44 (small blind) folded before Flop
Seat 4: Burassi (big blind) folded before Flop
Seat 5: PureWizardry collected (18200)
Seat 6: barhoper732 folded before Flop (didn't bet)


*********** # 243 **************
PokerStars Hand #175482474984: Tournament #1701793695, $9.10+$0.90 USD =
Hold'em No Limit - Level XXIV (2800/5600) - 2017/09/24 19:51:50 ET
Table '1701793695 16' 6-max Seat #3 is the button
Seat 1: JJin91 (749058 in chips)=20
Seat 2: All4Cocoa (43000 in chips)=20
Seat 3: donkeynutz44 (126608 in chips)=20
Seat 4: Burassi (252946 in chips)=20
Seat 5: PureWizardry (70400 in chips)=20
Seat 6: barhoper732 (38788 in chips)=20
JJin91: posts the ante 700
All4Cocoa: posts the ante 700
donkeynutz44: posts the ante 700
Burassi: posts the ante 700
PureWizardry: posts the ante 700
barhoper732: posts the ante 700
Burassi: posts small blind 2800
PureWizardry: posts big blind 5600
*** HOLE CARDS ***
Dealt to JJin91 [Js 5s]
barhoper732: folds=20
JJin91: folds=20
All4Cocoa: folds=20
donkeynutz44: calls 5600
Burassi: folds=20
PureWizardry: checks=20
*** FLOP *** [7h Qd 8s]
PureWizardry: checks=20
donkeynutz44: bets 9100
PureWizardry: folds=20
Uncalled bet (9100) returned to donkeynutz44
donkeynutz44 collected 18200 from pot
donkeynutz44: doesn't show hand=20
*** SUMMARY ***
Total pot 18200 | Rake 0=20
Board [7h Qd 8s]
Seat 1: JJin91 folded before Flop (didn't bet)
Seat 2: All4Cocoa folded before Flop (didn't bet)
Seat 3: donkeynutz44 (button) collected (18200)
Seat 4: Burassi (small blind) folded before Flop
Seat 5: PureWizardry (big blind) folded on the Flop
Seat 6: barhoper732 folded before Flop (didn't bet)


*********** # 244 **************
PokerStars Hand #175482475118: Tournament #1701793695, $9.10+$0.90 USD =
Hold'em No Limit - Level XXIV (2800/5600) - 2017/09/24 19:52:12 ET
Table '1701793695 16' 6-max Seat #4 is the button
Seat 1: JJin91 (748358 in chips)=20
Seat 2: All4Cocoa (42300 in chips)=20
Seat 3: donkeynutz44 (138508 in chips)=20
Seat 4: Burassi (249446 in chips)=20
Seat 5: PureWizardry (64100 in chips)=20
Seat 6: barhoper732 (38088 in chips)=20
JJin91: posts the ante 700
All4Cocoa: posts the ante 700
donkeynutz44: posts the ante 700
Burassi: posts the ante 700
PureWizardry: posts the ante 700
barhoper732: posts the ante 700
PureWizardry: posts small blind 2800
barhoper732: posts big blind 5600
*** HOLE CARDS ***
Dealt to JJin91 [5s Qs]
JJin91: folds=20
All4Cocoa: raises 36000 to 41600 and is all-in
donkeynutz44: calls 41600
Burassi: folds=20
PureWizardry: folds=20
barhoper732: folds=20
*** FLOP *** [Th 5h Js]
*** TURN *** [Th 5h Js] [2d]
*** RIVER *** [Th 5h Js 2d] [6c]
*** SHOW DOWN ***
All4Cocoa: shows [9d 9c] (a pair of Nines)
donkeynutz44: shows [Ac 7c] (high card Ace)
All4Cocoa collected 95800 from pot
*** SUMMARY ***
Total pot 95800 | Rake 0=20
Board [Th 5h Js 2d 6c]
Seat 1: JJin91 folded before Flop (didn't bet)
Seat 2: All4Cocoa showed [9d 9c] and won (95800) with a pair of Nines
Seat 3: donkeynutz44 showed [Ac 7c] and lost with high card Ace
Seat 4: Burassi (button) folded before Flop (didn't bet)
Seat 5: PureWizardry (small blind) folded before Flop
Seat 6: barhoper732 (big blind) folded before Flop


*********** # 245 **************
PokerStars Hand #175482475244: Tournament #1701793695, $9.10+$0.90 USD =
Hold'em No Limit - Level XXIV (2800/5600) - 2017/09/24 19:52:34 ET
Table '1701793695 16' 6-max Seat #5 is the button
Seat 1: JJin91 (747658 in chips)=20
Seat 2: All4Cocoa (95800 in chips)=20
Seat 3: donkeynutz44 (96208 in chips)=20
Seat 4: Burassi (248746 in chips)=20
Seat 5: PureWizardry (60600 in chips)=20
Seat 6: barhoper732 (31788 in chips)=20
JJin91: posts the ante 700
All4Cocoa: posts the ante 700
donkeynutz44: posts the ante 700
Burassi: posts the ante 700
PureWizardry: posts the ante 700
barhoper732: posts the ante 700
barhoper732: posts small blind 2800
JJin91: posts big blind 5600
*** HOLE CARDS ***
Dealt to JJin91 [7c 9s]
All4Cocoa: folds=20
donkeynutz44: folds=20
Burassi: folds=20
PureWizardry: folds=20
barhoper732: calls 2800
JJin91: checks=20
*** FLOP *** [Qs 3h 8d]
barhoper732: checks=20
JJin91: bets 5698
barhoper732: calls 5698
*** TURN *** [Qs 3h 8d] [Js]
barhoper732: checks=20
JJin91: checks=20
*** RIVER *** [Qs 3h 8d Js] [9h]
barhoper732: bets 19790 and is all-in
JJin91: calls 19790
*** SHOW DOWN ***
barhoper732: shows [8s 9d] (two pair, Nines and Eights)
JJin91: shows [7c 9s] (a pair of Nines)
barhoper732 collected 66376 from pot
*** SUMMARY ***
Total pot 66376 | Rake 0=20
Board [Qs 3h 8d Js 9h]
Seat 1: JJin91 (big blind) showed [7c 9s] and lost with a pair of Nines
Seat 2: All4Cocoa folded before Flop (didn't bet)
Seat 3: donkeynutz44 folded before Flop (didn't bet)
Seat 4: Burassi folded before Flop (didn't bet)
Seat 5: PureWizardry (button) folded before Flop (didn't bet)
Seat 6: barhoper732 (small blind) showed [8s 9d] and won (66376) with t=
wo pair, Nines and Eights


*********** # 246 **************
PokerStars Hand #175482475459: Tournament #1701793695, $9.10+$0.90 USD =
Hold'em No Limit - Level XXIV (2800/5600) - 2017/09/24 19:53:16 ET
Table '1701793695 16' 6-max Seat #6 is the button
Seat 1: JJin91 (715870 in chips)=20
Seat 2: All4Cocoa (95100 in chips)=20
Seat 3: donkeynutz44 (95508 in chips)=20
Seat 4: Burassi (248046 in chips)=20
Seat 5: PureWizardry (59900 in chips)=20
Seat 6: barhoper732 (66376 in chips)=20
JJin91: posts the ante 700
All4Cocoa: posts the ante 700
donkeynutz44: posts the ante 700
Burassi: posts the ante 700
PureWizardry: posts the ante 700
barhoper732: posts the ante 700
JJin91: posts small blind 2800
All4Cocoa: posts big blind 5600
*** HOLE CARDS ***
Dealt to JJin91 [9s 3h]
donkeynutz44: calls 5600
Burassi: folds=20
PureWizardry: folds=20
barhoper732: calls 5600
JJin91: folds=20
All4Cocoa: checks=20
*** FLOP *** [Qs 3c 9d]
All4Cocoa: checks=20
donkeynutz44: bets 11900
barhoper732: folds=20
All4Cocoa: folds=20
Uncalled bet (11900) returned to donkeynutz44
donkeynutz44 collected 23800 from pot
donkeynutz44: doesn't show hand=20
*** SUMMARY ***
Total pot 23800 | Rake 0=20
Board [Qs 3c 9d]
Seat 1: JJin91 (small blind) folded before Flop
Seat 2: All4Cocoa (big blind) folded on the Flop
Seat 3: donkeynutz44 collected (23800)
Seat 4: Burassi folded before Flop (didn't bet)
Seat 5: PureWizardry folded before Flop (didn't bet)
Seat 6: barhoper732 (button) folded on the Flop


*********** # 247 **************
PokerStars Hand #175482475664: Tournament #1701793695, $9.10+$0.90 USD =
Hold'em No Limit - Level XXIV (2800/5600) - 2017/09/24 19:53:54 ET
Table '1701793695 16' 6-max Seat #1 is the button
Seat 1: JJin91 (712370 in chips)=20
Seat 2: All4Cocoa (88800 in chips)=20
Seat 3: donkeynutz44 (113008 in chips)=20
Seat 4: Burassi (247346 in chips)=20
Seat 5: PureWizardry (59200 in chips)=20
Seat 6: barhoper732 (60076 in chips)=20
JJin91: posts the ante 700
All4Cocoa: posts the ante 700
donkeynutz44: posts the ante 700
Burassi: posts the ante 700
PureWizardry: posts the ante 700
barhoper732: posts the ante 700
All4Cocoa: posts small blind 2800
donkeynutz44: posts big blind 5600
*** HOLE CARDS ***
Dealt to JJin91 [Js Ks]
Burassi: folds=20
PureWizardry: raises 52900 to 58500 and is all-in
barhoper732: folds=20
JJin91: raises 653170 to 711670 and is all-in
All4Cocoa: folds=20
donkeynutz44: folds=20
Uncalled bet (653170) returned to JJin91
*** FLOP *** [2c Jc 2d]
*** TURN *** [2c Jc 2d] [5h]
*** RIVER *** [2c Jc 2d 5h] [9h]
*** SHOW DOWN ***
PureWizardry: shows [Jh Qc] (two pair, Jacks and Deuces)
JJin91: shows [Js Ks] (two pair, Jacks and Deuces - King kicker)
JJin91 collected 129600 from pot
PureWizardry finished the tournament in 64th place and received $17.50.
*** SUMMARY ***
Total pot 129600 | Rake 0=20
Board [2c Jc 2d 5h 9h]
Seat 1: JJin91 (button) showed [Js Ks] and won (129600) with two pair, =
Jacks and Deuces
Seat 2: All4Cocoa (small blind) folded before Flop
Seat 3: donkeynutz44 (big blind) folded before Flop
Seat 4: Burassi folded before Flop (didn't bet)
Seat 5: PureWizardry showed [Jh Qc] and lost with two pair, Jacks and D=
euces
Seat 6: barhoper732 folded before Flop (didn't bet)


*********** # 248 **************
PokerStars Hand #175482475876: Tournament #1701793695, $9.10+$0.90 USD =
Hold'em No Limit - Level XXV (3200/6400) - 2017/09/24 19:54:36 ET
Table '1701793695 16' 6-max Seat #2 is the button
Seat 1: JJin91 (782770 in chips)=20
Seat 2: All4Cocoa (85300 in chips)=20
Seat 3: donkeynutz44 (106708 in chips)=20
Seat 4: Burassi (246646 in chips)=20
Seat 6: barhoper732 (59376 in chips)=20
JJin91: posts the ante 800
All4Cocoa: posts the ante 800
donkeynutz44: posts the ante 800
Burassi: posts the ante 800
barhoper732: posts the ante 800
donkeynutz44: posts small blind 3200
Burassi: posts big blind 6400
*** HOLE CARDS ***
Dealt to JJin91 [5h As]
barhoper732: folds=20
JJin91: raises 7488 to 13888
All4Cocoa: folds=20
donkeynutz44: folds=20
Burassi: calls 7488
*** FLOP *** [Qh 6h Jc]
Burassi: checks=20
JJin91: checks=20
*** TURN *** [Qh 6h Jc] [5c]
Burassi: checks=20
JJin91: checks=20
*** RIVER *** [Qh 6h Jc 5c] [3c]
Burassi: checks=20
JJin91: checks=20
*** SHOW DOWN ***
Burassi: shows [8d 6d] (a pair of Sixes)
JJin91: mucks hand=20
Burassi collected 34976 from pot
*** SUMMARY ***
Total pot 34976 | Rake 0=20
Board [Qh 6h Jc 5c 3c]
Seat 1: JJin91 mucked [5h As]
Seat 2: All4Cocoa (button) folded before Flop (didn't bet)
Seat 3: donkeynutz44 (small blind) folded before Flop
Seat 4: Burassi (big blind) showed [8d 6d] and won (34976) with a pair =
of Sixes
Seat 6: barhoper732 folded before Flop (didn't bet)


*********** # 249 **************
PokerStars Hand #175482477050: Tournament #1701793695, $9.10+$0.90 USD =
Hold'em No Limit - Level XXV (3200/6400) - 2017/09/24 20:00:56 ET
Table '1701793695 16' 6-max Seat #3 is the button
Seat 1: JJin91 (768082 in chips)=20
Seat 2: All4Cocoa (84500 in chips)=20
Seat 3: donkeynutz44 (102708 in chips)=20
Seat 4: Burassi (266934 in chips)=20
Seat 5: Bar.usWYGRAM (53100 in chips)=20
Seat 6: barhoper732 (58576 in chips)=20
JJin91: posts the ante 800
All4Cocoa: posts the ante 800
donkeynutz44: posts the ante 800
Burassi: posts the ante 800
Bar.usWYGRAM: posts the ante 800
barhoper732: posts the ante 800
Burassi: posts small blind 3200
Bar.usWYGRAM: posts big blind 6400
*** HOLE CARDS ***
Dealt to JJin91 [9h Ac]
barhoper732: calls 6400
JJin91: calls 6400
All4Cocoa: folds=20
donkeynutz44: folds=20
Burassi: folds=20
Bar.usWYGRAM: checks=20
*** FLOP *** [5s 2c 4h]
Bar.usWYGRAM: bets 45900 and is all-in
barhoper732: folds=20
JJin91: folds=20
Uncalled bet (45900) returned to Bar.usWYGRAM
Bar.usWYGRAM collected 27200 from pot
Bar.usWYGRAM: shows [5d]
*** SUMMARY ***
Total pot 27200 | Rake 0=20
Board [5s 2c 4h]
Seat 1: JJin91 folded on the Flop
Seat 2: All4Cocoa folded before Flop (didn't bet)
Seat 3: donkeynutz44 (button) folded before Flop (didn't bet)
Seat 4: Burassi (small blind) folded before Flop
Seat 5: Bar.usWYGRAM (big blind) collected (27200)
Seat 6: barhoper732 folded on the Flop


*********** # 250 **************
PokerStars Hand #175482477233: Tournament #1701793695, $9.10+$0.90 USD =
Hold'em No Limit - Level XXV (3200/6400) - 2017/09/24 20:01:32 ET
Table '1701793695 16' 6-max Seat #4 is the button
Seat 1: JJin91 (760882 in chips)=20
Seat 2: All4Cocoa (83700 in chips)=20
Seat 3: donkeynutz44 (101908 in chips)=20
Seat 4: Burassi (262934 in chips)=20
Seat 5: Bar.usWYGRAM (73100 in chips)=20
Seat 6: barhoper732 (51376 in chips)=20
JJin91: posts the ante 800
All4Cocoa: posts the ante 800
donkeynutz44: posts the ante 800
Burassi: posts the ante 800
Bar.usWYGRAM: posts the ante 800
barhoper732: posts the ante 800
Bar.usWYGRAM: posts small blind 3200
barhoper732: posts big blind 6400
*** HOLE CARDS ***
Dealt to JJin91 [4c 3d]
JJin91: folds=20
All4Cocoa: folds=20
donkeynutz44: raises 20800 to 27200
Burassi: folds=20
Bar.usWYGRAM: folds=20
barhoper732: folds=20
Uncalled bet (20800) returned to donkeynutz44
donkeynutz44 collected 20800 from pot
donkeynutz44: doesn't show hand=20
*** SUMMARY ***
Total pot 20800 | Rake 0=20
Seat 1: JJin91 folded before Flop (didn't bet)
Seat 2: All4Cocoa folded before Flop (didn't bet)
Seat 3: donkeynutz44 collected (20800)
Seat 4: Burassi (button) folded before Flop (didn't bet)
Seat 5: Bar.usWYGRAM (small blind) folded before Flop
Seat 6: barhoper732 (big blind) folded before Flop


*********** # 251 **************
PokerStars Hand #175482477390: Tournament #1701793695, $9.10+$0.90 USD =
Hold'em No Limit - Level XXV (3200/6400) - 2017/09/24 20:02:05 ET
Table '1701793695 16' 6-max Seat #5 is the button
Seat 1: JJin91 (760082 in chips)=20
Seat 2: All4Cocoa (82900 in chips)=20
Seat 3: donkeynutz44 (115508 in chips)=20
Seat 4: Burassi (262134 in chips)=20
Seat 5: Bar.usWYGRAM (69100 in chips)=20
Seat 6: barhoper732 (44176 in chips)=20
JJin91: posts the ante 800
All4Cocoa: posts the ante 800
donkeynutz44: posts the ante 800
Burassi: posts the ante 800
Bar.usWYGRAM: posts the ante 800
barhoper732: posts the ante 800
barhoper732: posts small blind 3200
JJin91: posts big blind 6400
*** HOLE CARDS ***
Dealt to JJin91 [Kc Ks]
All4Cocoa: folds=20
donkeynutz44: folds=20
Burassi: raises 7488 to 13888
Bar.usWYGRAM: folds=20
barhoper732: folds=20
JJin91: raises 25111 to 38999
Burassi: raises 76201 to 115200
JJin91: raises 644082 to 759282 and is all-in
Burassi: calls 146134 and is all-in
Uncalled bet (497948) returned to JJin91
*** FLOP *** [Jd Th 8s]
*** TURN *** [Jd Th 8s] [7c]
*** RIVER *** [Jd Th 8s 7c] [Kd]
*** SHOW DOWN ***
JJin91: shows [Kc Ks] (three of a kind, Kings)
Burassi: shows [Qd Qc] (a pair of Queens)
JJin91 collected 530668 from pot
Burassi finished the tournament in 58th place and received $20.00.
*** SUMMARY ***
Total pot 530668 | Rake 0=20
Board [Jd Th 8s 7c Kd]
Seat 1: JJin91 (big blind) showed [Kc Ks] and won (530668) with three o=
f a kind, Kings
Seat 2: All4Cocoa folded before Flop (didn't bet)
Seat 3: donkeynutz44 folded before Flop (didn't bet)
Seat 4: Burassi showed [Qd Qc] and lost with a pair of Queens
Seat 5: Bar.usWYGRAM (button) folded before Flop (didn't bet)
Seat 6: barhoper732 (small blind) folded before Flop


*********** # 252 **************
PokerStars Hand #175482477664: Tournament #1701793695, $9.10+$0.90 USD =
Hold'em No Limit - Level XXV (3200/6400) - 2017/09/24 20:03:11 ET
Table '1701793695 16' 6-max Seat #6 is the button
Seat 1: JJin91 (1028616 in chips)=20
Seat 2: All4Cocoa (82100 in chips)=20
Seat 3: donkeynutz44 (114708 in chips)=20
Seat 5: Bar.usWYGRAM (68300 in chips)=20
Seat 6: barhoper732 (40176 in chips)=20
JJin91: posts the ante 800
All4Cocoa: posts the ante 800
donkeynutz44: posts the ante 800
Bar.usWYGRAM: posts the ante 800
barhoper732: posts the ante 800
JJin91: posts small blind 3200
All4Cocoa: posts big blind 6400
*** HOLE CARDS ***
Dealt to JJin91 [7h 3d]
donkeynutz44: raises 20000 to 26400
Bar.usWYGRAM: folds=20
barhoper732: folds=20
JJin91: folds=20
All4Cocoa: folds=20
Uncalled bet (20000) returned to donkeynutz44
donkeynutz44 collected 20000 from pot
donkeynutz44: doesn't show hand=20
*** SUMMARY ***
Total pot 20000 | Rake 0=20
Seat 1: JJin91 (small blind) folded before Flop
Seat 2: All4Cocoa (big blind) folded before Flop
Seat 3: donkeynutz44 collected (20000)
Seat 5: Bar.usWYGRAM folded before Flop (didn't bet)
Seat 6: barhoper732 (button) folded before Flop (didn't bet)


*********** # 253 **************
PokerStars Hand #175482477782: Tournament #1701793695, $9.10+$0.90 USD =
Hold'em No Limit - Level XXV (3200/6400) - 2017/09/24 20:03:38 ET
Table '1701793695 16' 6-max Seat #1 is the button
Seat 1: JJin91 (1024616 in chips)=20
Seat 2: All4Cocoa (74900 in chips)=20
Seat 3: donkeynutz44 (127508 in chips)=20
Seat 5: Bar.usWYGRAM (67500 in chips)=20
Seat 6: barhoper732 (39376 in chips)=20
JJin91: posts the ante 800
All4Cocoa: posts the ante 800
donkeynutz44: posts the ante 800
Bar.usWYGRAM: posts the ante 800
barhoper732: posts the ante 800
All4Cocoa: posts small blind 3200
donkeynutz44: posts big blind 6400
*** HOLE CARDS ***
Dealt to JJin91 [Ks 8h]
Bar.usWYGRAM: folds=20
barhoper732: raises 12800 to 19200
JJin91: folds=20
All4Cocoa: folds=20
donkeynutz44: folds=20
Uncalled bet (12800) returned to barhoper732
barhoper732 collected 20000 from pot
barhoper732: doesn't show hand=20
*** SUMMARY ***
Total pot 20000 | Rake 0=20
Seat 1: JJin91 (button) folded before Flop (didn't bet)
Seat 2: All4Cocoa (small blind) folded before Flop
Seat 3: donkeynutz44 (big blind) folded before Flop
Seat 5: Bar.usWYGRAM folded before Flop (didn't bet)
Seat 6: barhoper732 collected (20000)


*********** # 254 **************
PokerStars Hand #175482477912: Tournament #1701793695, $9.10+$0.90 USD =
Hold'em No Limit - Level XXV (3200/6400) - 2017/09/24 20:04:07 ET
Table '1701793695 16' 6-max Seat #2 is the button
Seat 1: JJin91 (1023816 in chips)=20
Seat 2: All4Cocoa (70900 in chips)=20
Seat 3: donkeynutz44 (120308 in chips)=20
Seat 5: Bar.usWYGRAM (66700 in chips)=20
Seat 6: barhoper732 (52176 in chips)=20
JJin91: posts the ante 800
All4Cocoa: posts the ante 800
donkeynutz44: posts the ante 800
Bar.usWYGRAM: posts the ante 800
barhoper732: posts the ante 800
donkeynutz44: posts small blind 3200
Bar.usWYGRAM: posts big blind 6400
*** HOLE CARDS ***
Dealt to JJin91 [Qd 3d]
barhoper732: folds=20
JJin91: folds=20
All4Cocoa: folds=20
donkeynutz44: folds=20
Uncalled bet (3200) returned to Bar.usWYGRAM
Bar.usWYGRAM collected 10400 from pot
*** SUMMARY ***
Total pot 10400 | Rake 0=20
Seat 1: JJin91 folded before Flop (didn't bet)
Seat 2: All4Cocoa (button) folded before Flop (didn't bet)
Seat 3: donkeynutz44 (small blind) folded before Flop
Seat 5: Bar.usWYGRAM (big blind) collected (10400)
Seat 6: barhoper732 folded before Flop (didn't bet)


*********** # 255 **************
PokerStars Hand #175482478080: Tournament #1701793695, $9.10+$0.90 USD =
Hold'em No Limit - Level XXV (3200/6400) - 2017/09/24 20:04:47 ET
Table '1701793695 16' 6-max Seat #3 is the button
Seat 1: JJin91 (1023016 in chips)=20
Seat 2: All4Cocoa (70100 in chips)=20
Seat 3: donkeynutz44 (116308 in chips)=20
Seat 4: Google_Man66 (82500 in chips) out of hand (moved from another t=
able into small blind)
Seat 5: Bar.usWYGRAM (73100 in chips)=20
Seat 6: barhoper732 (51376 in chips)=20
JJin91: posts the ante 800
All4Cocoa: posts the ante 800
donkeynutz44: posts the ante 800
Bar.usWYGRAM: posts the ante 800
barhoper732: posts the ante 800
Bar.usWYGRAM: posts small blind 3200
barhoper732: posts big blind 6400
*** HOLE CARDS ***
Dealt to JJin91 [Kh Kd]
JJin91: raises 7488 to 13888
All4Cocoa: folds=20
donkeynutz44: folds=20
Bar.usWYGRAM: folds=20
barhoper732: folds=20
Uncalled bet (7488) returned to JJin91
JJin91 collected 20000 from pot
JJin91: doesn't show hand=20
*** SUMMARY ***
Total pot 20000 | Rake 0=20
Seat 1: JJin91 collected (20000)
Seat 2: All4Cocoa folded before Flop (didn't bet)
Seat 3: donkeynutz44 (button) folded before Flop (didn't bet)
Seat 5: Bar.usWYGRAM (small blind) folded before Flop
Seat 6: barhoper732 (big blind) folded before Flop


*********** # 256 **************
PokerStars Hand #175482478173: Tournament #1701793695, $9.10+$0.90 USD =
Hold'em No Limit - Level XXV (3200/6400) - 2017/09/24 20:05:06 ET
Table '1701793695 16' 6-max Seat #5 is the button
Seat 1: JJin91 (1035816 in chips)=20
Seat 2: All4Cocoa (69300 in chips)=20
Seat 3: donkeynutz44 (115508 in chips)=20
Seat 4: Google_Man66 (82500 in chips)=20
Seat 5: Bar.usWYGRAM (69100 in chips)=20
Seat 6: barhoper732 (44176 in chips)=20
JJin91: posts the ante 800
All4Cocoa: posts the ante 800
donkeynutz44: posts the ante 800
Google_Man66: posts the ante 800
Bar.usWYGRAM: posts the ante 800
barhoper732: posts the ante 800
barhoper732: posts small blind 3200
JJin91: posts big blind 6400
*** HOLE CARDS ***
Dealt to JJin91 [9s 5c]
All4Cocoa: folds=20
donkeynutz44: folds=20
Google_Man66: folds=20
Bar.usWYGRAM: raises 61900 to 68300 and is all-in
barhoper732: calls 40176 and is all-in
JJin91: folds=20
Uncalled bet (24924) returned to Bar.usWYGRAM
Bar.usWYGRAM said, "a9a9a9a9a9a9a9a9a9a99a9a9a9a9a9a"
*** FLOP *** [Td 2c Ad]
Bar.usWYGRAM said, "9aa99a9a9a9a9a9a9a9a"
Bar.usWYGRAM said, "noooooooo"
*** TURN *** [Td 2c Ad] [As]
Bar.usWYGRAM said, "nooooooooooo"
*** RIVER *** [Td 2c Ad As] [4h]
*** SHOW DOWN ***
barhoper732: shows [9d 8d] (a pair of Aces)
Bar.usWYGRAM: shows [Ac 9c] (three of a kind, Aces)
Bar.usWYGRAM collected 97952 from pot
barhoper732 finished the tournament in 54th place and received $22.50.
*** SUMMARY ***
Total pot 97952 | Rake 0=20
Board [Td 2c Ad As 4h]
Seat 1: JJin91 (big blind) folded before Flop
Seat 2: All4Cocoa folded before Flop (didn't bet)
Seat 3: donkeynutz44 folded before Flop (didn't bet)
Seat 4: Google_Man66 folded before Flop (didn't bet)
Seat 5: Bar.usWYGRAM (button) showed [Ac 9c] and won (97952) with three=
 of a kind, Aces
Seat 6: barhoper732 (small blind) showed [9d 8d] and lost with a pair o=
f Aces


*********** # 257 **************
PokerStars Hand #175482478336: Tournament #1701793695, $9.10+$0.90 USD =
Hold'em No Limit - Level XXV (3200/6400) - 2017/09/24 20:05:43 ET
Table '1701793695 16' 6-max Seat #1 is the button
Seat 1: JJin91 (1028616 in chips)=20
Seat 2: All4Cocoa (68500 in chips)=20
Seat 3: donkeynutz44 (114708 in chips)=20
Seat 4: Google_Man66 (81700 in chips)=20
Seat 5: Bar.usWYGRAM (122876 in chips)=20
JJin91: posts the ante 800
All4Cocoa: posts the ante 800
donkeynutz44: posts the ante 800
Google_Man66: posts the ante 800
Bar.usWYGRAM: posts the ante 800
All4Cocoa: posts small blind 3200
donkeynutz44: posts big blind 6400
*** HOLE CARDS ***
Dealt to JJin91 [Qc 4c]
Bar.usWYGRAM said, "i saw flush coming"
Google_Man66: folds=20
Bar.usWYGRAM said, "one time no suckout"
Bar.usWYGRAM said, "first time no suckout <3"
Bar.usWYGRAM: folds=20
JJin91: raises 7488 to 13888
All4Cocoa: folds=20
donkeynutz44: calls 7488
*** FLOP *** [Tc 9s 6h]
donkeynutz44: checks=20
JJin91: bets 17838
donkeynutz44: calls 17838
*** TURN *** [Tc 9s 6h] [2h]
donkeynutz44: checks=20
JJin91: checks=20
*** RIVER *** [Tc 9s 6h 2h] [Jc]
donkeynutz44: checks=20
JJin91: checks=20
*** SHOW DOWN ***
donkeynutz44: shows [Qd Jh] (a pair of Jacks)
JJin91: mucks hand=20
donkeynutz44 collected 70652 from pot
*** SUMMARY ***
Total pot 70652 | Rake 0=20
Board [Tc 9s 6h 2h Jc]
Seat 1: JJin91 (button) mucked [Qc 4c]
Seat 2: All4Cocoa (small blind) folded before Flop
Seat 3: donkeynutz44 (big blind) showed [Qd Jh] and won (70652) with a =
pair of Jacks
Seat 4: Google_Man66 folded before Flop (didn't bet)
Seat 5: Bar.usWYGRAM folded before Flop (didn't bet)


*********** # 258 **************
PokerStars Hand #175482478643: Tournament #1701793695, $9.10+$0.90 USD =
Hold'em No Limit - Level XXV (3200/6400) - 2017/09/24 20:06:52 ET
Table '1701793695 16' 6-max Seat #2 is the button
Seat 1: JJin91 (996090 in chips)=20
Seat 2: All4Cocoa (64500 in chips)=20
Seat 3: donkeynutz44 (152834 in chips)=20
Seat 4: Google_Man66 (80900 in chips)=20
Seat 5: Bar.usWYGRAM (122076 in chips)=20
JJin91: posts the ante 800
All4Cocoa: posts the ante 800
donkeynutz44: posts the ante 800
Google_Man66: posts the ante 800
Bar.usWYGRAM: posts the ante 800
donkeynutz44: posts small blind 3200
Google_Man66: posts big blind 6400
*** HOLE CARDS ***
Dealt to JJin91 [5d Jd]
Bar.usWYGRAM: folds=20
JJin91: folds=20
All4Cocoa: raises 57300 to 63700 and is all-in
donkeynutz44: folds=20
Google_Man66: folds=20
Uncalled bet (57300) returned to All4Cocoa
All4Cocoa collected 20000 from pot
All4Cocoa: doesn't show hand=20
*** SUMMARY ***
Total pot 20000 | Rake 0=20
Seat 1: JJin91 folded before Flop (didn't bet)
Seat 2: All4Cocoa (button) collected (20000)
Seat 3: donkeynutz44 (small blind) folded before Flop
Seat 4: Google_Man66 (big blind) folded before Flop
Seat 5: Bar.usWYGRAM folded before Flop (didn't bet)


*********** # 259 **************
PokerStars Hand #175482478736: Tournament #1701793695, $9.10+$0.90 USD =
Hold'em No Limit - Level XXV (3200/6400) - 2017/09/24 20:07:15 ET
Table '1701793695 16' 6-max Seat #3 is the button
Seat 1: JJin91 (995290 in chips)=20
Seat 2: All4Cocoa (77300 in chips)=20
Seat 3: donkeynutz44 (148834 in chips)=20
Seat 4: Google_Man66 (73700 in chips)=20
Seat 5: Bar.usWYGRAM (121276 in chips)=20
JJin91: posts the ante 800
All4Cocoa: posts the ante 800
donkeynutz44: posts the ante 800
Google_Man66: posts the ante 800
Bar.usWYGRAM: posts the ante 800
Google_Man66: posts small blind 3200
Bar.usWYGRAM: posts big blind 6400
*** HOLE CARDS ***
Dealt to JJin91 [3c Td]
JJin91: folds=20
All4Cocoa: raises 70100 to 76500 and is all-in
donkeynutz44: folds=20
Google_Man66: folds=20
Bar.usWYGRAM: folds [9h 3s]
Uncalled bet (70100) returned to All4Cocoa
All4Cocoa collected 20000 from pot
All4Cocoa: doesn't show hand=20
*** SUMMARY ***
Total pot 20000 | Rake 0=20
Seat 1: JJin91 folded before Flop (didn't bet)
Seat 2: All4Cocoa collected (20000)
Seat 3: donkeynutz44 (button) folded before Flop (didn't bet)
Seat 4: Google_Man66 (small blind) folded before Flop
Seat 5: Bar.usWYGRAM (big blind) folded before Flop


*********** # 260 **************
PokerStars Hand #175482478844: Tournament #1701793695, $9.10+$0.90 USD =
Hold'em No Limit - Level XXV (3200/6400) - 2017/09/24 20:07:38 ET
Table '1701793695 16' 6-max Seat #4 is the button
Seat 1: JJin91 (994490 in chips)=20
Seat 2: All4Cocoa (90100 in chips)=20
Seat 3: donkeynutz44 (148034 in chips)=20
Seat 4: Google_Man66 (69700 in chips)=20
Seat 5: Bar.usWYGRAM (114076 in chips)=20
JJin91: posts the ante 800
All4Cocoa: posts the ante 800
donkeynutz44: posts the ante 800
Google_Man66: posts the ante 800
Bar.usWYGRAM: posts the ante 800
Bar.usWYGRAM: posts small blind 3200
JJin91: posts big blind 6400
*** HOLE CARDS ***
Dealt to JJin91 [Kd Ts]
All4Cocoa: raises 82900 to 89300 and is all-in
donkeynutz44: folds=20
Google_Man66: folds=20
Bar.usWYGRAM: folds=20
JJin91: calls 82900
*** FLOP *** [Qs 3h Kh]
*** TURN *** [Qs 3h Kh] [Ks]
*** RIVER *** [Qs 3h Kh Ks] [3c]
*** SHOW DOWN ***
JJin91: shows [Kd Ts] (a full house, Kings full of Threes)
All4Cocoa: shows [5s 7d] (two pair, Kings and Threes)
JJin91 collected 185800 from pot
All4Cocoa finished the tournament in 49th place and received $22.50.
*** SUMMARY ***
Total pot 185800 | Rake 0=20
Board [Qs 3h Kh Ks 3c]
Seat 1: JJin91 (big blind) showed [Kd Ts] and won (185800) with a full =
house, Kings full of Threes
Seat 2: All4Cocoa showed [5s 7d] and lost with two pair, Kings and Thre=
es
Seat 3: donkeynutz44 folded before Flop (didn't bet)
Seat 4: Google_Man66 (button) folded before Flop (didn't bet)
Seat 5: Bar.usWYGRAM (small blind) folded before Flop


*********** # 261 **************
PokerStars Hand #175482478952: Tournament #1701793695, $9.10+$0.90 USD =
Hold'em No Limit - Level XXVI (3600/7200) - 2017/09/24 20:08:03 ET
Table '1701793695 14' 6-max Seat #1 is the button
Seat 1: miscreant42 (90446 in chips)=20
Seat 2: SneakyPete85 (200711 in chips)=20
Seat 3: lasttruepoet (76169 in chips)=20
Seat 4: Warrior00086 (282209 in chips)=20
Seat 5: BENZBMW (199693 in chips)=20
Seat 6: JJin91 (1090190 in chips)=20
miscreant42: posts the ante 900
SneakyPete85: posts the ante 900
lasttruepoet: posts the ante 900
Warrior00086: posts the ante 900
BENZBMW: posts the ante 900
JJin91: posts the ante 900
SneakyPete85: posts small blind 3600
lasttruepoet: posts big blind 7200
*** HOLE CARDS ***
Dealt to JJin91 [4c 4h]
Warrior00086: folds=20
BENZBMW: raises 23400 to 30600
JJin91: calls 30600
miscreant42: folds=20
SneakyPete85: folds=20
lasttruepoet: folds=20
*** FLOP *** [9c Qc 7d]
BENZBMW: bets 7200
JJin91: calls 7200
*** TURN *** [9c Qc 7d] [Kc]
BENZBMW: bets 45900
JJin91: folds=20
Uncalled bet (45900) returned to BENZBMW
BENZBMW collected 91800 from pot
*** SUMMARY ***
Total pot 91800 | Rake 0=20
Board [9c Qc 7d Kc]
Seat 1: miscreant42 (button) folded before Flop (didn't bet)
Seat 2: SneakyPete85 (small blind) folded before Flop
Seat 3: lasttruepoet (big blind) folded before Flop
Seat 4: Warrior00086 folded before Flop (didn't bet)
Seat 5: BENZBMW collected (91800)
Seat 6: JJin91 folded on the Turn


*********** # 262 **************
PokerStars Hand #175482479234: Tournament #1701793695, $9.10+$0.90 USD =
Hold'em No Limit - Level XXVI (3600/7200) - 2017/09/24 20:09:09 ET
Table '1701793695 14' 6-max Seat #2 is the button
Seat 1: miscreant42 (89546 in chips)=20
Seat 2: SneakyPete85 (196211 in chips)=20
Seat 3: lasttruepoet (68069 in chips)=20
Seat 4: Warrior00086 (281309 in chips)=20
Seat 5: BENZBMW (252793 in chips)=20
Seat 6: JJin91 (1051490 in chips)=20
miscreant42: posts the ante 900
SneakyPete85: posts the ante 900
lasttruepoet: posts the ante 900
Warrior00086: posts the ante 900
BENZBMW: posts the ante 900
JJin91: posts the ante 900
lasttruepoet: posts small blind 3600
Warrior00086: posts big blind 7200
*** HOLE CARDS ***
Dealt to JJin91 [As 9s]
BENZBMW: folds=20
JJin91: raises 8424 to 15624
miscreant42: calls 15624
SneakyPete85: folds=20
lasttruepoet: folds=20
Warrior00086: folds=20
*** FLOP *** [Qs Jd 2h]
JJin91: checks=20
miscreant42: bets 36000
JJin91: folds=20
Uncalled bet (36000) returned to miscreant42
miscreant42 collected 47448 from pot
miscreant42: doesn't show hand=20
*** SUMMARY ***
Total pot 47448 | Rake 0=20
Board [Qs Jd 2h]
Seat 1: miscreant42 collected (47448)
Seat 2: SneakyPete85 (button) folded before Flop (didn't bet)
Seat 3: lasttruepoet (small blind) folded before Flop
Seat 4: Warrior00086 (big blind) folded before Flop
Seat 5: BENZBMW folded before Flop (didn't bet)
Seat 6: JJin91 folded on the Flop


*********** # 263 **************
PokerStars Hand #175482479461: Tournament #1701793695, $9.10+$0.90 USD =
Hold'em No Limit - Level XXVI (3600/7200) - 2017/09/24 20:09:57 ET
Table '1701793695 14' 6-max Seat #3 is the button
Seat 1: miscreant42 (120470 in chips)=20
Seat 2: SneakyPete85 (195311 in chips)=20
Seat 3: lasttruepoet (63569 in chips)=20
Seat 4: Warrior00086 (273209 in chips)=20
Seat 5: BENZBMW (251893 in chips)=20
Seat 6: JJin91 (1034966 in chips)=20
miscreant42: posts the ante 900
SneakyPete85: posts the ante 900
lasttruepoet: posts the ante 900
Warrior00086: posts the ante 900
BENZBMW: posts the ante 900
JJin91: posts the ante 900
Warrior00086: posts small blind 3600
BENZBMW: posts big blind 7200
*** HOLE CARDS ***
Dealt to JJin91 [9c Js]
JJin91: folds=20
miscreant42: raises 10300 to 17500
SneakyPete85: folds=20
lasttruepoet: folds=20
Warrior00086: folds=20
BENZBMW: calls 10300
*** FLOP *** [Kh Jh 2s]
BENZBMW: checks=20
miscreant42: bets 21600
BENZBMW: calls 21600
*** TURN *** [Kh Jh 2s] [3c]
BENZBMW: checks=20
miscreant42: checks=20
*** RIVER *** [Kh Jh 2s 3c] [Qc]
BENZBMW: checks=20
miscreant42: bets 43600
BENZBMW: calls 43600
*** SHOW DOWN ***
miscreant42: shows [8h 8s] (a pair of Eights)
BENZBMW: shows [9s Ks] (a pair of Kings)
BENZBMW collected 174400 from pot
*** SUMMARY ***
Total pot 174400 | Rake 0=20
Board [Kh Jh 2s 3c Qc]
Seat 1: miscreant42 showed [8h 8s] and lost with a pair of Eights
Seat 2: SneakyPete85 folded before Flop (didn't bet)
Seat 3: lasttruepoet (button) folded before Flop (didn't bet)
Seat 4: Warrior00086 (small blind) folded before Flop
Seat 5: BENZBMW (big blind) showed [9s Ks] and won (174400) with a pair=
 of Kings
Seat 6: JJin91 folded before Flop (didn't bet)


*********** # 264 **************
PokerStars Hand #175482479913: Tournament #1701793695, $9.10+$0.90 USD =
Hold'em No Limit - Level XXVI (3600/7200) - 2017/09/24 20:11:27 ET
Table '1701793695 14' 6-max Seat #4 is the button
Seat 1: miscreant42 (36870 in chips)=20
Seat 2: SneakyPete85 (194411 in chips)=20
Seat 3: lasttruepoet (62669 in chips)=20
Seat 4: Warrior00086 (268709 in chips)=20
Seat 5: BENZBMW (342693 in chips)=20
Seat 6: JJin91 (1034066 in chips)=20
miscreant42: posts the ante 900
SneakyPete85: posts the ante 900
lasttruepoet: posts the ante 900
Warrior00086: posts the ante 900
BENZBMW: posts the ante 900
JJin91: posts the ante 900
BENZBMW: posts small blind 3600
JJin91: posts big blind 7200
*** HOLE CARDS ***
Dealt to JJin91 [Kc 6h]
miscreant42: folds=20
SneakyPete85: raises 7200 to 14400
lasttruepoet: folds=20
Warrior00086: folds=20
BENZBMW: raises 7200 to 21600
JJin91: folds=20
SneakyPete85: raises 171911 to 193511 and is all-in
BENZBMW: folds=20
Uncalled bet (171911) returned to SneakyPete85
SneakyPete85 collected 55800 from pot
SneakyPete85: doesn't show hand=20
*** SUMMARY ***
Total pot 55800 | Rake 0=20
Seat 1: miscreant42 folded before Flop (didn't bet)
Seat 2: SneakyPete85 collected (55800)
Seat 3: lasttruepoet folded before Flop (didn't bet)
Seat 4: Warrior00086 (button) folded before Flop (didn't bet)
Seat 5: BENZBMW (small blind) folded before Flop
Seat 6: JJin91 (big blind) folded before Flop


*********** # 265 **************
PokerStars Hand #175483887395: Tournament #1701793695, $9.10+$0.90 USD =
Hold'em No Limit - Level XXVI (3600/7200) - 2017/09/24 20:12:07 ET
Table '1701793695 14' 6-max Seat #5 is the button
Seat 1: miscreant42 (35970 in chips)=20
Seat 2: SneakyPete85 (227711 in chips)=20
Seat 3: lasttruepoet (61769 in chips)=20
Seat 4: Warrior00086 (267809 in chips)=20
Seat 5: BENZBMW (320193 in chips)=20
Seat 6: JJin91 (1025966 in chips)=20
miscreant42: posts the ante 900
SneakyPete85: posts the ante 900
lasttruepoet: posts the ante 900
Warrior00086: posts the ante 900
BENZBMW: posts the ante 900
JJin91: posts the ante 900
JJin91: posts small blind 3600
miscreant42: posts big blind 7200
*** HOLE CARDS ***
Dealt to JJin91 [3s 7c]
SneakyPete85: folds=20
lasttruepoet: raises 53669 to 60869 and is all-in
Warrior00086: folds=20
BENZBMW: folds=20
JJin91: folds=20
miscreant42: folds=20
Uncalled bet (53669) returned to lasttruepoet
lasttruepoet collected 23400 from pot
*** SUMMARY ***
Total pot 23400 | Rake 0=20
Seat 1: miscreant42 (big blind) folded before Flop
Seat 2: SneakyPete85 folded before Flop (didn't bet)
Seat 3: lasttruepoet collected (23400)
Seat 4: Warrior00086 folded before Flop (didn't bet)
Seat 5: BENZBMW (button) folded before Flop (didn't bet)
Seat 6: JJin91 (small blind) folded before Flop


*********** # 266 **************
PokerStars Hand #175483887529: Tournament #1701793695, $9.10+$0.90 USD =
Hold'em No Limit - Level XXVI (3600/7200) - 2017/09/24 20:12:35 ET
Table '1701793695 14' 6-max Seat #6 is the button
Seat 1: miscreant42 (27870 in chips)=20
Seat 2: SneakyPete85 (226811 in chips)=20
Seat 3: lasttruepoet (77069 in chips)=20
Seat 4: Warrior00086 (266909 in chips)=20
Seat 5: BENZBMW (319293 in chips)=20
Seat 6: JJin91 (1021466 in chips)=20
miscreant42: posts the ante 900
SneakyPete85: posts the ante 900
lasttruepoet: posts the ante 900
Warrior00086: posts the ante 900
BENZBMW: posts the ante 900
JJin91: posts the ante 900
miscreant42: posts small blind 3600
SneakyPete85: posts big blind 7200
*** HOLE CARDS ***
Dealt to JJin91 [4d Kd]
lasttruepoet has timed out
lasttruepoet: folds=20
lasttruepoet is sitting out
Warrior00086: folds=20
BENZBMW: raises 7200 to 14400
JJin91: folds=20
miscreant42: calls 10800
SneakyPete85: calls 7200
*** FLOP *** [5d 6d 8h]
miscreant42: bets 12570 and is all-in
SneakyPete85: raises 12570 to 25140
BENZBMW: folds=20
Uncalled bet (12570) returned to SneakyPete85
*** TURN *** [5d 6d 8h] [Kc]
*** RIVER *** [5d 6d 8h Kc] [Tc]
*** SHOW DOWN ***
miscreant42: shows [8s As] (a pair of Eights)
SneakyPete85: shows [8d 6h] (two pair, Eights and Sixes)
SneakyPete85 collected 73740 from pot
miscreant42 finished the tournament in 43rd place and received $25.00.
*** SUMMARY ***
Total pot 73740 | Rake 0=20
Board [5d 6d 8h Kc Tc]
Seat 1: miscreant42 (small blind) showed [8s As] and lost with a pair o=
f Eights
Seat 2: SneakyPete85 (big blind) showed [8d 6h] and won (73740) with tw=
o pair, Eights and Sixes
Seat 3: lasttruepoet folded before Flop (didn't bet)
Seat 4: Warrior00086 folded before Flop (didn't bet)
Seat 5: BENZBMW folded on the Flop
Seat 6: JJin91 (button) folded before Flop (didn't bet)


*********** # 267 **************
PokerStars Hand #175483888052: Tournament #1701793695, $9.10+$0.90 USD =
Hold'em No Limit - Level XXVI (3600/7200) - 2017/09/24 20:14:20 ET
Table '1701793695 2' 6-max Seat #5 is the button
Seat 1: NearlyRoyal (191900 in chips)=20
Seat 2: VagColeSlaw (410309 in chips)=20
Seat 3: Jivetoast (150773 in chips)=20
Seat 4: JJin91 (1020566 in chips)=20
Seat 5: WhiteIce0328 (772228 in chips) is sitting out
Seat 6: DavidFloyd46 (141334 in chips)=20
NearlyRoyal: posts the ante 900
VagColeSlaw: posts the ante 900
Jivetoast: posts the ante 900
JJin91: posts the ante 900
WhiteIce0328: posts the ante 900
DavidFloyd46: posts the ante 900
DavidFloyd46: posts small blind 3600
NearlyRoyal: posts big blind 7200
*** HOLE CARDS ***
Dealt to JJin91 [9s Ah]
WhiteIce0328 has returned
VagColeSlaw: folds=20
Jivetoast: folds=20
JJin91: raises 8424 to 15624
WhiteIce0328: folds=20
DavidFloyd46: folds=20
Jivetoast said, "1 and 2 next to my left, never good..."
NearlyRoyal: calls 8424
*** FLOP *** [3d Qd 9c]
NearlyRoyal: checks=20
JJin91: bets 7200
ReservoirK@ [observer] said, "yeah buddy, youre definitely not a good s=
pot"
NearlyRoyal: calls 7200
*** TURN *** [3d Qd 9c] [Jh]
NearlyRoyal: checks=20
ReservoirK@ [observer] said, "nearly had a very nice comeback"
JJin91: checks=20
*** RIVER *** [3d Qd 9c Jh] [7c]
NearlyRoyal: checks=20
JJin91: checks=20
*** SHOW DOWN ***
NearlyRoyal: shows [Kd 5d] (high card King)
JJin91: shows [9s Ah] (a pair of Nines)
JJin91 collected 54648 from pot
*** SUMMARY ***
Total pot 54648 | Rake 0=20
Board [3d Qd 9c Jh 7c]
Seat 1: NearlyRoyal (big blind) showed [Kd 5d] and lost with high card =
King
Seat 2: VagColeSlaw folded before Flop (didn't bet)
Seat 3: Jivetoast folded before Flop (didn't bet)
Seat 4: JJin91 showed [9s Ah] and won (54648) with a pair of Nines
Seat 5: WhiteIce0328 (button) folded before Flop (didn't bet)
Seat 6: DavidFloyd46 (small blind) folded before Flop


*********** # 268 **************
PokerStars Hand #175483888461: Tournament #1701793695, $9.10+$0.90 USD =
Hold'em No Limit - Level XXVI (3600/7200) - 2017/09/24 20:15:50 ET
Table '1701793695 2' 6-max Seat #6 is the button
Seat 1: NearlyRoyal (168176 in chips)=20
Seat 2: VagColeSlaw (409409 in chips)=20
Seat 3: Jivetoast (149873 in chips)=20
Seat 4: JJin91 (1051490 in chips)=20
Seat 5: WhiteIce0328 (771328 in chips)=20
Seat 6: DavidFloyd46 (136834 in chips)=20
NearlyRoyal: posts the ante 900
VagColeSlaw: posts the ante 900
Jivetoast: posts the ante 900
JJin91: posts the ante 900
WhiteIce0328: posts the ante 900
DavidFloyd46: posts the ante 900
NearlyRoyal: posts small blind 3600
VagColeSlaw: posts big blind 7200
*** HOLE CARDS ***
Dealt to JJin91 [Ts Jh]
Jivetoast: folds=20
JJin91: folds=20
WhiteIce0328: raises 7200 to 14400
DavidFloyd46: folds=20
NearlyRoyal: folds=20
VagColeSlaw: folds=20
Uncalled bet (7200) returned to WhiteIce0328
WhiteIce0328 collected 23400 from pot
WhiteIce0328: doesn't show hand=20
*** SUMMARY ***
Total pot 23400 | Rake 0=20
Seat 1: NearlyRoyal (small blind) folded before Flop
Seat 2: VagColeSlaw (big blind) folded before Flop
Seat 3: Jivetoast folded before Flop (didn't bet)
Seat 4: JJin91 folded before Flop (didn't bet)
Seat 5: WhiteIce0328 collected (23400)
Seat 6: DavidFloyd46 (button) folded before Flop (didn't bet)


*********** # 269 **************
PokerStars Hand #175483888593: Tournament #1701793695, $9.10+$0.90 USD =
Hold'em No Limit - Level XXVII (4000/8000) - 2017/09/24 20:16:19 ET
Table '1701793695 2' 6-max Seat #1 is the button
Seat 1: NearlyRoyal (163676 in chips)=20
Seat 2: VagColeSlaw (401309 in chips)=20
Seat 3: Jivetoast (148973 in chips)=20
Seat 4: JJin91 (1050590 in chips)=20
Seat 5: WhiteIce0328 (786628 in chips)=20
Seat 6: DavidFloyd46 (135934 in chips)=20
NearlyRoyal: posts the ante 1000
VagColeSlaw: posts the ante 1000
Jivetoast: posts the ante 1000
JJin91: posts the ante 1000
WhiteIce0328: posts the ante 1000
DavidFloyd46: posts the ante 1000
VagColeSlaw: posts small blind 4000
Jivetoast: posts big blind 8000
*** HOLE CARDS ***
Dealt to JJin91 [Kd Jh]
JJin91: raises 9360 to 17360
WhiteIce0328: folds=20
DavidFloyd46: folds=20
NearlyRoyal: raises 46640 to 64000
VagColeSlaw: folds=20
Jivetoast: folds=20
JJin91: folds=20
Uncalled bet (46640) returned to NearlyRoyal
NearlyRoyal collected 52720 from pot
*** SUMMARY ***
Total pot 52720 | Rake 0=20
Seat 1: NearlyRoyal (button) collected (52720)
Seat 2: VagColeSlaw (small blind) folded before Flop
Seat 3: Jivetoast (big blind) folded before Flop
Seat 4: JJin91 folded before Flop
Seat 5: WhiteIce0328 folded before Flop (didn't bet)
Seat 6: DavidFloyd46 folded before Flop (didn't bet)


*********** # 270 **************
PokerStars Hand #175483888862: Tournament #1701793695, $9.10+$0.90 USD =
Hold'em No Limit - Level XXVII (4000/8000) - 2017/09/24 20:17:12 ET
Table '1701793695 2' 6-max Seat #2 is the button
Seat 1: NearlyRoyal (198036 in chips)=20
Seat 2: VagColeSlaw (396309 in chips)=20
Seat 3: Jivetoast (139973 in chips)=20
Seat 4: JJin91 (1032230 in chips)=20
Seat 5: WhiteIce0328 (785628 in chips)=20
Seat 6: DavidFloyd46 (134934 in chips)=20
NearlyRoyal: posts the ante 1000
VagColeSlaw: posts the ante 1000
Jivetoast: posts the ante 1000
JJin91: posts the ante 1000
WhiteIce0328: posts the ante 1000
DavidFloyd46: posts the ante 1000
Jivetoast: posts small blind 4000
JJin91: posts big blind 8000
*** HOLE CARDS ***
Dealt to JJin91 [8s 9h]
WhiteIce0328: raises 8000 to 16000
DavidFloyd46: folds=20
NearlyRoyal: folds=20
VagColeSlaw: calls 16000
Jivetoast: folds=20
JJin91: calls 8000
*** FLOP *** [4s 5d 2h]
JJin91: checks=20
WhiteIce0328: checks=20
VagColeSlaw: bets 32000
JJin91: folds=20
WhiteIce0328: folds=20
Uncalled bet (32000) returned to VagColeSlaw
VagColeSlaw collected 58000 from pot
VagColeSlaw: doesn't show hand=20
*** SUMMARY ***
Total pot 58000 | Rake 0=20
Board [4s 5d 2h]
Seat 1: NearlyRoyal folded before Flop (didn't bet)
Seat 2: VagColeSlaw (button) collected (58000)
Seat 3: Jivetoast (small blind) folded before Flop
Seat 4: JJin91 (big blind) folded on the Flop
Seat 5: WhiteIce0328 folded on the Flop
Seat 6: DavidFloyd46 folded before Flop (didn't bet)


*********** # 271 **************
PokerStars Hand #175483889157: Tournament #1701793695, $9.10+$0.90 USD =
Hold'em No Limit - Level XXVII (4000/8000) - 2017/09/24 20:18:14 ET
Table '1701793695 2' 6-max Seat #3 is the button
Seat 1: NearlyRoyal (197036 in chips)=20
Seat 2: VagColeSlaw (437309 in chips)=20
Seat 3: Jivetoast (134973 in chips)=20
Seat 4: JJin91 (1015230 in chips)=20
Seat 5: WhiteIce0328 (768628 in chips)=20
Seat 6: DavidFloyd46 (133934 in chips)=20
NearlyRoyal: posts the ante 1000
VagColeSlaw: posts the ante 1000
Jivetoast: posts the ante 1000
JJin91: posts the ante 1000
WhiteIce0328: posts the ante 1000
DavidFloyd46: posts the ante 1000
JJin91: posts small blind 4000
WhiteIce0328: posts big blind 8000
*** HOLE CARDS ***
Dealt to JJin91 [Kd 8d]
DavidFloyd46: folds=20
NearlyRoyal: raises 26000 to 34000
VagColeSlaw: folds=20
Jivetoast: folds=20
JJin91: folds=20
WhiteIce0328: folds=20
Uncalled bet (26000) returned to NearlyRoyal
NearlyRoyal collected 26000 from pot
*** SUMMARY ***
Total pot 26000 | Rake 0=20
Seat 1: NearlyRoyal collected (26000)
Seat 2: VagColeSlaw folded before Flop (didn't bet)
Seat 3: Jivetoast (button) folded before Flop (didn't bet)
Seat 4: JJin91 (small blind) folded before Flop
Seat 5: WhiteIce0328 (big blind) folded before Flop
Seat 6: DavidFloyd46 folded before Flop (didn't bet)


*********** # 272 **************
PokerStars Hand #175483889383: Tournament #1701793695, $9.10+$0.90 USD =
Hold'em No Limit - Level XXVII (4000/8000) - 2017/09/24 20:19:03 ET
Table '1701793695 2' 6-max Seat #4 is the button
Seat 1: NearlyRoyal (214036 in chips)=20
Seat 2: VagColeSlaw (436309 in chips)=20
Seat 3: Jivetoast (133973 in chips)=20
Seat 4: JJin91 (1010230 in chips)=20
Seat 5: WhiteIce0328 (759628 in chips)=20
Seat 6: DavidFloyd46 (132934 in chips)=20
NearlyRoyal: posts the ante 1000
VagColeSlaw: posts the ante 1000
Jivetoast: posts the ante 1000
JJin91: posts the ante 1000
WhiteIce0328: posts the ante 1000
DavidFloyd46: posts the ante 1000
WhiteIce0328: posts small blind 4000
DavidFloyd46: posts big blind 8000
*** HOLE CARDS ***
Dealt to JJin91 [Jd 8h]
NearlyRoyal: folds=20
VagColeSlaw: folds=20
Jivetoast: folds=20
JJin91: folds=20
WhiteIce0328: calls 4000
DavidFloyd46: checks=20
*** FLOP *** [7c 7s Kd]
WhiteIce0328: checks=20
DavidFloyd46: checks=20
*** TURN *** [7c 7s Kd] [2c]
WhiteIce0328: bets 22000
DavidFloyd46: folds=20
Uncalled bet (22000) returned to WhiteIce0328
WhiteIce0328 collected 22000 from pot
WhiteIce0328: doesn't show hand=20
*** SUMMARY ***
Total pot 22000 | Rake 0=20
Board [7c 7s Kd 2c]
Seat 1: NearlyRoyal folded before Flop (didn't bet)
Seat 2: VagColeSlaw folded before Flop (didn't bet)
Seat 3: Jivetoast folded before Flop (didn't bet)
Seat 4: JJin91 (button) folded before Flop (didn't bet)
Seat 5: WhiteIce0328 (small blind) collected (22000)
Seat 6: DavidFloyd46 (big blind) folded on the Turn


*********** # 273 **************
PokerStars Hand #175483889682: Tournament #1701793695, $9.10+$0.90 USD =
Hold'em No Limit - Level XXVII (4000/8000) - 2017/09/24 20:20:09 ET
Table '1701793695 2' 6-max Seat #5 is the button
Seat 1: NearlyRoyal (213036 in chips)=20
Seat 2: VagColeSlaw (435309 in chips)=20
Seat 3: Jivetoast (132973 in chips)=20
Seat 4: JJin91 (1009230 in chips)=20
Seat 5: WhiteIce0328 (772628 in chips)=20
Seat 6: DavidFloyd46 (123934 in chips)=20
NearlyRoyal: posts the ante 1000
VagColeSlaw: posts the ante 1000
Jivetoast: posts the ante 1000
JJin91: posts the ante 1000
WhiteIce0328: posts the ante 1000
DavidFloyd46: posts the ante 1000
DavidFloyd46: posts small blind 4000
NearlyRoyal: posts big blind 8000
*** HOLE CARDS ***
Dealt to JJin91 [Ad 5d]
VagColeSlaw: folds=20
Jivetoast: folds=20
JJin91: raises 9360 to 17360
WhiteIce0328: folds=20
DavidFloyd46: folds=20
NearlyRoyal: folds=20
Uncalled bet (9360) returned to JJin91
JJin91 collected 26000 from pot
JJin91: doesn't show hand=20
*** SUMMARY ***
Total pot 26000 | Rake 0=20
Seat 1: NearlyRoyal (big blind) folded before Flop
Seat 2: VagColeSlaw folded before Flop (didn't bet)
Seat 3: Jivetoast folded before Flop (didn't bet)
Seat 4: JJin91 collected (26000)
Seat 5: WhiteIce0328 (button) folded before Flop (didn't bet)
Seat 6: DavidFloyd46 (small blind) folded before Flop


*********** # 274 **************
PokerStars Hand #175483889981: Tournament #1701793695, $9.10+$0.90 USD =
Hold'em No Limit - Level XXVII (4000/8000) - 2017/09/24 20:21:14 ET
Table '1701793695 2' 6-max Seat #6 is the button
Seat 1: NearlyRoyal (204036 in chips)=20
Seat 2: VagColeSlaw (434309 in chips)=20
Seat 3: Jivetoast (131973 in chips)=20
Seat 4: JJin91 (1026230 in chips)=20
Seat 5: WhiteIce0328 (771628 in chips)=20
Seat 6: DavidFloyd46 (118934 in chips)=20
NearlyRoyal: posts the ante 1000
VagColeSlaw: posts the ante 1000
Jivetoast: posts the ante 1000
JJin91: posts the ante 1000
WhiteIce0328: posts the ante 1000
DavidFloyd46: posts the ante 1000
NearlyRoyal: posts small blind 4000
VagColeSlaw: posts big blind 8000
*** HOLE CARDS ***
Dealt to JJin91 [9d Qc]
Jivetoast: calls 8000
JJin91: folds=20
WhiteIce0328: folds=20
DavidFloyd46: folds=20
NearlyRoyal: calls 4000
VagColeSlaw: checks=20
*** FLOP *** [6h 3c Jh]
NearlyRoyal: checks=20
VagColeSlaw: checks=20
Jivetoast: bets 16000
NearlyRoyal: folds=20
VagColeSlaw: folds=20
Uncalled bet (16000) returned to Jivetoast
Jivetoast collected 30000 from pot
Jivetoast: doesn't show hand=20
*** SUMMARY ***
Total pot 30000 | Rake 0=20
Board [6h 3c Jh]
Seat 1: NearlyRoyal (small blind) folded on the Flop
Seat 2: VagColeSlaw (big blind) folded on the Flop
Seat 3: Jivetoast collected (30000)
Seat 4: JJin91 folded before Flop (didn't bet)
Seat 5: WhiteIce0328 folded before Flop (didn't bet)
Seat 6: DavidFloyd46 (button) folded before Flop (didn't bet)


*********** # 275 **************
PokerStars Hand #175484106137: Tournament #1701793695, $9.10+$0.90 USD =
Hold'em No Limit - Level XXVII (4000/8000) - 2017/09/24 20:21:46 ET
Table '1701793695 2' 6-max Seat #1 is the button
Seat 1: NearlyRoyal (195036 in chips)=20
Seat 2: VagColeSlaw (425309 in chips)=20
Seat 3: Jivetoast (152973 in chips)=20
Seat 4: JJin91 (1025230 in chips)=20
Seat 5: WhiteIce0328 (770628 in chips)=20
NearlyRoyal: posts the ante 1000
VagColeSlaw: posts the ante 1000
Jivetoast: posts the ante 1000
JJin91: posts the ante 1000
WhiteIce0328: posts the ante 1000
VagColeSlaw: posts small blind 4000
Jivetoast: posts big blind 8000
*** HOLE CARDS ***
Dealt to JJin91 [3s 2s]
JJin91: folds=20
WhiteIce0328: folds=20
NearlyRoyal: raises 186036 to 194036 and is all-in
VagColeSlaw: folds=20
Jivetoast: folds=20
Uncalled bet (186036) returned to NearlyRoyal
NearlyRoyal collected 25000 from pot
*** SUMMARY ***
Total pot 25000 | Rake 0=20
Seat 1: NearlyRoyal (button) collected (25000)
Seat 2: VagColeSlaw (small blind) folded before Flop
Seat 3: Jivetoast (big blind) folded before Flop
Seat 4: JJin91 folded before Flop (didn't bet)
Seat 5: WhiteIce0328 folded before Flop (didn't bet)


*********** # 276 **************
PokerStars Hand #175484106475: Tournament #1701793695, $9.10+$0.90 USD =
Hold'em No Limit - Level XXVII (4000/8000) - 2017/09/24 20:23:00 ET
Table '1701793695 2' 6-max Seat #2 is the button
Seat 1: NearlyRoyal (211036 in chips)=20
Seat 2: VagColeSlaw (420309 in chips)=20
Seat 3: Jivetoast (143973 in chips)=20
Seat 4: JJin91 (1024230 in chips)=20
Seat 5: WhiteIce0328 (769628 in chips)=20
Seat 6: YourRobotDad (232832 in chips)=20
NearlyRoyal: posts the ante 1000
VagColeSlaw: posts the ante 1000
Jivetoast: posts the ante 1000
JJin91: posts the ante 1000
WhiteIce0328: posts the ante 1000
YourRobotDad: posts the ante 1000
Jivetoast: posts small blind 4000
JJin91: posts big blind 8000
*** HOLE CARDS ***
Dealt to JJin91 [9c Ad]
WhiteIce0328: folds=20
YourRobotDad: folds=20
NearlyRoyal: folds=20
VagColeSlaw: folds=20
Jivetoast: folds=20
Uncalled bet (4000) returned to JJin91
JJin91 collected 14000 from pot
JJin91: doesn't show hand=20
*** SUMMARY ***
Total pot 14000 | Rake 0=20
Seat 1: NearlyRoyal folded before Flop (didn't bet)
Seat 2: VagColeSlaw (button) folded before Flop (didn't bet)
Seat 3: Jivetoast (small blind) folded before Flop
Seat 4: JJin91 (big blind) collected (14000)
Seat 5: WhiteIce0328 folded before Flop (didn't bet)
Seat 6: YourRobotDad folded before Flop (didn't bet)


*********** # 277 **************
PokerStars Hand #175484106546: Tournament #1701793695, $9.10+$0.90 USD =
Hold'em No Limit - Level XXVII (4000/8000) - 2017/09/24 20:23:17 ET
Table '1701793695 2' 6-max Seat #3 is the button
Seat 1: NearlyRoyal (210036 in chips)=20
Seat 2: VagColeSlaw (419309 in chips)=20
Seat 3: Jivetoast (138973 in chips)=20
Seat 4: JJin91 (1033230 in chips)=20
Seat 5: WhiteIce0328 (768628 in chips)=20
Seat 6: YourRobotDad (231832 in chips)=20
NearlyRoyal: posts the ante 1000
VagColeSlaw: posts the ante 1000
Jivetoast: posts the ante 1000
JJin91: posts the ante 1000
WhiteIce0328: posts the ante 1000
YourRobotDad: posts the ante 1000
JJin91: posts small blind 4000
WhiteIce0328: posts big blind 8000
*** HOLE CARDS ***
Dealt to JJin91 [Js 2d]
YourRobotDad: folds=20
NearlyRoyal has timed out
NearlyRoyal: folds=20
NearlyRoyal is sitting out
VagColeSlaw: raises 8000 to 16000
Jivetoast: folds=20
JJin91: folds=20
WhiteIce0328: raises 24000 to 40000
VagColeSlaw: calls 24000
*** FLOP *** [Jd 7d 7c]
WhiteIce0328: bets 90000
VagColeSlaw: folds=20
Uncalled bet (90000) returned to WhiteIce0328
WhiteIce0328 collected 90000 from pot
WhiteIce0328: doesn't show hand=20
*** SUMMARY ***
Total pot 90000 | Rake 0=20
Board [Jd 7d 7c]
Seat 1: NearlyRoyal folded before Flop (didn't bet)
Seat 2: VagColeSlaw folded on the Flop
Seat 3: Jivetoast (button) folded before Flop (didn't bet)
Seat 4: JJin91 (small blind) folded before Flop
Seat 5: WhiteIce0328 (big blind) collected (90000)
Seat 6: YourRobotDad folded before Flop (didn't bet)


*********** # 278 **************
PokerStars Hand #175484106921: Tournament #1701793695, $9.10+$0.90 USD =
Hold'em No Limit - Level XXVIII (4500/9000) - 2017/09/24 20:24:39 ET
Table '1701793695 2' 6-max Seat #4 is the button
Seat 1: NearlyRoyal (209036 in chips) is sitting out
Seat 2: VagColeSlaw (378309 in chips)=20
Seat 3: Jivetoast (137973 in chips)=20
Seat 4: JJin91 (1028230 in chips)=20
Seat 5: WhiteIce0328 (817628 in chips)=20
Seat 6: YourRobotDad (230832 in chips)=20
NearlyRoyal: posts the ante 1125
VagColeSlaw: posts the ante 1125
Jivetoast: posts the ante 1125
JJin91: posts the ante 1125
WhiteIce0328: posts the ante 1125
YourRobotDad: posts the ante 1125
WhiteIce0328: posts small blind 4500
YourRobotDad: posts big blind 9000
*** HOLE CARDS ***
Dealt to JJin91 [Kc 2s]
NearlyRoyal: folds=20
VagColeSlaw: folds=20
Jivetoast: folds=20
JJin91: folds=20
NearlyRoyal has returned
WhiteIce0328: folds=20
Uncalled bet (4500) returned to YourRobotDad
YourRobotDad collected 15750 from pot
*** SUMMARY ***
Total pot 15750 | Rake 0=20
Seat 1: NearlyRoyal folded before Flop (didn't bet)
Seat 2: VagColeSlaw folded before Flop (didn't bet)
Seat 3: Jivetoast folded before Flop (didn't bet)
Seat 4: JJin91 (button) folded before Flop (didn't bet)
Seat 5: WhiteIce0328 (small blind) folded before Flop
Seat 6: YourRobotDad (big blind) collected (15750)


*********** # 279 **************
PokerStars Hand #175484107055: Tournament #1701793695, $9.10+$0.90 USD =
Hold'em No Limit - Level XXVIII (4500/9000) - 2017/09/24 20:25:07 ET
Table '1701793695 2' 6-max Seat #5 is the button
Seat 1: NearlyRoyal (207911 in chips)=20
Seat 2: VagColeSlaw (377184 in chips)=20
Seat 3: Jivetoast (136848 in chips)=20
Seat 4: JJin91 (1027105 in chips)=20
Seat 5: WhiteIce0328 (812003 in chips)=20
Seat 6: YourRobotDad (240957 in chips)=20
NearlyRoyal: posts the ante 1125
VagColeSlaw: posts the ante 1125
Jivetoast: posts the ante 1125
JJin91: posts the ante 1125
WhiteIce0328: posts the ante 1125
YourRobotDad: posts the ante 1125
YourRobotDad: posts small blind 4500
NearlyRoyal: posts big blind 9000
*** HOLE CARDS ***
Dealt to JJin91 [6d 2h]
VagColeSlaw: folds=20
Jivetoast: raises 126723 to 135723 and is all-in
JJin91: folds=20
WhiteIce0328: folds=20
YourRobotDad: folds=20
NearlyRoyal: folds=20
Uncalled bet (126723) returned to Jivetoast
Jivetoast collected 29250 from pot
Jivetoast: doesn't show hand=20
*** SUMMARY ***
Total pot 29250 | Rake 0=20
Seat 1: NearlyRoyal (big blind) folded before Flop
Seat 2: VagColeSlaw folded before Flop (didn't bet)
Seat 3: Jivetoast collected (29250)
Seat 4: JJin91 folded before Flop (didn't bet)
Seat 5: WhiteIce0328 (button) folded before Flop (didn't bet)
Seat 6: YourRobotDad (small blind) folded before Flop


*********** # 280 **************
PokerStars Hand #175484107247: Tournament #1701793695, $9.10+$0.90 USD =
Hold'em No Limit - Level XXVIII (4500/9000) - 2017/09/24 20:25:47 ET
Table '1701793695 2' 6-max Seat #6 is the button
Seat 1: NearlyRoyal (197786 in chips)=20
Seat 2: VagColeSlaw (376059 in chips)=20
Seat 3: Jivetoast (155973 in chips)=20
Seat 4: JJin91 (1025980 in chips)=20
Seat 5: WhiteIce0328 (810878 in chips)=20
Seat 6: YourRobotDad (235332 in chips)=20
NearlyRoyal: posts the ante 1125
VagColeSlaw: posts the ante 1125
Jivetoast: posts the ante 1125
JJin91: posts the ante 1125
WhiteIce0328: posts the ante 1125
YourRobotDad: posts the ante 1125
NearlyRoyal: posts small blind 4500
VagColeSlaw: posts big blind 9000
*** HOLE CARDS ***
Dealt to JJin91 [Jh Jd]
Jivetoast: folds=20
JJin91: raises 10530 to 19530
WhiteIce0328: folds=20
YourRobotDad: folds=20
NearlyRoyal: folds=20
VagColeSlaw: folds=20
Uncalled bet (10530) returned to JJin91
JJin91 collected 29250 from pot
JJin91: doesn't show hand=20
*** SUMMARY ***
Total pot 29250 | Rake 0=20
Seat 1: NearlyRoyal (small blind) folded before Flop
Seat 2: VagColeSlaw (big blind) folded before Flop
Seat 3: Jivetoast folded before Flop (didn't bet)
Seat 4: JJin91 collected (29250)
Seat 5: WhiteIce0328 folded before Flop (didn't bet)
Seat 6: YourRobotDad (button) folded before Flop (didn't bet)


*********** # 281 **************
PokerStars Hand #175484107508: Tournament #1701793695, $9.10+$0.90 USD =
Hold'em No Limit - Level XXVIII (4500/9000) - 2017/09/24 20:26:40 ET
Table '1701793695 2' 6-max Seat #1 is the button
Seat 1: NearlyRoyal (192161 in chips)=20
Seat 2: VagColeSlaw (365934 in chips)=20
Seat 3: Jivetoast (154848 in chips)=20
Seat 4: JJin91 (1045105 in chips)=20
Seat 5: WhiteIce0328 (809753 in chips)=20
Seat 6: YourRobotDad (234207 in chips)=20
NearlyRoyal: posts the ante 1125
VagColeSlaw: posts the ante 1125
Jivetoast: posts the ante 1125
JJin91: posts the ante 1125
WhiteIce0328: posts the ante 1125
YourRobotDad: posts the ante 1125
VagColeSlaw: posts small blind 4500
Jivetoast: posts big blind 9000
*** HOLE CARDS ***
Dealt to JJin91 [Th 6h]
JJin91: folds=20
WhiteIce0328: folds=20
YourRobotDad: folds=20
NearlyRoyal: folds=20
VagColeSlaw: calls 4500
Jivetoast: raises 144723 to 153723 and is all-in
VagColeSlaw: folds=20
Uncalled bet (144723) returned to Jivetoast
Jivetoast collected 24750 from pot
Jivetoast: doesn't show hand=20
*** SUMMARY ***
Total pot 24750 | Rake 0=20
Seat 1: NearlyRoyal (button) folded before Flop (didn't bet)
Seat 2: VagColeSlaw (small blind) folded before Flop
Seat 3: Jivetoast (big blind) collected (24750)
Seat 4: JJin91 folded before Flop (didn't bet)
Seat 5: WhiteIce0328 folded before Flop (didn't bet)
Seat 6: YourRobotDad folded before Flop (didn't bet)


*********** # 282 **************
PokerStars Hand #175484107636: Tournament #1701793695, $9.10+$0.90 USD =
Hold'em No Limit - Level XXVIII (4500/9000) - 2017/09/24 20:27:09 ET
Table '1701793695 2' 6-max Seat #2 is the button
Seat 1: NearlyRoyal (191036 in chips)=20
Seat 2: VagColeSlaw (355809 in chips)=20
Seat 3: Jivetoast (169473 in chips)=20
Seat 4: JJin91 (1043980 in chips)=20
Seat 5: WhiteIce0328 (808628 in chips)=20
Seat 6: YourRobotDad (233082 in chips)=20
NearlyRoyal: posts the ante 1125
VagColeSlaw: posts the ante 1125
Jivetoast: posts the ante 1125
JJin91: posts the ante 1125
WhiteIce0328: posts the ante 1125
YourRobotDad: posts the ante 1125
Jivetoast: posts small blind 4500
JJin91: posts big blind 9000
*** HOLE CARDS ***
Dealt to JJin91 [Tc 4d]
WhiteIce0328: folds=20
YourRobotDad: raises 9000 to 18000
NearlyRoyal: folds=20
VagColeSlaw: folds=20
Jivetoast: folds=20
JJin91: raises 43111 to 61111
YourRobotDad: folds=20
Uncalled bet (43111) returned to JJin91
JJin91 collected 47250 from pot
JJin91: doesn't show hand=20
*** SUMMARY ***
Total pot 47250 | Rake 0=20
Seat 1: NearlyRoyal folded before Flop (didn't bet)
Seat 2: VagColeSlaw (button) folded before Flop (didn't bet)
Seat 3: Jivetoast (small blind) folded before Flop
Seat 4: JJin91 (big blind) collected (47250)
Seat 5: WhiteIce0328 folded before Flop (didn't bet)
Seat 6: YourRobotDad folded before Flop


*********** # 283 **************
PokerStars Hand #175484107967: Tournament #1701793695, $9.10+$0.90 USD =
Hold'em No Limit - Level XXVIII (4500/9000) - 2017/09/24 20:28:17 ET
Table '1701793695 2' 6-max Seat #3 is the button
Seat 1: NearlyRoyal (189911 in chips)=20
Seat 2: VagColeSlaw (354684 in chips)=20
Seat 3: Jivetoast (163848 in chips)=20
Seat 4: JJin91 (1072105 in chips)=20
Seat 5: WhiteIce0328 (807503 in chips)=20
Seat 6: YourRobotDad (213957 in chips)=20
NearlyRoyal: posts the ante 1125
VagColeSlaw: posts the ante 1125
Jivetoast: posts the ante 1125
JJin91: posts the ante 1125
WhiteIce0328: posts the ante 1125
YourRobotDad: posts the ante 1125
JJin91: posts small blind 4500
WhiteIce0328: posts big blind 9000
*** HOLE CARDS ***
Dealt to JJin91 [4h 8s]
YourRobotDad: folds=20
NearlyRoyal: folds=20
VagColeSlaw: folds=20
Jivetoast: folds=20
JJin91: folds=20
Uncalled bet (4500) returned to WhiteIce0328
WhiteIce0328 collected 15750 from pot
WhiteIce0328: doesn't show hand=20
*** SUMMARY ***
Total pot 15750 | Rake 0=20
Seat 1: NearlyRoyal folded before Flop (didn't bet)
Seat 2: VagColeSlaw folded before Flop (didn't bet)
Seat 3: Jivetoast (button) folded before Flop (didn't bet)
Seat 4: JJin91 (small blind) folded before Flop
Seat 5: WhiteIce0328 (big blind) collected (15750)
Seat 6: YourRobotDad folded before Flop (didn't bet)


*********** # 284 **************
PokerStars Hand #175484108169: Tournament #1701793695, $9.10+$0.90 USD =
Hold'em No Limit - Level XXVIII (4500/9000) - 2017/09/24 20:29:00 ET
Table '1701793695 2' 6-max Seat #4 is the button
Seat 1: NearlyRoyal (188786 in chips)=20
Seat 2: VagColeSlaw (353559 in chips)=20
Seat 3: Jivetoast (162723 in chips)=20
Seat 4: JJin91 (1066480 in chips)=20
Seat 5: WhiteIce0328 (817628 in chips)=20
Seat 6: YourRobotDad (212832 in chips)=20
NearlyRoyal: posts the ante 1125
VagColeSlaw: posts the ante 1125
Jivetoast: posts the ante 1125
JJin91: posts the ante 1125
WhiteIce0328: posts the ante 1125
YourRobotDad: posts the ante 1125
WhiteIce0328: posts small blind 4500
YourRobotDad: posts big blind 9000
*** HOLE CARDS ***
Dealt to JJin91 [5h 6h]
NearlyRoyal: folds=20
VagColeSlaw: folds=20
Jivetoast: folds=20
JJin91: folds=20
WhiteIce0328: folds=20
Uncalled bet (4500) returned to YourRobotDad
YourRobotDad collected 15750 from pot
*** SUMMARY ***
Total pot 15750 | Rake 0=20
Seat 1: NearlyRoyal folded before Flop (didn't bet)
Seat 2: VagColeSlaw folded before Flop (didn't bet)
Seat 3: Jivetoast folded before Flop (didn't bet)
Seat 4: JJin91 (button) folded before Flop (didn't bet)
Seat 5: WhiteIce0328 (small blind) folded before Flop
Seat 6: YourRobotDad (big blind) collected (15750)


*********** # 285 **************
PokerStars Hand #175484108342: Tournament #1701793695, $9.10+$0.90 USD =
Hold'em No Limit - Level XXVIII (4500/9000) - 2017/09/24 20:29:35 ET
Table '1701793695 2' 6-max Seat #5 is the button
Seat 2: VagColeSlaw (352434 in chips)=20
Seat 3: Jivetoast (161598 in chips)=20
Seat 4: JJin91 (1065355 in chips)=20
Seat 5: WhiteIce0328 (812003 in chips)=20
Seat 6: YourRobotDad (222957 in chips)=20
VagColeSlaw: posts the ante 1125
Jivetoast: posts the ante 1125
JJin91: posts the ante 1125
WhiteIce0328: posts the ante 1125
YourRobotDad: posts the ante 1125
YourRobotDad: posts small blind 4500
VagColeSlaw: posts big blind 9000
*** HOLE CARDS ***
Dealt to JJin91 [6h 9h]
Jivetoast: folds=20
JJin91: folds=20
WhiteIce0328: folds=20
YourRobotDad: raises 18000 to 27000
VagColeSlaw: calls 18000
*** FLOP *** [Jc 4d 6s]
YourRobotDad: bets 36000
VagColeSlaw: folds=20
Uncalled bet (36000) returned to YourRobotDad
YourRobotDad collected 59625 from pot
*** SUMMARY ***
Total pot 59625 | Rake 0=20
Board [Jc 4d 6s]
Seat 2: VagColeSlaw (big blind) folded on the Flop
Seat 3: Jivetoast folded before Flop (didn't bet)
Seat 4: JJin91 folded before Flop (didn't bet)
Seat 5: WhiteIce0328 (button) folded before Flop (didn't bet)
Seat 6: YourRobotDad (small blind) collected (59625)


*********** # 286 **************
PokerStars Hand #175484108526: Tournament #1701793695, $9.10+$0.90 USD =
Hold'em No Limit - Level XXVIII (4500/9000) - 2017/09/24 20:30:17 ET
Table '1701793695 2' 6-max Seat #6 is the button
Seat 2: VagColeSlaw (324309 in chips)=20
Seat 3: Jivetoast (160473 in chips)=20
Seat 4: JJin91 (1064230 in chips)=20
Seat 5: WhiteIce0328 (810878 in chips)=20
Seat 6: YourRobotDad (254457 in chips)=20
VagColeSlaw: posts the ante 1125
Jivetoast: posts the ante 1125
JJin91: posts the ante 1125
WhiteIce0328: posts the ante 1125
YourRobotDad: posts the ante 1125
VagColeSlaw: posts small blind 4500
Jivetoast: posts big blind 9000
*** HOLE CARDS ***
Dealt to JJin91 [Tc Qh]
JJin91: folds=20
WhiteIce0328: folds=20
YourRobotDad: folds=20
VagColeSlaw: calls 4500
Jivetoast: raises 18000 to 27000
VagColeSlaw: calls 18000
*** FLOP *** [4s 6s 7d]
VagColeSlaw: checks=20
Jivetoast: bets 132348 and is all-in
VagColeSlaw: folds=20
Uncalled bet (132348) returned to Jivetoast
Jivetoast collected 59625 from pot
Jivetoast: doesn't show hand=20
*** SUMMARY ***
Total pot 59625 | Rake 0=20
Board [4s 6s 7d]
Seat 2: VagColeSlaw (small blind) folded on the Flop
Seat 3: Jivetoast (big blind) collected (59625)
Seat 4: JJin91 folded before Flop (didn't bet)
Seat 5: WhiteIce0328 folded before Flop (didn't bet)
Seat 6: YourRobotDad (button) folded before Flop (didn't bet)


*********** # 287 **************
PokerStars Hand #175484108718: Tournament #1701793695, $9.10+$0.90 USD =
Hold'em No Limit - Level XXVIII (4500/9000) - 2017/09/24 20:30:56 ET
Table '1701793695 2' 6-max Seat #2 is the button
Seat 2: VagColeSlaw (296184 in chips)=20
Seat 3: Jivetoast (191973 in chips)=20
Seat 4: JJin91 (1063105 in chips)=20
Seat 5: WhiteIce0328 (809753 in chips)=20
Seat 6: YourRobotDad (253332 in chips)=20
VagColeSlaw: posts the ante 1125
Jivetoast: posts the ante 1125
JJin91: posts the ante 1125
WhiteIce0328: posts the ante 1125
YourRobotDad: posts the ante 1125
Jivetoast: posts small blind 4500
JJin91: posts big blind 9000
*** HOLE CARDS ***
Dealt to JJin91 [4s 3c]
WhiteIce0328: folds=20
YourRobotDad: raises 9000 to 18000
VagColeSlaw: folds=20
Jivetoast: folds=20
JJin91: folds=20
Uncalled bet (9000) returned to YourRobotDad
YourRobotDad collected 28125 from pot
YourRobotDad: shows [Ah Kd] (high card Ace)
*** SUMMARY ***
Total pot 28125 | Rake 0=20
Seat 2: VagColeSlaw (button) folded before Flop (didn't bet)
Seat 3: Jivetoast (small blind) folded before Flop
Seat 4: JJin91 (big blind) folded before Flop
Seat 5: WhiteIce0328 folded before Flop (didn't bet)
Seat 6: YourRobotDad collected (28125)


*********** # 288 **************
PokerStars Hand #175484108893: Tournament #1701793695, $9.10+$0.90 USD =
Hold'em No Limit - Level XXVIII (4500/9000) - 2017/09/24 20:31:34 ET
Table '1701793695 2' 6-max Seat #3 is the button
Seat 2: VagColeSlaw (295059 in chips)=20
Seat 3: Jivetoast (186348 in chips)=20
Seat 4: JJin91 (1052980 in chips)=20
Seat 5: WhiteIce0328 (808628 in chips)=20
Seat 6: YourRobotDad (271332 in chips)=20
VagColeSlaw: posts the ante 1125
Jivetoast: posts the ante 1125
JJin91: posts the ante 1125
WhiteIce0328: posts the ante 1125
YourRobotDad: posts the ante 1125
JJin91: posts small blind 4500
WhiteIce0328: posts big blind 9000
*** HOLE CARDS ***
Dealt to JJin91 [Qd 2s]
YourRobotDad: folds=20
VagColeSlaw: folds=20
Jivetoast: folds=20
JJin91: calls 4500
WhiteIce0328: checks=20
*** FLOP *** [5d 7d 7h]
JJin91: checks=20
WhiteIce0328: bets 11813
JJin91: folds=20
Uncalled bet (11813) returned to WhiteIce0328
WhiteIce0328 collected 23625 from pot
WhiteIce0328: doesn't show hand=20
*** SUMMARY ***
Total pot 23625 | Rake 0=20
Board [5d 7d 7h]
Seat 2: VagColeSlaw folded before Flop (didn't bet)
Seat 3: Jivetoast (button) folded before Flop (didn't bet)
Seat 4: JJin91 (small blind) folded on the Flop
Seat 5: WhiteIce0328 (big blind) collected (23625)
Seat 6: YourRobotDad folded before Flop (didn't bet)


*********** # 289 **************
PokerStars Hand #175484109153: Tournament #1701793695, $9.10+$0.90 USD =
Hold'em No Limit - Level XXIX (5000/10000) - 2017/09/24 20:32:23 ET
Table '1701793695 2' 6-max Seat #4 is the button
Seat 2: VagColeSlaw (293934 in chips)=20
Seat 3: Jivetoast (185223 in chips)=20
Seat 4: JJin91 (1042855 in chips)=20
Seat 5: WhiteIce0328 (822128 in chips)=20
Seat 6: YourRobotDad (270207 in chips)=20
VagColeSlaw: posts the ante 1250
Jivetoast: posts the ante 1250
JJin91: posts the ante 1250
WhiteIce0328: posts the ante 1250
YourRobotDad: posts the ante 1250
WhiteIce0328: posts small blind 5000
YourRobotDad: posts big blind 10000
*** HOLE CARDS ***
Dealt to JJin91 [4h Qs]
VagColeSlaw: folds=20
Jivetoast: raises 173973 to 183973 and is all-in
JJin91: folds=20
WhiteIce0328: folds=20
YourRobotDad: folds=20
Uncalled bet (173973) returned to Jivetoast
Jivetoast collected 31250 from pot
Jivetoast: doesn't show hand=20
*** SUMMARY ***
Total pot 31250 | Rake 0=20
Seat 2: VagColeSlaw folded before Flop (didn't bet)
Seat 3: Jivetoast collected (31250)
Seat 4: JJin91 (button) folded before Flop (didn't bet)
Seat 5: WhiteIce0328 (small blind) folded before Flop
Seat 6: YourRobotDad (big blind) folded before Flop


*********** # 290 **************
PokerStars Hand #175484109332: Tournament #1701793695, $9.10+$0.90 USD =
Hold'em No Limit - Level XXIX (5000/10000) - 2017/09/24 20:33:02 ET
Table '1701793695 2' 6-max Seat #5 is the button
Seat 2: VagColeSlaw (292684 in chips)=20
Seat 3: Jivetoast (205223 in chips)=20
Seat 4: JJin91 (1041605 in chips)=20
Seat 5: WhiteIce0328 (815878 in chips)=20
Seat 6: YourRobotDad (258957 in chips)=20
VagColeSlaw: posts the ante 1250
Jivetoast: posts the ante 1250
JJin91: posts the ante 1250
WhiteIce0328: posts the ante 1250
YourRobotDad: posts the ante 1250
YourRobotDad: posts small blind 5000
VagColeSlaw: posts big blind 10000
*** HOLE CARDS ***
Dealt to JJin91 [Jh 3c]
Jivetoast: folds=20
JJin91: folds=20
WhiteIce0328: raises 20000 to 30000
YourRobotDad: folds=20
VagColeSlaw: folds=20
Uncalled bet (20000) returned to WhiteIce0328
WhiteIce0328 collected 31250 from pot
WhiteIce0328: doesn't show hand=20
*** SUMMARY ***
Total pot 31250 | Rake 0=20
Seat 2: VagColeSlaw (big blind) folded before Flop
Seat 3: Jivetoast folded before Flop (didn't bet)
Seat 4: JJin91 folded before Flop (didn't bet)
Seat 5: WhiteIce0328 (button) collected (31250)
Seat 6: YourRobotDad (small blind) folded before Flop


*********** # 291 **************
PokerStars Hand #175484109549: Tournament #1701793695, $9.10+$0.90 USD =
Hold'em No Limit - Level XXIX (5000/10000) - 2017/09/24 20:33:39 ET
Table '1701793695 2' 6-max Seat #6 is the button
Seat 2: VagColeSlaw (281434 in chips)=20
Seat 3: Jivetoast (203973 in chips)=20
Seat 4: JJin91 (1040355 in chips)=20
Seat 5: WhiteIce0328 (835878 in chips)=20
Seat 6: YourRobotDad (252707 in chips)=20
VagColeSlaw: posts the ante 1250
Jivetoast: posts the ante 1250
JJin91: posts the ante 1250
WhiteIce0328: posts the ante 1250
YourRobotDad: posts the ante 1250
VagColeSlaw: posts small blind 5000
Jivetoast: posts big blind 10000
*** HOLE CARDS ***
Dealt to JJin91 [2d 4s]
JJin91: folds=20
WhiteIce0328: folds=20
YourRobotDad: folds=20
VagColeSlaw: folds=20
Uncalled bet (5000) returned to Jivetoast
Jivetoast collected 16250 from pot
Jivetoast: doesn't show hand=20
*** SUMMARY ***
Total pot 16250 | Rake 0=20
Seat 2: VagColeSlaw (small blind) folded before Flop
Seat 3: Jivetoast (big blind) collected (16250)
Seat 4: JJin91 folded before Flop (didn't bet)
Seat 5: WhiteIce0328 folded before Flop (didn't bet)
Seat 6: YourRobotDad (button) folded before Flop (didn't bet)


*********** # 292 **************
PokerStars Hand #175484109732: Tournament #1701793695, $9.10+$0.90 USD =
Hold'em No Limit - Level XXIX (5000/10000) - 2017/09/24 20:34:13 ET
Table '1701793695 2' 6-max Seat #2 is the button
Seat 2: VagColeSlaw (275184 in chips)=20
Seat 3: Jivetoast (213973 in chips)=20
Seat 4: JJin91 (1039105 in chips)=20
Seat 5: WhiteIce0328 (834628 in chips)=20
Seat 6: YourRobotDad (251457 in chips)=20
VagColeSlaw: posts the ante 1250
Jivetoast: posts the ante 1250
JJin91: posts the ante 1250
WhiteIce0328: posts the ante 1250
YourRobotDad: posts the ante 1250
Jivetoast: posts small blind 5000
JJin91: posts big blind 10000
*** HOLE CARDS ***
Dealt to JJin91 [Th 3c]
WhiteIce0328: folds=20
YourRobotDad: folds=20
VagColeSlaw: folds=20
Jivetoast: raises 10000 to 20000
JJin91: calls 10000
*** FLOP *** [5s Kd Ks]
Jivetoast: bets 23125
JJin91: folds=20
Uncalled bet (23125) returned to Jivetoast
Jivetoast collected 46250 from pot
Jivetoast: doesn't show hand=20
*** SUMMARY ***
Total pot 46250 | Rake 0=20
Board [5s Kd Ks]
Seat 2: VagColeSlaw (button) folded before Flop (didn't bet)
Seat 3: Jivetoast (small blind) collected (46250)
Seat 4: JJin91 (big blind) folded on the Flop
Seat 5: WhiteIce0328 folded before Flop (didn't bet)
Seat 6: YourRobotDad folded before Flop (didn't bet)


*********** # 293 **************
PokerStars Hand #175484109999: Tournament #1701793695, $9.10+$0.90 USD =
Hold'em No Limit - Level XXIX (5000/10000) - 2017/09/24 20:35:03 ET
Table '1701793695 2' 6-max Seat #3 is the button
Seat 2: VagColeSlaw (273934 in chips)=20
Seat 3: Jivetoast (238973 in chips)=20
Seat 4: JJin91 (1017855 in chips)=20
Seat 5: WhiteIce0328 (833378 in chips)=20
Seat 6: YourRobotDad (250207 in chips)=20
VagColeSlaw: posts the ante 1250
Jivetoast: posts the ante 1250
JJin91: posts the ante 1250
WhiteIce0328: posts the ante 1250
YourRobotDad: posts the ante 1250
JJin91: posts small blind 5000
WhiteIce0328: posts big blind 10000
*** HOLE CARDS ***
Dealt to JJin91 [Td 4h]
YourRobotDad: folds=20
VagColeSlaw: folds=20
Jivetoast: folds=20
JJin91: folds=20
Uncalled bet (5000) returned to WhiteIce0328
WhiteIce0328 collected 16250 from pot
WhiteIce0328: doesn't show hand=20
*** SUMMARY ***
Total pot 16250 | Rake 0=20
Seat 2: VagColeSlaw folded before Flop (didn't bet)
Seat 3: Jivetoast (button) folded before Flop (didn't bet)
Seat 4: JJin91 (small blind) folded before Flop
Seat 5: WhiteIce0328 (big blind) collected (16250)
Seat 6: YourRobotDad folded before Flop (didn't bet)


*********** # 294 **************
PokerStars Hand #175484432666: Tournament #1701793695, $9.10+$0.90 USD =
Hold'em No Limit - Level XXIX (5000/10000) - 2017/09/24 20:35:14 ET
Table '1701793695 2' 6-max Seat #4 is the button
Seat 2: VagColeSlaw (272684 in chips)=20
Seat 3: Jivetoast (237723 in chips)=20
Seat 4: JJin91 (1011605 in chips)=20
Seat 5: WhiteIce0328 (843378 in chips)=20
Seat 6: YourRobotDad (248957 in chips)=20
VagColeSlaw: posts the ante 1250
Jivetoast: posts the ante 1250
JJin91: posts the ante 1250
WhiteIce0328: posts the ante 1250
YourRobotDad: posts the ante 1250
WhiteIce0328: posts small blind 5000
YourRobotDad: posts big blind 10000
*** HOLE CARDS ***
Dealt to JJin91 [3h 8h]
VagColeSlaw: folds=20
Jivetoast: raises 20000 to 30000
JJin91: folds=20
WhiteIce0328: folds=20
YourRobotDad: folds=20
Uncalled bet (20000) returned to Jivetoast
Jivetoast collected 31250 from pot
Jivetoast: doesn't show hand=20
*** SUMMARY ***
Total pot 31250 | Rake 0=20
Seat 2: VagColeSlaw folded before Flop (didn't bet)
Seat 3: Jivetoast collected (31250)
Seat 4: JJin91 (button) folded before Flop (didn't bet)
Seat 5: WhiteIce0328 (small blind) folded before Flop
Seat 6: YourRobotDad (big blind) folded before Flop


*********** # 295 **************
PokerStars Hand #175484432790: Tournament #1701793695, $9.10+$0.90 USD =
Hold'em No Limit - Level XXIX (5000/10000) - 2017/09/24 20:35:36 ET
Table '1701793695 2' 6-max Seat #5 is the button
Seat 2: VagColeSlaw (271434 in chips)=20
Seat 3: Jivetoast (257723 in chips)=20
Seat 4: JJin91 (1010355 in chips)=20
Seat 5: WhiteIce0328 (837128 in chips)=20
Seat 6: YourRobotDad (237707 in chips)=20
VagColeSlaw: posts the ante 1250
Jivetoast: posts the ante 1250
JJin91: posts the ante 1250
WhiteIce0328: posts the ante 1250
YourRobotDad: posts the ante 1250
YourRobotDad: posts small blind 5000
VagColeSlaw: posts big blind 10000
*** HOLE CARDS ***
Dealt to JJin91 [2h 7d]
Jivetoast: folds=20
JJin91: folds=20
WhiteIce0328: raises 20000 to 30000
YourRobotDad: folds=20
VagColeSlaw: folds=20
Uncalled bet (20000) returned to WhiteIce0328
WhiteIce0328 collected 31250 from pot
WhiteIce0328: doesn't show hand=20
*** SUMMARY ***
Total pot 31250 | Rake 0=20
Seat 2: VagColeSlaw (big blind) folded before Flop
Seat 3: Jivetoast folded before Flop (didn't bet)
Seat 4: JJin91 folded before Flop (didn't bet)
Seat 5: WhiteIce0328 (button) collected (31250)
Seat 6: YourRobotDad (small blind) folded before Flop


*********** # 296 **************
PokerStars Hand #175484432994: Tournament #1701793695, $9.10+$0.90 USD =
Hold'em No Limit - Level XXIX (5000/10000) - 2017/09/24 20:36:12 ET
Table '1701793695 2' 6-max Seat #6 is the button
Seat 2: VagColeSlaw (260184 in chips)=20
Seat 3: Jivetoast (256473 in chips)=20
Seat 4: JJin91 (1009105 in chips)=20
Seat 5: WhiteIce0328 (857128 in chips)=20
Seat 6: YourRobotDad (231457 in chips)=20
VagColeSlaw: posts the ante 1250
Jivetoast: posts the ante 1250
JJin91: posts the ante 1250
WhiteIce0328: posts the ante 1250
YourRobotDad: posts the ante 1250
VagColeSlaw: posts small blind 5000
Jivetoast: posts big blind 10000
*** HOLE CARDS ***
Dealt to JJin91 [As Js]
JJin91: raises 11700 to 21700
WhiteIce0328: folds=20
YourRobotDad: calls 21700
VagColeSlaw: folds=20
Jivetoast: calls 11700
*** FLOP *** [2d Qc Ts]
Jivetoast: checks=20
JJin91: bets 38939
YourRobotDad: raises 38939 to 77878
Jivetoast: folds=20
JJin91: calls 38939
*** TURN *** [2d Qc Ts] [Qh]
JJin91: checks=20
YourRobotDad: bets 130629 and is all-in
JJin91: folds=20
Uncalled bet (130629) returned to YourRobotDad
YourRobotDad collected 232106 from pot
*** SUMMARY ***
Total pot 232106 | Rake 0=20
Board [2d Qc Ts Qh]
Seat 2: VagColeSlaw (small blind) folded before Flop
Seat 3: Jivetoast (big blind) folded on the Flop
Seat 4: JJin91 folded on the Turn
Seat 5: WhiteIce0328 folded before Flop (didn't bet)
Seat 6: YourRobotDad (button) collected (232106)


*********** # 297 **************
PokerStars Hand #175484433430: Tournament #1701793695, $9.10+$0.90 USD =
Hold'em No Limit - Level XXIX (5000/10000) - 2017/09/24 20:37:35 ET
Table '1701793695 2' 6-max Seat #2 is the button
Seat 1: j2157 (198925 in chips)=20
Seat 2: VagColeSlaw (253934 in chips)=20
Seat 3: Jivetoast (233523 in chips)=20
Seat 4: JJin91 (908277 in chips)=20
Seat 5: WhiteIce0328 (855878 in chips)=20
Seat 6: YourRobotDad (362735 in chips)=20
j2157: posts the ante 1250
VagColeSlaw: posts the ante 1250
Jivetoast: posts the ante 1250
JJin91: posts the ante 1250
WhiteIce0328: posts the ante 1250
YourRobotDad: posts the ante 1250
Jivetoast: posts small blind 5000
JJin91: posts big blind 10000
*** HOLE CARDS ***
Dealt to JJin91 [4d Jh]
WhiteIce0328: raises 20000 to 30000
YourRobotDad: folds=20
j2157: folds=20
VagColeSlaw: folds=20
Jivetoast: folds=20
JJin91: folds=20
Uncalled bet (20000) returned to WhiteIce0328
WhiteIce0328 collected 32500 from pot
WhiteIce0328: doesn't show hand=20
*** SUMMARY ***
Total pot 32500 | Rake 0=20
Seat 1: j2157 folded before Flop (didn't bet)
Seat 2: VagColeSlaw (button) folded before Flop (didn't bet)
Seat 3: Jivetoast (small blind) folded before Flop
Seat 4: JJin91 (big blind) folded before Flop
Seat 5: WhiteIce0328 collected (32500)
Seat 6: YourRobotDad folded before Flop (didn't bet)


*********** # 298 **************
PokerStars Hand #175484433581: Tournament #1701793695, $9.10+$0.90 USD =
Hold'em No Limit - Level XXIX (5000/10000) - 2017/09/24 20:38:05 ET
Table '1701793695 2' 6-max Seat #3 is the button
Seat 1: j2157 (197675 in chips)=20
Seat 2: VagColeSlaw (252684 in chips)=20
Seat 3: Jivetoast (227273 in chips)=20
Seat 4: JJin91 (897027 in chips)=20
Seat 5: WhiteIce0328 (877128 in chips)=20
Seat 6: YourRobotDad (361485 in chips)=20
j2157: posts the ante 1250
VagColeSlaw: posts the ante 1250
Jivetoast: posts the ante 1250
JJin91: posts the ante 1250
WhiteIce0328: posts the ante 1250
YourRobotDad: posts the ante 1250
JJin91: posts small blind 5000
WhiteIce0328: posts big blind 10000
*** HOLE CARDS ***
Dealt to JJin91 [6s 4h]
YourRobotDad: folds=20
j2157: folds=20
VagColeSlaw: raises 10000 to 20000
Jivetoast: folds=20
JJin91: folds=20
WhiteIce0328: calls 10000
*** FLOP *** [4s Ac Ks]
WhiteIce0328: checks=20
VagColeSlaw: bets 30000
WhiteIce0328: calls 30000
*** TURN *** [4s Ac Ks] [9s]
WhiteIce0328: checks=20
VagColeSlaw: checks=20
*** RIVER *** [4s Ac Ks 9s] [Qh]
WhiteIce0328: bets 112500
VagColeSlaw: folds=20
Uncalled bet (112500) returned to WhiteIce0328
WhiteIce0328 collected 112500 from pot
WhiteIce0328: doesn't show hand=20
*** SUMMARY ***
Total pot 112500 | Rake 0=20
Board [4s Ac Ks 9s Qh]
Seat 1: j2157 folded before Flop (didn't bet)
Seat 2: VagColeSlaw folded on the River
Seat 3: Jivetoast (button) folded before Flop (didn't bet)
Seat 4: JJin91 (small blind) folded before Flop
Seat 5: WhiteIce0328 (big blind) collected (112500)
Seat 6: YourRobotDad folded before Flop (didn't bet)


*********** # 299 **************
PokerStars Hand #175484433777: Tournament #1701793695, $9.10+$0.90 USD =
Hold'em No Limit - Level XXIX (5000/10000) - 2017/09/24 20:38:46 ET
Table '1701793695 2' 6-max Seat #4 is the button
Seat 1: j2157 (196425 in chips)=20
Seat 2: VagColeSlaw (201434 in chips)=20
Seat 3: Jivetoast (226023 in chips)=20
Seat 4: JJin91 (890777 in chips)=20
Seat 5: WhiteIce0328 (938378 in chips)=20
Seat 6: YourRobotDad (360235 in chips)=20
j2157: posts the ante 1250
VagColeSlaw: posts the ante 1250
Jivetoast: posts the ante 1250
JJin91: posts the ante 1250
WhiteIce0328: posts the ante 1250
YourRobotDad: posts the ante 1250
WhiteIce0328: posts small blind 5000
YourRobotDad: posts big blind 10000
*** HOLE CARDS ***
Dealt to JJin91 [Jh Qs]
j2157: folds=20
VagColeSlaw: folds=20
Jivetoast: folds=20
JJin91: raises 11700 to 21700
WhiteIce0328: folds=20
YourRobotDad: calls 11700
*** FLOP *** [8h 7c 2c]
YourRobotDad: checks=20
JJin91: checks=20
*** TURN *** [8h 7c 2c] [As]
YourRobotDad: bets 20000
JJin91: calls 20000
*** RIVER *** [8h 7c 2c As] [Th]
YourRobotDad: bets 30000
JJin91: folds=20
Uncalled bet (30000) returned to YourRobotDad
YourRobotDad collected 95900 from pot
*** SUMMARY ***
Total pot 95900 | Rake 0=20
Board [8h 7c 2c As Th]
Seat 1: j2157 folded before Flop (didn't bet)
Seat 2: VagColeSlaw folded before Flop (didn't bet)
Seat 3: Jivetoast folded before Flop (didn't bet)
Seat 4: JJin91 (button) folded on the River
Seat 5: WhiteIce0328 (small blind) folded before Flop
Seat 6: YourRobotDad (big blind) collected (95900)


*********** # 300 **************
PokerStars Hand #175484434167: Tournament #1701793695, $9.10+$0.90 USD =
Hold'em No Limit - Level XXX (6000/12000) - 2017/09/24 20:40:01 ET
Table '1701793695 2' 6-max Seat #5 is the button
Seat 1: j2157 (195175 in chips)=20
Seat 2: VagColeSlaw (200184 in chips)=20
Seat 3: Jivetoast (224773 in chips)=20
Seat 4: JJin91 (847827 in chips)=20
Seat 5: WhiteIce0328 (932128 in chips)=20
Seat 6: YourRobotDad (413185 in chips)=20
j2157: posts the ante 1500
VagColeSlaw: posts the ante 1500
Jivetoast: posts the ante 1500
JJin91: posts the ante 1500
WhiteIce0328: posts the ante 1500
YourRobotDad: posts the ante 1500
YourRobotDad: posts small blind 6000
j2157: posts big blind 12000
*** HOLE CARDS ***
Dealt to JJin91 [6s Th]
VagColeSlaw: raises 12000 to 24000
Jivetoast: folds=20
JJin91: folds=20
WhiteIce0328: folds=20
YourRobotDad: folds=20
j2157: calls 12000
*** FLOP *** [5d 8c Qh]
j2157: checks=20
VagColeSlaw: bets 24000
j2157: calls 24000
*** TURN *** [5d 8c Qh] [Kc]
j2157: checks=20
VagColeSlaw: bets 48000
j2157: folds=20
Uncalled bet (48000) returned to VagColeSlaw
VagColeSlaw collected 111000 from pot
VagColeSlaw: doesn't show hand=20
*** SUMMARY ***
Total pot 111000 | Rake 0=20
Board [5d 8c Qh Kc]
Seat 1: j2157 (big blind) folded on the Turn
Seat 2: VagColeSlaw collected (111000)
Seat 3: Jivetoast folded before Flop (didn't bet)
Seat 4: JJin91 folded before Flop (didn't bet)
Seat 5: WhiteIce0328 (button) folded before Flop (didn't bet)
Seat 6: YourRobotDad (small blind) folded before Flop


*********** # 301 **************
PokerStars Hand #175484434534: Tournament #1701793695, $9.10+$0.90 USD =
Hold'em No Limit - Level XXX (6000/12000) - 2017/09/24 20:41:10 ET
Table '1701793695 2' 6-max Seat #6 is the button
Seat 1: j2157 (145675 in chips)=20
Seat 2: VagColeSlaw (261684 in chips)=20
Seat 3: Jivetoast (223273 in chips)=20
Seat 4: JJin91 (846327 in chips)=20
Seat 5: WhiteIce0328 (930628 in chips)=20
Seat 6: YourRobotDad (405685 in chips)=20
j2157: posts the ante 1500
VagColeSlaw: posts the ante 1500
Jivetoast: posts the ante 1500
JJin91: posts the ante 1500
WhiteIce0328: posts the ante 1500
YourRobotDad: posts the ante 1500
j2157: posts small blind 6000
VagColeSlaw: posts big blind 12000
*** HOLE CARDS ***
Dealt to JJin91 [5s Td]
Jivetoast: raises 24000 to 36000
JJin91: folds=20
WhiteIce0328: folds=20
YourRobotDad: folds=20
j2157: calls 30000
VagColeSlaw: folds=20
*** FLOP *** [6d 3d 2c]
j2157: checks=20
Jivetoast: bets 46500
j2157: folds=20
Uncalled bet (46500) returned to Jivetoast
Jivetoast collected 93000 from pot
Jivetoast: doesn't show hand=20
*** SUMMARY ***
Total pot 93000 | Rake 0=20
Board [6d 3d 2c]
Seat 1: j2157 (small blind) folded on the Flop
Seat 2: VagColeSlaw (big blind) folded before Flop
Seat 3: Jivetoast collected (93000)
Seat 4: JJin91 folded before Flop (didn't bet)
Seat 5: WhiteIce0328 folded before Flop (didn't bet)
Seat 6: YourRobotDad (button) folded before Flop (didn't bet)


*********** # 302 **************
PokerStars Hand #175484434703: Tournament #1701793695, $9.10+$0.90 USD =
Hold'em No Limit - Level XXX (6000/12000) - 2017/09/24 20:41:42 ET
Table '1701793695 2' 6-max Seat #1 is the button
Seat 1: j2157 (108175 in chips)=20
Seat 2: VagColeSlaw (248184 in chips)=20
Seat 3: Jivetoast (278773 in chips)=20
Seat 4: JJin91 (844827 in chips)=20
Seat 5: WhiteIce0328 (929128 in chips)=20
Seat 6: YourRobotDad (404185 in chips)=20
j2157: posts the ante 1500
VagColeSlaw: posts the ante 1500
Jivetoast: posts the ante 1500
JJin91: posts the ante 1500
WhiteIce0328: posts the ante 1500
YourRobotDad: posts the ante 1500
VagColeSlaw: posts small blind 6000
Jivetoast: posts big blind 12000
*** HOLE CARDS ***
Dealt to JJin91 [Qd 9h]
JJin91: folds=20
WhiteIce0328: folds=20
YourRobotDad: raises 24000 to 36000
j2157: folds=20
VagColeSlaw: folds=20
Jivetoast: folds=20
Uncalled bet (24000) returned to YourRobotDad
YourRobotDad collected 39000 from pot
*** SUMMARY ***
Total pot 39000 | Rake 0=20
Seat 1: j2157 (button) folded before Flop (didn't bet)
Seat 2: VagColeSlaw (small blind) folded before Flop
Seat 3: Jivetoast (big blind) folded before Flop
Seat 4: JJin91 folded before Flop (didn't bet)
Seat 5: WhiteIce0328 folded before Flop (didn't bet)
Seat 6: YourRobotDad collected (39000)


*********** # 303 **************
PokerStars Hand #175484434990: Tournament #1701793695, $9.10+$0.90 USD =
Hold'em No Limit - Level XXX (6000/12000) - 2017/09/24 20:42:35 ET
Table '1701793695 2' 6-max Seat #2 is the button
Seat 1: j2157 (106675 in chips)=20
Seat 2: VagColeSlaw (240684 in chips)=20
Seat 3: Jivetoast (265273 in chips)=20
Seat 4: JJin91 (843327 in chips)=20
Seat 5: WhiteIce0328 (927628 in chips)=20
Seat 6: YourRobotDad (429685 in chips)=20
j2157: posts the ante 1500
VagColeSlaw: posts the ante 1500
Jivetoast: posts the ante 1500
JJin91: posts the ante 1500
WhiteIce0328: posts the ante 1500
YourRobotDad: posts the ante 1500
Jivetoast: posts small blind 6000
JJin91: posts big blind 12000
*** HOLE CARDS ***
Dealt to JJin91 [9h 3s]
WhiteIce0328: folds=20
YourRobotDad: raises 24000 to 36000
j2157: folds=20
VagColeSlaw: calls 36000
Jivetoast: folds=20
JJin91: folds=20
*** FLOP *** [2c Ad Jd]
YourRobotDad: bets 36000
VagColeSlaw: raises 36000 to 72000
YourRobotDad: raises 320185 to 392185 and is all-in
VagColeSlaw: folds=20
Uncalled bet (320185) returned to YourRobotDad
YourRobotDad collected 243000 from pot
*** SUMMARY ***
Total pot 243000 | Rake 0=20
Board [2c Ad Jd]
Seat 1: j2157 folded before Flop (didn't bet)
Seat 2: VagColeSlaw (button) folded on the Flop
Seat 3: Jivetoast (small blind) folded before Flop
Seat 4: JJin91 (big blind) folded before Flop
Seat 5: WhiteIce0328 folded before Flop (didn't bet)
Seat 6: YourRobotDad collected (243000)


*********** # 304 **************
PokerStars Hand #175484435453: Tournament #1701793695, $9.10+$0.90 USD =
Hold'em No Limit - Level XXX (6000/12000) - 2017/09/24 20:44:06 ET
Table '1701793695 2' 6-max Seat #3 is the button
Seat 1: j2157 (105175 in chips)=20
Seat 2: VagColeSlaw (131184 in chips)=20
Seat 3: Jivetoast (257773 in chips)=20
Seat 4: JJin91 (829827 in chips)=20
Seat 5: WhiteIce0328 (926128 in chips)=20
Seat 6: YourRobotDad (563185 in chips)=20
j2157: posts the ante 1500
VagColeSlaw: posts the ante 1500
Jivetoast: posts the ante 1500
JJin91: posts the ante 1500
WhiteIce0328: posts the ante 1500
YourRobotDad: posts the ante 1500
JJin91: posts small blind 6000
WhiteIce0328: posts big blind 12000
*** HOLE CARDS ***
Dealt to JJin91 [Kh 5h]
YourRobotDad: folds=20
j2157: folds=20
VagColeSlaw: folds=20
Jivetoast: folds=20
JJin91: raises 18120 to 30120
WhiteIce0328: folds=20
Uncalled bet (18120) returned to JJin91
JJin91 collected 33000 from pot
JJin91: doesn't show hand=20
*** SUMMARY ***
Total pot 33000 | Rake 0=20
Seat 1: j2157 folded before Flop (didn't bet)
Seat 2: VagColeSlaw folded before Flop (didn't bet)
Seat 3: Jivetoast (button) folded before Flop (didn't bet)
Seat 4: JJin91 (small blind) collected (33000)
Seat 5: WhiteIce0328 (big blind) folded before Flop
Seat 6: YourRobotDad folded before Flop (didn't bet)


*********** # 305 **************
PokerStars Hand #175484435576: Tournament #1701793695, $9.10+$0.90 USD =
Hold'em No Limit - Level XXX (6000/12000) - 2017/09/24 20:44:29 ET
Table '1701793695 2' 6-max Seat #4 is the button
Seat 1: j2157 (103675 in chips)=20
Seat 2: VagColeSlaw (129684 in chips)=20
Seat 3: Jivetoast (256273 in chips)=20
Seat 4: JJin91 (849327 in chips)=20
Seat 5: WhiteIce0328 (912628 in chips)=20
Seat 6: YourRobotDad (561685 in chips)=20
j2157: posts the ante 1500
VagColeSlaw: posts the ante 1500
Jivetoast: posts the ante 1500
JJin91: posts the ante 1500
WhiteIce0328: posts the ante 1500
YourRobotDad: posts the ante 1500
WhiteIce0328: posts small blind 6000
YourRobotDad: posts big blind 12000
*** HOLE CARDS ***
Dealt to JJin91 [2c 3s]
j2157: folds=20
VagColeSlaw: folds=20
Jivetoast: folds=20
JJin91: folds=20
WhiteIce0328: raises 24000 to 36000
YourRobotDad: folds=20
Uncalled bet (24000) returned to WhiteIce0328
WhiteIce0328 collected 33000 from pot
WhiteIce0328: doesn't show hand=20
*** SUMMARY ***
Total pot 33000 | Rake 0=20
Seat 1: j2157 folded before Flop (didn't bet)
Seat 2: VagColeSlaw folded before Flop (didn't bet)
Seat 3: Jivetoast folded before Flop (didn't bet)
Seat 4: JJin91 (button) folded before Flop (didn't bet)
Seat 5: WhiteIce0328 (small blind) collected (33000)
Seat 6: YourRobotDad (big blind) folded before Flop


*********** # 306 **************
PokerStars Hand #175484435822: Tournament #1701793695, $9.10+$0.90 USD =
Hold'em No Limit - Level XXX (6000/12000) - 2017/09/24 20:45:19 ET
Table '1701793695 2' 6-max Seat #5 is the button
Seat 1: j2157 (102175 in chips)=20
Seat 2: VagColeSlaw (128184 in chips)=20
Seat 3: Jivetoast (254773 in chips)=20
Seat 4: JJin91 (847827 in chips)=20
Seat 5: WhiteIce0328 (932128 in chips)=20
Seat 6: YourRobotDad (548185 in chips)=20
j2157: posts the ante 1500
VagColeSlaw: posts the ante 1500
Jivetoast: posts the ante 1500
JJin91: posts the ante 1500
WhiteIce0328: posts the ante 1500
YourRobotDad: posts the ante 1500
YourRobotDad: posts small blind 6000
j2157: posts big blind 12000
*** HOLE CARDS ***
Dealt to JJin91 [Kh Ts]
VagColeSlaw: folds=20
Jivetoast: folds=20
JJin91: raises 14040 to 26040
WhiteIce0328: folds=20
YourRobotDad: folds=20
j2157: calls 14040
*** FLOP *** [4c Qc 8h]
j2157: checks=20
JJin91: bets 67080
j2157: folds=20
Uncalled bet (67080) returned to JJin91
JJin91 collected 67080 from pot
JJin91: doesn't show hand=20
*** SUMMARY ***
Total pot 67080 | Rake 0=20
Board [4c Qc 8h]
Seat 1: j2157 (big blind) folded on the Flop
Seat 2: VagColeSlaw folded before Flop (didn't bet)
Seat 3: Jivetoast folded before Flop (didn't bet)
Seat 4: JJin91 collected (67080)
Seat 5: WhiteIce0328 (button) folded before Flop (didn't bet)
Seat 6: YourRobotDad (small blind) folded before Flop


*********** # 307 **************
PokerStars Hand #175484436005: Tournament #1701793695, $9.10+$0.90 USD =
Hold'em No Limit - Level XXX (6000/12000) - 2017/09/24 20:45:56 ET
Table '1701793695 2' 6-max Seat #6 is the button
Seat 1: j2157 (74635 in chips)=20
Seat 2: VagColeSlaw (126684 in chips)=20
Seat 3: Jivetoast (253273 in chips)=20
Seat 4: JJin91 (887367 in chips)=20
Seat 5: WhiteIce0328 (930628 in chips)=20
Seat 6: YourRobotDad (540685 in chips)=20
j2157: posts the ante 1500
VagColeSlaw: posts the ante 1500
Jivetoast: posts the ante 1500
JJin91: posts the ante 1500
WhiteIce0328: posts the ante 1500
YourRobotDad: posts the ante 1500
j2157: posts small blind 6000
VagColeSlaw: posts big blind 12000
*** HOLE CARDS ***
Dealt to JJin91 [Qd 8d]
Jivetoast: raises 24000 to 36000
JJin91: folds=20
WhiteIce0328: folds=20
YourRobotDad: folds=20
j2157: folds=20
VagColeSlaw: folds=20
Uncalled bet (24000) returned to Jivetoast
Jivetoast collected 39000 from pot
Jivetoast: doesn't show hand=20
*** SUMMARY ***
Total pot 39000 | Rake 0=20
Seat 1: j2157 (small blind) folded before Flop
Seat 2: VagColeSlaw (big blind) folded before Flop
Seat 3: Jivetoast collected (39000)
Seat 4: JJin91 folded before Flop (didn't bet)
Seat 5: WhiteIce0328 folded before Flop (didn't bet)
Seat 6: YourRobotDad (button) folded before Flop (didn't bet)


*********** # 308 **************
PokerStars Hand #175484436147: Tournament #1701793695, $9.10+$0.90 USD =
Hold'em No Limit - Level XXX (6000/12000) - 2017/09/24 20:46:21 ET
Table '1701793695 2' 6-max Seat #1 is the button
Seat 1: j2157 (67135 in chips)=20
Seat 2: VagColeSlaw (113184 in chips)=20
Seat 3: Jivetoast (278773 in chips)=20
Seat 4: JJin91 (885867 in chips)=20
Seat 6: YourRobotDad (539185 in chips)=20
j2157: posts the ante 1500
VagColeSlaw: posts the ante 1500
Jivetoast: posts the ante 1500
JJin91: posts the ante 1500
YourRobotDad: posts the ante 1500
VagColeSlaw: posts small blind 6000
Jivetoast: posts big blind 12000
*** HOLE CARDS ***
Dealt to JJin91 [Qh Kh]
JJin91: raises 14040 to 26040
YourRobotDad: folds=20
j2157: folds=20
VagColeSlaw: folds=20
Jivetoast: folds=20
Uncalled bet (14040) returned to JJin91
JJin91 collected 37500 from pot
JJin91: doesn't show hand=20
*** SUMMARY ***
Total pot 37500 | Rake 0=20
Seat 1: j2157 (button) folded before Flop (didn't bet)
Seat 2: VagColeSlaw (small blind) folded before Flop
Seat 3: Jivetoast (big blind) folded before Flop
Seat 4: JJin91 collected (37500)
Seat 6: YourRobotDad folded before Flop (didn't bet)


*********** # 309 **************
PokerStars Hand #175484436261: Tournament #1701793695, $9.10+$0.90 USD =
Hold'em No Limit - Level XXX (6000/12000) - 2017/09/24 20:46:46 ET
Table '1701793695 2' 6-max Seat #2 is the button
Seat 1: j2157 (65635 in chips)=20
Seat 2: VagColeSlaw (105684 in chips)=20
Seat 3: Jivetoast (265273 in chips)=20
Seat 4: JJin91 (909867 in chips)=20
Seat 6: YourRobotDad (537685 in chips)=20
j2157: posts the ante 1500
VagColeSlaw: posts the ante 1500
Jivetoast: posts the ante 1500
JJin91: posts the ante 1500
YourRobotDad: posts the ante 1500
Jivetoast: posts small blind 6000
JJin91: posts big blind 12000
*** HOLE CARDS ***
Dealt to JJin91 [As 7h]
YourRobotDad: raises 24000 to 36000
j2157: folds=20
VagColeSlaw: folds=20
Jivetoast: folds=20
JJin91: calls 24000
*** FLOP *** [Tc Kd 7d]
JJin91: checks=20
YourRobotDad: bets 48000
JJin91: calls 48000
*** TURN *** [Tc Kd 7d] [8s]
JJin91: checks=20
YourRobotDad: bets 96000
JJin91: folds=20
Uncalled bet (96000) returned to YourRobotDad
YourRobotDad collected 181500 from pot
*** SUMMARY ***
Total pot 181500 | Rake 0=20
Board [Tc Kd 7d 8s]
Seat 1: j2157 folded before Flop (didn't bet)
Seat 2: VagColeSlaw (button) folded before Flop (didn't bet)
Seat 3: Jivetoast (small blind) folded before Flop
Seat 4: JJin91 (big blind) folded on the Turn
Seat 6: YourRobotDad collected (181500)


*********** # 310 **************
PokerStars Hand #175484436675: Tournament #1701793695, $9.10+$0.90 USD =
Hold'em No Limit - Level XXXI (7000/14000) - 2017/09/24 20:48:07 ET
Table '1701793695 2' 6-max Seat #3 is the button
Seat 1: j2157 (64135 in chips)=20
Seat 2: VagColeSlaw (104184 in chips)=20
Seat 3: Jivetoast (257773 in chips)=20
Seat 4: JJin91 (824367 in chips)=20
Seat 6: YourRobotDad (633685 in chips)=20
j2157: posts the ante 1750
VagColeSlaw: posts the ante 1750
Jivetoast: posts the ante 1750
JJin91: posts the ante 1750
YourRobotDad: posts the ante 1750
JJin91: posts small blind 7000
YourRobotDad: posts big blind 14000
*** HOLE CARDS ***
Dealt to JJin91 [Ts As]
j2157: folds=20
VagColeSlaw: folds=20
Jivetoast: folds=20
JJin91: raises 31220 to 45220
YourRobotDad: folds=20
Uncalled bet (31220) returned to JJin91
JJin91 collected 36750 from pot
JJin91: doesn't show hand=20
*** SUMMARY ***
Total pot 36750 | Rake 0=20
Seat 1: j2157 folded before Flop (didn't bet)
Seat 2: VagColeSlaw folded before Flop (didn't bet)
Seat 3: Jivetoast (button) folded before Flop (didn't bet)
Seat 4: JJin91 (small blind) collected (36750)
Seat 6: YourRobotDad (big blind) folded before Flop


*********** # 311 **************
PokerStars Hand #175484437073: Tournament #1701793695, $9.10+$0.90 USD =
Hold'em No Limit - Level XXXI (7000/14000) - 2017/09/24 20:49:23 ET
Table '1701793695 2' 6-max Seat #4 is the button
Seat 1: j2157 (62385 in chips)=20
Seat 2: VagColeSlaw (102434 in chips)=20
Seat 3: Jivetoast (256023 in chips)=20
Seat 4: JJin91 (845367 in chips)=20
Seat 6: YourRobotDad (617935 in chips)=20
j2157: posts the ante 1750
VagColeSlaw: posts the ante 1750
Jivetoast: posts the ante 1750
JJin91: posts the ante 1750
YourRobotDad: posts the ante 1750
YourRobotDad: posts small blind 7000
j2157: posts big blind 14000
*** HOLE CARDS ***
Dealt to JJin91 [Jh Jd]
VagColeSlaw: folds=20
Jivetoast: folds=20
JJin91: raises 16380 to 30380
YourRobotDad: folds=20
j2157: folds=20
Uncalled bet (16380) returned to JJin91
JJin91 collected 43750 from pot
JJin91: doesn't show hand=20
*** SUMMARY ***
Total pot 43750 | Rake 0=20
Seat 1: j2157 (big blind) folded before Flop
Seat 2: VagColeSlaw folded before Flop (didn't bet)
Seat 3: Jivetoast folded before Flop (didn't bet)
Seat 4: JJin91 (button) collected (43750)
Seat 6: YourRobotDad (small blind) folded before Flop


*********** # 312 **************
PokerStars Hand #175484437250: Tournament #1701793695, $9.10+$0.90 USD =
Hold'em No Limit - Level XXXI (7000/14000) - 2017/09/24 20:49:59 ET
Table '1701793695 2' 6-max Seat #6 is the button
Seat 1: j2157 (46635 in chips)=20
Seat 2: VagColeSlaw (100684 in chips)=20
Seat 3: Jivetoast (254273 in chips)=20
Seat 4: JJin91 (873367 in chips)=20
Seat 6: YourRobotDad (609185 in chips)=20
j2157: posts the ante 1750
VagColeSlaw: posts the ante 1750
Jivetoast: posts the ante 1750
JJin91: posts the ante 1750
YourRobotDad: posts the ante 1750
j2157: posts small blind 7000
VagColeSlaw: posts big blind 14000
*** HOLE CARDS ***
Dealt to JJin91 [3c Qs]
Jivetoast: folds=20
JJin91: folds=20
YourRobotDad: raises 14000 to 28000
j2157: folds=20
VagColeSlaw: calls 14000
*** FLOP *** [6d 8s 7s]
VagColeSlaw: checks=20
YourRobotDad: checks=20
*** TURN *** [6d 8s 7s] [3h]
VagColeSlaw: bets 70934 and is all-in
YourRobotDad: folds=20
Uncalled bet (70934) returned to VagColeSlaw
VagColeSlaw collected 71750 from pot
VagColeSlaw: doesn't show hand=20
*** SUMMARY ***
Total pot 71750 | Rake 0=20
Board [6d 8s 7s 3h]
Seat 1: j2157 (small blind) folded before Flop
Seat 2: VagColeSlaw (big blind) collected (71750)
Seat 3: Jivetoast folded before Flop (didn't bet)
Seat 4: JJin91 folded before Flop (didn't bet)
Seat 6: YourRobotDad (button) folded on the Turn


*********** # 313 **************
PokerStars Hand #175484437467: Tournament #1701793695, $9.10+$0.90 USD =
Hold'em No Limit - Level XXXI (7000/14000) - 2017/09/24 20:50:40 ET
Table '1701793695 2' 6-max Seat #1 is the button
Seat 1: j2157 (37885 in chips)=20
Seat 2: VagColeSlaw (142684 in chips)=20
Seat 3: Jivetoast (252523 in chips)=20
Seat 4: JJin91 (871617 in chips)=20
Seat 6: YourRobotDad (579435 in chips)=20
j2157: posts the ante 1750
VagColeSlaw: posts the ante 1750
Jivetoast: posts the ante 1750
JJin91: posts the ante 1750
YourRobotDad: posts the ante 1750
VagColeSlaw: posts small blind 7000
Jivetoast: posts big blind 14000
*** HOLE CARDS ***
Dealt to JJin91 [9s 3h]
JJin91: folds=20
YourRobotDad: folds=20
j2157: folds=20
VagColeSlaw: raises 126934 to 140934 and is all-in
Jivetoast: calls 126934
*** FLOP *** [Qh 4h 5c]
*** TURN *** [Qh 4h 5c] [9h]
*** RIVER *** [Qh 4h 5c 9h] [9d]
*** SHOW DOWN ***
VagColeSlaw: shows [Ah 8s] (a pair of Nines)
Jivetoast: shows [7c 7s] (two pair, Nines and Sevens)
Jivetoast collected 290618 from pot
VagColeSlaw finished the tournament in 25th place and received $32.50.
*** SUMMARY ***
Total pot 290618 | Rake 0=20
Board [Qh 4h 5c 9h 9d]
Seat 1: j2157 (button) folded before Flop (didn't bet)
Seat 2: VagColeSlaw (small blind) showed [Ah 8s] and lost with a pair o=
f Nines
Seat 3: Jivetoast (big blind) showed [7c 7s] and won (290618) with two =
pair, Nines and Sevens
Seat 4: JJin91 folded before Flop (didn't bet)
Seat 6: YourRobotDad folded before Flop (didn't bet)


*********** # 314 **************
PokerStars Hand #175484437706: Tournament #1701793695, $9.10+$0.90 USD =
Hold'em No Limit - Level XXXI (7000/14000) - 2017/09/24 20:51:25 ET
Table '1701793695 9' 6-max Seat #6 is the button
Seat 1: JJin91 (869867 in chips) out of hand (moved from another table =
into small blind)
Seat 2: CrazyCatGent (95105 in chips)=20
Seat 3: Batzz88 (827876 in chips)=20
Seat 4: BENZBMW (468004 in chips)=20
Seat 5: narew (825693 in chips)=20
Seat 6: Eaglesstink? (358774 in chips)=20
CrazyCatGent: posts the ante 1750
Batzz88: posts the ante 1750
BENZBMW: posts the ante 1750
narew: posts the ante 1750
Eaglesstink?: posts the ante 1750
CrazyCatGent: posts small blind 7000
Batzz88: posts big blind 14000
*** HOLE CARDS ***
BENZBMW: folds=20
narew: raises 14000 to 28000
Eaglesstink?: calls 28000
CrazyCatGent: folds=20
Batzz88: calls 14000
*** FLOP *** [Th 7c 4c]
Batzz88: checks=20
narew: bets 49875
Eaglesstink?: folds=20
Batzz88: calls 49875
*** TURN *** [Th 7c 4c] [3h]
Batzz88: checks=20
narew: bets 99750
Batzz88: calls 99750
*** RIVER *** [Th 7c 4c 3h] [6h]
Batzz88: checks=20
narew: checks=20
*** SHOW DOWN ***
Batzz88: shows [6s Ts] (two pair, Tens and Sixes)
narew: mucks hand=20
Batzz88 collected 399000 from pot
*** SUMMARY ***
Total pot 399000 | Rake 0=20
Board [Th 7c 4c 3h 6h]
Seat 2: CrazyCatGent (small blind) folded before Flop
Seat 3: Batzz88 (big blind) showed [6s Ts] and won (399000) with two pa=
ir, Tens and Sixes
Seat 4: BENZBMW folded before Flop (didn't bet)
Seat 5: narew mucked [Kh Td]
Seat 6: Eaglesstink? (button) folded on the Flop


*********** # 315 **************
PokerStars Hand #175484438218: Tournament #1701793695, $9.10+$0.90 USD =
Hold'em No Limit - Level XXXI (7000/14000) - 2017/09/24 20:53:01 ET
Table '1701793695 9' 6-max Seat #2 is the button
Seat 1: JJin91 (869867 in chips)=20
Seat 2: CrazyCatGent (86355 in chips)=20
Seat 3: Batzz88 (1047501 in chips)=20
Seat 4: BENZBMW (466254 in chips)=20
Seat 5: narew (646318 in chips)=20
Seat 6: Eaglesstink? (329024 in chips)=20
JJin91: posts the ante 1750
CrazyCatGent: posts the ante 1750
Batzz88: posts the ante 1750
BENZBMW: posts the ante 1750
narew: posts the ante 1750
Eaglesstink?: posts the ante 1750
Batzz88: posts small blind 7000
BENZBMW: posts big blind 14000
*** HOLE CARDS ***
Dealt to JJin91 [8c 9h]
narew: calls 14000
Eaglesstink?: folds=20
JJin91: folds=20
CrazyCatGent: folds=20
Batzz88: folds=20
BENZBMW: checks=20
*** FLOP *** [Jc 8h 3s]
BENZBMW: checks=20
narew: bets 14000
BENZBMW: calls 14000
*** TURN *** [Jc 8h 3s] [Th]
BENZBMW: bets 36750
narew: folds=20
Uncalled bet (36750) returned to BENZBMW
BENZBMW collected 73500 from pot
*** SUMMARY ***
Total pot 73500 | Rake 0=20
Board [Jc 8h 3s Th]
Seat 1: JJin91 folded before Flop (didn't bet)
Seat 2: CrazyCatGent (button) folded before Flop (didn't bet)
Seat 3: Batzz88 (small blind) folded before Flop
Seat 4: BENZBMW (big blind) collected (73500)
Seat 5: narew folded on the Turn
Seat 6: Eaglesstink? folded before Flop (didn't bet)


*********** # 316 **************
PokerStars Hand #175484438668: Tournament #1701793695, $9.10+$0.90 USD =
Hold'em No Limit - Level XXXI (7000/14000) - 2017/09/24 20:54:31 ET
Table '1701793695 9' 6-max Seat #3 is the button
Seat 1: JJin91 (868117 in chips)=20
Seat 2: CrazyCatGent (84605 in chips)=20
Seat 3: Batzz88 (1038751 in chips)=20
Seat 4: BENZBMW (510004 in chips)=20
Seat 5: narew (616568 in chips)=20
Seat 6: Eaglesstink? (327274 in chips)=20
JJin91: posts the ante 1750
CrazyCatGent: posts the ante 1750
Batzz88: posts the ante 1750
BENZBMW: posts the ante 1750
narew: posts the ante 1750
Eaglesstink?: posts the ante 1750
BENZBMW: posts small blind 7000
narew: posts big blind 14000
*** HOLE CARDS ***
Dealt to JJin91 [2s 5h]
Eaglesstink?: folds=20
JJin91: folds=20
CrazyCatGent: raises 68855 to 82855 and is all-in
Batzz88: calls 82855
BENZBMW: folds=20
narew: folds=20
*** FLOP *** [Ah 7c Qh]
*** TURN *** [Ah 7c Qh] [8h]
*** RIVER *** [Ah 7c Qh 8h] [4c]
*** SHOW DOWN ***
CrazyCatGent: shows [Ad Qc] (two pair, Aces and Queens)
Batzz88: shows [Td Kd] (high card Ace)
CrazyCatGent collected 197210 from pot
*** SUMMARY ***
Total pot 197210 | Rake 0=20
Board [Ah 7c Qh 8h 4c]
Seat 1: JJin91 folded before Flop (didn't bet)
Seat 2: CrazyCatGent showed [Ad Qc] and won (197210) with two pair, Ace=
s and Queens
Seat 3: Batzz88 (button) showed [Td Kd] and lost with high card Ace
Seat 4: BENZBMW (small blind) folded before Flop
Seat 5: narew (big blind) folded before Flop
Seat 6: Eaglesstink? folded before Flop (didn't bet)


*********** # 317 **************
PokerStars Hand #175484438864: Tournament #1701793695, $9.10+$0.90 USD =
Hold'em No Limit - Level XXXI (7000/14000) - 2017/09/24 20:55:10 ET
Table '1701793695 9' 6-max Seat #4 is the button
Seat 1: JJin91 (866367 in chips)=20
Seat 2: CrazyCatGent (197210 in chips)=20
Seat 3: Batzz88 (954146 in chips)=20
Seat 4: BENZBMW (501254 in chips)=20
Seat 5: narew (600818 in chips)=20
Seat 6: Eaglesstink? (325524 in chips)=20
JJin91: posts the ante 1750
CrazyCatGent: posts the ante 1750
Batzz88: posts the ante 1750
BENZBMW: posts the ante 1750
narew: posts the ante 1750
Eaglesstink?: posts the ante 1750
narew: posts small blind 7000
Eaglesstink?: posts big blind 14000
*** HOLE CARDS ***
Dealt to JJin91 [Kh 5h]
JJin91: folds=20
CrazyCatGent: folds=20
Batzz88: folds=20
BENZBMW: folds=20
narew: calls 7000
Eaglesstink?: raises 28000 to 42000
narew: folds=20
Uncalled bet (28000) returned to Eaglesstink?
Eaglesstink? collected 38500 from pot
Eaglesstink?: doesn't show hand=20
*** SUMMARY ***
Total pot 38500 | Rake 0=20
Seat 1: JJin91 folded before Flop (didn't bet)
Seat 2: CrazyCatGent folded before Flop (didn't bet)
Seat 3: Batzz88 folded before Flop (didn't bet)
Seat 4: BENZBMW (button) folded before Flop (didn't bet)
Seat 5: narew (small blind) folded before Flop
Seat 6: Eaglesstink? (big blind) collected (38500)


*********** # 318 **************
PokerStars Hand #175484439998: Tournament #1701793695, $9.10+$0.90 USD =
Hold'em No Limit - Level XXXI (7000/14000) - 2017/09/24 21:00:58 ET
Table '1701793695 9' 6-max Seat #5 is the button
Seat 1: JJin91 (864617 in chips)=20
Seat 2: CrazyCatGent (195460 in chips)=20
Seat 3: Batzz88 (952396 in chips)=20
Seat 4: BENZBMW (499504 in chips)=20
Seat 5: narew (585068 in chips)=20
Seat 6: Eaglesstink? (348274 in chips)=20
JJin91: posts the ante 1750
CrazyCatGent: posts the ante 1750
Batzz88: posts the ante 1750
BENZBMW: posts the ante 1750
narew: posts the ante 1750
Eaglesstink?: posts the ante 1750
Eaglesstink?: posts small blind 7000
JJin91: posts big blind 14000
*** HOLE CARDS ***
Dealt to JJin91 [Qs 5c]
CrazyCatGent: folds=20
Batzz88: folds=20
BENZBMW: folds=20
narew: folds=20
Eaglesstink?: calls 7000
JJin91: checks=20
*** FLOP *** [3h 9h Qh]
Eaglesstink?: checks=20
JJin91: bets 19635
Eaglesstink?: folds=20
Uncalled bet (19635) returned to JJin91
JJin91 collected 38500 from pot
JJin91: doesn't show hand=20
*** SUMMARY ***
Total pot 38500 | Rake 0=20
Board [3h 9h Qh]
Seat 1: JJin91 (big blind) collected (38500)
Seat 2: CrazyCatGent folded before Flop (didn't bet)
Seat 3: Batzz88 folded before Flop (didn't bet)
Seat 4: BENZBMW folded before Flop (didn't bet)
Seat 5: narew (button) folded before Flop (didn't bet)
Seat 6: Eaglesstink? (small blind) folded on the Flop


*********** # 319 **************
PokerStars Hand #175485228035: Tournament #1701793695, $9.10+$0.90 USD =
Hold'em No Limit - Level XXXI (7000/14000) - 2017/09/24 21:01:29 ET
Table '1701793695 9' 6-max Seat #6 is the button
Seat 1: JJin91 (887367 in chips)=20
Seat 2: CrazyCatGent (193710 in chips)=20
Seat 3: Batzz88 (950646 in chips)=20
Seat 4: BENZBMW (497754 in chips)=20
Seat 5: narew (583318 in chips)=20
Seat 6: Eaglesstink? (332524 in chips)=20
JJin91: posts the ante 1750
CrazyCatGent: posts the ante 1750
Batzz88: posts the ante 1750
BENZBMW: posts the ante 1750
narew: posts the ante 1750
Eaglesstink?: posts the ante 1750
JJin91: posts small blind 7000
CrazyCatGent: posts big blind 14000
*** HOLE CARDS ***
Dealt to JJin91 [2h 4s]
Batzz88: folds=20
BENZBMW: calls 14000
narew: folds=20
Eaglesstink?: folds=20
JJin91: folds=20
CrazyCatGent: checks=20
*** FLOP *** [8d Jd Ac]
CrazyCatGent: checks=20
BENZBMW: bets 28000
CrazyCatGent: folds=20
Uncalled bet (28000) returned to BENZBMW
BENZBMW collected 45500 from pot
*** SUMMARY ***
Total pot 45500 | Rake 0=20
Board [8d Jd Ac]
Seat 1: JJin91 (small blind) folded before Flop
Seat 2: CrazyCatGent (big blind) folded on the Flop
Seat 3: Batzz88 folded before Flop (didn't bet)
Seat 4: BENZBMW collected (45500)
Seat 5: narew folded before Flop (didn't bet)
Seat 6: Eaglesstink? (button) folded before Flop (didn't bet)


*********** # 320 **************
PokerStars Hand #175485228470: Tournament #1701793695, $9.10+$0.90 USD =
Hold'em No Limit - Level XXXI (7000/14000) - 2017/09/24 21:02:59 ET
Table '1701793695 9' 6-max Seat #1 is the button
Seat 1: JJin91 (878617 in chips)=20
Seat 2: CrazyCatGent (177960 in chips)=20
Seat 3: Batzz88 (948896 in chips)=20
Seat 4: BENZBMW (527504 in chips)=20
Seat 5: narew (581568 in chips)=20
Seat 6: Eaglesstink? (330774 in chips)=20
JJin91: posts the ante 1750
CrazyCatGent: posts the ante 1750
Batzz88: posts the ante 1750
BENZBMW: posts the ante 1750
narew: posts the ante 1750
Eaglesstink?: posts the ante 1750
CrazyCatGent: posts small blind 7000
Batzz88: posts big blind 14000
*** HOLE CARDS ***
Dealt to JJin91 [7h Jh]
BENZBMW: folds=20
narew: folds=20
Eaglesstink?: folds=20
JJin91: raises 16380 to 30380
CrazyCatGent: folds=20
Batzz88: calls 16380
*** FLOP *** [3c Kc 2s]
Batzz88: checks=20
JJin91: checks=20
*** TURN *** [3c Kc 2s] [3d]
Batzz88: checks=20
JJin91: checks=20
*** RIVER *** [3c Kc 2s 3d] [9h]
Batzz88: checks=20
JJin91: bets 28956
Batzz88: folds=20
Uncalled bet (28956) returned to JJin91
JJin91 collected 78260 from pot
JJin91: doesn't show hand=20
*** SUMMARY ***
Total pot 78260 | Rake 0=20
Board [3c Kc 2s 3d 9h]
Seat 1: JJin91 (button) collected (78260)
Seat 2: CrazyCatGent (small blind) folded before Flop
Seat 3: Batzz88 (big blind) folded on the River
Seat 4: BENZBMW folded before Flop (didn't bet)
Seat 5: narew folded before Flop (didn't bet)
Seat 6: Eaglesstink? folded before Flop (didn't bet)


*********** # 321 **************
PokerStars Hand #175485228676: Tournament #1701793695, $9.10+$0.90 USD =
Hold'em No Limit - Level XXXII (8000/16000) - 2017/09/24 21:03:45 ET
Table '1701793695 9' 6-max Seat #2 is the button
Seat 1: JJin91 (924747 in chips)=20
Seat 2: CrazyCatGent (169210 in chips)=20
Seat 3: Batzz88 (916766 in chips)=20
Seat 4: BENZBMW (525754 in chips)=20
Seat 5: narew (579818 in chips)=20
JJin91: posts the ante 2000
CrazyCatGent: posts the ante 2000
Batzz88: posts the ante 2000
BENZBMW: posts the ante 2000
narew: posts the ante 2000
Batzz88: posts small blind 8000
BENZBMW: posts big blind 16000
*** HOLE CARDS ***
Dealt to JJin91 [Th Ts]
narew: folds=20
JJin91: raises 18720 to 34720
CrazyCatGent: folds=20
Batzz88: raises 61280 to 96000
BENZBMW: folds=20
JJin91: calls 61280
*** FLOP *** [7d Qs Qd]
Batzz88: checks=20
JJin91: bets 123334
Batzz88: folds=20
Uncalled bet (123334) returned to JJin91
JJin91 collected 218000 from pot
JJin91: doesn't show hand=20
*** SUMMARY ***
Total pot 218000 | Rake 0=20
Board [7d Qs Qd]
Seat 1: JJin91 collected (218000)
Seat 2: CrazyCatGent (button) folded before Flop (didn't bet)
Seat 3: Batzz88 (small blind) folded on the Flop
Seat 4: BENZBMW (big blind) folded before Flop
Seat 5: narew folded before Flop (didn't bet)


*********** # 322 **************
PokerStars Hand #175485228930: Tournament #1701793695, $9.10+$0.90 USD =
Hold'em No Limit - Level XXXII (8000/16000) - 2017/09/24 21:04:37 ET
Table '1701793695 9' 6-max Seat #3 is the button
Seat 1: JJin91 (1044747 in chips)=20
Seat 2: CrazyCatGent (167210 in chips)=20
Seat 3: Batzz88 (818766 in chips)=20
Seat 4: BENZBMW (507754 in chips)=20
Seat 5: narew (577818 in chips)=20
Seat 6: YourRobotDad (403935 in chips)=20
JJin91: posts the ante 2000
CrazyCatGent: posts the ante 2000
Batzz88: posts the ante 2000
BENZBMW: posts the ante 2000
narew: posts the ante 2000
YourRobotDad: posts the ante 2000
BENZBMW: posts small blind 8000
narew: posts big blind 16000
*** HOLE CARDS ***
Dealt to JJin91 [3h 9c]
YourRobotDad: folds=20
JJin91: folds=20
CrazyCatGent: folds=20
Batzz88: raises 16000 to 32000
BENZBMW: folds=20
narew: calls 16000
*** FLOP *** [3d Td 9s]
narew: checks=20
Batzz88: checks=20
*** TURN *** [3d Td 9s] [Qd]
narew: checks=20
Batzz88: bets 64000
narew: folds=20
Uncalled bet (64000) returned to Batzz88
Batzz88 collected 84000 from pot
Batzz88: doesn't show hand=20
*** SUMMARY ***
Total pot 84000 | Rake 0=20
Board [3d Td 9s Qd]
Seat 1: JJin91 folded before Flop (didn't bet)
Seat 2: CrazyCatGent folded before Flop (didn't bet)
Seat 3: Batzz88 (button) collected (84000)
Seat 4: BENZBMW (small blind) folded before Flop
Seat 5: narew (big blind) folded on the Turn
Seat 6: YourRobotDad folded before Flop (didn't bet)


*********** # 323 **************
PokerStars Hand #175485229251: Tournament #1701793695, $9.10+$0.90 USD =
Hold'em No Limit - Level XXXII (8000/16000) - 2017/09/24 21:05:42 ET
Table '1701793695 9' 6-max Seat #4 is the button
Seat 1: JJin91 (1042747 in chips)=20
Seat 2: CrazyCatGent (165210 in chips)=20
Seat 3: Batzz88 (868766 in chips)=20
Seat 4: BENZBMW (497754 in chips)=20
Seat 5: narew (543818 in chips)=20
Seat 6: YourRobotDad (401935 in chips)=20
JJin91: posts the ante 2000
CrazyCatGent: posts the ante 2000
Batzz88: posts the ante 2000
BENZBMW: posts the ante 2000
narew: posts the ante 2000
YourRobotDad: posts the ante 2000
narew: posts small blind 8000
YourRobotDad: posts big blind 16000
*** HOLE CARDS ***
Dealt to JJin91 [2s Th]
JJin91: folds=20
CrazyCatGent: folds=20
Batzz88: raises 16000 to 32000
BENZBMW: folds=20
narew: folds=20
YourRobotDad: folds=20
Uncalled bet (16000) returned to Batzz88
Batzz88 collected 52000 from pot
Batzz88: doesn't show hand=20
*** SUMMARY ***
Total pot 52000 | Rake 0=20
Seat 1: JJin91 folded before Flop (didn't bet)
Seat 2: CrazyCatGent folded before Flop (didn't bet)
Seat 3: Batzz88 collected (52000)
Seat 4: BENZBMW (button) folded before Flop (didn't bet)
Seat 5: narew (small blind) folded before Flop
Seat 6: YourRobotDad (big blind) folded before Flop


*********** # 324 **************
PokerStars Hand #175485229410: Tournament #1701793695, $9.10+$0.90 USD =
Hold'em No Limit - Level XXXII (8000/16000) - 2017/09/24 21:06:12 ET
Table '1701793695 9' 6-max Seat #5 is the button
Seat 1: JJin91 (1040747 in chips)=20
Seat 2: CrazyCatGent (163210 in chips)=20
Seat 3: Batzz88 (902766 in chips)=20
Seat 4: BENZBMW (495754 in chips)=20
Seat 5: narew (533818 in chips)=20
Seat 6: YourRobotDad (383935 in chips)=20
JJin91: posts the ante 2000
CrazyCatGent: posts the ante 2000
Batzz88: posts the ante 2000
BENZBMW: posts the ante 2000
narew: posts the ante 2000
YourRobotDad: posts the ante 2000
YourRobotDad: posts small blind 8000
JJin91: posts big blind 16000
*** HOLE CARDS ***
Dealt to JJin91 [7s 2s]
CrazyCatGent: folds=20
Batzz88: folds=20
BENZBMW: folds=20
narew: raises 32000 to 48000
YourRobotDad: folds=20
JJin91: folds=20
Uncalled bet (32000) returned to narew
narew collected 52000 from pot
narew: doesn't show hand=20
*** SUMMARY ***
Total pot 52000 | Rake 0=20
Seat 1: JJin91 (big blind) folded before Flop
Seat 2: CrazyCatGent folded before Flop (didn't bet)
Seat 3: Batzz88 folded before Flop (didn't bet)
Seat 4: BENZBMW folded before Flop (didn't bet)
Seat 5: narew (button) collected (52000)
Seat 6: YourRobotDad (small blind) folded before Flop


*********** # 325 **************
PokerStars Hand #175485229517: Tournament #1701793695, $9.10+$0.90 USD =
Hold'em No Limit - Level XXXII (8000/16000) - 2017/09/24 21:06:35 ET
Table '1701793695 9' 6-max Seat #6 is the button
Seat 1: JJin91 (1022747 in chips)=20
Seat 2: CrazyCatGent (161210 in chips)=20
Seat 3: Batzz88 (900766 in chips)=20
Seat 4: BENZBMW (493754 in chips)=20
Seat 5: narew (567818 in chips)=20
Seat 6: YourRobotDad (373935 in chips)=20
JJin91: posts the ante 2000
CrazyCatGent: posts the ante 2000
Batzz88: posts the ante 2000
BENZBMW: posts the ante 2000
narew: posts the ante 2000
YourRobotDad: posts the ante 2000
JJin91: posts small blind 8000
CrazyCatGent: posts big blind 16000
*** HOLE CARDS ***
Dealt to JJin91 [Kh 4c]
Batzz88: folds=20
BENZBMW: raises 16000 to 32000
narew: calls 32000
YourRobotDad: folds=20
JJin91: folds=20
CrazyCatGent: calls 16000
*** FLOP *** [3s Ac 2d]
CrazyCatGent: checks=20
BENZBMW: bets 32000
narew: calls 32000
CrazyCatGent: folds=20
*** TURN *** [3s Ac 2d] [Qd]
BENZBMW: bets 32000
narew: raises 48000 to 80000
BENZBMW: calls 48000
*** RIVER *** [3s Ac 2d Qd] [2c]
BENZBMW: bets 16000
narew: raises 160000 to 176000
BENZBMW: folds=20
Uncalled bet (160000) returned to narew
narew collected 372000 from pot
narew: doesn't show hand=20
*** SUMMARY ***
Total pot 372000 | Rake 0=20
Board [3s Ac 2d Qd 2c]
Seat 1: JJin91 (small blind) folded before Flop
Seat 2: CrazyCatGent (big blind) folded on the Flop
Seat 3: Batzz88 folded before Flop (didn't bet)
Seat 4: BENZBMW folded on the River
Seat 5: narew collected (372000)
Seat 6: YourRobotDad (button) folded before Flop (didn't bet)


*********** # 326 **************
PokerStars Hand #175485438012: Tournament #1701793695, $9.10+$0.90 USD =
Hold'em No Limit - Level XXXII (8000/16000) - 2017/09/24 21:08:59 ET
Table '1701793695 9' 6-max Seat #1 is the button
Seat 1: JJin91 (1012747 in chips)=20
Seat 2: CrazyCatGent (127210 in chips)=20
Seat 3: Batzz88 (898766 in chips)=20
Seat 4: BENZBMW (331754 in chips)=20
Seat 5: narew (777818 in chips)=20
Seat 6: YourRobotDad (371935 in chips)=20
JJin91: posts the ante 2000
CrazyCatGent: posts the ante 2000
Batzz88: posts the ante 2000
BENZBMW: posts the ante 2000
narew: posts the ante 2000
YourRobotDad: posts the ante 2000
CrazyCatGent: posts small blind 8000
Batzz88: posts big blind 16000
*** HOLE CARDS ***
Dealt to JJin91 [3c 4s]
BENZBMW: folds=20
narew: raises 16000 to 32000
YourRobotDad: folds=20
JJin91: folds=20
CrazyCatGent: folds=20
Batzz88: calls 16000
*** FLOP *** [5h 9c 9h]
Batzz88: checks=20
narew: bets 32000
Batzz88: calls 32000
*** TURN *** [5h 9c 9h] [4h]
Batzz88: checks=20
narew: checks=20
*** RIVER *** [5h 9c 9h 4h] [Qc]
Batzz88: checks=20
narew: bets 96000
Batzz88: folds=20
Uncalled bet (96000) returned to narew
narew collected 148000 from pot
narew: doesn't show hand=20
*** SUMMARY ***
Total pot 148000 | Rake 0=20
Board [5h 9c 9h 4h Qc]
Seat 1: JJin91 (button) folded before Flop (didn't bet)
Seat 2: CrazyCatGent (small blind) folded before Flop
Seat 3: Batzz88 (big blind) folded on the River
Seat 4: BENZBMW folded before Flop (didn't bet)
Seat 5: narew collected (148000)
Seat 6: YourRobotDad folded before Flop (didn't bet)


*********** # 327 **************
PokerStars Hand #175485438459: Tournament #1701793695, $9.10+$0.90 USD =
Hold'em No Limit - Level XXXII (8000/16000) - 2017/09/24 21:10:27 ET
Table '1701793695 9' 6-max Seat #2 is the button
Seat 1: JJin91 (1010747 in chips)=20
Seat 2: CrazyCatGent (117210 in chips)=20
Seat 3: Batzz88 (832766 in chips)=20
Seat 4: BENZBMW (329754 in chips)=20
Seat 5: narew (859818 in chips)=20
Seat 6: YourRobotDad (369935 in chips)=20
JJin91: posts the ante 2000
CrazyCatGent: posts the ante 2000
Batzz88: posts the ante 2000
BENZBMW: posts the ante 2000
narew: posts the ante 2000
YourRobotDad: posts the ante 2000
Batzz88: posts small blind 8000
BENZBMW: posts big blind 16000
*** HOLE CARDS ***
Dealt to JJin91 [Td 2c]
narew: folds=20
YourRobotDad: folds=20
JJin91: folds=20
CrazyCatGent: raises 99210 to 115210 and is all-in
Batzz88: folds=20
BENZBMW: folds=20
Uncalled bet (99210) returned to CrazyCatGent
CrazyCatGent collected 52000 from pot
CrazyCatGent: doesn't show hand=20
*** SUMMARY ***
Total pot 52000 | Rake 0=20
Seat 1: JJin91 folded before Flop (didn't bet)
Seat 2: CrazyCatGent (button) collected (52000)
Seat 3: Batzz88 (small blind) folded before Flop
Seat 4: BENZBMW (big blind) folded before Flop
Seat 5: narew folded before Flop (didn't bet)
Seat 6: YourRobotDad folded before Flop (didn't bet)


*********** # 328 **************
PokerStars Hand #175485438559: Tournament #1701793695, $9.10+$0.90 USD =
Hold'em No Limit - Level XXXII (8000/16000) - 2017/09/24 21:10:50 ET
Table '1701793695 9' 6-max Seat #3 is the button
Seat 1: JJin91 (1008747 in chips)=20
Seat 2: CrazyCatGent (151210 in chips)=20
Seat 3: Batzz88 (822766 in chips)=20
Seat 4: BENZBMW (311754 in chips)=20
Seat 5: narew (857818 in chips)=20
Seat 6: YourRobotDad (367935 in chips)=20
JJin91: posts the ante 2000
CrazyCatGent: posts the ante 2000
Batzz88: posts the ante 2000
BENZBMW: posts the ante 2000
narew: posts the ante 2000
YourRobotDad: posts the ante 2000
BENZBMW: posts small blind 8000
narew: posts big blind 16000
*** HOLE CARDS ***
Dealt to JJin91 [Ah 7d]
YourRobotDad: folds=20
JJin91: raises 18720 to 34720
CrazyCatGent: folds=20
Batzz88: folds=20
BENZBMW: folds=20
narew: calls 18720
*** FLOP *** [Jc 2h 3d]
narew: checks=20
JJin91: checks=20
*** TURN *** [Jc 2h 3d] [4h]
narew: checks=20
JJin91: checks=20
*** RIVER *** [Jc 2h 3d 4h] [Ts]
narew: bets 44720
JJin91: calls 44720
*** SHOW DOWN ***
narew: shows [Ks 8s] (high card King)
JJin91: shows [Ah 7d] (high card Ace)
JJin91 collected 178880 from pot
*** SUMMARY ***
Total pot 178880 | Rake 0=20
Board [Jc 2h 3d 4h Ts]
Seat 1: JJin91 showed [Ah 7d] and won (178880) with high card Ace
Seat 2: CrazyCatGent folded before Flop (didn't bet)
Seat 3: Batzz88 (button) folded before Flop (didn't bet)
Seat 4: BENZBMW (small blind) folded before Flop
Seat 5: narew (big blind) showed [Ks 8s] and lost with high card King
Seat 6: YourRobotDad folded before Flop (didn't bet)


*********** # 329 **************
PokerStars Hand #175485438946: Tournament #1701793695, $9.10+$0.90 USD =
Hold'em No Limit - Level XXXII (8000/16000) - 2017/09/24 21:12:06 ET
Table '1701793695 9' 6-max Seat #4 is the button
Seat 1: JJin91 (1106187 in chips)=20
Seat 2: CrazyCatGent (149210 in chips)=20
Seat 3: Batzz88 (820766 in chips)=20
Seat 4: BENZBMW (301754 in chips)=20
Seat 5: narew (776378 in chips)=20
Seat 6: YourRobotDad (365935 in chips)=20
JJin91: posts the ante 2000
CrazyCatGent: posts the ante 2000
Batzz88: posts the ante 2000
BENZBMW: posts the ante 2000
narew: posts the ante 2000
YourRobotDad: posts the ante 2000
narew: posts small blind 8000
YourRobotDad: posts big blind 16000
*** HOLE CARDS ***
Dealt to JJin91 [9s As]
JJin91: raises 18720 to 34720
CrazyCatGent: folds=20
Batzz88: folds=20
BENZBMW: calls 34720
narew: folds=20
YourRobotDad: folds=20
*** FLOP *** [4c Ad Tc]
JJin91: bets 39013
BENZBMW: raises 39013 to 78026
JJin91: raises 261492 to 339518
BENZBMW: calls 187008 and is all-in
Uncalled bet (74484) returned to JJin91
*** TURN *** [4c Ad Tc] [Qs]
*** RIVER *** [4c Ad Tc Qs] [3h]
*** SHOW DOWN ***
JJin91: shows [9s As] (a pair of Aces)
BENZBMW: shows [Ac 7s] (a pair of Aces - lower kicker)
JJin91 collected 635508 from pot
BENZBMW finished the tournament in 18th place and received $47.50.
*** SUMMARY ***
Total pot 635508 | Rake 0=20
Board [4c Ad Tc Qs 3h]
Seat 1: JJin91 showed [9s As] and won (635508) with a pair of Aces
Seat 2: CrazyCatGent folded before Flop (didn't bet)
Seat 3: Batzz88 folded before Flop (didn't bet)
Seat 4: BENZBMW (button) showed [Ac 7s] and lost with a pair of Aces
Seat 5: narew (small blind) folded before Flop
Seat 6: YourRobotDad (big blind) folded before Flop


*********** # 330 **************
PokerStars Hand #175485439261: Tournament #1701793695, $9.10+$0.90 USD =
Hold'em No Limit - Level XXXII (8000/16000) - 2017/09/24 21:13:10 ET
Table '1701793695 9' 6-max Seat #5 is the button
Seat 1: JJin91 (1439941 in chips)=20
Seat 2: CrazyCatGent (147210 in chips)=20
Seat 3: Batzz88 (818766 in chips)=20
Seat 5: narew (766378 in chips)=20
Seat 6: YourRobotDad (347935 in chips)=20
JJin91: posts the ante 2000
CrazyCatGent: posts the ante 2000
Batzz88: posts the ante 2000
narew: posts the ante 2000
YourRobotDad: posts the ante 2000
YourRobotDad: posts small blind 8000
JJin91: posts big blind 16000
*** HOLE CARDS ***
Dealt to JJin91 [8h Tc]
CrazyCatGent: raises 129210 to 145210 and is all-in
Batzz88: folds=20
narew: folds=20
YourRobotDad: folds=20
JJin91: calls 129210
*** FLOP *** [2c Ah Js]
*** TURN *** [2c Ah Js] [9c]
*** RIVER *** [2c Ah Js 9c] [2h]
*** SHOW DOWN ***
JJin91: shows [8h Tc] (a pair of Deuces)
CrazyCatGent: shows [Ac Qh] (two pair, Aces and Deuces)
CrazyCatGent collected 308420 from pot
*** SUMMARY ***
Total pot 308420 | Rake 0=20
Board [2c Ah Js 9c 2h]
Seat 1: JJin91 (big blind) showed [8h Tc] and lost with a pair of Deuces
Seat 2: CrazyCatGent showed [Ac Qh] and won (308420) with two pair, Ace=
s and Deuces
Seat 3: Batzz88 folded before Flop (didn't bet)
Seat 5: narew (button) folded before Flop (didn't bet)
Seat 6: YourRobotDad (small blind) folded before Flop


*********** # 331 **************
PokerStars Hand #175485439383: Tournament #1701793695, $9.10+$0.90 USD =
Hold'em No Limit - Level XXXII (8000/16000) - 2017/09/24 21:13:32 ET
Table '1701793695 9' 6-max Seat #6 is the button
Seat 1: JJin91 (1292731 in chips)=20
Seat 2: CrazyCatGent (308420 in chips)=20
Seat 3: Batzz88 (816766 in chips)=20
Seat 5: narew (764378 in chips)=20
Seat 6: YourRobotDad (337935 in chips)=20
JJin91: posts the ante 2000
CrazyCatGent: posts the ante 2000
Batzz88: posts the ante 2000
narew: posts the ante 2000
YourRobotDad: posts the ante 2000
JJin91: posts small blind 8000
CrazyCatGent: posts big blind 16000
*** HOLE CARDS ***
Dealt to JJin91 [8d 9s]
Batzz88: folds=20
narew: folds=20
YourRobotDad: raises 50000 to 66000
JJin91: folds=20
CrazyCatGent: folds=20
Uncalled bet (50000) returned to YourRobotDad
YourRobotDad collected 50000 from pot
*** SUMMARY ***
Total pot 50000 | Rake 0=20
Seat 1: JJin91 (small blind) folded before Flop
Seat 2: CrazyCatGent (big blind) folded before Flop
Seat 3: Batzz88 folded before Flop (didn't bet)
Seat 5: narew folded before Flop (didn't bet)
Seat 6: YourRobotDad (button) collected (50000)


*********** # 332 **************
PokerStars Hand #175485439497: Tournament #1701793695, $9.10+$0.90 USD =
Hold'em No Limit - Level XXXIII (10000/20000) - 2017/09/24 21:13:55 ET
Table '1701793695 9' 6-max Seat #1 is the button
Seat 1: JJin91 (1282731 in chips)=20
Seat 2: CrazyCatGent (290420 in chips)=20
Seat 3: Batzz88 (814766 in chips)=20
Seat 5: narew (762378 in chips)=20
Seat 6: YourRobotDad (369935 in chips)=20
JJin91: posts the ante 2500
CrazyCatGent: posts the ante 2500
Batzz88: posts the ante 2500
narew: posts the ante 2500
YourRobotDad: posts the ante 2500
CrazyCatGent: posts small blind 10000
Batzz88: posts big blind 20000
*** HOLE CARDS ***
Dealt to JJin91 [6h 9d]
narew: folds=20
YourRobotDad: raises 62500 to 82500
JJin91: folds=20
CrazyCatGent: folds=20
Batzz88: folds=20
Uncalled bet (62500) returned to YourRobotDad
YourRobotDad collected 62500 from pot
YourRobotDad: shows [Jc Jh] (a pair of Jacks)
*** SUMMARY ***
Total pot 62500 | Rake 0=20
Seat 1: JJin91 (button) folded before Flop (didn't bet)
Seat 2: CrazyCatGent (small blind) folded before Flop
Seat 3: Batzz88 (big blind) folded before Flop
Seat 5: narew folded before Flop (didn't bet)
Seat 6: YourRobotDad collected (62500)


*********** # 333 **************
PokerStars Hand #175485439599: Tournament #1701793695, $9.10+$0.90 USD =
Hold'em No Limit - Level XXXIII (10000/20000) - 2017/09/24 21:14:16 ET
Table '1701793695 9' 6-max Seat #2 is the button
Seat 1: JJin91 (1280231 in chips)=20
Seat 2: CrazyCatGent (277920 in chips)=20
Seat 3: Batzz88 (792266 in chips)=20
Seat 5: narew (759878 in chips)=20
Seat 6: YourRobotDad (409935 in chips)=20
JJin91: posts the ante 2500
CrazyCatGent: posts the ante 2500
Batzz88: posts the ante 2500
narew: posts the ante 2500
YourRobotDad: posts the ante 2500
Batzz88: posts small blind 10000
narew: posts big blind 20000
*** HOLE CARDS ***
Dealt to JJin91 [Jh Ks]
YourRobotDad: folds=20
JJin91: raises 23400 to 43400
CrazyCatGent: folds=20
Batzz88: folds=20
narew: calls 23400
*** FLOP *** [8d 3s 6d]
narew: checks=20
JJin91: checks=20
*** TURN *** [8d 3s 6d] [Js]
narew: checks=20
JJin91: checks=20
*** RIVER *** [8d 3s 6d Js] [4s]
narew: bets 54650
JJin91: calls 54650
*** SHOW DOWN ***
narew: shows [Ah Qh] (high card Ace)
JJin91: shows [Jh Ks] (a pair of Jacks)
JJin91 collected 218600 from pot
*** SUMMARY ***
Total pot 218600 | Rake 0=20
Board [8d 3s 6d Js 4s]
Seat 1: JJin91 showed [Jh Ks] and won (218600) with a pair of Jacks
Seat 2: CrazyCatGent (button) folded before Flop (didn't bet)
Seat 3: Batzz88 (small blind) folded before Flop
Seat 5: narew (big blind) showed [Ah Qh] and lost with high card Ace
Seat 6: YourRobotDad folded before Flop (didn't bet)


*********** # 334 **************
PokerStars Hand #175485439967: Tournament #1701793695, $9.10+$0.90 USD =
Hold'em No Limit - Level XXXIII (10000/20000) - 2017/09/24 21:15:31 ET
Table '1701793695 9' 6-max Seat #3 is the button
Seat 1: JJin91 (1398281 in chips)=20
Seat 2: CrazyCatGent (275420 in chips)=20
Seat 3: Batzz88 (779766 in chips)=20
Seat 5: narew (659328 in chips)=20
Seat 6: YourRobotDad (407435 in chips)=20
JJin91: posts the ante 2500
CrazyCatGent: posts the ante 2500
Batzz88: posts the ante 2500
narew: posts the ante 2500
YourRobotDad: posts the ante 2500
narew: posts small blind 10000
YourRobotDad: posts big blind 20000
*** HOLE CARDS ***
Dealt to JJin91 [6h 7h]
JJin91: folds=20
CrazyCatGent: folds=20
Batzz88: folds=20
narew: calls 10000
YourRobotDad: checks=20
*** FLOP *** [Ac Qd Th]
narew: checks=20
YourRobotDad: bets 40000
narew: calls 40000
*** TURN *** [Ac Qd Th] [4d]
narew: checks=20
YourRobotDad: bets 60000
narew: calls 60000
*** RIVER *** [Ac Qd Th 4d] [3s]
narew: checks=20
YourRobotDad: bets 100000
narew: calls 100000
*** SHOW DOWN ***
YourRobotDad: shows [2h Ks] (high card Ace)
narew: shows [Qc 5c] (a pair of Queens)
narew collected 452500 from pot
*** SUMMARY ***
Total pot 452500 | Rake 0=20
Board [Ac Qd Th 4d 3s]
Seat 1: JJin91 folded before Flop (didn't bet)
Seat 2: CrazyCatGent folded before Flop (didn't bet)
Seat 3: Batzz88 (button) folded before Flop (didn't bet)
Seat 5: narew (small blind) showed [Qc 5c] and won (452500) with a pair=
 of Queens
Seat 6: YourRobotDad (big blind) showed [2h Ks] and lost with high card=
 Ace


*********** # 335 **************
PokerStars Hand #175485669184: Tournament #1701793695, $9.10+$0.90 USD =
Hold'em No Limit - Level XXXIII (10000/20000) - 2017/09/24 21:16:52 ET
Table '1701793695 9' 6-max Seat #5 is the button
Seat 1: JJin91 (1395781 in chips)=20
Seat 2: CrazyCatGent (272920 in chips)=20
Seat 3: Batzz88 (777266 in chips)=20
Seat 5: narew (889328 in chips)=20
Seat 6: YourRobotDad (184935 in chips)=20
JJin91: posts the ante 2500
CrazyCatGent: posts the ante 2500
Batzz88: posts the ante 2500
narew: posts the ante 2500
YourRobotDad: posts the ante 2500
YourRobotDad: posts small blind 10000
JJin91: posts big blind 20000
*** HOLE CARDS ***
Dealt to JJin91 [Ks Ah]
CrazyCatGent: folds=20
Batzz88: folds=20
narew: folds=20
YourRobotDad: folds=20
Uncalled bet (10000) returned to JJin91
JJin91 collected 32500 from pot
JJin91: doesn't show hand=20
*** SUMMARY ***
Total pot 32500 | Rake 0=20
Seat 1: JJin91 (big blind) collected (32500)
Seat 2: CrazyCatGent folded before Flop (didn't bet)
Seat 3: Batzz88 folded before Flop (didn't bet)
Seat 5: narew (button) folded before Flop (didn't bet)
Seat 6: YourRobotDad (small blind) folded before Flop


*********** # 336 **************
PokerStars Hand #175485669306: Tournament #1701793695, $9.10+$0.90 USD =
Hold'em No Limit - Level XXXIII (10000/20000) - 2017/09/24 21:17:18 ET
Table '1701793695 9' 6-max Seat #6 is the button
Seat 1: JJin91 (1415781 in chips)=20
Seat 2: CrazyCatGent (270420 in chips)=20
Seat 3: Batzz88 (774766 in chips)=20
Seat 5: narew (886828 in chips)=20
Seat 6: YourRobotDad (172435 in chips)=20
JJin91: posts the ante 2500
CrazyCatGent: posts the ante 2500
Batzz88: posts the ante 2500
narew: posts the ante 2500
YourRobotDad: posts the ante 2500
JJin91: posts small blind 10000
CrazyCatGent: posts big blind 20000
*** HOLE CARDS ***
Dealt to JJin91 [8s 7c]
Batzz88: folds=20
narew: folds=20
YourRobotDad: raises 149935 to 169935 and is all-in
JJin91: folds=20
CrazyCatGent: folds=20
Uncalled bet (149935) returned to YourRobotDad
YourRobotDad collected 62500 from pot
*** SUMMARY ***
Total pot 62500 | Rake 0=20
Seat 1: JJin91 (small blind) folded before Flop
Seat 2: CrazyCatGent (big blind) folded before Flop
Seat 3: Batzz88 folded before Flop (didn't bet)
Seat 5: narew folded before Flop (didn't bet)
Seat 6: YourRobotDad (button) collected (62500)


*********** # 337 **************
PokerStars Hand #175485669484: Tournament #1701793695, $9.10+$0.90 USD =
Hold'em No Limit - Level XXXIII (10000/20000) - 2017/09/24 21:17:53 ET
Table '1701793695 9' 6-max Seat #1 is the button
Seat 1: JJin91 (1403281 in chips)=20
Seat 2: CrazyCatGent (247920 in chips)=20
Seat 3: Batzz88 (772266 in chips)=20
Seat 5: narew (884328 in chips)=20
Seat 6: YourRobotDad (212435 in chips)=20
JJin91: posts the ante 2500
CrazyCatGent: posts the ante 2500
Batzz88: posts the ante 2500
narew: posts the ante 2500
YourRobotDad: posts the ante 2500
CrazyCatGent: posts small blind 10000
Batzz88: posts big blind 20000
*** HOLE CARDS ***
Dealt to JJin91 [Jc Kc]
narew: raises 25000 to 45000
YourRobotDad: folds=20
JJin91: raises 68424 to 113424
CrazyCatGent: folds=20
Batzz88 has timed out
Batzz88: folds=20
Batzz88 is sitting out
Batzz88 has returned
narew: calls 68424
*** FLOP *** [4s Qs 3c]
narew is disconnected=20
narew has timed out while disconnected
narew: checks=20
JJin91: bets 99659
narew has timed out while disconnected
narew: folds=20
Uncalled bet (99659) returned to JJin91
narew is sitting out
JJin91 collected 269348 from pot
JJin91: doesn't show hand=20
*** SUMMARY ***
Total pot 269348 | Rake 0=20
Board [4s Qs 3c]
Seat 1: JJin91 (button) collected (269348)
Seat 2: CrazyCatGent (small blind) folded before Flop
Seat 3: Batzz88 (big blind) folded before Flop
Seat 5: narew folded on the Flop
Seat 6: YourRobotDad folded before Flop (didn't bet)


*********** # 338 **************
PokerStars Hand #175485784107: Tournament #1701793695, $9.10+$0.90 USD =
Hold'em No Limit - Level XXXIII (10000/20000) - 2017/09/24 21:20:15 ET
Table '1701793695 9' 6-max Seat #2 is the button
Seat 1: JJin91 (1556705 in chips)=20
Seat 2: CrazyCatGent (235420 in chips)=20
Seat 3: Batzz88 (749766 in chips)=20
Seat 5: narew (768404 in chips) is sitting out
Seat 6: YourRobotDad (209935 in chips)=20
JJin91: posts the ante 2500
CrazyCatGent: posts the ante 2500
Batzz88: posts the ante 2500
narew: posts the ante 2500
YourRobotDad: posts the ante 2500
Batzz88: posts small blind 10000
narew: posts big blind 20000
*** HOLE CARDS ***
Dealt to JJin91 [Qs Qh]
YourRobotDad: folds=20
JJin91: raises 23400 to 43400
CrazyCatGent: folds=20
Batzz88: folds=20
narew: folds=20
Uncalled bet (23400) returned to JJin91
JJin91 collected 62500 from pot
JJin91: doesn't show hand=20
*** SUMMARY ***
Total pot 62500 | Rake 0=20
Seat 1: JJin91 collected (62500)
Seat 2: CrazyCatGent (button) folded before Flop (didn't bet)
Seat 3: Batzz88 (small blind) folded before Flop
Seat 5: narew (big blind) folded before Flop
Seat 6: YourRobotDad folded before Flop (didn't bet)


*********** # 339 **************
PokerStars Hand #175485784205: Tournament #1701793695, $9.10+$0.90 USD =
Hold'em No Limit - Level XXXIII (10000/20000) - 2017/09/24 21:20:35 ET
Table '1701793695 9' 6-max Seat #3 is the button
Seat 1: JJin91 (1596705 in chips)=20
Seat 2: CrazyCatGent (232920 in chips)=20
Seat 3: Batzz88 (737266 in chips)=20
Seat 5: narew (745904 in chips) is sitting out
Seat 6: YourRobotDad (207435 in chips)=20
JJin91: posts the ante 2500
CrazyCatGent: posts the ante 2500
Batzz88: posts the ante 2500
narew: posts the ante 2500
YourRobotDad: posts the ante 2500
narew: posts small blind 10000
YourRobotDad: posts big blind 20000
*** HOLE CARDS ***
Dealt to JJin91 [Ad Jd]
JJin91: raises 23400 to 43400
CrazyCatGent: folds=20
Batzz88: calls 43400
narew: folds=20
YourRobotDad: folds=20
*** FLOP *** [Kd 3c 7s]
JJin91: checks=20
Batzz88: checks=20
*** TURN *** [Kd 3c 7s] [6d]
JJin91: bets 65943
Batzz88: folds=20
Uncalled bet (65943) returned to JJin91
JJin91 collected 129300 from pot
JJin91: doesn't show hand=20
*** SUMMARY ***
Total pot 129300 | Rake 0=20
Board [Kd 3c 7s 6d]
Seat 1: JJin91 collected (129300)
Seat 2: CrazyCatGent folded before Flop (didn't bet)
Seat 3: Batzz88 (button) folded on the Turn
Seat 5: narew (small blind) folded before Flop
Seat 6: YourRobotDad (big blind) folded before Flop


*********** # 340 **************
PokerStars Hand #175485784535: Tournament #1701793695, $9.10+$0.90 USD =
Hold'em No Limit - Level XXXIII (10000/20000) - 2017/09/24 21:21:41 ET
Table '1701793695 9' 6-max Seat #5 is the button
Seat 1: JJin91 (1680105 in chips)=20
Seat 2: CrazyCatGent (230420 in chips)=20
Seat 3: Batzz88 (691366 in chips)=20
Seat 5: narew (733404 in chips) is sitting out
Seat 6: YourRobotDad (184935 in chips)=20
JJin91: posts the ante 2500
CrazyCatGent: posts the ante 2500
Batzz88: posts the ante 2500
narew: posts the ante 2500
YourRobotDad: posts the ante 2500
YourRobotDad: posts small blind 10000
JJin91: posts big blind 20000
*** HOLE CARDS ***
Dealt to JJin91 [6c Qc]
CrazyCatGent: raises 207920 to 227920 and is all-in
Batzz88: folds=20
narew: folds=20
YourRobotDad: folds=20
JJin91: folds=20
Uncalled bet (207920) returned to CrazyCatGent
CrazyCatGent collected 62500 from pot
CrazyCatGent: doesn't show hand=20
*** SUMMARY ***
Total pot 62500 | Rake 0=20
Seat 1: JJin91 (big blind) folded before Flop
Seat 2: CrazyCatGent collected (62500)
Seat 3: Batzz88 folded before Flop (didn't bet)
Seat 5: narew (button) folded before Flop (didn't bet)
Seat 6: YourRobotDad (small blind) folded before Flop


*********** # 341 **************
PokerStars Hand #175485784624: Tournament #1701793695, $9.10+$0.90 USD =
Hold'em No Limit - Level XXXIII (10000/20000) - 2017/09/24 21:21:58 ET
Table '1701793695 9' 6-max Seat #6 is the button
Seat 1: JJin91 (1657605 in chips)=20
Seat 2: CrazyCatGent (270420 in chips)=20
Seat 3: Batzz88 (688866 in chips)=20
Seat 5: narew (730904 in chips) is sitting out
Seat 6: YourRobotDad (172435 in chips)=20
JJin91: posts the ante 2500
CrazyCatGent: posts the ante 2500
Batzz88: posts the ante 2500
narew: posts the ante 2500
YourRobotDad: posts the ante 2500
JJin91: posts small blind 10000
CrazyCatGent: posts big blind 20000
*** HOLE CARDS ***
Dealt to JJin91 [Kh 6d]
Batzz88: raises 20000 to 40000
narew: folds=20
YourRobotDad: folds=20
JJin91: folds=20
CrazyCatGent: calls 20000
*** FLOP *** [9h 6h 7s]
CrazyCatGent: checks=20
Batzz88: checks=20
*** TURN *** [9h 6h 7s] [3h]
CrazyCatGent: checks=20
Batzz88: bets 57688
narew has returned
CrazyCatGent: folds=20
Uncalled bet (57688) returned to Batzz88
Batzz88 collected 102500 from pot
Batzz88: doesn't show hand=20
*** SUMMARY ***
Total pot 102500 | Rake 0=20
Board [9h 6h 7s 3h]
Seat 1: JJin91 (small blind) folded before Flop
Seat 2: CrazyCatGent (big blind) folded on the Turn
Seat 3: Batzz88 collected (102500)
Seat 5: narew folded before Flop (didn't bet)
Seat 6: YourRobotDad (button) folded before Flop (didn't bet)


*********** # 342 **************
PokerStars Hand #175485784946: Tournament #1701793695, $9.10+$0.90 USD =
Hold'em No Limit - Level XXXIII (10000/20000) - 2017/09/24 21:23:04 ET
Table '1701793695 9' 6-max Seat #1 is the button
Seat 1: JJin91 (1645105 in chips)=20
Seat 2: CrazyCatGent (227920 in chips)=20
Seat 3: Batzz88 (748866 in chips)=20
Seat 5: narew (728404 in chips)=20
Seat 6: YourRobotDad (169935 in chips)=20
JJin91: posts the ante 2500
CrazyCatGent: posts the ante 2500
Batzz88: posts the ante 2500
narew: posts the ante 2500
YourRobotDad: posts the ante 2500
CrazyCatGent: posts small blind 10000
Batzz88: posts big blind 20000
*** HOLE CARDS ***
Dealt to JJin91 [8d 9s]
narew: folds=20
YourRobotDad: raises 40000 to 60000
JJin91: folds=20
CrazyCatGent: folds=20
Batzz88: folds=20
Uncalled bet (40000) returned to YourRobotDad
YourRobotDad collected 62500 from pot
*** SUMMARY ***
Total pot 62500 | Rake 0=20
Seat 1: JJin91 (button) folded before Flop (didn't bet)
Seat 2: CrazyCatGent (small blind) folded before Flop
Seat 3: Batzz88 (big blind) folded before Flop
Seat 5: narew folded before Flop (didn't bet)
Seat 6: YourRobotDad collected (62500)


*********** # 343 **************
PokerStars Hand #175485785079: Tournament #1701793695, $9.10+$0.90 USD =
Hold'em No Limit - Level XXXIII (10000/20000) - 2017/09/24 21:23:31 ET
Table '1701793695 9' 6-max Seat #2 is the button
Seat 1: JJin91 (1642605 in chips)=20
Seat 2: CrazyCatGent (215420 in chips)=20
Seat 3: Batzz88 (726366 in chips)=20
Seat 5: narew (725904 in chips)=20
Seat 6: YourRobotDad (209935 in chips)=20
JJin91: posts the ante 2500
CrazyCatGent: posts the ante 2500
Batzz88: posts the ante 2500
narew: posts the ante 2500
YourRobotDad: posts the ante 2500
Batzz88: posts small blind 10000
narew: posts big blind 20000
*** HOLE CARDS ***
Dealt to JJin91 [9h Qh]
YourRobotDad: folds=20
JJin91: raises 23400 to 43400
CrazyCatGent: folds=20
Batzz88: folds=20
narew: calls 23400
*** FLOP *** [Th 4s 5d]
narew: checks=20
JJin91: checks=20
*** TURN *** [Th 4s 5d] [Ah]
narew: checks=20
JJin91: checks=20
*** RIVER *** [Th 4s 5d Ah] [Jh]
narew: checks=20
YourRobotDad is disconnected=20
JJin91: bets 88823
narew: calls 88823
*** SHOW DOWN ***
JJin91: shows [9h Qh] (a flush, Ace high)
narew: mucks hand=20
JJin91 collected 286946 from pot
*** SUMMARY ***
Total pot 286946 | Rake 0=20
Board [Th 4s 5d Ah Jh]
Seat 1: JJin91 showed [9h Qh] and won (286946) with a flush, Ace high
Seat 2: CrazyCatGent (button) folded before Flop (didn't bet)
Seat 3: Batzz88 (small blind) folded before Flop
Seat 5: narew (big blind) mucked [7d 7h]
Seat 6: YourRobotDad folded before Flop (didn't bet)


*********** # 344 **************
PokerStars Hand #175485785369: Tournament #1701793695, $9.10+$0.90 USD =
Hold'em No Limit - Level XXXIV (12500/25000) - 2017/09/24 21:24:30 ET
Table '1701793695 9' 6-max Seat #3 is the button
Seat 1: JJin91 (1794828 in chips)=20
Seat 2: CrazyCatGent (212920 in chips)=20
Seat 3: Batzz88 (713866 in chips)=20
Seat 5: narew (591181 in chips)=20
Seat 6: YourRobotDad (207435 in chips)=20
JJin91: posts the ante 3125
CrazyCatGent: posts the ante 3125
Batzz88: posts the ante 3125
narew: posts the ante 3125
YourRobotDad: posts the ante 3125
narew: posts small blind 12500
YourRobotDad: posts big blind 25000
*** HOLE CARDS ***
Dealt to JJin91 [2h 7c]
JJin91: folds=20
CrazyCatGent: folds=20
narew said, "nice"
Batzz88: raises 25000 to 50000
narew: folds=20
YourRobotDad: folds=20
Uncalled bet (25000) returned to Batzz88
Batzz88 collected 78125 from pot
Batzz88: doesn't show hand=20
*** SUMMARY ***
Total pot 78125 | Rake 0=20
Seat 1: JJin91 folded before Flop (didn't bet)
Seat 2: CrazyCatGent folded before Flop (didn't bet)
Seat 3: Batzz88 (button) collected (78125)
Seat 5: narew (small blind) folded before Flop
Seat 6: YourRobotDad (big blind) folded before Flop


*********** # 345 **************
PokerStars Hand #175485785536: Tournament #1701793695, $9.10+$0.90 USD =
Hold'em No Limit - Level XXXIV (12500/25000) - 2017/09/24 21:25:04 ET
Table '1701793695 9' 6-max Seat #5 is the button
Seat 1: JJin91 (1791703 in chips)=20
Seat 3: Batzz88 (763866 in chips)=20
Seat 5: narew (575556 in chips)=20
Seat 6: YourRobotDad (179310 in chips)=20
JJin91: posts the ante 3125
Batzz88: posts the ante 3125
narew: posts the ante 3125
YourRobotDad: posts the ante 3125
YourRobotDad: posts small blind 12500
JJin91: posts big blind 25000
*** HOLE CARDS ***
Dealt to JJin91 [6d 9h]
Batzz88: folds=20
narew: folds=20
YourRobotDad is connected=20
YourRobotDad: calls 12500
JJin91: checks=20
*** FLOP *** [8s 7c Th]
YourRobotDad: bets 25000
JJin91: calls 25000
*** TURN *** [8s 7c Th] [Ah]
YourRobotDad: bets 50000
JJin91: raises 212500 to 262500
YourRobotDad: folds=20
Uncalled bet (212500) returned to JJin91
JJin91 collected 212500 from pot
JJin91: doesn't show hand=20
*** SUMMARY ***
Total pot 212500 | Rake 0=20
Board [8s 7c Th Ah]
Seat 1: JJin91 (big blind) collected (212500)
Seat 3: Batzz88 folded before Flop (didn't bet)
Seat 5: narew (button) folded before Flop (didn't bet)
Seat 6: YourRobotDad (small blind) folded on the Turn


*********** # 346 **************
PokerStars Hand #175485785916: Tournament #1701793695, $9.10+$0.90 USD =
Hold'em No Limit - Level XXXIV (12500/25000) - 2017/09/24 21:26:26 ET
Table '1701793695 9' 6-max Seat #6 is the button
Seat 1: JJin91 (1901078 in chips)=20
Seat 3: Batzz88 (760741 in chips)=20
Seat 5: narew (572431 in chips)=20
Seat 6: YourRobotDad (76185 in chips)=20
JJin91: posts the ante 3125
Batzz88: posts the ante 3125
narew: posts the ante 3125
YourRobotDad: posts the ante 3125
JJin91: posts small blind 12500
Batzz88: posts big blind 25000
*** HOLE CARDS ***
Dealt to JJin91 [Qs 3c]
narew: raises 50000 to 75000
YourRobotDad: folds=20
JJin91: folds=20
Batzz88: calls 50000
*** FLOP *** [3s Qc Kc]
Batzz88: checks=20
narew: bets 50000
Batzz88: folds=20
Uncalled bet (50000) returned to narew
narew collected 175000 from pot
narew: doesn't show hand=20
*** SUMMARY ***
Total pot 175000 | Rake 0=20
Board [3s Qc Kc]
Seat 1: JJin91 (small blind) folded before Flop
Seat 3: Batzz88 (big blind) folded on the Flop
Seat 5: narew collected (175000)
Seat 6: YourRobotDad (button) folded before Flop (didn't bet)


*********** # 347 **************
PokerStars Hand #175485786133: Tournament #1701793695, $9.10+$0.90 USD =
Hold'em No Limit - Level XXXIV (12500/25000) - 2017/09/24 21:27:14 ET
Table '1701793695 9' 6-max Seat #1 is the button
Seat 1: JJin91 (1885453 in chips)=20
Seat 2: Warrior00086 (1516595 in chips) out of hand (moved from another=
 table into small blind)
Seat 3: Batzz88 (682616 in chips)=20
Seat 4: craxkedu (991091 in chips)=20
Seat 5: narew (669306 in chips)=20
Seat 6: YourRobotDad (73060 in chips)=20
JJin91: posts the ante 3125
Batzz88: posts the ante 3125
craxkedu: posts the ante 3125
narew: posts the ante 3125
YourRobotDad: posts the ante 3125
Batzz88: posts small blind 12500
craxkedu: posts big blind 25000
*** HOLE CARDS ***
Dealt to JJin91 [7c 3c]
narew: folds=20
YourRobotDad: raises 44935 to 69935 and is all-in
JJin91: folds=20
Batzz88: folds=20
craxkedu: folds=20
Uncalled bet (44935) returned to YourRobotDad
YourRobotDad collected 78125 from pot
*** SUMMARY ***
Total pot 78125 | Rake 0=20
Seat 1: JJin91 (button) folded before Flop (didn't bet)
Seat 3: Batzz88 (small blind) folded before Flop
Seat 4: craxkedu (big blind) folded before Flop
Seat 5: narew folded before Flop (didn't bet)
Seat 6: YourRobotDad collected (78125)


*********** # 348 **************
PokerStars Hand #175485786224: Tournament #1701793695, $9.10+$0.90 USD =
Hold'em No Limit - Level XXXIV (12500/25000) - 2017/09/24 21:27:33 ET
Table '1701793695 9' 6-max Seat #3 is the button
Seat 1: JJin91 (1882328 in chips)=20
Seat 2: Warrior00086 (1516595 in chips)=20
Seat 3: Batzz88 (666991 in chips)=20
Seat 4: craxkedu (962966 in chips)=20
Seat 5: narew (666181 in chips)=20
Seat 6: YourRobotDad (123060 in chips)=20
JJin91: posts the ante 3125
Warrior00086: posts the ante 3125
Batzz88: posts the ante 3125
craxkedu: posts the ante 3125
narew: posts the ante 3125
YourRobotDad: posts the ante 3125
craxkedu: posts small blind 12500
narew: posts big blind 25000
*** HOLE CARDS ***
Dealt to JJin91 [4h 5c]
YourRobotDad: folds=20
JJin91: folds=20
Warrior00086: raises 25000 to 50000
Batzz88: raises 75000 to 125000
craxkedu: folds=20
narew has timed out
narew: folds=20
narew is sitting out
narew has returned
Warrior00086: calls 75000
*** FLOP *** [5h 2c 9s]
Warrior00086: checks=20
Batzz88: bets 125000
Warrior00086: folds=20
Uncalled bet (125000) returned to Batzz88
Batzz88 collected 306250 from pot
Batzz88: doesn't show hand=20
*** SUMMARY ***
Total pot 306250 | Rake 0=20
Board [5h 2c 9s]
Seat 1: JJin91 folded before Flop (didn't bet)
Seat 2: Warrior00086 folded on the Flop
Seat 3: Batzz88 (button) collected (306250)
Seat 4: craxkedu (small blind) folded before Flop
Seat 5: narew (big blind) folded before Flop
Seat 6: YourRobotDad folded before Flop (didn't bet)


*********** # 349 **************
PokerStars Hand #175485786716: Tournament #1701793695, $9.10+$0.90 USD =
Hold'em No Limit - Level XXXIV (12500/25000) - 2017/09/24 21:29:16 ET
Table '1701793695 9' 6-max Seat #4 is the button
Seat 1: JJin91 (1879203 in chips)=20
Seat 2: Warrior00086 (1388470 in chips)=20
Seat 3: Batzz88 (845116 in chips)=20
Seat 4: craxkedu (947341 in chips)=20
Seat 5: narew (638056 in chips)=20
Seat 6: YourRobotDad (119935 in chips)=20
JJin91: posts the ante 3125
Warrior00086: posts the ante 3125
Batzz88: posts the ante 3125
craxkedu: posts the ante 3125
narew: posts the ante 3125
YourRobotDad: posts the ante 3125
narew: posts small blind 12500
YourRobotDad: posts big blind 25000
*** HOLE CARDS ***
Dealt to JJin91 [4s 8s]
JJin91: folds=20
Warrior00086: folds=20
Batzz88: folds=20
craxkedu is disconnected=20
craxkedu is connected=20
craxkedu: folds=20
narew: calls 12500
YourRobotDad: checks=20
*** FLOP *** [Td 3s 6d]
narew: bets 25000
YourRobotDad: folds=20
Uncalled bet (25000) returned to narew
narew collected 68750 from pot
narew: doesn't show hand=20
*** SUMMARY ***
Total pot 68750 | Rake 0=20
Board [Td 3s 6d]
Seat 1: JJin91 folded before Flop (didn't bet)
Seat 2: Warrior00086 folded before Flop (didn't bet)
Seat 3: Batzz88 folded before Flop (didn't bet)
Seat 4: craxkedu (button) folded before Flop (didn't bet)
Seat 5: narew (small blind) collected (68750)
Seat 6: YourRobotDad (big blind) folded on the Flop


*********** # 350 **************
PokerStars Hand #175485787068: Tournament #1701793695, $9.10+$0.90 USD =
Hold'em No Limit - Level XXXIV (12500/25000) - 2017/09/24 21:30:24 ET
Table '1701793695 9' 6-max Seat #5 is the button
Seat 1: JJin91 (1876078 in chips)=20
Seat 2: Warrior00086 (1385345 in chips)=20
Seat 3: Batzz88 (841991 in chips)=20
Seat 4: craxkedu (944216 in chips)=20
Seat 5: narew (678681 in chips)=20
Seat 6: YourRobotDad (91810 in chips)=20
JJin91: posts the ante 3125
Warrior00086: posts the ante 3125
Batzz88: posts the ante 3125
craxkedu: posts the ante 3125
narew: posts the ante 3125
YourRobotDad: posts the ante 3125
YourRobotDad: posts small blind 12500
JJin91: posts big blind 25000
*** HOLE CARDS ***
Dealt to JJin91 [5d 9h]
Warrior00086: raises 25000 to 50000
Batzz88: folds=20
craxkedu: folds=20
narew: folds=20
YourRobotDad: raises 38685 to 88685 and is all-in
JJin91: folds=20
Warrior00086: calls 38685
*** FLOP *** [Jd 6h 7c]
*** TURN *** [Jd 6h 7c] [9s]
*** RIVER *** [Jd 6h 7c 9s] [6d]
*** SHOW DOWN ***
YourRobotDad: shows [8c 8h] (two pair, Eights and Sixes)
Warrior00086: shows [Qc Ts] (a pair of Sixes)
YourRobotDad collected 221120 from pot
*** SUMMARY ***
Total pot 221120 | Rake 0=20
Board [Jd 6h 7c 9s 6d]
Seat 1: JJin91 (big blind) folded before Flop
Seat 2: Warrior00086 showed [Qc Ts] and lost with a pair of Sixes
Seat 3: Batzz88 folded before Flop (didn't bet)
Seat 4: craxkedu folded before Flop (didn't bet)
Seat 5: narew (button) folded before Flop (didn't bet)
Seat 6: YourRobotDad (small blind) showed [8c 8h] and won (221120) with=
 two pair, Eights and Sixes


*********** # 351 **************
PokerStars Hand #175485787257: Tournament #1701793695, $9.10+$0.90 USD =
Hold'em No Limit - Level XXXIV (12500/25000) - 2017/09/24 21:31:04 ET
Table '1701793695 9' 6-max Seat #6 is the button
Seat 1: JJin91 (1847953 in chips)=20
Seat 2: Warrior00086 (1293535 in chips)=20
Seat 3: Batzz88 (838866 in chips)=20
Seat 4: craxkedu (941091 in chips)=20
Seat 5: narew (675556 in chips)=20
Seat 6: YourRobotDad (221120 in chips)=20
JJin91: posts the ante 3125
Warrior00086: posts the ante 3125
Batzz88: posts the ante 3125
craxkedu: posts the ante 3125
narew: posts the ante 3125
YourRobotDad: posts the ante 3125
JJin91: posts small blind 12500
Warrior00086: posts big blind 25000
*** HOLE CARDS ***
Dealt to JJin91 [Js Kh]
Batzz88: raises 25000 to 50000
craxkedu: folds=20
narew: folds=20
YourRobotDad: folds=20
JJin91: calls 37500
Warrior00086: folds=20
*** FLOP *** [7c Ts Qh]
JJin91: bets 73313
Batzz88: calls 73313
*** TURN *** [7c Ts Qh] [2c]
JJin91: bets 156626
Batzz88: calls 156626
*** RIVER *** [7c Ts Qh 2c] [Th]
JJin91: bets 433212
Batzz88: calls 433212
*** SHOW DOWN ***
JJin91: shows [Js Kh] (a pair of Tens)
Batzz88: shows [Jc Qd] (two pair, Queens and Tens)
Batzz88 collected 1470052 from pot
*** SUMMARY ***
Total pot 1470052 | Rake 0=20
Board [7c Ts Qh 2c Th]
Seat 1: JJin91 (small blind) showed [Js Kh] and lost with a pair of Tens
Seat 2: Warrior00086 (big blind) folded before Flop
Seat 3: Batzz88 showed [Jc Qd] and won (1470052) with two pair, Queens =
and Tens
Seat 4: craxkedu folded before Flop (didn't bet)
Seat 5: narew folded before Flop (didn't bet)
Seat 6: YourRobotDad (button) folded before Flop (didn't bet)


*********** # 352 **************
PokerStars Hand #175485787736: Tournament #1701793695, $9.10+$0.90 USD =
Hold'em No Limit - Level XXXIV (12500/25000) - 2017/09/24 21:32:39 ET
Table '1701793695 9' 6-max Seat #1 is the button
Seat 1: JJin91 (1131677 in chips)=20
Seat 2: Warrior00086 (1265410 in chips)=20
Seat 3: Batzz88 (1592642 in chips)=20
Seat 4: craxkedu (937966 in chips)=20
Seat 5: narew (672431 in chips)=20
Seat 6: YourRobotDad (217995 in chips)=20
JJin91: posts the ante 3125
Warrior00086: posts the ante 3125
Batzz88: posts the ante 3125
craxkedu: posts the ante 3125
narew: posts the ante 3125
YourRobotDad: posts the ante 3125
Warrior00086: posts small blind 12500
Batzz88: posts big blind 25000
*** HOLE CARDS ***
Dealt to JJin91 [8h 5s]
craxkedu: folds=20
JJin91 said, "nh"
narew: folds=20
YourRobotDad: folds=20
JJin91: folds=20
Warrior00086: folds=20
Uncalled bet (12500) returned to Batzz88
Batzz88 collected 43750 from pot
Batzz88: doesn't show hand=20
*** SUMMARY ***
Total pot 43750 | Rake 0=20
Seat 1: JJin91 (button) folded before Flop (didn't bet)
Seat 2: Warrior00086 (small blind) folded before Flop
Seat 3: Batzz88 (big blind) collected (43750)
Seat 4: craxkedu folded before Flop (didn't bet)
Seat 5: narew folded before Flop (didn't bet)
Seat 6: YourRobotDad folded before Flop (didn't bet)


*********** # 353 **************
PokerStars Hand #175485787818: Tournament #1701793695, $9.10+$0.90 USD =
Hold'em No Limit - Level XXXIV (12500/25000) - 2017/09/24 21:32:59 ET
Table '1701793695 9' 6-max Seat #2 is the button
Seat 1: JJin91 (1128552 in chips)=20
Seat 2: Warrior00086 (1249785 in chips)=20
Seat 3: Batzz88 (1620767 in chips)=20
Seat 4: craxkedu (934841 in chips)=20
Seat 5: narew (669306 in chips)=20
Seat 6: YourRobotDad (214870 in chips)=20
JJin91: posts the ante 3125
Warrior00086: posts the ante 3125
Batzz88: posts the ante 3125
craxkedu: posts the ante 3125
narew: posts the ante 3125
YourRobotDad: posts the ante 3125
Batzz88: posts small blind 12500
craxkedu: posts big blind 25000
*** HOLE CARDS ***
Dealt to JJin91 [Ts 8h]
narew: folds=20
YourRobotDad: folds=20
JJin91: folds=20
Warrior00086: folds=20
Batzz88: calls 12500
craxkedu: checks=20
*** FLOP *** [Kh 9c 8c]
Batzz88: checks=20
craxkedu: bets 25000
Batzz88: calls 25000
*** TURN *** [Kh 9c 8c] [2c]
Batzz88: checks=20
craxkedu: checks=20
*** RIVER *** [Kh 9c 8c 2c] [7s]
Batzz88: checks=20
craxkedu: checks=20
*** SHOW DOWN ***
Batzz88: shows [Qs 8d] (a pair of Eights)
craxkedu: mucks hand=20
Batzz88 collected 118750 from pot
*** SUMMARY ***
Total pot 118750 | Rake 0=20
Board [Kh 9c 8c 2c 7s]
Seat 1: JJin91 folded before Flop (didn't bet)
Seat 2: Warrior00086 (button) folded before Flop (didn't bet)
Seat 3: Batzz88 (small blind) showed [Qs 8d] and won (118750) with a pa=
ir of Eights
Seat 4: craxkedu (big blind) mucked [Th 7d]
Seat 5: narew folded before Flop (didn't bet)
Seat 6: YourRobotDad folded before Flop (didn't bet)


*********** # 354 **************
PokerStars Hand #175485788052: Tournament #1701793695, $9.10+$0.90 USD =
Hold'em No Limit - Level XXXV (15000/30000) - 2017/09/24 21:33:48 ET
Table '1701793695 9' 6-max Seat #3 is the button
Seat 1: JJin91 (1125427 in chips)=20
Seat 2: Warrior00086 (1246660 in chips)=20
Seat 3: Batzz88 (1686392 in chips)=20
Seat 4: craxkedu (881716 in chips)=20
Seat 5: narew (666181 in chips)=20
Seat 6: YourRobotDad (211745 in chips)=20
JJin91: posts the ante 3750
Warrior00086: posts the ante 3750
Batzz88: posts the ante 3750
craxkedu: posts the ante 3750
narew: posts the ante 3750
YourRobotDad: posts the ante 3750
craxkedu: posts small blind 15000
narew: posts big blind 30000
*** HOLE CARDS ***
Dealt to JJin91 [3d Kd]
YourRobotDad: folds=20
JJin91: folds=20
Warrior00086: folds=20
Batzz88: raises 30000 to 60000
craxkedu: folds=20
narew: calls 30000
*** FLOP *** [7h 9d Qc]
narew: checks=20
Batzz88: checks=20
*** TURN *** [7h 9d Qc] [Ts]
narew: bets 78750
Batzz88: folds=20
Uncalled bet (78750) returned to narew
narew collected 157500 from pot
narew: doesn't show hand=20
*** SUMMARY ***
Total pot 157500 | Rake 0=20
Board [7h 9d Qc Ts]
Seat 1: JJin91 folded before Flop (didn't bet)
Seat 2: Warrior00086 folded before Flop (didn't bet)
Seat 3: Batzz88 (button) folded on the Turn
Seat 4: craxkedu (small blind) folded before Flop
Seat 5: narew (big blind) collected (157500)
Seat 6: YourRobotDad folded before Flop (didn't bet)


*********** # 355 **************
PokerStars Hand #175485788357: Tournament #1701793695, $9.10+$0.90 USD =
Hold'em No Limit - Level XXXV (15000/30000) - 2017/09/24 21:34:50 ET
Table '1701793695 9' 6-max Seat #4 is the button
Seat 1: JJin91 (1121677 in chips)=20
Seat 2: Warrior00086 (1242910 in chips)=20
Seat 3: Batzz88 (1622642 in chips)=20
Seat 4: craxkedu (862966 in chips)=20
Seat 5: narew (759931 in chips)=20
Seat 6: YourRobotDad (207995 in chips)=20
JJin91: posts the ante 3750
Warrior00086: posts the ante 3750
Batzz88: posts the ante 3750
craxkedu: posts the ante 3750
narew: posts the ante 3750
YourRobotDad: posts the ante 3750
narew: posts small blind 15000
YourRobotDad: posts big blind 30000
*** HOLE CARDS ***
Dealt to JJin91 [6h 4d]
JJin91: folds=20
Warrior00086: folds=20
Batzz88: folds=20
craxkedu: folds=20
narew: raises 726181 to 756181 and is all-in
YourRobotDad: folds=20
Uncalled bet (726181) returned to narew
narew collected 82500 from pot
narew: doesn't show hand=20
*** SUMMARY ***
Total pot 82500 | Rake 0=20
Seat 1: JJin91 folded before Flop (didn't bet)
Seat 2: Warrior00086 folded before Flop (didn't bet)
Seat 3: Batzz88 folded before Flop (didn't bet)
Seat 4: craxkedu (button) folded before Flop (didn't bet)
Seat 5: narew (small blind) collected (82500)
Seat 6: YourRobotDad (big blind) folded before Flop


*********** # 356 **************
PokerStars Hand #175485788511: Tournament #1701793695, $9.10+$0.90 USD =
Hold'em No Limit - Level XXXV (15000/30000) - 2017/09/24 21:35:23 ET
Table '1701793695 9' 6-max Seat #5 is the button
Seat 1: JJin91 (1117927 in chips)=20
Seat 2: Warrior00086 (1239160 in chips)=20
Seat 3: Batzz88 (1618892 in chips)=20
Seat 4: craxkedu (859216 in chips)=20
Seat 5: narew (808681 in chips)=20
Seat 6: YourRobotDad (174245 in chips)=20
JJin91: posts the ante 3750
Warrior00086: posts the ante 3750
Batzz88: posts the ante 3750
craxkedu: posts the ante 3750
narew: posts the ante 3750
YourRobotDad: posts the ante 3750
YourRobotDad: posts small blind 15000
JJin91: posts big blind 30000
*** HOLE CARDS ***
Dealt to JJin91 [4d Ts]
Warrior00086: folds=20
Batzz88: folds=20
craxkedu: folds=20
narew: folds=20
YourRobotDad: folds=20
Uncalled bet (15000) returned to JJin91
JJin91 collected 52500 from pot
JJin91: doesn't show hand=20
*** SUMMARY ***
Total pot 52500 | Rake 0=20
Seat 1: JJin91 (big blind) collected (52500)
Seat 2: Warrior00086 folded before Flop (didn't bet)
Seat 3: Batzz88 folded before Flop (didn't bet)
Seat 4: craxkedu folded before Flop (didn't bet)
Seat 5: narew (button) folded before Flop (didn't bet)
Seat 6: YourRobotDad (small blind) folded before Flop


*********** # 357 **************
PokerStars Hand #175485788652: Tournament #1701793695, $9.10+$0.90 USD =
Hold'em No Limit - Level XXXV (15000/30000) - 2017/09/24 21:35:50 ET
Table '1701793695 9' 6-max Seat #6 is the button
Seat 1: JJin91 (1151677 in chips)=20
Seat 2: Warrior00086 (1235410 in chips)=20
Seat 3: Batzz88 (1615142 in chips)=20
Seat 4: craxkedu (855466 in chips)=20
Seat 5: narew (804931 in chips)=20
Seat 6: YourRobotDad (155495 in chips)=20
JJin91: posts the ante 3750
Warrior00086: posts the ante 3750
Batzz88: posts the ante 3750
craxkedu: posts the ante 3750
narew: posts the ante 3750
YourRobotDad: posts the ante 3750
JJin91: posts small blind 15000
Warrior00086: posts big blind 30000
*** HOLE CARDS ***
Dealt to JJin91 [7h 4h]
Batzz88: folds=20
craxkedu: folds=20
narew: folds=20
YourRobotDad: raises 121745 to 151745 and is all-in
JJin91: folds=20
Warrior00086: calls 121745
*** FLOP *** [Jc 3c Td]
*** TURN *** [Jc 3c Td] [9h]
*** RIVER *** [Jc 3c Td 9h] [8h]
*** SHOW DOWN ***
Warrior00086: shows [Kd Kh] (a pair of Kings)
YourRobotDad: shows [Qh Qd] (a straight, Eight to Queen)
YourRobotDad collected 340990 from pot
*** SUMMARY ***
Total pot 340990 | Rake 0=20
Board [Jc 3c Td 9h 8h]
Seat 1: JJin91 (small blind) folded before Flop
Seat 2: Warrior00086 (big blind) showed [Kd Kh] and lost with a pair of=
 Kings
Seat 3: Batzz88 folded before Flop (didn't bet)
Seat 4: craxkedu folded before Flop (didn't bet)
Seat 5: narew folded before Flop (didn't bet)
Seat 6: YourRobotDad (button) showed [Qh Qd] and won (340990) with a st=
raight, Eight to Queen


*********** # 358 **************
PokerStars Hand #175485788774: Tournament #1701793695, $9.10+$0.90 USD =
Hold'em No Limit - Level XXXV (15000/30000) - 2017/09/24 21:36:18 ET
Table '1701793695 9' 6-max Seat #1 is the button
Seat 1: JJin91 (1132927 in chips)=20
Seat 2: Warrior00086 (1079915 in chips)=20
Seat 3: Batzz88 (1611392 in chips)=20
Seat 4: craxkedu (851716 in chips)=20
Seat 5: narew (801181 in chips)=20
Seat 6: YourRobotDad (340990 in chips)=20
JJin91: posts the ante 3750
Warrior00086: posts the ante 3750
Batzz88: posts the ante 3750
craxkedu: posts the ante 3750
narew: posts the ante 3750
YourRobotDad: posts the ante 3750
Warrior00086: posts small blind 15000
Batzz88: posts big blind 30000
*** HOLE CARDS ***
Dealt to JJin91 [3s Jd]
craxkedu: folds=20
narew: folds=20
YourRobotDad: folds=20
JJin91: folds=20
Warrior00086: folds=20
Uncalled bet (15000) returned to Batzz88
Batzz88 collected 52500 from pot
Batzz88: doesn't show hand=20
*** SUMMARY ***
Total pot 52500 | Rake 0=20
Seat 1: JJin91 (button) folded before Flop (didn't bet)
Seat 2: Warrior00086 (small blind) folded before Flop
Seat 3: Batzz88 (big blind) collected (52500)
Seat 4: craxkedu folded before Flop (didn't bet)
Seat 5: narew folded before Flop (didn't bet)
Seat 6: YourRobotDad folded before Flop (didn't bet)


*********** # 359 **************
PokerStars Hand #175485788857: Tournament #1701793695, $9.10+$0.90 USD =
Hold'em No Limit - Level XXXV (15000/30000) - 2017/09/24 21:36:36 ET
Table '1701793695 9' 6-max Seat #2 is the button
Seat 1: JJin91 (1129177 in chips)=20
Seat 2: Warrior00086 (1061165 in chips)=20
Seat 3: Batzz88 (1645142 in chips)=20
Seat 4: craxkedu (847966 in chips)=20
Seat 5: narew (797431 in chips)=20
Seat 6: YourRobotDad (337240 in chips)=20
JJin91: posts the ante 3750
Warrior00086: posts the ante 3750
Batzz88: posts the ante 3750
craxkedu: posts the ante 3750
narew: posts the ante 3750
YourRobotDad: posts the ante 3750
Batzz88: posts small blind 15000
craxkedu: posts big blind 30000
*** HOLE CARDS ***
Dealt to JJin91 [3h 2s]
narew: folds=20
YourRobotDad: folds=20
JJin91: folds=20
Warrior00086: raises 30000 to 60000
Batzz88: folds=20
craxkedu: calls 30000
*** FLOP *** [Ac 5d Ad]
craxkedu: checks=20
Warrior00086: bets 60000
craxkedu: calls 60000
*** TURN *** [Ac 5d Ad] [9c]
craxkedu: checks=20
Warrior00086: bets 90000
craxkedu: raises 450000 to 540000
Warrior00086: folds=20
Uncalled bet (450000) returned to craxkedu
craxkedu collected 457500 from pot
craxkedu: doesn't show hand=20
*** SUMMARY ***
Total pot 457500 | Rake 0=20
Board [Ac 5d Ad 9c]
Seat 1: JJin91 folded before Flop (didn't bet)
Seat 2: Warrior00086 (button) folded on the Turn
Seat 3: Batzz88 (small blind) folded before Flop
Seat 4: craxkedu (big blind) collected (457500)
Seat 5: narew folded before Flop (didn't bet)
Seat 6: YourRobotDad folded before Flop (didn't bet)


*********** # 360 **************
PokerStars Hand #175485789189: Tournament #1701793695, $9.10+$0.90 USD =
Hold'em No Limit - Level XXXV (15000/30000) - 2017/09/24 21:37:49 ET
Table '1701793695 9' 6-max Seat #3 is the button
Seat 1: JJin91 (1125427 in chips)=20
Seat 2: Warrior00086 (847415 in chips)=20
Seat 3: Batzz88 (1626392 in chips)=20
Seat 4: craxkedu (1091716 in chips)=20
Seat 5: narew (793681 in chips)=20
Seat 6: YourRobotDad (333490 in chips)=20
JJin91: posts the ante 3750
Warrior00086: posts the ante 3750
Batzz88: posts the ante 3750
craxkedu: posts the ante 3750
narew: posts the ante 3750
YourRobotDad: posts the ante 3750
craxkedu: posts small blind 15000
narew: posts big blind 30000
*** HOLE CARDS ***
Dealt to JJin91 [8d 8c]
YourRobotDad: folds=20
JJin91: raises 35100 to 65100
Warrior00086: calls 65100
Batzz88: folds=20
craxkedu: folds=20
narew: calls 35100
*** FLOP *** [As 9c 8h]
narew: checks=20
JJin91: bets 118728
Warrior00086: folds=20
narew: folds=20
Uncalled bet (118728) returned to JJin91
JJin91 collected 232800 from pot
JJin91: doesn't show hand=20
*** SUMMARY ***
Total pot 232800 | Rake 0=20
Board [As 9c 8h]
Seat 1: JJin91 collected (232800)
Seat 2: Warrior00086 folded on the Flop
Seat 3: Batzz88 (button) folded before Flop (didn't bet)
Seat 4: craxkedu (small blind) folded before Flop
Seat 5: narew (big blind) folded on the Flop
Seat 6: YourRobotDad folded before Flop (didn't bet)


*********** # 361 **************
PokerStars Hand #175485789473: Tournament #1701793695, $9.10+$0.90 USD =
Hold'em No Limit - Level XXXV (15000/30000) - 2017/09/24 21:38:50 ET
Table '1701793695 9' 6-max Seat #4 is the button
Seat 1: JJin91 (1289377 in chips)=20
Seat 2: Warrior00086 (778565 in chips)=20
Seat 3: Batzz88 (1622642 in chips)=20
Seat 4: craxkedu (1072966 in chips)=20
Seat 5: narew (724831 in chips)=20
Seat 6: YourRobotDad (329740 in chips)=20
JJin91: posts the ante 3750
Warrior00086: posts the ante 3750
Batzz88: posts the ante 3750
craxkedu: posts the ante 3750
narew: posts the ante 3750
YourRobotDad: posts the ante 3750
narew: posts small blind 15000
YourRobotDad: posts big blind 30000
*** HOLE CARDS ***
Dealt to JJin91 [6s 6h]
JJin91: raises 35100 to 65100
Warrior00086: raises 114900 to 180000
Batzz88: folds=20
craxkedu: folds=20
narew: folds=20
YourRobotDad: folds=20
JJin91: folds=20
Uncalled bet (114900) returned to Warrior00086
Warrior00086 collected 197700 from pot
Warrior00086: doesn't show hand=20
*** SUMMARY ***
Total pot 197700 | Rake 0=20
Seat 1: JJin91 folded before Flop
Seat 2: Warrior00086 collected (197700)
Seat 3: Batzz88 folded before Flop (didn't bet)
Seat 4: craxkedu (button) folded before Flop (didn't bet)
Seat 5: narew (small blind) folded before Flop
Seat 6: YourRobotDad (big blind) folded before Flop


*********** # 362 **************
PokerStars Hand #175485789650: Tournament #1701793695, $9.10+$0.90 USD =
Hold'em No Limit - Level XXXV (15000/30000) - 2017/09/24 21:39:24 ET
Table '1701793695 9' 6-max Seat #5 is the button
Seat 1: JJin91 (1220527 in chips)=20
Seat 2: Warrior00086 (907415 in chips)=20
Seat 3: Batzz88 (1618892 in chips)=20
Seat 4: craxkedu (1069216 in chips)=20
Seat 5: narew (706081 in chips)=20
Seat 6: YourRobotDad (295990 in chips)=20
JJin91: posts the ante 3750
Warrior00086: posts the ante 3750
Batzz88: posts the ante 3750
craxkedu: posts the ante 3750
narew: posts the ante 3750
YourRobotDad: posts the ante 3750
YourRobotDad: posts small blind 15000
JJin91: posts big blind 30000
*** HOLE CARDS ***
Dealt to JJin91 [5h Qd]
Warrior00086: folds=20
Batzz88: folds=20
craxkedu: folds=20
narew: calls 30000
YourRobotDad: calls 15000
JJin91: checks=20
*** FLOP *** [6h Js Jc]
YourRobotDad: checks=20
JJin91: checks=20
narew: bets 56250
YourRobotDad: folds=20
JJin91: folds=20
Uncalled bet (56250) returned to narew
narew collected 112500 from pot
narew: doesn't show hand=20
*** SUMMARY ***
Total pot 112500 | Rake 0=20
Board [6h Js Jc]
Seat 1: JJin91 (big blind) folded on the Flop
Seat 2: Warrior00086 folded before Flop (didn't bet)
Seat 3: Batzz88 folded before Flop (didn't bet)
Seat 4: craxkedu folded before Flop (didn't bet)
Seat 5: narew (button) collected (112500)
Seat 6: YourRobotDad (small blind) folded on the Flop


*********** # 363 **************
PokerStars Hand #175486378268: Tournament #1701793695, $9.10+$0.90 USD =
Hold'em No Limit - Level XXXV (15000/30000) - 2017/09/24 21:40:57 ET
Table '1701793695 9' 6-max Seat #6 is the button
Seat 1: JJin91 (1186777 in chips)=20
Seat 2: Warrior00086 (903665 in chips)=20
Seat 3: Batzz88 (1615142 in chips)=20
Seat 4: craxkedu (1065466 in chips)=20
Seat 5: narew (784831 in chips)=20
Seat 6: YourRobotDad (262240 in chips)=20
JJin91: posts the ante 3750
Warrior00086: posts the ante 3750
Batzz88: posts the ante 3750
craxkedu: posts the ante 3750
narew: posts the ante 3750
YourRobotDad: posts the ante 3750
JJin91: posts small blind 15000
Warrior00086: posts big blind 30000
*** HOLE CARDS ***
Dealt to JJin91 [Jc 5c]
Batzz88: folds=20
craxkedu: calls 30000
narew: folds=20
YourRobotDad: folds=20
JJin91: folds=20
Warrior00086: checks=20
*** FLOP *** [7c Qh 9c]
Warrior00086: checks=20
craxkedu: checks=20
*** TURN *** [7c Qh 9c] [Kh]
Warrior00086: checks=20
craxkedu: bets 30000
Warrior00086: folds=20
Uncalled bet (30000) returned to craxkedu
craxkedu collected 97500 from pot
craxkedu: doesn't show hand=20
*** SUMMARY ***
Total pot 97500 | Rake 0=20
Board [7c Qh 9c Kh]
Seat 1: JJin91 (small blind) folded before Flop
Seat 2: Warrior00086 (big blind) folded on the Turn
Seat 3: Batzz88 folded before Flop (didn't bet)
Seat 4: craxkedu collected (97500)
Seat 5: narew folded before Flop (didn't bet)
Seat 6: YourRobotDad (button) folded before Flop (didn't bet)


*********** # 364 **************
PokerStars Hand #175486378480: Tournament #1701793695, $9.10+$0.90 USD =
Hold'em No Limit - Level XXXV (15000/30000) - 2017/09/24 21:41:43 ET
Table '1701793695 9' 6-max Seat #1 is the button
Seat 1: JJin91 (1168027 in chips)=20
Seat 2: Warrior00086 (869915 in chips)=20
Seat 4: craxkedu (1129216 in chips)=20
Seat 5: narew (781081 in chips)=20
Seat 6: YourRobotDad (258490 in chips)=20
JJin91: posts the ante 3750
Warrior00086: posts the ante 3750
craxkedu: posts the ante 3750
narew: posts the ante 3750
YourRobotDad: posts the ante 3750
Warrior00086: posts small blind 15000
craxkedu: posts big blind 30000
*** HOLE CARDS ***
Dealt to JJin91 [2h Ac]
narew: folds=20
YourRobotDad: folds=20
JJin91: raises 35100 to 65100
Warrior00086: folds=20
craxkedu: folds=20
Uncalled bet (35100) returned to JJin91
JJin91 collected 93750 from pot
JJin91: doesn't show hand=20
*** SUMMARY ***
Total pot 93750 | Rake 0=20
Seat 1: JJin91 (button) collected (93750)
Seat 2: Warrior00086 (small blind) folded before Flop
Seat 4: craxkedu (big blind) folded before Flop
Seat 5: narew folded before Flop (didn't bet)
Seat 6: YourRobotDad folded before Flop (didn't bet)


*********** # 365 **************
PokerStars Hand #175486378621: Tournament #1701793695, $9.10+$0.90 USD =
Hold'em No Limit - Level XXXV (15000/30000) - 2017/09/24 21:42:17 ET
Table '1701793695 9' 6-max Seat #2 is the button
Seat 1: JJin91 (1228027 in chips)=20
Seat 2: Warrior00086 (851165 in chips)=20
Seat 4: craxkedu (1095466 in chips)=20
Seat 5: narew (777331 in chips)=20
Seat 6: YourRobotDad (254740 in chips)=20
JJin91: posts the ante 3750
Warrior00086: posts the ante 3750
craxkedu: posts the ante 3750
narew: posts the ante 3750
YourRobotDad: posts the ante 3750
craxkedu: posts small blind 15000
narew: posts big blind 30000
*** HOLE CARDS ***
Dealt to JJin91 [Tc 3c]
YourRobotDad: folds=20
JJin91: folds=20
Warrior00086: folds=20
craxkedu: calls 15000
narew: checks=20
*** FLOP *** [4c 6d Ks]
craxkedu: checks=20
narew: bets 30000
craxkedu: folds=20
Uncalled bet (30000) returned to narew
narew collected 78750 from pot
narew: doesn't show hand=20
*** SUMMARY ***
Total pot 78750 | Rake 0=20
Board [4c 6d Ks]
Seat 1: JJin91 folded before Flop (didn't bet)
Seat 2: Warrior00086 (button) folded before Flop (didn't bet)
Seat 4: craxkedu (small blind) folded on the Flop
Seat 5: narew (big blind) collected (78750)
Seat 6: YourRobotDad folded before Flop (didn't bet)


*********** # 366 **************
PokerStars Hand #175486378828: Tournament #1701793695, $9.10+$0.90 USD =
Hold'em No Limit - Level XXXV (15000/30000) - 2017/09/24 21:43:03 ET
Table '1701793695 9' 6-max Seat #4 is the button
Seat 1: JJin91 (1224277 in chips)=20
Seat 2: Warrior00086 (847415 in chips)=20
Seat 4: craxkedu (1061716 in chips)=20
Seat 5: narew (822331 in chips)=20
Seat 6: YourRobotDad (250990 in chips)=20
JJin91: posts the ante 3750
Warrior00086: posts the ante 3750
craxkedu: posts the ante 3750
narew: posts the ante 3750
YourRobotDad: posts the ante 3750
narew: posts small blind 15000
YourRobotDad: posts big blind 30000
*** HOLE CARDS ***
Dealt to JJin91 [3h 5d]
JJin91: folds=20
Warrior00086: folds=20
craxkedu: folds=20
narew: calls 15000
YourRobotDad: checks=20
*** FLOP *** [Kd 8d 4c]
narew: checks=20
YourRobotDad: bets 30000
narew: folds=20
Uncalled bet (30000) returned to YourRobotDad
YourRobotDad collected 78750 from pot
*** SUMMARY ***
Total pot 78750 | Rake 0=20
Board [Kd 8d 4c]
Seat 1: JJin91 folded before Flop (didn't bet)
Seat 2: Warrior00086 folded before Flop (didn't bet)
Seat 4: craxkedu (button) folded before Flop (didn't bet)
Seat 5: narew (small blind) folded on the Flop
Seat 6: YourRobotDad (big blind) collected (78750)


*********** # 367 **************
PokerStars Hand #175486378976: Tournament #1701793695, $9.10+$0.90 USD =
Hold'em No Limit - Level XXXV (15000/30000) - 2017/09/24 21:43:38 ET
Table '1701793695 9' 6-max Seat #5 is the button
Seat 1: JJin91 (1220527 in chips)=20
Seat 2: Warrior00086 (843665 in chips)=20
Seat 4: craxkedu (1057966 in chips)=20
Seat 5: narew (788581 in chips)=20
Seat 6: YourRobotDad (295990 in chips)=20
JJin91: posts the ante 3750
Warrior00086: posts the ante 3750
craxkedu: posts the ante 3750
narew: posts the ante 3750
YourRobotDad: posts the ante 3750
YourRobotDad: posts small blind 15000
JJin91: posts big blind 30000
*** HOLE CARDS ***
Dealt to JJin91 [3c 2d]
Warrior00086: folds=20
craxkedu: raises 30000 to 60000
narew: folds=20
YourRobotDad: folds=20
JJin91: folds=20
Uncalled bet (30000) returned to craxkedu
craxkedu collected 93750 from pot
craxkedu: doesn't show hand=20
*** SUMMARY ***
Total pot 93750 | Rake 0=20
Seat 1: JJin91 (big blind) folded before Flop
Seat 2: Warrior00086 folded before Flop (didn't bet)
Seat 4: craxkedu collected (93750)
Seat 5: narew (button) folded before Flop (didn't bet)
Seat 6: YourRobotDad (small blind) folded before Flop


*********** # 368 **************
PokerStars Hand #175486379105: Tournament #1701793695, $9.10+$0.90 USD =
Hold'em No Limit - Level XXXVI (17500/35000) - 2017/09/24 21:44:06 ET
Table '1701793695 9' 6-max Seat #6 is the button
Seat 1: JJin91 (1186777 in chips)=20
Seat 2: Warrior00086 (839915 in chips)=20
Seat 4: craxkedu (1117966 in chips)=20
Seat 5: narew (784831 in chips)=20
Seat 6: YourRobotDad (277240 in chips)=20
JJin91: posts the ante 4375
Warrior00086: posts the ante 4375
craxkedu: posts the ante 4375
narew: posts the ante 4375
YourRobotDad: posts the ante 4375
JJin91: posts small blind 17500
Warrior00086: posts big blind 35000
*** HOLE CARDS ***
Dealt to JJin91 [Ks 6d]
craxkedu: folds=20
narew: raises 55000 to 90000
YourRobotDad: folds=20
JJin91: folds=20
Warrior00086: folds=20
Uncalled bet (55000) returned to narew
narew collected 109375 from pot
narew: doesn't show hand=20
*** SUMMARY ***
Total pot 109375 | Rake 0=20
Seat 1: JJin91 (small blind) folded before Flop
Seat 2: Warrior00086 (big blind) folded before Flop
Seat 4: craxkedu folded before Flop (didn't bet)
Seat 5: narew collected (109375)
Seat 6: YourRobotDad (button) folded before Flop (didn't bet)


*********** # 369 **************
PokerStars Hand #175486379212: Tournament #1701793695, $9.10+$0.90 USD =
Hold'em No Limit - Level XXXVI (17500/35000) - 2017/09/24 21:44:31 ET
Table '1701793695 9' 6-max Seat #1 is the button
Seat 1: JJin91 (1164902 in chips)=20
Seat 2: Warrior00086 (800540 in chips)=20
Seat 4: craxkedu (1113591 in chips)=20
Seat 5: narew (854831 in chips)=20
Seat 6: YourRobotDad (272865 in chips)=20
JJin91: posts the ante 4375
Warrior00086: posts the ante 4375
craxkedu: posts the ante 4375
narew: posts the ante 4375
YourRobotDad: posts the ante 4375
Warrior00086: posts small blind 17500
craxkedu: posts big blind 35000
*** HOLE CARDS ***
Dealt to JJin91 [Tc 8c]
narew: folds=20
YourRobotDad: folds=20
JJin91: raises 40950 to 75950
Warrior00086: folds=20
craxkedu: calls 40950
*** FLOP *** [2s 2h Qh]
craxkedu: checks=20
JJin91: checks=20
*** TURN *** [2s 2h Qh] [Ad]
craxkedu: checks=20
JJin91: bets 134242
craxkedu: folds=20
Uncalled bet (134242) returned to JJin91
JJin91 collected 191275 from pot
JJin91: doesn't show hand=20
*** SUMMARY ***
Total pot 191275 | Rake 0=20
Board [2s 2h Qh Ad]
Seat 1: JJin91 (button) collected (191275)
Seat 2: Warrior00086 (small blind) folded before Flop
Seat 4: craxkedu (big blind) folded on the Turn
Seat 5: narew folded before Flop (didn't bet)
Seat 6: YourRobotDad folded before Flop (didn't bet)


*********** # 370 **************
PokerStars Hand #175486379547: Tournament #1701793695, $9.10+$0.90 USD =
Hold'em No Limit - Level XXXVI (17500/35000) - 2017/09/24 21:45:44 ET
Table '1701793695 9' 6-max Seat #2 is the button
Seat 1: JJin91 (1275852 in chips)=20
Seat 2: Warrior00086 (778665 in chips)=20
Seat 4: craxkedu (1033266 in chips)=20
Seat 5: narew (850456 in chips)=20
Seat 6: YourRobotDad (268490 in chips)=20
JJin91: posts the ante 4375
Warrior00086: posts the ante 4375
craxkedu: posts the ante 4375
narew: posts the ante 4375
YourRobotDad: posts the ante 4375
craxkedu: posts small blind 17500
narew: posts big blind 35000
*** HOLE CARDS ***
Dealt to JJin91 [Qc 6d]
YourRobotDad: folds=20
JJin91: folds=20
Warrior00086: raises 70000 to 105000
craxkedu: raises 231875 to 336875
narew: folds=20
Warrior00086: raises 437415 to 774290 and is all-in
craxkedu: calls 437415
*** FLOP *** [Qh 5c 3h]
*** TURN *** [Qh 5c 3h] [5s]
*** RIVER *** [Qh 5c 3h 5s] [8h]
*** SHOW DOWN ***
craxkedu: shows [Kc Kh] (two pair, Kings and Fives)
Warrior00086: shows [Jh Ac] (a pair of Fives)
craxkedu collected 1605455 from pot
Warrior00086 finished the tournament in 10th place and received $67.50.
*** SUMMARY ***
Total pot 1605455 | Rake 0=20
Board [Qh 5c 3h 5s 8h]
Seat 1: JJin91 folded before Flop (didn't bet)
Seat 2: Warrior00086 (button) showed [Jh Ac] and lost with a pair of Fi=
ves
Seat 4: craxkedu (small blind) showed [Kc Kh] and won (1605455) with tw=
o pair, Kings and Fives
Seat 5: narew (big blind) folded before Flop
Seat 6: YourRobotDad folded before Flop (didn't bet)


*********** # 371 **************
PokerStars Hand #175486379776: Tournament #1701793695, $9.10+$0.90 USD =
Hold'em No Limit - Level XXXVI (17500/35000) - 2017/09/24 21:46:33 ET
Table '1701793695 9' 6-max Seat #4 is the button
Seat 1: JJin91 (1271477 in chips)=20
Seat 4: craxkedu (1860056 in chips)=20
Seat 5: narew (811081 in chips)=20
Seat 6: YourRobotDad (264115 in chips)=20
JJin91: posts the ante 4375
craxkedu: posts the ante 4375
narew: posts the ante 4375
YourRobotDad: posts the ante 4375
narew: posts small blind 17500
YourRobotDad: posts big blind 35000
*** HOLE CARDS ***
Dealt to JJin91 [4d 8h]
JJin91: folds=20
craxkedu: folds=20
narew: calls 17500
YourRobotDad: raises 224740 to 259740 and is all-in
narew: folds=20
Uncalled bet (224740) returned to YourRobotDad
YourRobotDad collected 87500 from pot
*** SUMMARY ***
Total pot 87500 | Rake 0=20
Seat 1: JJin91 folded before Flop (didn't bet)
Seat 4: craxkedu (button) folded before Flop (didn't bet)
Seat 5: narew (small blind) folded before Flop
Seat 6: YourRobotDad (big blind) collected (87500)


*********** # 372 **************
PokerStars Hand #175486379909: Tournament #1701793695, $9.10+$0.90 USD =
Hold'em No Limit - Level XXXVI (17500/35000) - 2017/09/24 21:47:01 ET
Table '1701793695 9' 6-max Seat #5 is the button
Seat 1: JJin91 (1267102 in chips)=20
Seat 4: craxkedu (1855681 in chips)=20
Seat 5: narew (771706 in chips)=20
Seat 6: YourRobotDad (312240 in chips)=20
JJin91: posts the ante 4375
craxkedu: posts the ante 4375
narew: posts the ante 4375
YourRobotDad: posts the ante 4375
YourRobotDad: posts small blind 17500
JJin91: posts big blind 35000
*** HOLE CARDS ***
Dealt to JJin91 [Qc 6h]
craxkedu: raises 35000 to 70000
narew: folds=20
YourRobotDad: folds=20
JJin91: calls 35000
*** FLOP *** [8s 2h 4c]
JJin91: checks=20
craxkedu: checks=20
*** TURN *** [8s 2h 4c] [6s]
JJin91: bets 64750
craxkedu: folds=20
Uncalled bet (64750) returned to JJin91
JJin91 collected 175000 from pot
JJin91: doesn't show hand=20
*** SUMMARY ***
Total pot 175000 | Rake 0=20
Board [8s 2h 4c 6s]
Seat 1: JJin91 (big blind) collected (175000)
Seat 4: craxkedu folded on the Turn
Seat 5: narew (button) folded before Flop (didn't bet)
Seat 6: YourRobotDad (small blind) folded before Flop


*********** # 373 **************
PokerStars Hand #175486549759: Tournament #1701793695, $9.10+$0.90 USD =
Hold'em No Limit - Level XXXVI (17500/35000) - 2017/09/24 21:47:59 ET
Table '1701793695 9' 6-max Seat #6 is the button
Seat 1: JJin91 (1367727 in chips)=20
Seat 4: craxkedu (1781306 in chips)=20
Seat 5: narew (767331 in chips)=20
Seat 6: YourRobotDad (290365 in chips)=20
JJin91: posts the ante 4375
craxkedu: posts the ante 4375
narew: posts the ante 4375
YourRobotDad: posts the ante 4375
JJin91: posts small blind 17500
craxkedu: posts big blind 35000
*** HOLE CARDS ***
Dealt to JJin91 [Kc 5c]
narew: folds=20
YourRobotDad: calls 35000
JJin91: calls 17500
craxkedu: checks=20
*** FLOP *** [Qh Td 6s]
JJin91: checks=20
craxkedu: checks=20
YourRobotDad: bets 70000
JJin91: folds=20
craxkedu: calls 70000
*** TURN *** [Qh Td 6s] [3d]
craxkedu: checks=20
YourRobotDad: checks=20
*** RIVER *** [Qh Td 6s 3d] [Ah]
craxkedu: checks=20
YourRobotDad: checks=20
*** SHOW DOWN ***
craxkedu: shows [Js Ts] (a pair of Tens)
YourRobotDad: mucks hand=20
craxkedu collected 262500 from pot
*** SUMMARY ***
Total pot 262500 | Rake 0=20
Board [Qh Td 6s 3d Ah]
Seat 1: JJin91 (small blind) folded on the Flop
Seat 4: craxkedu (big blind) showed [Js Ts] and won (262500) with a pai=
r of Tens
Seat 5: narew folded before Flop (didn't bet)
Seat 6: YourRobotDad (button) mucked [Kd 8d]


*********** # 374 **************
PokerStars Hand #175486585229: Tournament #1701793695, $9.10+$0.90 USD =
Hold'em No Limit - Level XXXVI (17500/35000) - 2017/09/24 21:49:05 ET
Table '1701793695 9' 6-max Seat #1 is the button
Seat 1: JJin91 (1328352 in chips)=20
Seat 4: craxkedu (1934431 in chips)=20
Seat 5: narew (762956 in chips)=20
Seat 6: YourRobotDad (180990 in chips)=20
JJin91: posts the ante 4375
craxkedu: posts the ante 4375
narew: posts the ante 4375
YourRobotDad: posts the ante 4375
craxkedu: posts small blind 17500
narew: posts big blind 35000
*** HOLE CARDS ***
Dealt to JJin91 [Ah 4d]
YourRobotDad: folds=20
JJin91: raises 40950 to 75950
craxkedu: folds=20
narew: calls 40950
*** FLOP *** [2c Qc 5d]
narew: checks=20
JJin91: checks=20
*** TURN *** [2c Qc 5d] [6s]
narew: bets 70000
JJin91: raises 107733 to 177733
narew: calls 107733
*** RIVER *** [2c Qc 5d 6s] [2s]
narew: bets 504898 and is all-in
JJin91: folds=20
Uncalled bet (504898) returned to narew
narew collected 542366 from pot
narew: doesn't show hand=20
*** SUMMARY ***
Total pot 542366 | Rake 0=20
Board [2c Qc 5d 6s 2s]
Seat 1: JJin91 (button) folded on the River
Seat 4: craxkedu (small blind) folded before Flop
Seat 5: narew (big blind) collected (542366)
Seat 6: YourRobotDad folded before Flop (didn't bet)


*********** # 375 **************
PokerStars Hand #175486585692: Tournament #1701793695, $9.10+$0.90 USD =
Hold'em No Limit - Level XXXVI (17500/35000) - 2017/09/24 21:50:55 ET
Table '1701793695 9' 6-max Seat #4 is the button
Seat 1: JJin91 (1070294 in chips)=20
Seat 4: craxkedu (1912556 in chips)=20
Seat 5: narew (1047264 in chips)=20
Seat 6: YourRobotDad (176615 in chips)=20
JJin91: posts the ante 4375
craxkedu: posts the ante 4375
narew: posts the ante 4375
YourRobotDad: posts the ante 4375
narew: posts small blind 17500
YourRobotDad: posts big blind 35000
*** HOLE CARDS ***
Dealt to JJin91 [Kh 4h]
JJin91: folds=20
craxkedu: raises 35000 to 70000
narew: folds=20
YourRobotDad: folds=20
Uncalled bet (35000) returned to craxkedu
craxkedu collected 105000 from pot
craxkedu: doesn't show hand=20
*** SUMMARY ***
Total pot 105000 | Rake 0=20
Seat 1: JJin91 folded before Flop (didn't bet)
Seat 4: craxkedu (button) collected (105000)
Seat 5: narew (small blind) folded before Flop
Seat 6: YourRobotDad (big blind) folded before Flop


*********** # 376 **************
PokerStars Hand #175486585783: Tournament #1701793695, $9.10+$0.90 USD =
Hold'em No Limit - Level XXXVI (17500/35000) - 2017/09/24 21:51:13 ET
Table '1701793695 9' 6-max Seat #5 is the button
Seat 1: JJin91 (1065919 in chips)=20
Seat 4: craxkedu (1978181 in chips)=20
Seat 5: narew (1025389 in chips)=20
Seat 6: YourRobotDad (137240 in chips)=20
JJin91: posts the ante 4375
craxkedu: posts the ante 4375
narew: posts the ante 4375
YourRobotDad: posts the ante 4375
YourRobotDad: posts small blind 17500
JJin91: posts big blind 35000
*** HOLE CARDS ***
Dealt to JJin91 [Ac 5s]
craxkedu: folds=20
narew: folds=20
YourRobotDad: calls 17500
JJin91: raises 1026544 to 1061544 and is all-in
YourRobotDad: folds=20
Uncalled bet (1026544) returned to JJin91
JJin91 collected 87500 from pot
JJin91: doesn't show hand=20
*** SUMMARY ***
Total pot 87500 | Rake 0=20
Seat 1: JJin91 (big blind) collected (87500)
Seat 4: craxkedu folded before Flop (didn't bet)
Seat 5: narew (button) folded before Flop (didn't bet)
Seat 6: YourRobotDad (small blind) folded before Flop


*********** # 377 **************
PokerStars Hand #175486585965: Tournament #1701793695, $9.10+$0.90 USD =
Hold'em No Limit - Level XXXVI (17500/35000) - 2017/09/24 21:52:00 ET
Table '1701793695 9' 6-max Seat #6 is the button
Seat 1: JJin91 (1114044 in chips)=20
Seat 4: craxkedu (1973806 in chips)=20
Seat 5: narew (1021014 in chips)=20
Seat 6: YourRobotDad (97865 in chips)=20
JJin91: posts the ante 4375
craxkedu: posts the ante 4375
narew: posts the ante 4375
YourRobotDad: posts the ante 4375
JJin91: posts small blind 17500
craxkedu: posts big blind 35000
*** HOLE CARDS ***
Dealt to JJin91 [4c 8c]
narew: folds=20
YourRobotDad: folds=20
JJin91: calls 17500
craxkedu: checks=20
*** FLOP *** [As 6s 8h]
JJin91: bets 44625
craxkedu is disconnected=20
craxkedu is connected=20
craxkedu: folds=20
Uncalled bet (44625) returned to JJin91
JJin91 collected 87500 from pot
JJin91: doesn't show hand=20
*** SUMMARY ***
Total pot 87500 | Rake 0=20
Board [As 6s 8h]
Seat 1: JJin91 (small blind) collected (87500)
Seat 4: craxkedu (big blind) folded on the Flop
Seat 5: narew folded before Flop (didn't bet)
Seat 6: YourRobotDad (button) folded before Flop (didn't bet)


*********** # 378 **************
PokerStars Hand #175486586276: Tournament #1701793695, $9.10+$0.90 USD =
Hold'em No Limit - Level XXXVI (17500/35000) - 2017/09/24 21:53:10 ET
Table '1701793695 9' 6-max Seat #1 is the button
Seat 1: JJin91 (1162169 in chips)=20
Seat 4: craxkedu (1934431 in chips)=20
Seat 5: narew (1016639 in chips)=20
Seat 6: YourRobotDad (93490 in chips)=20
JJin91: posts the ante 4375
craxkedu: posts the ante 4375
narew: posts the ante 4375
YourRobotDad: posts the ante 4375
craxkedu: posts small blind 17500
narew: posts big blind 35000
*** HOLE CARDS ***
Dealt to JJin91 [4c 2h]
YourRobotDad: raises 54115 to 89115 and is all-in
JJin91: folds=20
craxkedu: folds=20
narew: calls 54115
*** FLOP *** [9s 5c 8s]
*** TURN *** [9s 5c 8s] [Ks]
*** RIVER *** [9s 5c 8s Ks] [3s]
*** SHOW DOWN ***
narew: shows [3h Qh] (a pair of Threes)
YourRobotDad: shows [Td Jd] (high card King)
narew collected 213230 from pot
YourRobotDad finished the tournament in 7th place and received $105.00.
*** SUMMARY ***
Total pot 213230 | Rake 0=20
Board [9s 5c 8s Ks 3s]
Seat 1: JJin91 (button) folded before Flop (didn't bet)
Seat 4: craxkedu (small blind) folded before Flop
Seat 5: narew (big blind) showed [3h Qh] and won (213230) with a pair o=
f Threes
Seat 6: YourRobotDad showed [Td Jd] and lost with high card King


*********** # 379 **************
PokerStars Hand #175486586418: Tournament #1701793695, $9.10+$0.90 USD =
Hold'em No Limit - Level XXXVII (20000/40000) - 2017/09/24 21:53:46 ET
Table '1701793695 18' 6-max Seat #6 is the button
Seat 1: CerPrisingLe (972165 in chips)=20
Seat 2: JJin91 (1157794 in chips)=20
Seat 3: Jivetoast (4272993 in chips)=20
Seat 4: narew (1136379 in chips)=20
Seat 5: craxkedu (1912556 in chips)=20
Seat 6: WhiteIce0328 (1108113 in chips)=20
CerPrisingLe: posts the ante 5000
JJin91: posts the ante 5000
Jivetoast: posts the ante 5000
narew: posts the ante 5000
craxkedu: posts the ante 5000
WhiteIce0328: posts the ante 5000
CerPrisingLe: posts small blind 20000
JJin91: posts big blind 40000
*** HOLE CARDS ***
Dealt to JJin91 [6h 3d]
Jivetoast: raises 80000 to 120000
narew: folds=20
craxkedu is connected=20
craxkedu: folds=20
WhiteIce0328: folds=20
CerPrisingLe: folds=20
JJin91: folds=20
Uncalled bet (80000) returned to Jivetoast
Jivetoast collected 130000 from pot
Jivetoast: doesn't show hand=20
*** SUMMARY ***
Total pot 130000 | Rake 0=20
Seat 1: CerPrisingLe (small blind) folded before Flop
Seat 2: JJin91 (big blind) folded before Flop
Seat 3: Jivetoast collected (130000)
Seat 4: narew folded before Flop (didn't bet)
Seat 5: craxkedu folded before Flop (didn't bet)
Seat 6: WhiteIce0328 (button) folded before Flop (didn't bet)


*********** # 380 **************
PokerStars Hand #175486586577: Tournament #1701793695, $9.10+$0.90 USD =
Hold'em No Limit - Level XXXVII (20000/40000) - 2017/09/24 21:54:20 ET
Table '1701793695 18' 6-max Seat #1 is the button
Seat 1: CerPrisingLe (947165 in chips)=20
Seat 2: JJin91 (1112794 in chips)=20
Seat 3: Jivetoast (4357993 in chips)=20
Seat 4: narew (1131379 in chips)=20
Seat 5: craxkedu (1907556 in chips)=20
Seat 6: WhiteIce0328 (1103113 in chips)=20
CerPrisingLe: posts the ante 5000
JJin91: posts the ante 5000
Jivetoast: posts the ante 5000
narew: posts the ante 5000
craxkedu: posts the ante 5000
WhiteIce0328: posts the ante 5000
JJin91: posts small blind 20000
Jivetoast: posts big blind 40000
*** HOLE CARDS ***
Dealt to JJin91 [7h Ad]
narew: folds=20
craxkedu: folds=20
WhiteIce0328: raises 80000 to 120000
CerPrisingLe: folds=20
JJin91: calls 100000
Jivetoast: calls 80000
*** FLOP *** [Ts As 3h]
JJin91: checks=20
Jivetoast: checks=20
WhiteIce0328: bets 390000
JJin91: calls 390000
Jivetoast: folds=20
*** TURN *** [Ts As 3h] [Kd]
JJin91: checks=20
WhiteIce0328: bets 588113 and is all-in
JJin91: folds=20
Uncalled bet (588113) returned to WhiteIce0328
WhiteIce0328 collected 1170000 from pot
WhiteIce0328: doesn't show hand=20
JJin91 is disconnected=20
CerPrisingLe is disconnected=20
WhiteIce0328 is disconnected=20
Jivetoast is disconnected=20
narew is disconnected=20
*** SUMMARY ***
Total pot 1170000 | Rake 0=20
Board [Ts As 3h Kd]
Seat 1: CerPrisingLe (button) folded before Flop (didn't bet)
Seat 2: JJin91 (small blind) folded on the Turn
Seat 3: Jivetoast (big blind) folded on the Flop
Seat 4: narew folded before Flop (didn't bet)
Seat 5: craxkedu folded before Flop (didn't bet)
Seat 6: WhiteIce0328 collected (1170000)


*********** # 381 **************
PokerStars Hand #175486587648: Tournament #1701793695, $9.10+$0.90 USD =
Hold'em No Limit - Level XXXVII (20000/40000) - 2017/09/24 21:59:40 ET
Table '1701793695 18' 6-max Seat #2 is the button
Seat 1: CerPrisingLe (942165 in chips)=20
Seat 2: JJin91 (597794 in chips)=20
Seat 3: Jivetoast (4232993 in chips)=20
Seat 4: narew (1126379 in chips)=20
Seat 5: craxkedu (1902556 in chips)=20
Seat 6: WhiteIce0328 (1758113 in chips)=20
All players have agreed to skip the break. Game resuming.
CerPrisingLe: posts the ante 5000
JJin91: posts the ante 5000
Jivetoast: posts the ante 5000
narew: posts the ante 5000
craxkedu: posts the ante 5000
WhiteIce0328: posts the ante 5000
Jivetoast: posts small blind 20000
narew: posts big blind 40000
*** HOLE CARDS ***
Dealt to JJin91 [Kc Ah]
craxkedu: folds=20
WhiteIce0328: folds=20
CerPrisingLe: folds=20
JJin91: raises 46800 to 86800
Jivetoast: folds=20
narew: calls 46800
*** FLOP *** [4s 5d 8s]
narew: checks=20
JJin91: bets 89999
narew: folds=20
Uncalled bet (89999) returned to JJin91
JJin91 collected 223600 from pot
JJin91: doesn't show hand=20
*** SUMMARY ***
Total pot 223600 | Rake 0=20
Board [4s 5d 8s]
Seat 1: CerPrisingLe folded before Flop (didn't bet)
Seat 2: JJin91 (button) collected (223600)
Seat 3: Jivetoast (small blind) folded before Flop
Seat 4: narew (big blind) folded on the Flop
Seat 5: craxkedu folded before Flop (didn't bet)
Seat 6: WhiteIce0328 folded before Flop (didn't bet)


*********** # 382 **************
PokerStars Hand #175486587841: Tournament #1701793695, $9.10+$0.90 USD =
Hold'em No Limit - Level XXXVII (20000/40000) - 2017/09/24 22:00:41 ET
Table '1701793695 18' 6-max Seat #3 is the button
Seat 1: CerPrisingLe (937165 in chips)=20
Seat 2: JJin91 (729594 in chips)=20
Seat 3: Jivetoast (4207993 in chips)=20
Seat 4: narew (1034579 in chips)=20
Seat 5: craxkedu (1897556 in chips)=20
Seat 6: WhiteIce0328 (1753113 in chips)=20
CerPrisingLe: posts the ante 5000
JJin91: posts the ante 5000
Jivetoast: posts the ante 5000
narew: posts the ante 5000
craxkedu: posts the ante 5000
WhiteIce0328: posts the ante 5000
narew: posts small blind 20000
craxkedu: posts big blind 40000
*** HOLE CARDS ***
Dealt to JJin91 [4c 6d]
WhiteIce0328: folds=20
CerPrisingLe: folds=20
JJin91: folds=20
Jivetoast: folds=20
narew: raises 80000 to 120000
craxkedu: calls 80000
*** FLOP *** [Ts 4h Ac]
narew: bets 120000
craxkedu: folds=20
Uncalled bet (120000) returned to narew
narew collected 270000 from pot
narew: doesn't show hand=20
*** SUMMARY ***
Total pot 270000 | Rake 0=20
Board [Ts 4h Ac]
Seat 1: CerPrisingLe folded before Flop (didn't bet)
Seat 2: JJin91 folded before Flop (didn't bet)
Seat 3: Jivetoast (button) folded before Flop (didn't bet)
Seat 4: narew (small blind) collected (270000)
Seat 5: craxkedu (big blind) folded on the Flop
Seat 6: WhiteIce0328 folded before Flop (didn't bet)


*********** # 383 **************
PokerStars Hand #175486588070: Tournament #1701793695, $9.10+$0.90 USD =
Hold'em No Limit - Level XXXVII (20000/40000) - 2017/09/24 22:01:31 ET
Table '1701793695 18' 6-max Seat #4 is the button
Seat 1: CerPrisingLe (932165 in chips)=20
Seat 2: JJin91 (724594 in chips)=20
Seat 3: Jivetoast (4202993 in chips)=20
Seat 4: narew (1179579 in chips)=20
Seat 5: craxkedu (1772556 in chips)=20
Seat 6: WhiteIce0328 (1748113 in chips)=20
CerPrisingLe: posts the ante 5000
JJin91: posts the ante 5000
Jivetoast: posts the ante 5000
narew: posts the ante 5000
craxkedu: posts the ante 5000
WhiteIce0328: posts the ante 5000
craxkedu: posts small blind 20000
WhiteIce0328: posts big blind 40000
*** HOLE CARDS ***
Dealt to JJin91 [Kc Ks]
CerPrisingLe: folds=20
JJin91: raises 46800 to 86800
Jivetoast: folds=20
narew: folds=20
craxkedu: folds=20
WhiteIce0328: folds=20
Uncalled bet (46800) returned to JJin91
JJin91 collected 130000 from pot
JJin91: doesn't show hand=20
*** SUMMARY ***
Total pot 130000 | Rake 0=20
Seat 1: CerPrisingLe folded before Flop (didn't bet)
Seat 2: JJin91 collected (130000)
Seat 3: Jivetoast folded before Flop (didn't bet)
Seat 4: narew (button) folded before Flop (didn't bet)
Seat 5: craxkedu (small blind) folded before Flop
Seat 6: WhiteIce0328 (big blind) folded before Flop


*********** # 384 **************
PokerStars Hand #175486588174: Tournament #1701793695, $9.10+$0.90 USD =
Hold'em No Limit - Level XXXVII (20000/40000) - 2017/09/24 22:01:53 ET
Table '1701793695 18' 6-max Seat #5 is the button
Seat 1: CerPrisingLe (927165 in chips)=20
Seat 2: JJin91 (809594 in chips)=20
Seat 3: Jivetoast (4197993 in chips)=20
Seat 4: narew (1174579 in chips)=20
Seat 5: craxkedu (1747556 in chips)=20
Seat 6: WhiteIce0328 (1703113 in chips)=20
CerPrisingLe: posts the ante 5000
JJin91: posts the ante 5000
Jivetoast: posts the ante 5000
narew: posts the ante 5000
craxkedu: posts the ante 5000
WhiteIce0328: posts the ante 5000
WhiteIce0328: posts small blind 20000
CerPrisingLe: posts big blind 40000
*** HOLE CARDS ***
Dealt to JJin91 [3s 8c]
JJin91: folds=20
Jivetoast: folds=20
narew: folds=20
craxkedu: folds=20
WhiteIce0328: folds=20
Uncalled bet (20000) returned to CerPrisingLe
CerPrisingLe collected 70000 from pot
CerPrisingLe: doesn't show hand=20
*** SUMMARY ***
Total pot 70000 | Rake 0=20
Seat 1: CerPrisingLe (big blind) collected (70000)
Seat 2: JJin91 folded before Flop (didn't bet)
Seat 3: Jivetoast folded before Flop (didn't bet)
Seat 4: narew folded before Flop (didn't bet)
Seat 5: craxkedu (button) folded before Flop (didn't bet)
Seat 6: WhiteIce0328 (small blind) folded before Flop


*********** # 385 **************
PokerStars Hand #175486588255: Tournament #1701793695, $9.10+$0.90 USD =
Hold'em No Limit - Level XXXVII (20000/40000) - 2017/09/24 22:02:10 ET
Table '1701793695 18' 6-max Seat #6 is the button
Seat 1: CerPrisingLe (972165 in chips)=20
Seat 2: JJin91 (804594 in chips)=20
Seat 3: Jivetoast (4192993 in chips)=20
Seat 4: narew (1169579 in chips)=20
Seat 5: craxkedu (1742556 in chips)=20
Seat 6: WhiteIce0328 (1678113 in chips)=20
CerPrisingLe: posts the ante 5000
JJin91: posts the ante 5000
Jivetoast: posts the ante 5000
narew: posts the ante 5000
craxkedu: posts the ante 5000
WhiteIce0328: posts the ante 5000
CerPrisingLe: posts small blind 20000
JJin91: posts big blind 40000
*** HOLE CARDS ***
Dealt to JJin91 [4d 2s]
Jivetoast: folds=20
narew: folds=20
craxkedu: raises 40000 to 80000
WhiteIce0328: folds=20
CerPrisingLe: folds=20
JJin91: folds=20
Uncalled bet (40000) returned to craxkedu
craxkedu collected 130000 from pot
craxkedu: doesn't show hand=20
*** SUMMARY ***
Total pot 130000 | Rake 0=20
Seat 1: CerPrisingLe (small blind) folded before Flop
Seat 2: JJin91 (big blind) folded before Flop
Seat 3: Jivetoast folded before Flop (didn't bet)
Seat 4: narew folded before Flop (didn't bet)
Seat 5: craxkedu collected (130000)
Seat 6: WhiteIce0328 (button) folded before Flop (didn't bet)


*********** # 386 **************
PokerStars Hand #175486588344: Tournament #1701793695, $9.10+$0.90 USD =
Hold'em No Limit - Level XXXVII (20000/40000) - 2017/09/24 22:02:29 ET
Table '1701793695 18' 6-max Seat #1 is the button
Seat 1: CerPrisingLe (947165 in chips)=20
Seat 2: JJin91 (759594 in chips)=20
Seat 3: Jivetoast (4187993 in chips)=20
Seat 4: narew (1164579 in chips)=20
Seat 5: craxkedu (1827556 in chips)=20
Seat 6: WhiteIce0328 (1673113 in chips)=20
CerPrisingLe: posts the ante 5000
JJin91: posts the ante 5000
Jivetoast: posts the ante 5000
narew: posts the ante 5000
craxkedu: posts the ante 5000
WhiteIce0328: posts the ante 5000
JJin91: posts small blind 20000
Jivetoast: posts big blind 40000
*** HOLE CARDS ***
Dealt to JJin91 [5c Kd]
narew: folds=20
craxkedu: calls 40000
WhiteIce0328: folds=20
CerPrisingLe: folds=20
JJin91: folds=20
Jivetoast: checks=20
*** FLOP *** [Jd 8d 2s]
Jivetoast: checks=20
craxkedu: checks=20
*** TURN *** [Jd 8d 2s] [Ad]
Jivetoast: bets 80000
craxkedu: folds=20
Uncalled bet (80000) returned to Jivetoast
Jivetoast collected 130000 from pot
Jivetoast: doesn't show hand=20
*** SUMMARY ***
Total pot 130000 | Rake 0=20
Board [Jd 8d 2s Ad]
Seat 1: CerPrisingLe (button) folded before Flop (didn't bet)
Seat 2: JJin91 (small blind) folded before Flop
Seat 3: Jivetoast (big blind) collected (130000)
Seat 4: narew folded before Flop (didn't bet)
Seat 5: craxkedu folded on the Turn
Seat 6: WhiteIce0328 folded before Flop (didn't bet)


*********** # 387 **************
PokerStars Hand #175486588530: Tournament #1701793695, $9.10+$0.90 USD =
Hold'em No Limit - Level XXXVII (20000/40000) - 2017/09/24 22:03:11 ET
Table '1701793695 18' 6-max Seat #2 is the button
Seat 1: CerPrisingLe (942165 in chips)=20
Seat 2: JJin91 (734594 in chips)=20
Seat 3: Jivetoast (4272993 in chips)=20
Seat 4: narew (1159579 in chips)=20
Seat 5: craxkedu (1782556 in chips)=20
Seat 6: WhiteIce0328 (1668113 in chips)=20
CerPrisingLe: posts the ante 5000
JJin91: posts the ante 5000
Jivetoast: posts the ante 5000
narew: posts the ante 5000
craxkedu: posts the ante 5000
WhiteIce0328: posts the ante 5000
Jivetoast: posts small blind 20000
narew: posts big blind 40000
*** HOLE CARDS ***
Dealt to JJin91 [Js 8h]
craxkedu: folds=20
WhiteIce0328: raises 80000 to 120000
CerPrisingLe: calls 120000
JJin91: folds=20
Jivetoast: folds=20
narew: calls 80000
*** FLOP *** [3d 9d 8c]
narew: checks=20
WhiteIce0328: bets 280000
CerPrisingLe: folds=20
narew: folds=20
Uncalled bet (280000) returned to WhiteIce0328
WhiteIce0328 collected 410000 from pot
WhiteIce0328: doesn't show hand=20
*** SUMMARY ***
Total pot 410000 | Rake 0=20
Board [3d 9d 8c]
Seat 1: CerPrisingLe folded on the Flop
Seat 2: JJin91 (button) folded before Flop (didn't bet)
Seat 3: Jivetoast (small blind) folded before Flop
Seat 4: narew (big blind) folded on the Flop
Seat 5: craxkedu folded before Flop (didn't bet)
Seat 6: WhiteIce0328 collected (410000)


*********** # 388 **************
PokerStars Hand #175486588733: Tournament #1701793695, $9.10+$0.90 USD =
Hold'em No Limit - Level XXXVII (20000/40000) - 2017/09/24 22:04:01 ET
Table '1701793695 18' 6-max Seat #3 is the button
Seat 1: CerPrisingLe (817165 in chips)=20
Seat 2: JJin91 (729594 in chips)=20
Seat 3: Jivetoast (4247993 in chips)=20
Seat 4: narew (1034579 in chips)=20
Seat 5: craxkedu (1777556 in chips)=20
Seat 6: WhiteIce0328 (1953113 in chips)=20
CerPrisingLe: posts the ante 5000
JJin91: posts the ante 5000
Jivetoast: posts the ante 5000
narew: posts the ante 5000
craxkedu: posts the ante 5000
WhiteIce0328: posts the ante 5000
narew: posts small blind 20000
craxkedu: posts big blind 40000
*** HOLE CARDS ***
Dealt to JJin91 [Jd 7c]
WhiteIce0328: folds=20
CerPrisingLe: raises 40000 to 80000
JJin91: folds=20
Jivetoast: calls 80000
narew: calls 60000
craxkedu: folds=20
*** FLOP *** [Ac 5s Qh]
narew: checks=20
CerPrisingLe: bets 120000
Jivetoast: calls 120000
narew: folds=20
*** TURN *** [Ac 5s Qh] [Kc]
CerPrisingLe: bets 612165 and is all-in
Jivetoast: folds=20
Uncalled bet (612165) returned to CerPrisingLe
CerPrisingLe collected 550000 from pot
CerPrisingLe: doesn't show hand=20
*** SUMMARY ***
Total pot 550000 | Rake 0=20
Board [Ac 5s Qh Kc]
Seat 1: CerPrisingLe collected (550000)
Seat 2: JJin91 folded before Flop (didn't bet)
Seat 3: Jivetoast (button) folded on the Turn
Seat 4: narew (small blind) folded on the Flop
Seat 5: craxkedu (big blind) folded before Flop
Seat 6: WhiteIce0328 folded before Flop (didn't bet)


*********** # 389 **************
PokerStars Hand #175486588957: Tournament #1701793695, $9.10+$0.90 USD =
Hold'em No Limit - Level XXXVII (20000/40000) - 2017/09/24 22:04:50 ET
Table '1701793695 18' 6-max Seat #4 is the button
Seat 1: CerPrisingLe (1162165 in chips)=20
Seat 2: JJin91 (724594 in chips)=20
Seat 3: Jivetoast (4042993 in chips)=20
Seat 4: narew (949579 in chips)=20
Seat 5: craxkedu (1732556 in chips)=20
Seat 6: WhiteIce0328 (1948113 in chips)=20
CerPrisingLe: posts the ante 5000
JJin91: posts the ante 5000
Jivetoast: posts the ante 5000
narew: posts the ante 5000
craxkedu: posts the ante 5000
WhiteIce0328: posts the ante 5000
craxkedu: posts small blind 20000
WhiteIce0328: posts big blind 40000
*** HOLE CARDS ***
Dealt to JJin91 [2c 6s]
CerPrisingLe: folds=20
JJin91: folds=20
Jivetoast: folds=20
narew: folds=20
craxkedu: folds=20
Uncalled bet (20000) returned to WhiteIce0328
WhiteIce0328 collected 70000 from pot
WhiteIce0328: doesn't show hand=20
*** SUMMARY ***
Total pot 70000 | Rake 0=20
Seat 1: CerPrisingLe folded before Flop (didn't bet)
Seat 2: JJin91 folded before Flop (didn't bet)
Seat 3: Jivetoast folded before Flop (didn't bet)
Seat 4: narew (button) folded before Flop (didn't bet)
Seat 5: craxkedu (small blind) folded before Flop
Seat 6: WhiteIce0328 (big blind) collected (70000)


*********** # 390 **************
PokerStars Hand #175486589022: Tournament #1701793695, $9.10+$0.90 USD =
Hold'em No Limit - Level XXXVII (20000/40000) - 2017/09/24 22:05:05 ET
Table '1701793695 18' 6-max Seat #5 is the button
Seat 1: CerPrisingLe (1157165 in chips)=20
Seat 2: JJin91 (719594 in chips)=20
Seat 3: Jivetoast (4037993 in chips)=20
Seat 4: narew (944579 in chips)=20
Seat 5: craxkedu (1707556 in chips)=20
Seat 6: WhiteIce0328 (1993113 in chips)=20
CerPrisingLe: posts the ante 5000
JJin91: posts the ante 5000
Jivetoast: posts the ante 5000
narew: posts the ante 5000
craxkedu: posts the ante 5000
WhiteIce0328: posts the ante 5000
WhiteIce0328: posts small blind 20000
CerPrisingLe: posts big blind 40000
*** HOLE CARDS ***
Dealt to JJin91 [8d 8s]
JJin91: raises 674594 to 714594 and is all-in
Jivetoast: folds=20
narew: folds=20
craxkedu: raises 987962 to 1702556 and is all-in
WhiteIce0328: folds=20
CerPrisingLe: folds=20
Uncalled bet (987962) returned to craxkedu
*** FLOP *** [Td 6s 3h]
*** TURN *** [Td 6s 3h] [8h]
*** RIVER *** [Td 6s 3h 8h] [6h]
*** SHOW DOWN ***
JJin91: shows [8d 8s] (a full house, Eights full of Sixes)
craxkedu: shows [Ah Kh] (a flush, Ace high)
JJin91 collected 1519188 from pot
*** SUMMARY ***
Total pot 1519188 | Rake 0=20
Board [Td 6s 3h 8h 6h]
Seat 1: CerPrisingLe (big blind) folded before Flop
Seat 2: JJin91 showed [8d 8s] and won (1519188) with a full house, Eigh=
ts full of Sixes
Seat 3: Jivetoast folded before Flop (didn't bet)
Seat 4: narew folded before Flop (didn't bet)
Seat 5: craxkedu (button) showed [Ah Kh] and lost with a flush, Ace high
Seat 6: WhiteIce0328 (small blind) folded before Flop


*********** # 391 **************
PokerStars Hand #175486589132: Tournament #1701793695, $9.10+$0.90 USD =
Hold'em No Limit - Level XXXVII (20000/40000) - 2017/09/24 22:05:31 ET
Table '1701793695 18' 6-max Seat #6 is the button
Seat 1: CerPrisingLe (1112165 in chips)=20
Seat 2: JJin91 (1519188 in chips)=20
Seat 3: Jivetoast (4032993 in chips)=20
Seat 4: narew (939579 in chips)=20
Seat 5: craxkedu (987962 in chips)=20
Seat 6: WhiteIce0328 (1968113 in chips)=20
CerPrisingLe: posts the ante 5000
JJin91: posts the ante 5000
Jivetoast: posts the ante 5000
narew: posts the ante 5000
craxkedu: posts the ante 5000
WhiteIce0328: posts the ante 5000
CerPrisingLe: posts small blind 20000
JJin91: posts big blind 40000
*** HOLE CARDS ***
Dealt to JJin91 [7d 6c]
Jivetoast: raises 80000 to 120000
narew: calls 120000
craxkedu: folds=20
WhiteIce0328: folds=20
CerPrisingLe: folds=20
JJin91: folds=20
*** FLOP *** [Tc Qd Js]
Jivetoast: bets 165000
narew: folds=20
Uncalled bet (165000) returned to Jivetoast
Jivetoast collected 330000 from pot
Jivetoast: doesn't show hand=20
*** SUMMARY ***
Total pot 330000 | Rake 0=20
Board [Tc Qd Js]
Seat 1: CerPrisingLe (small blind) folded before Flop
Seat 2: JJin91 (big blind) folded before Flop
Seat 3: Jivetoast collected (330000)
Seat 4: narew folded on the Flop
Seat 5: craxkedu folded before Flop (didn't bet)
Seat 6: WhiteIce0328 (button) folded before Flop (didn't bet)


*********** # 392 **************
PokerStars Hand #175486589315: Tournament #1701793695, $9.10+$0.90 USD =
Hold'em No Limit - Level XXXVII (20000/40000) - 2017/09/24 22:06:14 ET
Table '1701793695 18' 6-max Seat #1 is the button
Seat 1: CerPrisingLe (1087165 in chips)=20
Seat 2: JJin91 (1474188 in chips)=20
Seat 3: Jivetoast (4237993 in chips)=20
Seat 4: narew (814579 in chips)=20
Seat 5: craxkedu (982962 in chips)=20
Seat 6: WhiteIce0328 (1963113 in chips)=20
CerPrisingLe: posts the ante 5000
JJin91: posts the ante 5000
Jivetoast: posts the ante 5000
narew: posts the ante 5000
craxkedu: posts the ante 5000
WhiteIce0328: posts the ante 5000
JJin91: posts small blind 20000
Jivetoast: posts big blind 40000
*** HOLE CARDS ***
Dealt to JJin91 [Td Kd]
narew: calls 40000
craxkedu: folds=20
WhiteIce0328: folds=20
CerPrisingLe: folds=20
JJin91: calls 20000
Jivetoast: checks=20
*** FLOP *** [8c Ts 9h]
JJin91: checks=20
Jivetoast: bets 80000
narew: calls 80000
JJin91: folds=20
*** TURN *** [8c Ts 9h] [5c]
Jivetoast: bets 120000
narew: calls 120000
*** RIVER *** [8c Ts 9h 5c] [Ks]
Jivetoast: bets 275000
narew: raises 275000 to 550000
Jivetoast: folds=20
Uncalled bet (275000) returned to narew
narew collected 1100000 from pot
narew: doesn't show hand=20
*** SUMMARY ***
Total pot 1100000 | Rake 0=20
Board [8c Ts 9h 5c Ks]
Seat 1: CerPrisingLe (button) folded before Flop (didn't bet)
Seat 2: JJin91 (small blind) folded on the Flop
Seat 3: Jivetoast (big blind) folded on the River
Seat 4: narew collected (1100000)
Seat 5: craxkedu folded before Flop (didn't bet)
Seat 6: WhiteIce0328 folded before Flop (didn't bet)


*********** # 393 **************
PokerStars Hand #175486589693: Tournament #1701793695, $9.10+$0.90 USD =
Hold'em No Limit - Level XXXVII (20000/40000) - 2017/09/24 22:07:38 ET
Table '1701793695 18' 6-max Seat #2 is the button
Seat 1: CerPrisingLe (1082165 in chips)=20
Seat 2: JJin91 (1429188 in chips)=20
Seat 3: Jivetoast (3717993 in chips)=20
Seat 4: narew (1394579 in chips)=20
Seat 5: craxkedu (977962 in chips)=20
Seat 6: WhiteIce0328 (1958113 in chips)=20
CerPrisingLe: posts the ante 5000
JJin91: posts the ante 5000
Jivetoast: posts the ante 5000
narew: posts the ante 5000
craxkedu: posts the ante 5000
WhiteIce0328: posts the ante 5000
Jivetoast: posts small blind 20000
narew: posts big blind 40000
*** HOLE CARDS ***
Dealt to JJin91 [8d As]
craxkedu: raises 40000 to 80000
WhiteIce0328: folds=20
CerPrisingLe: folds=20
JJin91: folds=20
Jivetoast: folds=20
narew: calls 40000
*** FLOP *** [7h Ks Jd]
narew: bets 70000
craxkedu: calls 70000
*** TURN *** [7h Ks Jd] [Jc]
narew: bets 120000
craxkedu: calls 120000
*** RIVER *** [7h Ks Jd Jc] [Qs]
narew: checks=20
craxkedu: bets 280000
narew: folds=20
Uncalled bet (280000) returned to craxkedu
craxkedu collected 590000 from pot
craxkedu: doesn't show hand=20
*** SUMMARY ***
Total pot 590000 | Rake 0=20
Board [7h Ks Jd Jc Qs]
Seat 1: CerPrisingLe folded before Flop (didn't bet)
Seat 2: JJin91 (button) folded before Flop (didn't bet)
Seat 3: Jivetoast (small blind) folded before Flop
Seat 4: narew (big blind) folded on the River
Seat 5: craxkedu collected (590000)
Seat 6: WhiteIce0328 folded before Flop (didn't bet)


*********** # 394 **************
PokerStars Hand #175487032683: Tournament #1701793695, $9.10+$0.90 USD =
Hold'em No Limit - Level XXXVIII (22500/45000) - 2017/09/24 22:09:05 ET
Table '1701793695 18' 6-max Seat #3 is the button
Seat 1: CerPrisingLe (1077165 in chips)=20
Seat 2: JJin91 (1424188 in chips)=20
Seat 3: Jivetoast (3692993 in chips)=20
Seat 4: narew (1119579 in chips)=20
Seat 5: craxkedu (1292962 in chips)=20
Seat 6: WhiteIce0328 (1953113 in chips)=20
CerPrisingLe: posts the ante 5625
JJin91: posts the ante 5625
Jivetoast: posts the ante 5625
narew: posts the ante 5625
craxkedu: posts the ante 5625
WhiteIce0328: posts the ante 5625
narew: posts small blind 22500
craxkedu: posts big blind 45000
*** HOLE CARDS ***
Dealt to JJin91 [6c 2h]
WhiteIce0328: raises 90000 to 135000
CerPrisingLe: folds=20
JJin91: folds=20
Jivetoast: folds=20
narew: folds=20
craxkedu: folds=20
Uncalled bet (90000) returned to WhiteIce0328
WhiteIce0328 collected 146250 from pot
WhiteIce0328: doesn't show hand=20
*** SUMMARY ***
Total pot 146250 | Rake 0=20
Seat 1: CerPrisingLe folded before Flop (didn't bet)
Seat 2: JJin91 folded before Flop (didn't bet)
Seat 3: Jivetoast (button) folded before Flop (didn't bet)
Seat 4: narew (small blind) folded before Flop
Seat 5: craxkedu (big blind) folded before Flop
Seat 6: WhiteIce0328 collected (146250)


*********** # 395 **************
PokerStars Hand #175487032765: Tournament #1701793695, $9.10+$0.90 USD =
Hold'em No Limit - Level XXXVIII (22500/45000) - 2017/09/24 22:09:24 ET
Table '1701793695 18' 6-max Seat #4 is the button
Seat 1: CerPrisingLe (1071540 in chips)=20
Seat 2: JJin91 (1418563 in chips)=20
Seat 3: Jivetoast (3687368 in chips)=20
Seat 4: narew (1091454 in chips)=20
Seat 5: craxkedu (1242337 in chips)=20
Seat 6: WhiteIce0328 (2048738 in chips)=20
CerPrisingLe: posts the ante 5625
JJin91: posts the ante 5625
Jivetoast: posts the ante 5625
narew: posts the ante 5625
craxkedu: posts the ante 5625
WhiteIce0328: posts the ante 5625
craxkedu: posts small blind 22500
WhiteIce0328: posts big blind 45000
*** HOLE CARDS ***
Dealt to JJin91 [Tc Qh]
CerPrisingLe: folds=20
JJin91: folds=20
Jivetoast: folds=20
narew: folds=20
craxkedu: folds=20
Uncalled bet (22500) returned to WhiteIce0328
WhiteIce0328 collected 78750 from pot
WhiteIce0328: doesn't show hand=20
*** SUMMARY ***
Total pot 78750 | Rake 0=20
Seat 1: CerPrisingLe folded before Flop (didn't bet)
Seat 2: JJin91 folded before Flop (didn't bet)
Seat 3: Jivetoast folded before Flop (didn't bet)
Seat 4: narew (button) folded before Flop (didn't bet)
Seat 5: craxkedu (small blind) folded before Flop
Seat 6: WhiteIce0328 (big blind) collected (78750)


*********** # 396 **************
PokerStars Hand #175487032829: Tournament #1701793695, $9.10+$0.90 USD =
Hold'em No Limit - Level XXXVIII (22500/45000) - 2017/09/24 22:09:38 ET
Table '1701793695 18' 6-max Seat #5 is the button
Seat 1: CerPrisingLe (1065915 in chips)=20
Seat 2: JJin91 (1412938 in chips)=20
Seat 3: Jivetoast (3681743 in chips)=20
Seat 4: narew (1085829 in chips)=20
Seat 5: craxkedu (1214212 in chips)=20
Seat 6: WhiteIce0328 (2099363 in chips)=20
CerPrisingLe: posts the ante 5625
JJin91: posts the ante 5625
Jivetoast: posts the ante 5625
narew: posts the ante 5625
craxkedu: posts the ante 5625
WhiteIce0328: posts the ante 5625
WhiteIce0328: posts small blind 22500
CerPrisingLe: posts big blind 45000
*** HOLE CARDS ***
Dealt to JJin91 [3c Kh]
JJin91: folds=20
Jivetoast: folds=20
narew: folds=20
craxkedu: folds=20
WhiteIce0328: folds=20
Uncalled bet (22500) returned to CerPrisingLe
CerPrisingLe collected 78750 from pot
CerPrisingLe: doesn't show hand=20
*** SUMMARY ***
Total pot 78750 | Rake 0=20
Seat 1: CerPrisingLe (big blind) collected (78750)
Seat 2: JJin91 folded before Flop (didn't bet)
Seat 3: Jivetoast folded before Flop (didn't bet)
Seat 4: narew folded before Flop (didn't bet)
Seat 5: craxkedu (button) folded before Flop (didn't bet)
Seat 6: WhiteIce0328 (small blind) folded before Flop


*********** # 397 **************
PokerStars Hand #175487032895: Tournament #1701793695, $9.10+$0.90 USD =
Hold'em No Limit - Level XXXVIII (22500/45000) - 2017/09/24 22:09:52 ET
Table '1701793695 18' 6-max Seat #6 is the button
Seat 1: CerPrisingLe (1116540 in chips)=20
Seat 2: JJin91 (1407313 in chips)=20
Seat 3: Jivetoast (3676118 in chips)=20
Seat 4: narew (1080204 in chips)=20
Seat 5: craxkedu (1208587 in chips)=20
Seat 6: WhiteIce0328 (2071238 in chips)=20
CerPrisingLe: posts the ante 5625
JJin91: posts the ante 5625
Jivetoast: posts the ante 5625
narew: posts the ante 5625
craxkedu: posts the ante 5625
WhiteIce0328: posts the ante 5625
CerPrisingLe: posts small blind 22500
JJin91: posts big blind 45000
*** HOLE CARDS ***
Dealt to JJin91 [Ts 2c]
Jivetoast: folds=20
narew: raises 90000 to 135000
craxkedu: folds=20
WhiteIce0328: folds=20
CerPrisingLe: folds=20
JJin91: folds=20
Uncalled bet (90000) returned to narew
narew collected 146250 from pot
narew: doesn't show hand=20
*** SUMMARY ***
Total pot 146250 | Rake 0=20
Seat 1: CerPrisingLe (small blind) folded before Flop
Seat 2: JJin91 (big blind) folded before Flop
Seat 3: Jivetoast folded before Flop (didn't bet)
Seat 4: narew collected (146250)
Seat 5: craxkedu folded before Flop (didn't bet)
Seat 6: WhiteIce0328 (button) folded before Flop (didn't bet)


*********** # 398 **************
PokerStars Hand #175487032989: Tournament #1701793695, $9.10+$0.90 USD =
Hold'em No Limit - Level XXXVIII (22500/45000) - 2017/09/24 22:10:14 ET
Table '1701793695 18' 6-max Seat #1 is the button
Seat 1: CerPrisingLe (1088415 in chips)=20
Seat 2: JJin91 (1356688 in chips)=20
Seat 3: Jivetoast (3670493 in chips)=20
Seat 4: narew (1175829 in chips)=20
Seat 5: craxkedu (1202962 in chips)=20
Seat 6: WhiteIce0328 (2065613 in chips)=20
CerPrisingLe: posts the ante 5625
JJin91: posts the ante 5625
Jivetoast: posts the ante 5625
narew: posts the ante 5625
craxkedu: posts the ante 5625
WhiteIce0328: posts the ante 5625
JJin91: posts small blind 22500
Jivetoast: posts big blind 45000
*** HOLE CARDS ***
Dealt to JJin91 [Qd 9h]
narew: folds=20
craxkedu: folds=20
WhiteIce0328: folds=20
CerPrisingLe: raises 45000 to 90000
JJin91: folds=20
Jivetoast: calls 45000
*** FLOP *** [9d 5h 9c]
Jivetoast: checks=20
CerPrisingLe: checks=20
*** TURN *** [9d 5h 9c] [4s]
Jivetoast: bets 90000
CerPrisingLe: calls 90000
*** RIVER *** [9d 5h 9c 4s] [7s]
Jivetoast: bets 208125
CerPrisingLe: folds=20
Uncalled bet (208125) returned to Jivetoast
Jivetoast collected 416250 from pot
Jivetoast: doesn't show hand=20
*** SUMMARY ***
Total pot 416250 | Rake 0=20
Board [9d 5h 9c 4s 7s]
Seat 1: CerPrisingLe (button) folded on the River
Seat 2: JJin91 (small blind) folded before Flop
Seat 3: Jivetoast (big blind) collected (416250)
Seat 4: narew folded before Flop (didn't bet)
Seat 5: craxkedu folded before Flop (didn't bet)
Seat 6: WhiteIce0328 folded before Flop (didn't bet)


*********** # 399 **************
PokerStars Hand #175487033261: Tournament #1701793695, $9.10+$0.90 USD =
Hold'em No Limit - Level XXXVIII (22500/45000) - 2017/09/24 22:11:13 ET
Table '1701793695 18' 6-max Seat #2 is the button
Seat 1: CerPrisingLe (902790 in chips)=20
Seat 2: JJin91 (1328563 in chips)=20
Seat 3: Jivetoast (3901118 in chips)=20
Seat 4: narew (1170204 in chips)=20
Seat 5: craxkedu (1197337 in chips)=20
Seat 6: WhiteIce0328 (2059988 in chips)=20
CerPrisingLe: posts the ante 5625
JJin91: posts the ante 5625
Jivetoast: posts the ante 5625
narew: posts the ante 5625
craxkedu: posts the ante 5625
WhiteIce0328: posts the ante 5625
Jivetoast: posts small blind 22500
narew: posts big blind 45000
*** HOLE CARDS ***
Dealt to JJin91 [5h 2c]
craxkedu: folds=20
WhiteIce0328: folds=20
CerPrisingLe: folds=20
JJin91: folds=20
Jivetoast: calls 22500
narew: checks=20
*** FLOP *** [5s Jd 2d]
Jivetoast: bets 61875
narew: calls 61875
*** TURN *** [5s Jd 2d] [Qc]
Jivetoast: bets 247500
narew: folds=20
Uncalled bet (247500) returned to Jivetoast
Jivetoast collected 247500 from pot
Jivetoast: doesn't show hand=20
*** SUMMARY ***
Total pot 247500 | Rake 0=20
Board [5s Jd 2d Qc]
Seat 1: CerPrisingLe folded before Flop (didn't bet)
Seat 2: JJin91 (button) folded before Flop (didn't bet)
Seat 3: Jivetoast (small blind) collected (247500)
Seat 4: narew (big blind) folded on the Turn
Seat 5: craxkedu folded before Flop (didn't bet)
Seat 6: WhiteIce0328 folded before Flop (didn't bet)


*********** # 400 **************
PokerStars Hand #175487033499: Tournament #1701793695, $9.10+$0.90 USD =
Hold'em No Limit - Level XXXVIII (22500/45000) - 2017/09/24 22:12:05 ET
Table '1701793695 18' 6-max Seat #3 is the button
Seat 1: CerPrisingLe (897165 in chips)=20
Seat 2: JJin91 (1322938 in chips)=20
Seat 3: Jivetoast (4036118 in chips)=20
Seat 4: narew (1057704 in chips)=20
Seat 5: craxkedu (1191712 in chips)=20
Seat 6: WhiteIce0328 (2054363 in chips)=20
CerPrisingLe: posts the ante 5625
JJin91: posts the ante 5625
Jivetoast: posts the ante 5625
narew: posts the ante 5625
craxkedu: posts the ante 5625
WhiteIce0328: posts the ante 5625
narew: posts small blind 22500
craxkedu: posts big blind 45000
*** HOLE CARDS ***
Dealt to JJin91 [Kh Th]
WhiteIce0328: folds=20
CerPrisingLe: folds=20
JJin91: raises 52650 to 97650
Jivetoast: folds=20
narew: folds=20
craxkedu: folds=20
Uncalled bet (52650) returned to JJin91
JJin91 collected 146250 from pot
JJin91: doesn't show hand=20
*** SUMMARY ***
Total pot 146250 | Rake 0=20
Seat 1: CerPrisingLe folded before Flop (didn't bet)
Seat 2: JJin91 collected (146250)
Seat 3: Jivetoast (button) folded before Flop (didn't bet)
Seat 4: narew (small blind) folded before Flop
Seat 5: craxkedu (big blind) folded before Flop
Seat 6: WhiteIce0328 folded before Flop (didn't bet)


*********** # 401 **************
PokerStars Hand #175487033613: Tournament #1701793695, $9.10+$0.90 USD =
Hold'em No Limit - Level XXXVIII (22500/45000) - 2017/09/24 22:12:31 ET
Table '1701793695 18' 6-max Seat #4 is the button
Seat 1: CerPrisingLe (891540 in chips)=20
Seat 2: JJin91 (1418563 in chips)=20
Seat 3: Jivetoast (4030493 in chips)=20
Seat 4: narew (1029579 in chips)=20
Seat 5: craxkedu (1141087 in chips)=20
Seat 6: WhiteIce0328 (2048738 in chips)=20
CerPrisingLe: posts the ante 5625
JJin91: posts the ante 5625
Jivetoast: posts the ante 5625
narew: posts the ante 5625
craxkedu: posts the ante 5625
WhiteIce0328: posts the ante 5625
craxkedu: posts small blind 22500
WhiteIce0328: posts big blind 45000
*** HOLE CARDS ***
Dealt to JJin91 [4d 2c]
CerPrisingLe: folds=20
JJin91: folds=20
Jivetoast: folds=20
narew: folds=20
craxkedu: raises 90000 to 135000
WhiteIce0328: folds=20
Uncalled bet (90000) returned to craxkedu
craxkedu collected 123750 from pot
craxkedu: doesn't show hand=20
*** SUMMARY ***
Total pot 123750 | Rake 0=20
Seat 1: CerPrisingLe folded before Flop (didn't bet)
Seat 2: JJin91 folded before Flop (didn't bet)
Seat 3: Jivetoast folded before Flop (didn't bet)
Seat 4: narew (button) folded before Flop (didn't bet)
Seat 5: craxkedu (small blind) collected (123750)
Seat 6: WhiteIce0328 (big blind) folded before Flop


*********** # 402 **************
PokerStars Hand #175487033739: Tournament #1701793695, $9.10+$0.90 USD =
Hold'em No Limit - Level XXXVIII (22500/45000) - 2017/09/24 22:12:59 ET
Table '1701793695 18' 6-max Seat #5 is the button
Seat 1: CerPrisingLe (885915 in chips)=20
Seat 2: JJin91 (1412938 in chips)=20
Seat 3: Jivetoast (4024868 in chips)=20
Seat 4: narew (1023954 in chips)=20
Seat 5: craxkedu (1214212 in chips)=20
Seat 6: WhiteIce0328 (1998113 in chips)=20
CerPrisingLe: posts the ante 5625
JJin91: posts the ante 5625
Jivetoast: posts the ante 5625
narew: posts the ante 5625
craxkedu: posts the ante 5625
WhiteIce0328: posts the ante 5625
WhiteIce0328: posts small blind 22500
CerPrisingLe: posts big blind 45000
*** HOLE CARDS ***
Dealt to JJin91 [4h 6s]
JJin91: folds=20
Jivetoast is disconnected=20
Jivetoast is connected=20
Jivetoast: raises 90000 to 135000
narew: calls 135000
craxkedu: folds=20
WhiteIce0328: folds=20
CerPrisingLe: calls 90000
*** FLOP *** [4d 9c 4s]
CerPrisingLe: checks=20
Jivetoast: checks=20
narew: bets 135000
CerPrisingLe: folds=20
Jivetoast: calls 135000
*** TURN *** [4d 9c 4s] [Jd]
Jivetoast: checks=20
narew: checks=20
*** RIVER *** [4d 9c 4s Jd] [Js]
Jivetoast: bets 90000
narew: calls 90000
*** SHOW DOWN ***
Jivetoast: shows [As Jh] (a full house, Jacks full of Fours)
narew: mucks hand=20
Jivetoast collected 911250 from pot
*** SUMMARY ***
Total pot 911250 | Rake 0=20
Board [4d 9c 4s Jd Js]
Seat 1: CerPrisingLe (big blind) folded on the Flop
Seat 2: JJin91 folded before Flop (didn't bet)
Seat 3: Jivetoast showed [As Jh] and won (911250) with a full house, Ja=
cks full of Fours
Seat 4: narew mucked [Ac 7c]
Seat 5: craxkedu (button) folded before Flop (didn't bet)
Seat 6: WhiteIce0328 (small blind) folded before Flop


*********** # 403 **************
PokerStars Hand #175487034422: Tournament #1701793695, $9.10+$0.90 USD =
Hold'em No Limit - Level XXXVIII (22500/45000) - 2017/09/24 22:15:47 ET
Table '1701793695 18' 6-max Seat #6 is the button
Seat 1: CerPrisingLe (745290 in chips)=20
Seat 2: JJin91 (1407313 in chips)=20
Seat 3: Jivetoast (4570493 in chips)=20
Seat 4: narew (658329 in chips)=20
Seat 5: craxkedu (1208587 in chips)=20
Seat 6: WhiteIce0328 (1969988 in chips)=20
CerPrisingLe: posts the ante 5625
JJin91: posts the ante 5625
Jivetoast: posts the ante 5625
narew: posts the ante 5625
craxkedu: posts the ante 5625
WhiteIce0328: posts the ante 5625
CerPrisingLe: posts small blind 22500
JJin91: posts big blind 45000
*** HOLE CARDS ***
Dealt to JJin91 [5c 9s]
Jivetoast: folds=20
narew: folds=20
craxkedu: folds=20
WhiteIce0328: folds=20
CerPrisingLe: folds=20
Uncalled bet (22500) returned to JJin91
JJin91 collected 78750 from pot
JJin91: doesn't show hand=20
*** SUMMARY ***
Total pot 78750 | Rake 0=20
Seat 1: CerPrisingLe (small blind) folded before Flop
Seat 2: JJin91 (big blind) collected (78750)
Seat 3: Jivetoast folded before Flop (didn't bet)
Seat 4: narew folded before Flop (didn't bet)
Seat 5: craxkedu folded before Flop (didn't bet)
Seat 6: WhiteIce0328 (button) folded before Flop (didn't bet)


*********** # 404 **************
PokerStars Hand #175487034522: Tournament #1701793695, $9.10+$0.90 USD =
Hold'em No Limit - Level XXXVIII (22500/45000) - 2017/09/24 22:16:09 ET
Table '1701793695 18' 6-max Seat #1 is the button
Seat 1: CerPrisingLe (717165 in chips)=20
Seat 2: JJin91 (1457938 in chips)=20
Seat 3: Jivetoast (4564868 in chips)=20
Seat 4: narew (652704 in chips)=20
Seat 5: craxkedu (1202962 in chips)=20
Seat 6: WhiteIce0328 (1964363 in chips)=20
CerPrisingLe: posts the ante 5625
JJin91: posts the ante 5625
Jivetoast: posts the ante 5625
narew: posts the ante 5625
craxkedu: posts the ante 5625
WhiteIce0328: posts the ante 5625
JJin91: posts small blind 22500
Jivetoast: posts big blind 45000
*** HOLE CARDS ***
Dealt to JJin91 [8c 4h]
narew: folds=20
craxkedu: folds=20
WhiteIce0328: folds=20
CerPrisingLe: folds=20
JJin91: folds=20
Uncalled bet (22500) returned to Jivetoast
Jivetoast collected 78750 from pot
Jivetoast: doesn't show hand=20
*** SUMMARY ***
Total pot 78750 | Rake 0=20
Seat 1: CerPrisingLe (button) folded before Flop (didn't bet)
Seat 2: JJin91 (small blind) folded before Flop
Seat 3: Jivetoast (big blind) collected (78750)
Seat 4: narew folded before Flop (didn't bet)
Seat 5: craxkedu folded before Flop (didn't bet)
Seat 6: WhiteIce0328 folded before Flop (didn't bet)


*********** # 405 **************
PokerStars Hand #175487034640: Tournament #1701793695, $9.10+$0.90 USD =
Hold'em No Limit - Level XXXVIII (22500/45000) - 2017/09/24 22:16:42 ET
Table '1701793695 18' 6-max Seat #2 is the button
Seat 1: CerPrisingLe (711540 in chips)=20
Seat 2: JJin91 (1429813 in chips)=20
Seat 3: Jivetoast (4615493 in chips)=20
Seat 4: narew (647079 in chips)=20
Seat 5: craxkedu (1197337 in chips)=20
Seat 6: WhiteIce0328 (1958738 in chips)=20
CerPrisingLe: posts the ante 5625
JJin91: posts the ante 5625
Jivetoast: posts the ante 5625
narew: posts the ante 5625
craxkedu: posts the ante 5625
WhiteIce0328: posts the ante 5625
Jivetoast: posts small blind 22500
narew: posts big blind 45000
*** HOLE CARDS ***
Dealt to JJin91 [3d Jh]
craxkedu: folds=20
WhiteIce0328: folds=20
CerPrisingLe: folds=20
JJin91: folds=20
Jivetoast: calls 22500
narew: raises 90000 to 135000
Jivetoast: calls 90000
*** FLOP *** [9s 7d Qd]
Jivetoast: checks=20
narew: bets 90000
Jivetoast: folds=20
Uncalled bet (90000) returned to narew
narew collected 303750 from pot
narew: doesn't show hand=20
*** SUMMARY ***
Total pot 303750 | Rake 0=20
Board [9s 7d Qd]
Seat 1: CerPrisingLe folded before Flop (didn't bet)
Seat 2: JJin91 (button) folded before Flop (didn't bet)
Seat 3: Jivetoast (small blind) folded on the Flop
Seat 4: narew (big blind) collected (303750)
Seat 5: craxkedu folded before Flop (didn't bet)
Seat 6: WhiteIce0328 folded before Flop (didn't bet)


*********** # 406 **************
PokerStars Hand #175487034827: Tournament #1701793695, $9.10+$0.90 USD =
Hold'em No Limit - Level XXXVIII (22500/45000) - 2017/09/24 22:17:25 ET
Table '1701793695 18' 6-max Seat #3 is the button
Seat 1: CerPrisingLe (705915 in chips)=20
Seat 2: JJin91 (1424188 in chips)=20
Seat 3: Jivetoast (4474868 in chips)=20
Seat 4: narew (810204 in chips)=20
Seat 5: craxkedu (1191712 in chips)=20
Seat 6: WhiteIce0328 (1953113 in chips)=20
CerPrisingLe: posts the ante 5625
JJin91: posts the ante 5625
Jivetoast: posts the ante 5625
narew: posts the ante 5625
craxkedu: posts the ante 5625
WhiteIce0328: posts the ante 5625
narew: posts small blind 22500
craxkedu: posts big blind 45000
*** HOLE CARDS ***
Dealt to JJin91 [3d Qc]
WhiteIce0328: folds=20
CerPrisingLe: folds=20
JJin91: folds=20
Jivetoast: folds=20
narew: calls 22500
craxkedu: checks=20
*** FLOP *** [Js Ks As]
narew: bets 123750
craxkedu: calls 123750
*** TURN *** [Js Ks As] [Kd]
narew: bets 371250
craxkedu: folds=20
Uncalled bet (371250) returned to narew
narew collected 371250 from pot
narew: doesn't show hand=20
*** SUMMARY ***
Total pot 371250 | Rake 0=20
Board [Js Ks As Kd]
Seat 1: CerPrisingLe folded before Flop (didn't bet)
Seat 2: JJin91 folded before Flop (didn't bet)
Seat 3: Jivetoast (button) folded before Flop (didn't bet)
Seat 4: narew (small blind) collected (371250)
Seat 5: craxkedu (big blind) folded on the Turn
Seat 6: WhiteIce0328 folded before Flop (didn't bet)


*********** # 407 **************
PokerStars Hand #175487035124: Tournament #1701793695, $9.10+$0.90 USD =
Hold'em No Limit - Level XXXVIII (22500/45000) - 2017/09/24 22:18:33 ET
Table '1701793695 18' 6-max Seat #4 is the button
Seat 1: CerPrisingLe (700290 in chips)=20
Seat 2: JJin91 (1418563 in chips)=20
Seat 3: Jivetoast (4469243 in chips)=20
Seat 4: narew (1007079 in chips)=20
Seat 5: craxkedu (1017337 in chips)=20
Seat 6: WhiteIce0328 (1947488 in chips)=20
CerPrisingLe: posts the ante 5625
JJin91: posts the ante 5625
Jivetoast: posts the ante 5625
narew: posts the ante 5625
craxkedu: posts the ante 5625
WhiteIce0328: posts the ante 5625
craxkedu: posts small blind 22500
WhiteIce0328: posts big blind 45000
*** HOLE CARDS ***
Dealt to JJin91 [7d Jh]
CerPrisingLe: folds=20
JJin91: folds=20
Jivetoast: folds=20
narew: folds=20
craxkedu: folds=20
Uncalled bet (22500) returned to WhiteIce0328
WhiteIce0328 collected 78750 from pot
WhiteIce0328: doesn't show hand=20
*** SUMMARY ***
Total pot 78750 | Rake 0=20
Seat 1: CerPrisingLe folded before Flop (didn't bet)
Seat 2: JJin91 folded before Flop (didn't bet)
Seat 3: Jivetoast folded before Flop (didn't bet)
Seat 4: narew (button) folded before Flop (didn't bet)
Seat 5: craxkedu (small blind) folded before Flop
Seat 6: WhiteIce0328 (big blind) collected (78750)


*********** # 408 **************
PokerStars Hand #175487035189: Tournament #1701793695, $9.10+$0.90 USD =
Hold'em No Limit - Level XXXVIII (22500/45000) - 2017/09/24 22:18:50 ET
Table '1701793695 18' 6-max Seat #5 is the button
Seat 1: CerPrisingLe (694665 in chips)=20
Seat 2: JJin91 (1412938 in chips)=20
Seat 3: Jivetoast (4463618 in chips)=20
Seat 4: narew (1001454 in chips)=20
Seat 5: craxkedu (989212 in chips)=20
Seat 6: WhiteIce0328 (1998113 in chips)=20
CerPrisingLe: posts the ante 5625
JJin91: posts the ante 5625
Jivetoast: posts the ante 5625
narew: posts the ante 5625
craxkedu: posts the ante 5625
WhiteIce0328: posts the ante 5625
WhiteIce0328: posts small blind 22500
CerPrisingLe: posts big blind 45000
*** HOLE CARDS ***
Dealt to JJin91 [6s As]
JJin91: raises 52650 to 97650
Jivetoast: folds=20
narew: folds=20
craxkedu: folds=20
WhiteIce0328: folds=20
CerPrisingLe: folds=20
Uncalled bet (52650) returned to JJin91
JJin91 collected 146250 from pot
JJin91: doesn't show hand=20
*** SUMMARY ***
Total pot 146250 | Rake 0=20
Seat 1: CerPrisingLe (big blind) folded before Flop
Seat 2: JJin91 collected (146250)
Seat 3: Jivetoast folded before Flop (didn't bet)
Seat 4: narew folded before Flop (didn't bet)
Seat 5: craxkedu (button) folded before Flop (didn't bet)
Seat 6: WhiteIce0328 (small blind) folded before Flop


*********** # 409 **************
PokerStars Hand #175487035263: Tournament #1701793695, $9.10+$0.90 USD =
Hold'em No Limit - Level XXXVIII (22500/45000) - 2017/09/24 22:19:08 ET
Table '1701793695 18' 6-max Seat #6 is the button
Seat 1: CerPrisingLe (644040 in chips)=20
Seat 2: JJin91 (1508563 in chips)=20
Seat 3: Jivetoast (4457993 in chips)=20
Seat 4: narew (995829 in chips)=20
Seat 5: craxkedu (983587 in chips)=20
Seat 6: WhiteIce0328 (1969988 in chips)=20
CerPrisingLe: posts the ante 5625
JJin91: posts the ante 5625
Jivetoast: posts the ante 5625
narew: posts the ante 5625
craxkedu: posts the ante 5625
WhiteIce0328: posts the ante 5625
CerPrisingLe: posts small blind 22500
JJin91: posts big blind 45000
*** HOLE CARDS ***
Dealt to JJin91 [5c 8c]
Jivetoast: folds=20
narew: folds=20
craxkedu: folds=20
WhiteIce0328: folds=20
CerPrisingLe: calls 22500
JJin91: checks=20
*** FLOP *** [4s 7d Ad]
CerPrisingLe: bets 45000
JJin91: folds=20
Uncalled bet (45000) returned to CerPrisingLe
CerPrisingLe collected 123750 from pot
CerPrisingLe: doesn't show hand=20
*** SUMMARY ***
Total pot 123750 | Rake 0=20
Board [4s 7d Ad]
Seat 1: CerPrisingLe (small blind) collected (123750)
Seat 2: JJin91 (big blind) folded on the Flop
Seat 3: Jivetoast folded before Flop (didn't bet)
Seat 4: narew folded before Flop (didn't bet)
Seat 5: craxkedu folded before Flop (didn't bet)
Seat 6: WhiteIce0328 (button) folded before Flop (didn't bet)


*********** # 410 **************
PokerStars Hand #175487035379: Tournament #1701793695, $9.10+$0.90 USD =
Hold'em No Limit - Level XXXIX (25000/50000) - 2017/09/24 22:19:38 ET
Table '1701793695 18' 6-max Seat #1 is the button
Seat 1: CerPrisingLe (717165 in chips)=20
Seat 2: JJin91 (1457938 in chips)=20
Seat 3: Jivetoast (4452368 in chips)=20
Seat 4: narew (990204 in chips)=20
Seat 5: craxkedu (977962 in chips)=20
Seat 6: WhiteIce0328 (1964363 in chips)=20
CerPrisingLe: posts the ante 6250
JJin91: posts the ante 6250
Jivetoast: posts the ante 6250
narew: posts the ante 6250
craxkedu: posts the ante 6250
WhiteIce0328: posts the ante 6250
JJin91: posts small blind 25000
Jivetoast: posts big blind 50000
*** HOLE CARDS ***
Dealt to JJin91 [7d Js]
narew: folds=20
craxkedu: folds=20
WhiteIce0328: raises 100000 to 150000
CerPrisingLe: folds=20
JJin91: folds=20
Jivetoast: calls 100000
*** FLOP *** [Jd 3c 3s]
Jivetoast: checks=20
WhiteIce0328: checks=20
*** TURN *** [Jd 3c 3s] [7s]
Jivetoast: bets 100000
WhiteIce0328: calls 100000
*** RIVER *** [Jd 3c 3s 7s] [Qs]
Jivetoast: bets 100000
WhiteIce0328: calls 100000
*** SHOW DOWN ***
Jivetoast: shows [Tc Td] (two pair, Tens and Threes)
WhiteIce0328: mucks hand=20
Jivetoast collected 762500 from pot
*** SUMMARY ***
Total pot 762500 | Rake 0=20
Board [Jd 3c 3s 7s Qs]
Seat 1: CerPrisingLe (button) folded before Flop (didn't bet)
Seat 2: JJin91 (small blind) folded before Flop
Seat 3: Jivetoast (big blind) showed [Tc Td] and won (762500) with two =
pair, Tens and Threes
Seat 4: narew folded before Flop (didn't bet)
Seat 5: craxkedu folded before Flop (didn't bet)
Seat 6: WhiteIce0328 mucked [Ac Ts]


*********** # 411 **************
PokerStars Hand #175487035579: Tournament #1701793695, $9.10+$0.90 USD =
Hold'em No Limit - Level XXXIX (25000/50000) - 2017/09/24 22:20:25 ET
Table '1701793695 18' 6-max Seat #2 is the button
Seat 1: CerPrisingLe (710915 in chips)=20
Seat 2: JJin91 (1426688 in chips)=20
Seat 3: Jivetoast (4858618 in chips)=20
Seat 4: narew (983954 in chips)=20
Seat 5: craxkedu (971712 in chips)=20
Seat 6: WhiteIce0328 (1608113 in chips)=20
CerPrisingLe: posts the ante 6250
JJin91: posts the ante 6250
Jivetoast: posts the ante 6250
narew: posts the ante 6250
craxkedu: posts the ante 6250
WhiteIce0328: posts the ante 6250
Jivetoast: posts small blind 25000
narew: posts big blind 50000
*** HOLE CARDS ***
Dealt to JJin91 [9s 7h]
craxkedu: calls 50000
WhiteIce0328: folds=20
CerPrisingLe: folds=20
JJin91: folds=20
Jivetoast: calls 25000
narew: checks=20
*** FLOP *** [6c 2h Th]
Jivetoast: checks=20
narew: bets 93750
craxkedu: folds=20
Jivetoast: folds=20
Uncalled bet (93750) returned to narew
narew collected 187500 from pot
narew: doesn't show hand=20
*** SUMMARY ***
Total pot 187500 | Rake 0=20
Board [6c 2h Th]
Seat 1: CerPrisingLe folded before Flop (didn't bet)
Seat 2: JJin91 (button) folded before Flop (didn't bet)
Seat 3: Jivetoast (small blind) folded on the Flop
Seat 4: narew (big blind) collected (187500)
Seat 5: craxkedu folded on the Flop
Seat 6: WhiteIce0328 folded before Flop (didn't bet)


*********** # 412 **************
PokerStars Hand #175487035741: Tournament #1701793695, $9.10+$0.90 USD =
Hold'em No Limit - Level XXXIX (25000/50000) - 2017/09/24 22:21:04 ET
Table '1701793695 18' 6-max Seat #3 is the button
Seat 1: CerPrisingLe (704665 in chips)=20
Seat 2: JJin91 (1420438 in chips)=20
Seat 3: Jivetoast (4802368 in chips)=20
Seat 4: narew (1115204 in chips)=20
Seat 5: craxkedu (915462 in chips)=20
Seat 6: WhiteIce0328 (1601863 in chips)=20
CerPrisingLe: posts the ante 6250
JJin91: posts the ante 6250
Jivetoast: posts the ante 6250
narew: posts the ante 6250
craxkedu: posts the ante 6250
WhiteIce0328: posts the ante 6250
narew: posts small blind 25000
craxkedu: posts big blind 50000
*** HOLE CARDS ***
Dealt to JJin91 [Kc 5d]
WhiteIce0328: raises 50000 to 100000
CerPrisingLe: folds=20
JJin91: folds=20
Jivetoast: calls 100000
narew: folds=20
craxkedu: folds=20
*** FLOP *** [4s 3s 9d]
WhiteIce0328: checks=20
Jivetoast: bets 100000
WhiteIce0328: calls 100000
*** TURN *** [4s 3s 9d] [2d]
WhiteIce0328: checks=20
Jivetoast: bets 150000
WhiteIce0328: calls 150000
*** RIVER *** [4s 3s 9d 2d] [Kd]
WhiteIce0328: checks=20
Jivetoast: bets 100000
WhiteIce0328: folds=20
Uncalled bet (100000) returned to Jivetoast
Jivetoast collected 812500 from pot
Jivetoast: doesn't show hand=20
*** SUMMARY ***
Total pot 812500 | Rake 0=20
Board [4s 3s 9d 2d Kd]
Seat 1: CerPrisingLe folded before Flop (didn't bet)
Seat 2: JJin91 folded before Flop (didn't bet)
Seat 3: Jivetoast (button) collected (812500)
Seat 4: narew (small blind) folded before Flop
Seat 5: craxkedu (big blind) folded before Flop
Seat 6: WhiteIce0328 folded on the River


*********** # 413 **************
PokerStars Hand #175487035891: Tournament #1701793695, $9.10+$0.90 USD =
Hold'em No Limit - Level XXXIX (25000/50000) - 2017/09/24 22:21:40 ET
Table '1701793695 18' 6-max Seat #4 is the button
Seat 1: CerPrisingLe (698415 in chips)=20
Seat 2: JJin91 (1414188 in chips)=20
Seat 3: Jivetoast (5258618 in chips)=20
Seat 4: narew (1083954 in chips)=20
Seat 5: craxkedu (859212 in chips)=20
Seat 6: WhiteIce0328 (1245613 in chips)=20
CerPrisingLe: posts the ante 6250
JJin91: posts the ante 6250
Jivetoast: posts the ante 6250
narew: posts the ante 6250
craxkedu: posts the ante 6250
WhiteIce0328: posts the ante 6250
craxkedu: posts small blind 25000
WhiteIce0328: posts big blind 50000
*** HOLE CARDS ***
Dealt to JJin91 [3h 9h]
CerPrisingLe: folds=20
JJin91: folds=20
Jivetoast has timed out while disconnected
Jivetoast: folds=20
Jivetoast is sitting out
Jivetoast has returned
narew: raises 100000 to 150000
craxkedu: folds=20
WhiteIce0328: calls 100000
*** FLOP *** [As Ad 8h]
WhiteIce0328: checks=20
narew: checks=20
*** TURN *** [As Ad 8h] [5c]
WhiteIce0328: checks=20
narew: bets 100000
WhiteIce0328: folds=20
Uncalled bet (100000) returned to narew
narew collected 362500 from pot
narew: doesn't show hand=20
*** SUMMARY ***
Total pot 362500 | Rake 0=20
Board [As Ad 8h 5c]
Seat 1: CerPrisingLe folded before Flop (didn't bet)
Seat 2: JJin91 folded before Flop (didn't bet)
Seat 3: Jivetoast folded before Flop (didn't bet)
Seat 4: narew (button) collected (362500)
Seat 5: craxkedu (small blind) folded before Flop
Seat 6: WhiteIce0328 (big blind) folded on the Turn


*********** # 414 **************
PokerStars Hand #175487036102: Tournament #1701793695, $9.10+$0.90 USD =
Hold'em No Limit - Level XXXIX (25000/50000) - 2017/09/24 22:22:35 ET
Table '1701793695 18' 6-max Seat #5 is the button
Seat 1: CerPrisingLe (692165 in chips)=20
Seat 2: JJin91 (1407938 in chips)=20
Seat 3: Jivetoast (5252368 in chips)=20
Seat 4: narew (1290204 in chips)=20
Seat 5: craxkedu (827962 in chips)=20
Seat 6: WhiteIce0328 (1089363 in chips)=20
CerPrisingLe: posts the ante 6250
JJin91: posts the ante 6250
Jivetoast: posts the ante 6250
narew: posts the ante 6250
craxkedu: posts the ante 6250
WhiteIce0328: posts the ante 6250
WhiteIce0328: posts small blind 25000
CerPrisingLe: posts big blind 50000
*** HOLE CARDS ***
Dealt to JJin91 [6h 6c]
JJin91: raises 58500 to 108500
Jivetoast: folds=20
narew: folds=20
craxkedu: folds=20
WhiteIce0328: folds=20
CerPrisingLe: folds=20
Uncalled bet (58500) returned to JJin91
JJin91 collected 162500 from pot
JJin91: doesn't show hand=20
*** SUMMARY ***
Total pot 162500 | Rake 0=20
Seat 1: CerPrisingLe (big blind) folded before Flop
Seat 2: JJin91 collected (162500)
Seat 3: Jivetoast folded before Flop (didn't bet)
Seat 4: narew folded before Flop (didn't bet)
Seat 5: craxkedu (button) folded before Flop (didn't bet)
Seat 6: WhiteIce0328 (small blind) folded before Flop


*********** # 415 **************
PokerStars Hand #175487036191: Tournament #1701793695, $9.10+$0.90 USD =
Hold'em No Limit - Level XXXIX (25000/50000) - 2017/09/24 22:22:54 ET
Table '1701793695 18' 6-max Seat #6 is the button
Seat 1: CerPrisingLe (635915 in chips)=20
Seat 2: JJin91 (1514188 in chips)=20
Seat 3: Jivetoast (5246118 in chips)=20
Seat 4: narew (1283954 in chips)=20
Seat 5: craxkedu (821712 in chips)=20
Seat 6: WhiteIce0328 (1058113 in chips)=20
CerPrisingLe: posts the ante 6250
JJin91: posts the ante 6250
Jivetoast: posts the ante 6250
narew: posts the ante 6250
craxkedu: posts the ante 6250
WhiteIce0328: posts the ante 6250
CerPrisingLe: posts small blind 25000
JJin91: posts big blind 50000
*** HOLE CARDS ***
Dealt to JJin91 [2d Jh]
Jivetoast: folds=20
narew: folds=20
craxkedu: folds=20
WhiteIce0328: folds=20
CerPrisingLe: folds=20
Uncalled bet (25000) returned to JJin91
JJin91 collected 87500 from pot
JJin91: doesn't show hand=20
*** SUMMARY ***
Total pot 87500 | Rake 0=20
Seat 1: CerPrisingLe (small blind) folded before Flop
Seat 2: JJin91 (big blind) collected (87500)
Seat 3: Jivetoast folded before Flop (didn't bet)
Seat 4: narew folded before Flop (didn't bet)
Seat 5: craxkedu folded before Flop (didn't bet)
Seat 6: WhiteIce0328 (button) folded before Flop (didn't bet)


*********** # 416 **************
PokerStars Hand #175487036297: Tournament #1701793695, $9.10+$0.90 USD =
Hold'em No Limit - Level XXXIX (25000/50000) - 2017/09/24 22:23:19 ET
Table '1701793695 18' 6-max Seat #1 is the button
Seat 1: CerPrisingLe (604665 in chips)=20
Seat 2: JJin91 (1570438 in chips)=20
Seat 3: Jivetoast (5239868 in chips)=20
Seat 4: narew (1277704 in chips)=20
Seat 5: craxkedu (815462 in chips)=20
Seat 6: WhiteIce0328 (1051863 in chips)=20
CerPrisingLe: posts the ante 6250
JJin91: posts the ante 6250
Jivetoast: posts the ante 6250
narew: posts the ante 6250
craxkedu: posts the ante 6250
WhiteIce0328: posts the ante 6250
JJin91: posts small blind 25000
Jivetoast: posts big blind 50000
*** HOLE CARDS ***
Dealt to JJin91 [8h 5c]
narew: folds=20
craxkedu: folds=20
WhiteIce0328: folds=20
CerPrisingLe: folds=20
JJin91: folds=20
Uncalled bet (25000) returned to Jivetoast
Jivetoast collected 87500 from pot
Jivetoast: doesn't show hand=20
*** SUMMARY ***
Total pot 87500 | Rake 0=20
Seat 1: CerPrisingLe (button) folded before Flop (didn't bet)
Seat 2: JJin91 (small blind) folded before Flop
Seat 3: Jivetoast (big blind) collected (87500)
Seat 4: narew folded before Flop (didn't bet)
Seat 5: craxkedu folded before Flop (didn't bet)
Seat 6: WhiteIce0328 folded before Flop (didn't bet)


*********** # 417 **************
PokerStars Hand #175487036361: Tournament #1701793695, $9.10+$0.90 USD =
Hold'em No Limit - Level XXXIX (25000/50000) - 2017/09/24 22:23:35 ET
Table '1701793695 18' 6-max Seat #2 is the button
Seat 1: CerPrisingLe (598415 in chips)=20
Seat 2: JJin91 (1539188 in chips)=20
Seat 3: Jivetoast (5296118 in chips)=20
Seat 4: narew (1271454 in chips)=20
Seat 5: craxkedu (809212 in chips)=20
Seat 6: WhiteIce0328 (1045613 in chips)=20
CerPrisingLe: posts the ante 6250
JJin91: posts the ante 6250
Jivetoast: posts the ante 6250
narew: posts the ante 6250
craxkedu: posts the ante 6250
WhiteIce0328: posts the ante 6250
Jivetoast: posts small blind 25000
narew: posts big blind 50000
*** HOLE CARDS ***
Dealt to JJin91 [5h 7d]
craxkedu: folds=20
WhiteIce0328: raises 100000 to 150000
CerPrisingLe: folds=20
JJin91: folds=20
Jivetoast: folds=20
narew: raises 1115204 to 1265204 and is all-in
WhiteIce0328: folds [7s 7h]
Uncalled bet (1115204) returned to narew
narew collected 362500 from pot
narew: doesn't show hand=20
*** SUMMARY ***
Total pot 362500 | Rake 0=20
Seat 1: CerPrisingLe folded before Flop (didn't bet)
Seat 2: JJin91 (button) folded before Flop (didn't bet)
Seat 3: Jivetoast (small blind) folded before Flop
Seat 4: narew (big blind) collected (362500)
Seat 5: craxkedu folded before Flop (didn't bet)
Seat 6: WhiteIce0328 folded before Flop


*********** # 418 **************
PokerStars Hand #175487036537: Tournament #1701793695, $9.10+$0.90 USD =
Hold'em No Limit - Level XXXIX (25000/50000) - 2017/09/24 22:24:20 ET
Table '1701793695 18' 6-max Seat #3 is the button
Seat 1: CerPrisingLe (592165 in chips)=20
Seat 2: JJin91 (1532938 in chips)=20
Seat 3: Jivetoast (5264868 in chips)=20
Seat 4: narew (1477704 in chips)=20
Seat 5: craxkedu (802962 in chips)=20
Seat 6: WhiteIce0328 (889363 in chips)=20
CerPrisingLe: posts the ante 6250
JJin91: posts the ante 6250
Jivetoast: posts the ante 6250
narew: posts the ante 6250
craxkedu: posts the ante 6250
WhiteIce0328: posts the ante 6250
narew: posts small blind 25000
craxkedu: posts big blind 50000
*** HOLE CARDS ***
Dealt to JJin91 [5c Kd]
WhiteIce0328: folds=20
CerPrisingLe: folds=20
JJin91: raises 58500 to 108500
Jivetoast: folds=20
narew: folds=20
craxkedu: folds=20
Uncalled bet (58500) returned to JJin91
JJin91 collected 162500 from pot
JJin91: doesn't show hand=20
*** SUMMARY ***
Total pot 162500 | Rake 0=20
Seat 1: CerPrisingLe folded before Flop (didn't bet)
Seat 2: JJin91 collected (162500)
Seat 3: Jivetoast (button) folded before Flop (didn't bet)
Seat 4: narew (small blind) folded before Flop
Seat 5: craxkedu (big blind) folded before Flop
Seat 6: WhiteIce0328 folded before Flop (didn't bet)


*********** # 419 **************
PokerStars Hand #175487036597: Tournament #1701793695, $9.10+$0.90 USD =
Hold'em No Limit - Level XXXIX (25000/50000) - 2017/09/24 22:24:33 ET
Table '1701793695 18' 6-max Seat #4 is the button
Seat 1: CerPrisingLe (585915 in chips)=20
Seat 2: JJin91 (1639188 in chips)=20
Seat 3: Jivetoast (5258618 in chips)=20
Seat 4: narew (1446454 in chips)=20
Seat 5: craxkedu (746712 in chips)=20
Seat 6: WhiteIce0328 (883113 in chips)=20
CerPrisingLe: posts the ante 6250
JJin91: posts the ante 6250
Jivetoast: posts the ante 6250
narew: posts the ante 6250
craxkedu: posts the ante 6250
WhiteIce0328: posts the ante 6250
craxkedu: posts small blind 25000
WhiteIce0328: posts big blind 50000
*** HOLE CARDS ***
Dealt to JJin91 [Kd Js]
CerPrisingLe: folds=20
JJin91: raises 58500 to 108500
Jivetoast: folds=20
narew: folds=20
craxkedu: folds=20
WhiteIce0328: folds=20
Uncalled bet (58500) returned to JJin91
JJin91 collected 162500 from pot
JJin91: doesn't show hand=20
*** SUMMARY ***
Total pot 162500 | Rake 0=20
Seat 1: CerPrisingLe folded before Flop (didn't bet)
Seat 2: JJin91 collected (162500)
Seat 3: Jivetoast folded before Flop (didn't bet)
Seat 4: narew (button) folded before Flop (didn't bet)
Seat 5: craxkedu (small blind) folded before Flop
Seat 6: WhiteIce0328 (big blind) folded before Flop


*********** # 420 **************
PokerStars Hand #175487036646: Tournament #1701793695, $9.10+$0.90 USD =
Hold'em No Limit - Level XXXIX (25000/50000) - 2017/09/24 22:24:46 ET
Table '1701793695 18' 6-max Seat #5 is the button
Seat 1: CerPrisingLe (579665 in chips)=20
Seat 2: JJin91 (1745438 in chips)=20
Seat 3: Jivetoast (5252368 in chips)=20
Seat 4: narew (1440204 in chips)=20
Seat 5: craxkedu (715462 in chips)=20
Seat 6: WhiteIce0328 (826863 in chips)=20
CerPrisingLe: posts the ante 6250
JJin91: posts the ante 6250
Jivetoast: posts the ante 6250
narew: posts the ante 6250
craxkedu: posts the ante 6250
WhiteIce0328: posts the ante 6250
WhiteIce0328: posts small blind 25000
CerPrisingLe: posts big blind 50000
*** HOLE CARDS ***
Dealt to JJin91 [3c Ad]
JJin91: folds=20
Jivetoast: raises 100000 to 150000
narew: folds=20
craxkedu: folds=20
WhiteIce0328: folds=20
CerPrisingLe: folds=20
Uncalled bet (100000) returned to Jivetoast
Jivetoast collected 162500 from pot
Jivetoast: doesn't show hand=20
*** SUMMARY ***
Total pot 162500 | Rake 0=20
Seat 1: CerPrisingLe (big blind) folded before Flop
Seat 2: JJin91 folded before Flop (didn't bet)
Seat 3: Jivetoast collected (162500)
Seat 4: narew folded before Flop (didn't bet)
Seat 5: craxkedu (button) folded before Flop (didn't bet)
Seat 6: WhiteIce0328 (small blind) folded before Flop


*********** # 421 **************
PokerStars Hand #175487036741: Tournament #1701793695, $9.10+$0.90 USD =
Hold'em No Limit - Level XXXIX (25000/50000) - 2017/09/24 22:25:08 ET
Table '1701793695 18' 6-max Seat #6 is the button
Seat 1: CerPrisingLe (523415 in chips)=20
Seat 2: JJin91 (1739188 in chips)=20
Seat 3: Jivetoast (5358618 in chips)=20
Seat 4: narew (1433954 in chips)=20
Seat 5: craxkedu (709212 in chips)=20
Seat 6: WhiteIce0328 (795613 in chips)=20
CerPrisingLe: posts the ante 6250
JJin91: posts the ante 6250
Jivetoast: posts the ante 6250
narew: posts the ante 6250
craxkedu: posts the ante 6250
WhiteIce0328: posts the ante 6250
CerPrisingLe: posts small blind 25000
JJin91: posts big blind 50000
*** HOLE CARDS ***
Dealt to JJin91 [Kh Kd]
Jivetoast: raises 50000 to 100000
narew: folds=20
craxkedu: calls 100000
WhiteIce0328: raises 689363 to 789363 and is all-in
CerPrisingLe: folds=20
JJin91: raises 943575 to 1732938 and is all-in
Jivetoast: folds=20
craxkedu: folds=20
Uncalled bet (943575) returned to JJin91
*** FLOP *** [9d 3d 5s]
*** TURN *** [9d 3d 5s] [Ad]
*** RIVER *** [9d 3d 5s Ad] [5d]
*** SHOW DOWN ***
JJin91: shows [Kh Kd] (a flush, Ace high)
WhiteIce0328: shows [Qh As] (two pair, Aces and Fives)
JJin91 collected 1841226 from pot
WhiteIce0328 finished the tournament in 6th place and received $160.00.
*** SUMMARY ***
Total pot 1841226 | Rake 0=20
Board [9d 3d 5s Ad 5d]
Seat 1: CerPrisingLe (small blind) folded before Flop
Seat 2: JJin91 (big blind) showed [Kh Kd] and won (1841226) with a flus=
h, Ace high
Seat 3: Jivetoast folded before Flop
Seat 4: narew folded before Flop (didn't bet)
Seat 5: craxkedu folded before Flop
Seat 6: WhiteIce0328 (button) showed [Qh As] and lost with two pair, Ac=
es and Fives


*********** # 422 **************
PokerStars Hand #175487036885: Tournament #1701793695, $9.10+$0.90 USD =
Hold'em No Limit - Level XXXIX (25000/50000) - 2017/09/24 22:25:40 ET
Table '1701793695 18' 6-max Seat #1 is the button
Seat 1: CerPrisingLe (492165 in chips)=20
Seat 2: JJin91 (2784801 in chips)=20
Seat 3: Jivetoast (5252368 in chips)=20
Seat 4: narew (1427704 in chips)=20
Seat 5: craxkedu (602962 in chips)=20
CerPrisingLe: posts the ante 6250
JJin91: posts the ante 6250
Jivetoast: posts the ante 6250
narew: posts the ante 6250
craxkedu: posts the ante 6250
JJin91: posts small blind 25000
Jivetoast: posts big blind 50000
*** HOLE CARDS ***
Dealt to JJin91 [As 2c]
narew: folds=20
craxkedu: folds=20
CerPrisingLe: folds=20
JJin91: calls 25000
Jivetoast: checks=20
*** FLOP *** [9h Ah Jc]
JJin91: checks=20
Jivetoast: bets 100000
JJin91: calls 100000
*** TURN *** [9h Ah Jc] [7h]
JJin91: checks=20
Jivetoast: bets 165625
JJin91: calls 165625
*** RIVER *** [9h Ah Jc 7h] [9s]
JJin91: checks=20
Jivetoast: checks=20
*** SHOW DOWN ***
JJin91: shows [As 2c] (two pair, Aces and Nines)
Jivetoast: mucks hand=20
JJin91 collected 662500 from pot
*** SUMMARY ***
Total pot 662500 | Rake 0=20
Board [9h Ah Jc 7h 9s]
Seat 1: CerPrisingLe (button) folded before Flop (didn't bet)
Seat 2: JJin91 (small blind) showed [As 2c] and won (662500) with two p=
air, Aces and Nines
Seat 3: Jivetoast (big blind) mucked [4d 2h]
Seat 4: narew folded before Flop (didn't bet)
Seat 5: craxkedu folded before Flop (didn't bet)


*********** # 423 **************
PokerStars Hand #175487037045: Tournament #1701793695, $9.10+$0.90 USD =
Hold'em No Limit - Level XXXIX (25000/50000) - 2017/09/24 22:26:15 ET
Table '1701793695 18' 6-max Seat #2 is the button
Seat 1: CerPrisingLe (485915 in chips)=20
Seat 2: JJin91 (3125426 in chips)=20
Seat 3: Jivetoast (4930493 in chips)=20
Seat 4: narew (1421454 in chips)=20
Seat 5: craxkedu (596712 in chips)=20
CerPrisingLe: posts the ante 6250
JJin91: posts the ante 6250
Jivetoast: posts the ante 6250
narew: posts the ante 6250
craxkedu: posts the ante 6250
Jivetoast: posts small blind 25000
narew: posts big blind 50000
*** HOLE CARDS ***
Dealt to JJin91 [6h 5c]
craxkedu: folds=20
CerPrisingLe: folds=20
JJin91: folds=20
Jivetoast: raises 4874243 to 4924243 and is all-in
narew has timed out
narew: folds=20
Uncalled bet (4874243) returned to Jivetoast
narew is sitting out
Jivetoast collected 131250 from pot
Jivetoast: doesn't show hand=20
narew has returned
*** SUMMARY ***
Total pot 131250 | Rake 0=20
Seat 1: CerPrisingLe folded before Flop (didn't bet)
Seat 2: JJin91 (button) folded before Flop (didn't bet)
Seat 3: Jivetoast (small blind) collected (131250)
Seat 4: narew (big blind) folded before Flop
Seat 5: craxkedu folded before Flop (didn't bet)


*********** # 424 **************
PokerStars Hand #175487037178: Tournament #1701793695, $9.10+$0.90 USD =
Hold'em No Limit - Level XXXIX (25000/50000) - 2017/09/24 22:26:45 ET
Table '1701793695 18' 6-max Seat #3 is the button
Seat 1: CerPrisingLe (479665 in chips)=20
Seat 2: JJin91 (3119176 in chips)=20
Seat 3: Jivetoast (5005493 in chips)=20
Seat 4: narew (1365204 in chips)=20
Seat 5: craxkedu (590462 in chips)=20
CerPrisingLe: posts the ante 6250
JJin91: posts the ante 6250
Jivetoast: posts the ante 6250
narew: posts the ante 6250
craxkedu: posts the ante 6250
narew: posts small blind 25000
craxkedu: posts big blind 50000
*** HOLE CARDS ***
Dealt to JJin91 [5h Td]
CerPrisingLe: raises 423415 to 473415 and is all-in
JJin91: folds=20
Jivetoast: folds=20
narew: folds=20
craxkedu: calls 423415
*** FLOP *** [Ks 9s As]
*** TURN *** [Ks 9s As] [Qc]
*** RIVER *** [Ks 9s As Qc] [2c]
*** SHOW DOWN ***
craxkedu: shows [Th Ad] (a pair of Aces)
CerPrisingLe: shows [Ac Js] (a pair of Aces - King+Queen+Jack kicker)
CerPrisingLe collected 1003080 from pot
*** SUMMARY ***
Total pot 1003080 | Rake 0=20
Board [Ks 9s As Qc 2c]
Seat 1: CerPrisingLe showed [Ac Js] and won (1003080) with a pair of Ac=
es
Seat 2: JJin91 folded before Flop (didn't bet)
Seat 3: Jivetoast (button) folded before Flop (didn't bet)
Seat 4: narew (small blind) folded before Flop
Seat 5: craxkedu (big blind) showed [Th Ad] and lost with a pair of Aces


*********** # 425 **************
PokerStars Hand #175487037281: Tournament #1701793695, $9.10+$0.90 USD =
Hold'em No Limit - Level XXXIX (25000/50000) - 2017/09/24 22:27:09 ET
Table '1701793695 18' 6-max Seat #4 is the button
Seat 1: CerPrisingLe (1003080 in chips)=20
Seat 2: JJin91 (3112926 in chips)=20
Seat 3: Jivetoast (4999243 in chips)=20
Seat 4: narew (1333954 in chips)=20
Seat 5: craxkedu (110797 in chips)=20
CerPrisingLe: posts the ante 6250
JJin91: posts the ante 6250
Jivetoast: posts the ante 6250
narew: posts the ante 6250
craxkedu: posts the ante 6250
craxkedu: posts small blind 25000
CerPrisingLe: posts big blind 50000
*** HOLE CARDS ***
Dealt to JJin91 [5s 3c]
JJin91: folds=20
Jivetoast: folds=20
narew: raises 100000 to 150000
craxkedu: calls 79547 and is all-in
CerPrisingLe: folds=20
Uncalled bet (45453) returned to narew
*** FLOP *** [3d 9d Ts]
*** TURN *** [3d 9d Ts] [6h]
*** RIVER *** [3d 9d Ts 6h] [8h]
*** SHOW DOWN ***
craxkedu: shows [Tc Jh] (a pair of Tens)
narew: shows [Td Kh] (a pair of Tens - King kicker)
narew collected 290344 from pot
craxkedu finished the tournament in 5th place and received $250.00.
*** SUMMARY ***
Total pot 290344 | Rake 0=20
Board [3d 9d Ts 6h 8h]
Seat 1: CerPrisingLe (big blind) folded before Flop
Seat 2: JJin91 folded before Flop (didn't bet)
Seat 3: Jivetoast folded before Flop (didn't bet)
Seat 4: narew (button) showed [Td Kh] and won (290344) with a pair of T=
ens
Seat 5: craxkedu (small blind) showed [Tc Jh] and lost with a pair of T=
ens


*********** # 426 **************
PokerStars Hand #175487037391: Tournament #1701793695, $9.10+$0.90 USD =
Hold'em No Limit - Level XXXIX (25000/50000) - 2017/09/24 22:27:35 ET
Table '1701793695 18' 6-max Seat #1 is the button
Seat 1: CerPrisingLe (946830 in chips)=20
Seat 2: JJin91 (3106676 in chips)=20
Seat 3: Jivetoast (4992993 in chips)=20
Seat 4: narew (1513501 in chips)=20
CerPrisingLe: posts the ante 6250
JJin91: posts the ante 6250
Jivetoast: posts the ante 6250
narew: posts the ante 6250
JJin91: posts small blind 25000
Jivetoast: posts big blind 50000
*** HOLE CARDS ***
Dealt to JJin91 [6h 3s]
narew: folds=20
CerPrisingLe: folds=20
JJin91: folds=20
Uncalled bet (25000) returned to Jivetoast
Jivetoast collected 75000 from pot
Jivetoast: doesn't show hand=20
*** SUMMARY ***
Total pot 75000 | Rake 0=20
Seat 1: CerPrisingLe (button) folded before Flop (didn't bet)
Seat 2: JJin91 (small blind) folded before Flop
Seat 3: Jivetoast (big blind) collected (75000)
Seat 4: narew folded before Flop (didn't bet)


*********** # 427 **************
PokerStars Hand #175487037474: Tournament #1701793695, $9.10+$0.90 USD =
Hold'em No Limit - Level XXXIX (25000/50000) - 2017/09/24 22:27:53 ET
Table '1701793695 18' 6-max Seat #2 is the button
Seat 1: CerPrisingLe (940580 in chips)=20
Seat 2: JJin91 (3075426 in chips)=20
Seat 3: Jivetoast (5036743 in chips)=20
Seat 4: narew (1507251 in chips)=20
CerPrisingLe: posts the ante 6250
JJin91: posts the ante 6250
Jivetoast: posts the ante 6250
narew: posts the ante 6250
Jivetoast: posts small blind 25000
narew: posts big blind 50000
*** HOLE CARDS ***
Dealt to JJin91 [Ad Qd]
CerPrisingLe: folds=20
JJin91: raises 58500 to 108500
Jivetoast: folds=20
narew: calls 58500
*** FLOP *** [6d 5h 3h]
narew: checks=20
JJin91: checks=20
*** TURN *** [6d 5h 3h] [8d]
narew: bets 100000
JJin91: calls 100000
*** RIVER *** [6d 5h 3h 8d] [3c]
narew: bets 200000
JJin91: folds=20
Uncalled bet (200000) returned to narew
narew collected 467000 from pot
narew: doesn't show hand=20
*** SUMMARY ***
Total pot 467000 | Rake 0=20
Board [6d 5h 3h 8d 3c]
Seat 1: CerPrisingLe folded before Flop (didn't bet)
Seat 2: JJin91 (button) folded on the River
Seat 3: Jivetoast (small blind) folded before Flop
Seat 4: narew (big blind) collected (467000)


*********** # 428 **************
PokerStars Hand #175487037740: Tournament #1701793695, $9.10+$0.90 USD =
Hold'em No Limit - Level XXXIX (25000/50000) - 2017/09/24 22:28:58 ET
Table '1701793695 18' 6-max Seat #3 is the button
Seat 1: CerPrisingLe (934330 in chips)=20
Seat 2: JJin91 (2860676 in chips)=20
Seat 3: Jivetoast (5005493 in chips)=20
Seat 4: narew (1759501 in chips)=20
CerPrisingLe: posts the ante 6250
JJin91: posts the ante 6250
Jivetoast: posts the ante 6250
narew: posts the ante 6250
narew: posts small blind 25000
CerPrisingLe: posts big blind 50000
*** HOLE CARDS ***
Dealt to JJin91 [Td Th]
JJin91: raises 58500 to 108500
Jivetoast: calls 108500
narew: calls 83500
CerPrisingLe: folds=20
*** FLOP *** [Qd Ts Ac]
narew: checks=20
JJin91: bets 289998
Jivetoast: folds=20
narew: folds=20
Uncalled bet (289998) returned to JJin91
JJin91 collected 400500 from pot
JJin91: doesn't show hand=20
*** SUMMARY ***
Total pot 400500 | Rake 0=20
Board [Qd Ts Ac]
Seat 1: CerPrisingLe (big blind) folded before Flop
Seat 2: JJin91 collected (400500)
Seat 3: Jivetoast (button) folded on the Flop
Seat 4: narew (small blind) folded on the Flop


*********** # 429 **************
PokerStars Hand #175487037929: Tournament #1701793695, $9.10+$0.90 USD =
Hold'em No Limit - Level XL (30000/60000) - 2017/09/24 22:29:44 ET
Table '1701793695 18' 6-max Seat #4 is the button
Seat 1: CerPrisingLe (878080 in chips)=20
Seat 2: JJin91 (3146426 in chips)=20
Seat 3: Jivetoast (4890743 in chips)=20
Seat 4: narew (1644751 in chips)=20
CerPrisingLe: posts the ante 7500
JJin91: posts the ante 7500
Jivetoast: posts the ante 7500
narew: posts the ante 7500
CerPrisingLe: posts small blind 30000
JJin91: posts big blind 60000
*** HOLE CARDS ***
Dealt to JJin91 [Qd 6h]
Jivetoast: folds=20
narew: folds=20
CerPrisingLe: calls 30000
JJin91: checks=20
*** FLOP *** [7d 3c Ac]
CerPrisingLe: checks=20
JJin91: bets 77777
CerPrisingLe: raises 732803 to 810580 and is all-in
JJin91: folds=20
Uncalled bet (732803) returned to CerPrisingLe
CerPrisingLe collected 305554 from pot
CerPrisingLe: doesn't show hand=20
*** SUMMARY ***
Total pot 305554 | Rake 0=20
Board [7d 3c Ac]
Seat 1: CerPrisingLe (small blind) collected (305554)
Seat 2: JJin91 (big blind) folded on the Flop
Seat 3: Jivetoast folded before Flop (didn't bet)
Seat 4: narew (button) folded before Flop (didn't bet)


*********** # 430 **************
PokerStars Hand #175487038088: Tournament #1701793695, $9.10+$0.90 USD =
Hold'em No Limit - Level XL (30000/60000) - 2017/09/24 22:30:21 ET
Table '1701793695 18' 6-max Seat #1 is the button
Seat 1: CerPrisingLe (1038357 in chips)=20
Seat 2: JJin91 (3001149 in chips)=20
Seat 3: Jivetoast (4883243 in chips)=20
Seat 4: narew (1637251 in chips)=20
CerPrisingLe: posts the ante 7500
JJin91: posts the ante 7500
Jivetoast: posts the ante 7500
narew: posts the ante 7500
JJin91: posts small blind 30000
Jivetoast: posts big blind 60000
*** HOLE CARDS ***
Dealt to JJin91 [3h Qc]
narew: raises 120000 to 180000
CerPrisingLe: folds=20
JJin91: folds=20
Jivetoast: calls 120000
*** FLOP *** [6h 2s 4c]
Jivetoast: checks=20
narew: bets 210000
Jivetoast: calls 210000
*** TURN *** [6h 2s 4c] [2d]
Jivetoast: checks=20
narew: checks=20
*** RIVER *** [6h 2s 4c 2d] [Js]
Jivetoast: bets 420000
narew: calls 420000
*** SHOW DOWN ***
Jivetoast: shows [Qh 4d] (two pair, Fours and Deuces)
narew: shows [Th Td] (two pair, Tens and Deuces)
narew collected 1680000 from pot
*** SUMMARY ***
Total pot 1680000 | Rake 0=20
Board [6h 2s 4c 2d Js]
Seat 1: CerPrisingLe (button) folded before Flop (didn't bet)
Seat 2: JJin91 (small blind) folded before Flop
Seat 3: Jivetoast (big blind) showed [Qh 4d] and lost with two pair, Fo=
urs and Deuces
Seat 4: narew showed [Th Td] and won (1680000) with two pair, Tens and =
Deuces


*********** # 431 **************
PokerStars Hand #175487038307: Tournament #1701793695, $9.10+$0.90 USD =
Hold'em No Limit - Level XL (30000/60000) - 2017/09/24 22:31:10 ET
Table '1701793695 18' 6-max Seat #2 is the button
Seat 1: CerPrisingLe (1030857 in chips)=20
Seat 2: JJin91 (2963649 in chips)=20
Seat 3: Jivetoast (4065743 in chips)=20
Seat 4: narew (2499751 in chips)=20
CerPrisingLe: posts the ante 7500
JJin91: posts the ante 7500
Jivetoast: posts the ante 7500
narew: posts the ante 7500
Jivetoast: posts small blind 30000
narew: posts big blind 60000
*** HOLE CARDS ***
Dealt to JJin91 [9d 8s]
CerPrisingLe: folds=20
JJin91: raises 70200 to 130200
Jivetoast: folds=20
narew: calls 70200
*** FLOP *** [Jc Jd Jh]
narew: checks=20
JJin91: checks=20
*** TURN *** [Jc Jd Jh] [Th]
narew: checks=20
JJin91: bets 233892
narew: folds=20
Uncalled bet (233892) returned to JJin91
JJin91 collected 320400 from pot
JJin91: doesn't show hand=20
*** SUMMARY ***
Total pot 320400 | Rake 0=20
Board [Jc Jd Jh Th]
Seat 1: CerPrisingLe folded before Flop (didn't bet)
Seat 2: JJin91 (button) collected (320400)
Seat 3: Jivetoast (small blind) folded before Flop
Seat 4: narew (big blind) folded on the Turn


*********** # 432 **************
PokerStars Hand #175487038539: Tournament #1701793695, $9.10+$0.90 USD =
Hold'em No Limit - Level XL (30000/60000) - 2017/09/24 22:32:04 ET
Table '1701793695 18' 6-max Seat #3 is the button
Seat 1: CerPrisingLe (1023357 in chips)=20
Seat 2: JJin91 (3146349 in chips)=20
Seat 3: Jivetoast (4028243 in chips)=20
Seat 4: narew (2362051 in chips)=20
CerPrisingLe: posts the ante 7500
JJin91: posts the ante 7500
Jivetoast: posts the ante 7500
narew: posts the ante 7500
narew: posts small blind 30000
CerPrisingLe: posts big blind 60000
*** HOLE CARDS ***
Dealt to JJin91 [8s 4h]
JJin91: folds=20
Jivetoast: folds=20
narew: raises 120000 to 180000
CerPrisingLe has timed out
CerPrisingLe: folds=20
Uncalled bet (120000) returned to narew
CerPrisingLe is sitting out
narew collected 150000 from pot
narew: doesn't show hand=20
CerPrisingLe has returned
*** SUMMARY ***
Total pot 150000 | Rake 0=20
Seat 1: CerPrisingLe (big blind) folded before Flop
Seat 2: JJin91 folded before Flop (didn't bet)
Seat 3: Jivetoast (button) folded before Flop (didn't bet)
Seat 4: narew (small blind) collected (150000)


*********** # 433 **************
PokerStars Hand #175487038701: Tournament #1701793695, $9.10+$0.90 USD =
Hold'em No Limit - Level XL (30000/60000) - 2017/09/24 22:32:39 ET
Table '1701793695 18' 6-max Seat #4 is the button
Seat 1: CerPrisingLe (955857 in chips)=20
Seat 2: JJin91 (3138849 in chips)=20
Seat 3: Jivetoast (4020743 in chips)=20
Seat 4: narew (2444551 in chips)=20
CerPrisingLe: posts the ante 7500
JJin91: posts the ante 7500
Jivetoast: posts the ante 7500
narew: posts the ante 7500
CerPrisingLe: posts small blind 30000
JJin91: posts big blind 60000
*** HOLE CARDS ***
Dealt to JJin91 [3d 7s]
Jivetoast: raises 120000 to 180000
narew: calls 180000
CerPrisingLe: folds=20
JJin91: folds=20
*** FLOP *** [Qh As 9h]
Jivetoast: checks=20
narew: checks=20
*** TURN *** [Qh As 9h] [Kd]
Jivetoast: bets 240000
narew: calls 240000
*** RIVER *** [Qh As 9h Kd] [6c]
Jivetoast: bets 720000
narew: raises 1297051 to 2017051 and is all-in
Jivetoast: calls 1297051
*** SHOW DOWN ***
narew: shows [Ts Js] (a straight, Ten to Ace)
Jivetoast: shows [Ac Qd] (two pair, Aces and Queens)
narew collected 4994102 from pot
*** SUMMARY ***
Total pot 4994102 | Rake 0=20
Board [Qh As 9h Kd 6c]
Seat 1: CerPrisingLe (small blind) folded before Flop
Seat 2: JJin91 (big blind) folded before Flop
Seat 3: Jivetoast showed [Ac Qd] and lost with two pair, Aces and Queens
Seat 4: narew (button) showed [Ts Js] and won (4994102) with a straight=
, Ten to Ace


*********** # 434 **************
PokerStars Hand #175487038995: Tournament #1701793695, $9.10+$0.90 USD =
Hold'em No Limit - Level XL (30000/60000) - 2017/09/24 22:33:48 ET
Table '1701793695 18' 6-max Seat #1 is the button
Seat 1: CerPrisingLe (918357 in chips)=20
Seat 2: JJin91 (3071349 in chips)=20
Seat 3: Jivetoast (1576192 in chips)=20
Seat 4: narew (4994102 in chips)=20
CerPrisingLe: posts the ante 7500
JJin91: posts the ante 7500
Jivetoast: posts the ante 7500
narew: posts the ante 7500
JJin91: posts small blind 30000
Jivetoast: posts big blind 60000
*** HOLE CARDS ***
Dealt to JJin91 [9d 5h]
Jivetoast said, "nh"
narew said, "ty"
narew: raises 180000 to 240000
CerPrisingLe: folds=20
JJin91: folds=20
Jivetoast: folds=20
Uncalled bet (180000) returned to narew
narew collected 180000 from pot
narew: doesn't show hand=20
*** SUMMARY ***
Total pot 180000 | Rake 0=20
Seat 1: CerPrisingLe (button) folded before Flop (didn't bet)
Seat 2: JJin91 (small blind) folded before Flop
Seat 3: Jivetoast (big blind) folded before Flop
Seat 4: narew collected (180000)


*********** # 435 **************
PokerStars Hand #175487039072: Tournament #1701793695, $9.10+$0.90 USD =
Hold'em No Limit - Level XL (30000/60000) - 2017/09/24 22:34:06 ET
Table '1701793695 18' 6-max Seat #2 is the button
Seat 1: CerPrisingLe (910857 in chips)=20
Seat 2: JJin91 (3033849 in chips)=20
Seat 3: Jivetoast (1508692 in chips)=20
Seat 4: narew (5106602 in chips)=20
CerPrisingLe: posts the ante 7500
JJin91: posts the ante 7500
Jivetoast: posts the ante 7500
narew: posts the ante 7500
Jivetoast: posts small blind 30000
narew: posts big blind 60000
*** HOLE CARDS ***
Dealt to JJin91 [Qs 8s]
CerPrisingLe: folds=20
JJin91: raises 70200 to 130200
Jivetoast: raises 1370992 to 1501192 and is all-in
narew: folds=20
JJin91: folds=20
Uncalled bet (1370992) returned to Jivetoast
Jivetoast collected 350400 from pot
Jivetoast: doesn't show hand=20
*** SUMMARY ***
Total pot 350400 | Rake 0=20
Seat 1: CerPrisingLe folded before Flop (didn't bet)
Seat 2: JJin91 (button) folded before Flop
Seat 3: Jivetoast (small blind) collected (350400)
Seat 4: narew (big blind) folded before Flop


*********** # 436 **************
PokerStars Hand #175487039162: Tournament #1701793695, $9.10+$0.90 USD =
Hold'em No Limit - Level XL (30000/60000) - 2017/09/24 22:34:25 ET
Table '1701793695 18' 6-max Seat #3 is the button
Seat 1: CerPrisingLe (903357 in chips)=20
Seat 2: JJin91 (2896149 in chips)=20
Seat 3: Jivetoast (1721392 in chips)=20
Seat 4: narew (5039102 in chips)=20
CerPrisingLe: posts the ante 7500
JJin91: posts the ante 7500
Jivetoast: posts the ante 7500
narew: posts the ante 7500
narew: posts small blind 30000
CerPrisingLe: posts big blind 60000
*** HOLE CARDS ***
Dealt to JJin91 [3h Qc]
JJin91: folds=20
Jivetoast: raises 360000 to 420000
narew: folds=20
CerPrisingLe: folds=20
Uncalled bet (360000) returned to Jivetoast
Jivetoast collected 180000 from pot
Jivetoast: doesn't show hand=20
*** SUMMARY ***
Total pot 180000 | Rake 0=20
Seat 1: CerPrisingLe (big blind) folded before Flop
Seat 2: JJin91 folded before Flop (didn't bet)
Seat 3: Jivetoast (button) collected (180000)
Seat 4: narew (small blind) folded before Flop


*********** # 437 **************
PokerStars Hand #175487039230: Tournament #1701793695, $9.10+$0.90 USD =
Hold'em No Limit - Level XL (30000/60000) - 2017/09/24 22:34:43 ET
Table '1701793695 18' 6-max Seat #4 is the button
Seat 1: CerPrisingLe (835857 in chips)=20
Seat 2: JJin91 (2888649 in chips)=20
Seat 3: Jivetoast (1833892 in chips)=20
Seat 4: narew (5001602 in chips)=20
CerPrisingLe: posts the ante 7500
JJin91: posts the ante 7500
Jivetoast: posts the ante 7500
narew: posts the ante 7500
CerPrisingLe: posts small blind 30000
JJin91: posts big blind 60000
*** HOLE CARDS ***
Dealt to JJin91 [9c 2h]
Jivetoast: folds=20
narew: raises 120000 to 180000
CerPrisingLe: folds=20
JJin91: folds=20
Uncalled bet (120000) returned to narew
narew collected 180000 from pot
narew: doesn't show hand=20
*** SUMMARY ***
Total pot 180000 | Rake 0=20
Seat 1: CerPrisingLe (small blind) folded before Flop
Seat 2: JJin91 (big blind) folded before Flop
Seat 3: Jivetoast folded before Flop (didn't bet)
Seat 4: narew (button) collected (180000)


*********** # 438 **************
PokerStars Hand #175487039295: Tournament #1701793695, $9.10+$0.90 USD =
Hold'em No Limit - Level XL (30000/60000) - 2017/09/24 22:34:59 ET
Table '1701793695 18' 6-max Seat #1 is the button
Seat 1: CerPrisingLe (798357 in chips)=20
Seat 2: JJin91 (2821149 in chips)=20
Seat 3: Jivetoast (1826392 in chips)=20
Seat 4: narew (5114102 in chips)=20
CerPrisingLe: posts the ante 7500
JJin91: posts the ante 7500
Jivetoast: posts the ante 7500
narew: posts the ante 7500
JJin91: posts small blind 30000
Jivetoast: posts big blind 60000
*** HOLE CARDS ***
Dealt to JJin91 [9h Jd]
narew: folds=20
CerPrisingLe: folds=20
JJin91: calls 30000
Jivetoast: checks=20
*** FLOP *** [2h 8s As]
JJin91: checks=20
Jivetoast: bets 180000
JJin91: folds=20
Uncalled bet (180000) returned to Jivetoast
Jivetoast collected 150000 from pot
Jivetoast: doesn't show hand=20
*** SUMMARY ***
Total pot 150000 | Rake 0=20
Board [2h 8s As]
Seat 1: CerPrisingLe (button) folded before Flop (didn't bet)
Seat 2: JJin91 (small blind) folded on the Flop
Seat 3: Jivetoast (big blind) collected (150000)
Seat 4: narew folded before Flop (didn't bet)


*********** # 439 **************
PokerStars Hand #175487039407: Tournament #1701793695, $9.10+$0.90 USD =
Hold'em No Limit - Level XL (30000/60000) - 2017/09/24 22:35:24 ET
Table '1701793695 18' 6-max Seat #2 is the button
Seat 1: CerPrisingLe (790857 in chips)=20
Seat 2: JJin91 (2753649 in chips)=20
Seat 3: Jivetoast (1908892 in chips)=20
Seat 4: narew (5106602 in chips)=20
CerPrisingLe: posts the ante 7500
JJin91: posts the ante 7500
Jivetoast: posts the ante 7500
narew: posts the ante 7500
Jivetoast: posts small blind 30000
narew: posts big blind 60000
*** HOLE CARDS ***
Dealt to JJin91 [6c 5d]
CerPrisingLe: raises 60000 to 120000
JJin91: folds=20
Jivetoast: folds=20
narew: calls 60000
*** FLOP *** [Ad 2c 9s]
narew: checks=20
CerPrisingLe: bets 663357 and is all-in
narew: folds=20
Uncalled bet (663357) returned to CerPrisingLe
CerPrisingLe collected 300000 from pot
CerPrisingLe: doesn't show hand=20
*** SUMMARY ***
Total pot 300000 | Rake 0=20
Board [Ad 2c 9s]
Seat 1: CerPrisingLe collected (300000)
Seat 2: JJin91 (button) folded before Flop (didn't bet)
Seat 3: Jivetoast (small blind) folded before Flop
Seat 4: narew (big blind) folded on the Flop


*********** # 440 **************
PokerStars Hand #175487039573: Tournament #1701793695, $9.10+$0.90 USD =
Hold'em No Limit - Level XL (30000/60000) - 2017/09/24 22:36:01 ET
Table '1701793695 18' 6-max Seat #3 is the button
Seat 1: CerPrisingLe (963357 in chips)=20
Seat 2: JJin91 (2746149 in chips)=20
Seat 3: Jivetoast (1871392 in chips)=20
Seat 4: narew (4979102 in chips)=20
CerPrisingLe: posts the ante 7500
JJin91: posts the ante 7500
Jivetoast: posts the ante 7500
narew: posts the ante 7500
narew: posts small blind 30000
CerPrisingLe: posts big blind 60000
*** HOLE CARDS ***
Dealt to JJin91 [Qs 7s]
JJin91: folds=20
Jivetoast: folds=20
narew: calls 30000
CerPrisingLe: checks=20
*** FLOP *** [2c 8c 8s]
narew: checks=20
CerPrisingLe: bets 60000
narew: calls 60000
*** TURN *** [2c 8c 8s] [5d]
narew: checks=20
CerPrisingLe: checks=20
*** RIVER *** [2c 8c 8s 5d] [5h]
narew: bets 180000
CerPrisingLe: folds=20
Uncalled bet (180000) returned to narew
narew collected 270000 from pot
narew: doesn't show hand=20
*** SUMMARY ***
Total pot 270000 | Rake 0=20
Board [2c 8c 8s 5d 5h]
Seat 1: CerPrisingLe (big blind) folded on the River
Seat 2: JJin91 folded before Flop (didn't bet)
Seat 3: Jivetoast (button) folded before Flop (didn't bet)
Seat 4: narew (small blind) collected (270000)


*********** # 441 **************
PokerStars Hand #175487039817: Tournament #1701793695, $9.10+$0.90 USD =
Hold'em No Limit - Level XL (30000/60000) - 2017/09/24 22:36:52 ET
Table '1701793695 18' 6-max Seat #4 is the button
Seat 1: CerPrisingLe (835857 in chips)=20
Seat 2: JJin91 (2738649 in chips)=20
Seat 3: Jivetoast (1863892 in chips)=20
Seat 4: narew (5121602 in chips)=20
CerPrisingLe: posts the ante 7500
JJin91: posts the ante 7500
Jivetoast: posts the ante 7500
narew: posts the ante 7500
CerPrisingLe: posts small blind 30000
JJin91: posts big blind 60000
*** HOLE CARDS ***
Dealt to JJin91 [Ah 9c]
Jivetoast: folds=20
narew: folds=20
CerPrisingLe: folds=20
Uncalled bet (30000) returned to JJin91
JJin91 collected 90000 from pot
JJin91: doesn't show hand=20
*** SUMMARY ***
Total pot 90000 | Rake 0=20
Seat 1: CerPrisingLe (small blind) folded before Flop
Seat 2: JJin91 (big blind) collected (90000)
Seat 3: Jivetoast folded before Flop (didn't bet)
Seat 4: narew (button) folded before Flop (didn't bet)


*********** # 442 **************
PokerStars Hand #175487039874: Tournament #1701793695, $9.10+$0.90 USD =
Hold'em No Limit - Level XL (30000/60000) - 2017/09/24 22:37:03 ET
Table '1701793695 18' 6-max Seat #1 is the button
Seat 1: CerPrisingLe (798357 in chips)=20
Seat 2: JJin91 (2791149 in chips)=20
Seat 3: Jivetoast (1856392 in chips)=20
Seat 4: narew (5114102 in chips)=20
CerPrisingLe: posts the ante 7500
JJin91: posts the ante 7500
Jivetoast: posts the ante 7500
narew: posts the ante 7500
JJin91: posts small blind 30000
Jivetoast: posts big blind 60000
*** HOLE CARDS ***
Dealt to JJin91 [8h Tc]
narew: folds=20
CerPrisingLe: folds=20
JJin91: folds=20
Uncalled bet (30000) returned to Jivetoast
Jivetoast collected 90000 from pot
Jivetoast: doesn't show hand=20
*** SUMMARY ***
Total pot 90000 | Rake 0=20
Seat 1: CerPrisingLe (button) folded before Flop (didn't bet)
Seat 2: JJin91 (small blind) folded before Flop
Seat 3: Jivetoast (big blind) collected (90000)
Seat 4: narew folded before Flop (didn't bet)


*********** # 443 **************
PokerStars Hand #175487039916: Tournament #1701793695, $9.10+$0.90 USD =
Hold'em No Limit - Level XL (30000/60000) - 2017/09/24 22:37:12 ET
Table '1701793695 18' 6-max Seat #2 is the button
Seat 1: CerPrisingLe (790857 in chips)=20
Seat 2: JJin91 (2753649 in chips)=20
Seat 3: Jivetoast (1908892 in chips)=20
Seat 4: narew (5106602 in chips)=20
CerPrisingLe: posts the ante 7500
JJin91: posts the ante 7500
Jivetoast: posts the ante 7500
narew: posts the ante 7500
Jivetoast: posts small blind 30000
narew: posts big blind 60000
*** HOLE CARDS ***
Dealt to JJin91 [Kc Ad]
CerPrisingLe: folds=20
JJin91: raises 70200 to 130200
Jivetoast: calls 100200
narew: calls 70200
*** FLOP *** [Tc Qc 2s]
Jivetoast: checks=20
narew: checks=20
JJin91: checks=20
*** TURN *** [Tc Qc 2s] [9d]
Jivetoast: bets 210300
narew: folds=20
JJin91: folds=20
Uncalled bet (210300) returned to Jivetoast
Jivetoast collected 420600 from pot
Jivetoast: doesn't show hand=20
*** SUMMARY ***
Total pot 420600 | Rake 0=20
Board [Tc Qc 2s 9d]
Seat 1: CerPrisingLe folded before Flop (didn't bet)
Seat 2: JJin91 (button) folded on the Turn
Seat 3: Jivetoast (small blind) collected (420600)
Seat 4: narew (big blind) folded on the Turn


*********** # 444 **************
PokerStars Hand #175487745384: Tournament #1701793695, $9.10+$0.90 USD =
Hold'em No Limit - Level XL (30000/60000) - 2017/09/24 22:37:52 ET
Table '1701793695 18' 6-max Seat #3 is the button
Seat 1: CerPrisingLe (783357 in chips)=20
Seat 2: JJin91 (2615949 in chips)=20
Seat 3: Jivetoast (2191792 in chips)=20
Seat 4: narew (4968902 in chips)=20
CerPrisingLe: posts the ante 7500
JJin91: posts the ante 7500
Jivetoast: posts the ante 7500
narew: posts the ante 7500
narew: posts small blind 30000
CerPrisingLe: posts big blind 60000
*** HOLE CARDS ***
Dealt to JJin91 [8d 3s]
JJin91: folds=20
Jivetoast: raises 60000 to 120000
narew: raises 4841402 to 4961402 and is all-in
CerPrisingLe: folds=20
Jivetoast: folds=20
Uncalled bet (4841402) returned to narew
narew collected 330000 from pot
narew: doesn't show hand=20
*** SUMMARY ***
Total pot 330000 | Rake 0=20
Seat 1: CerPrisingLe (big blind) folded before Flop
Seat 2: JJin91 folded before Flop (didn't bet)
Seat 3: Jivetoast (button) folded before Flop
Seat 4: narew (small blind) collected (330000)


*********** # 445 **************
PokerStars Hand #175487745541: Tournament #1701793695, $9.10+$0.90 USD =
Hold'em No Limit - Level XL (30000/60000) - 2017/09/24 22:38:27 ET
Table '1701793695 18' 6-max Seat #4 is the button
Seat 1: CerPrisingLe (715857 in chips)=20
Seat 2: JJin91 (2608449 in chips)=20
Seat 3: Jivetoast (2064292 in chips)=20
Seat 4: narew (5171402 in chips)=20
CerPrisingLe: posts the ante 7500
JJin91: posts the ante 7500
Jivetoast: posts the ante 7500
narew: posts the ante 7500
CerPrisingLe: posts small blind 30000
JJin91: posts big blind 60000
*** HOLE CARDS ***
Dealt to JJin91 [7d 8d]
Jivetoast: folds=20
narew: folds=20
CerPrisingLe: calls 30000
JJin91: checks=20
*** FLOP *** [6h Qd 4c]
CerPrisingLe: bets 60000
JJin91: calls 60000
*** TURN *** [6h Qd 4c] [3h]
CerPrisingLe: bets 60000
JJin91: folds=20
Uncalled bet (60000) returned to CerPrisingLe
CerPrisingLe collected 270000 from pot
CerPrisingLe: doesn't show hand=20
*** SUMMARY ***
Total pot 270000 | Rake 0=20
Board [6h Qd 4c 3h]
Seat 1: CerPrisingLe (small blind) collected (270000)
Seat 2: JJin91 (big blind) folded on the Turn
Seat 3: Jivetoast folded before Flop (didn't bet)
Seat 4: narew (button) folded before Flop (didn't bet)


*********** # 446 **************
PokerStars Hand #175487745698: Tournament #1701793695, $9.10+$0.90 USD =
Hold'em No Limit - Level XL (30000/60000) - 2017/09/24 22:39:00 ET
Table '1701793695 18' 6-max Seat #1 is the button
Seat 1: CerPrisingLe (858357 in chips)=20
Seat 2: JJin91 (2480949 in chips)=20
Seat 3: Jivetoast (2056792 in chips)=20
Seat 4: narew (5163902 in chips)=20
CerPrisingLe: posts the ante 7500
JJin91: posts the ante 7500
Jivetoast: posts the ante 7500
narew: posts the ante 7500
JJin91: posts small blind 30000
Jivetoast: posts big blind 60000
*** HOLE CARDS ***
Dealt to JJin91 [5d Ac]
narew: raises 60000 to 120000
CerPrisingLe: folds=20
JJin91: raises 290234 to 410234
Jivetoast: folds=20
narew: folds=20
Uncalled bet (290234) returned to JJin91
JJin91 collected 330000 from pot
JJin91: doesn't show hand=20
*** SUMMARY ***
Total pot 330000 | Rake 0=20
Seat 1: CerPrisingLe (button) folded before Flop (didn't bet)
Seat 2: JJin91 (small blind) collected (330000)
Seat 3: Jivetoast (big blind) folded before Flop
Seat 4: narew folded before Flop


*********** # 447 **************
PokerStars Hand #175487745890: Tournament #1701793695, $9.10+$0.90 USD =
Hold'em No Limit - Level XLI (40000/80000) - 2017/09/24 22:39:37 ET
Table '1701793695 18' 6-max Seat #2 is the button
Seat 1: CerPrisingLe (850857 in chips)=20
Seat 2: JJin91 (2683449 in chips)=20
Seat 3: Jivetoast (1989292 in chips)=20
Seat 4: narew (5036402 in chips)=20
CerPrisingLe: posts the ante 10000
JJin91: posts the ante 10000
Jivetoast: posts the ante 10000
narew: posts the ante 10000
Jivetoast: posts small blind 40000
narew: posts big blind 80000
*** HOLE CARDS ***
Dealt to JJin91 [7h Jh]
CerPrisingLe: folds=20
JJin91: folds=20
Jivetoast: calls 40000
narew: checks=20
*** FLOP *** [3h 6c 2h]
Jivetoast: bets 80000
narew: calls 80000
*** TURN *** [3h 6c 2h] [As]
Jivetoast: bets 180000
narew: folds=20
Uncalled bet (180000) returned to Jivetoast
Jivetoast collected 360000 from pot
Jivetoast: doesn't show hand=20
*** SUMMARY ***
Total pot 360000 | Rake 0=20
Board [3h 6c 2h As]
Seat 1: CerPrisingLe folded before Flop (didn't bet)
Seat 2: JJin91 (button) folded before Flop (didn't bet)
Seat 3: Jivetoast (small blind) collected (360000)
Seat 4: narew (big blind) folded on the Turn


*********** # 448 **************
PokerStars Hand #175487746113: Tournament #1701793695, $9.10+$0.90 USD =
Hold'em No Limit - Level XLI (40000/80000) - 2017/09/24 22:40:29 ET
Table '1701793695 18' 6-max Seat #3 is the button
Seat 1: CerPrisingLe (840857 in chips)=20
Seat 2: JJin91 (2673449 in chips)=20
Seat 3: Jivetoast (2179292 in chips)=20
Seat 4: narew (4866402 in chips)=20
CerPrisingLe: posts the ante 10000
JJin91: posts the ante 10000
Jivetoast: posts the ante 10000
narew: posts the ante 10000
narew: posts small blind 40000
CerPrisingLe: posts big blind 80000
*** HOLE CARDS ***
Dealt to JJin91 [Qc 3s]
JJin91: folds=20
Jivetoast: raises 160000 to 240000
narew: folds=20
CerPrisingLe: folds=20
Uncalled bet (160000) returned to Jivetoast
Jivetoast collected 240000 from pot
Jivetoast: doesn't show hand=20
*** SUMMARY ***
Total pot 240000 | Rake 0=20
Seat 1: CerPrisingLe (big blind) folded before Flop
Seat 2: JJin91 folded before Flop (didn't bet)
Seat 3: Jivetoast (button) collected (240000)
Seat 4: narew (small blind) folded before Flop


*********** # 449 **************
PokerStars Hand #175487746165: Tournament #1701793695, $9.10+$0.90 USD =
Hold'em No Limit - Level XLI (40000/80000) - 2017/09/24 22:40:40 ET
Table '1701793695 18' 6-max Seat #4 is the button
Seat 1: CerPrisingLe (750857 in chips)=20
Seat 2: JJin91 (2663449 in chips)=20
Seat 3: Jivetoast (2329292 in chips)=20
Seat 4: narew (4816402 in chips)=20
CerPrisingLe: posts the ante 10000
JJin91: posts the ante 10000
Jivetoast: posts the ante 10000
narew: posts the ante 10000
CerPrisingLe: posts small blind 40000
JJin91: posts big blind 80000
*** HOLE CARDS ***
Dealt to JJin91 [Kh 9s]
Jivetoast: folds=20
narew: folds=20
CerPrisingLe: raises 160000 to 240000
JJin91: folds=20
Uncalled bet (160000) returned to CerPrisingLe
CerPrisingLe collected 200000 from pot
CerPrisingLe: doesn't show hand=20
*** SUMMARY ***
Total pot 200000 | Rake 0=20
Seat 1: CerPrisingLe (small blind) collected (200000)
Seat 2: JJin91 (big blind) folded before Flop
Seat 3: Jivetoast folded before Flop (didn't bet)
Seat 4: narew (button) folded before Flop (didn't bet)


*********** # 450 **************
PokerStars Hand #175487746262: Tournament #1701793695, $9.10+$0.90 USD =
Hold'em No Limit - Level XLI (40000/80000) - 2017/09/24 22:41:01 ET
Table '1701793695 18' 6-max Seat #1 is the button
Seat 1: CerPrisingLe (860857 in chips)=20
Seat 2: JJin91 (2573449 in chips)=20
Seat 3: Jivetoast (2319292 in chips)=20
Seat 4: narew (4806402 in chips)=20
CerPrisingLe: posts the ante 10000
JJin91: posts the ante 10000
Jivetoast: posts the ante 10000
narew: posts the ante 10000
JJin91: posts small blind 40000
Jivetoast: posts big blind 80000
*** HOLE CARDS ***
Dealt to JJin91 [Qs Kh]
narew: folds=20
CerPrisingLe: raises 80000 to 160000
JJin91: calls 120000
Jivetoast: calls 80000
*** FLOP *** [5c As 9c]
JJin91: bets 221111
Jivetoast: calls 221111
CerPrisingLe: folds=20
*** TURN *** [5c As 9c] [Ad]
JJin91: checks=20
Jivetoast: bets 240000
JJin91: calls 240000
*** RIVER *** [5c As 9c Ad] [7d]
JJin91: bets 899382
Jivetoast: calls 899382
*** SHOW DOWN ***
JJin91: shows [Qs Kh] (a pair of Aces)
Jivetoast: shows [Ac Jd] (three of a kind, Aces)
Jivetoast collected 3240986 from pot
*** SUMMARY ***
Total pot 3240986 | Rake 0=20
Board [5c As 9c Ad 7d]
Seat 1: CerPrisingLe (button) folded on the Flop
Seat 2: JJin91 (small blind) showed [Qs Kh] and lost with a pair of Aces
Seat 3: Jivetoast (big blind) showed [Ac Jd] and won (3240986) with thr=
ee of a kind, Aces
Seat 4: narew folded before Flop (didn't bet)


*********** # 451 **************
PokerStars Hand #175487746613: Tournament #1701793695, $9.10+$0.90 USD =
Hold'em No Limit - Level XLI (40000/80000) - 2017/09/24 22:42:22 ET
Table '1701793695 18' 6-max Seat #2 is the button
Seat 1: CerPrisingLe (690857 in chips)=20
Seat 2: JJin91 (1042956 in chips)=20
Seat 3: Jivetoast (4029785 in chips)=20
Seat 4: narew (4796402 in chips)=20
CerPrisingLe: posts the ante 10000
JJin91: posts the ante 10000
Jivetoast: posts the ante 10000
narew: posts the ante 10000
Jivetoast: posts small blind 40000
narew: posts big blind 80000
*** HOLE CARDS ***
Dealt to JJin91 [8h 6h]
CerPrisingLe: folds=20
JJin91: folds=20
Jivetoast: folds=20
Uncalled bet (40000) returned to narew
narew collected 120000 from pot
narew: doesn't show hand=20
*** SUMMARY ***
Total pot 120000 | Rake 0=20
Seat 1: CerPrisingLe folded before Flop (didn't bet)
Seat 2: JJin91 (button) folded before Flop (didn't bet)
Seat 3: Jivetoast (small blind) folded before Flop
Seat 4: narew (big blind) collected (120000)


*********** # 452 **************
PokerStars Hand #175487746657: Tournament #1701793695, $9.10+$0.90 USD =
Hold'em No Limit - Level XLI (40000/80000) - 2017/09/24 22:42:29 ET
Table '1701793695 18' 6-max Seat #3 is the button
Seat 1: CerPrisingLe (680857 in chips)=20
Seat 2: JJin91 (1032956 in chips)=20
Seat 3: Jivetoast (3979785 in chips)=20
Seat 4: narew (4866402 in chips)=20
CerPrisingLe: posts the ante 10000
JJin91: posts the ante 10000
Jivetoast: posts the ante 10000
narew: posts the ante 10000
narew: posts small blind 40000
CerPrisingLe: posts big blind 80000
*** HOLE CARDS ***
Dealt to JJin91 [Ah 9s]
JJin91: raises 942956 to 1022956 and is all-in
Jivetoast: folds=20
narew: folds=20
CerPrisingLe: folds=20
Uncalled bet (942956) returned to JJin91
JJin91 collected 240000 from pot
JJin91: doesn't show hand=20
*** SUMMARY ***
Total pot 240000 | Rake 0=20
Seat 1: CerPrisingLe (big blind) folded before Flop
Seat 2: JJin91 collected (240000)
Seat 3: Jivetoast (button) folded before Flop (didn't bet)
Seat 4: narew (small blind) folded before Flop


*********** # 453 **************
PokerStars Hand #175487746724: Tournament #1701793695, $9.10+$0.90 USD =
Hold'em No Limit - Level XLI (40000/80000) - 2017/09/24 22:42:45 ET
Table '1701793695 18' 6-max Seat #4 is the button
Seat 1: CerPrisingLe (590857 in chips)=20
Seat 2: JJin91 (1182956 in chips)=20
Seat 3: Jivetoast (3969785 in chips)=20
Seat 4: narew (4816402 in chips)=20
CerPrisingLe: posts the ante 10000
JJin91: posts the ante 10000
Jivetoast: posts the ante 10000
narew: posts the ante 10000
CerPrisingLe: posts small blind 40000
JJin91: posts big blind 80000
*** HOLE CARDS ***
Dealt to JJin91 [7c 3s]
Jivetoast: folds=20
narew: folds=20
CerPrisingLe: folds=20
Uncalled bet (40000) returned to JJin91
JJin91 collected 120000 from pot
JJin91: doesn't show hand=20
*** SUMMARY ***
Total pot 120000 | Rake 0=20
Seat 1: CerPrisingLe (small blind) folded before Flop
Seat 2: JJin91 (big blind) collected (120000)
Seat 3: Jivetoast folded before Flop (didn't bet)
Seat 4: narew (button) folded before Flop (didn't bet)


*********** # 454 **************
PokerStars Hand #175487746752: Tournament #1701793695, $9.10+$0.90 USD =
Hold'em No Limit - Level XLI (40000/80000) - 2017/09/24 22:42:53 ET
Table '1701793695 18' 6-max Seat #1 is the button
Seat 1: CerPrisingLe (540857 in chips)=20
Seat 2: JJin91 (1252956 in chips)=20
Seat 3: Jivetoast (3959785 in chips)=20
Seat 4: narew (4806402 in chips)=20
CerPrisingLe: posts the ante 10000
JJin91: posts the ante 10000
Jivetoast: posts the ante 10000
narew: posts the ante 10000
JJin91: posts small blind 40000
Jivetoast: posts big blind 80000
*** HOLE CARDS ***
Dealt to JJin91 [5d 2d]
narew: raises 160000 to 240000
CerPrisingLe: folds=20
JJin91: folds=20
Jivetoast: calls 160000
*** FLOP *** [Ac Ts 4d]
Jivetoast: checks=20
narew: bets 160000
Jivetoast: folds=20
Uncalled bet (160000) returned to narew
narew collected 560000 from pot
narew: doesn't show hand=20
*** SUMMARY ***
Total pot 560000 | Rake 0=20
Board [Ac Ts 4d]
Seat 1: CerPrisingLe (button) folded before Flop (didn't bet)
Seat 2: JJin91 (small blind) folded before Flop
Seat 3: Jivetoast (big blind) folded on the Flop
Seat 4: narew collected (560000)


*********** # 455 **************
PokerStars Hand #175487746887: Tournament #1701793695, $9.10+$0.90 USD =
Hold'em No Limit - Level XLI (40000/80000) - 2017/09/24 22:43:27 ET
Table '1701793695 18' 6-max Seat #2 is the button
Seat 1: CerPrisingLe (530857 in chips)=20
Seat 2: JJin91 (1202956 in chips)=20
Seat 3: Jivetoast (3709785 in chips)=20
Seat 4: narew (5116402 in chips)=20
CerPrisingLe: posts the ante 10000
JJin91: posts the ante 10000
Jivetoast: posts the ante 10000
narew: posts the ante 10000
Jivetoast: posts small blind 40000
narew: posts big blind 80000
*** HOLE CARDS ***
Dealt to JJin91 [Jc 6c]
CerPrisingLe has timed out
CerPrisingLe: folds=20
CerPrisingLe is sitting out
JJin91: folds=20
Jivetoast: calls 40000
narew: raises 320000 to 400000
Jivetoast: folds=20
Uncalled bet (320000) returned to narew
narew collected 200000 from pot
narew: doesn't show hand=20
*** SUMMARY ***
Total pot 200000 | Rake 0=20
Seat 1: CerPrisingLe folded before Flop (didn't bet)
Seat 2: JJin91 (button) folded before Flop (didn't bet)
Seat 3: Jivetoast (small blind) folded before Flop
Seat 4: narew (big blind) collected (200000)


*********** # 456 **************
PokerStars Hand #175487747072: Tournament #1701793695, $9.10+$0.90 USD =
Hold'em No Limit - Level XLI (40000/80000) - 2017/09/24 22:44:10 ET
Table '1701793695 18' 6-max Seat #3 is the button
Seat 1: CerPrisingLe (520857 in chips) is sitting out
Seat 2: JJin91 (1192956 in chips)=20
Seat 3: Jivetoast (3619785 in chips)=20
Seat 4: narew (5226402 in chips)=20
CerPrisingLe: posts the ante 10000
JJin91: posts the ante 10000
Jivetoast: posts the ante 10000
narew: posts the ante 10000
narew: posts small blind 40000
CerPrisingLe: posts big blind 80000
*** HOLE CARDS ***
Dealt to JJin91 [6s 5d]
JJin91: folds=20
Jivetoast: raises 80000 to 160000
narew: calls 120000
CerPrisingLe: folds=20
*** FLOP *** [8h Ks 7d]
CerPrisingLe has returned
narew: checks=20
Jivetoast: bets 240000
narew: folds=20
Uncalled bet (240000) returned to Jivetoast
Jivetoast collected 440000 from pot
Jivetoast: doesn't show hand=20
*** SUMMARY ***
Total pot 440000 | Rake 0=20
Board [8h Ks 7d]
Seat 1: CerPrisingLe (big blind) folded before Flop
Seat 2: JJin91 folded before Flop (didn't bet)
Seat 3: Jivetoast (button) collected (440000)
Seat 4: narew (small blind) folded on the Flop


*********** # 457 **************
PokerStars Hand #175487747274: Tournament #1701793695, $9.10+$0.90 USD =
Hold'em No Limit - Level XLI (40000/80000) - 2017/09/24 22:44:56 ET
Table '1701793695 18' 6-max Seat #4 is the button
Seat 1: CerPrisingLe (430857 in chips)=20
Seat 2: JJin91 (1182956 in chips)=20
Seat 3: Jivetoast (3889785 in chips)=20
Seat 4: narew (5056402 in chips)=20
CerPrisingLe: posts the ante 10000
JJin91: posts the ante 10000
Jivetoast: posts the ante 10000
narew: posts the ante 10000
CerPrisingLe: posts small blind 40000
JJin91: posts big blind 80000
*** HOLE CARDS ***
Dealt to JJin91 [Kc 9h]
Jivetoast: raises 160000 to 240000
narew: folds=20
CerPrisingLe: folds=20
JJin91: folds=20
Uncalled bet (160000) returned to Jivetoast
Jivetoast collected 240000 from pot
Jivetoast: doesn't show hand=20
*** SUMMARY ***
Total pot 240000 | Rake 0=20
Seat 1: CerPrisingLe (small blind) folded before Flop
Seat 2: JJin91 (big blind) folded before Flop
Seat 3: Jivetoast collected (240000)
Seat 4: narew (button) folded before Flop (didn't bet)


*********** # 458 **************
PokerStars Hand #175487747362: Tournament #1701793695, $9.10+$0.90 USD =
Hold'em No Limit - Level XLI (40000/80000) - 2017/09/24 22:45:12 ET
Table '1701793695 18' 6-max Seat #1 is the button
Seat 1: CerPrisingLe (380857 in chips)=20
Seat 2: JJin91 (1092956 in chips)=20
Seat 3: Jivetoast (4039785 in chips)=20
Seat 4: narew (5046402 in chips)=20
CerPrisingLe: posts the ante 10000
JJin91: posts the ante 10000
Jivetoast: posts the ante 10000
narew: posts the ante 10000
JJin91: posts small blind 40000
Jivetoast: posts big blind 80000
*** HOLE CARDS ***
Dealt to JJin91 [9s Ks]
narew: folds=20
CerPrisingLe: raises 290857 to 370857 and is all-in
JJin91: folds=20
Jivetoast: calls 290857
*** FLOP *** [Qc Ac 6s]
*** TURN *** [Qc Ac 6s] [Td]
*** RIVER *** [Qc Ac 6s Td] [3d]
*** SHOW DOWN ***
Jivetoast: shows [8h As] (a pair of Aces)
CerPrisingLe: shows [5h 5c] (a pair of Fives)
Jivetoast collected 821714 from pot
CerPrisingLe finished the tournament in 4th place and received $350.00.
*** SUMMARY ***
Total pot 821714 | Rake 0=20
Board [Qc Ac 6s Td 3d]
Seat 1: CerPrisingLe (button) showed [5h 5c] and lost with a pair of Fi=
ves
Seat 2: JJin91 (small blind) folded before Flop
Seat 3: Jivetoast (big blind) showed [8h As] and won (821714) with a pa=
ir of Aces
Seat 4: narew folded before Flop (didn't bet)


*********** # 459 **************
PokerStars Hand #175487747508: Tournament #1701793695, $9.10+$0.90 USD =
Hold'em No Limit - Level XLI (40000/80000) - 2017/09/24 22:45:43 ET
Table '1701793695 18' 6-max Seat #2 is the button
Seat 2: JJin91 (1042956 in chips)=20
Seat 3: Jivetoast (4480642 in chips)=20
Seat 4: narew (5036402 in chips)=20
JJin91: posts the ante 10000
Jivetoast: posts the ante 10000
narew: posts the ante 10000
Jivetoast: posts small blind 40000
narew: posts big blind 80000
*** HOLE CARDS ***
Dealt to JJin91 [Kc 5s]
JJin91: raises 952956 to 1032956 and is all-in
Jivetoast: folds=20
narew: folds=20
Uncalled bet (952956) returned to JJin91
JJin91 collected 230000 from pot
JJin91: doesn't show hand=20
*** SUMMARY ***
Total pot 230000 | Rake 0=20
Seat 2: JJin91 (button) collected (230000)
Seat 3: Jivetoast (small blind) folded before Flop
Seat 4: narew (big blind) folded before Flop


*********** # 460 **************
PokerStars Hand #175487747589: Tournament #1701793695, $9.10+$0.90 USD =
Hold'em No Limit - Level XLI (40000/80000) - 2017/09/24 22:45:56 ET
Table '1701793695 18' 6-max Seat #3 is the button
Seat 2: JJin91 (1182956 in chips)=20
Seat 3: Jivetoast (4430642 in chips)=20
Seat 4: narew (4946402 in chips)=20
JJin91: posts the ante 10000
Jivetoast: posts the ante 10000
narew: posts the ante 10000
narew: posts small blind 40000
JJin91: posts big blind 80000
*** HOLE CARDS ***
Dealt to JJin91 [Ts Ks]
Jivetoast: folds=20
narew: calls 40000
JJin91: checks=20
*** FLOP *** [6s Ah 3d]
narew: bets 80000
JJin91: calls 80000
*** TURN *** [6s Ah 3d] [Jh]
narew: bets 240000
JJin91: folds=20
Uncalled bet (240000) returned to narew
narew collected 350000 from pot
narew: doesn't show hand=20
*** SUMMARY ***
Total pot 350000 | Rake 0=20
Board [6s Ah 3d Jh]
Seat 2: JJin91 (big blind) folded on the Turn
Seat 3: Jivetoast (button) folded before Flop (didn't bet)
Seat 4: narew (small blind) collected (350000)


*********** # 461 **************
PokerStars Hand #175487747779: Tournament #1701793695, $9.10+$0.90 USD =
Hold'em No Limit - Level XLI (40000/80000) - 2017/09/24 22:46:35 ET
Table '1701793695 18' 6-max Seat #4 is the button
Seat 2: JJin91 (1012956 in chips)=20
Seat 3: Jivetoast (4420642 in chips)=20
Seat 4: narew (5126402 in chips)=20
JJin91: posts the ante 10000
Jivetoast: posts the ante 10000
narew: posts the ante 10000
JJin91: posts small blind 40000
Jivetoast: posts big blind 80000
*** HOLE CARDS ***
Dealt to JJin91 [9d 7h]
narew: folds=20
JJin91: folds=20
Uncalled bet (40000) returned to Jivetoast
Jivetoast collected 110000 from pot
Jivetoast: doesn't show hand=20
*** SUMMARY ***
Total pot 110000 | Rake 0=20
Seat 2: JJin91 (small blind) folded before Flop
Seat 3: Jivetoast (big blind) collected (110000)
Seat 4: narew (button) folded before Flop (didn't bet)


*********** # 462 **************
PokerStars Hand #175487747832: Tournament #1701793695, $9.10+$0.90 USD =
Hold'em No Limit - Level XLI (40000/80000) - 2017/09/24 22:46:46 ET
Table '1701793695 18' 6-max Seat #2 is the button
Seat 2: JJin91 (962956 in chips)=20
Seat 3: Jivetoast (4480642 in chips)=20
Seat 4: narew (5116402 in chips)=20
JJin91: posts the ante 10000
Jivetoast: posts the ante 10000
narew: posts the ante 10000
Jivetoast: posts small blind 40000
narew: posts big blind 80000
*** HOLE CARDS ***
Dealt to JJin91 [Kc 6h]
JJin91: raises 872956 to 952956 and is all-in
Jivetoast: folds=20
narew: folds=20
Uncalled bet (872956) returned to JJin91
JJin91 collected 230000 from pot
JJin91: doesn't show hand=20
*** SUMMARY ***
Total pot 230000 | Rake 0=20
Seat 2: JJin91 (button) collected (230000)
Seat 3: Jivetoast (small blind) folded before Flop
Seat 4: narew (big blind) folded before Flop


*********** # 463 **************
PokerStars Hand #175487747892: Tournament #1701793695, $9.10+$0.90 USD =
Hold'em No Limit - Level XLI (40000/80000) - 2017/09/24 22:46:58 ET
Table '1701793695 18' 6-max Seat #3 is the button
Seat 2: JJin91 (1102956 in chips)=20
Seat 3: Jivetoast (4430642 in chips)=20
Seat 4: narew (5026402 in chips)=20
JJin91: posts the ante 10000
Jivetoast: posts the ante 10000
narew: posts the ante 10000
narew: posts small blind 40000
JJin91: posts big blind 80000
*** HOLE CARDS ***
Dealt to JJin91 [4s Th]
Jivetoast: folds=20
narew: calls 40000
JJin91: checks=20
*** FLOP *** [9h Jd 7d]
narew: bets 80000
JJin91: raises 118722 to 198722
narew: raises 4737680 to 4936402 and is all-in
JJin91: folds=20
Uncalled bet (4737680) returned to narew
narew collected 587444 from pot
narew: doesn't show hand=20
*** SUMMARY ***
Total pot 587444 | Rake 0=20
Board [9h Jd 7d]
Seat 2: JJin91 (big blind) folded on the Flop
Seat 3: Jivetoast (button) folded before Flop (didn't bet)
Seat 4: narew (small blind) collected (587444)


*********** # 464 **************
PokerStars Hand #175487748092: Tournament #1701793695, $9.10+$0.90 USD =
Hold'em No Limit - Level XLI (40000/80000) - 2017/09/24 22:47:39 ET
Table '1701793695 18' 6-max Seat #4 is the button
Seat 2: JJin91 (814234 in chips)=20
Seat 3: Jivetoast (4420642 in chips)=20
Seat 4: narew (5325124 in chips)=20
JJin91: posts the ante 10000
Jivetoast: posts the ante 10000
narew: posts the ante 10000
JJin91: posts small blind 40000
Jivetoast: posts big blind 80000
*** HOLE CARDS ***
Dealt to JJin91 [8d 2d]
narew: folds=20
JJin91: folds=20
Uncalled bet (40000) returned to Jivetoast
Jivetoast collected 110000 from pot
Jivetoast: doesn't show hand=20
*** SUMMARY ***
Total pot 110000 | Rake 0=20
Seat 2: JJin91 (small blind) folded before Flop
Seat 3: Jivetoast (big blind) collected (110000)
Seat 4: narew (button) folded before Flop (didn't bet)


*********** # 465 **************
PokerStars Hand #175487748127: Tournament #1701793695, $9.10+$0.90 USD =
Hold'em No Limit - Level XLI (40000/80000) - 2017/09/24 22:47:46 ET
Table '1701793695 18' 6-max Seat #2 is the button
Seat 2: JJin91 (764234 in chips)=20
Seat 3: Jivetoast (4480642 in chips)=20
Seat 4: narew (5315124 in chips)=20
JJin91: posts the ante 10000
Jivetoast: posts the ante 10000
narew: posts the ante 10000
Jivetoast: posts small blind 40000
narew: posts big blind 80000
*** HOLE CARDS ***
Dealt to JJin91 [7d 5c]
JJin91: folds=20
Jivetoast: calls 40000
narew: raises 190000 to 270000
Jivetoast: folds=20
Uncalled bet (190000) returned to narew
narew collected 190000 from pot
narew: doesn't show hand=20
*** SUMMARY ***
Total pot 190000 | Rake 0=20
Seat 2: JJin91 (button) folded before Flop (didn't bet)
Seat 3: Jivetoast (small blind) folded before Flop
Seat 4: narew (big blind) collected (190000)


*********** # 466 **************
PokerStars Hand #175487748188: Tournament #1701793695, $9.10+$0.90 USD =
Hold'em No Limit - Level XLI (40000/80000) - 2017/09/24 22:47:59 ET
Table '1701793695 18' 6-max Seat #3 is the button
Seat 2: JJin91 (754234 in chips)=20
Seat 3: Jivetoast (4390642 in chips)=20
Seat 4: narew (5415124 in chips)=20
JJin91: posts the ante 10000
Jivetoast: posts the ante 10000
narew: posts the ante 10000
narew: posts small blind 40000
JJin91: posts big blind 80000
*** HOLE CARDS ***
Dealt to JJin91 [Js Qs]
Jivetoast: folds=20
narew: calls 40000
JJin91: checks=20
*** FLOP *** [6s 9c 3h]
narew: checks=20
JJin91: bets 96900
narew: calls 96900
*** TURN *** [6s 9c 3h] [9d]
narew: checks=20
JJin91: bets 383800
narew: folds=20
Uncalled bet (383800) returned to JJin91
JJin91 collected 383800 from pot
JJin91: doesn't show hand=20
*** SUMMARY ***
Total pot 383800 | Rake 0=20
Board [6s 9c 3h 9d]
Seat 2: JJin91 (big blind) collected (383800)
Seat 3: Jivetoast (button) folded before Flop (didn't bet)
Seat 4: narew (small blind) folded on the Turn


*********** # 467 **************
PokerStars Hand #175487748420: Tournament #1701793695, $9.10+$0.90 USD =
Hold'em No Limit - Level XLI (40000/80000) - 2017/09/24 22:48:47 ET
Table '1701793695 18' 6-max Seat #4 is the button
Seat 2: JJin91 (951134 in chips)=20
Seat 3: Jivetoast (4380642 in chips)=20
Seat 4: narew (5228224 in chips)=20
JJin91: posts the ante 10000
Jivetoast: posts the ante 10000
narew: posts the ante 10000
JJin91: posts small blind 40000
Jivetoast: posts big blind 80000
*** HOLE CARDS ***
Dealt to JJin91 [Jh 2s]
narew: raises 80000 to 160000
JJin91: folds=20
Jivetoast: calls 80000
*** FLOP *** [9h 9d Ts]
Jivetoast: checks=20
narew: bets 160000
Jivetoast: folds=20
Uncalled bet (160000) returned to narew
narew collected 390000 from pot
narew: doesn't show hand=20
*** SUMMARY ***
Total pot 390000 | Rake 0=20
Board [9h 9d Ts]
Seat 2: JJin91 (small blind) folded before Flop
Seat 3: Jivetoast (big blind) folded on the Flop
Seat 4: narew (button) collected (390000)


*********** # 468 **************
PokerStars Hand #175487748521: Tournament #1701793695, $9.10+$0.90 USD =
Hold'em No Limit - Level XLI (40000/80000) - 2017/09/24 22:49:09 ET
Table '1701793695 18' 6-max Seat #2 is the button
Seat 2: JJin91 (901134 in chips)=20
Seat 3: Jivetoast (4210642 in chips)=20
Seat 4: narew (5448224 in chips)=20
JJin91: posts the ante 10000
Jivetoast: posts the ante 10000
narew: posts the ante 10000
Jivetoast: posts small blind 40000
narew: posts big blind 80000
*** HOLE CARDS ***
Dealt to JJin91 [6d 6c]
JJin91: raises 811134 to 891134 and is all-in
Jivetoast: calls 851134
narew: folds=20
*** FLOP *** [Jc Qc Qs]
*** TURN *** [Jc Qc Qs] [3c]
*** RIVER *** [Jc Qc Qs 3c] [7d]
*** SHOW DOWN ***
Jivetoast: shows [8d 8c] (two pair, Queens and Eights)
JJin91: shows [6d 6c] (two pair, Queens and Sixes)
Jivetoast collected 1892268 from pot
JJin91 finished the tournament in 3rd place and received $512.50.
*** SUMMARY ***
Total pot 1892268 | Rake 0=20
Board [Jc Qc Qs 3c 7d]
Seat 2: JJin91 (button) showed [6d 6c] and lost with two pair, Queens a=
nd Sixes
Seat 3: Jivetoast (small blind) showed [8d 8c] and won (1892268) with t=
wo pair, Queens and Eights
Seat 4: narew (big blind) folded before Flop



If you have any questions, please contact us at "PokerStars Support" <s=
upport@pokerstarsnj.com>


