Transcript for tournament #1597684117 requested by JJin91 (jamiejin91@g=
mail.com)

*********** # 1 **************
PokerStars Hand #169554806910: Tournament #1597684117, $4.55+$0.45 USD =
Hold'em No Limit - Level I (25/50) - 2017/05/07 21:04:07 ET
Table '1597684117 4' 9-max Seat #1 is the button
Seat 1: gator856500 (10000 in chips)=20
Seat 2: Pocket9s99 (9050 in chips)=20
Seat 3: nigock (10713 in chips)=20
Seat 4: nwmdnj (10000 in chips)=20
Seat 9: JJin91 (10000 in chips)=20
Pocket9s99: posts small blind 25
nigock: posts big blind 50
*** HOLE CARDS ***
Dealt to JJin91 [9c Jc]
nwmdnj: calls 50
JJin91: raises 150 to 200
gator856500: folds=20
Pocket9s99: calls 175
nigock: folds=20
nwmdnj: calls 150
*** FLOP *** [Qc 8c Kd]
Pocket9s99: bets 325
nwmdnj: folds=20
JJin91: calls 325
*** TURN *** [Qc 8c Kd] [Js]
Pocket9s99: bets 50
JJin91: raises 750 to 800
Pocket9s99 said, "misclick"
Pocket9s99: folds=20
Uncalled bet (750) returned to JJin91
JJin91 collected 1400 from pot
JJin91: doesn't show hand=20
*** SUMMARY ***
Total pot 1400 | Rake 0=20
Board [Qc 8c Kd Js]
Seat 1: gator856500 (button) folded before Flop (didn't bet)
Seat 2: Pocket9s99 (small blind) folded on the Turn
Seat 3: nigock (big blind) folded before Flop
Seat 4: nwmdnj folded on the Flop
Seat 9: JJin91 collected (1400)


*********** # 2 **************
PokerStars Hand #169554807403: Tournament #1597684117, $4.55+$0.45 USD =
Hold'em No Limit - Level II (30/60) - 2017/05/07 21:05:27 ET
Table '1597684117 4' 9-max Seat #2 is the button
Seat 1: gator856500 (10000 in chips)=20
Seat 2: Pocket9s99 (8475 in chips)=20
Seat 3: nigock (10663 in chips)=20
Seat 4: nwmdnj (9800 in chips)=20
Seat 5: njhaar (10000 in chips)=20
Seat 6: ytseshr3d (10000 in chips)=20
Seat 7: LetsGoMets 6 (10000 in chips)=20
Seat 9: JJin91 (10825 in chips)=20
nigock: posts small blind 30
nwmdnj: posts big blind 60
*** HOLE CARDS ***
Dealt to JJin91 [Jh 7c]
njhaar: folds=20
ytseshr3d: calls 60
LetsGoMets 6: folds=20
JJin91: folds=20
gator856500: folds=20
Pocket9s99: folds=20
nigock: folds=20
nwmdnj: checks=20
*** FLOP *** [7d 5s 7h]
nwmdnj: checks=20
ytseshr3d: checks=20
*** TURN *** [7d 5s 7h] [2s]
nwmdnj: checks=20
ytseshr3d: checks=20
*** RIVER *** [7d 5s 7h 2s] [3h]
nwmdnj: checks=20
ytseshr3d: checks=20
*** SHOW DOWN ***
nwmdnj: shows [Js Td] (a pair of Sevens)
ytseshr3d: shows [2d 3d] (two pair, Sevens and Threes)
ytseshr3d collected 150 from pot
*** SUMMARY ***
Total pot 150 | Rake 0=20
Board [7d 5s 7h 2s 3h]
Seat 1: gator856500 folded before Flop (didn't bet)
Seat 2: Pocket9s99 (button) folded before Flop (didn't bet)
Seat 3: nigock (small blind) folded before Flop
Seat 4: nwmdnj (big blind) showed [Js Td] and lost with a pair of Sevens
Seat 5: njhaar folded before Flop (didn't bet)
Seat 6: ytseshr3d showed [2d 3d] and won (150) with two pair, Sevens an=
d Threes
Seat 7: LetsGoMets 6 folded before Flop (didn't bet)
Seat 9: JJin91 folded before Flop (didn't bet)


*********** # 3 **************
PokerStars Hand #169554807693: Tournament #1597684117, $4.55+$0.45 USD =
Hold'em No Limit - Level II (30/60) - 2017/05/07 21:06:12 ET
Table '1597684117 4' 9-max Seat #3 is the button
Seat 1: gator856500 (10000 in chips)=20
Seat 2: Pocket9s99 (8475 in chips)=20
Seat 3: nigock (10633 in chips)=20
Seat 4: nwmdnj (9740 in chips)=20
Seat 5: njhaar (10000 in chips)=20
Seat 6: ytseshr3d (10090 in chips)=20
Seat 7: LetsGoMets 6 (10000 in chips)=20
Seat 9: JJin91 (10825 in chips)=20
nwmdnj: posts small blind 30
njhaar: posts big blind 60
*** HOLE CARDS ***
Dealt to JJin91 [8h 5c]
ytseshr3d: folds=20
LetsGoMets 6: folds=20
JJin91: folds=20
gator856500: calls 60
Pocket9s99: folds=20
nigock: folds=20
nwmdnj: calls 30
njhaar: checks=20
*** FLOP *** [5s 6s Ah]
nwmdnj: checks=20
njhaar: checks=20
gator856500: checks=20
*** TURN *** [5s 6s Ah] [2s]
nwmdnj: checks=20
njhaar: checks=20
gator856500: checks=20
*** RIVER *** [5s 6s Ah 2s] [6c]
nwmdnj: checks=20
njhaar: checks=20
gator856500: checks=20
*** SHOW DOWN ***
nwmdnj: shows [Ts Kc] (a pair of Sixes)
njhaar: shows [5h 9h] (two pair, Sixes and Fives)
gator856500: mucks hand=20
njhaar collected 180 from pot
*** SUMMARY ***
Total pot 180 | Rake 0=20
Board [5s 6s Ah 2s 6c]
Seat 1: gator856500 mucked [4s 4h]
Seat 2: Pocket9s99 folded before Flop (didn't bet)
Seat 3: nigock (button) folded before Flop (didn't bet)
Seat 4: nwmdnj (small blind) showed [Ts Kc] and lost with a pair of Six=
es
Seat 5: njhaar (big blind) showed [5h 9h] and won (180) with two pair, =
Sixes and Fives
Seat 6: ytseshr3d folded before Flop (didn't bet)
Seat 7: LetsGoMets 6 folded before Flop (didn't bet)
Seat 9: JJin91 folded before Flop (didn't bet)


*********** # 4 **************
PokerStars Hand #169554808208: Tournament #1597684117, $4.55+$0.45 USD =
Hold'em No Limit - Level II (30/60) - 2017/05/07 21:07:33 ET
Table '1597684117 5' 9-max Seat #2 is the button
Seat 1: edsu373 (9950 in chips)=20
Seat 2: anthonyblue1 (9935 in chips)=20
Seat 3: chefmark70 (9940 in chips)=20
Seat 4: D_Rannn22 (10000 in chips)=20
Seat 5: Dezrok17 (9925 in chips)=20
Seat 6: JJin91 (10825 in chips)=20
Seat 9: SDVSF2290 (10000 in chips)=20
chefmark70: posts small blind 30
D_Rannn22: posts big blind 60
*** HOLE CARDS ***
Dealt to JJin91 [Kc 8h]
Dezrok17: folds=20
JJin91: folds=20
SDVSF2290: folds=20
edsu373: folds=20
anthonyblue1: folds=20
chefmark70: calls 30
D_Rannn22: checks=20
*** FLOP *** [4s Th 5h]
chefmark70: bets 120
D_Rannn22: calls 120
*** TURN *** [4s Th 5h] [Ah]
chefmark70: bets 180
D_Rannn22: folds=20
Uncalled bet (180) returned to chefmark70
chefmark70 collected 360 from pot
*** SUMMARY ***
Total pot 360 | Rake 0=20
Board [4s Th 5h Ah]
Seat 1: edsu373 folded before Flop (didn't bet)
Seat 2: anthonyblue1 (button) folded before Flop (didn't bet)
Seat 3: chefmark70 (small blind) collected (360)
Seat 4: D_Rannn22 (big blind) folded on the Turn
Seat 5: Dezrok17 folded before Flop (didn't bet)
Seat 6: JJin91 folded before Flop (didn't bet)
Seat 9: SDVSF2290 folded before Flop (didn't bet)


*********** # 5 **************
PokerStars Hand #169554808377: Tournament #1597684117, $4.55+$0.45 USD =
Hold'em No Limit - Level II (30/60) - 2017/05/07 21:08:03 ET
Table '1597684117 5' 9-max Seat #3 is the button
Seat 1: edsu373 (9950 in chips)=20
Seat 2: anthonyblue1 (9935 in chips)=20
Seat 3: chefmark70 (10120 in chips)=20
Seat 4: D_Rannn22 (9820 in chips)=20
Seat 5: Dezrok17 (9925 in chips)=20
Seat 6: JJin91 (10825 in chips)=20
Seat 7: RynerNJ (10000 in chips)=20
Seat 9: SDVSF2290 (10000 in chips)=20
D_Rannn22: posts small blind 30
Dezrok17: posts big blind 60
*** HOLE CARDS ***
Dealt to JJin91 [Jc 6s]
JJin91: folds=20
RynerNJ: folds=20
SDVSF2290: calls 60
edsu373: raises 300 to 360
anthonyblue1: folds=20
chefmark70: folds=20
D_Rannn22: folds=20
Dezrok17: folds=20
SDVSF2290: folds=20
Uncalled bet (300) returned to edsu373
edsu373 collected 210 from pot
edsu373: doesn't show hand=20
*** SUMMARY ***
Total pot 210 | Rake 0=20
Seat 1: edsu373 collected (210)
Seat 2: anthonyblue1 folded before Flop (didn't bet)
Seat 3: chefmark70 (button) folded before Flop (didn't bet)
Seat 4: D_Rannn22 (small blind) folded before Flop
Seat 5: Dezrok17 (big blind) folded before Flop
Seat 6: JJin91 folded before Flop (didn't bet)
Seat 7: RynerNJ folded before Flop (didn't bet)
Seat 9: SDVSF2290 folded before Flop


*********** # 6 **************
PokerStars Hand #169554808689: Tournament #1597684117, $4.55+$0.45 USD =
Hold'em No Limit - Level II (30/60) - 2017/05/07 21:08:53 ET
Table '1597684117 5' 9-max Seat #4 is the button
Seat 1: edsu373 (10100 in chips)=20
Seat 2: anthonyblue1 (9935 in chips)=20
Seat 3: chefmark70 (10120 in chips)=20
Seat 4: D_Rannn22 (9790 in chips)=20
Seat 5: Dezrok17 (9865 in chips)=20
Seat 6: JJin91 (10825 in chips)=20
Seat 7: RynerNJ (10000 in chips)=20
Seat 9: SDVSF2290 (9940 in chips)=20
Dezrok17: posts small blind 30
JJin91: posts big blind 60
*** HOLE CARDS ***
Dealt to JJin91 [9c 2c]
RynerNJ: folds=20
SDVSF2290: folds=20
edsu373: raises 300 to 360
anthonyblue1: folds=20
chefmark70: folds=20
D_Rannn22: calls 360
Dezrok17: folds=20
JJin91: folds=20
*** FLOP *** [Ks 7h As]
edsu373: bets 420
D_Rannn22: calls 420
*** TURN *** [Ks 7h As] [2d]
edsu373: bets 840
D_Rannn22: raises 840 to 1680
edsu373: calls 840
*** RIVER *** [Ks 7h As 2d] [Kh]
edsu373: bets 4980
D_Rannn22: folds=20
Uncalled bet (4980) returned to edsu373
edsu373 collected 5010 from pot
edsu373: doesn't show hand=20
*** SUMMARY ***
Total pot 5010 | Rake 0=20
Board [Ks 7h As 2d Kh]
Seat 1: edsu373 collected (5010)
Seat 2: anthonyblue1 folded before Flop (didn't bet)
Seat 3: chefmark70 folded before Flop (didn't bet)
Seat 4: D_Rannn22 (button) folded on the River
Seat 5: Dezrok17 (small blind) folded before Flop
Seat 6: JJin91 (big blind) folded before Flop
Seat 7: RynerNJ folded before Flop (didn't bet)
Seat 9: SDVSF2290 folded before Flop (didn't bet)


*********** # 7 **************
PokerStars Hand #169554809054: Tournament #1597684117, $4.55+$0.45 USD =
Hold'em No Limit - Level II (30/60) - 2017/05/07 21:09:49 ET
Table '1597684117 5' 9-max Seat #5 is the button
Seat 1: edsu373 (12650 in chips)=20
Seat 2: anthonyblue1 (9935 in chips)=20
Seat 3: chefmark70 (10120 in chips)=20
Seat 4: D_Rannn22 (7330 in chips)=20
Seat 5: Dezrok17 (9835 in chips)=20
Seat 6: JJin91 (10765 in chips)=20
Seat 7: RynerNJ (10000 in chips)=20
Seat 9: SDVSF2290 (9940 in chips)=20
JJin91: posts small blind 30
RynerNJ: posts big blind 60
*** HOLE CARDS ***
Dealt to JJin91 [Ts 2c]
SDVSF2290: folds=20
edsu373: calls 60
anthonyblue1: folds=20
chefmark70: raises 120 to 180
D_Rannn22: calls 180
Dezrok17: folds=20
JJin91: folds=20
RynerNJ: raises 9820 to 10000 and is all-in
edsu373: folds=20
chefmark70: folds=20
D_Rannn22: folds=20
Uncalled bet (9820) returned to RynerNJ
RynerNJ collected 630 from pot
RynerNJ: doesn't show hand=20
*** SUMMARY ***
Total pot 630 | Rake 0=20
Seat 1: edsu373 folded before Flop
Seat 2: anthonyblue1 folded before Flop (didn't bet)
Seat 3: chefmark70 folded before Flop
Seat 4: D_Rannn22 folded before Flop
Seat 5: Dezrok17 (button) folded before Flop (didn't bet)
Seat 6: JJin91 (small blind) folded before Flop
Seat 7: RynerNJ (big blind) collected (630)
Seat 9: SDVSF2290 folded before Flop (didn't bet)


*********** # 8 **************
PokerStars Hand #169554809322: Tournament #1597684117, $4.55+$0.45 USD =
Hold'em No Limit - Level III (40/80) - 2017/05/07 21:10:32 ET
Table '1597684117 5' 9-max Seat #6 is the button
Seat 1: edsu373 (12590 in chips)=20
Seat 2: anthonyblue1 (9935 in chips)=20
Seat 3: chefmark70 (9940 in chips)=20
Seat 4: D_Rannn22 (7150 in chips)=20
Seat 5: Dezrok17 (9835 in chips)=20
Seat 6: JJin91 (10735 in chips)=20
Seat 7: RynerNJ (10450 in chips)=20
Seat 9: SDVSF2290 (9940 in chips)=20
RynerNJ: posts small blind 40
SDVSF2290: posts big blind 80
*** HOLE CARDS ***
Dealt to JJin91 [Qd Kh]
edsu373: calls 80
anthonyblue1: calls 80
chefmark70: folds=20
D_Rannn22: folds=20
Dezrok17: folds=20
JJin91: calls 80
RynerNJ: folds=20
SDVSF2290: checks=20
*** FLOP *** [3s 8c 4c]
SDVSF2290: bets 180
edsu373: folds=20
anthonyblue1 is disconnected=20
anthonyblue1 has timed out while disconnected
anthonyblue1: folds=20
anthonyblue1 is sitting out
JJin91: calls 180
*** TURN *** [3s 8c 4c] [7s]
SDVSF2290: bets 720
anthonyblue1 has returned
JJin91: folds=20
Uncalled bet (720) returned to SDVSF2290
SDVSF2290 collected 720 from pot
SDVSF2290: doesn't show hand=20
*** SUMMARY ***
Total pot 720 | Rake 0=20
Board [3s 8c 4c 7s]
Seat 1: edsu373 folded on the Flop
Seat 2: anthonyblue1 folded on the Flop
Seat 3: chefmark70 folded before Flop (didn't bet)
Seat 4: D_Rannn22 folded before Flop (didn't bet)
Seat 5: Dezrok17 folded before Flop (didn't bet)
Seat 6: JJin91 (button) folded on the Turn
Seat 7: RynerNJ (small blind) folded before Flop
Seat 9: SDVSF2290 (big blind) collected (720)


*********** # 9 **************
PokerStars Hand #169554809988: Tournament #1597684117, $4.55+$0.45 USD =
Hold'em No Limit - Level III (40/80) - 2017/05/07 21:12:21 ET
Table '1597684117 5' 9-max Seat #7 is the button
Seat 1: edsu373 (12510 in chips)=20
Seat 2: anthonyblue1 (9855 in chips)=20
Seat 3: chefmark70 (9940 in chips)=20
Seat 4: D_Rannn22 (7150 in chips)=20
Seat 5: Dezrok17 (9835 in chips)=20
Seat 6: JJin91 (10475 in chips)=20
Seat 7: RynerNJ (10410 in chips)=20
Seat 9: SDVSF2290 (10400 in chips)=20
SDVSF2290: posts small blind 40
edsu373: posts big blind 80
*** HOLE CARDS ***
Dealt to JJin91 [2d 7h]
anthonyblue1: folds=20
chefmark70: raises 160 to 240
D_Rannn22: folds=20
Dezrok17: folds=20
JJin91: folds=20
RynerNJ: folds=20
SDVSF2290: folds=20
edsu373: folds=20
Uncalled bet (160) returned to chefmark70
chefmark70 collected 200 from pot
*** SUMMARY ***
Total pot 200 | Rake 0=20
Seat 1: edsu373 (big blind) folded before Flop
Seat 2: anthonyblue1 folded before Flop (didn't bet)
Seat 3: chefmark70 collected (200)
Seat 4: D_Rannn22 folded before Flop (didn't bet)
Seat 5: Dezrok17 folded before Flop (didn't bet)
Seat 6: JJin91 folded before Flop (didn't bet)
Seat 7: RynerNJ (button) folded before Flop (didn't bet)
Seat 9: SDVSF2290 (small blind) folded before Flop


*********** # 10 **************
PokerStars Hand #169556171113: Tournament #1597684117, $4.55+$0.45 USD =
Hold'em No Limit - Level III (40/80) - 2017/05/07 21:12:42 ET
Table '1597684117 5' 9-max Seat #9 is the button
Seat 1: edsu373 (12430 in chips)=20
Seat 2: anthonyblue1 (9855 in chips)=20
Seat 3: chefmark70 (10060 in chips)=20
Seat 4: D_Rannn22 (7150 in chips)=20
Seat 5: Dezrok17 (9835 in chips)=20
Seat 6: JJin91 (10475 in chips)=20
Seat 7: RynerNJ (10410 in chips)=20
Seat 9: SDVSF2290 (10360 in chips)=20
edsu373: posts small blind 40
anthonyblue1: posts big blind 80
*** HOLE CARDS ***
Dealt to JJin91 [5h 5s]
chefmark70: folds=20
D_Rannn22: folds=20
Dezrok17: folds=20
JJin91: raises 95 to 175
RynerNJ: calls 175
SDVSF2290: folds=20
edsu373: raises 605 to 780
anthonyblue1: folds=20
JJin91: folds=20
RynerNJ: calls 605
*** FLOP *** [7s Ks 7d]
edsu373: bets 880
RynerNJ: calls 880
*** TURN *** [7s Ks 7d] [Js]
edsu373: bets 1760
RynerNJ: calls 1760
*** RIVER *** [7s Ks 7d Js] [8s]
edsu373: bets 3520
RynerNJ: raises 3470 to 6990 and is all-in
edsu373: calls 3470
*** SHOW DOWN ***
RynerNJ: shows [Ts 9s] (a straight flush, Seven to Jack)
edsu373: shows [Th Tc] (two pair, Tens and Sevens)
RynerNJ collected 21075 from pot
*** SUMMARY ***
Total pot 21075 | Rake 0=20
Board [7s Ks 7d Js 8s]
Seat 1: edsu373 (small blind) showed [Th Tc] and lost with two pair, Te=
ns and Sevens
Seat 2: anthonyblue1 (big blind) folded before Flop
Seat 3: chefmark70 folded before Flop (didn't bet)
Seat 4: D_Rannn22 folded before Flop (didn't bet)
Seat 5: Dezrok17 folded before Flop (didn't bet)
Seat 6: JJin91 folded before Flop
Seat 7: RynerNJ showed [Ts 9s] and won (21075) with a straight flush, S=
even to Jack
Seat 9: SDVSF2290 (button) folded before Flop (didn't bet)


*********** # 11 **************
PokerStars Hand #169556171456: Tournament #1597684117, $4.55+$0.45 USD =
Hold'em No Limit - Level III (40/80) - 2017/05/07 21:13:39 ET
Table '1597684117 5' 9-max Seat #1 is the button
Seat 1: edsu373 (2020 in chips)=20
Seat 2: anthonyblue1 (9775 in chips)=20
Seat 4: D_Rannn22 (7150 in chips)=20
Seat 5: Dezrok17 (9835 in chips)=20
Seat 6: JJin91 (10300 in chips)=20
Seat 7: RynerNJ (21075 in chips)=20
Seat 8: EmmaBrighton (10000 in chips)=20
Seat 9: SDVSF2290 (10360 in chips)=20
anthonyblue1: posts small blind 40
D_Rannn22: posts big blind 80
*** HOLE CARDS ***
Dealt to JJin91 [7c 4c]
Dezrok17: folds=20
JJin91: folds=20
RynerNJ: folds=20
EmmaBrighton: raises 160 to 240
SDVSF2290: folds=20
edsu373: raises 1780 to 2020 and is all-in
anthonyblue1: folds=20
D_Rannn22: calls 1940
EmmaBrighton: calls 1780
*** FLOP *** [5d Ts 8c]
D_Rannn22: bets 5130 and is all-in
EmmaBrighton: calls 5130
*** TURN *** [5d Ts 8c] [2c]
*** RIVER *** [5d Ts 8c 2c] [6h]
*** SHOW DOWN ***
D_Rannn22: shows [Js Qd] (high card Queen)
EmmaBrighton: shows [Kh 9d] (high card King)
EmmaBrighton collected 10260 from side pot
edsu373: shows [Ad 6d] (a pair of Sixes)
edsu373 collected 6100 from main pot
D_Rannn22 finished the tournament in 101st place
*** SUMMARY ***
Total pot 16360 Main pot 6100. Side pot 10260. | Rake 0=20
Board [5d Ts 8c 2c 6h]
Seat 1: edsu373 (button) showed [Ad 6d] and won (6100) with a pair of S=
ixes
Seat 2: anthonyblue1 (small blind) folded before Flop
Seat 4: D_Rannn22 (big blind) showed [Js Qd] and lost with high card Qu=
een
Seat 5: Dezrok17 folded before Flop (didn't bet)
Seat 6: JJin91 folded before Flop (didn't bet)
Seat 7: RynerNJ folded before Flop (didn't bet)
Seat 8: EmmaBrighton showed [Kh 9d] and won (10260) with high card King
Seat 9: SDVSF2290 folded before Flop (didn't bet)


*********** # 12 **************
PokerStars Hand #169556171668: Tournament #1597684117, $4.55+$0.45 USD =
Hold'em No Limit - Level III (40/80) - 2017/05/07 21:14:14 ET
Table '1597684117 5' 9-max Seat #2 is the button
Seat 1: edsu373 (6100 in chips)=20
Seat 2: anthonyblue1 (9735 in chips)=20
Seat 6: JJin91 (10300 in chips)=20
Seat 7: RynerNJ (21075 in chips)=20
Seat 8: EmmaBrighton (13110 in chips)=20
Seat 9: SDVSF2290 (10360 in chips)=20
JJin91: posts small blind 40
RynerNJ: posts big blind 80
*** HOLE CARDS ***
Dealt to JJin91 [4d 3d]
EmmaBrighton: calls 80
SDVSF2290: folds=20
edsu373: raises 280 to 360
anthonyblue1: folds=20
JJin91: folds=20
RynerNJ: folds=20
EmmaBrighton: calls 280
*** FLOP *** [Jh 8c 9h]
EmmaBrighton: bets 12750 and is all-in
edsu373: calls 5740 and is all-in
Uncalled bet (7010) returned to EmmaBrighton
*** TURN *** [Jh 8c 9h] [Td]
*** RIVER *** [Jh 8c 9h Td] [Qc]
*** SHOW DOWN ***
EmmaBrighton: shows [Js 8h] (a straight, Eight to Queen)
edsu373: shows [3h Ah] (a straight, Eight to Queen)
EmmaBrighton collected 6160 from pot
edsu373 collected 6160 from pot
*** SUMMARY ***
Total pot 12320 | Rake 0=20
Board [Jh 8c 9h Td Qc]
Seat 1: edsu373 showed [3h Ah] and won (6160) with a straight, Eight to=
 Queen
Seat 2: anthonyblue1 (button) folded before Flop (didn't bet)
Seat 6: JJin91 (small blind) folded before Flop
Seat 7: RynerNJ (big blind) folded before Flop
Seat 8: EmmaBrighton showed [Js 8h] and won (6160) with a straight, Eig=
ht to Queen
Seat 9: SDVSF2290 folded before Flop (didn't bet)


*********** # 13 **************
PokerStars Hand #169556171871: Tournament #1597684117, $4.55+$0.45 USD =
Hold'em No Limit - Level III (40/80) - 2017/05/07 21:14:45 ET
Table '1597684117 5' 9-max Seat #6 is the button
Seat 1: edsu373 (6160 in chips)=20
Seat 2: anthonyblue1 (9735 in chips)=20
Seat 6: JJin91 (10260 in chips)=20
Seat 7: RynerNJ (20995 in chips)=20
Seat 8: EmmaBrighton (13170 in chips)=20
Seat 9: SDVSF2290 (10360 in chips)=20
RynerNJ: posts small blind 40
EmmaBrighton: posts big blind 80
*** HOLE CARDS ***
Dealt to JJin91 [7s Js]
SDVSF2290: calls 80
edsu373: calls 80
anthonyblue1: folds=20
JJin91: folds=20
RynerNJ: calls 40
EmmaBrighton: checks=20
*** FLOP *** [Ts 4h 2d]
RynerNJ: checks=20
EmmaBrighton: bets 320
SDVSF2290: folds=20
edsu373: raises 5760 to 6080 and is all-in
RynerNJ: folds=20
EmmaBrighton: calls 5760
*** TURN *** [Ts 4h 2d] [3d]
*** RIVER *** [Ts 4h 2d 3d] [6d]
*** SHOW DOWN ***
EmmaBrighton: shows [Tc Ks] (a pair of Tens)
edsu373: shows [Ah 6s] (a pair of Sixes)
EmmaBrighton collected 12480 from pot
edsu373 finished the tournament in 100th place
*** SUMMARY ***
Total pot 12480 | Rake 0=20
Board [Ts 4h 2d 3d 6d]
Seat 1: edsu373 showed [Ah 6s] and lost with a pair of Sixes
Seat 2: anthonyblue1 folded before Flop (didn't bet)
Seat 6: JJin91 (button) folded before Flop (didn't bet)
Seat 7: RynerNJ (small blind) folded on the Flop
Seat 8: EmmaBrighton (big blind) showed [Tc Ks] and won (12480) with a =
pair of Tens
Seat 9: SDVSF2290 folded on the Flop


*********** # 14 **************
PokerStars Hand #169556172232: Tournament #1597684117, $4.55+$0.45 USD =
Hold'em No Limit - Level IV (50/100) - 2017/05/07 21:15:47 ET
Table '1597684117 5' 9-max Seat #7 is the button
Seat 2: anthonyblue1 (9735 in chips)=20
Seat 3: Harmn8r (1500 in chips)=20
Seat 4: gator856500 (9275 in chips)=20
Seat 6: JJin91 (10260 in chips)=20
Seat 7: RynerNJ (20915 in chips)=20
Seat 8: EmmaBrighton (19490 in chips)=20
Seat 9: SDVSF2290 (10280 in chips)=20
anthonyblue1: posts the ante 10
Harmn8r: posts the ante 10
gator856500: posts the ante 10
JJin91: posts the ante 10
RynerNJ: posts the ante 10
EmmaBrighton: posts the ante 10
SDVSF2290: posts the ante 10
EmmaBrighton: posts small blind 50
SDVSF2290: posts big blind 100
*** HOLE CARDS ***
Dealt to JJin91 [Qs Qh]
anthonyblue1: folds=20
Harmn8r: folds=20
gator856500: folds=20
JJin91: raises 161 to 261
RynerNJ: folds=20
EmmaBrighton: folds=20
SDVSF2290: folds=20
Uncalled bet (161) returned to JJin91
JJin91 collected 320 from pot
JJin91: doesn't show hand=20
*** SUMMARY ***
Total pot 320 | Rake 0=20
Seat 2: anthonyblue1 folded before Flop (didn't bet)
Seat 3: Harmn8r folded before Flop (didn't bet)
Seat 4: gator856500 folded before Flop (didn't bet)
Seat 6: JJin91 collected (320)
Seat 7: RynerNJ (button) folded before Flop (didn't bet)
Seat 8: EmmaBrighton (small blind) folded before Flop
Seat 9: SDVSF2290 (big blind) folded before Flop


*********** # 15 **************
PokerStars Hand #169556172347: Tournament #1597684117, $4.55+$0.45 USD =
Hold'em No Limit - Level IV (50/100) - 2017/05/07 21:16:06 ET
Table '1597684117 5' 9-max Seat #8 is the button
Seat 2: anthonyblue1 (9725 in chips)=20
Seat 3: Harmn8r (1490 in chips)=20
Seat 4: gator856500 (9265 in chips)=20
Seat 6: JJin91 (10470 in chips)=20
Seat 7: RynerNJ (20905 in chips)=20
Seat 8: EmmaBrighton (19430 in chips)=20
Seat 9: SDVSF2290 (10170 in chips)=20
anthonyblue1: posts the ante 10
Harmn8r: posts the ante 10
gator856500: posts the ante 10
JJin91: posts the ante 10
RynerNJ: posts the ante 10
EmmaBrighton: posts the ante 10
SDVSF2290: posts the ante 10
SDVSF2290: posts small blind 50
anthonyblue1: posts big blind 100
*** HOLE CARDS ***
Dealt to JJin91 [6h Jc]
Harmn8r: folds=20
gator856500: folds=20
JJin91: folds=20
RynerNJ: raises 150 to 250
EmmaBrighton: folds=20
SDVSF2290: folds=20
anthonyblue1: folds=20
Uncalled bet (150) returned to RynerNJ
RynerNJ collected 320 from pot
RynerNJ: doesn't show hand=20
*** SUMMARY ***
Total pot 320 | Rake 0=20
Seat 2: anthonyblue1 (big blind) folded before Flop
Seat 3: Harmn8r folded before Flop (didn't bet)
Seat 4: gator856500 folded before Flop (didn't bet)
Seat 6: JJin91 folded before Flop (didn't bet)
Seat 7: RynerNJ collected (320)
Seat 8: EmmaBrighton (button) folded before Flop (didn't bet)
Seat 9: SDVSF2290 (small blind) folded before Flop


*********** # 16 **************
PokerStars Hand #169556172580: Tournament #1597684117, $4.55+$0.45 USD =
Hold'em No Limit - Level IV (50/100) - 2017/05/07 21:16:40 ET
Table '1597684117 5' 9-max Seat #9 is the button
Seat 2: anthonyblue1 (9615 in chips)=20
Seat 3: Harmn8r (1480 in chips)=20
Seat 4: gator856500 (9255 in chips)=20
Seat 6: JJin91 (10460 in chips)=20
Seat 7: RynerNJ (21115 in chips)=20
Seat 8: EmmaBrighton (19420 in chips)=20
Seat 9: SDVSF2290 (10110 in chips)=20
anthonyblue1: posts the ante 10
Harmn8r: posts the ante 10
gator856500: posts the ante 10
JJin91: posts the ante 10
RynerNJ: posts the ante 10
EmmaBrighton: posts the ante 10
SDVSF2290: posts the ante 10
anthonyblue1: posts small blind 50
Harmn8r: posts big blind 100
*** HOLE CARDS ***
Dealt to JJin91 [6d 9c]
gator856500: folds=20
JJin91: folds=20
RynerNJ: folds=20
EmmaBrighton: calls 100
SDVSF2290: folds=20
anthonyblue1: folds=20
Harmn8r: checks=20
*** FLOP *** [Th Tc As]
Harmn8r: checks=20
EmmaBrighton: checks=20
*** TURN *** [Th Tc As] [5d]
Harmn8r: bets 100
EmmaBrighton: folds=20
Uncalled bet (100) returned to Harmn8r
Harmn8r collected 320 from pot
Harmn8r: doesn't show hand=20
*** SUMMARY ***
Total pot 320 | Rake 0=20
Board [Th Tc As 5d]
Seat 2: anthonyblue1 (small blind) folded before Flop
Seat 3: Harmn8r (big blind) collected (320)
Seat 4: gator856500 folded before Flop (didn't bet)
Seat 6: JJin91 folded before Flop (didn't bet)
Seat 7: RynerNJ folded before Flop (didn't bet)
Seat 8: EmmaBrighton folded on the Turn
Seat 9: SDVSF2290 (button) folded before Flop (didn't bet)


*********** # 17 **************
PokerStars Hand #169556172784: Tournament #1597684117, $4.55+$0.45 USD =
Hold'em No Limit - Level IV (50/100) - 2017/05/07 21:17:13 ET
Table '1597684117 5' 9-max Seat #2 is the button
Seat 2: anthonyblue1 (9555 in chips)=20
Seat 3: Harmn8r (1690 in chips)=20
Seat 4: gator856500 (9245 in chips)=20
Seat 6: JJin91 (10450 in chips)=20
Seat 7: RynerNJ (21105 in chips)=20
Seat 8: EmmaBrighton (19310 in chips)=20
Seat 9: SDVSF2290 (10100 in chips)=20
anthonyblue1: posts the ante 10
Harmn8r: posts the ante 10
gator856500: posts the ante 10
JJin91: posts the ante 10
RynerNJ: posts the ante 10
EmmaBrighton: posts the ante 10
SDVSF2290: posts the ante 10
Harmn8r: posts small blind 50
gator856500: posts big blind 100
*** HOLE CARDS ***
Dealt to JJin91 [7c Kd]
JJin91: folds=20
RynerNJ: calls 100
EmmaBrighton: raises 420 to 520
SDVSF2290: folds=20
anthonyblue1: calls 520
Harmn8r: folds=20
gator856500: folds=20
RynerNJ: calls 420
*** FLOP *** [Ah Ts Qs]
RynerNJ: checks=20
EmmaBrighton: bets 1780
anthonyblue1: folds=20
RynerNJ: folds=20
Uncalled bet (1780) returned to EmmaBrighton
EmmaBrighton collected 1780 from pot
EmmaBrighton: doesn't show hand=20
*** SUMMARY ***
Total pot 1780 | Rake 0=20
Board [Ah Ts Qs]
Seat 2: anthonyblue1 (button) folded on the Flop
Seat 3: Harmn8r (small blind) folded before Flop
Seat 4: gator856500 (big blind) folded before Flop
Seat 6: JJin91 folded before Flop (didn't bet)
Seat 7: RynerNJ folded on the Flop
Seat 8: EmmaBrighton collected (1780)
Seat 9: SDVSF2290 folded before Flop (didn't bet)


*********** # 18 **************
PokerStars Hand #169556173042: Tournament #1597684117, $4.55+$0.45 USD =
Hold'em No Limit - Level IV (50/100) - 2017/05/07 21:17:54 ET
Table '1597684117 5' 9-max Seat #3 is the button
Seat 2: anthonyblue1 (9025 in chips)=20
Seat 3: Harmn8r (1630 in chips)=20
Seat 4: gator856500 (9135 in chips)=20
Seat 6: JJin91 (10440 in chips)=20
Seat 7: RynerNJ (20575 in chips)=20
Seat 8: EmmaBrighton (20560 in chips)=20
Seat 9: SDVSF2290 (10090 in chips)=20
anthonyblue1: posts the ante 10
Harmn8r: posts the ante 10
gator856500: posts the ante 10
JJin91: posts the ante 10
RynerNJ: posts the ante 10
EmmaBrighton: posts the ante 10
SDVSF2290: posts the ante 10
gator856500: posts small blind 50
JJin91: posts big blind 100
*** HOLE CARDS ***
Dealt to JJin91 [7s 4c]
RynerNJ: folds=20
EmmaBrighton: raises 200 to 300
SDVSF2290: raises 820 to 1120
anthonyblue1: folds=20
Harmn8r: folds=20
gator856500: calls 1070
JJin91: folds=20
EmmaBrighton: calls 820
*** FLOP *** [Ah 9d 2c]
gator856500: checks=20
EmmaBrighton: checks=20
SDVSF2290: bets 1765
gator856500: folds=20
EmmaBrighton: folds=20
Uncalled bet (1765) returned to SDVSF2290
SDVSF2290 collected 3530 from pot
SDVSF2290: doesn't show hand=20
*** SUMMARY ***
Total pot 3530 | Rake 0=20
Board [Ah 9d 2c]
Seat 2: anthonyblue1 folded before Flop (didn't bet)
Seat 3: Harmn8r (button) folded before Flop (didn't bet)
Seat 4: gator856500 (small blind) folded on the Flop
Seat 6: JJin91 (big blind) folded before Flop
Seat 7: RynerNJ folded before Flop (didn't bet)
Seat 8: EmmaBrighton folded on the Flop
Seat 9: SDVSF2290 collected (3530)


*********** # 19 **************
PokerStars Hand #169556173399: Tournament #1597684117, $4.55+$0.45 USD =
Hold'em No Limit - Level IV (50/100) - 2017/05/07 21:18:50 ET
Table '1597684117 5' 9-max Seat #4 is the button
Seat 2: anthonyblue1 (9015 in chips)=20
Seat 3: Harmn8r (1620 in chips)=20
Seat 4: gator856500 (8005 in chips)=20
Seat 6: JJin91 (10330 in chips)=20
Seat 7: RynerNJ (20565 in chips)=20
Seat 8: EmmaBrighton (19430 in chips)=20
Seat 9: SDVSF2290 (12490 in chips)=20
anthonyblue1: posts the ante 10
Harmn8r: posts the ante 10
gator856500: posts the ante 10
JJin91: posts the ante 10
RynerNJ: posts the ante 10
EmmaBrighton: posts the ante 10
SDVSF2290: posts the ante 10
JJin91: posts small blind 50
RynerNJ: posts big blind 100
*** HOLE CARDS ***
Dealt to JJin91 [9c 8d]
EmmaBrighton: calls 100
SDVSF2290: calls 100
anthonyblue1: folds=20
Harmn8r: folds=20
gator856500: calls 100
JJin91: calls 50
RynerNJ: checks=20
*** FLOP *** [4s 5c 5s]
JJin91: checks=20
RynerNJ: checks=20
EmmaBrighton: checks=20
SDVSF2290: bets 570
gator856500: folds=20
JJin91: folds=20
RynerNJ: calls 570
EmmaBrighton: folds=20
*** TURN *** [4s 5c 5s] [Js]
RynerNJ: checks=20
SDVSF2290: bets 1710
RynerNJ: raises 2390 to 4100
SDVSF2290: raises 2390 to 6490
RynerNJ: raises 13395 to 19885 and is all-in
SDVSF2290: calls 5320 and is all-in
Uncalled bet (8075) returned to RynerNJ
*** RIVER *** [4s 5c 5s Js] [Th]
*** SHOW DOWN ***
RynerNJ: shows [7d 5h] (three of a kind, Fives)
SDVSF2290: shows [As 2s] (a flush, Ace high)
SDVSF2290 collected 25330 from pot
*** SUMMARY ***
Total pot 25330 | Rake 0=20
Board [4s 5c 5s Js Th]
Seat 2: anthonyblue1 folded before Flop (didn't bet)
Seat 3: Harmn8r folded before Flop (didn't bet)
Seat 4: gator856500 (button) folded on the Flop
Seat 6: JJin91 (small blind) folded on the Flop
Seat 7: RynerNJ (big blind) showed [7d 5h] and lost with three of a kin=
d, Fives
Seat 8: EmmaBrighton folded on the Flop
Seat 9: SDVSF2290 showed [As 2s] and won (25330) with a flush, Ace high


*********** # 20 **************
PokerStars Hand #169556173835: Tournament #1597684117, $4.55+$0.45 USD =
Hold'em No Limit - Level IV (50/100) - 2017/05/07 21:20:04 ET
Table '1597684117 5' 9-max Seat #6 is the button
Seat 1: Burassi (10000 in chips)=20
Seat 2: anthonyblue1 (9005 in chips)=20
Seat 3: Harmn8r (1610 in chips)=20
Seat 4: gator856500 (7895 in chips)=20
Seat 6: JJin91 (10220 in chips)=20
Seat 7: RynerNJ (8075 in chips)=20
Seat 8: EmmaBrighton (19320 in chips)=20
Seat 9: SDVSF2290 (25330 in chips)=20
Burassi: posts the ante 10
anthonyblue1: posts the ante 10
Harmn8r: posts the ante 10
gator856500: posts the ante 10
JJin91: posts the ante 10
RynerNJ: posts the ante 10
EmmaBrighton: posts the ante 10
SDVSF2290: posts the ante 10
RynerNJ: posts small blind 50
EmmaBrighton: posts big blind 100
*** HOLE CARDS ***
Dealt to JJin91 [7s 8h]
SDVSF2290: folds=20
Burassi: folds=20
anthonyblue1: folds=20
Harmn8r: folds=20
gator856500: folds=20
JJin91: raises 119 to 219
RynerNJ: folds=20
EmmaBrighton: raises 119 to 338
JJin91: calls 119
*** FLOP *** [3d 4d 7h]
EmmaBrighton: bets 806
JJin91: raises 1494 to 2300
EmmaBrighton: folds=20
Uncalled bet (1494) returned to JJin91
JJin91 collected 2418 from pot
JJin91: doesn't show hand=20
*** SUMMARY ***
Total pot 2418 | Rake 0=20
Board [3d 4d 7h]
Seat 1: Burassi folded before Flop (didn't bet)
Seat 2: anthonyblue1 folded before Flop (didn't bet)
Seat 3: Harmn8r folded before Flop (didn't bet)
Seat 4: gator856500 folded before Flop (didn't bet)
Seat 6: JJin91 (button) collected (2418)
Seat 7: RynerNJ (small blind) folded before Flop
Seat 8: EmmaBrighton (big blind) folded on the Flop
Seat 9: SDVSF2290 folded before Flop (didn't bet)


*********** # 21 **************
PokerStars Hand #169556174082: Tournament #1597684117, $4.55+$0.45 USD =
Hold'em No Limit - Level V (60/120) - 2017/05/07 21:20:44 ET
Table '1597684117 5' 9-max Seat #7 is the button
Seat 1: Burassi (9990 in chips)=20
Seat 2: anthonyblue1 (8995 in chips)=20
Seat 3: Harmn8r (1600 in chips)=20
Seat 4: gator856500 (7885 in chips)=20
Seat 6: JJin91 (11484 in chips)=20
Seat 7: RynerNJ (8015 in chips)=20
Seat 8: EmmaBrighton (18166 in chips)=20
Seat 9: SDVSF2290 (25320 in chips)=20
Burassi: posts the ante 15
anthonyblue1: posts the ante 15
Harmn8r: posts the ante 15
gator856500: posts the ante 15
JJin91: posts the ante 15
RynerNJ: posts the ante 15
EmmaBrighton: posts the ante 15
SDVSF2290: posts the ante 15
EmmaBrighton: posts small blind 60
SDVSF2290: posts big blind 120
*** HOLE CARDS ***
Dealt to JJin91 [9c 3d]
Burassi: folds=20
anthonyblue1: folds=20
Harmn8r: folds=20
gator856500: folds=20
JJin91: folds=20
RynerNJ: raises 180 to 300
EmmaBrighton: calls 240
SDVSF2290: folds=20
*** FLOP *** [8d Js 4s]
EmmaBrighton: checks=20
RynerNJ: bets 420
EmmaBrighton: folds=20
Uncalled bet (420) returned to RynerNJ
RynerNJ collected 840 from pot
RynerNJ: doesn't show hand=20
*** SUMMARY ***
Total pot 840 | Rake 0=20
Board [8d Js 4s]
Seat 1: Burassi folded before Flop (didn't bet)
Seat 2: anthonyblue1 folded before Flop (didn't bet)
Seat 3: Harmn8r folded before Flop (didn't bet)
Seat 4: gator856500 folded before Flop (didn't bet)
Seat 6: JJin91 folded before Flop (didn't bet)
Seat 7: RynerNJ (button) collected (840)
Seat 8: EmmaBrighton (small blind) folded on the Flop
Seat 9: SDVSF2290 (big blind) folded before Flop


*********** # 22 **************
PokerStars Hand #169556174224: Tournament #1597684117, $4.55+$0.45 USD =
Hold'em No Limit - Level V (60/120) - 2017/05/07 21:21:09 ET
Table '1597684117 5' 9-max Seat #8 is the button
Seat 1: Burassi (9975 in chips)=20
Seat 2: anthonyblue1 (8980 in chips)=20
Seat 3: Harmn8r (1585 in chips)=20
Seat 4: gator856500 (7870 in chips)=20
Seat 6: JJin91 (11469 in chips)=20
Seat 7: RynerNJ (8540 in chips)=20
Seat 8: EmmaBrighton (17851 in chips)=20
Seat 9: SDVSF2290 (25185 in chips)=20
Burassi: posts the ante 15
anthonyblue1: posts the ante 15
Harmn8r: posts the ante 15
gator856500: posts the ante 15
JJin91: posts the ante 15
RynerNJ: posts the ante 15
EmmaBrighton: posts the ante 15
SDVSF2290: posts the ante 15
SDVSF2290: posts small blind 60
Burassi: posts big blind 120
*** HOLE CARDS ***
Dealt to JJin91 [7c 9c]
anthonyblue1: folds=20
Harmn8r: folds=20
gator856500: calls 120
JJin91: folds=20
RynerNJ: folds=20
EmmaBrighton: raises 240 to 360
SDVSF2290: folds=20
Burassi: folds=20
gator856500: calls 240
*** FLOP *** [5d 6s 7d]
gator856500: checks=20
EmmaBrighton: bets 1020
gator856500: calls 1020
*** TURN *** [5d 6s 7d] [Kd]
gator856500: bets 1530
EmmaBrighton: calls 1530
*** RIVER *** [5d 6s 7d Kd] [Qh]
gator856500: bets 3060
EmmaBrighton: folds=20
Uncalled bet (3060) returned to gator856500
gator856500 collected 6120 from pot
gator856500: doesn't show hand=20
*** SUMMARY ***
Total pot 6120 | Rake 0=20
Board [5d 6s 7d Kd Qh]
Seat 1: Burassi (big blind) folded before Flop
Seat 2: anthonyblue1 folded before Flop (didn't bet)
Seat 3: Harmn8r folded before Flop (didn't bet)
Seat 4: gator856500 collected (6120)
Seat 6: JJin91 folded before Flop (didn't bet)
Seat 7: RynerNJ folded before Flop (didn't bet)
Seat 8: EmmaBrighton (button) folded on the River
Seat 9: SDVSF2290 (small blind) folded before Flop


*********** # 23 **************
PokerStars Hand #169556174495: Tournament #1597684117, $4.55+$0.45 USD =
Hold'em No Limit - Level V (60/120) - 2017/05/07 21:21:57 ET
Table '1597684117 5' 9-max Seat #9 is the button
Seat 1: Burassi (9840 in chips)=20
Seat 2: anthonyblue1 (8965 in chips)=20
Seat 3: Harmn8r (1570 in chips)=20
Seat 4: gator856500 (11065 in chips)=20
Seat 6: JJin91 (11454 in chips)=20
Seat 7: RynerNJ (8525 in chips)=20
Seat 8: EmmaBrighton (14926 in chips)=20
Seat 9: SDVSF2290 (25110 in chips)=20
Burassi: posts the ante 15
anthonyblue1: posts the ante 15
Harmn8r: posts the ante 15
gator856500: posts the ante 15
JJin91: posts the ante 15
RynerNJ: posts the ante 15
EmmaBrighton: posts the ante 15
SDVSF2290: posts the ante 15
Burassi: posts small blind 60
anthonyblue1: posts big blind 120
*** HOLE CARDS ***
Dealt to JJin91 [Ac 8s]
Harmn8r: folds=20
gator856500: calls 120
JJin91: folds=20
RynerNJ: raises 180 to 300
EmmaBrighton: calls 300
SDVSF2290: folds=20
Burassi: folds=20
anthonyblue1: calls 180
gator856500: folds=20
*** FLOP *** [Td 6c Th]
anthonyblue1: checks=20
RynerNJ: checks=20
EmmaBrighton: checks=20
*** TURN *** [Td 6c Th] [4c]
anthonyblue1: bets 480
RynerNJ: calls 480
EmmaBrighton: folds=20
*** RIVER *** [Td 6c Th 4c] [3d]
anthonyblue1: bets 1200
RynerNJ: raises 1800 to 3000
anthonyblue1: folds=20
Uncalled bet (1800) returned to RynerNJ
RynerNJ collected 4560 from pot
RynerNJ: doesn't show hand=20
*** SUMMARY ***
Total pot 4560 | Rake 0=20
Board [Td 6c Th 4c 3d]
Seat 1: Burassi (small blind) folded before Flop
Seat 2: anthonyblue1 (big blind) folded on the River
Seat 3: Harmn8r folded before Flop (didn't bet)
Seat 4: gator856500 folded before Flop
Seat 6: JJin91 folded before Flop (didn't bet)
Seat 7: RynerNJ collected (4560)
Seat 8: EmmaBrighton folded on the Turn
Seat 9: SDVSF2290 (button) folded before Flop (didn't bet)


*********** # 24 **************
PokerStars Hand #169556175050: Tournament #1597684117, $4.55+$0.45 USD =
Hold'em No Limit - Level V (60/120) - 2017/05/07 21:23:32 ET
Table '1597684117 5' 9-max Seat #1 is the button
Seat 1: Burassi (9765 in chips)=20
Seat 2: anthonyblue1 (6970 in chips)=20
Seat 3: Harmn8r (1555 in chips)=20
Seat 4: gator856500 (10930 in chips)=20
Seat 6: JJin91 (11439 in chips)=20
Seat 7: RynerNJ (11090 in chips)=20
Seat 8: EmmaBrighton (14611 in chips)=20
Seat 9: SDVSF2290 (25095 in chips)=20
Burassi: posts the ante 15
anthonyblue1: posts the ante 15
Harmn8r: posts the ante 15
gator856500: posts the ante 15
JJin91: posts the ante 15
RynerNJ: posts the ante 15
EmmaBrighton: posts the ante 15
SDVSF2290: posts the ante 15
anthonyblue1: posts small blind 60
Harmn8r: posts big blind 120
*** HOLE CARDS ***
Dealt to JJin91 [Td 6d]
gator856500: calls 120
JJin91: folds=20
RynerNJ: calls 120
EmmaBrighton: folds=20
SDVSF2290: raises 120 to 240
Burassi: folds=20
anthonyblue1: calls 180
Harmn8r: raises 1300 to 1540 and is all-in
gator856500: folds=20
RynerNJ: folds=20
SDVSF2290: calls 1300
anthonyblue1: folds=20
*** FLOP *** [5h 7c 9c]
*** TURN *** [5h 7c 9c] [5c]
*** RIVER *** [5h 7c 9c 5c] [Jh]
*** SHOW DOWN ***
Harmn8r: shows [Ac Kc] (a flush, Ace high)
SDVSF2290: shows [Kd Th] (a pair of Fives)
Harmn8r collected 3680 from pot
*** SUMMARY ***
Total pot 3680 | Rake 0=20
Board [5h 7c 9c 5c Jh]
Seat 1: Burassi (button) folded before Flop (didn't bet)
Seat 2: anthonyblue1 (small blind) folded before Flop
Seat 3: Harmn8r (big blind) showed [Ac Kc] and won (3680) with a flush,=
 Ace high
Seat 4: gator856500 folded before Flop
Seat 6: JJin91 folded before Flop (didn't bet)
Seat 7: RynerNJ folded before Flop
Seat 8: EmmaBrighton folded before Flop (didn't bet)
Seat 9: SDVSF2290 showed [Kd Th] and lost with a pair of Fives


*********** # 25 **************
PokerStars Hand #169556175349: Tournament #1597684117, $4.55+$0.45 USD =
Hold'em No Limit - Level V (60/120) - 2017/05/07 21:24:24 ET
Table '1597684117 5' 9-max Seat #2 is the button
Seat 1: Burassi (9750 in chips)=20
Seat 2: anthonyblue1 (6715 in chips)=20
Seat 3: Harmn8r (3680 in chips)=20
Seat 4: gator856500 (10795 in chips)=20
Seat 6: JJin91 (11424 in chips)=20
Seat 7: RynerNJ (10955 in chips)=20
Seat 8: EmmaBrighton (14596 in chips)=20
Seat 9: SDVSF2290 (23540 in chips)=20
Burassi: posts the ante 15
anthonyblue1: posts the ante 15
Harmn8r: posts the ante 15
gator856500: posts the ante 15
JJin91: posts the ante 15
RynerNJ: posts the ante 15
EmmaBrighton: posts the ante 15
SDVSF2290: posts the ante 15
Harmn8r: posts small blind 60
gator856500: posts big blind 120
*** HOLE CARDS ***
Dealt to JJin91 [3c 8h]
JJin91: folds=20
RynerNJ: folds=20
EmmaBrighton: calls 120
SDVSF2290: folds=20
Burassi: folds=20
anthonyblue1: folds=20
Harmn8r: folds=20
gator856500: checks=20
*** FLOP *** [Js 7c As]
gator856500: bets 120
EmmaBrighton: folds=20
Uncalled bet (120) returned to gator856500
gator856500 collected 420 from pot
gator856500: doesn't show hand=20
*** SUMMARY ***
Total pot 420 | Rake 0=20
Board [Js 7c As]
Seat 1: Burassi folded before Flop (didn't bet)
Seat 2: anthonyblue1 (button) folded before Flop (didn't bet)
Seat 3: Harmn8r (small blind) folded before Flop
Seat 4: gator856500 (big blind) collected (420)
Seat 6: JJin91 folded before Flop (didn't bet)
Seat 7: RynerNJ folded before Flop (didn't bet)
Seat 8: EmmaBrighton folded on the Flop
Seat 9: SDVSF2290 folded before Flop (didn't bet)


*********** # 26 **************
PokerStars Hand #169556175548: Tournament #1597684117, $4.55+$0.45 USD =
Hold'em No Limit - Level V (60/120) - 2017/05/07 21:24:58 ET
Table '1597684117 5' 9-max Seat #3 is the button
Seat 1: Burassi (9735 in chips)=20
Seat 2: anthonyblue1 (6700 in chips)=20
Seat 3: Harmn8r (3605 in chips)=20
Seat 4: gator856500 (11080 in chips)=20
Seat 6: JJin91 (11409 in chips)=20
Seat 7: RynerNJ (10940 in chips)=20
Seat 8: EmmaBrighton (14461 in chips)=20
Seat 9: SDVSF2290 (23525 in chips)=20
Burassi: posts the ante 15
anthonyblue1: posts the ante 15
Harmn8r: posts the ante 15
gator856500: posts the ante 15
JJin91: posts the ante 15
RynerNJ: posts the ante 15
EmmaBrighton: posts the ante 15
SDVSF2290: posts the ante 15
gator856500: posts small blind 60
JJin91: posts big blind 120
*** HOLE CARDS ***
Dealt to JJin91 [Jc Jh]
RynerNJ: folds=20
EmmaBrighton: raises 420 to 540
SDVSF2290: calls 540
Burassi: folds=20
anthonyblue1: calls 540
Harmn8r: folds=20
gator856500: folds=20
JJin91: calls 420
*** FLOP *** [Tc Qh 4c]
JJin91: checks=20
EmmaBrighton: bets 13906 and is all-in
SDVSF2290: folds=20
anthonyblue1: folds=20
JJin91: folds=20
Uncalled bet (13906) returned to EmmaBrighton
EmmaBrighton collected 2340 from pot
EmmaBrighton: doesn't show hand=20
*** SUMMARY ***
Total pot 2340 | Rake 0=20
Board [Tc Qh 4c]
Seat 1: Burassi folded before Flop (didn't bet)
Seat 2: anthonyblue1 folded on the Flop
Seat 3: Harmn8r (button) folded before Flop (didn't bet)
Seat 4: gator856500 (small blind) folded before Flop
Seat 6: JJin91 (big blind) folded on the Flop
Seat 7: RynerNJ folded before Flop (didn't bet)
Seat 8: EmmaBrighton collected (2340)
Seat 9: SDVSF2290 folded on the Flop


*********** # 27 **************
PokerStars Hand #169556175816: Tournament #1597684117, $4.55+$0.45 USD =
Hold'em No Limit - Level VI (75/150) - 2017/05/07 21:25:43 ET
Table '1597684117 5' 9-max Seat #4 is the button
Seat 1: Burassi (9720 in chips)=20
Seat 2: anthonyblue1 (6145 in chips)=20
Seat 3: Harmn8r (3590 in chips)=20
Seat 4: gator856500 (11005 in chips)=20
Seat 6: JJin91 (10854 in chips)=20
Seat 7: RynerNJ (10925 in chips)=20
Seat 8: EmmaBrighton (16246 in chips)=20
Seat 9: SDVSF2290 (22970 in chips)=20
Burassi: posts the ante 20
anthonyblue1: posts the ante 20
Harmn8r: posts the ante 20
gator856500: posts the ante 20
JJin91: posts the ante 20
RynerNJ: posts the ante 20
EmmaBrighton: posts the ante 20
SDVSF2290: posts the ante 20
JJin91: posts small blind 75
RynerNJ: posts big blind 150
*** HOLE CARDS ***
Dealt to JJin91 [9s Qh]
EmmaBrighton: raises 300 to 450
SDVSF2290: folds=20
Burassi: folds=20
anthonyblue1: folds=20
Harmn8r: folds=20
gator856500: folds=20
JJin91: folds=20
RynerNJ: calls 300
*** FLOP *** [5h Ad 4d]
RynerNJ: checks=20
EmmaBrighton: bets 1135
RynerNJ: folds=20
Uncalled bet (1135) returned to EmmaBrighton
EmmaBrighton collected 1135 from pot
EmmaBrighton: doesn't show hand=20
*** SUMMARY ***
Total pot 1135 | Rake 0=20
Board [5h Ad 4d]
Seat 1: Burassi folded before Flop (didn't bet)
Seat 2: anthonyblue1 folded before Flop (didn't bet)
Seat 3: Harmn8r folded before Flop (didn't bet)
Seat 4: gator856500 (button) folded before Flop (didn't bet)
Seat 6: JJin91 (small blind) folded before Flop
Seat 7: RynerNJ (big blind) folded on the Flop
Seat 8: EmmaBrighton collected (1135)
Seat 9: SDVSF2290 folded before Flop (didn't bet)


*********** # 28 **************
PokerStars Hand #169556175993: Tournament #1597684117, $4.55+$0.45 USD =
Hold'em No Limit - Level VI (75/150) - 2017/05/07 21:26:14 ET
Table '1597684117 5' 9-max Seat #6 is the button
Seat 1: Burassi (9700 in chips)=20
Seat 2: anthonyblue1 (6125 in chips)=20
Seat 3: Harmn8r (3570 in chips)=20
Seat 4: gator856500 (10985 in chips)=20
Seat 6: JJin91 (10759 in chips)=20
Seat 7: RynerNJ (10455 in chips)=20
Seat 8: EmmaBrighton (16911 in chips)=20
Seat 9: SDVSF2290 (22950 in chips)=20
Burassi: posts the ante 20
anthonyblue1: posts the ante 20
Harmn8r: posts the ante 20
gator856500: posts the ante 20
JJin91: posts the ante 20
RynerNJ: posts the ante 20
EmmaBrighton: posts the ante 20
SDVSF2290: posts the ante 20
RynerNJ: posts small blind 75
EmmaBrighton: posts big blind 150
*** HOLE CARDS ***
Dealt to JJin91 [Qh 5h]
SDVSF2290: calls 150
Burassi: folds=20
anthonyblue1: raises 300 to 450
Harmn8r: folds=20
gator856500: folds=20
JJin91: folds=20
RynerNJ: calls 375
EmmaBrighton: calls 300
SDVSF2290: calls 300
*** FLOP *** [3d Ac 6c]
RynerNJ: checks=20
EmmaBrighton: checks=20
SDVSF2290: checks=20
anthonyblue1: bets 450
RynerNJ: raises 1200 to 1650
EmmaBrighton: folds=20
SDVSF2290: calls 1650
anthonyblue1: calls 1200
*** TURN *** [3d Ac 6c] [Kh]
RynerNJ: bets 8335 and is all-in
SDVSF2290: folds=20
anthonyblue1: calls 4005 and is all-in
Uncalled bet (4330) returned to RynerNJ
*** RIVER *** [3d Ac 6c Kh] [9d]
*** SHOW DOWN ***
RynerNJ: shows [3h 3s] (three of a kind, Threes)
anthonyblue1: shows [Ah Ad] (three of a kind, Aces)
anthonyblue1 collected 14920 from pot
*** SUMMARY ***
Total pot 14920 | Rake 0=20
Board [3d Ac 6c Kh 9d]
Seat 1: Burassi folded before Flop (didn't bet)
Seat 2: anthonyblue1 showed [Ah Ad] and won (14920) with three of a kin=
d, Aces
Seat 3: Harmn8r folded before Flop (didn't bet)
Seat 4: gator856500 folded before Flop (didn't bet)
Seat 6: JJin91 (button) folded before Flop (didn't bet)
Seat 7: RynerNJ (small blind) showed [3h 3s] and lost with three of a k=
ind, Threes
Seat 8: EmmaBrighton (big blind) folded on the Flop
Seat 9: SDVSF2290 folded on the Turn


*********** # 29 **************
PokerStars Hand #169556176508: Tournament #1597684117, $4.55+$0.45 USD =
Hold'em No Limit - Level VI (75/150) - 2017/05/07 21:27:46 ET
Table '1597684117 5' 9-max Seat #7 is the button
Seat 1: Burassi (9680 in chips)=20
Seat 2: anthonyblue1 (14920 in chips)=20
Seat 3: Harmn8r (3550 in chips)=20
Seat 4: gator856500 (10965 in chips)=20
Seat 6: JJin91 (10739 in chips)=20
Seat 7: RynerNJ (4330 in chips)=20
Seat 8: EmmaBrighton (16441 in chips)=20
Seat 9: SDVSF2290 (20830 in chips)=20
Burassi: posts the ante 20
anthonyblue1: posts the ante 20
Harmn8r: posts the ante 20
gator856500: posts the ante 20
JJin91: posts the ante 20
RynerNJ: posts the ante 20
EmmaBrighton: posts the ante 20
SDVSF2290: posts the ante 20
EmmaBrighton: posts small blind 75
SDVSF2290: posts big blind 150
*** HOLE CARDS ***
Dealt to JJin91 [Ad 4s]
Burassi: folds=20
anthonyblue1: folds=20
Harmn8r: folds=20
gator856500: folds=20
JJin91: folds=20
RynerNJ: folds=20
EmmaBrighton: raises 460 to 610
SDVSF2290: folds=20
Uncalled bet (460) returned to EmmaBrighton
EmmaBrighton collected 460 from pot
EmmaBrighton: doesn't show hand=20
*** SUMMARY ***
Total pot 460 | Rake 0=20
Seat 1: Burassi folded before Flop (didn't bet)
Seat 2: anthonyblue1 folded before Flop (didn't bet)
Seat 3: Harmn8r folded before Flop (didn't bet)
Seat 4: gator856500 folded before Flop (didn't bet)
Seat 6: JJin91 folded before Flop (didn't bet)
Seat 7: RynerNJ (button) folded before Flop (didn't bet)
Seat 8: EmmaBrighton (small blind) collected (460)
Seat 9: SDVSF2290 (big blind) folded before Flop


*********** # 30 **************
PokerStars Hand #169556176603: Tournament #1597684117, $4.55+$0.45 USD =
Hold'em No Limit - Level VI (75/150) - 2017/05/07 21:28:01 ET
Table '1597684117 5' 9-max Seat #8 is the button
Seat 1: Burassi (9660 in chips)=20
Seat 2: anthonyblue1 (14900 in chips)=20
Seat 3: Harmn8r (3530 in chips)=20
Seat 4: gator856500 (10945 in chips)=20
Seat 6: JJin91 (10719 in chips)=20
Seat 7: RynerNJ (4310 in chips)=20
Seat 8: EmmaBrighton (16731 in chips)=20
Seat 9: SDVSF2290 (20660 in chips)=20
Burassi: posts the ante 20
anthonyblue1: posts the ante 20
Harmn8r: posts the ante 20
gator856500: posts the ante 20
JJin91: posts the ante 20
RynerNJ: posts the ante 20
EmmaBrighton: posts the ante 20
SDVSF2290: posts the ante 20
SDVSF2290: posts small blind 75
Burassi: posts big blind 150
*** HOLE CARDS ***
Dealt to JJin91 [9s Kd]
anthonyblue1: folds=20
Harmn8r: folds=20
gator856500: calls 150
JJin91: folds=20
RynerNJ: folds=20
EmmaBrighton: calls 150
SDVSF2290: calls 75
Burassi: checks=20
*** FLOP *** [5s Qc Kc]
SDVSF2290: checks=20
Burassi: checks=20
gator856500: checks=20
EmmaBrighton: checks=20
*** TURN *** [5s Qc Kc] [Td]
SDVSF2290: checks=20
Burassi: checks=20
gator856500: checks=20
EmmaBrighton: bets 760
SDVSF2290: folds=20
Burassi: folds=20
gator856500: calls 760
*** RIVER *** [5s Qc Kc Td] [3s]
gator856500: checks=20
EmmaBrighton: checks=20
*** SHOW DOWN ***
gator856500: shows [Ts Ad] (a pair of Tens)
EmmaBrighton: mucks hand=20
gator856500 collected 2280 from pot
*** SUMMARY ***
Total pot 2280 | Rake 0=20
Board [5s Qc Kc Td 3s]
Seat 1: Burassi (big blind) folded on the Turn
Seat 2: anthonyblue1 folded before Flop (didn't bet)
Seat 3: Harmn8r folded before Flop (didn't bet)
Seat 4: gator856500 showed [Ts Ad] and won (2280) with a pair of Tens
Seat 6: JJin91 folded before Flop (didn't bet)
Seat 7: RynerNJ folded before Flop (didn't bet)
Seat 8: EmmaBrighton (button) mucked [7s Jc]
Seat 9: SDVSF2290 (small blind) folded on the Turn


*********** # 31 **************
PokerStars Hand #169556177107: Tournament #1597684117, $4.55+$0.45 USD =
Hold'em No Limit - Level VI (75/150) - 2017/05/07 21:29:30 ET
Table '1597684117 5' 9-max Seat #9 is the button
Seat 1: Burassi (9490 in chips)=20
Seat 2: anthonyblue1 (14880 in chips)=20
Seat 3: Harmn8r (3510 in chips)=20
Seat 4: gator856500 (12295 in chips)=20
Seat 5: BGOLD1 (10000 in chips)=20
Seat 6: JJin91 (10699 in chips)=20
Seat 7: RynerNJ (4290 in chips)=20
Seat 8: EmmaBrighton (15801 in chips)=20
Seat 9: SDVSF2290 (20490 in chips)=20
Burassi: posts the ante 20
anthonyblue1: posts the ante 20
Harmn8r: posts the ante 20
gator856500: posts the ante 20
BGOLD1: posts the ante 20
JJin91: posts the ante 20
RynerNJ: posts the ante 20
EmmaBrighton: posts the ante 20
SDVSF2290: posts the ante 20
Burassi: posts small blind 75
anthonyblue1: posts big blind 150
*** HOLE CARDS ***
Dealt to JJin91 [5c 3d]
Harmn8r: folds=20
gator856500: folds=20
BGOLD1: folds=20
JJin91: folds=20
RynerNJ: raises 225 to 375
EmmaBrighton: calls 375
SDVSF2290: calls 375
Burassi: folds=20
anthonyblue1: folds=20
*** FLOP *** [3h 3s Ts]
RynerNJ: bets 620
EmmaBrighton: folds=20
SDVSF2290: raises 2770 to 3390
RynerNJ: raises 505 to 3895 and is all-in
SDVSF2290: calls 505
*** TURN *** [3h 3s Ts] [2c]
*** RIVER *** [3h 3s Ts 2c] [Ac]
*** SHOW DOWN ***
RynerNJ: shows [Js As] (two pair, Aces and Threes)
SDVSF2290: shows [6s 6d] (two pair, Sixes and Threes)
RynerNJ collected 9320 from pot
*** SUMMARY ***
Total pot 9320 | Rake 0=20
Board [3h 3s Ts 2c Ac]
Seat 1: Burassi (small blind) folded before Flop
Seat 2: anthonyblue1 (big blind) folded before Flop
Seat 3: Harmn8r folded before Flop (didn't bet)
Seat 4: gator856500 folded before Flop (didn't bet)
Seat 5: BGOLD1 folded before Flop (didn't bet)
Seat 6: JJin91 folded before Flop (didn't bet)
Seat 7: RynerNJ showed [Js As] and won (9320) with two pair, Aces and T=
hrees
Seat 8: EmmaBrighton folded on the Flop
Seat 9: SDVSF2290 (button) showed [6s 6d] and lost with two pair, Sixes=
 and Threes


*********** # 32 **************
PokerStars Hand #169556177443: Tournament #1597684117, $4.55+$0.45 USD =
Hold'em No Limit - Level VII (100/200) - 2017/05/07 21:30:34 ET
Table '1597684117 5' 9-max Seat #1 is the button
Seat 1: Burassi (9395 in chips)=20
Seat 2: anthonyblue1 (14710 in chips)=20
Seat 3: Harmn8r (3490 in chips)=20
Seat 4: gator856500 (12275 in chips)=20
Seat 5: BGOLD1 (9980 in chips)=20
Seat 6: JJin91 (10679 in chips)=20
Seat 7: RynerNJ (9320 in chips)=20
Seat 8: EmmaBrighton (15406 in chips)=20
Seat 9: SDVSF2290 (16200 in chips)=20
Burassi: posts the ante 25
anthonyblue1: posts the ante 25
Harmn8r: posts the ante 25
gator856500: posts the ante 25
BGOLD1: posts the ante 25
JJin91: posts the ante 25
RynerNJ: posts the ante 25
EmmaBrighton: posts the ante 25
SDVSF2290: posts the ante 25
anthonyblue1: posts small blind 100
Harmn8r: posts big blind 200
*** HOLE CARDS ***
Dealt to JJin91 [5c 6c]
gator856500: folds=20
BGOLD1: raises 200 to 400
JJin91: folds=20
RynerNJ: folds=20
EmmaBrighton: folds=20
SDVSF2290: raises 200 to 600
Burassi: folds=20
anthonyblue1: folds=20
Harmn8r: folds=20
BGOLD1: calls 200
*** FLOP *** [Ac 5d 4d]
BGOLD1: bets 863
SDVSF2290: raises 1726 to 2589
BGOLD1: raises 6766 to 9355 and is all-in
SDVSF2290: folds=20
Uncalled bet (6766) returned to BGOLD1
BGOLD1 collected 6903 from pot
*** SUMMARY ***
Total pot 6903 | Rake 0=20
Board [Ac 5d 4d]
Seat 1: Burassi (button) folded before Flop (didn't bet)
Seat 2: anthonyblue1 (small blind) folded before Flop
Seat 3: Harmn8r (big blind) folded before Flop
Seat 4: gator856500 folded before Flop (didn't bet)
Seat 5: BGOLD1 collected (6903)
Seat 6: JJin91 folded before Flop (didn't bet)
Seat 7: RynerNJ folded before Flop (didn't bet)
Seat 8: EmmaBrighton folded before Flop (didn't bet)
Seat 9: SDVSF2290 folded on the Flop


*********** # 33 **************
PokerStars Hand #169556177748: Tournament #1597684117, $4.55+$0.45 USD =
Hold'em No Limit - Level VII (100/200) - 2017/05/07 21:31:24 ET
Table '1597684117 5' 9-max Seat #2 is the button
Seat 1: Burassi (9370 in chips)=20
Seat 2: anthonyblue1 (14585 in chips)=20
Seat 3: Harmn8r (3265 in chips)=20
Seat 4: gator856500 (12250 in chips)=20
Seat 5: BGOLD1 (13669 in chips)=20
Seat 6: JJin91 (10654 in chips)=20
Seat 7: RynerNJ (9295 in chips)=20
Seat 8: EmmaBrighton (15381 in chips)=20
Seat 9: SDVSF2290 (12986 in chips)=20
Burassi: posts the ante 25
anthonyblue1: posts the ante 25
Harmn8r: posts the ante 25
gator856500: posts the ante 25
BGOLD1: posts the ante 25
JJin91: posts the ante 25
RynerNJ: posts the ante 25
EmmaBrighton: posts the ante 25
SDVSF2290: posts the ante 25
Harmn8r: posts small blind 100
gator856500: posts big blind 200
*** HOLE CARDS ***
Dealt to JJin91 [Ad Qc]
BGOLD1: calls 200
JJin91: raises 600 to 800
RynerNJ: folds=20
EmmaBrighton: calls 800
SDVSF2290: folds=20
Burassi: folds=20
anthonyblue1: raises 600 to 1400
Harmn8r: folds=20
gator856500: folds=20
BGOLD1: folds=20
JJin91: calls 600
EmmaBrighton: calls 600
*** FLOP *** [8d Jd Ks]
JJin91: checks=20
EmmaBrighton: checks=20
anthonyblue1: bets 1400
JJin91: calls 1400
EmmaBrighton: folds=20
*** TURN *** [8d Jd Ks] [Qs]
JJin91: checks=20
anthonyblue1: checks=20
*** RIVER *** [8d Jd Ks Qs] [7s]
JJin91: checks=20
anthonyblue1: bets 3800
JJin91: calls 3800
*** SHOW DOWN ***
anthonyblue1: shows [Ah Ac] (a pair of Aces)
JJin91: mucks hand=20
anthonyblue1 collected 15325 from pot
*** SUMMARY ***
Total pot 15325 | Rake 0=20
Board [8d Jd Ks Qs 7s]
Seat 1: Burassi folded before Flop (didn't bet)
Seat 2: anthonyblue1 (button) showed [Ah Ac] and won (15325) with a pai=
r of Aces
Seat 3: Harmn8r (small blind) folded before Flop
Seat 4: gator856500 (big blind) folded before Flop
Seat 5: BGOLD1 folded before Flop
Seat 6: JJin91 mucked [Ad Qc]
Seat 7: RynerNJ folded before Flop (didn't bet)
Seat 8: EmmaBrighton folded on the Flop
Seat 9: SDVSF2290 folded before Flop (didn't bet)


*********** # 34 **************
PokerStars Hand #169556178250: Tournament #1597684117, $4.55+$0.45 USD =
Hold'em No Limit - Level VII (100/200) - 2017/05/07 21:32:53 ET
Table '1597684117 5' 9-max Seat #3 is the button
Seat 2: anthonyblue1 (23285 in chips)=20
Seat 3: Harmn8r (3140 in chips)=20
Seat 4: gator856500 (12025 in chips)=20
Seat 5: BGOLD1 (13444 in chips)=20
Seat 6: JJin91 (4029 in chips)=20
Seat 7: RynerNJ (9270 in chips)=20
Seat 8: EmmaBrighton (13956 in chips)=20
Seat 9: SDVSF2290 (12961 in chips)=20
anthonyblue1: posts the ante 25
Harmn8r: posts the ante 25
gator856500: posts the ante 25
BGOLD1: posts the ante 25
JJin91: posts the ante 25
RynerNJ: posts the ante 25
EmmaBrighton: posts the ante 25
SDVSF2290: posts the ante 25
gator856500: posts small blind 100
BGOLD1: posts big blind 200
*** HOLE CARDS ***
Dealt to JJin91 [6h Qc]
JJin91: folds=20
RynerNJ: folds=20
EmmaBrighton: raises 1000 to 1200
SDVSF2290: folds=20
anthonyblue1: folds=20
Harmn8r: folds=20
gator856500: folds=20
BGOLD1: folds=20
Uncalled bet (1000) returned to EmmaBrighton
EmmaBrighton collected 700 from pot
EmmaBrighton: doesn't show hand=20
*** SUMMARY ***
Total pot 700 | Rake 0=20
Seat 2: anthonyblue1 folded before Flop (didn't bet)
Seat 3: Harmn8r (button) folded before Flop (didn't bet)
Seat 4: gator856500 (small blind) folded before Flop
Seat 5: BGOLD1 (big blind) folded before Flop
Seat 6: JJin91 folded before Flop (didn't bet)
Seat 7: RynerNJ folded before Flop (didn't bet)
Seat 8: EmmaBrighton collected (700)
Seat 9: SDVSF2290 folded before Flop (didn't bet)


*********** # 35 **************
PokerStars Hand #169556178375: Tournament #1597684117, $4.55+$0.45 USD =
Hold'em No Limit - Level VII (100/200) - 2017/05/07 21:33:12 ET
Table '1597684117 5' 9-max Seat #4 is the button
Seat 2: anthonyblue1 (23260 in chips)=20
Seat 3: Harmn8r (3115 in chips)=20
Seat 4: gator856500 (11900 in chips)=20
Seat 5: BGOLD1 (13219 in chips)=20
Seat 6: JJin91 (4004 in chips)=20
Seat 7: RynerNJ (9245 in chips)=20
Seat 8: EmmaBrighton (14431 in chips)=20
Seat 9: SDVSF2290 (12936 in chips)=20
anthonyblue1: posts the ante 25
Harmn8r: posts the ante 25
gator856500: posts the ante 25
BGOLD1: posts the ante 25
JJin91: posts the ante 25
RynerNJ: posts the ante 25
EmmaBrighton: posts the ante 25
SDVSF2290: posts the ante 25
BGOLD1: posts small blind 100
JJin91: posts big blind 200
*** HOLE CARDS ***
Dealt to JJin91 [Tc Kh]
RynerNJ: folds=20
EmmaBrighton: folds=20
SDVSF2290: calls 200
anthonyblue1: folds=20
Harmn8r: raises 600 to 800
gator856500: calls 800
BGOLD1: folds=20
JJin91: raises 3179 to 3979 and is all-in
SDVSF2290: folds=20
Harmn8r: calls 2290 and is all-in
gator856500: folds=20
Uncalled bet (889) returned to JJin91
*** FLOP *** [Kd 7h 4c]
*** TURN *** [Kd 7h 4c] [5c]
*** RIVER *** [Kd 7h 4c 5c] [7d]
*** SHOW DOWN ***
JJin91: shows [Tc Kh] (two pair, Kings and Sevens)
Harmn8r: shows [9d 9h] (two pair, Nines and Sevens)
JJin91 collected 7480 from pot
Harmn8r finished the tournament in 89th place
*** SUMMARY ***
Total pot 7480 | Rake 0=20
Board [Kd 7h 4c 5c 7d]
Seat 2: anthonyblue1 folded before Flop (didn't bet)
Seat 3: Harmn8r showed [9d 9h] and lost with two pair, Nines and Sevens
Seat 4: gator856500 (button) folded before Flop
Seat 5: BGOLD1 (small blind) folded before Flop
Seat 6: JJin91 (big blind) showed [Tc Kh] and won (7480) with two pair,=
 Kings and Sevens
Seat 7: RynerNJ folded before Flop (didn't bet)
Seat 8: EmmaBrighton folded before Flop (didn't bet)
Seat 9: SDVSF2290 folded before Flop


*********** # 36 **************
PokerStars Hand #169556178619: Tournament #1597684117, $4.55+$0.45 USD =
Hold'em No Limit - Level VII (100/200) - 2017/05/07 21:33:53 ET
Table '1597684117 5' 9-max Seat #5 is the button
Seat 2: anthonyblue1 (23235 in chips)=20
Seat 4: gator856500 (11075 in chips)=20
Seat 5: BGOLD1 (13094 in chips)=20
Seat 6: JJin91 (8369 in chips)=20
Seat 7: RynerNJ (9220 in chips)=20
Seat 8: EmmaBrighton (14406 in chips)=20
Seat 9: SDVSF2290 (12711 in chips)=20
anthonyblue1: posts the ante 25
gator856500: posts the ante 25
BGOLD1: posts the ante 25
JJin91: posts the ante 25
RynerNJ: posts the ante 25
EmmaBrighton: posts the ante 25
SDVSF2290: posts the ante 25
JJin91: posts small blind 100
RynerNJ: posts big blind 200
*** HOLE CARDS ***
Dealt to JJin91 [Kd 3h]
EmmaBrighton: folds=20
SDVSF2290: raises 200 to 400
anthonyblue1: folds=20
gator856500: calls 400
BGOLD1: folds=20
JJin91: folds=20
RynerNJ: folds=20
*** FLOP *** [Ks 6h 4h]
SDVSF2290: bets 638
gator856500: calls 638
*** TURN *** [Ks 6h 4h] [4c]
SDVSF2290: bets 2551
gator856500: folds=20
Uncalled bet (2551) returned to SDVSF2290
SDVSF2290 collected 2551 from pot
SDVSF2290: doesn't show hand=20
*** SUMMARY ***
Total pot 2551 | Rake 0=20
Board [Ks 6h 4h 4c]
Seat 2: anthonyblue1 folded before Flop (didn't bet)
Seat 4: gator856500 folded on the Turn
Seat 5: BGOLD1 (button) folded before Flop (didn't bet)
Seat 6: JJin91 (small blind) folded before Flop
Seat 7: RynerNJ (big blind) folded before Flop
Seat 8: EmmaBrighton folded before Flop (didn't bet)
Seat 9: SDVSF2290 collected (2551)


*********** # 37 **************
PokerStars Hand #169556178835: Tournament #1597684117, $4.55+$0.45 USD =
Hold'em No Limit - Level VII (100/200) - 2017/05/07 21:34:29 ET
Table '1597684117 5' 9-max Seat #6 is the button
Seat 2: anthonyblue1 (23210 in chips)=20
Seat 3: marknj68 (10000 in chips)=20
Seat 4: gator856500 (10012 in chips)=20
Seat 5: BGOLD1 (13069 in chips)=20
Seat 6: JJin91 (8244 in chips)=20
Seat 7: RynerNJ (8995 in chips)=20
Seat 8: EmmaBrighton (14381 in chips)=20
Seat 9: SDVSF2290 (14199 in chips)=20
anthonyblue1: posts the ante 25
marknj68: posts the ante 25
gator856500: posts the ante 25
BGOLD1: posts the ante 25
JJin91: posts the ante 25
RynerNJ: posts the ante 25
EmmaBrighton: posts the ante 25
SDVSF2290: posts the ante 25
RynerNJ: posts small blind 100
EmmaBrighton: posts big blind 200
*** HOLE CARDS ***
Dealt to JJin91 [6d 2c]
SDVSF2290: folds=20
anthonyblue1: folds=20
marknj68: folds=20
gator856500: folds=20
BGOLD1: folds=20
JJin91: folds=20
RynerNJ: calls 100
EmmaBrighton: checks=20
*** FLOP *** [4d 4c 8s]
RynerNJ: checks=20
EmmaBrighton: checks=20
*** TURN *** [4d 4c 8s] [5h]
RynerNJ: checks=20
EmmaBrighton: bets 200
RynerNJ: calls 200
*** RIVER *** [4d 4c 8s 5h] [Jc]
RynerNJ: checks=20
EmmaBrighton: bets 13956 and is all-in
RynerNJ: folds=20
Uncalled bet (13956) returned to EmmaBrighton
EmmaBrighton collected 1000 from pot
EmmaBrighton: doesn't show hand=20
*** SUMMARY ***
Total pot 1000 | Rake 0=20
Board [4d 4c 8s 5h Jc]
Seat 2: anthonyblue1 folded before Flop (didn't bet)
Seat 3: marknj68 folded before Flop (didn't bet)
Seat 4: gator856500 folded before Flop (didn't bet)
Seat 5: BGOLD1 folded before Flop (didn't bet)
Seat 6: JJin91 (button) folded before Flop (didn't bet)
Seat 7: RynerNJ (small blind) folded on the River
Seat 8: EmmaBrighton (big blind) collected (1000)
Seat 9: SDVSF2290 folded before Flop (didn't bet)


*********** # 38 **************
PokerStars Hand #169556179028: Tournament #1597684117, $4.55+$0.45 USD =
Hold'em No Limit - Level VII (100/200) - 2017/05/07 21:35:02 ET
Table '1597684117 5' 9-max Seat #7 is the button
Seat 2: anthonyblue1 (23185 in chips)=20
Seat 3: marknj68 (9975 in chips)=20
Seat 4: gator856500 (9987 in chips)=20
Seat 5: BGOLD1 (13044 in chips)=20
Seat 6: JJin91 (8219 in chips)=20
Seat 7: RynerNJ (8570 in chips)=20
Seat 8: EmmaBrighton (14956 in chips)=20
Seat 9: SDVSF2290 (14174 in chips)=20
anthonyblue1: posts the ante 25
marknj68: posts the ante 25
gator856500: posts the ante 25
BGOLD1: posts the ante 25
JJin91: posts the ante 25
RynerNJ: posts the ante 25
EmmaBrighton: posts the ante 25
SDVSF2290: posts the ante 25
EmmaBrighton: posts small blind 100
SDVSF2290: posts big blind 200
*** HOLE CARDS ***
Dealt to JJin91 [3h 9d]
anthonyblue1: folds=20
marknj68: folds=20
gator856500: folds=20
BGOLD1: calls 200
JJin91: folds=20
RynerNJ: folds=20
EmmaBrighton: calls 100
SDVSF2290: checks=20
*** FLOP *** [2h 8c Ts]
EmmaBrighton: checks=20
SDVSF2290: checks=20
BGOLD1: bets 400
EmmaBrighton: folds=20
SDVSF2290: folds=20
Uncalled bet (400) returned to BGOLD1
BGOLD1 collected 800 from pot
*** SUMMARY ***
Total pot 800 | Rake 0=20
Board [2h 8c Ts]
Seat 2: anthonyblue1 folded before Flop (didn't bet)
Seat 3: marknj68 folded before Flop (didn't bet)
Seat 4: gator856500 folded before Flop (didn't bet)
Seat 5: BGOLD1 collected (800)
Seat 6: JJin91 folded before Flop (didn't bet)
Seat 7: RynerNJ (button) folded before Flop (didn't bet)
Seat 8: EmmaBrighton (small blind) folded on the Flop
Seat 9: SDVSF2290 (big blind) folded on the Flop


*********** # 39 **************
PokerStars Hand #169556179231: Tournament #1597684117, $4.55+$0.45 USD =
Hold'em No Limit - Level VIII (125/250) - 2017/05/07 21:35:38 ET
Table '1597684117 5' 9-max Seat #8 is the button
Seat 2: anthonyblue1 (23160 in chips)=20
Seat 3: marknj68 (9950 in chips)=20
Seat 4: gator856500 (9962 in chips)=20
Seat 5: BGOLD1 (13619 in chips)=20
Seat 6: JJin91 (8194 in chips)=20
Seat 7: RynerNJ (8545 in chips)=20
Seat 8: EmmaBrighton (14731 in chips)=20
Seat 9: SDVSF2290 (13949 in chips)=20
anthonyblue1: posts the ante 30
marknj68: posts the ante 30
gator856500: posts the ante 30
BGOLD1: posts the ante 30
JJin91: posts the ante 30
RynerNJ: posts the ante 30
EmmaBrighton: posts the ante 30
SDVSF2290: posts the ante 30
SDVSF2290: posts small blind 125
anthonyblue1: posts big blind 250
*** HOLE CARDS ***
Dealt to JJin91 [Qc Kc]
marknj68: folds=20
gator856500: folds=20
BGOLD1: folds=20
JJin91: raises 297 to 547
RynerNJ: folds=20
EmmaBrighton: calls 547
SDVSF2290: folds=20
anthonyblue1: folds=20
*** FLOP *** [5h 4d Jh]
JJin91: bets 906
EmmaBrighton: folds=20
Uncalled bet (906) returned to JJin91
JJin91 collected 1709 from pot
JJin91: doesn't show hand=20
*** SUMMARY ***
Total pot 1709 | Rake 0=20
Board [5h 4d Jh]
Seat 2: anthonyblue1 (big blind) folded before Flop
Seat 3: marknj68 folded before Flop (didn't bet)
Seat 4: gator856500 folded before Flop (didn't bet)
Seat 5: BGOLD1 folded before Flop (didn't bet)
Seat 6: JJin91 collected (1709)
Seat 7: RynerNJ folded before Flop (didn't bet)
Seat 8: EmmaBrighton (button) folded on the Flop
Seat 9: SDVSF2290 (small blind) folded before Flop


*********** # 40 **************
PokerStars Hand #169556179405: Tournament #1597684117, $4.55+$0.45 USD =
Hold'em No Limit - Level VIII (125/250) - 2017/05/07 21:36:07 ET
Table '1597684117 5' 9-max Seat #9 is the button
Seat 2: anthonyblue1 (22880 in chips)=20
Seat 3: marknj68 (9920 in chips)=20
Seat 4: gator856500 (9932 in chips)=20
Seat 5: BGOLD1 (13589 in chips)=20
Seat 6: JJin91 (9326 in chips)=20
Seat 7: RynerNJ (8515 in chips)=20
Seat 8: EmmaBrighton (14154 in chips)=20
Seat 9: SDVSF2290 (13794 in chips)=20
anthonyblue1: posts the ante 30
marknj68: posts the ante 30
gator856500: posts the ante 30
BGOLD1: posts the ante 30
JJin91: posts the ante 30
RynerNJ: posts the ante 30
EmmaBrighton: posts the ante 30
SDVSF2290: posts the ante 30
anthonyblue1: posts small blind 125
marknj68: posts big blind 250
*** HOLE CARDS ***
Dealt to JJin91 [7d Ac]
gator856500: calls 250
BGOLD1: folds=20
JJin91: folds=20
RynerNJ: folds=20
EmmaBrighton: calls 250
SDVSF2290: raises 250 to 500
anthonyblue1: calls 375
marknj68: calls 250
gator856500: calls 250
EmmaBrighton: calls 250
*** FLOP *** [Js 3c 5c]
anthonyblue1: checks=20
marknj68: checks=20
gator856500: checks=20
EmmaBrighton: checks=20
SDVSF2290: bets 2740
anthonyblue1 has timed out while being disconnected
anthonyblue1: folds=20
anthonyblue1 is sitting out
marknj68: folds=20
anthonyblue1 has returned
gator856500: raises 6662 to 9402 and is all-in
EmmaBrighton: folds=20
SDVSF2290: folds=20
Uncalled bet (6662) returned to gator856500
gator856500 collected 8220 from pot
gator856500: doesn't show hand=20
*** SUMMARY ***
Total pot 8220 | Rake 0=20
Board [Js 3c 5c]
Seat 2: anthonyblue1 (small blind) folded on the Flop
Seat 3: marknj68 (big blind) folded on the Flop
Seat 4: gator856500 collected (8220)
Seat 5: BGOLD1 folded before Flop (didn't bet)
Seat 6: JJin91 folded before Flop (didn't bet)
Seat 7: RynerNJ folded before Flop (didn't bet)
Seat 8: EmmaBrighton folded on the Flop
Seat 9: SDVSF2290 (button) folded on the Flop


*********** # 41 **************
PokerStars Hand #169556179909: Tournament #1597684117, $4.55+$0.45 USD =
Hold'em No Limit - Level VIII (125/250) - 2017/05/07 21:37:27 ET
Table '1597684117 5' 9-max Seat #2 is the button
Seat 2: anthonyblue1 (22350 in chips)=20
Seat 3: marknj68 (9390 in chips)=20
Seat 4: gator856500 (14882 in chips)=20
Seat 5: BGOLD1 (13559 in chips)=20
Seat 6: JJin91 (9296 in chips)=20
Seat 7: RynerNJ (8485 in chips)=20
Seat 8: EmmaBrighton (13624 in chips)=20
Seat 9: SDVSF2290 (10524 in chips)=20
anthonyblue1: posts the ante 30
marknj68: posts the ante 30
gator856500: posts the ante 30
BGOLD1: posts the ante 30
JJin91: posts the ante 30
RynerNJ: posts the ante 30
EmmaBrighton: posts the ante 30
SDVSF2290: posts the ante 30
marknj68: posts small blind 125
gator856500: posts big blind 250
*** HOLE CARDS ***
Dealt to JJin91 [4h 5s]
BGOLD1: raises 250 to 500
JJin91: folds=20
RynerNJ: folds=20
EmmaBrighton: calls 500
SDVSF2290: folds=20
anthonyblue1: folds=20
marknj68: calls 375
gator856500: calls 250
*** FLOP *** [6h 6c 5d]
marknj68: checks=20
gator856500: checks=20
BGOLD1: bets 500
EmmaBrighton: calls 500
marknj68: folds=20
gator856500: folds=20
*** TURN *** [6h 6c 5d] [Kc]
BGOLD1: bets 500
EmmaBrighton: calls 500
*** RIVER *** [6h 6c 5d Kc] [Tc]
BGOLD1: checks=20
EmmaBrighton: bets 12094 and is all-in
BGOLD1: folds=20
Uncalled bet (12094) returned to EmmaBrighton
EmmaBrighton collected 4240 from pot
EmmaBrighton: doesn't show hand=20
*** SUMMARY ***
Total pot 4240 | Rake 0=20
Board [6h 6c 5d Kc Tc]
Seat 2: anthonyblue1 (button) folded before Flop (didn't bet)
Seat 3: marknj68 (small blind) folded on the Flop
Seat 4: gator856500 (big blind) folded on the Flop
Seat 5: BGOLD1 folded on the River
Seat 6: JJin91 folded before Flop (didn't bet)
Seat 7: RynerNJ folded before Flop (didn't bet)
Seat 8: EmmaBrighton collected (4240)
Seat 9: SDVSF2290 folded before Flop (didn't bet)


*********** # 42 **************
PokerStars Hand #169558462643: Tournament #1597684117, $4.55+$0.45 USD =
Hold'em No Limit - Level VIII (125/250) - 2017/05/07 21:38:40 ET
Table '1597684117 5' 9-max Seat #3 is the button
Seat 2: anthonyblue1 (22320 in chips)=20
Seat 3: marknj68 (8860 in chips)=20
Seat 4: gator856500 (14352 in chips)=20
Seat 5: BGOLD1 (12029 in chips)=20
Seat 6: JJin91 (9266 in chips)=20
Seat 7: RynerNJ (8455 in chips)=20
Seat 8: EmmaBrighton (16334 in chips)=20
Seat 9: SDVSF2290 (10494 in chips)=20
anthonyblue1: posts the ante 30
marknj68: posts the ante 30
gator856500: posts the ante 30
BGOLD1: posts the ante 30
JJin91: posts the ante 30
RynerNJ: posts the ante 30
EmmaBrighton: posts the ante 30
SDVSF2290: posts the ante 30
gator856500: posts small blind 125
BGOLD1: posts big blind 250
*** HOLE CARDS ***
Dealt to JJin91 [Jc 6d]
JJin91: folds=20
RynerNJ: folds=20
EmmaBrighton: calls 250
SDVSF2290: raises 500 to 750
anthonyblue1: folds=20
marknj68: folds=20
gator856500: folds=20
BGOLD1: folds=20
EmmaBrighton: calls 500
*** FLOP *** [8h 3s Ah]
EmmaBrighton: bets 2115
SDVSF2290: raises 2115 to 4230
EmmaBrighton: calls 2115
*** TURN *** [8h 3s Ah] [5h]
EmmaBrighton: bets 11324 and is all-in
SDVSF2290: calls 5484 and is all-in
Uncalled bet (5840) returned to EmmaBrighton
*** RIVER *** [8h 3s Ah 5h] [Kc]
*** SHOW DOWN ***
EmmaBrighton: shows [7h 8d] (a pair of Eights)
SDVSF2290: shows [Ts Ac] (a pair of Aces)
SDVSF2290 collected 21543 from pot
*** SUMMARY ***
Total pot 21543 | Rake 0=20
Board [8h 3s Ah 5h Kc]
Seat 2: anthonyblue1 folded before Flop (didn't bet)
Seat 3: marknj68 (button) folded before Flop (didn't bet)
Seat 4: gator856500 (small blind) folded before Flop
Seat 5: BGOLD1 (big blind) folded before Flop
Seat 6: JJin91 folded before Flop (didn't bet)
Seat 7: RynerNJ folded before Flop (didn't bet)
Seat 8: EmmaBrighton showed [7h 8d] and lost with a pair of Eights
Seat 9: SDVSF2290 showed [Ts Ac] and won (21543) with a pair of Aces


*********** # 43 **************
PokerStars Hand #169558462908: Tournament #1597684117, $4.55+$0.45 USD =
Hold'em No Limit - Level VIII (125/250) - 2017/05/07 21:39:26 ET
Table '1597684117 5' 9-max Seat #4 is the button
Seat 2: anthonyblue1 (22290 in chips)=20
Seat 3: marknj68 (8830 in chips)=20
Seat 4: gator856500 (14197 in chips)=20
Seat 5: BGOLD1 (11749 in chips)=20
Seat 6: JJin91 (9236 in chips)=20
Seat 7: RynerNJ (8425 in chips)=20
Seat 8: EmmaBrighton (5840 in chips)=20
Seat 9: SDVSF2290 (21543 in chips)=20
anthonyblue1: posts the ante 30
marknj68: posts the ante 30
gator856500: posts the ante 30
BGOLD1: posts the ante 30
JJin91: posts the ante 30
RynerNJ: posts the ante 30
EmmaBrighton: posts the ante 30
SDVSF2290: posts the ante 30
BGOLD1: posts small blind 125
JJin91: posts big blind 250
*** HOLE CARDS ***
Dealt to JJin91 [3h 9c]
RynerNJ: folds=20
EmmaBrighton: raises 865 to 1115
SDVSF2290: folds=20
anthonyblue1: folds=20
marknj68: folds=20
gator856500: folds=20
BGOLD1: folds=20
JJin91: folds=20
Uncalled bet (865) returned to EmmaBrighton
EmmaBrighton collected 865 from pot
EmmaBrighton: doesn't show hand=20
*** SUMMARY ***
Total pot 865 | Rake 0=20
Seat 2: anthonyblue1 folded before Flop (didn't bet)
Seat 3: marknj68 folded before Flop (didn't bet)
Seat 4: gator856500 (button) folded before Flop (didn't bet)
Seat 5: BGOLD1 (small blind) folded before Flop
Seat 6: JJin91 (big blind) folded before Flop
Seat 7: RynerNJ folded before Flop (didn't bet)
Seat 8: EmmaBrighton collected (865)
Seat 9: SDVSF2290 folded before Flop (didn't bet)


*********** # 44 **************
PokerStars Hand #169558463024: Tournament #1597684117, $4.55+$0.45 USD =
Hold'em No Limit - Level VIII (125/250) - 2017/05/07 21:39:46 ET
Table '1597684117 5' 9-max Seat #5 is the button
Seat 2: anthonyblue1 (22260 in chips)=20
Seat 3: marknj68 (8800 in chips)=20
Seat 4: gator856500 (14167 in chips)=20
Seat 5: BGOLD1 (11594 in chips)=20
Seat 6: JJin91 (8956 in chips)=20
Seat 7: RynerNJ (8395 in chips)=20
Seat 8: EmmaBrighton (6425 in chips)=20
Seat 9: SDVSF2290 (21513 in chips)=20
anthonyblue1: posts the ante 30
marknj68: posts the ante 30
gator856500: posts the ante 30
BGOLD1: posts the ante 30
JJin91: posts the ante 30
RynerNJ: posts the ante 30
EmmaBrighton: posts the ante 30
SDVSF2290: posts the ante 30
JJin91: posts small blind 125
RynerNJ: posts big blind 250
*** HOLE CARDS ***
Dealt to JJin91 [Qh Ad]
EmmaBrighton: folds=20
SDVSF2290: calls 250
anthonyblue1: folds=20
marknj68: folds=20
gator856500: folds=20
BGOLD1: folds=20
JJin91: calls 125
RynerNJ: checks=20
*** FLOP *** [8s 4h Jh]
JJin91: checks=20
RynerNJ: checks=20
SDVSF2290: checks=20
*** TURN *** [8s 4h Jh] [Jc]
JJin91: checks=20
RynerNJ: checks=20
SDVSF2290: checks=20
*** RIVER *** [8s 4h Jh Jc] [4d]
JJin91: checks=20
RynerNJ: checks=20
SDVSF2290: bets 990
JJin91: calls 990
RynerNJ: folds=20
*** SHOW DOWN ***
SDVSF2290: shows [Tc 7d] (two pair, Jacks and Fours)
JJin91: shows [Qh Ad] (two pair, Jacks and Fours - Ace kicker)
JJin91 collected 2970 from pot
*** SUMMARY ***
Total pot 2970 | Rake 0=20
Board [8s 4h Jh Jc 4d]
Seat 2: anthonyblue1 folded before Flop (didn't bet)
Seat 3: marknj68 folded before Flop (didn't bet)
Seat 4: gator856500 folded before Flop (didn't bet)
Seat 5: BGOLD1 (button) folded before Flop (didn't bet)
Seat 6: JJin91 (small blind) showed [Qh Ad] and won (2970) with two pai=
r, Jacks and Fours
Seat 7: RynerNJ (big blind) folded on the River
Seat 8: EmmaBrighton folded before Flop (didn't bet)
Seat 9: SDVSF2290 showed [Tc 7d] and lost with two pair, Jacks and Fours


*********** # 45 **************
PokerStars Hand #169558463440: Tournament #1597684117, $4.55+$0.45 USD =
Hold'em No Limit - Level IX (150/300) - 2017/05/07 21:40:55 ET
Table '1597684117 5' 9-max Seat #6 is the button
Seat 2: anthonyblue1 (22230 in chips)=20
Seat 3: marknj68 (8770 in chips)=20
Seat 4: gator856500 (14137 in chips)=20
Seat 5: BGOLD1 (11564 in chips)=20
Seat 6: JJin91 (10656 in chips)=20
Seat 7: RynerNJ (8115 in chips)=20
Seat 8: EmmaBrighton (6395 in chips)=20
Seat 9: SDVSF2290 (20243 in chips)=20
anthonyblue1: posts the ante 40
marknj68: posts the ante 40
gator856500: posts the ante 40
BGOLD1: posts the ante 40
JJin91: posts the ante 40
RynerNJ: posts the ante 40
EmmaBrighton: posts the ante 40
SDVSF2290: posts the ante 40
RynerNJ: posts small blind 150
EmmaBrighton: posts big blind 300
*** HOLE CARDS ***
Dealt to JJin91 [Qc Ad]
SDVSF2290: folds=20
anthonyblue1: folds=20
marknj68: raises 300 to 600
gator856500: calls 600
BGOLD1: folds=20
JJin91: calls 600
RynerNJ: folds=20
EmmaBrighton: calls 300
*** FLOP *** [Ts 9s Kh]
EmmaBrighton: checks=20
marknj68: bets 3000
gator856500: raises 8870 to 11870
JJin91: folds=20
EmmaBrighton: folds=20
marknj68: calls 5130 and is all-in
Uncalled bet (3740) returned to gator856500
*** TURN *** [Ts 9s Kh] [Qd]
*** RIVER *** [Ts 9s Kh Qd] [6c]
*** SHOW DOWN ***
marknj68: shows [Tc 9c] (two pair, Tens and Nines)
gator856500: shows [Ks Jd] (a straight, Nine to King)
gator856500 collected 19130 from pot
marknj68 finished the tournament in 75th place
*** SUMMARY ***
Total pot 19130 | Rake 0=20
Board [Ts 9s Kh Qd 6c]
Seat 2: anthonyblue1 folded before Flop (didn't bet)
Seat 3: marknj68 showed [Tc 9c] and lost with two pair, Tens and Nines
Seat 4: gator856500 showed [Ks Jd] and won (19130) with a straight, Nin=
e to King
Seat 5: BGOLD1 folded before Flop (didn't bet)
Seat 6: JJin91 (button) folded on the Flop
Seat 7: RynerNJ (small blind) folded before Flop
Seat 8: EmmaBrighton (big blind) folded on the Flop
Seat 9: SDVSF2290 folded before Flop (didn't bet)


*********** # 46 **************
PokerStars Hand #169558463750: Tournament #1597684117, $4.55+$0.45 USD =
Hold'em No Limit - Level IX (150/300) - 2017/05/07 21:41:43 ET
Table '1597684117 5' 9-max Seat #7 is the button
Seat 2: anthonyblue1 (22190 in chips)=20
Seat 4: gator856500 (24497 in chips)=20
Seat 5: BGOLD1 (11524 in chips)=20
Seat 6: JJin91 (10016 in chips)=20
Seat 7: RynerNJ (7925 in chips)=20
Seat 8: EmmaBrighton (5755 in chips)=20
Seat 9: SDVSF2290 (20203 in chips)=20
anthonyblue1: posts the ante 40
gator856500: posts the ante 40
BGOLD1: posts the ante 40
JJin91: posts the ante 40
RynerNJ: posts the ante 40
EmmaBrighton: posts the ante 40
SDVSF2290: posts the ante 40
EmmaBrighton: posts small blind 150
SDVSF2290: posts big blind 300
*** HOLE CARDS ***
Dealt to JJin91 [6s 9d]
anthonyblue1: folds=20
gator856500: calls 300
BGOLD1: folds=20
JJin91: folds=20
RynerNJ: folds=20
EmmaBrighton: raises 5415 to 5715 and is all-in
SDVSF2290: calls 5415
gator856500: folds=20
*** FLOP *** [3s 3h Kd]
*** TURN *** [3s 3h Kd] [9h]
*** RIVER *** [3s 3h Kd 9h] [Kc]
*** SHOW DOWN ***
EmmaBrighton: shows [Jc Tc] (two pair, Kings and Threes)
SDVSF2290: shows [Ac 7d] (two pair, Kings and Threes - Ace kicker)
SDVSF2290 collected 12010 from pot
EmmaBrighton finished the tournament in 74th place
*** SUMMARY ***
Total pot 12010 | Rake 0=20
Board [3s 3h Kd 9h Kc]
Seat 2: anthonyblue1 folded before Flop (didn't bet)
Seat 4: gator856500 folded before Flop
Seat 5: BGOLD1 folded before Flop (didn't bet)
Seat 6: JJin91 folded before Flop (didn't bet)
Seat 7: RynerNJ (button) folded before Flop (didn't bet)
Seat 8: EmmaBrighton (small blind) showed [Jc Tc] and lost with two pai=
r, Kings and Threes
Seat 9: SDVSF2290 (big blind) showed [Ac 7d] and won (12010) with two p=
air, Kings and Threes


*********** # 47 **************
PokerStars Hand #169558464294: Tournament #1597684117, $4.55+$0.45 USD =
Hold'em No Limit - Level IX (150/300) - 2017/05/07 21:43:08 ET
Table '1597684117 7' 9-max Seat #8 is the button
Seat 1: mikefran13 (9500 in chips)=20
Seat 2: FoldGetBouti (17913 in chips)=20
Seat 3: hainesiv2 (8040 in chips) is sitting out
Seat 4: JJin91 (9976 in chips)=20
Seat 5: nwmdnj (7090 in chips)=20
Seat 6: SammyN109 (12275 in chips)=20
Seat 7: BIGTIME30829 (12441 in chips)=20
Seat 8: hockingjoe (12980 in chips)=20
Seat 9: TheOne7423 (6195 in chips)=20
mikefran13: posts the ante 40
FoldGetBouti: posts the ante 40
hainesiv2: posts the ante 40
JJin91: posts the ante 40
nwmdnj: posts the ante 40
SammyN109: posts the ante 40
BIGTIME30829: posts the ante 40
hockingjoe: posts the ante 40
TheOne7423: posts the ante 40
TheOne7423: posts small blind 150
mikefran13: posts big blind 300
*** HOLE CARDS ***
Dealt to JJin91 [3s Qs]
FoldGetBouti: folds=20
hainesiv2: folds=20
JJin91: folds=20
nwmdnj: raises 300 to 600
SammyN109: calls 600
BIGTIME30829: calls 600
hockingjoe: calls 600
TheOne7423: raises 5555 to 6155 and is all-in
mikefran13: folds=20
nwmdnj: folds=20
SammyN109: folds=20
BIGTIME30829: folds=20
hockingjoe: folds=20
Uncalled bet (5555) returned to TheOne7423
TheOne7423 collected 3660 from pot
TheOne7423: doesn't show hand=20
*** SUMMARY ***
Total pot 3660 | Rake 0=20
Seat 1: mikefran13 (big blind) folded before Flop
Seat 2: FoldGetBouti folded before Flop (didn't bet)
Seat 3: hainesiv2 folded before Flop (didn't bet)
Seat 4: JJin91 folded before Flop (didn't bet)
Seat 5: nwmdnj folded before Flop
Seat 6: SammyN109 folded before Flop
Seat 7: BIGTIME30829 folded before Flop
Seat 8: hockingjoe (button) folded before Flop
Seat 9: TheOne7423 (small blind) collected (3660)


*********** # 48 **************
PokerStars Hand #169558464747: Tournament #1597684117, $4.55+$0.45 USD =
Hold'em No Limit - Level IX (150/300) - 2017/05/07 21:44:19 ET
Table '1597684117 7' 9-max Seat #9 is the button
Seat 1: mikefran13 (9160 in chips)=20
Seat 2: FoldGetBouti (17873 in chips)=20
Seat 3: hainesiv2 (8000 in chips) is sitting out
Seat 4: JJin91 (9936 in chips)=20
Seat 5: nwmdnj (6450 in chips)=20
Seat 6: SammyN109 (11635 in chips)=20
Seat 7: BIGTIME30829 (11801 in chips)=20
Seat 8: hockingjoe (12340 in chips)=20
Seat 9: TheOne7423 (9215 in chips)=20
mikefran13: posts the ante 40
FoldGetBouti: posts the ante 40
hainesiv2: posts the ante 40
JJin91: posts the ante 40
nwmdnj: posts the ante 40
SammyN109: posts the ante 40
BIGTIME30829: posts the ante 40
hockingjoe: posts the ante 40
TheOne7423: posts the ante 40
mikefran13: posts small blind 150
FoldGetBouti: posts big blind 300
*** HOLE CARDS ***
Dealt to JJin91 [8s 6s]
hainesiv2: folds=20
JJin91: folds=20
nwmdnj: folds=20
SammyN109: raises 300 to 600
BIGTIME30829: calls 600
hockingjoe: calls 600
TheOne7423: folds=20
mikefran13: folds=20
FoldGetBouti: calls 300
*** FLOP *** [7c 5h 8c]
FoldGetBouti: checks=20
SammyN109: bets 300
BIGTIME30829: calls 300
hockingjoe: folds=20
FoldGetBouti: folds=20
*** TURN *** [7c 5h 8c] [Jd]
SammyN109: checks=20
BIGTIME30829: bets 1755
SammyN109: calls 1755
*** RIVER *** [7c 5h 8c Jd] [9d]
SammyN109: checks=20
BIGTIME30829: bets 3510
SammyN109: calls 3510
*** SHOW DOWN ***
BIGTIME30829: shows [6d Qs] (a straight, Five to Nine)
SammyN109: mucks hand=20
BIGTIME30829 collected 14040 from pot
*** SUMMARY ***
Total pot 14040 | Rake 0=20
Board [7c 5h 8c Jd 9d]
Seat 1: mikefran13 (small blind) folded before Flop
Seat 2: FoldGetBouti (big blind) folded on the Flop
Seat 3: hainesiv2 folded before Flop (didn't bet)
Seat 4: JJin91 folded before Flop (didn't bet)
Seat 5: nwmdnj folded before Flop (didn't bet)
Seat 6: SammyN109 mucked [Qc 9c]
Seat 7: BIGTIME30829 showed [6d Qs] and won (14040) with a straight, Fi=
ve to Nine
Seat 8: hockingjoe folded on the Flop
Seat 9: TheOne7423 (button) folded before Flop (didn't bet)


*********** # 49 **************
PokerStars Hand #169558465215: Tournament #1597684117, $4.55+$0.45 USD =
Hold'em No Limit - Level X (200/400) - 2017/05/07 21:45:36 ET
Table '1597684117 7' 9-max Seat #1 is the button
Seat 1: mikefran13 (8970 in chips)=20
Seat 2: FoldGetBouti (17233 in chips)=20
Seat 3: hainesiv2 (7960 in chips) is sitting out
Seat 4: JJin91 (9896 in chips)=20
Seat 5: nwmdnj (6410 in chips)=20
Seat 6: SammyN109 (5430 in chips)=20
Seat 7: BIGTIME30829 (19636 in chips)=20
Seat 8: hockingjoe (11700 in chips)=20
Seat 9: TheOne7423 (9175 in chips)=20
mikefran13: posts the ante 50
FoldGetBouti: posts the ante 50
hainesiv2: posts the ante 50
JJin91: posts the ante 50
nwmdnj: posts the ante 50
SammyN109: posts the ante 50
BIGTIME30829: posts the ante 50
hockingjoe: posts the ante 50
TheOne7423: posts the ante 50
FoldGetBouti: posts small blind 200
hainesiv2: posts big blind 400
*** HOLE CARDS ***
Dealt to JJin91 [Ah 7c]
JJin91: folds=20
nwmdnj: folds=20
SammyN109: folds=20
BIGTIME30829: calls 400
hockingjoe: folds=20
TheOne7423: folds=20
mikefran13: calls 400
FoldGetBouti: calls 200
hainesiv2: folds=20
*** FLOP *** [3h Th Kc]
FoldGetBouti: checks=20
BIGTIME30829: checks=20
mikefran13: bets 800
FoldGetBouti: folds=20
BIGTIME30829: calls 800
*** TURN *** [3h Th Kc] [5h]
BIGTIME30829: bets 1825
mikefran13: calls 1825
*** RIVER *** [3h Th Kc 5h] [6d]
BIGTIME30829: checks=20
mikefran13: bets 3600
BIGTIME30829: folds=20
Uncalled bet (3600) returned to mikefran13
mikefran13 collected 7300 from pot
mikefran13: doesn't show hand=20
*** SUMMARY ***
Total pot 7300 | Rake 0=20
Board [3h Th Kc 5h 6d]
Seat 1: mikefran13 (button) collected (7300)
Seat 2: FoldGetBouti (small blind) folded on the Flop
Seat 3: hainesiv2 (big blind) folded before Flop
Seat 4: JJin91 folded before Flop (didn't bet)
Seat 5: nwmdnj folded before Flop (didn't bet)
Seat 6: SammyN109 folded before Flop (didn't bet)
Seat 7: BIGTIME30829 folded on the River
Seat 8: hockingjoe folded before Flop (didn't bet)
Seat 9: TheOne7423 folded before Flop (didn't bet)


*********** # 50 **************
PokerStars Hand #169558465663: Tournament #1597684117, $4.55+$0.45 USD =
Hold'em No Limit - Level X (200/400) - 2017/05/07 21:46:45 ET
Table '1597684117 7' 9-max Seat #2 is the button
Seat 1: mikefran13 (13195 in chips)=20
Seat 2: FoldGetBouti (16783 in chips)=20
Seat 3: hainesiv2 (7510 in chips) is sitting out
Seat 4: JJin91 (9846 in chips)=20
Seat 5: nwmdnj (6360 in chips)=20
Seat 6: SammyN109 (5380 in chips)=20
Seat 7: BIGTIME30829 (16561 in chips)=20
Seat 8: hockingjoe (11650 in chips)=20
Seat 9: TheOne7423 (9125 in chips)=20
mikefran13: posts the ante 50
FoldGetBouti: posts the ante 50
hainesiv2: posts the ante 50
JJin91: posts the ante 50
nwmdnj: posts the ante 50
SammyN109: posts the ante 50
BIGTIME30829: posts the ante 50
hockingjoe: posts the ante 50
TheOne7423: posts the ante 50
hainesiv2: posts small blind 200
JJin91: posts big blind 400
*** HOLE CARDS ***
Dealt to JJin91 [As 2c]
nwmdnj: folds=20
SammyN109: calls 400
BIGTIME30829: calls 400
hockingjoe has timed out while being disconnected
hockingjoe: folds=20
hockingjoe is sitting out
TheOne7423: folds=20
hockingjoe has returned
mikefran13: folds=20
FoldGetBouti: calls 400
hainesiv2: folds=20
JJin91: checks=20
*** FLOP *** [9d Kc 8d]
JJin91: checks=20
SammyN109: checks=20
BIGTIME30829: checks=20
FoldGetBouti: checks=20
*** TURN *** [9d Kc 8d] [4c]
JJin91: checks=20
SammyN109: bets 400
BIGTIME30829: calls 400
FoldGetBouti: folds=20
JJin91: folds=20
*** RIVER *** [9d Kc 8d 4c] [Ad]
SammyN109: bets 4530 and is all-in
BIGTIME30829: calls 4530
*** SHOW DOWN ***
SammyN109: shows [7c Qc] (high card Ace)
BIGTIME30829: shows [5d Jd] (a flush, Ace high)
BIGTIME30829 collected 12110 from pot
SammyN109 finished the tournament in 70th place
*** SUMMARY ***
Total pot 12110 | Rake 0=20
Board [9d Kc 8d 4c Ad]
Seat 1: mikefran13 folded before Flop (didn't bet)
Seat 2: FoldGetBouti (button) folded on the Turn
Seat 3: hainesiv2 (small blind) folded before Flop
Seat 4: JJin91 (big blind) folded on the Turn
Seat 5: nwmdnj folded before Flop (didn't bet)
Seat 6: SammyN109 showed [7c Qc] and lost with high card Ace
Seat 7: BIGTIME30829 showed [5d Jd] and won (12110) with a flush, Ace h=
igh
Seat 8: hockingjoe folded before Flop (didn't bet)
Seat 9: TheOne7423 folded before Flop (didn't bet)


*********** # 51 **************
PokerStars Hand #169558466256: Tournament #1597684117, $4.55+$0.45 USD =
Hold'em No Limit - Level X (200/400) - 2017/05/07 21:48:17 ET
Table '1597684117 7' 9-max Seat #3 is the button
Seat 1: mikefran13 (13145 in chips)=20
Seat 2: FoldGetBouti (16333 in chips)=20
Seat 3: hainesiv2 (7260 in chips) is sitting out
Seat 4: JJin91 (9396 in chips)=20
Seat 5: nwmdnj (6310 in chips)=20
Seat 7: BIGTIME30829 (23291 in chips)=20
Seat 8: hockingjoe (11600 in chips)=20
Seat 9: TheOne7423 (9075 in chips)=20
mikefran13: posts the ante 50
FoldGetBouti: posts the ante 50
hainesiv2: posts the ante 50
JJin91: posts the ante 50
nwmdnj: posts the ante 50
BIGTIME30829: posts the ante 50
hockingjoe: posts the ante 50
TheOne7423: posts the ante 50
JJin91: posts small blind 200
nwmdnj: posts big blind 400
*** HOLE CARDS ***
Dealt to JJin91 [5h Ad]
BIGTIME30829: calls 400
hockingjoe: folds=20
TheOne7423: folds=20
mikefran13: folds=20
FoldGetBouti: folds=20
hainesiv2: folds=20
JJin91: raises 1600 to 2000
nwmdnj: folds=20
BIGTIME30829: folds=20
Uncalled bet (1600) returned to JJin91
JJin91 collected 1600 from pot
JJin91: doesn't show hand=20
*** SUMMARY ***
Total pot 1600 | Rake 0=20
Seat 1: mikefran13 folded before Flop (didn't bet)
Seat 2: FoldGetBouti folded before Flop (didn't bet)
Seat 3: hainesiv2 (button) folded before Flop (didn't bet)
Seat 4: JJin91 (small blind) collected (1600)
Seat 5: nwmdnj (big blind) folded before Flop
Seat 7: BIGTIME30829 folded before Flop
Seat 8: hockingjoe folded before Flop (didn't bet)
Seat 9: TheOne7423 folded before Flop (didn't bet)


*********** # 52 **************
PokerStars Hand #169558466459: Tournament #1597684117, $4.55+$0.45 USD =
Hold'em No Limit - Level X (200/400) - 2017/05/07 21:48:49 ET
Table '1597684117 7' 9-max Seat #4 is the button
Seat 1: mikefran13 (13095 in chips)=20
Seat 2: FoldGetBouti (16283 in chips)=20
Seat 3: hainesiv2 (7210 in chips) is sitting out
Seat 4: JJin91 (10546 in chips)=20
Seat 5: nwmdnj (5860 in chips)=20
Seat 7: BIGTIME30829 (22841 in chips)=20
Seat 8: hockingjoe (11550 in chips)=20
Seat 9: TheOne7423 (9025 in chips)=20
mikefran13: posts the ante 50
FoldGetBouti: posts the ante 50
hainesiv2: posts the ante 50
JJin91: posts the ante 50
nwmdnj: posts the ante 50
BIGTIME30829: posts the ante 50
hockingjoe: posts the ante 50
TheOne7423: posts the ante 50
nwmdnj: posts small blind 200
BIGTIME30829: posts big blind 400
*** HOLE CARDS ***
Dealt to JJin91 [2d 9d]
hockingjoe: folds=20
TheOne7423: raises 800 to 1200
mikefran13: calls 1200
FoldGetBouti: folds=20
hainesiv2: folds=20
JJin91: folds=20
nwmdnj: raises 4610 to 5810 and is all-in
BIGTIME30829: folds=20
TheOne7423: raises 3165 to 8975 and is all-in
mikefran13: folds=20
Uncalled bet (3165) returned to TheOne7423
*** FLOP *** [5h Tc 8h]
*** TURN *** [5h Tc 8h] [8c]
*** RIVER *** [5h Tc 8h 8c] [2h]
*** SHOW DOWN ***
nwmdnj: shows [Qh Ad] (a pair of Eights)
TheOne7423: shows [Ac Kd] (a pair of Eights - Ace+King kicker)
TheOne7423 collected 13620 from pot
nwmdnj finished the tournament in 69th place
*** SUMMARY ***
Total pot 13620 | Rake 0=20
Board [5h Tc 8h 8c 2h]
Seat 1: mikefran13 folded before Flop
Seat 2: FoldGetBouti folded before Flop (didn't bet)
Seat 3: hainesiv2 folded before Flop (didn't bet)
Seat 4: JJin91 (button) folded before Flop (didn't bet)
Seat 5: nwmdnj (small blind) showed [Qh Ad] and lost with a pair of Eig=
hts
Seat 7: BIGTIME30829 (big blind) folded before Flop
Seat 8: hockingjoe folded before Flop (didn't bet)
Seat 9: TheOne7423 showed [Ac Kd] and won (13620) with a pair of Eights


*********** # 53 **************
PokerStars Hand #169558466686: Tournament #1597684117, $4.55+$0.45 USD =
Hold'em No Limit - Level X (200/400) - 2017/05/07 21:49:26 ET
Table '1597684117 7' 9-max Seat #7 is the button
Seat 1: mikefran13 (11845 in chips)=20
Seat 2: FoldGetBouti (16233 in chips)=20
Seat 3: hainesiv2 (7160 in chips) is sitting out
Seat 4: JJin91 (10496 in chips)=20
Seat 7: BIGTIME30829 (22391 in chips)=20
Seat 8: hockingjoe (11500 in chips)=20
Seat 9: TheOne7423 (16785 in chips)=20
mikefran13: posts the ante 50
FoldGetBouti: posts the ante 50
hainesiv2: posts the ante 50
JJin91: posts the ante 50
BIGTIME30829: posts the ante 50
hockingjoe: posts the ante 50
TheOne7423: posts the ante 50
hockingjoe: posts small blind 200
TheOne7423: posts big blind 400
*** HOLE CARDS ***
Dealt to JJin91 [9h Kd]
mikefran13: folds=20
FoldGetBouti: folds=20
hainesiv2: folds=20
JJin91: folds=20
BIGTIME30829: calls 400
hockingjoe: calls 200
TheOne7423: checks=20
*** FLOP *** [3h 2c 8h]
hockingjoe: checks=20
TheOne7423: bets 775
BIGTIME30829: calls 775
hockingjoe: calls 775
*** TURN *** [3h 2c 8h] [7s]
hockingjoe: checks=20
TheOne7423: checks=20
BIGTIME30829: bets 1938
hockingjoe: folds=20
TheOne7423: calls 1938
*** RIVER *** [3h 2c 8h 7s] [2d]
TheOne7423: checks=20
BIGTIME30829: checks=20
*** SHOW DOWN ***
TheOne7423: shows [Qh Kh] (a pair of Deuces)
BIGTIME30829: shows [7d Th] (two pair, Sevens and Deuces)
BIGTIME30829 collected 7751 from pot
*** SUMMARY ***
Total pot 7751 | Rake 0=20
Board [3h 2c 8h 7s 2d]
Seat 1: mikefran13 folded before Flop (didn't bet)
Seat 2: FoldGetBouti folded before Flop (didn't bet)
Seat 3: hainesiv2 folded before Flop (didn't bet)
Seat 4: JJin91 folded before Flop (didn't bet)
Seat 7: BIGTIME30829 (button) showed [7d Th] and won (7751) with two pa=
ir, Sevens and Deuces
Seat 8: hockingjoe (small blind) folded on the Turn
Seat 9: TheOne7423 (big blind) showed [Qh Kh] and lost with a pair of D=
euces


*********** # 54 **************
PokerStars Hand #169558467002: Tournament #1597684117, $4.55+$0.45 USD =
Hold'em No Limit - Level XI (250/500) - 2017/05/07 21:50:18 ET
Table '1597684117 7' 9-max Seat #8 is the button
Seat 1: mikefran13 (11795 in chips)=20
Seat 2: FoldGetBouti (16183 in chips)=20
Seat 3: hainesiv2 (7110 in chips) is sitting out
Seat 4: JJin91 (10446 in chips)=20
Seat 5: nwmdnj (10000 in chips)=20
Seat 7: BIGTIME30829 (26979 in chips)=20
Seat 8: hockingjoe (10275 in chips)=20
Seat 9: TheOne7423 (13622 in chips)=20
mikefran13: posts the ante 60
FoldGetBouti: posts the ante 60
hainesiv2: posts the ante 60
JJin91: posts the ante 60
nwmdnj: posts the ante 60
BIGTIME30829: posts the ante 60
hockingjoe: posts the ante 60
TheOne7423: posts the ante 60
TheOne7423: posts small blind 250
mikefran13: posts big blind 500
*** HOLE CARDS ***
Dealt to JJin91 [2c 3s]
FoldGetBouti: folds=20
hainesiv2: folds=20
JJin91: folds=20
nwmdnj: folds=20
BIGTIME30829: calls 500
hockingjoe: folds=20
TheOne7423: calls 250
mikefran13: checks=20
*** FLOP *** [7s Ac 6h]
TheOne7423: checks=20
mikefran13: checks=20
BIGTIME30829: bets 990
TheOne7423: calls 990
mikefran13: folds=20
*** TURN *** [7s Ac 6h] [Ks]
TheOne7423: checks=20
BIGTIME30829: bets 1980
TheOne7423: folds=20
Uncalled bet (1980) returned to BIGTIME30829
BIGTIME30829 collected 3960 from pot
BIGTIME30829: doesn't show hand=20
*** SUMMARY ***
Total pot 3960 | Rake 0=20
Board [7s Ac 6h Ks]
Seat 1: mikefran13 (big blind) folded on the Flop
Seat 2: FoldGetBouti folded before Flop (didn't bet)
Seat 3: hainesiv2 folded before Flop (didn't bet)
Seat 4: JJin91 folded before Flop (didn't bet)
Seat 5: nwmdnj folded before Flop (didn't bet)
Seat 7: BIGTIME30829 collected (3960)
Seat 8: hockingjoe (button) folded before Flop (didn't bet)
Seat 9: TheOne7423 (small blind) folded on the Turn


*********** # 55 **************
PokerStars Hand #169558467465: Tournament #1597684117, $4.55+$0.45 USD =
Hold'em No Limit - Level XI (250/500) - 2017/05/07 21:51:31 ET
Table '1597684117 7' 9-max Seat #9 is the button
Seat 1: mikefran13 (11235 in chips)=20
Seat 3: hainesiv2 (7050 in chips) is sitting out
Seat 4: JJin91 (10386 in chips)=20
Seat 5: nwmdnj (9940 in chips)=20
Seat 6: pokermsrt2 (10000 in chips)=20
Seat 7: BIGTIME30829 (29389 in chips)=20
Seat 8: hockingjoe (10215 in chips)=20
Seat 9: TheOne7423 (12072 in chips)=20
mikefran13: posts the ante 60
hainesiv2: posts the ante 60
JJin91: posts the ante 60
nwmdnj: posts the ante 60
pokermsrt2: posts the ante 60
BIGTIME30829: posts the ante 60
hockingjoe: posts the ante 60
TheOne7423: posts the ante 60
mikefran13: posts small blind 250
hainesiv2: posts big blind 500
*** HOLE CARDS ***
Dealt to JJin91 [Ts Jh]
JJin91: folds=20
nwmdnj: folds=20
pokermsrt2: folds=20
BIGTIME30829: calls 500
hockingjoe: folds=20
TheOne7423: raises 1000 to 1500
mikefran13: folds=20
hainesiv2: folds=20
BIGTIME30829: calls 1000
*** FLOP *** [Jc 3h 6c]
BIGTIME30829: checks=20
TheOne7423: bets 4230
BIGTIME30829: raises 4230 to 8460
TheOne7423: raises 2052 to 10512 and is all-in
BIGTIME30829: calls 2052
*** TURN *** [Jc 3h 6c] [7h]
*** RIVER *** [Jc 3h 6c 7h] [Qc]
*** SHOW DOWN ***
BIGTIME30829: shows [Jd 8h] (a pair of Jacks)
TheOne7423: shows [8c 8s] (a pair of Eights)
BIGTIME30829 collected 25254 from pot
TheOne7423 finished the tournament in 65th place
*** SUMMARY ***
Total pot 25254 | Rake 0=20
Board [Jc 3h 6c 7h Qc]
Seat 1: mikefran13 (small blind) folded before Flop
Seat 3: hainesiv2 (big blind) folded before Flop
Seat 4: JJin91 folded before Flop (didn't bet)
Seat 5: nwmdnj folded before Flop (didn't bet)
Seat 6: pokermsrt2 folded before Flop (didn't bet)
Seat 7: BIGTIME30829 showed [Jd 8h] and won (25254) with a pair of Jacks
Seat 8: hockingjoe folded before Flop (didn't bet)
Seat 9: TheOne7423 (button) showed [8c 8s] and lost with a pair of Eigh=
ts


*********** # 56 **************
PokerStars Hand #169558467738: Tournament #1597684117, $4.55+$0.45 USD =
Hold'em No Limit - Level XI (250/500) - 2017/05/07 21:52:13 ET
Table '1597684117 7' 9-max Seat #1 is the button
Seat 1: mikefran13 (10925 in chips)=20
Seat 3: hainesiv2 (6490 in chips) is sitting out
Seat 4: JJin91 (10326 in chips)=20
Seat 5: nwmdnj (9880 in chips)=20
Seat 6: pokermsrt2 (9940 in chips)=20
Seat 7: BIGTIME30829 (42571 in chips)=20
Seat 8: hockingjoe (10155 in chips)=20
mikefran13: posts the ante 60
hainesiv2: posts the ante 60
JJin91: posts the ante 60
nwmdnj: posts the ante 60
pokermsrt2: posts the ante 60
BIGTIME30829: posts the ante 60
hockingjoe: posts the ante 60
hainesiv2: posts small blind 250
JJin91: posts big blind 500
*** HOLE CARDS ***
Dealt to JJin91 [7c 3s]
nwmdnj: folds=20
pokermsrt2: calls 500
BIGTIME30829: calls 500
hockingjoe: folds=20
mikefran13: folds=20
hainesiv2: folds=20
JJin91: checks=20
*** FLOP *** [Kd 4h 8d]
JJin91: checks=20
pokermsrt2: checks=20
BIGTIME30829: bets 500
JJin91: folds=20
pokermsrt2: folds=20
Uncalled bet (500) returned to BIGTIME30829
BIGTIME30829 collected 2170 from pot
BIGTIME30829: doesn't show hand=20
*** SUMMARY ***
Total pot 2170 | Rake 0=20
Board [Kd 4h 8d]
Seat 1: mikefran13 (button) folded before Flop (didn't bet)
Seat 3: hainesiv2 (small blind) folded before Flop
Seat 4: JJin91 (big blind) folded on the Flop
Seat 5: nwmdnj folded before Flop (didn't bet)
Seat 6: pokermsrt2 folded on the Flop
Seat 7: BIGTIME30829 collected (2170)
Seat 8: hockingjoe folded before Flop (didn't bet)


*********** # 57 **************
PokerStars Hand #169558467982: Tournament #1597684117, $4.55+$0.45 USD =
Hold'em No Limit - Level XI (250/500) - 2017/05/07 21:52:50 ET
Table '1597684117 7' 9-max Seat #3 is the button
Seat 1: mikefran13 (10865 in chips)=20
Seat 3: hainesiv2 (6180 in chips) is sitting out
Seat 4: JJin91 (9766 in chips)=20
Seat 5: nwmdnj (9820 in chips)=20
Seat 6: pokermsrt2 (9380 in chips)=20
Seat 7: BIGTIME30829 (44181 in chips)=20
Seat 8: hockingjoe (10095 in chips)=20
mikefran13: posts the ante 60
hainesiv2: posts the ante 60
JJin91: posts the ante 60
nwmdnj: posts the ante 60
pokermsrt2: posts the ante 60
BIGTIME30829: posts the ante 60
hockingjoe: posts the ante 60
JJin91: posts small blind 250
nwmdnj: posts big blind 500
*** HOLE CARDS ***
Dealt to JJin91 [2h Kc]
pokermsrt2: folds=20
BIGTIME30829: calls 500
hockingjoe: raises 1000 to 1500
mikefran13: folds=20
hainesiv2: folds=20
JJin91: folds=20
nwmdnj: folds=20
BIGTIME30829: calls 1000
*** FLOP *** [8c 4s Jc]
BIGTIME30829: bets 2085
hockingjoe: calls 2085
*** TURN *** [8c 4s Jc] [2s]
BIGTIME30829: bets 4170
hockingjoe: raises 2280 to 6450 and is all-in
BIGTIME30829: calls 2280
*** RIVER *** [8c 4s Jc 2s] [3h]
*** SHOW DOWN ***
BIGTIME30829: shows [7c 3c] (a pair of Threes)
hockingjoe: shows [Tc Td] (a pair of Tens)
hockingjoe collected 21240 from pot
*** SUMMARY ***
Total pot 21240 | Rake 0=20
Board [8c 4s Jc 2s 3h]
Seat 1: mikefran13 folded before Flop (didn't bet)
Seat 3: hainesiv2 (button) folded before Flop (didn't bet)
Seat 4: JJin91 (small blind) folded before Flop
Seat 5: nwmdnj (big blind) folded before Flop
Seat 6: pokermsrt2 folded before Flop (didn't bet)
Seat 7: BIGTIME30829 showed [7c 3c] and lost with a pair of Threes
Seat 8: hockingjoe showed [Tc Td] and won (21240) with a pair of Tens


*********** # 58 **************
PokerStars Hand #169558468420: Tournament #1597684117, $4.55+$0.45 USD =
Hold'em No Limit - Level XI (250/500) - 2017/05/07 21:53:57 ET
Table '1597684117 7' 9-max Seat #4 is the button
Seat 1: mikefran13 (10805 in chips)=20
Seat 3: hainesiv2 (6120 in chips) is sitting out
Seat 4: JJin91 (9456 in chips)=20
Seat 5: nwmdnj (9260 in chips)=20
Seat 6: pokermsrt2 (9320 in chips)=20
Seat 7: BIGTIME30829 (34086 in chips)=20
Seat 8: hockingjoe (21240 in chips)=20
Seat 9: Mr. seeflops (10000 in chips)=20
mikefran13: posts the ante 60
hainesiv2: posts the ante 60
JJin91: posts the ante 60
nwmdnj: posts the ante 60
pokermsrt2: posts the ante 60
BIGTIME30829: posts the ante 60
hockingjoe: posts the ante 60
Mr. seeflops: posts the ante 60
nwmdnj: posts small blind 250
pokermsrt2: posts big blind 500
*** HOLE CARDS ***
Dealt to JJin91 [9d 9s]
BIGTIME30829: folds=20
hockingjoe: folds=20
Mr. seeflops: folds=20
mikefran13: folds=20
hainesiv2: folds=20
JJin91: raises 805 to 1305
BIGTIME30829 is sitting out
nwmdnj: folds=20
pokermsrt2: calls 805
*** FLOP *** [Ah 6h 3c]
pokermsrt2: checks=20
JJin91: bets 1970
pokermsrt2: folds=20
Uncalled bet (1970) returned to JJin91
JJin91 collected 3340 from pot
JJin91: doesn't show hand=20
*** SUMMARY ***
Total pot 3340 | Rake 0=20
Board [Ah 6h 3c]
Seat 1: mikefran13 folded before Flop (didn't bet)
Seat 3: hainesiv2 folded before Flop (didn't bet)
Seat 4: JJin91 (button) collected (3340)
Seat 5: nwmdnj (small blind) folded before Flop
Seat 6: pokermsrt2 (big blind) folded on the Flop
Seat 7: BIGTIME30829 folded before Flop (didn't bet)
Seat 8: hockingjoe folded before Flop (didn't bet)
Seat 9: Mr. seeflops folded before Flop (didn't bet)


*********** # 59 **************
PokerStars Hand #169558468645: Tournament #1597684117, $4.55+$0.45 USD =
Hold'em No Limit - Level XI (250/500) - 2017/05/07 21:54:36 ET
Table '1597684117 7' 9-max Seat #5 is the button
Seat 1: mikefran13 (10745 in chips)=20
Seat 3: hainesiv2 (6060 in chips) is sitting out
Seat 4: JJin91 (11431 in chips)=20
Seat 5: nwmdnj (8950 in chips)=20
Seat 6: pokermsrt2 (7955 in chips)=20
Seat 7: BIGTIME30829 (34026 in chips) is sitting out
Seat 8: hockingjoe (21180 in chips)=20
Seat 9: Mr. seeflops (9940 in chips)=20
mikefran13: posts the ante 60
hainesiv2: posts the ante 60
JJin91: posts the ante 60
nwmdnj: posts the ante 60
pokermsrt2: posts the ante 60
BIGTIME30829: posts the ante 60
hockingjoe: posts the ante 60
Mr. seeflops: posts the ante 60
pokermsrt2: posts small blind 250
BIGTIME30829: posts big blind 500
*** HOLE CARDS ***
Dealt to JJin91 [7h Jc]
hockingjoe is disconnected=20
hockingjoe is connected=20
hockingjoe: folds=20
BIGTIME30829 has returned
Mr. seeflops: folds=20
mikefran13: folds=20
hainesiv2: folds=20
JJin91: folds=20
nwmdnj: raises 8390 to 8890 and is all-in
pokermsrt2: folds=20
BIGTIME30829: folds=20
Uncalled bet (8390) returned to nwmdnj
nwmdnj collected 1730 from pot
nwmdnj: doesn't show hand=20
*** SUMMARY ***
Total pot 1730 | Rake 0=20
Seat 1: mikefran13 folded before Flop (didn't bet)
Seat 3: hainesiv2 folded before Flop (didn't bet)
Seat 4: JJin91 folded before Flop (didn't bet)
Seat 5: nwmdnj (button) collected (1730)
Seat 6: pokermsrt2 (small blind) folded before Flop
Seat 7: BIGTIME30829 (big blind) folded before Flop
Seat 8: hockingjoe folded before Flop (didn't bet)
Seat 9: Mr. seeflops folded before Flop (didn't bet)


*********** # 60 **************
PokerStars Hand #169558468790: Tournament #1597684117, $4.55+$0.45 USD =
Hold'em No Limit - Level XI (250/500) - 2017/05/07 21:54:59 ET
Table '1597684117 7' 9-max Seat #6 is the button
Seat 1: mikefran13 (10685 in chips)=20
Seat 3: hainesiv2 (6000 in chips) is sitting out
Seat 4: JJin91 (11371 in chips)=20
Seat 5: nwmdnj (10120 in chips)=20
Seat 6: pokermsrt2 (7645 in chips)=20
Seat 7: BIGTIME30829 (33466 in chips)=20
Seat 8: hockingjoe (21120 in chips)=20
Seat 9: Mr. seeflops (9880 in chips)=20
mikefran13: posts the ante 60
hainesiv2: posts the ante 60
JJin91: posts the ante 60
nwmdnj: posts the ante 60
pokermsrt2: posts the ante 60
BIGTIME30829: posts the ante 60
hockingjoe: posts the ante 60
Mr. seeflops: posts the ante 60
BIGTIME30829: posts small blind 250
hockingjoe: posts big blind 500
*** HOLE CARDS ***
Dealt to JJin91 [4s 9s]
Mr. seeflops: folds=20
mikefran13: folds=20
hainesiv2: folds=20
JJin91: folds=20
nwmdnj: raises 500 to 1000
pokermsrt2: folds=20
BIGTIME30829: calls 750
hockingjoe: folds=20
*** FLOP *** [2d 9h Qc]
BIGTIME30829: checks=20
pokermsrt2 is sitting out
nwmdnj: checks=20
*** TURN *** [2d 9h Qc] [2s]
BIGTIME30829: bets 1490
nwmdnj: folds=20
Uncalled bet (1490) returned to BIGTIME30829
BIGTIME30829 collected 2980 from pot
BIGTIME30829: doesn't show hand=20
*** SUMMARY ***
Total pot 2980 | Rake 0=20
Board [2d 9h Qc 2s]
Seat 1: mikefran13 folded before Flop (didn't bet)
Seat 3: hainesiv2 folded before Flop (didn't bet)
Seat 4: JJin91 folded before Flop (didn't bet)
Seat 5: nwmdnj folded on the Turn
Seat 6: pokermsrt2 (button) folded before Flop (didn't bet)
Seat 7: BIGTIME30829 (small blind) collected (2980)
Seat 8: hockingjoe (big blind) folded before Flop
Seat 9: Mr. seeflops folded before Flop (didn't bet)


*********** # 61 **************
PokerStars Hand #169560026694: Tournament #1597684117, $4.55+$0.45 USD =
Hold'em No Limit - Level XI (250/500) - 2017/05/07 22:01:26 ET
Table '1597684117 7' 9-max Seat #8 is the button
Seat 1: mikefran13 (10625 in chips)=20
Seat 2: alwaysking3 (10000 in chips)=20
Seat 3: hainesiv2 (5940 in chips) is sitting out
Seat 4: JJin91 (11311 in chips)=20
Seat 5: nwmdnj (9060 in chips)=20
Seat 6: pokermsrt2 (7585 in chips)=20
Seat 8: hockingjoe (20560 in chips)=20
mikefran13: posts the ante 60
alwaysking3: posts the ante 60
hainesiv2: posts the ante 60
JJin91: posts the ante 60
nwmdnj: posts the ante 60
pokermsrt2: posts the ante 60
hockingjoe: posts the ante 60
mikefran13: posts small blind 250
alwaysking3: posts big blind 500
*** HOLE CARDS ***
Dealt to JJin91 [Kd 9h]
hainesiv2: folds=20
JJin91: folds=20
nwmdnj: folds=20
pokermsrt2: folds=20
hockingjoe: raises 1000 to 1500
mikefran13: folds=20
alwaysking3: folds=20
Uncalled bet (1000) returned to hockingjoe
hockingjoe collected 1670 from pot
*** SUMMARY ***
Total pot 1670 | Rake 0=20
Seat 1: mikefran13 (small blind) folded before Flop
Seat 2: alwaysking3 (big blind) folded before Flop
Seat 3: hainesiv2 folded before Flop (didn't bet)
Seat 4: JJin91 folded before Flop (didn't bet)
Seat 5: nwmdnj folded before Flop (didn't bet)
Seat 6: pokermsrt2 folded before Flop (didn't bet)
Seat 8: hockingjoe (button) collected (1670)


*********** # 62 **************
PokerStars Hand #169560026969: Tournament #1597684117, $4.55+$0.45 USD =
Hold'em No Limit - Level XII (300/600) - 2017/05/07 22:02:10 ET
Table '1597684117 6' 9-max Seat #1 is the button
Seat 1: ks1112 (16610 in chips)=20
Seat 2: leadarse01 (9780 in chips)=20
Seat 3: SammyN109 (29542 in chips)=20
Seat 4: JerseyGuy316 (9940 in chips)=20
Seat 5: DaMiJKoNtRoL (20935 in chips)=20
Seat 6: paynowplz (10870 in chips)=20
Seat 7: hockingjoe (21670 in chips)=20
Seat 8: JJin91 (11251 in chips)=20
Seat 9: UncleWetnaps (19210 in chips)=20
ks1112: posts the ante 70
leadarse01: posts the ante 70
SammyN109: posts the ante 70
JerseyGuy316: posts the ante 70
DaMiJKoNtRoL: posts the ante 70
paynowplz: posts the ante 70
hockingjoe: posts the ante 70
JJin91: posts the ante 70
UncleWetnaps: posts the ante 70
leadarse01: posts small blind 300
SammyN109: posts big blind 600
*** HOLE CARDS ***
Dealt to JJin91 [4c 3c]
JerseyGuy316: folds=20
DaMiJKoNtRoL: folds=20
paynowplz: folds=20
hockingjoe: folds=20
JJin91: folds=20
UncleWetnaps: calls 600
ks1112: folds=20
leadarse01: calls 300
SammyN109: checks=20
*** FLOP *** [2s Td Jd]
leadarse01: bets 600
SammyN109: calls 600
UncleWetnaps: calls 600
*** TURN *** [2s Td Jd] [3d]
leadarse01: bets 2115
SammyN109: folds=20
UncleWetnaps: folds=20
Uncalled bet (2115) returned to leadarse01
leadarse01 collected 4230 from pot
leadarse01: doesn't show hand=20
*** SUMMARY ***
Total pot 4230 | Rake 0=20
Board [2s Td Jd 3d]
Seat 1: ks1112 (button) folded before Flop (didn't bet)
Seat 2: leadarse01 (small blind) collected (4230)
Seat 3: SammyN109 (big blind) folded on the Turn
Seat 4: JerseyGuy316 folded before Flop (didn't bet)
Seat 5: DaMiJKoNtRoL folded before Flop (didn't bet)
Seat 6: paynowplz folded before Flop (didn't bet)
Seat 7: hockingjoe folded before Flop (didn't bet)
Seat 8: JJin91 folded before Flop (didn't bet)
Seat 9: UncleWetnaps folded on the Turn


*********** # 63 **************
PokerStars Hand #169560027174: Tournament #1597684117, $4.55+$0.45 USD =
Hold'em No Limit - Level XII (300/600) - 2017/05/07 22:02:41 ET
Table '1597684117 6' 9-max Seat #2 is the button
Seat 1: ks1112 (16540 in chips)=20
Seat 2: leadarse01 (12740 in chips)=20
Seat 3: SammyN109 (28272 in chips)=20
Seat 4: JerseyGuy316 (9870 in chips)=20
Seat 5: DaMiJKoNtRoL (20865 in chips)=20
Seat 6: paynowplz (10800 in chips)=20
Seat 7: hockingjoe (21600 in chips)=20
Seat 8: JJin91 (11181 in chips)=20
Seat 9: UncleWetnaps (17940 in chips)=20
ks1112: posts the ante 70
leadarse01: posts the ante 70
SammyN109: posts the ante 70
JerseyGuy316: posts the ante 70
DaMiJKoNtRoL: posts the ante 70
paynowplz: posts the ante 70
hockingjoe: posts the ante 70
JJin91: posts the ante 70
UncleWetnaps: posts the ante 70
SammyN109: posts small blind 300
JerseyGuy316: posts big blind 600
*** HOLE CARDS ***
Dealt to JJin91 [Tc 5h]
DaMiJKoNtRoL: folds=20
paynowplz: folds=20
hockingjoe: folds=20
JJin91: folds=20
UncleWetnaps: folds=20
ks1112: folds=20
leadarse01: folds=20
SammyN109: folds=20
Uncalled bet (300) returned to JerseyGuy316
JerseyGuy316 collected 1230 from pot
*** SUMMARY ***
Total pot 1230 | Rake 0=20
Seat 1: ks1112 folded before Flop (didn't bet)
Seat 2: leadarse01 (button) folded before Flop (didn't bet)
Seat 3: SammyN109 (small blind) folded before Flop
Seat 4: JerseyGuy316 (big blind) collected (1230)
Seat 5: DaMiJKoNtRoL folded before Flop (didn't bet)
Seat 6: paynowplz folded before Flop (didn't bet)
Seat 7: hockingjoe folded before Flop (didn't bet)
Seat 8: JJin91 folded before Flop (didn't bet)
Seat 9: UncleWetnaps folded before Flop (didn't bet)


*********** # 64 **************
PokerStars Hand #169560027258: Tournament #1597684117, $4.55+$0.45 USD =
Hold'em No Limit - Level XII (300/600) - 2017/05/07 22:02:55 ET
Table '1597684117 6' 9-max Seat #3 is the button
Seat 1: ks1112 (16470 in chips)=20
Seat 2: leadarse01 (12670 in chips)=20
Seat 3: SammyN109 (27902 in chips)=20
Seat 4: JerseyGuy316 (10730 in chips)=20
Seat 5: DaMiJKoNtRoL (20795 in chips)=20
Seat 6: paynowplz (10730 in chips)=20
Seat 7: hockingjoe (21530 in chips)=20
Seat 8: JJin91 (11111 in chips)=20
Seat 9: UncleWetnaps (17870 in chips)=20
ks1112: posts the ante 70
leadarse01: posts the ante 70
SammyN109: posts the ante 70
JerseyGuy316: posts the ante 70
DaMiJKoNtRoL: posts the ante 70
paynowplz: posts the ante 70
hockingjoe: posts the ante 70
JJin91: posts the ante 70
UncleWetnaps: posts the ante 70
JerseyGuy316: posts small blind 300
DaMiJKoNtRoL: posts big blind 600
*** HOLE CARDS ***
Dealt to JJin91 [6c 6d]
paynowplz: folds=20
hockingjoe: folds=20
JJin91: raises 600 to 1200
UncleWetnaps: folds=20
ks1112: folds=20
leadarse01: folds=20
SammyN109: calls 1200
JerseyGuy316: folds=20
DaMiJKoNtRoL: calls 600
*** FLOP *** [Th 9d Qs]
DaMiJKoNtRoL: checks=20
JJin91: checks=20
SammyN109: bets 26632 and is all-in
DaMiJKoNtRoL: folds=20
JJin91: folds=20
Uncalled bet (26632) returned to SammyN109
SammyN109 collected 4530 from pot
*** SUMMARY ***
Total pot 4530 | Rake 0=20
Board [Th 9d Qs]
Seat 1: ks1112 folded before Flop (didn't bet)
Seat 2: leadarse01 folded before Flop (didn't bet)
Seat 3: SammyN109 (button) collected (4530)
Seat 4: JerseyGuy316 (small blind) folded before Flop
Seat 5: DaMiJKoNtRoL (big blind) folded on the Flop
Seat 6: paynowplz folded before Flop (didn't bet)
Seat 7: hockingjoe folded before Flop (didn't bet)
Seat 8: JJin91 folded on the Flop
Seat 9: UncleWetnaps folded before Flop (didn't bet)


*********** # 65 **************
PokerStars Hand #169560027543: Tournament #1597684117, $4.55+$0.45 USD =
Hold'em No Limit - Level XII (300/600) - 2017/05/07 22:03:42 ET
Table '1597684117 6' 9-max Seat #4 is the button
Seat 1: ks1112 (16400 in chips)=20
Seat 2: leadarse01 (12600 in chips)=20
Seat 3: SammyN109 (31162 in chips)=20
Seat 4: JerseyGuy316 (10360 in chips)=20
Seat 5: DaMiJKoNtRoL (19525 in chips)=20
Seat 6: paynowplz (10660 in chips)=20
Seat 7: hockingjoe (21460 in chips)=20
Seat 8: JJin91 (9841 in chips)=20
Seat 9: UncleWetnaps (17800 in chips)=20
ks1112: posts the ante 70
leadarse01: posts the ante 70
SammyN109: posts the ante 70
JerseyGuy316: posts the ante 70
DaMiJKoNtRoL: posts the ante 70
paynowplz: posts the ante 70
hockingjoe: posts the ante 70
JJin91: posts the ante 70
UncleWetnaps: posts the ante 70
DaMiJKoNtRoL: posts small blind 300
paynowplz: posts big blind 600
*** HOLE CARDS ***
Dealt to JJin91 [Td 6s]
hockingjoe: folds=20
JJin91: folds=20
UncleWetnaps: folds=20
ks1112: folds=20
leadarse01: folds=20
SammyN109: folds=20
JerseyGuy316: folds=20
DaMiJKoNtRoL: raises 18855 to 19455 and is all-in
paynowplz: folds=20
Uncalled bet (18855) returned to DaMiJKoNtRoL
DaMiJKoNtRoL collected 1830 from pot
DaMiJKoNtRoL: doesn't show hand=20
*** SUMMARY ***
Total pot 1830 | Rake 0=20
Seat 1: ks1112 folded before Flop (didn't bet)
Seat 2: leadarse01 folded before Flop (didn't bet)
Seat 3: SammyN109 folded before Flop (didn't bet)
Seat 4: JerseyGuy316 (button) folded before Flop (didn't bet)
Seat 5: DaMiJKoNtRoL (small blind) collected (1830)
Seat 6: paynowplz (big blind) folded before Flop
Seat 7: hockingjoe folded before Flop (didn't bet)
Seat 8: JJin91 folded before Flop (didn't bet)
Seat 9: UncleWetnaps folded before Flop (didn't bet)


*********** # 66 **************
PokerStars Hand #169560027675: Tournament #1597684117, $4.55+$0.45 USD =
Hold'em No Limit - Level XII (300/600) - 2017/05/07 22:04:03 ET
Table '1597684117 6' 9-max Seat #5 is the button
Seat 1: ks1112 (16330 in chips)=20
Seat 2: leadarse01 (12530 in chips)=20
Seat 3: SammyN109 (31092 in chips)=20
Seat 4: JerseyGuy316 (10290 in chips)=20
Seat 5: DaMiJKoNtRoL (20685 in chips)=20
Seat 6: paynowplz (9990 in chips)=20
Seat 7: hockingjoe (21390 in chips)=20
Seat 8: JJin91 (9771 in chips)=20
Seat 9: UncleWetnaps (17730 in chips)=20
ks1112: posts the ante 70
leadarse01: posts the ante 70
SammyN109: posts the ante 70
JerseyGuy316: posts the ante 70
DaMiJKoNtRoL: posts the ante 70
paynowplz: posts the ante 70
hockingjoe: posts the ante 70
JJin91: posts the ante 70
UncleWetnaps: posts the ante 70
paynowplz: posts small blind 300
hockingjoe: posts big blind 600
*** HOLE CARDS ***
Dealt to JJin91 [5s 3h]
JJin91: folds=20
UncleWetnaps: raises 600 to 1200
ks1112: raises 600 to 1800
leadarse01: folds=20
SammyN109: folds=20
JerseyGuy316: folds=20
DaMiJKoNtRoL: folds=20
paynowplz: folds=20
hockingjoe: folds=20
UncleWetnaps: calls 600
*** FLOP *** [9h 2s 2c]
UncleWetnaps: bets 600
ks1112: raises 13860 to 14460 and is all-in
UncleWetnaps: folds=20
Uncalled bet (13860) returned to ks1112
ks1112 collected 6330 from pot
*** SUMMARY ***
Total pot 6330 | Rake 0=20
Board [9h 2s 2c]
Seat 1: ks1112 collected (6330)
Seat 2: leadarse01 folded before Flop (didn't bet)
Seat 3: SammyN109 folded before Flop (didn't bet)
Seat 4: JerseyGuy316 folded before Flop (didn't bet)
Seat 5: DaMiJKoNtRoL (button) folded before Flop (didn't bet)
Seat 6: paynowplz (small blind) folded before Flop
Seat 7: hockingjoe (big blind) folded before Flop
Seat 8: JJin91 folded before Flop (didn't bet)
Seat 9: UncleWetnaps folded on the Flop


*********** # 67 **************
PokerStars Hand #169560028127: Tournament #1597684117, $4.55+$0.45 USD =
Hold'em No Limit - Level XII (300/600) - 2017/05/07 22:05:17 ET
Table '1597684117 6' 9-max Seat #6 is the button
Seat 1: ks1112 (20190 in chips)=20
Seat 2: leadarse01 (12460 in chips)=20
Seat 3: SammyN109 (31022 in chips)=20
Seat 4: JerseyGuy316 (10220 in chips)=20
Seat 5: DaMiJKoNtRoL (20615 in chips)=20
Seat 6: paynowplz (9620 in chips)=20
Seat 7: hockingjoe (20720 in chips)=20
Seat 8: JJin91 (9701 in chips)=20
Seat 9: UncleWetnaps (15260 in chips)=20
ks1112: posts the ante 70
leadarse01: posts the ante 70
SammyN109: posts the ante 70
JerseyGuy316: posts the ante 70
DaMiJKoNtRoL: posts the ante 70
paynowplz: posts the ante 70
hockingjoe: posts the ante 70
JJin91: posts the ante 70
UncleWetnaps: posts the ante 70
hockingjoe: posts small blind 300
JJin91: posts big blind 600
*** HOLE CARDS ***
Dealt to JJin91 [Jc Qh]
UncleWetnaps: folds=20
ks1112: raises 1200 to 1800
leadarse01: folds=20
SammyN109: folds=20
JerseyGuy316: folds=20
DaMiJKoNtRoL: folds=20
paynowplz: calls 1800
hockingjoe: folds=20
JJin91: folds=20
*** FLOP *** [4s 2s 5d]
ks1112: bets 2565
paynowplz: folds=20
Uncalled bet (2565) returned to ks1112
ks1112 collected 5130 from pot
*** SUMMARY ***
Total pot 5130 | Rake 0=20
Board [4s 2s 5d]
Seat 1: ks1112 collected (5130)
Seat 2: leadarse01 folded before Flop (didn't bet)
Seat 3: SammyN109 folded before Flop (didn't bet)
Seat 4: JerseyGuy316 folded before Flop (didn't bet)
Seat 5: DaMiJKoNtRoL folded before Flop (didn't bet)
Seat 6: paynowplz (button) folded on the Flop
Seat 7: hockingjoe (small blind) folded before Flop
Seat 8: JJin91 (big blind) folded before Flop
Seat 9: UncleWetnaps folded before Flop (didn't bet)


*********** # 68 **************
PokerStars Hand #169560028423: Tournament #1597684117, $4.55+$0.45 USD =
Hold'em No Limit - Level XII (300/600) - 2017/05/07 22:06:03 ET
Table '1597684117 6' 9-max Seat #7 is the button
Seat 1: ks1112 (23450 in chips)=20
Seat 2: leadarse01 (12390 in chips)=20
Seat 3: SammyN109 (30952 in chips)=20
Seat 4: JerseyGuy316 (10150 in chips)=20
Seat 5: DaMiJKoNtRoL (20545 in chips)=20
Seat 6: paynowplz (7750 in chips)=20
Seat 7: hockingjoe (20350 in chips)=20
Seat 8: JJin91 (9031 in chips)=20
Seat 9: UncleWetnaps (15190 in chips)=20
ks1112: posts the ante 70
leadarse01: posts the ante 70
SammyN109: posts the ante 70
JerseyGuy316: posts the ante 70
DaMiJKoNtRoL: posts the ante 70
paynowplz: posts the ante 70
hockingjoe: posts the ante 70
JJin91: posts the ante 70
UncleWetnaps: posts the ante 70
JJin91: posts small blind 300
UncleWetnaps: posts big blind 600
*** HOLE CARDS ***
Dealt to JJin91 [3s 3c]
ks1112: folds=20
leadarse01: folds=20
SammyN109: folds=20
JerseyGuy316: folds=20
DaMiJKoNtRoL: raises 2130 to 2730
paynowplz: folds=20
hockingjoe: folds=20
JJin91: folds=20
UncleWetnaps: folds=20
Uncalled bet (2130) returned to DaMiJKoNtRoL
DaMiJKoNtRoL collected 2130 from pot
DaMiJKoNtRoL: doesn't show hand=20
*** SUMMARY ***
Total pot 2130 | Rake 0=20
Seat 1: ks1112 folded before Flop (didn't bet)
Seat 2: leadarse01 folded before Flop (didn't bet)
Seat 3: SammyN109 folded before Flop (didn't bet)
Seat 4: JerseyGuy316 folded before Flop (didn't bet)
Seat 5: DaMiJKoNtRoL collected (2130)
Seat 6: paynowplz folded before Flop (didn't bet)
Seat 7: hockingjoe (button) folded before Flop (didn't bet)
Seat 8: JJin91 (small blind) folded before Flop
Seat 9: UncleWetnaps (big blind) folded before Flop


*********** # 69 **************
PokerStars Hand #169560028584: Tournament #1597684117, $4.55+$0.45 USD =
Hold'em No Limit - Level XII (300/600) - 2017/05/07 22:06:28 ET
Table '1597684117 6' 9-max Seat #8 is the button
Seat 1: ks1112 (23380 in chips)=20
Seat 2: leadarse01 (12320 in chips)=20
Seat 3: SammyN109 (30882 in chips)=20
Seat 4: JerseyGuy316 (10080 in chips)=20
Seat 5: DaMiJKoNtRoL (22005 in chips)=20
Seat 6: paynowplz (7680 in chips)=20
Seat 7: hockingjoe (20280 in chips)=20
Seat 8: JJin91 (8661 in chips)=20
Seat 9: UncleWetnaps (14520 in chips)=20
ks1112: posts the ante 70
leadarse01: posts the ante 70
SammyN109: posts the ante 70
JerseyGuy316: posts the ante 70
DaMiJKoNtRoL: posts the ante 70
paynowplz: posts the ante 70
hockingjoe: posts the ante 70
JJin91: posts the ante 70
UncleWetnaps: posts the ante 70
UncleWetnaps: posts small blind 300
ks1112: posts big blind 600
*** HOLE CARDS ***
Dealt to JJin91 [9s 8d]
leadarse01: folds=20
SammyN109: folds=20
JerseyGuy316: folds=20
DaMiJKoNtRoL: folds=20
paynowplz: folds=20
hockingjoe: folds=20
JJin91: raises 7991 to 8591 and is all-in
UncleWetnaps: folds=20
ks1112: folds=20
Uncalled bet (7991) returned to JJin91
JJin91 collected 2130 from pot
*** SUMMARY ***
Total pot 2130 | Rake 0=20
Seat 1: ks1112 (big blind) folded before Flop
Seat 2: leadarse01 folded before Flop (didn't bet)
Seat 3: SammyN109 folded before Flop (didn't bet)
Seat 4: JerseyGuy316 folded before Flop (didn't bet)
Seat 5: DaMiJKoNtRoL folded before Flop (didn't bet)
Seat 6: paynowplz folded before Flop (didn't bet)
Seat 7: hockingjoe folded before Flop (didn't bet)
Seat 8: JJin91 (button) collected (2130)
Seat 9: UncleWetnaps (small blind) folded before Flop


*********** # 70 **************
PokerStars Hand #169560028743: Tournament #1597684117, $4.55+$0.45 USD =
Hold'em No Limit - Level XIII (350/700) - 2017/05/07 22:06:55 ET
Table '1597684117 6' 9-max Seat #9 is the button
Seat 1: ks1112 (22710 in chips)=20
Seat 2: leadarse01 (12250 in chips)=20
Seat 3: SammyN109 (30812 in chips)=20
Seat 4: JerseyGuy316 (10010 in chips)=20
Seat 5: DaMiJKoNtRoL (21935 in chips)=20
Seat 6: paynowplz (7610 in chips)=20
Seat 7: hockingjoe (20210 in chips)=20
Seat 8: JJin91 (10121 in chips)=20
Seat 9: UncleWetnaps (14150 in chips)=20
ks1112: posts the ante 85
leadarse01: posts the ante 85
SammyN109: posts the ante 85
JerseyGuy316: posts the ante 85
DaMiJKoNtRoL: posts the ante 85
paynowplz: posts the ante 85
hockingjoe: posts the ante 85
JJin91: posts the ante 85
UncleWetnaps: posts the ante 85
ks1112: posts small blind 350
leadarse01: posts big blind 700
*** HOLE CARDS ***
Dealt to JJin91 [3s 7h]
SammyN109: folds=20
JerseyGuy316: folds=20
DaMiJKoNtRoL: folds=20
paynowplz: folds=20
hockingjoe: folds=20
JJin91: folds=20
UncleWetnaps: folds=20
ks1112: raises 1400 to 2100
leadarse01: folds=20
Uncalled bet (1400) returned to ks1112
ks1112 collected 2165 from pot
*** SUMMARY ***
Total pot 2165 | Rake 0=20
Seat 1: ks1112 (small blind) collected (2165)
Seat 2: leadarse01 (big blind) folded before Flop
Seat 3: SammyN109 folded before Flop (didn't bet)
Seat 4: JerseyGuy316 folded before Flop (didn't bet)
Seat 5: DaMiJKoNtRoL folded before Flop (didn't bet)
Seat 6: paynowplz folded before Flop (didn't bet)
Seat 7: hockingjoe folded before Flop (didn't bet)
Seat 8: JJin91 folded before Flop (didn't bet)
Seat 9: UncleWetnaps (button) folded before Flop (didn't bet)


*********** # 71 **************
PokerStars Hand #169560028878: Tournament #1597684117, $4.55+$0.45 USD =
Hold'em No Limit - Level XIII (350/700) - 2017/05/07 22:07:16 ET
Table '1597684117 6' 9-max Seat #2 is the button
Seat 2: leadarse01 (11465 in chips)=20
Seat 3: SammyN109 (30727 in chips)=20
Seat 4: JerseyGuy316 (9925 in chips)=20
Seat 5: DaMiJKoNtRoL (21850 in chips)=20
Seat 6: paynowplz (7525 in chips)=20
Seat 7: hockingjoe (20125 in chips)=20
Seat 8: JJin91 (10036 in chips)=20
Seat 9: UncleWetnaps (14065 in chips)=20
leadarse01: posts the ante 85
SammyN109: posts the ante 85
JerseyGuy316: posts the ante 85
DaMiJKoNtRoL: posts the ante 85
paynowplz: posts the ante 85
hockingjoe: posts the ante 85
JJin91: posts the ante 85
UncleWetnaps: posts the ante 85
SammyN109: posts small blind 350
JerseyGuy316: posts big blind 700
*** HOLE CARDS ***
Dealt to JJin91 [Qd 9d]
DaMiJKoNtRoL: folds=20
paynowplz: folds=20
hockingjoe: folds=20
JJin91: raises 700 to 1400
UncleWetnaps: folds=20
leadarse01: folds=20
SammyN109: folds=20
JerseyGuy316: folds=20
Uncalled bet (700) returned to JJin91
JJin91 collected 2430 from pot
*** SUMMARY ***
Total pot 2430 | Rake 0=20
Seat 2: leadarse01 (button) folded before Flop (didn't bet)
Seat 3: SammyN109 (small blind) folded before Flop
Seat 4: JerseyGuy316 (big blind) folded before Flop
Seat 5: DaMiJKoNtRoL folded before Flop (didn't bet)
Seat 6: paynowplz folded before Flop (didn't bet)
Seat 7: hockingjoe folded before Flop (didn't bet)
Seat 8: JJin91 collected (2430)
Seat 9: UncleWetnaps folded before Flop (didn't bet)


*********** # 72 **************
PokerStars Hand #169560029010: Tournament #1597684117, $4.55+$0.45 USD =
Hold'em No Limit - Level XIII (350/700) - 2017/05/07 22:07:36 ET
Table '1597684117 6' 9-max Seat #3 is the button
Seat 2: leadarse01 (11380 in chips)=20
Seat 3: SammyN109 (30292 in chips)=20
Seat 4: JerseyGuy316 (9140 in chips)=20
Seat 5: DaMiJKoNtRoL (21765 in chips)=20
Seat 6: paynowplz (7440 in chips)=20
Seat 7: hockingjoe (20040 in chips)=20
Seat 8: JJin91 (11681 in chips)=20
Seat 9: UncleWetnaps (13980 in chips)=20
leadarse01: posts the ante 85
SammyN109: posts the ante 85
JerseyGuy316: posts the ante 85
DaMiJKoNtRoL: posts the ante 85
paynowplz: posts the ante 85
hockingjoe: posts the ante 85
JJin91: posts the ante 85
UncleWetnaps: posts the ante 85
JerseyGuy316: posts small blind 350
DaMiJKoNtRoL: posts big blind 700
*** HOLE CARDS ***
Dealt to JJin91 [9c 4s]
paynowplz: calls 700
hockingjoe: folds=20
JJin91: folds=20
UncleWetnaps: folds=20
leadarse01: folds=20
SammyN109: calls 700
JerseyGuy316: calls 350
DaMiJKoNtRoL: checks=20
*** FLOP *** [Qh 3c 8d]
JerseyGuy316: checks=20
DaMiJKoNtRoL: checks=20
paynowplz: checks=20
SammyN109: bets 1400
JerseyGuy316: folds=20
DaMiJKoNtRoL: folds=20
paynowplz: folds=20
Uncalled bet (1400) returned to SammyN109
SammyN109 collected 3480 from pot
*** SUMMARY ***
Total pot 3480 | Rake 0=20
Board [Qh 3c 8d]
Seat 2: leadarse01 folded before Flop (didn't bet)
Seat 3: SammyN109 (button) collected (3480)
Seat 4: JerseyGuy316 (small blind) folded on the Flop
Seat 5: DaMiJKoNtRoL (big blind) folded on the Flop
Seat 6: paynowplz folded on the Flop
Seat 7: hockingjoe folded before Flop (didn't bet)
Seat 8: JJin91 folded before Flop (didn't bet)
Seat 9: UncleWetnaps folded before Flop (didn't bet)


*********** # 73 **************
PokerStars Hand #169560029353: Tournament #1597684117, $4.55+$0.45 USD =
Hold'em No Limit - Level XIII (350/700) - 2017/05/07 22:08:33 ET
Table '1597684117 6' 9-max Seat #4 is the button
Seat 1: RunninItUp98 (7189 in chips)=20
Seat 2: leadarse01 (11295 in chips)=20
Seat 3: SammyN109 (32987 in chips)=20
Seat 4: JerseyGuy316 (8355 in chips)=20
Seat 5: DaMiJKoNtRoL (20980 in chips)=20
Seat 6: paynowplz (6655 in chips)=20
Seat 7: hockingjoe (19955 in chips)=20
Seat 8: JJin91 (11596 in chips)=20
Seat 9: UncleWetnaps (13895 in chips)=20
RunninItUp98: posts the ante 85
leadarse01: posts the ante 85
SammyN109: posts the ante 85
JerseyGuy316: posts the ante 85
DaMiJKoNtRoL: posts the ante 85
paynowplz: posts the ante 85
hockingjoe: posts the ante 85
JJin91: posts the ante 85
UncleWetnaps: posts the ante 85
DaMiJKoNtRoL: posts small blind 350
paynowplz: posts big blind 700
*** HOLE CARDS ***
Dealt to JJin91 [4d 5s]
hockingjoe: folds=20
JJin91: folds=20
UncleWetnaps: calls 700
RunninItUp98: raises 6404 to 7104 and is all-in
leadarse01: folds=20
SammyN109: folds=20
JerseyGuy316: folds=20
DaMiJKoNtRoL: calls 6754
paynowplz: folds=20
UncleWetnaps: folds=20
*** FLOP *** [Th 3d Qh]
*** TURN *** [Th 3d Qh] [2d]
*** RIVER *** [Th 3d Qh 2d] [Ks]
*** SHOW DOWN ***
DaMiJKoNtRoL: shows [Qs Kd] (two pair, Kings and Queens)
RunninItUp98: shows [Kh Jd] (a pair of Kings)
DaMiJKoNtRoL collected 16373 from pot
RunninItUp98 finished the tournament in 54th place
*** SUMMARY ***
Total pot 16373 | Rake 0=20
Board [Th 3d Qh 2d Ks]
Seat 1: RunninItUp98 showed [Kh Jd] and lost with a pair of Kings
Seat 2: leadarse01 folded before Flop (didn't bet)
Seat 3: SammyN109 folded before Flop (didn't bet)
Seat 4: JerseyGuy316 (button) folded before Flop (didn't bet)
Seat 5: DaMiJKoNtRoL (small blind) showed [Qs Kd] and won (16373) with =
two pair, Kings and Queens
Seat 6: paynowplz (big blind) folded before Flop
Seat 7: hockingjoe folded before Flop (didn't bet)
Seat 8: JJin91 folded before Flop (didn't bet)
Seat 9: UncleWetnaps folded before Flop


*********** # 74 **************
PokerStars Hand #169560029516: Tournament #1597684117, $4.55+$0.45 USD =
Hold'em No Limit - Level XIII (350/700) - 2017/05/07 22:09:01 ET
Table '1597684117 6' 9-max Seat #5 is the button
Seat 2: leadarse01 (11210 in chips)=20
Seat 3: SammyN109 (32902 in chips)=20
Seat 4: JerseyGuy316 (8270 in chips)=20
Seat 5: DaMiJKoNtRoL (30164 in chips)=20
Seat 6: paynowplz (5870 in chips)=20
Seat 7: hockingjoe (19870 in chips)=20
Seat 8: JJin91 (11511 in chips)=20
Seat 9: UncleWetnaps (13110 in chips)=20
leadarse01: posts the ante 85
SammyN109: posts the ante 85
JerseyGuy316: posts the ante 85
DaMiJKoNtRoL: posts the ante 85
paynowplz: posts the ante 85
hockingjoe: posts the ante 85
JJin91: posts the ante 85
UncleWetnaps: posts the ante 85
paynowplz: posts small blind 350
hockingjoe: posts big blind 700
*** HOLE CARDS ***
Dealt to JJin91 [3d Td]
JJin91: folds=20
UncleWetnaps: folds=20
leadarse01: folds=20
SammyN109: folds=20
JerseyGuy316: folds=20
DaMiJKoNtRoL: folds=20
paynowplz: raises 700 to 1400
hockingjoe: calls 700
*** FLOP *** [8s Ah 3s]
paynowplz: bets 4385 and is all-in
hockingjoe: folds=20
Uncalled bet (4385) returned to paynowplz
paynowplz collected 3480 from pot
paynowplz: doesn't show hand=20
*** SUMMARY ***
Total pot 3480 | Rake 0=20
Board [8s Ah 3s]
Seat 2: leadarse01 folded before Flop (didn't bet)
Seat 3: SammyN109 folded before Flop (didn't bet)
Seat 4: JerseyGuy316 folded before Flop (didn't bet)
Seat 5: DaMiJKoNtRoL (button) folded before Flop (didn't bet)
Seat 6: paynowplz (small blind) collected (3480)
Seat 7: hockingjoe (big blind) folded on the Flop
Seat 8: JJin91 folded before Flop (didn't bet)
Seat 9: UncleWetnaps folded before Flop (didn't bet)


*********** # 75 **************
PokerStars Hand #169560029645: Tournament #1597684117, $4.55+$0.45 USD =
Hold'em No Limit - Level XIII (350/700) - 2017/05/07 22:09:23 ET
Table '1597684117 6' 9-max Seat #6 is the button
Seat 2: leadarse01 (11125 in chips)=20
Seat 3: SammyN109 (32817 in chips)=20
Seat 4: JerseyGuy316 (8185 in chips)=20
Seat 5: DaMiJKoNtRoL (30079 in chips)=20
Seat 6: paynowplz (7865 in chips)=20
Seat 7: hockingjoe (18385 in chips)=20
Seat 8: JJin91 (11426 in chips)=20
Seat 9: UncleWetnaps (13025 in chips)=20
leadarse01: posts the ante 85
SammyN109: posts the ante 85
JerseyGuy316: posts the ante 85
DaMiJKoNtRoL: posts the ante 85
paynowplz: posts the ante 85
hockingjoe: posts the ante 85
JJin91: posts the ante 85
UncleWetnaps: posts the ante 85
hockingjoe: posts small blind 350
JJin91: posts big blind 700
*** HOLE CARDS ***
Dealt to JJin91 [Ad 5h]
UncleWetnaps: folds=20
leadarse01: folds=20
SammyN109: folds=20
JerseyGuy316: calls 700
DaMiJKoNtRoL: folds=20
paynowplz: folds=20
hockingjoe: raises 1400 to 2100
JJin91: folds=20
JerseyGuy316: folds=20
Uncalled bet (1400) returned to hockingjoe
hockingjoe collected 2780 from pot
hockingjoe: doesn't show hand=20
*** SUMMARY ***
Total pot 2780 | Rake 0=20
Seat 2: leadarse01 folded before Flop (didn't bet)
Seat 3: SammyN109 folded before Flop (didn't bet)
Seat 4: JerseyGuy316 folded before Flop
Seat 5: DaMiJKoNtRoL folded before Flop (didn't bet)
Seat 6: paynowplz (button) folded before Flop (didn't bet)
Seat 7: hockingjoe (small blind) collected (2780)
Seat 8: JJin91 (big blind) folded before Flop
Seat 9: UncleWetnaps folded before Flop (didn't bet)


*********** # 76 **************
PokerStars Hand #169560029818: Tournament #1597684117, $4.55+$0.45 USD =
Hold'em No Limit - Level XIII (350/700) - 2017/05/07 22:09:52 ET
Table '1597684117 6' 9-max Seat #7 is the button
Seat 2: leadarse01 (11040 in chips)=20
Seat 3: SammyN109 (32732 in chips)=20
Seat 4: JerseyGuy316 (7400 in chips)=20
Seat 5: DaMiJKoNtRoL (29994 in chips)=20
Seat 6: paynowplz (7780 in chips)=20
Seat 7: hockingjoe (20380 in chips)=20
Seat 8: JJin91 (10641 in chips)=20
Seat 9: UncleWetnaps (12940 in chips)=20
leadarse01: posts the ante 85
SammyN109: posts the ante 85
JerseyGuy316: posts the ante 85
DaMiJKoNtRoL: posts the ante 85
paynowplz: posts the ante 85
hockingjoe: posts the ante 85
JJin91: posts the ante 85
UncleWetnaps: posts the ante 85
JJin91: posts small blind 350
UncleWetnaps: posts big blind 700
*** HOLE CARDS ***
Dealt to JJin91 [Kc Jd]
leadarse01: calls 700
SammyN109: folds=20
JerseyGuy316: folds=20
DaMiJKoNtRoL: folds=20
paynowplz: folds=20
hockingjoe: calls 700
JJin91: raises 9856 to 10556 and is all-in
UncleWetnaps: folds=20
leadarse01: folds=20
hockingjoe: folds=20
Uncalled bet (9856) returned to JJin91
JJin91 collected 3480 from pot
*** SUMMARY ***
Total pot 3480 | Rake 0=20
Seat 2: leadarse01 folded before Flop
Seat 3: SammyN109 folded before Flop (didn't bet)
Seat 4: JerseyGuy316 folded before Flop (didn't bet)
Seat 5: DaMiJKoNtRoL folded before Flop (didn't bet)
Seat 6: paynowplz folded before Flop (didn't bet)
Seat 7: hockingjoe (button) folded before Flop
Seat 8: JJin91 (small blind) collected (3480)
Seat 9: UncleWetnaps (big blind) folded before Flop


*********** # 77 **************
PokerStars Hand #169560781202: Tournament #1597684117, $4.55+$0.45 USD =
Hold'em No Limit - Level XIII (350/700) - 2017/05/07 22:10:25 ET
Table '1597684117 6' 9-max Seat #8 is the button
Seat 2: leadarse01 (10255 in chips)=20
Seat 3: SammyN109 (32647 in chips)=20
Seat 4: JerseyGuy316 (7315 in chips)=20
Seat 5: DaMiJKoNtRoL (29909 in chips)=20
Seat 6: paynowplz (7695 in chips)=20
Seat 7: hockingjoe (19595 in chips)=20
Seat 8: JJin91 (13336 in chips)=20
Seat 9: UncleWetnaps (12155 in chips)=20
leadarse01: posts the ante 85
SammyN109: posts the ante 85
JerseyGuy316: posts the ante 85
DaMiJKoNtRoL: posts the ante 85
paynowplz: posts the ante 85
hockingjoe: posts the ante 85
JJin91: posts the ante 85
UncleWetnaps: posts the ante 85
UncleWetnaps: posts small blind 350
leadarse01: posts big blind 700
*** HOLE CARDS ***
Dealt to JJin91 [3h Kh]
SammyN109: folds=20
JerseyGuy316: folds=20
DaMiJKoNtRoL: calls 700
paynowplz: calls 700
hockingjoe: folds=20
JJin91: calls 700
UncleWetnaps: calls 350
leadarse01: checks=20
*** FLOP *** [6h 7c Qc]
UncleWetnaps: bets 1400
leadarse01: folds=20
DaMiJKoNtRoL: calls 1400
paynowplz: folds=20
JJin91: folds=20
*** TURN *** [6h 7c Qc] [Ac]
UncleWetnaps: bets 1400
DaMiJKoNtRoL: calls 1400
*** RIVER *** [6h 7c Qc Ac] [5s]
UncleWetnaps: bets 2100
DaMiJKoNtRoL: calls 2100
*** SHOW DOWN ***
UncleWetnaps: shows [Qd Tc] (a pair of Queens)
DaMiJKoNtRoL: shows [Ks Kd] (a pair of Kings)
DaMiJKoNtRoL collected 13980 from pot
*** SUMMARY ***
Total pot 13980 | Rake 0=20
Board [6h 7c Qc Ac 5s]
Seat 2: leadarse01 (big blind) folded on the Flop
Seat 3: SammyN109 folded before Flop (didn't bet)
Seat 4: JerseyGuy316 folded before Flop (didn't bet)
Seat 5: DaMiJKoNtRoL showed [Ks Kd] and won (13980) with a pair of Kings
Seat 6: paynowplz folded on the Flop
Seat 7: hockingjoe folded before Flop (didn't bet)
Seat 8: JJin91 (button) folded on the Flop
Seat 9: UncleWetnaps (small blind) showed [Qd Tc] and lost with a pair =
of Queens


*********** # 78 **************
PokerStars Hand #169560781601: Tournament #1597684117, $4.55+$0.45 USD =
Hold'em No Limit - Level XIV (400/800) - 2017/05/07 22:11:35 ET
Table '1597684117 6' 9-max Seat #9 is the button
Seat 2: leadarse01 (9470 in chips)=20
Seat 3: SammyN109 (32562 in chips)=20
Seat 4: JerseyGuy316 (7230 in chips)=20
Seat 5: DaMiJKoNtRoL (38204 in chips)=20
Seat 6: paynowplz (6910 in chips)=20
Seat 7: hockingjoe (19510 in chips)=20
Seat 8: JJin91 (12551 in chips)=20
Seat 9: UncleWetnaps (6470 in chips)=20
leadarse01: posts the ante 100
SammyN109: posts the ante 100
JerseyGuy316: posts the ante 100
DaMiJKoNtRoL: posts the ante 100
paynowplz: posts the ante 100
hockingjoe: posts the ante 100
JJin91: posts the ante 100
UncleWetnaps: posts the ante 100
leadarse01: posts small blind 400
SammyN109: posts big blind 800
*** HOLE CARDS ***
Dealt to JJin91 [5c Jc]
JerseyGuy316: folds=20
DaMiJKoNtRoL: calls 800
paynowplz: folds=20
hockingjoe: folds=20
JJin91: folds=20
UncleWetnaps: folds=20
leadarse01: calls 400
SammyN109: checks=20
*** FLOP *** [6c 3c Ts]
leadarse01: bets 800
SammyN109: calls 800
DaMiJKoNtRoL: calls 800
*** TURN *** [6c 3c Ts] [4c]
leadarse01: bets 2800
SammyN109: calls 2800
DaMiJKoNtRoL: calls 2800
*** RIVER *** [6c 3c Ts 4c] [Kd]
leadarse01: bets 4970 and is all-in
SammyN109: calls 4970
DaMiJKoNtRoL: raises 14455 to 19425
SammyN109: folds=20
Uncalled bet (14455) returned to DaMiJKoNtRoL
*** SHOW DOWN ***
DaMiJKoNtRoL: shows [Ac Kc] (a flush, Ace high)
leadarse01: shows [Qc 9c] (a flush, Queen high)
DaMiJKoNtRoL collected 28910 from pot
leadarse01 finished the tournament in 51st place
*** SUMMARY ***
Total pot 28910 | Rake 0=20
Board [6c 3c Ts 4c Kd]
Seat 2: leadarse01 (small blind) showed [Qc 9c] and lost with a flush, =
Queen high
Seat 3: SammyN109 (big blind) folded on the River
Seat 4: JerseyGuy316 folded before Flop (didn't bet)
Seat 5: DaMiJKoNtRoL showed [Ac Kc] and won (28910) with a flush, Ace h=
igh
Seat 6: paynowplz folded before Flop (didn't bet)
Seat 7: hockingjoe folded before Flop (didn't bet)
Seat 8: JJin91 folded before Flop (didn't bet)
Seat 9: UncleWetnaps (button) folded before Flop (didn't bet)


*********** # 79 **************
PokerStars Hand #169560781950: Tournament #1597684117, $4.55+$0.45 USD =
Hold'em No Limit - Level XIV (400/800) - 2017/05/07 22:12:35 ET
Table '1597684117 6' 9-max Seat #3 is the button
Seat 3: SammyN109 (23092 in chips)=20
Seat 4: JerseyGuy316 (7130 in chips)=20
Seat 5: DaMiJKoNtRoL (57644 in chips)=20
Seat 6: paynowplz (6810 in chips)=20
Seat 7: hockingjoe (19410 in chips)=20
Seat 8: JJin91 (12451 in chips)=20
Seat 9: UncleWetnaps (6370 in chips)=20
SammyN109: posts the ante 100
JerseyGuy316: posts the ante 100
DaMiJKoNtRoL: posts the ante 100
paynowplz: posts the ante 100
hockingjoe: posts the ante 100
JJin91: posts the ante 100
UncleWetnaps: posts the ante 100
JerseyGuy316: posts small blind 400
DaMiJKoNtRoL: posts big blind 800
*** HOLE CARDS ***
Dealt to JJin91 [Kc 8s]
paynowplz: raises 5910 to 6710 and is all-in
hockingjoe: calls 6710
JJin91: folds=20
Rendgz1234 is sitting out
Rendgz1234 has returned
UncleWetnaps: folds=20
SammyN109: folds=20
JerseyGuy316: folds=20
DaMiJKoNtRoL: folds=20
*** FLOP *** [7h 2s 6c]
*** TURN *** [7h 2s 6c] [Th]
*** RIVER *** [7h 2s 6c Th] [9d]
*** SHOW DOWN ***
paynowplz: shows [9c 9s] (three of a kind, Nines)
hockingjoe: shows [5d 5h] (a pair of Fives)
paynowplz collected 15320 from pot
*** SUMMARY ***
Total pot 15320 | Rake 0=20
Board [7h 2s 6c Th 9d]
Seat 3: SammyN109 (button) folded before Flop (didn't bet)
Seat 4: JerseyGuy316 (small blind) folded before Flop
Seat 5: DaMiJKoNtRoL (big blind) folded before Flop
Seat 6: paynowplz showed [9c 9s] and won (15320) with three of a kind, =
Nines
Seat 7: hockingjoe showed [5d 5h] and lost with a pair of Fives
Seat 8: JJin91 folded before Flop (didn't bet)
Seat 9: UncleWetnaps folded before Flop (didn't bet)


*********** # 80 **************
PokerStars Hand #169560782067: Tournament #1597684117, $4.55+$0.45 USD =
Hold'em No Limit - Level XIV (400/800) - 2017/05/07 22:12:53 ET
Table '1597684117 6' 9-max Seat #4 is the button
Seat 1: Rendgz1234 (7160 in chips)=20
Seat 3: SammyN109 (22992 in chips)=20
Seat 4: JerseyGuy316 (6630 in chips)=20
Seat 5: DaMiJKoNtRoL (56744 in chips)=20
Seat 6: paynowplz (15320 in chips)=20
Seat 7: hockingjoe (12600 in chips)=20
Seat 8: JJin91 (12351 in chips)=20
Seat 9: UncleWetnaps (6270 in chips)=20
Rendgz1234: posts the ante 100
SammyN109: posts the ante 100
JerseyGuy316: posts the ante 100
DaMiJKoNtRoL: posts the ante 100
paynowplz: posts the ante 100
hockingjoe: posts the ante 100
JJin91: posts the ante 100
UncleWetnaps: posts the ante 100
DaMiJKoNtRoL: posts small blind 400
paynowplz: posts big blind 800
*** HOLE CARDS ***
Dealt to JJin91 [2h Jd]
hockingjoe: folds=20
JJin91: folds=20
UncleWetnaps: calls 800
Rendgz1234: folds=20
SammyN109: folds=20
JerseyGuy316: folds=20
DaMiJKoNtRoL: folds=20
paynowplz: checks=20
*** FLOP *** [Kd Kh 4d]
paynowplz: checks=20
UncleWetnaps: bets 1600
paynowplz: folds=20
Uncalled bet (1600) returned to UncleWetnaps
UncleWetnaps collected 2800 from pot
UncleWetnaps: doesn't show hand=20
*** SUMMARY ***
Total pot 2800 | Rake 0=20
Board [Kd Kh 4d]
Seat 1: Rendgz1234 folded before Flop (didn't bet)
Seat 3: SammyN109 folded before Flop (didn't bet)
Seat 4: JerseyGuy316 (button) folded before Flop (didn't bet)
Seat 5: DaMiJKoNtRoL (small blind) folded before Flop
Seat 6: paynowplz (big blind) folded on the Flop
Seat 7: hockingjoe folded before Flop (didn't bet)
Seat 8: JJin91 folded before Flop (didn't bet)
Seat 9: UncleWetnaps collected (2800)


*********** # 81 **************
PokerStars Hand #169560782204: Tournament #1597684117, $4.55+$0.45 USD =
Hold'em No Limit - Level XIV (400/800) - 2017/05/07 22:13:15 ET
Table '1597684117 6' 9-max Seat #5 is the button
Seat 1: Rendgz1234 (7060 in chips)=20
Seat 3: SammyN109 (22892 in chips)=20
Seat 4: JerseyGuy316 (6530 in chips)=20
Seat 5: DaMiJKoNtRoL (56244 in chips)=20
Seat 6: paynowplz (14420 in chips)=20
Seat 7: hockingjoe (12500 in chips)=20
Seat 8: JJin91 (12251 in chips)=20
Seat 9: UncleWetnaps (8170 in chips)=20
Rendgz1234: posts the ante 100
SammyN109: posts the ante 100
JerseyGuy316: posts the ante 100
DaMiJKoNtRoL: posts the ante 100
paynowplz: posts the ante 100
hockingjoe: posts the ante 100
JJin91: posts the ante 100
UncleWetnaps: posts the ante 100
paynowplz: posts small blind 400
hockingjoe: posts big blind 800
*** HOLE CARDS ***
Dealt to JJin91 [3d 7h]
JJin91: folds=20
UncleWetnaps: folds=20
Rendgz1234: folds=20
SammyN109: folds=20
JerseyGuy316: calls 800
DaMiJKoNtRoL: calls 800
paynowplz: calls 400
hockingjoe: checks=20
*** FLOP *** [7c 9h 9d]
paynowplz: checks=20
hockingjoe: checks=20
JerseyGuy316: bets 800
DaMiJKoNtRoL: folds=20
paynowplz: folds=20
hockingjoe: raises 2400 to 3200
JerseyGuy316: folds=20
Uncalled bet (2400) returned to hockingjoe
hockingjoe collected 5600 from pot
hockingjoe: doesn't show hand=20
*** SUMMARY ***
Total pot 5600 | Rake 0=20
Board [7c 9h 9d]
Seat 1: Rendgz1234 folded before Flop (didn't bet)
Seat 3: SammyN109 folded before Flop (didn't bet)
Seat 4: JerseyGuy316 folded on the Flop
Seat 5: DaMiJKoNtRoL (button) folded on the Flop
Seat 6: paynowplz (small blind) folded on the Flop
Seat 7: hockingjoe (big blind) collected (5600)
Seat 8: JJin91 folded before Flop (didn't bet)
Seat 9: UncleWetnaps folded before Flop (didn't bet)


*********** # 82 **************
PokerStars Hand #169560782464: Tournament #1597684117, $4.55+$0.45 USD =
Hold'em No Limit - Level XIV (400/800) - 2017/05/07 22:13:59 ET
Table '1597684117 6' 9-max Seat #6 is the button
Seat 1: Rendgz1234 (6960 in chips)=20
Seat 3: SammyN109 (22792 in chips)=20
Seat 4: JerseyGuy316 (4830 in chips)=20
Seat 5: DaMiJKoNtRoL (55344 in chips)=20
Seat 6: paynowplz (13520 in chips)=20
Seat 7: hockingjoe (16400 in chips)=20
Seat 8: JJin91 (12151 in chips)=20
Seat 9: UncleWetnaps (8070 in chips)=20
Rendgz1234: posts the ante 100
SammyN109: posts the ante 100
JerseyGuy316: posts the ante 100
DaMiJKoNtRoL: posts the ante 100
paynowplz: posts the ante 100
hockingjoe: posts the ante 100
JJin91: posts the ante 100
UncleWetnaps: posts the ante 100
hockingjoe: posts small blind 400
JJin91: posts big blind 800
*** HOLE CARDS ***
Dealt to JJin91 [7s 7c]
UncleWetnaps: raises 800 to 1600
Rendgz1234: calls 1600
SammyN109: raises 800 to 2400
JerseyGuy316: folds=20
DaMiJKoNtRoL: folds=20
paynowplz: folds=20
hockingjoe: folds=20
JJin91: calls 1600
UncleWetnaps: calls 800
Rendgz1234: calls 800
*** FLOP *** [7d Ks 4s]
JJin91: checks=20
UncleWetnaps: bets 800
Rendgz1234: raises 800 to 1600
SammyN109: calls 1600
JJin91: raises 8051 to 9651 and is all-in
UncleWetnaps: folds=20
Rendgz1234: calls 2860 and is all-in
SammyN109: folds=20
Uncalled bet (5191) returned to JJin91
*** TURN *** [7d Ks 4s] [8h]
*** RIVER *** [7d Ks 4s 8h] [5d]
*** SHOW DOWN ***
JJin91: shows [7s 7c] (three of a kind, Sevens)
Rendgz1234: shows [Kd Qh] (a pair of Kings)
JJin91 collected 22120 from pot
Rendgz1234 finished the tournament in 45th place
*** SUMMARY ***
Total pot 22120 | Rake 0=20
Board [7d Ks 4s 8h 5d]
Seat 1: Rendgz1234 showed [Kd Qh] and lost with a pair of Kings
Seat 3: SammyN109 folded on the Flop
Seat 4: JerseyGuy316 folded before Flop (didn't bet)
Seat 5: DaMiJKoNtRoL folded before Flop (didn't bet)
Seat 6: paynowplz (button) folded before Flop (didn't bet)
Seat 7: hockingjoe (small blind) folded before Flop
Seat 8: JJin91 (big blind) showed [7s 7c] and won (22120) with three of=
 a kind, Sevens
Seat 9: UncleWetnaps folded on the Flop


*********** # 83 **************
PokerStars Hand #169560782886: Tournament #1597684117, $4.55+$0.45 USD =
Hold'em No Limit - Level XIV (400/800) - 2017/05/07 22:15:12 ET
Table '1597684117 6' 9-max Seat #7 is the button
Seat 2: justin66lee (40567 in chips)=20
Seat 3: SammyN109 (18692 in chips)=20
Seat 4: JerseyGuy316 (4730 in chips)=20
Seat 5: DaMiJKoNtRoL (55244 in chips)=20
Seat 6: paynowplz (13420 in chips)=20
Seat 7: hockingjoe (15900 in chips)=20
Seat 8: JJin91 (27311 in chips)=20
Seat 9: UncleWetnaps (4770 in chips)=20
justin66lee: posts the ante 100
SammyN109: posts the ante 100
JerseyGuy316: posts the ante 100
DaMiJKoNtRoL: posts the ante 100
paynowplz: posts the ante 100
hockingjoe: posts the ante 100
JJin91: posts the ante 100
UncleWetnaps: posts the ante 100
JJin91: posts small blind 400
UncleWetnaps: posts big blind 800
*** HOLE CARDS ***
Dealt to JJin91 [4s 4d]
justin66lee has timed out
justin66lee: folds=20
justin66lee is sitting out
SammyN109: calls 800
JerseyGuy316: calls 800
DaMiJKoNtRoL: folds=20
paynowplz: folds=20
hockingjoe: folds=20
JJin91: calls 400
justin66lee has returned
UncleWetnaps: raises 3870 to 4670 and is all-in
SammyN109: calls 3870
JerseyGuy316: folds=20
JJin91: calls 3870
*** FLOP *** [5s 8h 2d]
JJin91: checks=20
SammyN109: checks=20
*** TURN *** [5s 8h 2d] [9d]
JJin91: checks=20
SammyN109: bets 1600
JJin91: calls 1600
*** RIVER *** [5s 8h 2d 9d] [Ad]
JJin91: checks=20
SammyN109: bets 4800
JJin91: folds=20
Uncalled bet (4800) returned to SammyN109
*** SHOW DOWN ***
SammyN109: shows [Ah 9c] (two pair, Aces and Nines)
SammyN109 collected 3200 from side pot
UncleWetnaps: shows [Ts As] (a pair of Aces)
SammyN109 collected 15610 from main pot
UncleWetnaps finished the tournament in 44th place
*** SUMMARY ***
Total pot 18810 Main pot 15610. Side pot 3200. | Rake 0=20
Board [5s 8h 2d 9d Ad]
Seat 2: justin66lee folded before Flop (didn't bet)
Seat 3: SammyN109 showed [Ah 9c] and won (18810) with two pair, Aces an=
d Nines
Seat 4: JerseyGuy316 folded before Flop
Seat 5: DaMiJKoNtRoL folded before Flop (didn't bet)
Seat 6: paynowplz folded before Flop (didn't bet)
Seat 7: hockingjoe (button) folded before Flop (didn't bet)
Seat 8: JJin91 (small blind) folded on the River
Seat 9: UncleWetnaps (big blind) showed [Ts As] and lost with a pair of=
 Aces


*********** # 84 **************
PokerStars Hand #169560783337: Tournament #1597684117, $4.55+$0.45 USD =
Hold'em No Limit - Level XIV (400/800) - 2017/05/07 22:16:32 ET
Table '1597684117 6' 9-max Seat #8 is the button
Seat 2: justin66lee (40467 in chips)=20
Seat 3: SammyN109 (31132 in chips)=20
Seat 4: JerseyGuy316 (3830 in chips)=20
Seat 5: DaMiJKoNtRoL (55144 in chips)=20
Seat 6: paynowplz (13320 in chips)=20
Seat 7: hockingjoe (15800 in chips)=20
Seat 8: JJin91 (20941 in chips)=20
Seat 9: TrademarkTer (17055 in chips) out of hand (moved from another t=
able into small blind)
justin66lee: posts the ante 100
SammyN109: posts the ante 100
JerseyGuy316: posts the ante 100
DaMiJKoNtRoL: posts the ante 100
paynowplz: posts the ante 100
hockingjoe: posts the ante 100
JJin91: posts the ante 100
justin66lee: posts small blind 400
SammyN109: posts big blind 800
*** HOLE CARDS ***
Dealt to JJin91 [7c 4d]
JerseyGuy316: folds=20
DaMiJKoNtRoL: folds=20
paynowplz: folds=20
hockingjoe: folds=20
JJin91: folds=20
justin66lee: calls 400
SammyN109: checks=20
*** FLOP *** [5s 3d Th]
justin66lee: bets 800
SammyN109: raises 800 to 1600
justin66lee: folds=20
Uncalled bet (800) returned to SammyN109
SammyN109 collected 3900 from pot
*** SUMMARY ***
Total pot 3900 | Rake 0=20
Board [5s 3d Th]
Seat 2: justin66lee (small blind) folded on the Flop
Seat 3: SammyN109 (big blind) collected (3900)
Seat 4: JerseyGuy316 folded before Flop (didn't bet)
Seat 5: DaMiJKoNtRoL folded before Flop (didn't bet)
Seat 6: paynowplz folded before Flop (didn't bet)
Seat 7: hockingjoe folded before Flop (didn't bet)
Seat 8: JJin91 (button) folded before Flop (didn't bet)


*********** # 85 **************
PokerStars Hand #169560783462: Tournament #1597684117, $4.55+$0.45 USD =
Hold'em No Limit - Level XV (500/1000) - 2017/05/07 22:16:53 ET
Table '1597684117 6' 9-max Seat #2 is the button
Seat 2: justin66lee (38767 in chips)=20
Seat 3: SammyN109 (33332 in chips)=20
Seat 4: JerseyGuy316 (3730 in chips)=20
Seat 5: DaMiJKoNtRoL (55044 in chips)=20
Seat 6: paynowplz (13220 in chips)=20
Seat 7: hockingjoe (15700 in chips)=20
Seat 8: JJin91 (20841 in chips)=20
Seat 9: TrademarkTer (17055 in chips)=20
justin66lee: posts the ante 125
SammyN109: posts the ante 125
JerseyGuy316: posts the ante 125
DaMiJKoNtRoL: posts the ante 125
paynowplz: posts the ante 125
hockingjoe: posts the ante 125
JJin91: posts the ante 125
TrademarkTer: posts the ante 125
SammyN109: posts small blind 500
JerseyGuy316: posts big blind 1000
*** HOLE CARDS ***
Dealt to JJin91 [Js Ts]
DaMiJKoNtRoL: folds=20
paynowplz: folds=20
hockingjoe: raises 2000 to 3000
JJin91: folds=20
TrademarkTer: folds=20
justin66lee: calls 3000
SammyN109: calls 2500
JerseyGuy316: folds=20
*** FLOP *** [8c Ac 4c]
SammyN109: checks=20
hockingjoe: bets 12575 and is all-in
justin66lee: calls 12575
SammyN109: folds=20
*** TURN *** [8c Ac 4c] [4s]
*** RIVER *** [8c Ac 4c 4s] [4d]
*** SHOW DOWN ***
hockingjoe: shows [Ad Ah] (a full house, Aces full of Fours)
justin66lee: shows [Jh Kc] (three of a kind, Fours)
hockingjoe collected 36150 from pot
*** SUMMARY ***
Total pot 36150 | Rake 0=20
Board [8c Ac 4c 4s 4d]
Seat 2: justin66lee (button) showed [Jh Kc] and lost with three of a ki=
nd, Fours
Seat 3: SammyN109 (small blind) folded on the Flop
Seat 4: JerseyGuy316 (big blind) folded before Flop
Seat 5: DaMiJKoNtRoL folded before Flop (didn't bet)
Seat 6: paynowplz folded before Flop (didn't bet)
Seat 7: hockingjoe showed [Ad Ah] and won (36150) with a full house, Ac=
es full of Fours
Seat 8: JJin91 folded before Flop (didn't bet)
Seat 9: TrademarkTer folded before Flop (didn't bet)


*********** # 86 **************
PokerStars Hand #169560783772: Tournament #1597684117, $4.55+$0.45 USD =
Hold'em No Limit - Level XV (500/1000) - 2017/05/07 22:17:50 ET
Table '1597684117 6' 9-max Seat #3 is the button
Seat 2: justin66lee (23067 in chips)=20
Seat 3: SammyN109 (30207 in chips)=20
Seat 4: JerseyGuy316 (2605 in chips)=20
Seat 5: DaMiJKoNtRoL (54919 in chips)=20
Seat 6: paynowplz (13095 in chips)=20
Seat 7: hockingjoe (36150 in chips)=20
Seat 8: JJin91 (20716 in chips)=20
Seat 9: TrademarkTer (16930 in chips)=20
justin66lee: posts the ante 125
SammyN109: posts the ante 125
JerseyGuy316: posts the ante 125
DaMiJKoNtRoL: posts the ante 125
paynowplz: posts the ante 125
hockingjoe: posts the ante 125
JJin91: posts the ante 125
TrademarkTer: posts the ante 125
JerseyGuy316: posts small blind 500
DaMiJKoNtRoL: posts big blind 1000
*** HOLE CARDS ***
Dealt to JJin91 [Th Kh]
paynowplz: raises 1750 to 2750
hockingjoe: raises 33275 to 36025 and is all-in
JJin91: folds=20
TrademarkTer: calls 16805 and is all-in
justin66lee: folds=20
SammyN109: folds=20
JerseyGuy316: folds=20
DaMiJKoNtRoL: folds=20
paynowplz: folds=20
Uncalled bet (19220) returned to hockingjoe
*** FLOP *** [4c 8h Js]
*** TURN *** [4c 8h Js] [9d]
TrademarkTer said, "ace!"
*** RIVER *** [4c 8h Js 9d] [5d]
*** SHOW DOWN ***
hockingjoe: shows [Ks Kd] (a pair of Kings)
TrademarkTer: shows [Qc As] (high card Ace)
hockingjoe collected 38860 from pot
TrademarkTer finished the tournament in 41st place
*** SUMMARY ***
Total pot 38860 | Rake 0=20
Board [4c 8h Js 9d 5d]
Seat 2: justin66lee folded before Flop (didn't bet)
Seat 3: SammyN109 (button) folded before Flop (didn't bet)
Seat 4: JerseyGuy316 (small blind) folded before Flop
Seat 5: DaMiJKoNtRoL (big blind) folded before Flop
Seat 6: paynowplz folded before Flop
Seat 7: hockingjoe showed [Ks Kd] and won (38860) with a pair of Kings
Seat 8: JJin91 folded before Flop (didn't bet)
Seat 9: TrademarkTer showed [Qc As] and lost with high card Ace


*********** # 87 **************
PokerStars Hand #169560783957: Tournament #1597684117, $4.55+$0.45 USD =
Hold'em No Limit - Level XV (500/1000) - 2017/05/07 22:18:24 ET
Table '1597684117 6' 9-max Seat #4 is the button
Seat 2: justin66lee (22942 in chips)=20
Seat 3: SammyN109 (30082 in chips)=20
Seat 4: JerseyGuy316 (1980 in chips)=20
Seat 5: DaMiJKoNtRoL (53794 in chips)=20
Seat 6: paynowplz (10220 in chips)=20
Seat 7: hockingjoe (58080 in chips)=20
Seat 8: JJin91 (20591 in chips)=20
justin66lee: posts the ante 125
SammyN109: posts the ante 125
JerseyGuy316: posts the ante 125
DaMiJKoNtRoL: posts the ante 125
paynowplz: posts the ante 125
hockingjoe: posts the ante 125
JJin91: posts the ante 125
DaMiJKoNtRoL: posts small blind 500
paynowplz: posts big blind 1000
*** HOLE CARDS ***
Dealt to JJin91 [Tc Th]
hockingjoe: calls 1000
JJin91: raises 3000 to 4000
justin66lee: raises 18817 to 22817 and is all-in
SammyN109: folds=20
JerseyGuy316: folds=20
DaMiJKoNtRoL: folds=20
paynowplz: folds=20
hockingjoe: folds=20
JJin91: calls 16466 and is all-in
Uncalled bet (2351) returned to justin66lee
*** FLOP *** [Jh Kh Qs]
*** TURN *** [Jh Kh Qs] [4d]
*** RIVER *** [Jh Kh Qs 4d] [Kd]
*** SHOW DOWN ***
JJin91: shows [Tc Th] (two pair, Kings and Tens)
justin66lee: shows [9s 9h] (two pair, Kings and Nines)
JJin91 collected 44307 from pot
*** SUMMARY ***
Total pot 44307 | Rake 0=20
Board [Jh Kh Qs 4d Kd]
Seat 2: justin66lee showed [9s 9h] and lost with two pair, Kings and Ni=
nes
Seat 3: SammyN109 folded before Flop (didn't bet)
Seat 4: JerseyGuy316 (button) folded before Flop (didn't bet)
Seat 5: DaMiJKoNtRoL (small blind) folded before Flop
Seat 6: paynowplz (big blind) folded before Flop
Seat 7: hockingjoe folded before Flop
Seat 8: JJin91 showed [Tc Th] and won (44307) with two pair, Kings and =
Tens


*********** # 88 **************
PokerStars Hand #169560784151: Tournament #1597684117, $4.55+$0.45 USD =
Hold'em No Limit - Level XV (500/1000) - 2017/05/07 22:19:01 ET
Table '1597684117 6' 9-max Seat #5 is the button
Seat 2: justin66lee (2351 in chips)=20
Seat 3: SammyN109 (29957 in chips)=20
Seat 4: JerseyGuy316 (1855 in chips)=20
Seat 5: DaMiJKoNtRoL (53169 in chips)=20
Seat 6: paynowplz (9095 in chips)=20
Seat 7: hockingjoe (56955 in chips)=20
Seat 8: JJin91 (44307 in chips)=20
justin66lee: posts the ante 125
SammyN109: posts the ante 125
JerseyGuy316: posts the ante 125
DaMiJKoNtRoL: posts the ante 125
paynowplz: posts the ante 125
hockingjoe: posts the ante 125
JJin91: posts the ante 125
paynowplz: posts small blind 500
hockingjoe: posts big blind 1000
*** HOLE CARDS ***
Dealt to JJin91 [Ac 3h]
JJin91: folds=20
justin66lee: raises 1226 to 2226 and is all-in
SammyN109: folds=20
JerseyGuy316: folds=20
DaMiJKoNtRoL: folds=20
paynowplz: folds=20
hockingjoe: calls 1226
*** FLOP *** [6s 2s Kd]
*** TURN *** [6s 2s Kd] [5h]
*** RIVER *** [6s 2s Kd 5h] [9s]
*** SHOW DOWN ***
hockingjoe: shows [Ad 2c] (a pair of Deuces)
justin66lee: shows [Kc Jh] (a pair of Kings)
justin66lee collected 5827 from pot
*** SUMMARY ***
Total pot 5827 | Rake 0=20
Board [6s 2s Kd 5h 9s]
Seat 2: justin66lee showed [Kc Jh] and won (5827) with a pair of Kings
Seat 3: SammyN109 folded before Flop (didn't bet)
Seat 4: JerseyGuy316 folded before Flop (didn't bet)
Seat 5: DaMiJKoNtRoL (button) folded before Flop (didn't bet)
Seat 6: paynowplz (small blind) folded before Flop
Seat 7: hockingjoe (big blind) showed [Ad 2c] and lost with a pair of D=
euces
Seat 8: JJin91 folded before Flop (didn't bet)


*********** # 89 **************
PokerStars Hand #169560784280: Tournament #1597684117, $4.55+$0.45 USD =
Hold'em No Limit - Level XV (500/1000) - 2017/05/07 22:19:24 ET
Table '1597684117 6' 9-max Seat #6 is the button
Seat 2: justin66lee (5827 in chips)=20
Seat 3: SammyN109 (29832 in chips)=20
Seat 4: JerseyGuy316 (1730 in chips)=20
Seat 5: DaMiJKoNtRoL (53044 in chips)=20
Seat 6: paynowplz (8470 in chips)=20
Seat 7: hockingjoe (54604 in chips)=20
Seat 8: JJin91 (44182 in chips)=20
justin66lee: posts the ante 125
SammyN109: posts the ante 125
JerseyGuy316: posts the ante 125
DaMiJKoNtRoL: posts the ante 125
paynowplz: posts the ante 125
hockingjoe: posts the ante 125
JJin91: posts the ante 125
hockingjoe: posts small blind 500
JJin91: posts big blind 1000
*** HOLE CARDS ***
Dealt to JJin91 [6d 9h]
justin66lee: folds=20
SammyN109: calls 1000
JerseyGuy316: raises 605 to 1605 and is all-in
DaMiJKoNtRoL: folds=20
paynowplz: folds=20
hockingjoe: raises 1395 to 3000
JJin91: folds=20
SammyN109: calls 2000
*** FLOP *** [2s Kd Qh]
hockingjoe: bets 9000
SammyN109: folds=20
Uncalled bet (9000) returned to hockingjoe
*** TURN *** [2s Kd Qh] [6h]
*** RIVER *** [2s Kd Qh 6h] [Th]
*** SHOW DOWN ***
hockingjoe: shows [Ac Qd] (a pair of Queens)
hockingjoe collected 2790 from side pot
JerseyGuy316: shows [5h Ks] (a pair of Kings)
JerseyGuy316 collected 6690 from main pot
*** SUMMARY ***
Total pot 9480 Main pot 6690. Side pot 2790. | Rake 0=20
Board [2s Kd Qh 6h Th]
Seat 2: justin66lee folded before Flop (didn't bet)
Seat 3: SammyN109 folded on the Flop
Seat 4: JerseyGuy316 showed [5h Ks] and won (6690) with a pair of Kings
Seat 5: DaMiJKoNtRoL folded before Flop (didn't bet)
Seat 6: paynowplz (button) folded before Flop (didn't bet)
Seat 7: hockingjoe (small blind) showed [Ac Qd] and won (2790) with a p=
air of Queens
Seat 8: JJin91 (big blind) folded before Flop


*********** # 90 **************
PokerStars Hand #169560784482: Tournament #1597684117, $4.55+$0.45 USD =
Hold'em No Limit - Level XV (500/1000) - 2017/05/07 22:20:01 ET
Table '1597684117 6' 9-max Seat #7 is the button
Seat 2: justin66lee (5702 in chips)=20
Seat 3: SammyN109 (26707 in chips)=20
Seat 4: JerseyGuy316 (6690 in chips)=20
Seat 5: DaMiJKoNtRoL (52919 in chips)=20
Seat 6: paynowplz (8345 in chips)=20
Seat 7: hockingjoe (54269 in chips)=20
Seat 8: JJin91 (43057 in chips)=20
justin66lee: posts the ante 125
SammyN109: posts the ante 125
JerseyGuy316: posts the ante 125
DaMiJKoNtRoL: posts the ante 125
paynowplz: posts the ante 125
hockingjoe: posts the ante 125
JJin91: posts the ante 125
JJin91: posts small blind 500
justin66lee: posts big blind 1000
*** HOLE CARDS ***
Dealt to JJin91 [Js Qs]
SammyN109: folds=20
JerseyGuy316: raises 5565 to 6565 and is all-in
DaMiJKoNtRoL: folds=20
paynowplz: raises 1655 to 8220 and is all-in
hockingjoe: folds=20
JJin91: folds=20
justin66lee: folds=20
Uncalled bet (1655) returned to paynowplz
*** FLOP *** [Jd Th 6c]
*** TURN *** [Jd Th 6c] [3c]
*** RIVER *** [Jd Th 6c 3c] [7d]
*** SHOW DOWN ***
JerseyGuy316: shows [9d 9s] (a pair of Nines)
paynowplz: shows [Qd Ac] (high card Ace)
JerseyGuy316 collected 15505 from pot
*** SUMMARY ***
Total pot 15505 | Rake 0=20
Board [Jd Th 6c 3c 7d]
Seat 2: justin66lee (big blind) folded before Flop
Seat 3: SammyN109 folded before Flop (didn't bet)
Seat 4: JerseyGuy316 showed [9d 9s] and won (15505) with a pair of Nines
Seat 5: DaMiJKoNtRoL folded before Flop (didn't bet)
Seat 6: paynowplz showed [Qd Ac] and lost with high card Ace
Seat 7: hockingjoe (button) folded before Flop (didn't bet)
Seat 8: JJin91 (small blind) folded before Flop


*********** # 91 **************
PokerStars Hand #169560784581: Tournament #1597684117, $4.55+$0.45 USD =
Hold'em No Limit - Level XV (500/1000) - 2017/05/07 22:20:22 ET
Table '1597684117 6' 9-max Seat #8 is the button
Seat 2: justin66lee (4577 in chips)=20
Seat 3: SammyN109 (26582 in chips)=20
Seat 4: JerseyGuy316 (15505 in chips)=20
Seat 5: DaMiJKoNtRoL (52794 in chips)=20
Seat 6: paynowplz (1655 in chips)=20
Seat 7: hockingjoe (54144 in chips)=20
Seat 8: JJin91 (42432 in chips)=20
justin66lee: posts the ante 125
SammyN109: posts the ante 125
JerseyGuy316: posts the ante 125
DaMiJKoNtRoL: posts the ante 125
paynowplz: posts the ante 125
hockingjoe: posts the ante 125
JJin91: posts the ante 125
justin66lee: posts small blind 500
SammyN109: posts big blind 1000
*** HOLE CARDS ***
Dealt to JJin91 [2c Js]
JerseyGuy316: folds=20
DaMiJKoNtRoL: folds=20
paynowplz: raises 530 to 1530 and is all-in
hockingjoe: calls 1530
JJin91: folds=20
justin66lee: calls 1030
SammyN109: calls 530
*** FLOP *** [Qc Th 3c]
justin66lee: checks=20
SammyN109: checks=20
hockingjoe: checks=20
*** TURN *** [Qc Th 3c] [3d]
justin66lee: checks=20
SammyN109: checks=20
hockingjoe: checks=20
*** RIVER *** [Qc Th 3c 3d] [Jd]
justin66lee: checks=20
SammyN109: checks=20
hockingjoe: checks=20
*** SHOW DOWN ***
justin66lee: shows [9h 7h] (a pair of Threes)
SammyN109: shows [6s 8h] (a pair of Threes)
paynowplz: shows [Ad 5c] (a pair of Threes - Ace kicker)
hockingjoe: shows [2s 2h] (two pair, Threes and Deuces)
hockingjoe collected 6995 from pot
paynowplz finished the tournament in 37th place
*** SUMMARY ***
Total pot 6995 | Rake 0=20
Board [Qc Th 3c 3d Jd]
Seat 2: justin66lee (small blind) showed [9h 7h] and lost with a pair o=
f Threes
Seat 3: SammyN109 (big blind) showed [6s 8h] and lost with a pair of Th=
rees
Seat 4: JerseyGuy316 folded before Flop (didn't bet)
Seat 5: DaMiJKoNtRoL folded before Flop (didn't bet)
Seat 6: paynowplz showed [Ad 5c] and lost with a pair of Threes
Seat 7: hockingjoe showed [2s 2h] and won (6995) with two pair, Threes =
and Deuces
Seat 8: JJin91 (button) folded before Flop (didn't bet)


*********** # 92 **************
PokerStars Hand #169560784854: Tournament #1597684117, $4.55+$0.45 USD =
Hold'em No Limit - Level XV (500/1000) - 2017/05/07 22:21:10 ET
Table '1597684117 1' 9-max Seat #9 is the button
Seat 1: seedload (20150 in chips)=20
Seat 2: JJin91 (42307 in chips)=20
Seat 3: CerPrisingLe (49476 in chips)=20
Seat 4: pokermsrt2 (13750 in chips)=20
Seat 5: ThePhenom508 (1617 in chips) is sitting out
Seat 6: xNEMESISx04 (15181 in chips)=20
Seat 7: SammyN109 (24927 in chips)=20
Seat 8: panth26 (43108 in chips)=20
Seat 9: RedHungryHip (24093 in chips)=20
seedload: posts the ante 125
JJin91: posts the ante 125
CerPrisingLe: posts the ante 125
pokermsrt2: posts the ante 125
ThePhenom508: posts the ante 125
xNEMESISx04: posts the ante 125
SammyN109: posts the ante 125
panth26: posts the ante 125
RedHungryHip: posts the ante 125
seedload: posts small blind 500
JJin91: posts big blind 1000
*** HOLE CARDS ***
Dealt to JJin91 [Ad 4c]
CerPrisingLe: folds=20
pokermsrt2: raises 12625 to 13625 and is all-in
ThePhenom508: folds=20
xNEMESISx04: folds=20
SammyN109: folds=20
panth26: folds=20
RedHungryHip: folds=20
seedload: folds=20
JJin91: folds=20
Uncalled bet (12625) returned to pokermsrt2
pokermsrt2 collected 3625 from pot
pokermsrt2: doesn't show hand=20
*** SUMMARY ***
Total pot 3625 | Rake 0=20
Seat 1: seedload (small blind) folded before Flop
Seat 2: JJin91 (big blind) folded before Flop
Seat 3: CerPrisingLe folded before Flop (didn't bet)
Seat 4: pokermsrt2 collected (3625)
Seat 5: ThePhenom508 folded before Flop (didn't bet)
Seat 6: xNEMESISx04 folded before Flop (didn't bet)
Seat 7: SammyN109 folded before Flop (didn't bet)
Seat 8: panth26 folded before Flop (didn't bet)
Seat 9: RedHungryHip (button) folded before Flop (didn't bet)


*********** # 93 **************
PokerStars Hand #169560785074: Tournament #1597684117, $4.55+$0.45 USD =
Hold'em No Limit - Level XVI (600/1200) - 2017/05/07 22:21:51 ET
Table '1597684117 1' 9-max Seat #1 is the button
Seat 1: seedload (19525 in chips)=20
Seat 2: JJin91 (41182 in chips)=20
Seat 3: CerPrisingLe (49351 in chips)=20
Seat 4: pokermsrt2 (16250 in chips)=20
Seat 5: ThePhenom508 (1492 in chips) is sitting out
Seat 6: xNEMESISx04 (15056 in chips)=20
Seat 7: SammyN109 (24802 in chips)=20
Seat 8: panth26 (42983 in chips)=20
Seat 9: RedHungryHip (23968 in chips)=20
seedload: posts the ante 150
JJin91: posts the ante 150
CerPrisingLe: posts the ante 150
pokermsrt2: posts the ante 150
ThePhenom508: posts the ante 150
xNEMESISx04: posts the ante 150
SammyN109: posts the ante 150
panth26: posts the ante 150
RedHungryHip: posts the ante 150
JJin91: posts small blind 600
CerPrisingLe: posts big blind 1200
*** HOLE CARDS ***
Dealt to JJin91 [Jh 8c]
pokermsrt2: folds=20
ThePhenom508: folds=20
xNEMESISx04: raises 13706 to 14906 and is all-in
SammyN109: folds=20
panth26: folds=20
RedHungryHip: folds=20
seedload: folds=20
JJin91: folds=20
CerPrisingLe: folds=20
Uncalled bet (13706) returned to xNEMESISx04
xNEMESISx04 collected 4350 from pot
xNEMESISx04: doesn't show hand=20
*** SUMMARY ***
Total pot 4350 | Rake 0=20
Seat 1: seedload (button) folded before Flop (didn't bet)
Seat 2: JJin91 (small blind) folded before Flop
Seat 3: CerPrisingLe (big blind) folded before Flop
Seat 4: pokermsrt2 folded before Flop (didn't bet)
Seat 5: ThePhenom508 folded before Flop (didn't bet)
Seat 6: xNEMESISx04 collected (4350)
Seat 7: SammyN109 folded before Flop (didn't bet)
Seat 8: panth26 folded before Flop (didn't bet)
Seat 9: RedHungryHip folded before Flop (didn't bet)


*********** # 94 **************
PokerStars Hand #169560785182: Tournament #1597684117, $4.55+$0.45 USD =
Hold'em No Limit - Level XVI (600/1200) - 2017/05/07 22:22:12 ET
Table '1597684117 1' 9-max Seat #2 is the button
Seat 1: seedload (19375 in chips)=20
Seat 2: JJin91 (40432 in chips)=20
Seat 3: CerPrisingLe (48001 in chips)=20
Seat 4: pokermsrt2 (16100 in chips)=20
Seat 5: ThePhenom508 (1342 in chips) is sitting out
Seat 6: xNEMESISx04 (18056 in chips)=20
Seat 7: SammyN109 (24652 in chips)=20
Seat 8: panth26 (42833 in chips)=20
Seat 9: RedHungryHip (23818 in chips)=20
seedload: posts the ante 150
JJin91: posts the ante 150
CerPrisingLe: posts the ante 150
pokermsrt2: posts the ante 150
ThePhenom508: posts the ante 150
xNEMESISx04: posts the ante 150
SammyN109: posts the ante 150
panth26: posts the ante 150
RedHungryHip: posts the ante 150
CerPrisingLe: posts small blind 600
pokermsrt2: posts big blind 1200
*** HOLE CARDS ***
Dealt to JJin91 [7c 7d]
ThePhenom508: folds=20
xNEMESISx04: folds=20
SammyN109: folds=20
panth26: folds=20
RedHungryHip: folds=20
seedload: folds=20
JJin91: raises 2400 to 3600
CerPrisingLe: calls 3000
pokermsrt2: calls 2400
*** FLOP *** [2h 3c 9c]
CerPrisingLe: checks=20
pokermsrt2: checks=20
JJin91: bets 6000
CerPrisingLe: calls 6000
pokermsrt2: folds=20
*** TURN *** [2h 3c 9c] [Qs]
CerPrisingLe: checks=20
JJin91: checks=20
*** RIVER *** [2h 3c 9c Qs] [Js]
CerPrisingLe: checks=20
JJin91: bets 14400
CerPrisingLe: folds=20
Uncalled bet (14400) returned to JJin91
JJin91 collected 24150 from pot
*** SUMMARY ***
Total pot 24150 | Rake 0=20
Board [2h 3c 9c Qs Js]
Seat 1: seedload folded before Flop (didn't bet)
Seat 2: JJin91 (button) collected (24150)
Seat 3: CerPrisingLe (small blind) folded on the River
Seat 4: pokermsrt2 (big blind) folded on the Flop
Seat 5: ThePhenom508 folded before Flop (didn't bet)
Seat 6: xNEMESISx04 folded before Flop (didn't bet)
Seat 7: SammyN109 folded before Flop (didn't bet)
Seat 8: panth26 folded before Flop (didn't bet)
Seat 9: RedHungryHip folded before Flop (didn't bet)


*********** # 95 **************
PokerStars Hand #169560785553: Tournament #1597684117, $4.55+$0.45 USD =
Hold'em No Limit - Level XVI (600/1200) - 2017/05/07 22:23:19 ET
Table '1597684117 1' 9-max Seat #3 is the button
Seat 1: seedload (19225 in chips)=20
Seat 2: JJin91 (54832 in chips)=20
Seat 3: CerPrisingLe (38251 in chips)=20
Seat 4: pokermsrt2 (12350 in chips)=20
Seat 5: ThePhenom508 (1192 in chips) is sitting out
Seat 6: xNEMESISx04 (17906 in chips)=20
Seat 7: SammyN109 (24502 in chips)=20
Seat 8: panth26 (42683 in chips)=20
Seat 9: RedHungryHip (23668 in chips)=20
seedload: posts the ante 150
JJin91: posts the ante 150
CerPrisingLe: posts the ante 150
pokermsrt2: posts the ante 150
ThePhenom508: posts the ante 150
xNEMESISx04: posts the ante 150
SammyN109: posts the ante 150
panth26: posts the ante 150
RedHungryHip: posts the ante 150
pokermsrt2: posts small blind 600
ThePhenom508: posts big blind 1042 and is all-in
*** HOLE CARDS ***
Dealt to JJin91 [6s 4h]
xNEMESISx04: raises 2558 to 3600
SammyN109: folds=20
panth26: folds=20
RedHungryHip: folds=20
seedload: folds=20
JJin91: folds=20
CerPrisingLe: folds=20
pokermsrt2: raises 8600 to 12200 and is all-in
ThePhenom508: folds=20
xNEMESISx04: calls 8600
*** FLOP *** [Ad As 2d]
*** TURN *** [Ad As 2d] [Qd]
*** RIVER *** [Ad As 2d Qd] [5h]
*** SHOW DOWN ***
pokermsrt2: shows [Js Jh] (two pair, Aces and Jacks)
xNEMESISx04: shows [Ah Th] (three of a kind, Aces)
xNEMESISx04 collected 22316 from side pot
xNEMESISx04 collected 4476 from main pot
pokermsrt2 finished the tournament in 34th place
ThePhenom508 finished the tournament in 35th place
*** SUMMARY ***
Total pot 26792 Main pot 4476. Side pot 22316. | Rake 0=20
Board [Ad As 2d Qd 5h]
Seat 1: seedload folded before Flop (didn't bet)
Seat 2: JJin91 folded before Flop (didn't bet)
Seat 3: CerPrisingLe (button) folded before Flop (didn't bet)
Seat 4: pokermsrt2 (small blind) showed [Js Jh] and lost with two pair,=
 Aces and Jacks
Seat 5: ThePhenom508 (big blind) folded before Flop
Seat 6: xNEMESISx04 showed [Ah Th] and won (26792) with three of a kind=
, Aces
Seat 7: SammyN109 folded before Flop (didn't bet)
Seat 8: panth26 folded before Flop (didn't bet)
Seat 9: RedHungryHip folded before Flop (didn't bet)


*********** # 96 **************
PokerStars Hand #169560785755: Tournament #1597684117, $4.55+$0.45 USD =
Hold'em No Limit - Level XVI (600/1200) - 2017/05/07 22:23:54 ET
Table '1597684117 1' 9-max Seat #6 is the button
Seat 1: seedload (19075 in chips)=20
Seat 2: JJin91 (54682 in chips)=20
Seat 3: CerPrisingLe (38101 in chips)=20
Seat 6: xNEMESISx04 (32348 in chips)=20
Seat 7: SammyN109 (24352 in chips)=20
Seat 8: panth26 (42533 in chips)=20
Seat 9: RedHungryHip (23518 in chips)=20
seedload: posts the ante 150
JJin91: posts the ante 150
CerPrisingLe: posts the ante 150
xNEMESISx04: posts the ante 150
SammyN109: posts the ante 150
panth26: posts the ante 150
RedHungryHip: posts the ante 150
SammyN109: posts small blind 600
panth26: posts big blind 1200
*** HOLE CARDS ***
Dealt to JJin91 [2s Ts]
RedHungryHip: raises 1200 to 2400
seedload: folds=20
JJin91: folds=20
CerPrisingLe: folds=20
xNEMESISx04: folds=20
SammyN109: folds=20
panth26: calls 1200
*** FLOP *** [9s Ac Ah]
panth26: bets 3225
RedHungryHip: folds=20
Uncalled bet (3225) returned to panth26
panth26 collected 6450 from pot
panth26: doesn't show hand=20
*** SUMMARY ***
Total pot 6450 | Rake 0=20
Board [9s Ac Ah]
Seat 1: seedload folded before Flop (didn't bet)
Seat 2: JJin91 folded before Flop (didn't bet)
Seat 3: CerPrisingLe folded before Flop (didn't bet)
Seat 6: xNEMESISx04 (button) folded before Flop (didn't bet)
Seat 7: SammyN109 (small blind) folded before Flop
Seat 8: panth26 (big blind) collected (6450)
Seat 9: RedHungryHip folded on the Flop


*********** # 97 **************
PokerStars Hand #169560786135: Tournament #1597684117, $4.55+$0.45 USD =
Hold'em No Limit - Level XVI (600/1200) - 2017/05/07 22:25:06 ET
Table '1597684117 1' 9-max Seat #7 is the button
Seat 1: seedload (18925 in chips)=20
Seat 2: JJin91 (54532 in chips)=20
Seat 3: CerPrisingLe (37951 in chips)=20
Seat 4: LetsGoMets 6 (40000 in chips)=20
Seat 6: xNEMESISx04 (32198 in chips)=20
Seat 7: SammyN109 (23602 in chips)=20
Seat 8: panth26 (46433 in chips)=20
Seat 9: RedHungryHip (20968 in chips)=20
seedload: posts the ante 150
JJin91: posts the ante 150
CerPrisingLe: posts the ante 150
LetsGoMets 6: posts the ante 150
xNEMESISx04: posts the ante 150
SammyN109: posts the ante 150
panth26: posts the ante 150
RedHungryHip: posts the ante 150
panth26: posts small blind 600
RedHungryHip: posts big blind 1200
*** HOLE CARDS ***
Dealt to JJin91 [Ah 5s]
seedload: folds=20
JJin91: folds=20
CerPrisingLe: raises 1200 to 2400
LetsGoMets 6: folds=20
xNEMESISx04: calls 2400
SammyN109: folds=20
panth26: folds=20
RedHungryHip: folds=20
*** FLOP *** [2d Kd 4s]
CerPrisingLe: bets 3600
xNEMESISx04: calls 3600
*** TURN *** [2d Kd 4s] [5c]
CerPrisingLe: checks=20
xNEMESISx04: bets 4800
CerPrisingLe: folds=20
Uncalled bet (4800) returned to xNEMESISx04
xNEMESISx04 collected 15000 from pot
xNEMESISx04: doesn't show hand=20
*** SUMMARY ***
Total pot 15000 | Rake 0=20
Board [2d Kd 4s 5c]
Seat 1: seedload folded before Flop (didn't bet)
Seat 2: JJin91 folded before Flop (didn't bet)
Seat 3: CerPrisingLe folded on the Turn
Seat 4: LetsGoMets 6 folded before Flop (didn't bet)
Seat 6: xNEMESISx04 collected (15000)
Seat 7: SammyN109 (button) folded before Flop (didn't bet)
Seat 8: panth26 (small blind) folded before Flop
Seat 9: RedHungryHip (big blind) folded before Flop


*********** # 98 **************
PokerStars Hand #169560786375: Tournament #1597684117, $4.55+$0.45 USD =
Hold'em No Limit - Level XVI (600/1200) - 2017/05/07 22:25:51 ET
Table '1597684117 1' 9-max Seat #8 is the button
Seat 1: seedload (18775 in chips)=20
Seat 2: JJin91 (54382 in chips)=20
Seat 3: CerPrisingLe (31801 in chips)=20
Seat 4: LetsGoMets 6 (39850 in chips)=20
Seat 6: xNEMESISx04 (41048 in chips)=20
Seat 7: SammyN109 (23452 in chips)=20
Seat 8: panth26 (45683 in chips)=20
Seat 9: RedHungryHip (19618 in chips)=20
seedload: posts the ante 150
JJin91: posts the ante 150
CerPrisingLe: posts the ante 150
LetsGoMets 6: posts the ante 150
xNEMESISx04: posts the ante 150
SammyN109: posts the ante 150
panth26: posts the ante 150
RedHungryHip: posts the ante 150
RedHungryHip: posts small blind 600
seedload: posts big blind 1200
*** HOLE CARDS ***
Dealt to JJin91 [As 6h]
JJin91: folds=20
CerPrisingLe: folds=20
LetsGoMets 6: folds=20
xNEMESISx04: raises 1200 to 2400
SammyN109: calls 2400
panth26: folds=20
RedHungryHip: folds=20
seedload: raises 16225 to 18625 and is all-in
xNEMESISx04: folds=20
SammyN109: folds=20
Uncalled bet (16225) returned to seedload
seedload collected 9000 from pot
seedload: doesn't show hand=20
*** SUMMARY ***
Total pot 9000 | Rake 0=20
Seat 1: seedload (big blind) collected (9000)
Seat 2: JJin91 folded before Flop (didn't bet)
Seat 3: CerPrisingLe folded before Flop (didn't bet)
Seat 4: LetsGoMets 6 folded before Flop (didn't bet)
Seat 6: xNEMESISx04 folded before Flop
Seat 7: SammyN109 folded before Flop
Seat 8: panth26 (button) folded before Flop (didn't bet)
Seat 9: RedHungryHip (small blind) folded before Flop


*********** # 99 **************
PokerStars Hand #169560786619: Tournament #1597684117, $4.55+$0.45 USD =
Hold'em No Limit - Level XVII (700/1400) - 2017/05/07 22:26:34 ET
Table '1597684117 1' 9-max Seat #9 is the button
Seat 1: seedload (25225 in chips)=20
Seat 2: JJin91 (54232 in chips)=20
Seat 3: CerPrisingLe (31651 in chips)=20
Seat 4: LetsGoMets 6 (39700 in chips)=20
Seat 6: xNEMESISx04 (38498 in chips)=20
Seat 7: SammyN109 (20902 in chips)=20
Seat 8: panth26 (45533 in chips)=20
Seat 9: RedHungryHip (18868 in chips)=20
seedload: posts the ante 175
JJin91: posts the ante 175
CerPrisingLe: posts the ante 175
LetsGoMets 6: posts the ante 175
xNEMESISx04: posts the ante 175
SammyN109: posts the ante 175
panth26: posts the ante 175
RedHungryHip: posts the ante 175
seedload: posts small blind 700
JJin91: posts big blind 1400
*** HOLE CARDS ***
Dealt to JJin91 [7c 7s]
CerPrisingLe: folds=20
LetsGoMets 6: folds=20
xNEMESISx04: folds=20
SammyN109: calls 1400
panth26: folds=20
RedHungryHip: folds=20
seedload: folds=20
JJin91: checks=20
*** FLOP *** [Kh Js Kc]
JJin91: checks=20
SammyN109: bets 1400
JJin91: folds=20
Uncalled bet (1400) returned to SammyN109
SammyN109 collected 4900 from pot
*** SUMMARY ***
Total pot 4900 | Rake 0=20
Board [Kh Js Kc]
Seat 1: seedload (small blind) folded before Flop
Seat 2: JJin91 (big blind) folded on the Flop
Seat 3: CerPrisingLe folded before Flop (didn't bet)
Seat 4: LetsGoMets 6 folded before Flop (didn't bet)
Seat 6: xNEMESISx04 folded before Flop (didn't bet)
Seat 7: SammyN109 collected (4900)
Seat 8: panth26 folded before Flop (didn't bet)
Seat 9: RedHungryHip (button) folded before Flop (didn't bet)


*********** # 100 **************
PokerStars Hand #169560786764: Tournament #1597684117, $4.55+$0.45 USD =
Hold'em No Limit - Level XVII (700/1400) - 2017/05/07 22:26:59 ET
Table '1597684117 1' 9-max Seat #1 is the button
Seat 1: seedload (24350 in chips)=20
Seat 2: JJin91 (52657 in chips)=20
Seat 3: CerPrisingLe (31476 in chips)=20
Seat 4: LetsGoMets 6 (39525 in chips)=20
Seat 5: The Gabbagu (91271 in chips)=20
Seat 6: xNEMESISx04 (38323 in chips)=20
Seat 7: SammyN109 (24227 in chips)=20
Seat 8: panth26 (45358 in chips)=20
Seat 9: RedHungryHip (18693 in chips)=20
seedload: posts the ante 175
JJin91: posts the ante 175
CerPrisingLe: posts the ante 175
LetsGoMets 6: posts the ante 175
The Gabbagu: posts the ante 175
xNEMESISx04: posts the ante 175
SammyN109: posts the ante 175
panth26: posts the ante 175
RedHungryHip: posts the ante 175
JJin91: posts small blind 700
CerPrisingLe: posts big blind 1400
*** HOLE CARDS ***
Dealt to JJin91 [6d 8s]
LetsGoMets 6: raises 2000 to 3400
The Gabbagu: folds=20
xNEMESISx04: calls 3400
SammyN109: folds=20
panth26: raises 5640 to 9040
RedHungryHip: folds=20
seedload: folds=20
JJin91: folds=20
CerPrisingLe: folds=20
LetsGoMets 6: folds=20
xNEMESISx04: raises 29108 to 38148 and is all-in
panth26: calls 29108
*** FLOP *** [4s 8c 6c]
*** TURN *** [4s 8c 6c] [8d]
*** RIVER *** [4s 8c 6c 8d] [Ac]
*** SHOW DOWN ***
xNEMESISx04: shows [9c 9d] (two pair, Nines and Eights)
panth26: shows [Ks Ad] (two pair, Aces and Eights)
panth26 collected 83371 from pot
xNEMESISx04 finished the tournament in 27th place
*** SUMMARY ***
Total pot 83371 | Rake 0=20
Board [4s 8c 6c 8d Ac]
Seat 1: seedload (button) folded before Flop (didn't bet)
Seat 2: JJin91 (small blind) folded before Flop
Seat 3: CerPrisingLe (big blind) folded before Flop
Seat 4: LetsGoMets 6 folded before Flop
Seat 5: The Gabbagu folded before Flop (didn't bet)
Seat 6: xNEMESISx04 showed [9c 9d] and lost with two pair, Nines and Ei=
ghts
Seat 7: SammyN109 folded before Flop (didn't bet)
Seat 8: panth26 showed [Ks Ad] and won (83371) with two pair, Aces and =
Eights
Seat 9: RedHungryHip folded before Flop (didn't bet)


*********** # 101 **************
PokerStars Hand #169560787067: Tournament #1597684117, $4.55+$0.45 USD =
Hold'em No Limit - Level XVII (700/1400) - 2017/05/07 22:27:53 ET
Table '1597684117 1' 9-max Seat #2 is the button
Seat 1: seedload (24175 in chips)=20
Seat 2: JJin91 (51782 in chips)=20
Seat 3: CerPrisingLe (29901 in chips)=20
Seat 4: LetsGoMets 6 (35950 in chips)=20
Seat 5: The Gabbagu (91096 in chips)=20
Seat 7: SammyN109 (24052 in chips)=20
Seat 8: panth26 (90406 in chips)=20
Seat 9: RedHungryHip (18518 in chips)=20
seedload: posts the ante 175
JJin91: posts the ante 175
CerPrisingLe: posts the ante 175
LetsGoMets 6: posts the ante 175
The Gabbagu: posts the ante 175
SammyN109: posts the ante 175
panth26: posts the ante 175
RedHungryHip: posts the ante 175
CerPrisingLe: posts small blind 700
LetsGoMets 6: posts big blind 1400
*** HOLE CARDS ***
Dealt to JJin91 [Qh Jc]
The Gabbagu: folds=20
SammyN109: calls 1400
panth26: folds=20
RedHungryHip: raises 2800 to 4200
seedload: folds=20
JJin91: folds=20
CerPrisingLe: folds=20
LetsGoMets 6: folds=20
SammyN109: calls 2800
*** FLOP *** [Ad 7s 4c]
SammyN109: bets 19677 and is all-in
RedHungryHip: calls 14143 and is all-in
Uncalled bet (5534) returned to SammyN109
*** TURN *** [Ad 7s 4c] [Th]
*** RIVER *** [Ad 7s 4c Th] [7d]
*** SHOW DOWN ***
SammyN109: shows [Qd Td] (two pair, Tens and Sevens)
RedHungryHip: shows [Js Jh] (two pair, Jacks and Sevens)
RedHungryHip collected 40186 from pot
*** SUMMARY ***
Total pot 40186 | Rake 0=20
Board [Ad 7s 4c Th 7d]
Seat 1: seedload folded before Flop (didn't bet)
Seat 2: JJin91 (button) folded before Flop (didn't bet)
Seat 3: CerPrisingLe (small blind) folded before Flop
Seat 4: LetsGoMets 6 (big blind) folded before Flop
Seat 5: The Gabbagu folded before Flop (didn't bet)
Seat 7: SammyN109 showed [Qd Td] and lost with two pair, Tens and Sevens
Seat 8: panth26 folded before Flop (didn't bet)
Seat 9: RedHungryHip showed [Js Jh] and won (40186) with two pair, Jack=
s and Sevens


*********** # 102 **************
PokerStars Hand #169560787242: Tournament #1597684117, $4.55+$0.45 USD =
Hold'em No Limit - Level XVII (700/1400) - 2017/05/07 22:28:25 ET
Table '1597684117 1' 9-max Seat #3 is the button
Seat 1: seedload (24000 in chips)=20
Seat 2: JJin91 (51607 in chips)=20
Seat 3: CerPrisingLe (29026 in chips)=20
Seat 4: LetsGoMets 6 (34375 in chips)=20
Seat 5: The Gabbagu (90921 in chips)=20
Seat 7: SammyN109 (5534 in chips)=20
Seat 8: panth26 (90231 in chips)=20
Seat 9: RedHungryHip (40186 in chips)=20
seedload: posts the ante 175
JJin91: posts the ante 175
CerPrisingLe: posts the ante 175
LetsGoMets 6: posts the ante 175
The Gabbagu: posts the ante 175
SammyN109: posts the ante 175
panth26: posts the ante 175
RedHungryHip: posts the ante 175
LetsGoMets 6: posts small blind 700
The Gabbagu: posts big blind 1400
*** HOLE CARDS ***
Dealt to JJin91 [Ks 6d]
SammyN109: raises 3959 to 5359 and is all-in
panth26: folds=20
RedHungryHip: folds=20
seedload: folds=20
JJin91: folds=20
CerPrisingLe: folds=20
LetsGoMets 6: folds=20
The Gabbagu: folds=20
Uncalled bet (3959) returned to SammyN109
SammyN109 collected 4900 from pot
*** SUMMARY ***
Total pot 4900 | Rake 0=20
Seat 1: seedload folded before Flop (didn't bet)
Seat 2: JJin91 folded before Flop (didn't bet)
Seat 3: CerPrisingLe (button) folded before Flop (didn't bet)
Seat 4: LetsGoMets 6 (small blind) folded before Flop
Seat 5: The Gabbagu (big blind) folded before Flop
Seat 7: SammyN109 collected (4900)
Seat 8: panth26 folded before Flop (didn't bet)
Seat 9: RedHungryHip folded before Flop (didn't bet)


*********** # 103 **************
PokerStars Hand #169560787361: Tournament #1597684117, $4.55+$0.45 USD =
Hold'em No Limit - Level XVII (700/1400) - 2017/05/07 22:28:47 ET
Table '1597684117 1' 9-max Seat #4 is the button
Seat 1: seedload (23825 in chips)=20
Seat 2: JJin91 (51432 in chips)=20
Seat 3: CerPrisingLe (28851 in chips)=20
Seat 4: LetsGoMets 6 (33500 in chips)=20
Seat 5: The Gabbagu (89346 in chips)=20
Seat 7: SammyN109 (8859 in chips)=20
Seat 8: panth26 (90056 in chips)=20
Seat 9: RedHungryHip (40011 in chips)=20
seedload: posts the ante 175
JJin91: posts the ante 175
CerPrisingLe: posts the ante 175
LetsGoMets 6: posts the ante 175
The Gabbagu: posts the ante 175
SammyN109: posts the ante 175
panth26: posts the ante 175
RedHungryHip: posts the ante 175
The Gabbagu: posts small blind 700
SammyN109: posts big blind 1400
*** HOLE CARDS ***
Dealt to JJin91 [Jd 5d]
panth26: folds=20
RedHungryHip: folds=20
seedload: folds=20
JJin91: folds=20
CerPrisingLe: folds=20
LetsGoMets 6: folds=20
The Gabbagu: raises 87771 to 89171 and is all-in
SammyN109: calls 7284 and is all-in
Uncalled bet (80487) returned to The Gabbagu
*** FLOP *** [Kc 5h Td]
*** TURN *** [Kc 5h Td] [Jh]
*** RIVER *** [Kc 5h Td Jh] [Ac]
*** SHOW DOWN ***
The Gabbagu: shows [4h 4d] (a pair of Fours)
SammyN109: shows [Qd 7d] (a straight, Ten to Ace)
SammyN109 collected 18768 from pot
*** SUMMARY ***
Total pot 18768 | Rake 0=20
Board [Kc 5h Td Jh Ac]
Seat 1: seedload folded before Flop (didn't bet)
Seat 2: JJin91 folded before Flop (didn't bet)
Seat 3: CerPrisingLe folded before Flop (didn't bet)
Seat 4: LetsGoMets 6 (button) folded before Flop (didn't bet)
Seat 5: The Gabbagu (small blind) showed [4h 4d] and lost with a pair o=
f Fours
Seat 7: SammyN109 (big blind) showed [Qd 7d] and won (18768) with a str=
aight, Ten to Ace
Seat 8: panth26 folded before Flop (didn't bet)
Seat 9: RedHungryHip folded before Flop (didn't bet)


*********** # 104 **************
PokerStars Hand #169560787501: Tournament #1597684117, $4.55+$0.45 USD =
Hold'em No Limit - Level XVII (700/1400) - 2017/05/07 22:29:13 ET
Table '1597684117 1' 9-max Seat #5 is the button
Seat 1: seedload (23650 in chips)=20
Seat 2: JJin91 (51257 in chips)=20
Seat 3: CerPrisingLe (28676 in chips)=20
Seat 4: LetsGoMets 6 (33325 in chips)=20
Seat 5: The Gabbagu (80487 in chips)=20
Seat 7: SammyN109 (18768 in chips)=20
Seat 8: panth26 (89881 in chips)=20
Seat 9: RedHungryHip (39836 in chips)=20
seedload: posts the ante 175
JJin91: posts the ante 175
CerPrisingLe: posts the ante 175
LetsGoMets 6: posts the ante 175
The Gabbagu: posts the ante 175
SammyN109: posts the ante 175
panth26: posts the ante 175
RedHungryHip: posts the ante 175
SammyN109: posts small blind 700
panth26: posts big blind 1400
*** HOLE CARDS ***
Dealt to JJin91 [7d 3c]
RedHungryHip: folds=20
seedload: folds=20
JJin91: folds=20
CerPrisingLe: folds=20
LetsGoMets 6: folds=20
The Gabbagu: calls 1400
SammyN109: calls 700
panth26: checks=20
*** FLOP *** [6h Th 7s]
SammyN109: checks=20
panth26: checks=20
The Gabbagu: bets 5600
SammyN109: folds=20
panth26: folds=20
Uncalled bet (5600) returned to The Gabbagu
The Gabbagu collected 5600 from pot
The Gabbagu: doesn't show hand=20
*** SUMMARY ***
Total pot 5600 | Rake 0=20
Board [6h Th 7s]
Seat 1: seedload folded before Flop (didn't bet)
Seat 2: JJin91 folded before Flop (didn't bet)
Seat 3: CerPrisingLe folded before Flop (didn't bet)
Seat 4: LetsGoMets 6 folded before Flop (didn't bet)
Seat 5: The Gabbagu (button) collected (5600)
Seat 7: SammyN109 (small blind) folded on the Flop
Seat 8: panth26 (big blind) folded on the Flop
Seat 9: RedHungryHip folded before Flop (didn't bet)


*********** # 105 **************
PokerStars Hand #169560787651: Tournament #1597684117, $4.55+$0.45 USD =
Hold'em No Limit - Level XVII (700/1400) - 2017/05/07 22:29:43 ET
Table '1597684117 1' 9-max Seat #7 is the button
Seat 1: seedload (23475 in chips)=20
Seat 2: JJin91 (51082 in chips)=20
Seat 3: CerPrisingLe (28501 in chips)=20
Seat 4: LetsGoMets 6 (33150 in chips)=20
Seat 5: The Gabbagu (84512 in chips)=20
Seat 7: SammyN109 (17193 in chips)=20
Seat 8: panth26 (88306 in chips)=20
Seat 9: RedHungryHip (39661 in chips)=20
seedload: posts the ante 175
JJin91: posts the ante 175
CerPrisingLe: posts the ante 175
LetsGoMets 6: posts the ante 175
The Gabbagu: posts the ante 175
SammyN109: posts the ante 175
panth26: posts the ante 175
RedHungryHip: posts the ante 175
panth26: posts small blind 700
RedHungryHip: posts big blind 1400
*** HOLE CARDS ***
Dealt to JJin91 [2s 3c]
seedload: folds=20
JJin91: folds=20
CerPrisingLe: folds=20
LetsGoMets 6: folds=20
The Gabbagu: calls 1400
SammyN109: calls 1400
panth26: raises 2800 to 4200
RedHungryHip: folds=20
The Gabbagu: folds=20
SammyN109: calls 2800
*** FLOP *** [Jd Ad 6c]
panth26: bets 15400
SammyN109: folds=20
Uncalled bet (15400) returned to panth26
panth26 collected 12600 from pot
panth26: doesn't show hand=20
*** SUMMARY ***
Total pot 12600 | Rake 0=20
Board [Jd Ad 6c]
Seat 1: seedload folded before Flop (didn't bet)
Seat 2: JJin91 folded before Flop (didn't bet)
Seat 3: CerPrisingLe folded before Flop (didn't bet)
Seat 4: LetsGoMets 6 folded before Flop (didn't bet)
Seat 5: The Gabbagu folded before Flop
Seat 7: SammyN109 (button) folded on the Flop
Seat 8: panth26 (small blind) collected (12600)
Seat 9: RedHungryHip (big blind) folded before Flop


*********** # 106 **************
PokerStars Hand #169560787904: Tournament #1597684117, $4.55+$0.45 USD =
Hold'em No Limit - Level XVII (700/1400) - 2017/05/07 22:30:25 ET
Table '1597684117 1' 9-max Seat #8 is the button
Seat 1: seedload (23300 in chips)=20
Seat 2: JJin91 (50907 in chips)=20
Seat 3: CerPrisingLe (28326 in chips)=20
Seat 4: LetsGoMets 6 (32975 in chips)=20
Seat 5: The Gabbagu (82937 in chips)=20
Seat 7: SammyN109 (12818 in chips)=20
Seat 8: panth26 (96531 in chips)=20
Seat 9: RedHungryHip (38086 in chips)=20
seedload: posts the ante 175
JJin91: posts the ante 175
CerPrisingLe: posts the ante 175
LetsGoMets 6: posts the ante 175
The Gabbagu: posts the ante 175
SammyN109: posts the ante 175
panth26: posts the ante 175
RedHungryHip: posts the ante 175
RedHungryHip: posts small blind 700
seedload: posts big blind 1400
*** HOLE CARDS ***
Dealt to JJin91 [Js 5h]
JJin91: folds=20
CerPrisingLe: raises 1400 to 2800
LetsGoMets 6: folds=20
The Gabbagu: folds=20
SammyN109: folds=20
panth26: calls 2800
RedHungryHip: folds=20
seedload: folds=20
*** FLOP *** [9d Kh Jd]
CerPrisingLe: bets 6825
panth26: raises 51975 to 58800
CerPrisingLe: calls 18526 and is all-in
Uncalled bet (33449) returned to panth26
*** TURN *** [9d Kh Jd] [3s]
*** RIVER *** [9d Kh Jd 3s] [5d]
*** SHOW DOWN ***
CerPrisingLe: shows [Qc Ks] (a pair of Kings)
panth26: shows [Qh Jc] (a pair of Jacks)
CerPrisingLe collected 59802 from pot
*** SUMMARY ***
Total pot 59802 | Rake 0=20
Board [9d Kh Jd 3s 5d]
Seat 1: seedload (big blind) folded before Flop
Seat 2: JJin91 folded before Flop (didn't bet)
Seat 3: CerPrisingLe showed [Qc Ks] and won (59802) with a pair of Kings
Seat 4: LetsGoMets 6 folded before Flop (didn't bet)
Seat 5: The Gabbagu folded before Flop (didn't bet)
Seat 7: SammyN109 folded before Flop (didn't bet)
Seat 8: panth26 (button) showed [Qh Jc] and lost with a pair of Jacks
Seat 9: RedHungryHip (small blind) folded before Flop


*********** # 107 **************
PokerStars Hand #169560788204: Tournament #1597684117, $4.55+$0.45 USD =
Hold'em No Limit - Level XVII (700/1400) - 2017/05/07 22:31:18 ET
Table '1597684117 1' 9-max Seat #9 is the button
Seat 1: seedload (21725 in chips)=20
Seat 2: JJin91 (50732 in chips)=20
Seat 3: CerPrisingLe (59802 in chips)=20
Seat 4: LetsGoMets 6 (32800 in chips)=20
Seat 5: The Gabbagu (82762 in chips)=20
Seat 7: SammyN109 (12643 in chips)=20
Seat 8: panth26 (68205 in chips)=20
Seat 9: RedHungryHip (37211 in chips)=20
seedload: posts the ante 175
JJin91: posts the ante 175
CerPrisingLe: posts the ante 175
LetsGoMets 6: posts the ante 175
The Gabbagu: posts the ante 175
SammyN109: posts the ante 175
panth26: posts the ante 175
RedHungryHip: posts the ante 175
seedload: posts small blind 700
JJin91: posts big blind 1400
*** HOLE CARDS ***
Dealt to JJin91 [Ad Jd]
CerPrisingLe: folds=20
LetsGoMets 6: folds=20
The Gabbagu: calls 1400
SammyN109: raises 11068 to 12468 and is all-in
panth26: folds=20
RedHungryHip: folds=20
seedload: folds=20
JJin91: calls 11068
The Gabbagu: folds=20
*** FLOP *** [Tc Ah 4d]
*** TURN *** [Tc Ah 4d] [Js]
*** RIVER *** [Tc Ah 4d Js] [9s]
*** SHOW DOWN ***
JJin91: shows [Ad Jd] (two pair, Aces and Jacks)
SammyN109: shows [5d 9d] (a pair of Nines)
JJin91 collected 28436 from pot
SammyN109 finished the tournament in 24th place
*** SUMMARY ***
Total pot 28436 | Rake 0=20
Board [Tc Ah 4d Js 9s]
Seat 1: seedload (small blind) folded before Flop
Seat 2: JJin91 (big blind) showed [Ad Jd] and won (28436) with two pair=
, Aces and Jacks
Seat 3: CerPrisingLe folded before Flop (didn't bet)
Seat 4: LetsGoMets 6 folded before Flop (didn't bet)
Seat 5: The Gabbagu folded before Flop
Seat 7: SammyN109 showed [5d 9d] and lost with a pair of Nines
Seat 8: panth26 folded before Flop (didn't bet)
Seat 9: RedHungryHip (button) folded before Flop (didn't bet)


*********** # 108 **************
PokerStars Hand #169560788481: Tournament #1597684117, $4.55+$0.45 USD =
Hold'em No Limit - Level XVIII (800/1600) - 2017/05/07 22:32:08 ET
Table '1597684117 1' 9-max Seat #1 is the button
Seat 1: seedload (20850 in chips)=20
Seat 2: JJin91 (66525 in chips)=20
Seat 3: CerPrisingLe (59627 in chips)=20
Seat 4: LetsGoMets 6 (32625 in chips)=20
Seat 5: The Gabbagu (81187 in chips)=20
Seat 8: panth26 (68030 in chips)=20
Seat 9: RedHungryHip (37036 in chips)=20
seedload: posts the ante 200
JJin91: posts the ante 200
CerPrisingLe: posts the ante 200
LetsGoMets 6: posts the ante 200
The Gabbagu: posts the ante 200
panth26: posts the ante 200
RedHungryHip: posts the ante 200
JJin91: posts small blind 800
CerPrisingLe: posts big blind 1600
*** HOLE CARDS ***
Dealt to JJin91 [Ah Jd]
LetsGoMets 6: raises 30825 to 32425 and is all-in
The Gabbagu: folds=20
panth26: folds=20
RedHungryHip: folds=20
seedload: folds=20
JJin91: folds=20
CerPrisingLe: folds=20
Uncalled bet (30825) returned to LetsGoMets 6
LetsGoMets 6 collected 5400 from pot
LetsGoMets 6: doesn't show hand=20
*** SUMMARY ***
Total pot 5400 | Rake 0=20
Seat 1: seedload (button) folded before Flop (didn't bet)
Seat 2: JJin91 (small blind) folded before Flop
Seat 3: CerPrisingLe (big blind) folded before Flop
Seat 4: LetsGoMets 6 collected (5400)
Seat 5: The Gabbagu folded before Flop (didn't bet)
Seat 8: panth26 folded before Flop (didn't bet)
Seat 9: RedHungryHip folded before Flop (didn't bet)


*********** # 109 **************
PokerStars Hand #169560788591: Tournament #1597684117, $4.55+$0.45 USD =
Hold'em No Limit - Level XVIII (800/1600) - 2017/05/07 22:32:27 ET
Table '1597684117 1' 9-max Seat #2 is the button
Seat 1: seedload (20650 in chips)=20
Seat 2: JJin91 (65525 in chips)=20
Seat 3: CerPrisingLe (57827 in chips)=20
Seat 4: LetsGoMets 6 (36225 in chips)=20
Seat 5: The Gabbagu (80987 in chips)=20
Seat 8: panth26 (67830 in chips)=20
Seat 9: RedHungryHip (36836 in chips)=20
seedload: posts the ante 200
JJin91: posts the ante 200
CerPrisingLe: posts the ante 200
LetsGoMets 6: posts the ante 200
The Gabbagu: posts the ante 200
panth26: posts the ante 200
RedHungryHip: posts the ante 200
CerPrisingLe: posts small blind 800
LetsGoMets 6: posts big blind 1600
*** HOLE CARDS ***
Dealt to JJin91 [Th 3d]
The Gabbagu: folds=20
panth26: folds=20
RedHungryHip: folds=20
seedload: folds=20
JJin91: folds=20
CerPrisingLe: raises 1600 to 3200
LetsGoMets 6: folds=20
Uncalled bet (1600) returned to CerPrisingLe
CerPrisingLe collected 4600 from pot
CerPrisingLe: doesn't show hand=20
*** SUMMARY ***
Total pot 4600 | Rake 0=20
Seat 1: seedload folded before Flop (didn't bet)
Seat 2: JJin91 (button) folded before Flop (didn't bet)
Seat 3: CerPrisingLe (small blind) collected (4600)
Seat 4: LetsGoMets 6 (big blind) folded before Flop
Seat 5: The Gabbagu folded before Flop (didn't bet)
Seat 8: panth26 folded before Flop (didn't bet)
Seat 9: RedHungryHip folded before Flop (didn't bet)


*********** # 110 **************
PokerStars Hand #169560788665: Tournament #1597684117, $4.55+$0.45 USD =
Hold'em No Limit - Level XVIII (800/1600) - 2017/05/07 22:32:44 ET
Table '1597684117 1' 9-max Seat #3 is the button
Seat 1: seedload (20450 in chips)=20
Seat 2: JJin91 (65325 in chips)=20
Seat 3: CerPrisingLe (60627 in chips)=20
Seat 4: LetsGoMets 6 (34425 in chips)=20
Seat 5: The Gabbagu (80787 in chips)=20
Seat 8: panth26 (67630 in chips)=20
Seat 9: RedHungryHip (36636 in chips)=20
seedload: posts the ante 200
JJin91: posts the ante 200
CerPrisingLe: posts the ante 200
LetsGoMets 6: posts the ante 200
The Gabbagu: posts the ante 200
panth26: posts the ante 200
RedHungryHip: posts the ante 200
LetsGoMets 6: posts small blind 800
The Gabbagu: posts big blind 1600
*** HOLE CARDS ***
Dealt to JJin91 [2h 7d]
panth26: folds=20
RedHungryHip: folds=20
seedload: folds=20
JJin91: folds=20
CerPrisingLe: raises 3200 to 4800
LetsGoMets 6: folds=20
The Gabbagu: calls 3200
*** FLOP *** [Ts 7s 2s]
The Gabbagu: checks=20
CerPrisingLe: bets 4800
The Gabbagu: calls 4800
*** TURN *** [Ts 7s 2s] [As]
The Gabbagu: checks=20
CerPrisingLe: bets 4800
The Gabbagu: calls 4800
*** RIVER *** [Ts 7s 2s As] [Ah]
The Gabbagu: checks=20
CerPrisingLe: checks=20
*** SHOW DOWN ***
The Gabbagu: shows [Js 4c] (a flush, Ace high)
CerPrisingLe: mucks hand=20
The Gabbagu collected 31000 from pot
*** SUMMARY ***
Total pot 31000 | Rake 0=20
Board [Ts 7s 2s As Ah]
Seat 1: seedload folded before Flop (didn't bet)
Seat 2: JJin91 folded before Flop (didn't bet)
Seat 3: CerPrisingLe (button) mucked [5h 4h]
Seat 4: LetsGoMets 6 (small blind) folded before Flop
Seat 5: The Gabbagu (big blind) showed [Js 4c] and won (31000) with a f=
lush, Ace high
Seat 8: panth26 folded before Flop (didn't bet)
Seat 9: RedHungryHip folded before Flop (didn't bet)


*********** # 111 **************
PokerStars Hand #169560788979: Tournament #1597684117, $4.55+$0.45 USD =
Hold'em No Limit - Level XVIII (800/1600) - 2017/05/07 22:33:36 ET
Table '1597684117 1' 9-max Seat #4 is the button
Seat 1: seedload (20250 in chips)=20
Seat 2: JJin91 (65125 in chips)=20
Seat 3: CerPrisingLe (46027 in chips)=20
Seat 4: LetsGoMets 6 (33425 in chips)=20
Seat 5: The Gabbagu (97187 in chips)=20
Seat 8: panth26 (67430 in chips)=20
Seat 9: RedHungryHip (36436 in chips)=20
seedload: posts the ante 200
JJin91: posts the ante 200
CerPrisingLe: posts the ante 200
LetsGoMets 6: posts the ante 200
The Gabbagu: posts the ante 200
panth26: posts the ante 200
RedHungryHip: posts the ante 200
The Gabbagu: posts small blind 800
panth26: posts big blind 1600
*** HOLE CARDS ***
Dealt to JJin91 [7s 8d]
RedHungryHip: folds=20
seedload: folds=20
JJin91: folds=20
CerPrisingLe: raises 3200 to 4800
LetsGoMets 6: folds=20
The Gabbagu: calls 4000
panth26: folds=20
*** FLOP *** [Tc 7c Js]
The Gabbagu: checks=20
CerPrisingLe: bets 9450
The Gabbagu: folds=20
Uncalled bet (9450) returned to CerPrisingLe
CerPrisingLe collected 12600 from pot
CerPrisingLe: doesn't show hand=20
*** SUMMARY ***
Total pot 12600 | Rake 0=20
Board [Tc 7c Js]
Seat 1: seedload folded before Flop (didn't bet)
Seat 2: JJin91 folded before Flop (didn't bet)
Seat 3: CerPrisingLe collected (12600)
Seat 4: LetsGoMets 6 (button) folded before Flop (didn't bet)
Seat 5: The Gabbagu (small blind) folded on the Flop
Seat 8: panth26 (big blind) folded before Flop
Seat 9: RedHungryHip folded before Flop (didn't bet)


*********** # 112 **************
PokerStars Hand #169560789189: Tournament #1597684117, $4.55+$0.45 USD =
Hold'em No Limit - Level XVIII (800/1600) - 2017/05/07 22:34:11 ET
Table '1597684117 1' 9-max Seat #5 is the button
Seat 1: seedload (20050 in chips)=20
Seat 2: JJin91 (64925 in chips)=20
Seat 3: CerPrisingLe (53627 in chips)=20
Seat 4: LetsGoMets 6 (33225 in chips)=20
Seat 5: The Gabbagu (92187 in chips)=20
Seat 8: panth26 (65630 in chips)=20
Seat 9: RedHungryHip (36236 in chips)=20
seedload: posts the ante 200
JJin91: posts the ante 200
CerPrisingLe: posts the ante 200
LetsGoMets 6: posts the ante 200
The Gabbagu: posts the ante 200
panth26: posts the ante 200
RedHungryHip: posts the ante 200
panth26: posts small blind 800
RedHungryHip: posts big blind 1600
*** HOLE CARDS ***
Dealt to JJin91 [8c Qd]
seedload: folds=20
JJin91: folds=20
CerPrisingLe: folds=20
LetsGoMets 6: folds=20
The Gabbagu: folds=20
panth26: folds=20
Uncalled bet (800) returned to RedHungryHip
RedHungryHip collected 3000 from pot
RedHungryHip: doesn't show hand=20
*** SUMMARY ***
Total pot 3000 | Rake 0=20
Seat 1: seedload folded before Flop (didn't bet)
Seat 2: JJin91 folded before Flop (didn't bet)
Seat 3: CerPrisingLe folded before Flop (didn't bet)
Seat 4: LetsGoMets 6 folded before Flop (didn't bet)
Seat 5: The Gabbagu (button) folded before Flop (didn't bet)
Seat 8: panth26 (small blind) folded before Flop
Seat 9: RedHungryHip (big blind) collected (3000)


*********** # 113 **************
PokerStars Hand #169560789259: Tournament #1597684117, $4.55+$0.45 USD =
Hold'em No Limit - Level XVIII (800/1600) - 2017/05/07 22:34:23 ET
Table '1597684117 1' 9-max Seat #8 is the button
Seat 1: seedload (19850 in chips)=20
Seat 2: JJin91 (64725 in chips)=20
Seat 3: CerPrisingLe (53427 in chips)=20
Seat 4: LetsGoMets 6 (33025 in chips)=20
Seat 5: The Gabbagu (91987 in chips)=20
Seat 8: panth26 (64630 in chips)=20
Seat 9: RedHungryHip (38236 in chips)=20
seedload: posts the ante 200
JJin91: posts the ante 200
CerPrisingLe: posts the ante 200
LetsGoMets 6: posts the ante 200
The Gabbagu: posts the ante 200
panth26: posts the ante 200
RedHungryHip: posts the ante 200
RedHungryHip: posts small blind 800
seedload: posts big blind 1600
*** HOLE CARDS ***
Dealt to JJin91 [Ah Qh]
JJin91: raises 1600 to 3200
CerPrisingLe: calls 3200
LetsGoMets 6: folds=20
The Gabbagu: raises 13400 to 16600
panth26 has timed out
panth26: folds=20
panth26 is sitting out
RedHungryHip: folds=20
seedload: folds=20
JJin91: calls 13400
CerPrisingLe: folds=20
*** FLOP *** [8s 4d Qs]
JJin91: checks=20
The Gabbagu: bets 75187 and is all-in
JJin91: calls 47925 and is all-in
Uncalled bet (27262) returned to The Gabbagu
*** TURN *** [8s 4d Qs] [Kh]
*** RIVER *** [8s 4d Qs Kh] [7d]
*** SHOW DOWN ***
JJin91: shows [Ah Qh] (a pair of Queens)
The Gabbagu: shows [Ad Jd] (high card Ace)
JJin91 collected 136050 from pot
*** SUMMARY ***
Total pot 136050 | Rake 0=20
Board [8s 4d Qs Kh 7d]
Seat 1: seedload (big blind) folded before Flop
Seat 2: JJin91 showed [Ah Qh] and won (136050) with a pair of Queens
Seat 3: CerPrisingLe folded before Flop
Seat 4: LetsGoMets 6 folded before Flop (didn't bet)
Seat 5: The Gabbagu showed [Ad Jd] and lost with high card Ace
Seat 8: panth26 (button) folded before Flop (didn't bet)
Seat 9: RedHungryHip (small blind) folded before Flop


*********** # 114 **************
PokerStars Hand #169562243341: Tournament #1597684117, $4.55+$0.45 USD =
Hold'em No Limit - Level XIX (1000/2000) - 2017/05/07 22:36:52 ET
Table '1597684117 1' 9-max Seat #9 is the button
Seat 1: seedload (18050 in chips)=20
Seat 2: JJin91 (136050 in chips)=20
Seat 3: CerPrisingLe (50027 in chips)=20
Seat 4: LetsGoMets 6 (32825 in chips)=20
Seat 5: The Gabbagu (27262 in chips)=20
Seat 8: panth26 (64430 in chips) is sitting out
Seat 9: RedHungryHip (37236 in chips)=20
seedload: posts the ante 250
JJin91: posts the ante 250
CerPrisingLe: posts the ante 250
LetsGoMets 6: posts the ante 250
The Gabbagu: posts the ante 250
panth26: posts the ante 250
RedHungryHip: posts the ante 250
seedload: posts small blind 1000
JJin91: posts big blind 2000
*** HOLE CARDS ***
Dealt to JJin91 [Kc 3s]
CerPrisingLe: folds=20
LetsGoMets 6: raises 30575 to 32575 and is all-in
The Gabbagu: folds=20
panth26: folds=20
RedHungryHip: folds=20
seedload: folds=20
JJin91: folds=20
Uncalled bet (30575) returned to LetsGoMets 6
LetsGoMets 6 collected 6750 from pot
LetsGoMets 6: doesn't show hand=20
*** SUMMARY ***
Total pot 6750 | Rake 0=20
Seat 1: seedload (small blind) folded before Flop
Seat 2: JJin91 (big blind) folded before Flop
Seat 3: CerPrisingLe folded before Flop (didn't bet)
Seat 4: LetsGoMets 6 collected (6750)
Seat 5: The Gabbagu folded before Flop (didn't bet)
Seat 8: panth26 folded before Flop (didn't bet)
Seat 9: RedHungryHip (button) folded before Flop (didn't bet)


*********** # 115 **************
PokerStars Hand #169562243457: Tournament #1597684117, $4.55+$0.45 USD =
Hold'em No Limit - Level XIX (1000/2000) - 2017/05/07 22:37:11 ET
Table '1597684117 1' 9-max Seat #1 is the button
Seat 1: seedload (16800 in chips)=20
Seat 2: JJin91 (133800 in chips)=20
Seat 3: CerPrisingLe (49777 in chips)=20
Seat 4: LetsGoMets 6 (37325 in chips)=20
Seat 5: The Gabbagu (27012 in chips)=20
Seat 8: panth26 (64180 in chips) is sitting out
Seat 9: RedHungryHip (36986 in chips)=20
seedload: posts the ante 250
JJin91: posts the ante 250
CerPrisingLe: posts the ante 250
LetsGoMets 6: posts the ante 250
The Gabbagu: posts the ante 250
panth26: posts the ante 250
RedHungryHip: posts the ante 250
JJin91: posts small blind 1000
CerPrisingLe: posts big blind 2000
*** HOLE CARDS ***
Dealt to JJin91 [Qs Ad]
LetsGoMets 6: folds=20
The Gabbagu: folds=20
panth26: folds=20
RedHungryHip: calls 2000
seedload: folds=20
JJin91: raises 4000 to 6000
CerPrisingLe: folds=20
RedHungryHip: raises 4000 to 10000
JJin91: calls 4000
*** FLOP *** [9h 7d Ks]
JJin91: checks=20
RedHungryHip: checks=20
*** TURN *** [9h 7d Ks] [5c]
JJin91: checks=20
RedHungryHip: bets 8000
JJin91: calls 8000
*** RIVER *** [9h 7d Ks 5c] [2d]
JJin91: checks=20
RedHungryHip: bets 12000
panth26 has returned
JJin91: raises 103550 to 115550 and is all-in
RedHungryHip: calls 6736 and is all-in
Uncalled bet (96814) returned to JJin91
*** SHOW DOWN ***
JJin91: shows [Qs Ad] (high card Ace)
RedHungryHip: shows [As Ac] (a pair of Aces)
RedHungryHip collected 77222 from pot
*** SUMMARY ***
Total pot 77222 | Rake 0=20
Board [9h 7d Ks 5c 2d]
Seat 1: seedload (button) folded before Flop (didn't bet)
Seat 2: JJin91 (small blind) showed [Qs Ad] and lost with high card Ace
Seat 3: CerPrisingLe (big blind) folded before Flop
Seat 4: LetsGoMets 6 folded before Flop (didn't bet)
Seat 5: The Gabbagu folded before Flop (didn't bet)
Seat 8: panth26 folded before Flop (didn't bet)
Seat 9: RedHungryHip showed [As Ac] and won (77222) with a pair of Aces


*********** # 116 **************
PokerStars Hand #169562244022: Tournament #1597684117, $4.55+$0.45 USD =
Hold'em No Limit - Level XIX (1000/2000) - 2017/05/07 22:38:48 ET
Table '1597684117 1' 9-max Seat #2 is the button
Seat 1: seedload (16550 in chips)=20
Seat 2: JJin91 (96814 in chips)=20
Seat 3: CerPrisingLe (47527 in chips)=20
Seat 4: LetsGoMets 6 (37075 in chips)=20
Seat 5: The Gabbagu (26762 in chips)=20
Seat 8: panth26 (63930 in chips)=20
Seat 9: RedHungryHip (77222 in chips)=20
seedload: posts the ante 250
JJin91: posts the ante 250
CerPrisingLe: posts the ante 250
LetsGoMets 6: posts the ante 250
The Gabbagu: posts the ante 250
panth26: posts the ante 250
RedHungryHip: posts the ante 250
CerPrisingLe: posts small blind 1000
LetsGoMets 6: posts big blind 2000
*** HOLE CARDS ***
Dealt to JJin91 [Td 2h]
The Gabbagu: folds=20
panth26: folds=20
RedHungryHip: folds=20
seedload: folds=20
JJin91: folds=20
CerPrisingLe: raises 2000 to 4000
LetsGoMets 6: folds=20
Uncalled bet (2000) returned to CerPrisingLe
CerPrisingLe collected 5750 from pot
CerPrisingLe: doesn't show hand=20
*** SUMMARY ***
Total pot 5750 | Rake 0=20
Seat 1: seedload folded before Flop (didn't bet)
Seat 2: JJin91 (button) folded before Flop (didn't bet)
Seat 3: CerPrisingLe (small blind) collected (5750)
Seat 4: LetsGoMets 6 (big blind) folded before Flop
Seat 5: The Gabbagu folded before Flop (didn't bet)
Seat 8: panth26 folded before Flop (didn't bet)
Seat 9: RedHungryHip folded before Flop (didn't bet)


*********** # 117 **************
PokerStars Hand #169562244114: Tournament #1597684117, $4.55+$0.45 USD =
Hold'em No Limit - Level XIX (1000/2000) - 2017/05/07 22:39:04 ET
Table '1597684117 1' 9-max Seat #3 is the button
Seat 1: seedload (16300 in chips)=20
Seat 2: JJin91 (96564 in chips)=20
Seat 3: CerPrisingLe (51027 in chips)=20
Seat 4: LetsGoMets 6 (34825 in chips)=20
Seat 5: The Gabbagu (26512 in chips)=20
Seat 8: panth26 (63680 in chips)=20
Seat 9: RedHungryHip (76972 in chips)=20
seedload: posts the ante 250
JJin91: posts the ante 250
CerPrisingLe: posts the ante 250
LetsGoMets 6: posts the ante 250
The Gabbagu: posts the ante 250
panth26: posts the ante 250
RedHungryHip: posts the ante 250
LetsGoMets 6: posts small blind 1000
The Gabbagu: posts big blind 2000
*** HOLE CARDS ***
Dealt to JJin91 [4h 5s]
panth26: folds=20
RedHungryHip: folds=20
seedload: folds=20
JJin91: folds=20
CerPrisingLe: folds=20
LetsGoMets 6: raises 32575 to 34575 and is all-in
The Gabbagu: folds=20
Uncalled bet (32575) returned to LetsGoMets 6
LetsGoMets 6 collected 5750 from pot
LetsGoMets 6: doesn't show hand=20
*** SUMMARY ***
Total pot 5750 | Rake 0=20
Seat 1: seedload folded before Flop (didn't bet)
Seat 2: JJin91 folded before Flop (didn't bet)
Seat 3: CerPrisingLe (button) folded before Flop (didn't bet)
Seat 4: LetsGoMets 6 (small blind) collected (5750)
Seat 5: The Gabbagu (big blind) folded before Flop
Seat 8: panth26 folded before Flop (didn't bet)
Seat 9: RedHungryHip folded before Flop (didn't bet)


*********** # 118 **************
PokerStars Hand #169562244251: Tournament #1597684117, $4.55+$0.45 USD =
Hold'em No Limit - Level XIX (1000/2000) - 2017/05/07 22:39:27 ET
Table '1597684117 1' 9-max Seat #4 is the button
Seat 1: seedload (16050 in chips)=20
Seat 2: JJin91 (96314 in chips)=20
Seat 3: CerPrisingLe (50777 in chips)=20
Seat 4: LetsGoMets 6 (38325 in chips)=20
Seat 5: The Gabbagu (24262 in chips)=20
Seat 8: panth26 (63430 in chips)=20
Seat 9: RedHungryHip (76722 in chips)=20
seedload: posts the ante 250
JJin91: posts the ante 250
CerPrisingLe: posts the ante 250
LetsGoMets 6: posts the ante 250
The Gabbagu: posts the ante 250
panth26: posts the ante 250
RedHungryHip: posts the ante 250
The Gabbagu: posts small blind 1000
panth26: posts big blind 2000
*** HOLE CARDS ***
Dealt to JJin91 [2d Kh]
RedHungryHip: folds=20
seedload: folds=20
JJin91: folds=20
CerPrisingLe: folds=20
LetsGoMets 6: folds=20
The Gabbagu: folds=20
Uncalled bet (1000) returned to panth26
panth26 collected 3750 from pot
panth26: doesn't show hand=20
*** SUMMARY ***
Total pot 3750 | Rake 0=20
Seat 1: seedload folded before Flop (didn't bet)
Seat 2: JJin91 folded before Flop (didn't bet)
Seat 3: CerPrisingLe folded before Flop (didn't bet)
Seat 4: LetsGoMets 6 (button) folded before Flop (didn't bet)
Seat 5: The Gabbagu (small blind) folded before Flop
Seat 8: panth26 (big blind) collected (3750)
Seat 9: RedHungryHip folded before Flop (didn't bet)


*********** # 119 **************
PokerStars Hand #169562244348: Tournament #1597684117, $4.55+$0.45 USD =
Hold'em No Limit - Level XIX (1000/2000) - 2017/05/07 22:39:44 ET
Table '1597684117 1' 9-max Seat #5 is the button
Seat 1: seedload (15800 in chips)=20
Seat 2: JJin91 (96064 in chips)=20
Seat 3: CerPrisingLe (50527 in chips)=20
Seat 4: LetsGoMets 6 (38075 in chips)=20
Seat 5: The Gabbagu (23012 in chips)=20
Seat 8: panth26 (65930 in chips)=20
Seat 9: RedHungryHip (76472 in chips)=20
seedload: posts the ante 250
JJin91: posts the ante 250
CerPrisingLe: posts the ante 250
LetsGoMets 6: posts the ante 250
The Gabbagu: posts the ante 250
panth26: posts the ante 250
RedHungryHip: posts the ante 250
panth26: posts small blind 1000
RedHungryHip: posts big blind 2000
*** HOLE CARDS ***
Dealt to JJin91 [7d 6d]
seedload: raises 13550 to 15550 and is all-in
JJin91: folds=20
CerPrisingLe: folds=20
LetsGoMets 6: folds=20
The Gabbagu: folds=20
panth26: folds=20
RedHungryHip: folds=20
Uncalled bet (13550) returned to seedload
seedload collected 6750 from pot
seedload: doesn't show hand=20
*** SUMMARY ***
Total pot 6750 | Rake 0=20
Seat 1: seedload collected (6750)
Seat 2: JJin91 folded before Flop (didn't bet)
Seat 3: CerPrisingLe folded before Flop (didn't bet)
Seat 4: LetsGoMets 6 folded before Flop (didn't bet)
Seat 5: The Gabbagu (button) folded before Flop (didn't bet)
Seat 8: panth26 (small blind) folded before Flop
Seat 9: RedHungryHip (big blind) folded before Flop


*********** # 120 **************
PokerStars Hand #169562244437: Tournament #1597684117, $4.55+$0.45 USD =
Hold'em No Limit - Level XIX (1000/2000) - 2017/05/07 22:40:02 ET
Table '1597684117 1' 9-max Seat #8 is the button
Seat 1: seedload (20300 in chips)=20
Seat 2: JJin91 (95814 in chips)=20
Seat 3: CerPrisingLe (50277 in chips)=20
Seat 4: LetsGoMets 6 (37825 in chips)=20
Seat 5: The Gabbagu (22762 in chips)=20
Seat 8: panth26 (64680 in chips)=20
Seat 9: RedHungryHip (74222 in chips)=20
seedload: posts the ante 250
JJin91: posts the ante 250
CerPrisingLe: posts the ante 250
LetsGoMets 6: posts the ante 250
The Gabbagu: posts the ante 250
panth26: posts the ante 250
RedHungryHip: posts the ante 250
RedHungryHip: posts small blind 1000
seedload: posts big blind 2000
*** HOLE CARDS ***
Dealt to JJin91 [Kh 3s]
JJin91: folds=20
CerPrisingLe: raises 2000 to 4000
LetsGoMets 6: raises 33575 to 37575 and is all-in
The Gabbagu: folds=20
panth26: folds=20
RedHungryHip: folds=20
seedload: folds=20
CerPrisingLe: folds=20
Uncalled bet (33575) returned to LetsGoMets 6
LetsGoMets 6 collected 12750 from pot
LetsGoMets 6: doesn't show hand=20
*** SUMMARY ***
Total pot 12750 | Rake 0=20
Seat 1: seedload (big blind) folded before Flop
Seat 2: JJin91 folded before Flop (didn't bet)
Seat 3: CerPrisingLe folded before Flop
Seat 4: LetsGoMets 6 collected (12750)
Seat 5: The Gabbagu folded before Flop (didn't bet)
Seat 8: panth26 (button) folded before Flop (didn't bet)
Seat 9: RedHungryHip (small blind) folded before Flop


*********** # 121 **************
PokerStars Hand #169562244661: Tournament #1597684117, $4.55+$0.45 USD =
Hold'em No Limit - Level XIX (1000/2000) - 2017/05/07 22:40:41 ET
Table '1597684117 1' 9-max Seat #9 is the button
Seat 1: seedload (18050 in chips)=20
Seat 2: JJin91 (95564 in chips)=20
Seat 3: CerPrisingLe (46027 in chips)=20
Seat 4: LetsGoMets 6 (46325 in chips)=20
Seat 5: The Gabbagu (22512 in chips)=20
Seat 8: panth26 (64430 in chips)=20
Seat 9: RedHungryHip (72972 in chips)=20
seedload: posts the ante 250
JJin91: posts the ante 250
CerPrisingLe: posts the ante 250
LetsGoMets 6: posts the ante 250
The Gabbagu: posts the ante 250
panth26: posts the ante 250
RedHungryHip: posts the ante 250
seedload: posts small blind 1000
JJin91: posts big blind 2000
*** HOLE CARDS ***
Dealt to JJin91 [8s 2d]
CerPrisingLe: raises 2000 to 4000
LetsGoMets 6: folds=20
The Gabbagu: folds=20
panth26: folds=20
RedHungryHip: folds=20
seedload: raises 13800 to 17800 and is all-in
JJin91: folds=20
CerPrisingLe: calls 13800
*** FLOP *** [Qd 3d 5h]
*** TURN *** [Qd 3d 5h] [6c]
*** RIVER *** [Qd 3d 5h 6c] [Qc]
*** SHOW DOWN ***
seedload: shows [Ad 8c] (a pair of Queens)
CerPrisingLe: shows [Ah 4h] (a pair of Queens - lower kicker)
seedload collected 39350 from pot
*** SUMMARY ***
Total pot 39350 | Rake 0=20
Board [Qd 3d 5h 6c Qc]
Seat 1: seedload (small blind) showed [Ad 8c] and won (39350) with a pa=
ir of Queens
Seat 2: JJin91 (big blind) folded before Flop
Seat 3: CerPrisingLe showed [Ah 4h] and lost with a pair of Queens
Seat 4: LetsGoMets 6 folded before Flop (didn't bet)
Seat 5: The Gabbagu folded before Flop (didn't bet)
Seat 8: panth26 folded before Flop (didn't bet)
Seat 9: RedHungryHip (button) folded before Flop (didn't bet)


*********** # 122 **************
PokerStars Hand #169562244781: Tournament #1597684117, $4.55+$0.45 USD =
Hold'em No Limit - Level XIX (1000/2000) - 2017/05/07 22:41:03 ET
Table '1597684117 1' 9-max Seat #1 is the button
Seat 1: seedload (39350 in chips)=20
Seat 2: JJin91 (93314 in chips)=20
Seat 3: CerPrisingLe (27977 in chips)=20
Seat 4: LetsGoMets 6 (46075 in chips)=20
Seat 5: The Gabbagu (22262 in chips)=20
Seat 8: panth26 (64180 in chips)=20
Seat 9: RedHungryHip (72722 in chips)=20
seedload: posts the ante 250
JJin91: posts the ante 250
CerPrisingLe: posts the ante 250
LetsGoMets 6: posts the ante 250
The Gabbagu: posts the ante 250
panth26: posts the ante 250
RedHungryHip: posts the ante 250
JJin91: posts small blind 1000
CerPrisingLe: posts big blind 2000
*** HOLE CARDS ***
Dealt to JJin91 [6s 7h]
LetsGoMets 6: folds=20
The Gabbagu: calls 2000
panth26: folds=20
RedHungryHip: folds=20
seedload: folds=20
JJin91: folds=20
CerPrisingLe: checks=20
*** FLOP *** [4h 4d 6d]
CerPrisingLe: checks=20
The Gabbagu: bets 3375
CerPrisingLe: folds=20
Uncalled bet (3375) returned to The Gabbagu
The Gabbagu collected 6750 from pot
The Gabbagu: doesn't show hand=20
*** SUMMARY ***
Total pot 6750 | Rake 0=20
Board [4h 4d 6d]
Seat 1: seedload (button) folded before Flop (didn't bet)
Seat 2: JJin91 (small blind) folded before Flop
Seat 3: CerPrisingLe (big blind) folded on the Flop
Seat 4: LetsGoMets 6 folded before Flop (didn't bet)
Seat 5: The Gabbagu collected (6750)
Seat 8: panth26 folded before Flop (didn't bet)
Seat 9: RedHungryHip folded before Flop (didn't bet)


*********** # 123 **************
PokerStars Hand #169562244988: Tournament #1597684117, $4.55+$0.45 USD =
Hold'em No Limit - Level XX (1250/2500) - 2017/05/07 22:41:41 ET
Table '1597684117 1' 9-max Seat #2 is the button
Seat 1: seedload (39100 in chips)=20
Seat 2: JJin91 (92064 in chips)=20
Seat 3: CerPrisingLe (25727 in chips)=20
Seat 4: LetsGoMets 6 (45825 in chips)=20
Seat 5: The Gabbagu (26762 in chips)=20
Seat 8: panth26 (63930 in chips)=20
Seat 9: RedHungryHip (72472 in chips)=20
seedload: posts the ante 325
JJin91: posts the ante 325
CerPrisingLe: posts the ante 325
LetsGoMets 6: posts the ante 325
The Gabbagu: posts the ante 325
panth26: posts the ante 325
RedHungryHip: posts the ante 325
CerPrisingLe: posts small blind 1250
LetsGoMets 6: posts big blind 2500
*** HOLE CARDS ***
Dealt to JJin91 [8c 9h]
The Gabbagu: folds=20
panth26: folds=20
RedHungryHip: calls 2500
seedload: raises 5000 to 7500
JJin91: folds=20
CerPrisingLe: folds=20
LetsGoMets 6: raises 38000 to 45500 and is all-in
RedHungryHip: folds=20
seedload: folds=20
Uncalled bet (38000) returned to LetsGoMets 6
LetsGoMets 6 collected 21025 from pot
LetsGoMets 6: doesn't show hand=20
*** SUMMARY ***
Total pot 21025 | Rake 0=20
Seat 1: seedload folded before Flop
Seat 2: JJin91 (button) folded before Flop (didn't bet)
Seat 3: CerPrisingLe (small blind) folded before Flop
Seat 4: LetsGoMets 6 (big blind) collected (21025)
Seat 5: The Gabbagu folded before Flop (didn't bet)
Seat 8: panth26 folded before Flop (didn't bet)
Seat 9: RedHungryHip folded before Flop


*********** # 124 **************
PokerStars Hand #169562245148: Tournament #1597684117, $4.55+$0.45 USD =
Hold'em No Limit - Level XX (1250/2500) - 2017/05/07 22:42:16 ET
Table '1597684117 1' 9-max Seat #3 is the button
Seat 1: seedload (31275 in chips)=20
Seat 2: JJin91 (91739 in chips)=20
Seat 3: CerPrisingLe (24152 in chips)=20
Seat 4: LetsGoMets 6 (59025 in chips)=20
Seat 5: The Gabbagu (26437 in chips)=20
Seat 8: panth26 (63605 in chips)=20
Seat 9: RedHungryHip (69647 in chips)=20
seedload: posts the ante 325
JJin91: posts the ante 325
CerPrisingLe: posts the ante 325
LetsGoMets 6: posts the ante 325
The Gabbagu: posts the ante 325
panth26: posts the ante 325
RedHungryHip: posts the ante 325
LetsGoMets 6: posts small blind 1250
The Gabbagu: posts big blind 2500
*** HOLE CARDS ***
Dealt to JJin91 [Td 3d]
panth26: folds=20
RedHungryHip: folds=20
seedload: calls 2500
JJin91: folds=20
CerPrisingLe: folds=20
LetsGoMets 6: calls 1250
The Gabbagu: checks=20
*** FLOP *** [3c 2d 7d]
LetsGoMets 6: checks=20
The Gabbagu: checks=20
seedload: checks=20
*** TURN *** [3c 2d 7d] [6h]
LetsGoMets 6: bets 5000
The Gabbagu: folds=20
seedload: folds=20
Uncalled bet (5000) returned to LetsGoMets 6
LetsGoMets 6 collected 9775 from pot
LetsGoMets 6: doesn't show hand=20
*** SUMMARY ***
Total pot 9775 | Rake 0=20
Board [3c 2d 7d 6h]
Seat 1: seedload folded on the Turn
Seat 2: JJin91 folded before Flop (didn't bet)
Seat 3: CerPrisingLe (button) folded before Flop (didn't bet)
Seat 4: LetsGoMets 6 (small blind) collected (9775)
Seat 5: The Gabbagu (big blind) folded on the Turn
Seat 8: panth26 folded before Flop (didn't bet)
Seat 9: RedHungryHip folded before Flop (didn't bet)


*********** # 125 **************
PokerStars Hand #169562245343: Tournament #1597684117, $4.55+$0.45 USD =
Hold'em No Limit - Level XX (1250/2500) - 2017/05/07 22:42:54 ET
Table '1597684117 1' 9-max Seat #4 is the button
Seat 1: seedload (28450 in chips)=20
Seat 2: JJin91 (91414 in chips)=20
Seat 3: CerPrisingLe (23827 in chips)=20
Seat 4: LetsGoMets 6 (65975 in chips)=20
Seat 5: The Gabbagu (23612 in chips)=20
Seat 8: panth26 (63280 in chips)=20
Seat 9: RedHungryHip (69322 in chips)=20
seedload: posts the ante 325
JJin91: posts the ante 325
CerPrisingLe: posts the ante 325
LetsGoMets 6: posts the ante 325
The Gabbagu: posts the ante 325
panth26: posts the ante 325
RedHungryHip: posts the ante 325
The Gabbagu: posts small blind 1250
panth26: posts big blind 2500
*** HOLE CARDS ***
Dealt to JJin91 [8d 2c]
RedHungryHip: folds=20
seedload: folds=20
JJin91: folds=20
CerPrisingLe: folds=20
LetsGoMets 6: folds=20
The Gabbagu: raises 20787 to 23287 and is all-in
panth26: folds=20
Uncalled bet (20787) returned to The Gabbagu
The Gabbagu collected 7275 from pot
The Gabbagu: doesn't show hand=20
*** SUMMARY ***
Total pot 7275 | Rake 0=20
Seat 1: seedload folded before Flop (didn't bet)
Seat 2: JJin91 folded before Flop (didn't bet)
Seat 3: CerPrisingLe folded before Flop (didn't bet)
Seat 4: LetsGoMets 6 (button) folded before Flop (didn't bet)
Seat 5: The Gabbagu (small blind) collected (7275)
Seat 8: panth26 (big blind) folded before Flop
Seat 9: RedHungryHip folded before Flop (didn't bet)


*********** # 126 **************
PokerStars Hand #169562245439: Tournament #1597684117, $4.55+$0.45 USD =
Hold'em No Limit - Level XX (1250/2500) - 2017/05/07 22:43:11 ET
Table '1597684117 1' 9-max Seat #5 is the button
Seat 1: seedload (28125 in chips)=20
Seat 2: JJin91 (91089 in chips)=20
Seat 3: CerPrisingLe (23502 in chips)=20
Seat 4: LetsGoMets 6 (65650 in chips)=20
Seat 5: The Gabbagu (28062 in chips)=20
Seat 8: panth26 (60455 in chips)=20
Seat 9: RedHungryHip (68997 in chips)=20
seedload: posts the ante 325
JJin91: posts the ante 325
CerPrisingLe: posts the ante 325
LetsGoMets 6: posts the ante 325
The Gabbagu: posts the ante 325
panth26: posts the ante 325
RedHungryHip: posts the ante 325
panth26: posts small blind 1250
RedHungryHip: posts big blind 2500
*** HOLE CARDS ***
Dealt to JJin91 [Qd Ah]
seedload: folds=20
JJin91: raises 2500 to 5000
CerPrisingLe: folds=20
LetsGoMets 6: folds=20
The Gabbagu: folds=20
panth26: folds=20
RedHungryHip: calls 2500
*** FLOP *** [6s 2d 9h]
RedHungryHip: checks=20
JJin91: bets 4852
RedHungryHip: folds=20
Uncalled bet (4852) returned to JJin91
JJin91 collected 13525 from pot
*** SUMMARY ***
Total pot 13525 | Rake 0=20
Board [6s 2d 9h]
Seat 1: seedload folded before Flop (didn't bet)
Seat 2: JJin91 collected (13525)
Seat 3: CerPrisingLe folded before Flop (didn't bet)
Seat 4: LetsGoMets 6 folded before Flop (didn't bet)
Seat 5: The Gabbagu (button) folded before Flop (didn't bet)
Seat 8: panth26 (small blind) folded before Flop
Seat 9: RedHungryHip (big blind) folded on the Flop


*********** # 127 **************
PokerStars Hand #169562245646: Tournament #1597684117, $4.55+$0.45 USD =
Hold'em No Limit - Level XX (1250/2500) - 2017/05/07 22:43:51 ET
Table '1597684117 1' 9-max Seat #8 is the button
Seat 1: seedload (27800 in chips)=20
Seat 2: JJin91 (99289 in chips)=20
Seat 3: CerPrisingLe (23177 in chips)=20
Seat 4: LetsGoMets 6 (65325 in chips)=20
Seat 5: The Gabbagu (27737 in chips)=20
Seat 8: panth26 (58880 in chips)=20
Seat 9: RedHungryHip (63672 in chips)=20
seedload: posts the ante 325
JJin91: posts the ante 325
CerPrisingLe: posts the ante 325
LetsGoMets 6: posts the ante 325
The Gabbagu: posts the ante 325
panth26: posts the ante 325
RedHungryHip: posts the ante 325
RedHungryHip: posts small blind 1250
seedload: posts big blind 2500
*** HOLE CARDS ***
Dealt to JJin91 [7h 5c]
JJin91: folds=20
CerPrisingLe: folds=20
LetsGoMets 6: folds=20
The Gabbagu: folds=20
panth26: raises 3500 to 6000
RedHungryHip: folds=20
seedload: folds=20
Uncalled bet (3500) returned to panth26
panth26 collected 8525 from pot
panth26: doesn't show hand=20
*** SUMMARY ***
Total pot 8525 | Rake 0=20
Seat 1: seedload (big blind) folded before Flop
Seat 2: JJin91 folded before Flop (didn't bet)
Seat 3: CerPrisingLe folded before Flop (didn't bet)
Seat 4: LetsGoMets 6 folded before Flop (didn't bet)
Seat 5: The Gabbagu folded before Flop (didn't bet)
Seat 8: panth26 (button) collected (8525)
Seat 9: RedHungryHip (small blind) folded before Flop


*********** # 128 **************
PokerStars Hand #169562245778: Tournament #1597684117, $4.55+$0.45 USD =
Hold'em No Limit - Level XX (1250/2500) - 2017/05/07 22:44:15 ET
Table '1597684117 1' 9-max Seat #9 is the button
Seat 1: seedload (24975 in chips)=20
Seat 2: JJin91 (98964 in chips)=20
Seat 3: CerPrisingLe (22852 in chips)=20
Seat 4: LetsGoMets 6 (65000 in chips)=20
Seat 5: The Gabbagu (27412 in chips)=20
Seat 8: panth26 (64580 in chips)=20
Seat 9: RedHungryHip (62097 in chips)=20
seedload: posts the ante 325
JJin91: posts the ante 325
CerPrisingLe: posts the ante 325
LetsGoMets 6: posts the ante 325
The Gabbagu: posts the ante 325
panth26: posts the ante 325
RedHungryHip: posts the ante 325
seedload: posts small blind 1250
JJin91: posts big blind 2500
*** HOLE CARDS ***
Dealt to JJin91 [8h 8d]
CerPrisingLe: folds=20
LetsGoMets 6: folds=20
The Gabbagu: folds=20
panth26: raises 3500 to 6000
RedHungryHip: folds=20
seedload: folds=20
JJin91: raises 8500 to 14500
panth26: calls 8500
*** FLOP *** [Qc 5c 9h]
JJin91: checks=20
panth26: bets 16263
JJin91: folds=20
Uncalled bet (16263) returned to panth26
panth26 collected 32525 from pot
panth26: doesn't show hand=20
*** SUMMARY ***
Total pot 32525 | Rake 0=20
Board [Qc 5c 9h]
Seat 1: seedload (small blind) folded before Flop
Seat 2: JJin91 (big blind) folded on the Flop
Seat 3: CerPrisingLe folded before Flop (didn't bet)
Seat 4: LetsGoMets 6 folded before Flop (didn't bet)
Seat 5: The Gabbagu folded before Flop (didn't bet)
Seat 8: panth26 collected (32525)
Seat 9: RedHungryHip (button) folded before Flop (didn't bet)


*********** # 129 **************
PokerStars Hand #169562246065: Tournament #1597684117, $4.55+$0.45 USD =
Hold'em No Limit - Level XX (1250/2500) - 2017/05/07 22:45:12 ET
Table '1597684117 1' 9-max Seat #1 is the button
Seat 1: seedload (23400 in chips)=20
Seat 2: JJin91 (84139 in chips)=20
Seat 3: CerPrisingLe (22527 in chips)=20
Seat 4: LetsGoMets 6 (64675 in chips)=20
Seat 5: The Gabbagu (27087 in chips)=20
Seat 8: panth26 (82280 in chips)=20
Seat 9: RedHungryHip (61772 in chips)=20
seedload: posts the ante 325
JJin91: posts the ante 325
CerPrisingLe: posts the ante 325
LetsGoMets 6: posts the ante 325
The Gabbagu: posts the ante 325
panth26: posts the ante 325
RedHungryHip: posts the ante 325
JJin91: posts small blind 1250
CerPrisingLe: posts big blind 2500
*** HOLE CARDS ***
Dealt to JJin91 [Kh 4h]
LetsGoMets 6: folds=20
The Gabbagu: folds=20
panth26: folds=20
RedHungryHip: folds=20
seedload: raises 20575 to 23075 and is all-in
JJin91: folds=20
CerPrisingLe: folds=20
Uncalled bet (20575) returned to seedload
seedload collected 8525 from pot
seedload: doesn't show hand=20
*** SUMMARY ***
Total pot 8525 | Rake 0=20
Seat 1: seedload (button) collected (8525)
Seat 2: JJin91 (small blind) folded before Flop
Seat 3: CerPrisingLe (big blind) folded before Flop
Seat 4: LetsGoMets 6 folded before Flop (didn't bet)
Seat 5: The Gabbagu folded before Flop (didn't bet)
Seat 8: panth26 folded before Flop (didn't bet)
Seat 9: RedHungryHip folded before Flop (didn't bet)


*********** # 130 **************
PokerStars Hand #169562246164: Tournament #1597684117, $4.55+$0.45 USD =
Hold'em No Limit - Level XX (1250/2500) - 2017/05/07 22:45:29 ET
Table '1597684117 1' 9-max Seat #2 is the button
Seat 1: seedload (29100 in chips)=20
Seat 2: JJin91 (82564 in chips)=20
Seat 3: CerPrisingLe (19702 in chips)=20
Seat 4: LetsGoMets 6 (64350 in chips)=20
Seat 5: The Gabbagu (26762 in chips)=20
Seat 8: panth26 (81955 in chips)=20
Seat 9: RedHungryHip (61447 in chips)=20
seedload: posts the ante 325
JJin91: posts the ante 325
CerPrisingLe: posts the ante 325
LetsGoMets 6: posts the ante 325
The Gabbagu: posts the ante 325
panth26: posts the ante 325
RedHungryHip: posts the ante 325
CerPrisingLe: posts small blind 1250
LetsGoMets 6: posts big blind 2500
*** HOLE CARDS ***
Dealt to JJin91 [7h 2c]
The Gabbagu: folds=20
panth26: folds=20
RedHungryHip: folds=20
seedload: folds=20
JJin91: folds=20
CerPrisingLe: raises 16877 to 19377 and is all-in
LetsGoMets 6: calls 16877
*** FLOP *** [Jc Kh 4h]
*** TURN *** [Jc Kh 4h] [9d]
*** RIVER *** [Jc Kh 4h 9d] [2s]
*** SHOW DOWN ***
CerPrisingLe: shows [Td Ad] (high card Ace)
LetsGoMets 6: shows [As Qh] (high card Ace - King+Queen kicker)
LetsGoMets 6 collected 41029 from pot
CerPrisingLe finished the tournament in 22nd place
*** SUMMARY ***
Total pot 41029 | Rake 0=20
Board [Jc Kh 4h 9d 2s]
Seat 1: seedload folded before Flop (didn't bet)
Seat 2: JJin91 (button) folded before Flop (didn't bet)
Seat 3: CerPrisingLe (small blind) showed [Td Ad] and lost with high ca=
rd Ace
Seat 4: LetsGoMets 6 (big blind) showed [As Qh] and won (41029) with hi=
gh card Ace
Seat 5: The Gabbagu folded before Flop (didn't bet)
Seat 8: panth26 folded before Flop (didn't bet)
Seat 9: RedHungryHip folded before Flop (didn't bet)


*********** # 131 **************
PokerStars Hand #169562246311: Tournament #1597684117, $4.55+$0.45 USD =
Hold'em No Limit - Level XX (1250/2500) - 2017/05/07 22:45:57 ET
Table '1597684117 1' 9-max Seat #4 is the button
Seat 1: seedload (28775 in chips)=20
Seat 2: JJin91 (82239 in chips)=20
Seat 4: LetsGoMets 6 (85677 in chips)=20
Seat 5: The Gabbagu (26437 in chips)=20
Seat 8: panth26 (81630 in chips)=20
Seat 9: RedHungryHip (61122 in chips)=20
seedload: posts the ante 325
JJin91: posts the ante 325
LetsGoMets 6: posts the ante 325
The Gabbagu: posts the ante 325
panth26: posts the ante 325
RedHungryHip: posts the ante 325
The Gabbagu: posts small blind 1250
panth26: posts big blind 2500
*** HOLE CARDS ***
Dealt to JJin91 [3d 4s]
RedHungryHip: folds=20
seedload: folds=20
JJin91: folds=20
LetsGoMets 6: raises 5500 to 8000
The Gabbagu: folds=20
panth26: folds=20
Uncalled bet (5500) returned to LetsGoMets 6
LetsGoMets 6 collected 8200 from pot
LetsGoMets 6: doesn't show hand=20
*** SUMMARY ***
Total pot 8200 | Rake 0=20
Seat 1: seedload folded before Flop (didn't bet)
Seat 2: JJin91 folded before Flop (didn't bet)
Seat 4: LetsGoMets 6 (button) collected (8200)
Seat 5: The Gabbagu (small blind) folded before Flop
Seat 8: panth26 (big blind) folded before Flop
Seat 9: RedHungryHip folded before Flop (didn't bet)


*********** # 132 **************
PokerStars Hand #169562246412: Tournament #1597684117, $4.55+$0.45 USD =
Hold'em No Limit - Level XX (1250/2500) - 2017/05/07 22:46:15 ET
Table '1597684117 1' 9-max Seat #5 is the button
Seat 1: seedload (28450 in chips)=20
Seat 2: JJin91 (81914 in chips)=20
Seat 4: LetsGoMets 6 (91052 in chips)=20
Seat 5: The Gabbagu (24862 in chips)=20
Seat 8: panth26 (78805 in chips)=20
Seat 9: RedHungryHip (60797 in chips)=20
seedload: posts the ante 325
JJin91: posts the ante 325
LetsGoMets 6: posts the ante 325
The Gabbagu: posts the ante 325
panth26: posts the ante 325
RedHungryHip: posts the ante 325
panth26: posts small blind 1250
RedHungryHip: posts big blind 2500
*** HOLE CARDS ***
Dealt to JJin91 [9c 3d]
seedload: folds=20
JJin91: folds=20
LetsGoMets 6: folds=20
The Gabbagu: raises 5000 to 7500
panth26: folds=20
RedHungryHip: folds=20
Uncalled bet (5000) returned to The Gabbagu
The Gabbagu collected 8200 from pot
The Gabbagu: doesn't show hand=20
*** SUMMARY ***
Total pot 8200 | Rake 0=20
Seat 1: seedload folded before Flop (didn't bet)
Seat 2: JJin91 folded before Flop (didn't bet)
Seat 4: LetsGoMets 6 folded before Flop (didn't bet)
Seat 5: The Gabbagu (button) collected (8200)
Seat 8: panth26 (small blind) folded before Flop
Seat 9: RedHungryHip (big blind) folded before Flop


*********** # 133 **************
PokerStars Hand #169562246529: Tournament #1597684117, $4.55+$0.45 USD =
Hold'em No Limit - Level XXI (1500/3000) - 2017/05/07 22:46:38 ET
Table '1597684117 1' 9-max Seat #8 is the button
Seat 1: seedload (28125 in chips)=20
Seat 2: JJin91 (81589 in chips)=20
Seat 3: ks1112 (25455 in chips)=20
Seat 4: LetsGoMets 6 (90727 in chips)=20
Seat 5: The Gabbagu (30237 in chips)=20
Seat 8: panth26 (77230 in chips)=20
Seat 9: RedHungryHip (57972 in chips)=20
seedload: posts the ante 375
JJin91: posts the ante 375
ks1112: posts the ante 375
LetsGoMets 6: posts the ante 375
The Gabbagu: posts the ante 375
panth26: posts the ante 375
RedHungryHip: posts the ante 375
RedHungryHip: posts small blind 1500
seedload: posts big blind 3000
*** HOLE CARDS ***
Dealt to JJin91 [Qc 5s]
JJin91: folds=20
ks1112: folds=20
LetsGoMets 6: folds=20
The Gabbagu: folds=20
panth26: folds=20
RedHungryHip: folds=20
Uncalled bet (1500) returned to seedload
seedload collected 5625 from pot
seedload: doesn't show hand=20
*** SUMMARY ***
Total pot 5625 | Rake 0=20
Seat 1: seedload (big blind) collected (5625)
Seat 2: JJin91 folded before Flop (didn't bet)
Seat 3: ks1112 folded before Flop (didn't bet)
Seat 4: LetsGoMets 6 folded before Flop (didn't bet)
Seat 5: The Gabbagu folded before Flop (didn't bet)
Seat 8: panth26 (button) folded before Flop (didn't bet)
Seat 9: RedHungryHip (small blind) folded before Flop


*********** # 134 **************
PokerStars Hand #169562246654: Tournament #1597684117, $4.55+$0.45 USD =
Hold'em No Limit - Level XXI (1500/3000) - 2017/05/07 22:47:03 ET
Table '1597684117 1' 9-max Seat #9 is the button
Seat 1: seedload (31875 in chips)=20
Seat 2: JJin91 (81214 in chips)=20
Seat 3: ks1112 (25080 in chips)=20
Seat 4: LetsGoMets 6 (90352 in chips)=20
Seat 5: The Gabbagu (29862 in chips)=20
Seat 8: panth26 (76855 in chips)=20
Seat 9: RedHungryHip (56097 in chips)=20
seedload: posts the ante 375
JJin91: posts the ante 375
ks1112: posts the ante 375
LetsGoMets 6: posts the ante 375
The Gabbagu: posts the ante 375
panth26: posts the ante 375
RedHungryHip: posts the ante 375
seedload: posts small blind 1500
JJin91: posts big blind 3000
*** HOLE CARDS ***
Dealt to JJin91 [5s 4d]
ks1112: folds=20
LetsGoMets 6: raises 6000 to 9000
The Gabbagu: raises 20487 to 29487 and is all-in
panth26: folds=20
RedHungryHip: raises 20487 to 49974
seedload: folds=20
JJin91: folds=20
LetsGoMets 6: folds=20
Uncalled bet (20487) returned to RedHungryHip
*** FLOP *** [2s 4s Kc]
*** TURN *** [2s 4s Kc] [Qc]
*** RIVER *** [2s 4s Kc Qc] [2c]
*** SHOW DOWN ***
The Gabbagu: shows [Th Kd] (two pair, Kings and Deuces)
RedHungryHip: shows [As Ac] (two pair, Aces and Deuces)
RedHungryHip collected 75099 from pot
The Gabbagu finished the tournament in 20th place
*** SUMMARY ***
Total pot 75099 | Rake 0=20
Board [2s 4s Kc Qc 2c]
Seat 1: seedload (small blind) folded before Flop
Seat 2: JJin91 (big blind) folded before Flop
Seat 3: ks1112 folded before Flop (didn't bet)
Seat 4: LetsGoMets 6 folded before Flop
Seat 5: The Gabbagu showed [Th Kd] and lost with two pair, Kings and De=
uces
Seat 8: panth26 folded before Flop (didn't bet)
Seat 9: RedHungryHip (button) showed [As Ac] and won (75099) with two p=
air, Aces and Deuces


*********** # 135 **************
PokerStars Hand #169562246879: Tournament #1597684117, $4.55+$0.45 USD =
Hold'em No Limit - Level XXI (1500/3000) - 2017/05/07 22:47:43 ET
Table '1597684117 1' 9-max Seat #1 is the button
Seat 1: seedload (30000 in chips)=20
Seat 2: JJin91 (77839 in chips)=20
Seat 3: ks1112 (24705 in chips)=20
Seat 4: LetsGoMets 6 (80977 in chips)=20
Seat 8: panth26 (76480 in chips)=20
Seat 9: RedHungryHip (101334 in chips)=20
seedload: posts the ante 375
JJin91: posts the ante 375
ks1112: posts the ante 375
LetsGoMets 6: posts the ante 375
panth26: posts the ante 375
RedHungryHip: posts the ante 375
JJin91: posts small blind 1500
ks1112: posts big blind 3000
*** HOLE CARDS ***
Dealt to JJin91 [6c Ac]
LetsGoMets 6: folds=20
panth26: folds=20
RedHungryHip: folds=20
seedload: folds=20
JJin91: raises 74464 to 77464 and is all-in
ks1112: folds=20
Uncalled bet (74464) returned to JJin91
JJin91 collected 8250 from pot
*** SUMMARY ***
Total pot 8250 | Rake 0=20
Seat 1: seedload (button) folded before Flop (didn't bet)
Seat 2: JJin91 (small blind) collected (8250)
Seat 3: ks1112 (big blind) folded before Flop
Seat 4: LetsGoMets 6 folded before Flop (didn't bet)
Seat 8: panth26 folded before Flop (didn't bet)
Seat 9: RedHungryHip folded before Flop (didn't bet)


*********** # 136 **************
PokerStars Hand #169562247055: Tournament #1597684117, $4.55+$0.45 USD =
Hold'em No Limit - Level XXI (1500/3000) - 2017/05/07 22:48:16 ET
Table '1597684117 1' 9-max Seat #2 is the button
Seat 1: seedload (29625 in chips)=20
Seat 2: JJin91 (82714 in chips)=20
Seat 3: ks1112 (21330 in chips)=20
Seat 4: LetsGoMets 6 (80602 in chips)=20
Seat 8: panth26 (76105 in chips)=20
Seat 9: RedHungryHip (100959 in chips)=20
seedload: posts the ante 375
JJin91: posts the ante 375
ks1112: posts the ante 375
LetsGoMets 6: posts the ante 375
panth26: posts the ante 375
RedHungryHip: posts the ante 375
ks1112: posts small blind 1500
LetsGoMets 6: posts big blind 3000
*** HOLE CARDS ***
Dealt to JJin91 [Ts Ks]
ks1112 said, "lol"
panth26: folds=20
RedHungryHip: folds=20
seedload: folds=20
JJin91: raises 3000 to 6000
ks1112: folds=20
LetsGoMets 6: folds=20
Uncalled bet (3000) returned to JJin91
JJin91 collected 9750 from pot
*** SUMMARY ***
Total pot 9750 | Rake 0=20
Seat 1: seedload folded before Flop (didn't bet)
Seat 2: JJin91 (button) collected (9750)
Seat 3: ks1112 (small blind) folded before Flop
Seat 4: LetsGoMets 6 (big blind) folded before Flop
Seat 8: panth26 folded before Flop (didn't bet)
Seat 9: RedHungryHip folded before Flop (didn't bet)


*********** # 137 **************
PokerStars Hand #169562247168: Tournament #1597684117, $4.55+$0.45 USD =
Hold'em No Limit - Level XXI (1500/3000) - 2017/05/07 22:48:39 ET
Table '1597684117 1' 9-max Seat #3 is the button
Seat 1: seedload (29250 in chips)=20
Seat 2: JJin91 (89089 in chips)=20
Seat 3: ks1112 (19455 in chips)=20
Seat 4: LetsGoMets 6 (77227 in chips)=20
Seat 8: panth26 (75730 in chips)=20
Seat 9: RedHungryHip (100584 in chips)=20
seedload: posts the ante 375
JJin91: posts the ante 375
ks1112: posts the ante 375
LetsGoMets 6: posts the ante 375
panth26: posts the ante 375
RedHungryHip: posts the ante 375
LetsGoMets 6: posts small blind 1500
panth26: posts big blind 3000
*** HOLE CARDS ***
Dealt to JJin91 [9h 4h]
RedHungryHip: folds=20
seedload: folds=20
JJin91: folds=20
ks1112: folds=20
LetsGoMets 6: folds=20
Uncalled bet (1500) returned to panth26
panth26 collected 5250 from pot
panth26: doesn't show hand=20
*** SUMMARY ***
Total pot 5250 | Rake 0=20
Seat 1: seedload folded before Flop (didn't bet)
Seat 2: JJin91 folded before Flop (didn't bet)
Seat 3: ks1112 (button) folded before Flop (didn't bet)
Seat 4: LetsGoMets 6 (small blind) folded before Flop
Seat 8: panth26 (big blind) collected (5250)
Seat 9: RedHungryHip folded before Flop (didn't bet)


*********** # 138 **************
PokerStars Hand #169562247288: Tournament #1597684117, $4.55+$0.45 USD =
Hold'em No Limit - Level XXI (1500/3000) - 2017/05/07 22:49:01 ET
Table '1597684117 1' 9-max Seat #4 is the button
Seat 1: seedload (28875 in chips)=20
Seat 2: JJin91 (88714 in chips)=20
Seat 3: ks1112 (19080 in chips)=20
Seat 4: LetsGoMets 6 (75352 in chips)=20
Seat 8: panth26 (79105 in chips)=20
Seat 9: RedHungryHip (100209 in chips)=20
seedload: posts the ante 375
JJin91: posts the ante 375
ks1112: posts the ante 375
LetsGoMets 6: posts the ante 375
panth26: posts the ante 375
RedHungryHip: posts the ante 375
panth26: posts small blind 1500
RedHungryHip: posts big blind 3000
*** HOLE CARDS ***
Dealt to JJin91 [Qs Qd]
seedload: folds=20
JJin91: raises 3000 to 6000
ks1112: folds=20
LetsGoMets 6: calls 6000
panth26: folds=20
RedHungryHip: folds=20
*** FLOP *** [Js 5h 8h]
JJin91: bets 13980
LetsGoMets 6: folds=20
Uncalled bet (13980) returned to JJin91
JJin91 collected 18750 from pot
*** SUMMARY ***
Total pot 18750 | Rake 0=20
Board [Js 5h 8h]
Seat 1: seedload folded before Flop (didn't bet)
Seat 2: JJin91 collected (18750)
Seat 3: ks1112 folded before Flop (didn't bet)
Seat 4: LetsGoMets 6 (button) folded on the Flop
Seat 8: panth26 (small blind) folded before Flop
Seat 9: RedHungryHip (big blind) folded before Flop


*********** # 139 **************
PokerStars Hand #169562247602: Tournament #1597684117, $4.55+$0.45 USD =
Hold'em No Limit - Level XXI (1500/3000) - 2017/05/07 22:50:02 ET
Table '1597684117 1' 9-max Seat #8 is the button
Seat 1: seedload (28500 in chips)=20
Seat 2: JJin91 (101089 in chips)=20
Seat 3: ks1112 (18705 in chips)=20
Seat 4: LetsGoMets 6 (68977 in chips)=20
Seat 5: CRAIG k9 (95860 in chips)=20
Seat 6: anthonyblue1 (91471 in chips)=20
Seat 7: Bsgwolfpack4 (29380 in chips)=20
Seat 8: panth26 (77230 in chips)=20
Seat 9: RedHungryHip (96834 in chips)=20
seedload: posts the ante 375
JJin91: posts the ante 375
ks1112: posts the ante 375
LetsGoMets 6: posts the ante 375
CRAIG k9: posts the ante 375
anthonyblue1: posts the ante 375
Bsgwolfpack4: posts the ante 375
panth26: posts the ante 375
RedHungryHip: posts the ante 375
RedHungryHip: posts small blind 1500
seedload: posts big blind 3000
*** HOLE CARDS ***
Dealt to JJin91 [7h 7c]
JJin91: raises 3000 to 6000
ks1112: folds=20
LetsGoMets 6: folds=20
CRAIG k9: folds=20
anthonyblue1: calls 6000
Bsgwolfpack4: folds=20
panth26: folds=20
RedHungryHip: folds=20
seedload: calls 3000
*** FLOP *** [Ts 6d 8d]
seedload: checks=20
JJin91: checks=20
anthonyblue1: bets 9000
seedload: folds=20
JJin91: folds=20
Uncalled bet (9000) returned to anthonyblue1
anthonyblue1 collected 22875 from pot
anthonyblue1: doesn't show hand=20
*** SUMMARY ***
Total pot 22875 | Rake 0=20
Board [Ts 6d 8d]
Seat 1: seedload (big blind) folded on the Flop
Seat 2: JJin91 folded on the Flop
Seat 3: ks1112 folded before Flop (didn't bet)
Seat 4: LetsGoMets 6 folded before Flop (didn't bet)
Seat 5: CRAIG k9 folded before Flop (didn't bet)
Seat 6: anthonyblue1 collected (22875)
Seat 7: Bsgwolfpack4 folded before Flop (didn't bet)
Seat 8: panth26 (button) folded before Flop (didn't bet)
Seat 9: RedHungryHip (small blind) folded before Flop


*********** # 140 **************
PokerStars Hand #169562247784: Tournament #1597684117, $4.55+$0.45 USD =
Hold'em No Limit - Level XXI (1500/3000) - 2017/05/07 22:50:39 ET
Table '1597684117 1' 9-max Seat #9 is the button
Seat 1: seedload (22125 in chips)=20
Seat 2: JJin91 (94714 in chips)=20
Seat 3: ks1112 (18330 in chips)=20
Seat 4: LetsGoMets 6 (68602 in chips)=20
Seat 5: CRAIG k9 (95485 in chips)=20
Seat 6: anthonyblue1 (107971 in chips)=20
Seat 7: Bsgwolfpack4 (29005 in chips)=20
Seat 8: panth26 (76855 in chips)=20
Seat 9: RedHungryHip (94959 in chips)=20
seedload: posts the ante 375
JJin91: posts the ante 375
ks1112: posts the ante 375
LetsGoMets 6: posts the ante 375
CRAIG k9: posts the ante 375
anthonyblue1: posts the ante 375
Bsgwolfpack4: posts the ante 375
panth26: posts the ante 375
RedHungryHip: posts the ante 375
seedload: posts small blind 1500
JJin91: posts big blind 3000
*** HOLE CARDS ***
Dealt to JJin91 [7c Qc]
ks1112: folds=20
LetsGoMets 6: folds=20
CRAIG k9: folds=20
anthonyblue1: folds=20
Bsgwolfpack4: raises 25630 to 28630 and is all-in
panth26: folds=20
RedHungryHip: folds=20
seedload: folds=20
JJin91: folds=20
Uncalled bet (25630) returned to Bsgwolfpack4
Bsgwolfpack4 collected 10875 from pot
Bsgwolfpack4: doesn't show hand=20
*** SUMMARY ***
Total pot 10875 | Rake 0=20
Seat 1: seedload (small blind) folded before Flop
Seat 2: JJin91 (big blind) folded before Flop
Seat 3: ks1112 folded before Flop (didn't bet)
Seat 4: LetsGoMets 6 folded before Flop (didn't bet)
Seat 5: CRAIG k9 folded before Flop (didn't bet)
Seat 6: anthonyblue1 folded before Flop (didn't bet)
Seat 7: Bsgwolfpack4 collected (10875)
Seat 8: panth26 folded before Flop (didn't bet)
Seat 9: RedHungryHip (button) folded before Flop (didn't bet)


*********** # 141 **************
PokerStars Hand #169562247932: Tournament #1597684117, $4.55+$0.45 USD =
Hold'em No Limit - Level XXI (1500/3000) - 2017/05/07 22:51:08 ET
Table '1597684117 1' 9-max Seat #1 is the button
Seat 1: seedload (20250 in chips)=20
Seat 2: JJin91 (91339 in chips)=20
Seat 3: ks1112 (17955 in chips)=20
Seat 4: LetsGoMets 6 (68227 in chips)=20
Seat 5: CRAIG k9 (95110 in chips)=20
Seat 6: anthonyblue1 (107596 in chips)=20
Seat 7: Bsgwolfpack4 (36505 in chips)=20
Seat 8: panth26 (76480 in chips)=20
Seat 9: RedHungryHip (94584 in chips)=20
seedload: posts the ante 375
JJin91: posts the ante 375
ks1112: posts the ante 375
LetsGoMets 6: posts the ante 375
CRAIG k9: posts the ante 375
anthonyblue1: posts the ante 375
Bsgwolfpack4: posts the ante 375
panth26: posts the ante 375
RedHungryHip: posts the ante 375
JJin91: posts small blind 1500
ks1112: posts big blind 3000
*** HOLE CARDS ***
Dealt to JJin91 [Ad 9d]
LetsGoMets 6: folds=20
CRAIG k9: calls 3000
anthonyblue1: calls 3000
Bsgwolfpack4: folds=20
panth26: folds=20
RedHungryHip: folds=20
seedload: raises 16875 to 19875 and is all-in
JJin91: calls 18375
ks1112: folds=20
CRAIG k9: folds=20
anthonyblue1: folds=20
*** FLOP *** [2h Th 4c]
*** TURN *** [2h Th 4c] [6c]
*** RIVER *** [2h Th 4c 6c] [4s]
*** SHOW DOWN ***
JJin91: shows [Ad 9d] (a pair of Fours)
seedload: shows [5c 5d] (two pair, Fives and Fours)
seedload collected 52125 from pot
*** SUMMARY ***
Total pot 52125 | Rake 0=20
Board [2h Th 4c 6c 4s]
Seat 1: seedload (button) showed [5c 5d] and won (52125) with two pair,=
 Fives and Fours
Seat 2: JJin91 (small blind) showed [Ad 9d] and lost with a pair of Fou=
rs
Seat 3: ks1112 (big blind) folded before Flop
Seat 4: LetsGoMets 6 folded before Flop (didn't bet)
Seat 5: CRAIG k9 folded before Flop
Seat 6: anthonyblue1 folded before Flop
Seat 7: Bsgwolfpack4 folded before Flop (didn't bet)
Seat 8: panth26 folded before Flop (didn't bet)
Seat 9: RedHungryHip folded before Flop (didn't bet)


*********** # 142 **************
PokerStars Hand #169562248207: Tournament #1597684117, $4.55+$0.45 USD =
Hold'em No Limit - Level XXII (2000/4000) - 2017/05/07 22:52:02 ET
Table '1597684117 1' 9-max Seat #2 is the button
Seat 1: seedload (52125 in chips)=20
Seat 2: JJin91 (71089 in chips)=20
Seat 3: ks1112 (14580 in chips)=20
Seat 4: LetsGoMets 6 (67852 in chips)=20
Seat 5: CRAIG k9 (91735 in chips)=20
Seat 6: anthonyblue1 (104221 in chips)=20
Seat 7: Bsgwolfpack4 (36130 in chips)=20
Seat 8: panth26 (76105 in chips)=20
Seat 9: RedHungryHip (94209 in chips)=20
seedload: posts the ante 500
JJin91: posts the ante 500
ks1112: posts the ante 500
LetsGoMets 6: posts the ante 500
CRAIG k9: posts the ante 500
anthonyblue1: posts the ante 500
Bsgwolfpack4: posts the ante 500
panth26: posts the ante 500
RedHungryHip: posts the ante 500
ks1112: posts small blind 2000
LetsGoMets 6: posts big blind 4000
*** HOLE CARDS ***
Dealt to JJin91 [9s Th]
CRAIG k9: folds=20
anthonyblue1: folds=20
Bsgwolfpack4: folds=20
panth26: folds=20
RedHungryHip: folds=20
seedload: folds=20
JJin91: folds=20
ks1112: folds=20
Uncalled bet (2000) returned to LetsGoMets 6
LetsGoMets 6 collected 8500 from pot
LetsGoMets 6: doesn't show hand=20
*** SUMMARY ***
Total pot 8500 | Rake 0=20
Seat 1: seedload folded before Flop (didn't bet)
Seat 2: JJin91 (button) folded before Flop (didn't bet)
Seat 3: ks1112 (small blind) folded before Flop
Seat 4: LetsGoMets 6 (big blind) collected (8500)
Seat 5: CRAIG k9 folded before Flop (didn't bet)
Seat 6: anthonyblue1 folded before Flop (didn't bet)
Seat 7: Bsgwolfpack4 folded before Flop (didn't bet)
Seat 8: panth26 folded before Flop (didn't bet)
Seat 9: RedHungryHip folded before Flop (didn't bet)


*********** # 143 **************
PokerStars Hand #169562248375: Tournament #1597684117, $4.55+$0.45 USD =
Hold'em No Limit - Level XXII (2000/4000) - 2017/05/07 22:52:34 ET
Table '1597684117 1' 9-max Seat #3 is the button
Seat 1: seedload (51625 in chips)=20
Seat 2: JJin91 (70589 in chips)=20
Seat 3: ks1112 (12080 in chips)=20
Seat 4: LetsGoMets 6 (73852 in chips)=20
Seat 5: CRAIG k9 (91235 in chips)=20
Seat 6: anthonyblue1 (103721 in chips)=20
Seat 7: Bsgwolfpack4 (35630 in chips)=20
Seat 8: panth26 (75605 in chips)=20
Seat 9: RedHungryHip (93709 in chips)=20
seedload: posts the ante 500
JJin91: posts the ante 500
ks1112: posts the ante 500
LetsGoMets 6: posts the ante 500
CRAIG k9: posts the ante 500
anthonyblue1: posts the ante 500
Bsgwolfpack4: posts the ante 500
panth26: posts the ante 500
RedHungryHip: posts the ante 500
LetsGoMets 6: posts small blind 2000
CRAIG k9: posts big blind 4000
*** HOLE CARDS ***
Dealt to JJin91 [Kc 8h]
anthonyblue1: folds=20
Bsgwolfpack4: folds=20
panth26: folds=20
RedHungryHip: folds=20
seedload: folds=20
JJin91: folds=20
ks1112: folds=20
LetsGoMets 6: folds=20
Uncalled bet (2000) returned to CRAIG k9
CRAIG k9 collected 8500 from pot
CRAIG k9: doesn't show hand=20
*** SUMMARY ***
Total pot 8500 | Rake 0=20
Seat 1: seedload folded before Flop (didn't bet)
Seat 2: JJin91 folded before Flop (didn't bet)
Seat 3: ks1112 (button) folded before Flop (didn't bet)
Seat 4: LetsGoMets 6 (small blind) folded before Flop
Seat 5: CRAIG k9 (big blind) collected (8500)
Seat 6: anthonyblue1 folded before Flop (didn't bet)
Seat 7: Bsgwolfpack4 folded before Flop (didn't bet)
Seat 8: panth26 folded before Flop (didn't bet)
Seat 9: RedHungryHip folded before Flop (didn't bet)


*********** # 144 **************
PokerStars Hand #169562248448: Tournament #1597684117, $4.55+$0.45 USD =
Hold'em No Limit - Level XXII (2000/4000) - 2017/05/07 22:52:47 ET
Table '1597684117 1' 9-max Seat #4 is the button
Seat 1: seedload (51125 in chips)=20
Seat 2: JJin91 (70089 in chips)=20
Seat 3: ks1112 (11580 in chips)=20
Seat 4: LetsGoMets 6 (71352 in chips)=20
Seat 5: CRAIG k9 (97235 in chips)=20
Seat 6: anthonyblue1 (103221 in chips)=20
Seat 7: Bsgwolfpack4 (35130 in chips)=20
Seat 8: panth26 (75105 in chips)=20
Seat 9: RedHungryHip (93209 in chips)=20
seedload: posts the ante 500
JJin91: posts the ante 500
ks1112: posts the ante 500
LetsGoMets 6: posts the ante 500
CRAIG k9: posts the ante 500
anthonyblue1: posts the ante 500
Bsgwolfpack4: posts the ante 500
panth26: posts the ante 500
RedHungryHip: posts the ante 500
CRAIG k9: posts small blind 2000
anthonyblue1: posts big blind 4000
*** HOLE CARDS ***
Dealt to JJin91 [9s Ah]
Bsgwolfpack4: folds=20
panth26: folds=20
RedHungryHip: folds=20
seedload: folds=20
JJin91: raises 4000 to 8000
ks1112: folds=20
LetsGoMets 6: folds=20
CRAIG k9: calls 6000
anthonyblue1: folds=20
*** FLOP *** [9d Qh Kc]
CRAIG k9: checks=20
JJin91: bets 12000
CRAIG k9: raises 76735 to 88735 and is all-in
JJin91: folds=20
Uncalled bet (76735) returned to CRAIG k9
CRAIG k9 collected 48500 from pot
CRAIG k9: doesn't show hand=20
*** SUMMARY ***
Total pot 48500 | Rake 0=20
Board [9d Qh Kc]
Seat 1: seedload folded before Flop (didn't bet)
Seat 2: JJin91 folded on the Flop
Seat 3: ks1112 folded before Flop (didn't bet)
Seat 4: LetsGoMets 6 (button) folded before Flop (didn't bet)
Seat 5: CRAIG k9 (small blind) collected (48500)
Seat 6: anthonyblue1 (big blind) folded before Flop
Seat 7: Bsgwolfpack4 folded before Flop (didn't bet)
Seat 8: panth26 folded before Flop (didn't bet)
Seat 9: RedHungryHip folded before Flop (didn't bet)


*********** # 145 **************
PokerStars Hand #169562248663: Tournament #1597684117, $4.55+$0.45 USD =
Hold'em No Limit - Level XXII (2000/4000) - 2017/05/07 22:53:29 ET
Table '1597684117 1' 9-max Seat #5 is the button
Seat 1: seedload (50625 in chips)=20
Seat 2: JJin91 (49589 in chips)=20
Seat 3: ks1112 (11080 in chips)=20
Seat 4: LetsGoMets 6 (70852 in chips)=20
Seat 5: CRAIG k9 (125235 in chips)=20
Seat 6: anthonyblue1 (98721 in chips)=20
Seat 7: Bsgwolfpack4 (34630 in chips)=20
Seat 8: panth26 (74605 in chips)=20
Seat 9: RedHungryHip (92709 in chips)=20
seedload: posts the ante 500
JJin91: posts the ante 500
ks1112: posts the ante 500
LetsGoMets 6: posts the ante 500
CRAIG k9: posts the ante 500
anthonyblue1: posts the ante 500
Bsgwolfpack4: posts the ante 500
panth26: posts the ante 500
RedHungryHip: posts the ante 500
anthonyblue1: posts small blind 2000
Bsgwolfpack4: posts big blind 4000
*** HOLE CARDS ***
Dealt to JJin91 [2d 6c]
panth26: folds=20
RedHungryHip: folds=20
seedload: folds=20
JJin91: folds=20
ks1112: folds=20
LetsGoMets 6: folds=20
CRAIG k9: folds=20
anthonyblue1: folds=20
Uncalled bet (2000) returned to Bsgwolfpack4
Bsgwolfpack4 collected 8500 from pot
Bsgwolfpack4: doesn't show hand=20
*** SUMMARY ***
Total pot 8500 | Rake 0=20
Seat 1: seedload folded before Flop (didn't bet)
Seat 2: JJin91 folded before Flop (didn't bet)
Seat 3: ks1112 folded before Flop (didn't bet)
Seat 4: LetsGoMets 6 folded before Flop (didn't bet)
Seat 5: CRAIG k9 (button) folded before Flop (didn't bet)
Seat 6: anthonyblue1 (small blind) folded before Flop
Seat 7: Bsgwolfpack4 (big blind) collected (8500)
Seat 8: panth26 folded before Flop (didn't bet)
Seat 9: RedHungryHip folded before Flop (didn't bet)


*********** # 146 **************
PokerStars Hand #169562248759: Tournament #1597684117, $4.55+$0.45 USD =
Hold'em No Limit - Level XXII (2000/4000) - 2017/05/07 22:53:47 ET
Table '1597684117 1' 9-max Seat #6 is the button
Seat 1: seedload (50125 in chips)=20
Seat 2: JJin91 (49089 in chips)=20
Seat 3: ks1112 (10580 in chips)=20
Seat 4: LetsGoMets 6 (70352 in chips)=20
Seat 5: CRAIG k9 (124735 in chips)=20
Seat 6: anthonyblue1 (96221 in chips)=20
Seat 7: Bsgwolfpack4 (40630 in chips)=20
Seat 8: panth26 (74105 in chips)=20
Seat 9: RedHungryHip (92209 in chips)=20
seedload: posts the ante 500
JJin91: posts the ante 500
ks1112: posts the ante 500
LetsGoMets 6: posts the ante 500
CRAIG k9: posts the ante 500
anthonyblue1: posts the ante 500
Bsgwolfpack4: posts the ante 500
panth26: posts the ante 500
RedHungryHip: posts the ante 500
Bsgwolfpack4: posts small blind 2000
panth26: posts big blind 4000
*** HOLE CARDS ***
Dealt to JJin91 [2h 2c]
RedHungryHip: folds=20
seedload: folds=20
JJin91: folds=20
ks1112: folds=20
LetsGoMets 6: folds=20
CRAIG k9: folds=20
anthonyblue1: folds=20
Bsgwolfpack4: folds=20
Uncalled bet (2000) returned to panth26
panth26 collected 8500 from pot
panth26: doesn't show hand=20
*** SUMMARY ***
Total pot 8500 | Rake 0=20
Seat 1: seedload folded before Flop (didn't bet)
Seat 2: JJin91 folded before Flop (didn't bet)
Seat 3: ks1112 folded before Flop (didn't bet)
Seat 4: LetsGoMets 6 folded before Flop (didn't bet)
Seat 5: CRAIG k9 folded before Flop (didn't bet)
Seat 6: anthonyblue1 (button) folded before Flop (didn't bet)
Seat 7: Bsgwolfpack4 (small blind) folded before Flop
Seat 8: panth26 (big blind) collected (8500)
Seat 9: RedHungryHip folded before Flop (didn't bet)


*********** # 147 **************
PokerStars Hand #169562248875: Tournament #1597684117, $4.55+$0.45 USD =
Hold'em No Limit - Level XXII (2000/4000) - 2017/05/07 22:54:08 ET
Table '1597684117 1' 9-max Seat #7 is the button
Seat 1: seedload (49625 in chips)=20
Seat 2: JJin91 (48589 in chips)=20
Seat 3: ks1112 (10080 in chips)=20
Seat 4: LetsGoMets 6 (69852 in chips)=20
Seat 5: CRAIG k9 (124235 in chips)=20
Seat 6: anthonyblue1 (95721 in chips)=20
Seat 7: Bsgwolfpack4 (38130 in chips)=20
Seat 8: panth26 (80105 in chips)=20
Seat 9: RedHungryHip (91709 in chips)=20
seedload: posts the ante 500
JJin91: posts the ante 500
ks1112: posts the ante 500
LetsGoMets 6: posts the ante 500
CRAIG k9: posts the ante 500
anthonyblue1: posts the ante 500
Bsgwolfpack4: posts the ante 500
panth26: posts the ante 500
RedHungryHip: posts the ante 500
panth26: posts small blind 2000
RedHungryHip: posts big blind 4000
*** HOLE CARDS ***
Dealt to JJin91 [Th Ks]
seedload: folds=20
JJin91: folds=20
ks1112: folds=20
LetsGoMets 6: raises 8000 to 12000
CRAIG k9: folds=20
anthonyblue1: folds=20
Bsgwolfpack4: folds=20
panth26: folds=20
RedHungryHip: folds=20
Uncalled bet (8000) returned to LetsGoMets 6
LetsGoMets 6 collected 14500 from pot
LetsGoMets 6: doesn't show hand=20
*** SUMMARY ***
Total pot 14500 | Rake 0=20
Seat 1: seedload folded before Flop (didn't bet)
Seat 2: JJin91 folded before Flop (didn't bet)
Seat 3: ks1112 folded before Flop (didn't bet)
Seat 4: LetsGoMets 6 collected (14500)
Seat 5: CRAIG k9 folded before Flop (didn't bet)
Seat 6: anthonyblue1 folded before Flop (didn't bet)
Seat 7: Bsgwolfpack4 (button) folded before Flop (didn't bet)
Seat 8: panth26 (small blind) folded before Flop
Seat 9: RedHungryHip (big blind) folded before Flop


*********** # 148 **************
PokerStars Hand #169562249072: Tournament #1597684117, $4.55+$0.45 USD =
Hold'em No Limit - Level XXII (2000/4000) - 2017/05/07 22:54:41 ET
Table '1597684117 1' 9-max Seat #8 is the button
Seat 1: seedload (49125 in chips)=20
Seat 2: JJin91 (48089 in chips)=20
Seat 3: ks1112 (9580 in chips)=20
Seat 4: LetsGoMets 6 (79852 in chips)=20
Seat 5: CRAIG k9 (123735 in chips)=20
Seat 6: anthonyblue1 (95221 in chips)=20
Seat 7: Bsgwolfpack4 (37630 in chips)=20
Seat 8: panth26 (77605 in chips)=20
Seat 9: RedHungryHip (87209 in chips)=20
seedload: posts the ante 500
JJin91: posts the ante 500
ks1112: posts the ante 500
LetsGoMets 6: posts the ante 500
CRAIG k9: posts the ante 500
anthonyblue1: posts the ante 500
Bsgwolfpack4: posts the ante 500
panth26: posts the ante 500
RedHungryHip: posts the ante 500
RedHungryHip: posts small blind 2000
seedload: posts big blind 4000
*** HOLE CARDS ***
Dealt to JJin91 [7c 6s]
JJin91: folds=20
ks1112: folds=20
LetsGoMets 6: raises 5000 to 9000
CRAIG k9: folds=20
anthonyblue1: folds=20
Bsgwolfpack4: folds=20
panth26: folds=20
RedHungryHip: folds=20
seedload: folds=20
Uncalled bet (5000) returned to LetsGoMets 6
LetsGoMets 6 collected 14500 from pot
LetsGoMets 6: doesn't show hand=20
*** SUMMARY ***
Total pot 14500 | Rake 0=20
Seat 1: seedload (big blind) folded before Flop
Seat 2: JJin91 folded before Flop (didn't bet)
Seat 3: ks1112 folded before Flop (didn't bet)
Seat 4: LetsGoMets 6 collected (14500)
Seat 5: CRAIG k9 folded before Flop (didn't bet)
Seat 6: anthonyblue1 folded before Flop (didn't bet)
Seat 7: Bsgwolfpack4 folded before Flop (didn't bet)
Seat 8: panth26 (button) folded before Flop (didn't bet)
Seat 9: RedHungryHip (small blind) folded before Flop


*********** # 149 **************
PokerStars Hand #169562249202: Tournament #1597684117, $4.55+$0.45 USD =
Hold'em No Limit - Level XXII (2000/4000) - 2017/05/07 22:55:04 ET
Table '1597684117 1' 9-max Seat #9 is the button
Seat 1: seedload (44625 in chips)=20
Seat 2: JJin91 (47589 in chips)=20
Seat 3: ks1112 (9080 in chips)=20
Seat 4: LetsGoMets 6 (89852 in chips)=20
Seat 5: CRAIG k9 (123235 in chips)=20
Seat 6: anthonyblue1 (94721 in chips)=20
Seat 7: Bsgwolfpack4 (37130 in chips)=20
Seat 8: panth26 (77105 in chips)=20
Seat 9: RedHungryHip (84709 in chips)=20
seedload: posts the ante 500
JJin91: posts the ante 500
ks1112: posts the ante 500
LetsGoMets 6: posts the ante 500
CRAIG k9: posts the ante 500
anthonyblue1: posts the ante 500
Bsgwolfpack4: posts the ante 500
panth26: posts the ante 500
RedHungryHip: posts the ante 500
seedload: posts small blind 2000
JJin91: posts big blind 4000
*** HOLE CARDS ***
Dealt to JJin91 [5c 6s]
ks1112 has timed out
ks1112: folds=20
ks1112 is sitting out
LetsGoMets 6: folds=20
CRAIG k9: folds=20
anthonyblue1: folds=20
Bsgwolfpack4: folds=20
panth26: folds=20
RedHungryHip: folds=20
ks1112 has returned
seedload: folds=20
Uncalled bet (2000) returned to JJin91
JJin91 collected 8500 from pot
*** SUMMARY ***
Total pot 8500 | Rake 0=20
Seat 1: seedload (small blind) folded before Flop
Seat 2: JJin91 (big blind) collected (8500)
Seat 3: ks1112 folded before Flop (didn't bet)
Seat 4: LetsGoMets 6 folded before Flop (didn't bet)
Seat 5: CRAIG k9 folded before Flop (didn't bet)
Seat 6: anthonyblue1 folded before Flop (didn't bet)
Seat 7: Bsgwolfpack4 folded before Flop (didn't bet)
Seat 8: panth26 folded before Flop (didn't bet)
Seat 9: RedHungryHip (button) folded before Flop (didn't bet)


*********** # 150 **************
PokerStars Hand #169563176968: Tournament #1597684117, $4.55+$0.45 USD =
Hold'em No Limit - Level XXII (2000/4000) - 2017/05/07 23:00:35 ET
Table '1597684117 1' 9-max Seat #1 is the button
Seat 1: seedload (42125 in chips)=20
Seat 2: JJin91 (53589 in chips)=20
Seat 3: ks1112 (8580 in chips)=20
Seat 4: LetsGoMets 6 (89352 in chips)=20
Seat 5: CRAIG k9 (122735 in chips)=20
Seat 6: anthonyblue1 (94221 in chips)=20
Seat 7: Bsgwolfpack4 (36630 in chips)=20
Seat 8: panth26 (76605 in chips)=20
Seat 9: RedHungryHip (84209 in chips)=20
seedload: posts the ante 500
JJin91: posts the ante 500
ks1112: posts the ante 500
LetsGoMets 6: posts the ante 500
CRAIG k9: posts the ante 500
anthonyblue1: posts the ante 500
Bsgwolfpack4: posts the ante 500
panth26: posts the ante 500
RedHungryHip: posts the ante 500
JJin91: posts small blind 2000
ks1112: posts big blind 4000
*** HOLE CARDS ***
Dealt to JJin91 [9d Qh]
LetsGoMets 6: folds=20
CRAIG k9: folds=20
anthonyblue1: folds=20
Bsgwolfpack4: folds=20
panth26: folds=20
RedHungryHip: raises 4000 to 8000
seedload: folds=20
JJin91: folds=20
ks1112: folds=20
Uncalled bet (4000) returned to RedHungryHip
RedHungryHip collected 14500 from pot
RedHungryHip: doesn't show hand=20
*** SUMMARY ***
Total pot 14500 | Rake 0=20
Seat 1: seedload (button) folded before Flop (didn't bet)
Seat 2: JJin91 (small blind) folded before Flop
Seat 3: ks1112 (big blind) folded before Flop
Seat 4: LetsGoMets 6 folded before Flop (didn't bet)
Seat 5: CRAIG k9 folded before Flop (didn't bet)
Seat 6: anthonyblue1 folded before Flop (didn't bet)
Seat 7: Bsgwolfpack4 folded before Flop (didn't bet)
Seat 8: panth26 folded before Flop (didn't bet)
Seat 9: RedHungryHip collected (14500)


*********** # 151 **************
PokerStars Hand #169563177141: Tournament #1597684117, $4.55+$0.45 USD =
Hold'em No Limit - Level XXII (2000/4000) - 2017/05/07 23:01:14 ET
Table '1597684117 1' 9-max Seat #2 is the button
Seat 1: seedload (41625 in chips)=20
Seat 2: JJin91 (51089 in chips)=20
Seat 3: ks1112 (4080 in chips)=20
Seat 4: LetsGoMets 6 (88852 in chips)=20
Seat 5: CRAIG k9 (122235 in chips)=20
Seat 6: anthonyblue1 (93721 in chips)=20
Seat 7: Bsgwolfpack4 (36130 in chips)=20
Seat 8: panth26 (76105 in chips)=20
Seat 9: RedHungryHip (94209 in chips)=20
seedload: posts the ante 500
JJin91: posts the ante 500
ks1112: posts the ante 500
LetsGoMets 6: posts the ante 500
CRAIG k9: posts the ante 500
anthonyblue1: posts the ante 500
Bsgwolfpack4: posts the ante 500
panth26: posts the ante 500
RedHungryHip: posts the ante 500
ks1112: posts small blind 2000
LetsGoMets 6: posts big blind 4000
*** HOLE CARDS ***
Dealt to JJin91 [Ts 8h]
CRAIG k9: calls 4000
anthonyblue1: folds=20
Bsgwolfpack4: folds=20
panth26: folds=20
RedHungryHip: folds=20
seedload: calls 4000
JJin91: folds=20
ks1112: folds=20
LetsGoMets 6: checks=20
*** FLOP *** [4d 8s 7s]
LetsGoMets 6: checks=20
CRAIG k9: checks=20
seedload: checks=20
*** TURN *** [4d 8s 7s] [Jd]
LetsGoMets 6: checks=20
CRAIG k9: bets 4000
seedload: raises 13250 to 17250
LetsGoMets 6: folds=20
CRAIG k9: folds=20
Uncalled bet (13250) returned to seedload
seedload collected 26500 from pot
seedload: doesn't show hand=20
*** SUMMARY ***
Total pot 26500 | Rake 0=20
Board [4d 8s 7s Jd]
Seat 1: seedload collected (26500)
Seat 2: JJin91 (button) folded before Flop (didn't bet)
Seat 3: ks1112 (small blind) folded before Flop
Seat 4: LetsGoMets 6 (big blind) folded on the Turn
Seat 5: CRAIG k9 folded on the Turn
Seat 6: anthonyblue1 folded before Flop (didn't bet)
Seat 7: Bsgwolfpack4 folded before Flop (didn't bet)
Seat 8: panth26 folded before Flop (didn't bet)
Seat 9: RedHungryHip folded before Flop (didn't bet)


*********** # 152 **************
PokerStars Hand #169563177394: Tournament #1597684117, $4.55+$0.45 USD =
Hold'em No Limit - Level XXIII (2500/5000) - 2017/05/07 23:02:06 ET
Table '1597684117 1' 9-max Seat #3 is the button
Seat 1: seedload (59625 in chips)=20
Seat 2: JJin91 (50589 in chips)=20
Seat 3: ks1112 (1580 in chips)=20
Seat 4: LetsGoMets 6 (84352 in chips)=20
Seat 5: CRAIG k9 (113735 in chips)=20
Seat 6: anthonyblue1 (93221 in chips)=20
Seat 7: Bsgwolfpack4 (35630 in chips)=20
Seat 8: panth26 (75605 in chips)=20
Seat 9: RedHungryHip (93709 in chips)=20
seedload: posts the ante 625
JJin91: posts the ante 625
ks1112: posts the ante 625
LetsGoMets 6: posts the ante 625
CRAIG k9: posts the ante 625
anthonyblue1: posts the ante 625
Bsgwolfpack4: posts the ante 625
panth26: posts the ante 625
RedHungryHip: posts the ante 625
LetsGoMets 6: posts small blind 2500
CRAIG k9: posts big blind 5000
*** HOLE CARDS ***
Dealt to JJin91 [2c 4h]
anthonyblue1: folds=20
Bsgwolfpack4: folds=20
panth26: folds=20
RedHungryHip: folds=20
seedload: folds=20
JJin91: folds=20
ks1112: folds=20
LetsGoMets 6: raises 5000 to 10000
CRAIG k9: folds=20
Uncalled bet (5000) returned to LetsGoMets 6
LetsGoMets 6 collected 15625 from pot
LetsGoMets 6: doesn't show hand=20
*** SUMMARY ***
Total pot 15625 | Rake 0=20
Seat 1: seedload folded before Flop (didn't bet)
Seat 2: JJin91 folded before Flop (didn't bet)
Seat 3: ks1112 (button) folded before Flop (didn't bet)
Seat 4: LetsGoMets 6 (small blind) collected (15625)
Seat 5: CRAIG k9 (big blind) folded before Flop
Seat 6: anthonyblue1 folded before Flop (didn't bet)
Seat 7: Bsgwolfpack4 folded before Flop (didn't bet)
Seat 8: panth26 folded before Flop (didn't bet)
Seat 9: RedHungryHip folded before Flop (didn't bet)


*********** # 153 **************
PokerStars Hand #169563177489: Tournament #1597684117, $4.55+$0.45 USD =
Hold'em No Limit - Level XXIII (2500/5000) - 2017/05/07 23:02:25 ET
Table '1597684117 1' 9-max Seat #4 is the button
Seat 1: seedload (59000 in chips)=20
Seat 2: JJin91 (49964 in chips)=20
Seat 3: ks1112 (955 in chips)=20
Seat 4: LetsGoMets 6 (94352 in chips)=20
Seat 5: CRAIG k9 (108110 in chips)=20
Seat 6: anthonyblue1 (92596 in chips)=20
Seat 7: Bsgwolfpack4 (35005 in chips)=20
Seat 8: panth26 (74980 in chips)=20
Seat 9: RedHungryHip (93084 in chips)=20
seedload: posts the ante 625
JJin91: posts the ante 625
ks1112: posts the ante 625
LetsGoMets 6: posts the ante 625
CRAIG k9: posts the ante 625
anthonyblue1: posts the ante 625
Bsgwolfpack4: posts the ante 625
panth26: posts the ante 625
RedHungryHip: posts the ante 625
CRAIG k9: posts small blind 2500
anthonyblue1: posts big blind 5000
*** HOLE CARDS ***
Dealt to JJin91 [9h Ad]
Bsgwolfpack4: folds=20
panth26: folds=20
RedHungryHip: folds=20
seedload: folds=20
JJin91: raises 5000 to 10000
ks1112: folds=20
LetsGoMets 6: folds=20
CRAIG k9: folds=20
anthonyblue1: folds=20
Uncalled bet (5000) returned to JJin91
JJin91 collected 18125 from pot
*** SUMMARY ***
Total pot 18125 | Rake 0=20
Seat 1: seedload folded before Flop (didn't bet)
Seat 2: JJin91 collected (18125)
Seat 3: ks1112 folded before Flop (didn't bet)
Seat 4: LetsGoMets 6 (button) folded before Flop (didn't bet)
Seat 5: CRAIG k9 (small blind) folded before Flop
Seat 6: anthonyblue1 (big blind) folded before Flop
Seat 7: Bsgwolfpack4 folded before Flop (didn't bet)
Seat 8: panth26 folded before Flop (didn't bet)
Seat 9: RedHungryHip folded before Flop (didn't bet)


*********** # 154 **************
PokerStars Hand #169563177584: Tournament #1597684117, $4.55+$0.45 USD =
Hold'em No Limit - Level XXIII (2500/5000) - 2017/05/07 23:02:45 ET
Table '1597684117 1' 9-max Seat #5 is the button
Seat 1: seedload (58375 in chips)=20
Seat 2: JJin91 (62464 in chips)=20
Seat 3: ks1112 (330 in chips)=20
Seat 4: LetsGoMets 6 (93727 in chips)=20
Seat 5: CRAIG k9 (104985 in chips)=20
Seat 6: anthonyblue1 (86971 in chips)=20
Seat 7: Bsgwolfpack4 (34380 in chips)=20
Seat 8: panth26 (74355 in chips)=20
Seat 9: RedHungryHip (92459 in chips)=20
seedload: posts the ante 625
JJin91: posts the ante 625
ks1112: posts the ante 330 and is all-in
LetsGoMets 6: posts the ante 625
CRAIG k9: posts the ante 625
anthonyblue1: posts the ante 625
Bsgwolfpack4: posts the ante 625
panth26: posts the ante 625
RedHungryHip: posts the ante 625
anthonyblue1: posts small blind 2500
Bsgwolfpack4: posts big blind 5000
*** HOLE CARDS ***
Dealt to JJin91 [Jc 3c]
panth26: folds=20
RedHungryHip: folds=20
seedload: folds=20
JJin91: folds=20
LetsGoMets 6: folds=20
CRAIG k9: folds=20
anthonyblue1: folds=20
Uncalled bet (2500) returned to Bsgwolfpack4
*** FLOP *** [Ac 8c 9s]
*** TURN *** [Ac 8c 9s] [Td]
*** RIVER *** [Ac 8c 9s Td] [2d]
*** SHOW DOWN ***
Bsgwolfpack4: shows [Ks 4s] (high card Ace)
Bsgwolfpack4 collected 7360 from side pot
ks1112: shows [7d Th] (a pair of Tens)
ks1112 collected 2970 from main pot
*** SUMMARY ***
Total pot 10330 Main pot 2970. Side pot 7360. | Rake 0=20
Board [Ac 8c 9s Td 2d]
Seat 1: seedload folded before Flop (didn't bet)
Seat 2: JJin91 folded before Flop (didn't bet)
Seat 3: ks1112 showed [7d Th] and won (2970) with a pair of Tens
Seat 4: LetsGoMets 6 folded before Flop (didn't bet)
Seat 5: CRAIG k9 (button) folded before Flop (didn't bet)
Seat 6: anthonyblue1 (small blind) folded before Flop
Seat 7: Bsgwolfpack4 (big blind) showed [Ks 4s] and won (7360) with hig=
h card Ace
Seat 8: panth26 folded before Flop (didn't bet)
Seat 9: RedHungryHip folded before Flop (didn't bet)


*********** # 155 **************
PokerStars Hand #169563177663: Tournament #1597684117, $4.55+$0.45 USD =
Hold'em No Limit - Level XXIII (2500/5000) - 2017/05/07 23:03:02 ET
Table '1597684117 1' 9-max Seat #6 is the button
Seat 1: seedload (57750 in chips)=20
Seat 2: JJin91 (61839 in chips)=20
Seat 3: ks1112 (2970 in chips)=20
Seat 4: LetsGoMets 6 (93102 in chips)=20
Seat 5: CRAIG k9 (104360 in chips)=20
Seat 6: anthonyblue1 (83846 in chips)=20
Seat 7: Bsgwolfpack4 (38615 in chips)=20
Seat 8: panth26 (73730 in chips)=20
Seat 9: RedHungryHip (91834 in chips)=20
seedload: posts the ante 625
JJin91: posts the ante 625
ks1112: posts the ante 625
LetsGoMets 6: posts the ante 625
CRAIG k9: posts the ante 625
anthonyblue1: posts the ante 625
Bsgwolfpack4: posts the ante 625
panth26: posts the ante 625
RedHungryHip: posts the ante 625
Bsgwolfpack4: posts small blind 2500
panth26: posts big blind 5000
*** HOLE CARDS ***
Dealt to JJin91 [Jc 7s]
RedHungryHip: folds=20
seedload: folds=20
JJin91: folds=20
ks1112: folds=20
LetsGoMets 6: folds=20
CRAIG k9: folds=20
anthonyblue1: folds=20
Bsgwolfpack4: folds=20
Uncalled bet (2500) returned to panth26
panth26 collected 10625 from pot
panth26: doesn't show hand=20
*** SUMMARY ***
Total pot 10625 | Rake 0=20
Seat 1: seedload folded before Flop (didn't bet)
Seat 2: JJin91 folded before Flop (didn't bet)
Seat 3: ks1112 folded before Flop (didn't bet)
Seat 4: LetsGoMets 6 folded before Flop (didn't bet)
Seat 5: CRAIG k9 folded before Flop (didn't bet)
Seat 6: anthonyblue1 (button) folded before Flop (didn't bet)
Seat 7: Bsgwolfpack4 (small blind) folded before Flop
Seat 8: panth26 (big blind) collected (10625)
Seat 9: RedHungryHip folded before Flop (didn't bet)


*********** # 156 **************
PokerStars Hand #169563177820: Tournament #1597684117, $4.55+$0.45 USD =
Hold'em No Limit - Level XXIII (2500/5000) - 2017/05/07 23:03:33 ET
Table '1597684117 1' 9-max Seat #7 is the button
Seat 1: seedload (57125 in chips)=20
Seat 2: JJin91 (61214 in chips)=20
Seat 3: ks1112 (2345 in chips)=20
Seat 4: LetsGoMets 6 (92477 in chips)=20
Seat 6: anthonyblue1 (83221 in chips)=20
Seat 7: Bsgwolfpack4 (35490 in chips)=20
Seat 8: panth26 (81230 in chips)=20
Seat 9: RedHungryHip (91209 in chips)=20
seedload: posts the ante 625
JJin91: posts the ante 625
ks1112: posts the ante 625
LetsGoMets 6: posts the ante 625
anthonyblue1: posts the ante 625
Bsgwolfpack4: posts the ante 625
panth26: posts the ante 625
RedHungryHip: posts the ante 625
panth26: posts small blind 2500
RedHungryHip: posts big blind 5000
*** HOLE CARDS ***
Dealt to JJin91 [Qc Qs]
seedload: raises 6250 to 11250
JJin91: raises 16250 to 27500
ks1112: folds=20
LetsGoMets 6: folds=20
anthonyblue1: folds=20
Bsgwolfpack4: folds=20
panth26: folds=20
RedHungryHip: folds=20
seedload: folds=20
Uncalled bet (16250) returned to JJin91
JJin91 collected 35000 from pot
*** SUMMARY ***
Total pot 35000 | Rake 0=20
Seat 1: seedload folded before Flop
Seat 2: JJin91 collected (35000)
Seat 3: ks1112 folded before Flop (didn't bet)
Seat 4: LetsGoMets 6 folded before Flop (didn't bet)
Seat 6: anthonyblue1 folded before Flop (didn't bet)
Seat 7: Bsgwolfpack4 (button) folded before Flop (didn't bet)
Seat 8: panth26 (small blind) folded before Flop
Seat 9: RedHungryHip (big blind) folded before Flop


*********** # 157 **************
PokerStars Hand #169563178082: Tournament #1597684117, $4.55+$0.45 USD =
Hold'em No Limit - Level XXIII (2500/5000) - 2017/05/07 23:04:24 ET
Table '1597684117 1' 9-max Seat #8 is the button
Seat 1: seedload (45250 in chips)=20
Seat 2: JJin91 (84339 in chips)=20
Seat 3: ks1112 (1720 in chips)=20
Seat 4: LetsGoMets 6 (91852 in chips)=20
Seat 6: anthonyblue1 (82596 in chips)=20
Seat 7: Bsgwolfpack4 (34865 in chips)=20
Seat 8: panth26 (78105 in chips)=20
Seat 9: RedHungryHip (85584 in chips)=20
seedload: posts the ante 625
JJin91: posts the ante 625
ks1112: posts the ante 625
LetsGoMets 6: posts the ante 625
anthonyblue1: posts the ante 625
Bsgwolfpack4: posts the ante 625
panth26: posts the ante 625
RedHungryHip: posts the ante 625
RedHungryHip: posts small blind 2500
seedload: posts big blind 5000
*** HOLE CARDS ***
Dealt to JJin91 [Jc 6s]
JJin91: folds=20
ks1112: folds=20
LetsGoMets 6: folds=20
anthonyblue1: folds=20
Bsgwolfpack4: folds=20
panth26: folds=20
RedHungryHip: folds=20
Uncalled bet (2500) returned to seedload
seedload collected 10000 from pot
seedload: doesn't show hand=20
*** SUMMARY ***
Total pot 10000 | Rake 0=20
Seat 1: seedload (big blind) collected (10000)
Seat 2: JJin91 folded before Flop (didn't bet)
Seat 3: ks1112 folded before Flop (didn't bet)
Seat 4: LetsGoMets 6 folded before Flop (didn't bet)
Seat 6: anthonyblue1 folded before Flop (didn't bet)
Seat 7: Bsgwolfpack4 folded before Flop (didn't bet)
Seat 8: panth26 (button) folded before Flop (didn't bet)
Seat 9: RedHungryHip (small blind) folded before Flop


*********** # 158 **************
PokerStars Hand #169563178480: Tournament #1597684117, $4.55+$0.45 USD =
Hold'em No Limit - Level XXIII (2500/5000) - 2017/05/07 23:05:43 ET
Table '1597684117 1' 9-max Seat #9 is the button
Seat 1: seedload (52125 in chips)=20
Seat 2: JJin91 (83714 in chips)=20
Seat 3: ks1112 (1095 in chips)=20
Seat 4: LetsGoMets 6 (91227 in chips)=20
Seat 6: anthonyblue1 (81971 in chips)=20
Seat 7: Bsgwolfpack4 (34240 in chips)=20
Seat 8: panth26 (77480 in chips)=20
Seat 9: RedHungryHip (82459 in chips)=20
seedload: posts the ante 625
JJin91: posts the ante 625
ks1112: posts the ante 625
LetsGoMets 6: posts the ante 625
anthonyblue1: posts the ante 625
Bsgwolfpack4: posts the ante 625
panth26: posts the ante 625
RedHungryHip: posts the ante 625
seedload: posts small blind 2500
JJin91: posts big blind 5000
*** HOLE CARDS ***
Dealt to JJin91 [Ts 9h]
ks1112: folds=20
LetsGoMets 6: folds=20
anthonyblue1: folds=20
Bsgwolfpack4: folds=20
panth26: folds=20
RedHungryHip: raises 5000 to 10000
seedload: folds=20
JJin91: folds=20
Uncalled bet (5000) returned to RedHungryHip
RedHungryHip collected 17500 from pot
RedHungryHip: doesn't show hand=20
*** SUMMARY ***
Total pot 17500 | Rake 0=20
Seat 1: seedload (small blind) folded before Flop
Seat 2: JJin91 (big blind) folded before Flop
Seat 3: ks1112 folded before Flop (didn't bet)
Seat 4: LetsGoMets 6 folded before Flop (didn't bet)
Seat 6: anthonyblue1 folded before Flop (didn't bet)
Seat 7: Bsgwolfpack4 folded before Flop (didn't bet)
Seat 8: panth26 folded before Flop (didn't bet)
Seat 9: RedHungryHip (button) collected (17500)


*********** # 159 **************
PokerStars Hand #169563178702: Tournament #1597684117, $4.55+$0.45 USD =
Hold'em No Limit - Level XXIII (2500/5000) - 2017/05/07 23:06:27 ET
Table '1597684117 1' 9-max Seat #1 is the button
Seat 1: seedload (49000 in chips)=20
Seat 2: JJin91 (78089 in chips)=20
Seat 3: ks1112 (470 in chips)=20
Seat 4: LetsGoMets 6 (90602 in chips)=20
Seat 6: anthonyblue1 (81346 in chips)=20
Seat 7: Bsgwolfpack4 (33615 in chips)=20
Seat 8: panth26 (76855 in chips)=20
Seat 9: RedHungryHip (94334 in chips)=20
seedload: posts the ante 625
JJin91: posts the ante 625
ks1112: posts the ante 470 and is all-in
LetsGoMets 6: posts the ante 625
anthonyblue1: posts the ante 625
Bsgwolfpack4: posts the ante 625
panth26: posts the ante 625
RedHungryHip: posts the ante 625
JJin91: posts small blind 2500
*** HOLE CARDS ***
Dealt to JJin91 [6h 3d]
LetsGoMets 6: folds=20
anthonyblue1: folds=20
Bsgwolfpack4: folds=20
panth26: folds=20
RedHungryHip: folds=20
seedload: folds=20
Uncalled bet (2500) returned to JJin91
*** FLOP *** [Ac 8s 7d]
*** TURN *** [Ac 8s 7d] [6d]
*** RIVER *** [Ac 8s 7d 6d] [As]
*** SHOW DOWN ***
JJin91: shows [6h 3d] (two pair, Aces and Sixes)
JJin91 collected 1085 from side pot
ks1112: shows [4d 9h] (a pair of Aces)
JJin91 collected 3760 from main pot
ks1112 finished the tournament in 16th place
*** SUMMARY ***
Total pot 4845 Main pot 3760. Side pot 1085. | Rake 0=20
Board [Ac 8s 7d 6d As]
Seat 1: seedload (button) folded before Flop (didn't bet)
Seat 2: JJin91 (small blind) showed [6h 3d] and won (4845) with two pai=
r, Aces and Sixes
Seat 3: ks1112 (big blind) showed [4d 9h] and lost with a pair of Aces
Seat 4: LetsGoMets 6 folded before Flop (didn't bet)
Seat 6: anthonyblue1 folded before Flop (didn't bet)
Seat 7: Bsgwolfpack4 folded before Flop (didn't bet)
Seat 8: panth26 folded before Flop (didn't bet)
Seat 9: RedHungryHip folded before Flop (didn't bet)


*********** # 160 **************
PokerStars Hand #169563178996: Tournament #1597684117, $4.55+$0.45 USD =
Hold'em No Limit - Level XXIV (3000/6000) - 2017/05/07 23:07:22 ET
Table '1597684117 1' 9-max Seat #2 is the button
Seat 1: seedload (48375 in chips)=20
Seat 2: JJin91 (82309 in chips)=20
Seat 4: LetsGoMets 6 (89977 in chips)=20
Seat 6: anthonyblue1 (80721 in chips)=20
Seat 7: Bsgwolfpack4 (32990 in chips)=20
Seat 8: panth26 (76230 in chips)=20
Seat 9: RedHungryHip (93709 in chips)=20
seedload: posts the ante 750
JJin91: posts the ante 750
LetsGoMets 6: posts the ante 750
anthonyblue1: posts the ante 750
Bsgwolfpack4: posts the ante 750
panth26: posts the ante 750
RedHungryHip: posts the ante 750
LetsGoMets 6: posts small blind 3000
anthonyblue1: posts big blind 6000
*** HOLE CARDS ***
Dealt to JJin91 [4c 9d]
Bsgwolfpack4: folds=20
panth26: folds=20
RedHungryHip: folds=20
seedload: raises 41625 to 47625 and is all-in
JJin91: folds=20
LetsGoMets 6: folds=20
anthonyblue1: folds=20
Uncalled bet (41625) returned to seedload
seedload collected 20250 from pot
seedload: doesn't show hand=20
*** SUMMARY ***
Total pot 20250 | Rake 0=20
Seat 1: seedload collected (20250)
Seat 2: JJin91 (button) folded before Flop (didn't bet)
Seat 4: LetsGoMets 6 (small blind) folded before Flop
Seat 6: anthonyblue1 (big blind) folded before Flop
Seat 7: Bsgwolfpack4 folded before Flop (didn't bet)
Seat 8: panth26 folded before Flop (didn't bet)
Seat 9: RedHungryHip folded before Flop (didn't bet)


*********** # 161 **************
PokerStars Hand #169563179088: Tournament #1597684117, $4.55+$0.45 USD =
Hold'em No Limit - Level XXIV (3000/6000) - 2017/05/07 23:07:39 ET
Table '1597684117 1' 9-max Seat #4 is the button
Seat 1: seedload (61875 in chips)=20
Seat 2: JJin91 (81559 in chips)=20
Seat 4: LetsGoMets 6 (86227 in chips)=20
Seat 6: anthonyblue1 (73971 in chips)=20
Seat 7: Bsgwolfpack4 (32240 in chips)=20
Seat 8: panth26 (75480 in chips)=20
Seat 9: RedHungryHip (92959 in chips)=20
seedload: posts the ante 750
JJin91: posts the ante 750
LetsGoMets 6: posts the ante 750
anthonyblue1: posts the ante 750
Bsgwolfpack4: posts the ante 750
panth26: posts the ante 750
RedHungryHip: posts the ante 750
anthonyblue1: posts small blind 3000
Bsgwolfpack4: posts big blind 6000
*** HOLE CARDS ***
Dealt to JJin91 [2h Th]
panth26: folds=20
RedHungryHip: folds=20
seedload: folds=20
JJin91: folds=20
LetsGoMets 6: raises 20250 to 26250
anthonyblue1: raises 46971 to 73221 and is all-in
Bsgwolfpack4: folds=20
LetsGoMets 6: calls 46971
*** FLOP *** [8c 7d Jh]
*** TURN *** [8c 7d Jh] [8d]
*** RIVER *** [8c 7d Jh 8d] [9h]
*** SHOW DOWN ***
anthonyblue1: shows [Kh Kc] (two pair, Kings and Eights)
LetsGoMets 6: shows [Jd Js] (a full house, Jacks full of Eights)
LetsGoMets 6 collected 157692 from pot
anthonyblue1 finished the tournament in 15th place and received $10.50.
*** SUMMARY ***
Total pot 157692 | Rake 0=20
Board [8c 7d Jh 8d 9h]
Seat 1: seedload folded before Flop (didn't bet)
Seat 2: JJin91 folded before Flop (didn't bet)
Seat 4: LetsGoMets 6 (button) showed [Jd Js] and won (157692) with a fu=
ll house, Jacks full of Eights
Seat 6: anthonyblue1 (small blind) showed [Kh Kc] and lost with two pai=
r, Kings and Eights
Seat 7: Bsgwolfpack4 (big blind) folded before Flop
Seat 8: panth26 folded before Flop (didn't bet)
Seat 9: RedHungryHip folded before Flop (didn't bet)


*********** # 162 **************
PokerStars Hand #169563179280: Tournament #1597684117, $4.55+$0.45 USD =
Hold'em No Limit - Level XXIV (3000/6000) - 2017/05/07 23:08:20 ET
Table '1597684117 1' 9-max Seat #7 is the button
Seat 1: seedload (61125 in chips)=20
Seat 2: JJin91 (80809 in chips)=20
Seat 4: LetsGoMets 6 (169948 in chips)=20
Seat 5: jaysu (26008 in chips)=20
Seat 7: Bsgwolfpack4 (25490 in chips)=20
Seat 8: panth26 (74730 in chips)=20
Seat 9: RedHungryHip (92209 in chips)=20
seedload: posts the ante 750
JJin91: posts the ante 750
LetsGoMets 6: posts the ante 750
jaysu: posts the ante 750
Bsgwolfpack4: posts the ante 750
panth26: posts the ante 750
RedHungryHip: posts the ante 750
panth26: posts small blind 3000
RedHungryHip: posts big blind 6000
*** HOLE CARDS ***
Dealt to JJin91 [2s Qc]
seedload: folds=20
JJin91: folds=20
LetsGoMets 6: folds=20
jaysu: raises 19258 to 25258 and is all-in
Bsgwolfpack4: folds=20
panth26: folds=20
RedHungryHip: folds=20
Uncalled bet (19258) returned to jaysu
jaysu collected 20250 from pot
jaysu: doesn't show hand=20
*** SUMMARY ***
Total pot 20250 | Rake 0=20
Seat 1: seedload folded before Flop (didn't bet)
Seat 2: JJin91 folded before Flop (didn't bet)
Seat 4: LetsGoMets 6 folded before Flop (didn't bet)
Seat 5: jaysu collected (20250)
Seat 7: Bsgwolfpack4 (button) folded before Flop (didn't bet)
Seat 8: panth26 (small blind) folded before Flop
Seat 9: RedHungryHip (big blind) folded before Flop


*********** # 163 **************
PokerStars Hand #169563179372: Tournament #1597684117, $4.55+$0.45 USD =
Hold'em No Limit - Level XXIV (3000/6000) - 2017/05/07 23:08:38 ET
Table '1597684117 1' 9-max Seat #8 is the button
Seat 1: seedload (60375 in chips)=20
Seat 2: JJin91 (80059 in chips)=20
Seat 4: LetsGoMets 6 (169198 in chips)=20
Seat 5: jaysu (39508 in chips)=20
Seat 7: Bsgwolfpack4 (24740 in chips)=20
Seat 8: panth26 (70980 in chips)=20
Seat 9: RedHungryHip (85459 in chips)=20
seedload: posts the ante 750
JJin91: posts the ante 750
LetsGoMets 6: posts the ante 750
jaysu: posts the ante 750
Bsgwolfpack4: posts the ante 750
panth26: posts the ante 750
RedHungryHip: posts the ante 750
RedHungryHip: posts small blind 3000
seedload: posts big blind 6000
*** HOLE CARDS ***
Dealt to JJin91 [Td 9c]
JJin91: folds=20
LetsGoMets 6: folds=20
jaysu: folds=20
Bsgwolfpack4: folds=20
panth26: folds=20
RedHungryHip: folds=20
Uncalled bet (3000) returned to seedload
seedload collected 11250 from pot
seedload: doesn't show hand=20
*** SUMMARY ***
Total pot 11250 | Rake 0=20
Seat 1: seedload (big blind) collected (11250)
Seat 2: JJin91 folded before Flop (didn't bet)
Seat 4: LetsGoMets 6 folded before Flop (didn't bet)
Seat 5: jaysu folded before Flop (didn't bet)
Seat 7: Bsgwolfpack4 folded before Flop (didn't bet)
Seat 8: panth26 (button) folded before Flop (didn't bet)
Seat 9: RedHungryHip (small blind) folded before Flop


*********** # 164 **************
PokerStars Hand #169563179488: Tournament #1597684117, $4.55+$0.45 USD =
Hold'em No Limit - Level XXIV (3000/6000) - 2017/05/07 23:08:58 ET
Table '1597684117 1' 9-max Seat #9 is the button
Seat 1: seedload (67875 in chips)=20
Seat 2: JJin91 (79309 in chips)=20
Seat 4: LetsGoMets 6 (168448 in chips)=20
Seat 5: jaysu (38758 in chips)=20
Seat 7: Bsgwolfpack4 (23990 in chips)=20
Seat 8: panth26 (70230 in chips)=20
Seat 9: RedHungryHip (81709 in chips)=20
seedload: posts the ante 750
JJin91: posts the ante 750
LetsGoMets 6: posts the ante 750
jaysu: posts the ante 750
Bsgwolfpack4: posts the ante 750
panth26: posts the ante 750
RedHungryHip: posts the ante 750
seedload: posts small blind 3000
JJin91: posts big blind 6000
*** HOLE CARDS ***
Dealt to JJin91 [4s 4c]
LetsGoMets 6: folds=20
jaysu: folds=20
Bsgwolfpack4: folds=20
panth26: folds=20
RedHungryHip: folds=20
seedload: raises 61125 to 67125 and is all-in
JJin91: folds=20
Uncalled bet (61125) returned to seedload
seedload collected 17250 from pot
seedload: doesn't show hand=20
*** SUMMARY ***
Total pot 17250 | Rake 0=20
Seat 1: seedload (small blind) collected (17250)
Seat 2: JJin91 (big blind) folded before Flop
Seat 4: LetsGoMets 6 folded before Flop (didn't bet)
Seat 5: jaysu folded before Flop (didn't bet)
Seat 7: Bsgwolfpack4 folded before Flop (didn't bet)
Seat 8: panth26 folded before Flop (didn't bet)
Seat 9: RedHungryHip (button) folded before Flop (didn't bet)


*********** # 165 **************
PokerStars Hand #169563179670: Tournament #1597684117, $4.55+$0.45 USD =
Hold'em No Limit - Level XXIV (3000/6000) - 2017/05/07 23:09:35 ET
Table '1597684117 1' 9-max Seat #1 is the button
Seat 1: seedload (78375 in chips)=20
Seat 2: JJin91 (72559 in chips)=20
Seat 4: LetsGoMets 6 (167698 in chips)=20
Seat 5: jaysu (38008 in chips)=20
Seat 7: Bsgwolfpack4 (23240 in chips)=20
Seat 8: panth26 (69480 in chips)=20
Seat 9: RedHungryHip (80959 in chips)=20
seedload: posts the ante 750
JJin91: posts the ante 750
LetsGoMets 6: posts the ante 750
jaysu: posts the ante 750
Bsgwolfpack4: posts the ante 750
panth26: posts the ante 750
RedHungryHip: posts the ante 750
JJin91: posts small blind 3000
LetsGoMets 6: posts big blind 6000
*** HOLE CARDS ***
Dealt to JJin91 [Jh 3s]
jaysu: raises 31258 to 37258 and is all-in
Bsgwolfpack4: folds=20
panth26: folds=20
RedHungryHip: folds=20
seedload: folds=20
JJin91: folds=20
LetsGoMets 6: folds=20
Uncalled bet (31258) returned to jaysu
jaysu collected 20250 from pot
jaysu: doesn't show hand=20
*** SUMMARY ***
Total pot 20250 | Rake 0=20
Seat 1: seedload (button) folded before Flop (didn't bet)
Seat 2: JJin91 (small blind) folded before Flop
Seat 4: LetsGoMets 6 (big blind) folded before Flop
Seat 5: jaysu collected (20250)
Seat 7: Bsgwolfpack4 folded before Flop (didn't bet)
Seat 8: panth26 folded before Flop (didn't bet)
Seat 9: RedHungryHip folded before Flop (didn't bet)


*********** # 166 **************
PokerStars Hand #169563179767: Tournament #1597684117, $4.55+$0.45 USD =
Hold'em No Limit - Level XXIV (3000/6000) - 2017/05/07 23:09:55 ET
Table '1597684117 1' 9-max Seat #2 is the button
Seat 1: seedload (77625 in chips)=20
Seat 2: JJin91 (68809 in chips)=20
Seat 4: LetsGoMets 6 (160948 in chips)=20
Seat 5: jaysu (51508 in chips)=20
Seat 7: Bsgwolfpack4 (22490 in chips)=20
Seat 8: panth26 (68730 in chips)=20
Seat 9: RedHungryHip (80209 in chips)=20
seedload: posts the ante 750
JJin91: posts the ante 750
LetsGoMets 6: posts the ante 750
jaysu: posts the ante 750
Bsgwolfpack4: posts the ante 750
panth26: posts the ante 750
RedHungryHip: posts the ante 750
LetsGoMets 6: posts small blind 3000
jaysu: posts big blind 6000
*** HOLE CARDS ***
Dealt to JJin91 [8h 2s]
Bsgwolfpack4: raises 15740 to 21740 and is all-in
panth26: folds=20
RedHungryHip: calls 21740
seedload: folds=20
JJin91: folds=20
LetsGoMets 6: folds=20
jaysu: folds=20
*** FLOP *** [Jh 2h 9h]
*** TURN *** [Jh 2h 9h] [Qh]
*** RIVER *** [Jh 2h 9h Qh] [5s]
*** SHOW DOWN ***
Bsgwolfpack4: shows [Ad Td] (high card Ace)
RedHungryHip: shows [Jc Jd] (three of a kind, Jacks)
RedHungryHip collected 57730 from pot
Bsgwolfpack4 finished the tournament in 13th place and received $10.50.
*** SUMMARY ***
Total pot 57730 | Rake 0=20
Board [Jh 2h 9h Qh 5s]
Seat 1: seedload folded before Flop (didn't bet)
Seat 2: JJin91 (button) folded before Flop (didn't bet)
Seat 4: LetsGoMets 6 (small blind) folded before Flop
Seat 5: jaysu (big blind) folded before Flop
Seat 7: Bsgwolfpack4 showed [Ad Td] and lost with high card Ace
Seat 8: panth26 folded before Flop (didn't bet)
Seat 9: RedHungryHip showed [Jc Jd] and won (57730) with three of a kin=
d, Jacks


*********** # 167 **************
PokerStars Hand #169563179883: Tournament #1597684117, $4.55+$0.45 USD =
Hold'em No Limit - Level XXIV (3000/6000) - 2017/05/07 23:10:21 ET
Table '1597684117 1' 9-max Seat #4 is the button
Seat 1: seedload (76875 in chips)=20
Seat 2: JJin91 (68059 in chips)=20
Seat 4: LetsGoMets 6 (157198 in chips)=20
Seat 5: jaysu (44758 in chips)=20
Seat 8: panth26 (67980 in chips)=20
Seat 9: RedHungryHip (115449 in chips)=20
seedload: posts the ante 750
JJin91: posts the ante 750
LetsGoMets 6: posts the ante 750
jaysu: posts the ante 750
panth26: posts the ante 750
RedHungryHip: posts the ante 750
jaysu: posts small blind 3000
panth26: posts big blind 6000
*** HOLE CARDS ***
Dealt to JJin91 [7h 7c]
RedHungryHip: folds=20
seedload: folds=20
JJin91: raises 12000 to 18000
LetsGoMets 6: folds=20
jaysu: folds=20
panth26: folds=20
Uncalled bet (12000) returned to JJin91
JJin91 collected 19500 from pot
*** SUMMARY ***
Total pot 19500 | Rake 0=20
Seat 1: seedload folded before Flop (didn't bet)
Seat 2: JJin91 collected (19500)
Seat 4: LetsGoMets 6 (button) folded before Flop (didn't bet)
Seat 5: jaysu (small blind) folded before Flop
Seat 8: panth26 (big blind) folded before Flop
Seat 9: RedHungryHip folded before Flop (didn't bet)


*********** # 168 **************
PokerStars Hand #169563179969: Tournament #1597684117, $4.55+$0.45 USD =
Hold'em No Limit - Level XXIV (3000/6000) - 2017/05/07 23:10:35 ET
Table '1597684117 1' 9-max Seat #5 is the button
Seat 1: seedload (76125 in chips)=20
Seat 2: JJin91 (80809 in chips)=20
Seat 4: LetsGoMets 6 (156448 in chips)=20
Seat 5: jaysu (41008 in chips)=20
Seat 8: panth26 (61230 in chips)=20
Seat 9: RedHungryHip (114699 in chips)=20
seedload: posts the ante 750
JJin91: posts the ante 750
LetsGoMets 6: posts the ante 750
jaysu: posts the ante 750
panth26: posts the ante 750
RedHungryHip: posts the ante 750
panth26: posts small blind 3000
RedHungryHip: posts big blind 6000
*** HOLE CARDS ***
Dealt to JJin91 [Jd Jh]
seedload: raises 69375 to 75375 and is all-in
JJin91: raises 4684 to 80059 and is all-in
LetsGoMets 6: folds=20
jaysu: folds=20
panth26: folds=20
RedHungryHip: folds=20
Uncalled bet (4684) returned to JJin91
*** FLOP *** [Tc Qs Ts]
*** TURN *** [Tc Qs Ts] [9h]
*** RIVER *** [Tc Qs Ts 9h] [5s]
*** SHOW DOWN ***
seedload: shows [Ah Kd] (a pair of Tens)
JJin91: shows [Jd Jh] (two pair, Jacks and Tens)
JJin91 collected 164250 from pot
seedload finished the tournament in 12th place and received $12.00.
*** SUMMARY ***
Total pot 164250 | Rake 0=20
Board [Tc Qs Ts 9h 5s]
Seat 1: seedload showed [Ah Kd] and lost with a pair of Tens
Seat 2: JJin91 showed [Jd Jh] and won (164250) with two pair, Jacks and=
 Tens
Seat 4: LetsGoMets 6 folded before Flop (didn't bet)
Seat 5: jaysu (button) folded before Flop (didn't bet)
Seat 8: panth26 (small blind) folded before Flop
Seat 9: RedHungryHip (big blind) folded before Flop


*********** # 169 **************
PokerStars Hand #169563582019: Tournament #1597684117, $4.55+$0.45 USD =
Hold'em No Limit - Level XXIV (3000/6000) - 2017/05/07 23:11:04 ET
Table '1597684117 1' 9-max Seat #8 is the button
Seat 2: JJin91 (168934 in chips)=20
Seat 4: LetsGoMets 6 (155698 in chips)=20
Seat 5: jaysu (40258 in chips)=20
Seat 8: panth26 (57480 in chips)=20
Seat 9: RedHungryHip (107949 in chips)=20
JJin91: posts the ante 750
LetsGoMets 6: posts the ante 750
jaysu: posts the ante 750
panth26: posts the ante 750
RedHungryHip: posts the ante 750
RedHungryHip: posts small blind 3000
JJin91: posts big blind 6000
*** HOLE CARDS ***
Dealt to JJin91 [3h 3s]
LetsGoMets 6: folds=20
jaysu: folds=20
panth26: raises 50730 to 56730 and is all-in
RedHungryHip: folds=20
JJin91: calls 50730
*** FLOP *** [2c 4s 6h]
*** TURN *** [2c 4s 6h] [Tc]
*** RIVER *** [2c 4s 6h Tc] [9d]
*** SHOW DOWN ***
JJin91: shows [3h 3s] (a pair of Threes)
panth26: shows [Td Ad] (a pair of Tens)
panth26 collected 120210 from pot
*** SUMMARY ***
Total pot 120210 | Rake 0=20
Board [2c 4s 6h Tc 9d]
Seat 2: JJin91 (big blind) showed [3h 3s] and lost with a pair of Threes
Seat 4: LetsGoMets 6 folded before Flop (didn't bet)
Seat 5: jaysu folded before Flop (didn't bet)
Seat 8: panth26 (button) showed [Td Ad] and won (120210) with a pair of=
 Tens
Seat 9: RedHungryHip (small blind) folded before Flop


*********** # 170 **************
PokerStars Hand #169563582116: Tournament #1597684117, $4.55+$0.45 USD =
Hold'em No Limit - Level XXIV (3000/6000) - 2017/05/07 23:11:26 ET
Table '1597684117 1' 9-max Seat #9 is the button
Seat 2: JJin91 (111454 in chips)=20
Seat 4: LetsGoMets 6 (154948 in chips)=20
Seat 5: jaysu (39508 in chips)=20
Seat 8: panth26 (120210 in chips)=20
Seat 9: RedHungryHip (104199 in chips)=20
JJin91: posts the ante 750
LetsGoMets 6: posts the ante 750
jaysu: posts the ante 750
panth26: posts the ante 750
RedHungryHip: posts the ante 750
JJin91: posts small blind 3000
LetsGoMets 6: posts big blind 6000
*** HOLE CARDS ***
Dealt to JJin91 [Jd 5c]
jaysu: raises 32758 to 38758 and is all-in
panth26: folds=20
RedHungryHip: folds=20
JJin91: folds=20
LetsGoMets 6: folds=20
Uncalled bet (32758) returned to jaysu
jaysu collected 18750 from pot
jaysu: doesn't show hand=20
*** SUMMARY ***
Total pot 18750 | Rake 0=20
Seat 2: JJin91 (small blind) folded before Flop
Seat 4: LetsGoMets 6 (big blind) folded before Flop
Seat 5: jaysu collected (18750)
Seat 8: panth26 folded before Flop (didn't bet)
Seat 9: RedHungryHip (button) folded before Flop (didn't bet)


*********** # 171 **************
PokerStars Hand #169563582180: Tournament #1597684117, $4.55+$0.45 USD =
Hold'em No Limit - Level XXIV (3000/6000) - 2017/05/07 23:11:39 ET
Table '1597684117 1' 9-max Seat #2 is the button
Seat 2: JJin91 (107704 in chips)=20
Seat 4: LetsGoMets 6 (148198 in chips)=20
Seat 5: jaysu (51508 in chips)=20
Seat 8: panth26 (119460 in chips)=20
Seat 9: RedHungryHip (103449 in chips)=20
JJin91: posts the ante 750
LetsGoMets 6: posts the ante 750
jaysu: posts the ante 750
panth26: posts the ante 750
RedHungryHip: posts the ante 750
LetsGoMets 6: posts small blind 3000
jaysu: posts big blind 6000
*** HOLE CARDS ***
Dealt to JJin91 [9d Tc]
panth26: raises 9000 to 15000
RedHungryHip: folds=20
JJin91: folds=20
LetsGoMets 6: folds=20
jaysu: folds=20
Uncalled bet (9000) returned to panth26
panth26 collected 18750 from pot
panth26: doesn't show hand=20
*** SUMMARY ***
Total pot 18750 | Rake 0=20
Seat 2: JJin91 (button) folded before Flop (didn't bet)
Seat 4: LetsGoMets 6 (small blind) folded before Flop
Seat 5: jaysu (big blind) folded before Flop
Seat 8: panth26 collected (18750)
Seat 9: RedHungryHip folded before Flop (didn't bet)


*********** # 172 **************
PokerStars Hand #169563582413: Tournament #1597684117, $4.55+$0.45 USD =
Hold'em No Limit - Level XXV (3500/7000) - 2017/05/07 23:12:26 ET
Table '1597684117 1' 9-max Seat #4 is the button
Seat 2: JJin91 (106954 in chips)=20
Seat 4: LetsGoMets 6 (144448 in chips)=20
Seat 5: jaysu (44758 in chips)=20
Seat 8: panth26 (131460 in chips)=20
Seat 9: RedHungryHip (102699 in chips)=20
JJin91: posts the ante 875
LetsGoMets 6: posts the ante 875
jaysu: posts the ante 875
panth26: posts the ante 875
RedHungryHip: posts the ante 875
jaysu: posts small blind 3500
panth26: posts big blind 7000
*** HOLE CARDS ***
Dealt to JJin91 [4d 3s]
RedHungryHip: calls 7000
JJin91: folds=20
LetsGoMets 6: folds=20
jaysu: folds=20
panth26: checks=20
*** FLOP *** [7c Qd 6d]
panth26: checks=20
RedHungryHip: bets 7000
panth26: folds=20
Uncalled bet (7000) returned to RedHungryHip
RedHungryHip collected 21875 from pot
RedHungryHip: doesn't show hand=20
*** SUMMARY ***
Total pot 21875 | Rake 0=20
Board [7c Qd 6d]
Seat 2: JJin91 folded before Flop (didn't bet)
Seat 4: LetsGoMets 6 (button) folded before Flop (didn't bet)
Seat 5: jaysu (small blind) folded before Flop
Seat 8: panth26 (big blind) folded on the Flop
Seat 9: RedHungryHip collected (21875)


*********** # 173 **************
PokerStars Hand #169563582632: Tournament #1597684117, $4.55+$0.45 USD =
Hold'em No Limit - Level XXV (3500/7000) - 2017/05/07 23:13:09 ET
Table '1597684117 1' 9-max Seat #5 is the button
Seat 2: JJin91 (106079 in chips)=20
Seat 4: LetsGoMets 6 (143573 in chips)=20
Seat 5: jaysu (40383 in chips)=20
Seat 8: panth26 (123585 in chips)=20
Seat 9: RedHungryHip (116699 in chips)=20
JJin91: posts the ante 875
LetsGoMets 6: posts the ante 875
jaysu: posts the ante 875
panth26: posts the ante 875
RedHungryHip: posts the ante 875
panth26: posts small blind 3500
RedHungryHip: posts big blind 7000
*** HOLE CARDS ***
Dealt to JJin91 [Td 6d]
JJin91: folds=20
LetsGoMets 6: folds=20
jaysu: raises 32508 to 39508 and is all-in
panth26: folds=20
RedHungryHip: folds=20
Uncalled bet (32508) returned to jaysu
jaysu collected 21875 from pot
jaysu: doesn't show hand=20
*** SUMMARY ***
Total pot 21875 | Rake 0=20
Seat 2: JJin91 folded before Flop (didn't bet)
Seat 4: LetsGoMets 6 folded before Flop (didn't bet)
Seat 5: jaysu (button) collected (21875)
Seat 8: panth26 (small blind) folded before Flop
Seat 9: RedHungryHip (big blind) folded before Flop


*********** # 174 **************
PokerStars Hand #169563582798: Tournament #1597684117, $4.55+$0.45 USD =
Hold'em No Limit - Level XXV (3500/7000) - 2017/05/07 23:13:37 ET
Table '1597684117 1' 9-max Seat #8 is the button
Seat 2: JJin91 (105204 in chips)=20
Seat 4: LetsGoMets 6 (142698 in chips)=20
Seat 5: jaysu (54383 in chips)=20
Seat 8: panth26 (119210 in chips)=20
Seat 9: RedHungryHip (108824 in chips)=20
JJin91: posts the ante 875
LetsGoMets 6: posts the ante 875
jaysu: posts the ante 875
panth26: posts the ante 875
RedHungryHip: posts the ante 875
RedHungryHip: posts small blind 3500
JJin91: posts big blind 7000
*** HOLE CARDS ***
Dealt to JJin91 [Qs 5h]
LetsGoMets 6: folds=20
jaysu: folds=20
panth26: folds=20
RedHungryHip: calls 3500
JJin91: checks=20
*** FLOP *** [Tc Jc 7d]
RedHungryHip: checks=20
JJin91: checks=20
*** TURN *** [Tc Jc 7d] [5s]
RedHungryHip: checks=20
JJin91: checks=20
*** RIVER *** [Tc Jc 7d 5s] [9c]
RedHungryHip: bets 9188
JJin91: folds=20
Uncalled bet (9188) returned to RedHungryHip
RedHungryHip collected 18375 from pot
*** SUMMARY ***
Total pot 18375 | Rake 0=20
Board [Tc Jc 7d 5s 9c]
Seat 2: JJin91 (big blind) folded on the River
Seat 4: LetsGoMets 6 folded before Flop (didn't bet)
Seat 5: jaysu folded before Flop (didn't bet)
Seat 8: panth26 (button) folded before Flop (didn't bet)
Seat 9: RedHungryHip (small blind) collected (18375)


*********** # 175 **************
PokerStars Hand #169563583120: Tournament #1597684117, $4.55+$0.45 USD =
Hold'em No Limit - Level XXV (3500/7000) - 2017/05/07 23:14:40 ET
Table '1597684117 1' 9-max Seat #9 is the button
Seat 2: JJin91 (97329 in chips)=20
Seat 4: LetsGoMets 6 (141823 in chips)=20
Seat 5: jaysu (53508 in chips)=20
Seat 8: panth26 (118335 in chips)=20
Seat 9: RedHungryHip (119324 in chips)=20
JJin91: posts the ante 875
LetsGoMets 6: posts the ante 875
jaysu: posts the ante 875
panth26: posts the ante 875
RedHungryHip: posts the ante 875
JJin91: posts small blind 3500
LetsGoMets 6: posts big blind 7000
*** HOLE CARDS ***
Dealt to JJin91 [2c 5d]
jaysu: folds=20
panth26: raises 9800 to 16800
RedHungryHip: folds=20
JJin91: folds=20
LetsGoMets 6: calls 9800
*** FLOP *** [6c Tc Kc]
LetsGoMets 6: checks=20
panth26: bets 20738
LetsGoMets 6: folds=20
Uncalled bet (20738) returned to panth26
panth26 collected 41475 from pot
panth26: doesn't show hand=20
*** SUMMARY ***
Total pot 41475 | Rake 0=20
Board [6c Tc Kc]
Seat 2: JJin91 (small blind) folded before Flop
Seat 4: LetsGoMets 6 (big blind) folded on the Flop
Seat 5: jaysu folded before Flop (didn't bet)
Seat 8: panth26 collected (41475)
Seat 9: RedHungryHip (button) folded before Flop (didn't bet)


*********** # 176 **************
PokerStars Hand #169563583300: Tournament #1597684117, $4.55+$0.45 USD =
Hold'em No Limit - Level XXV (3500/7000) - 2017/05/07 23:15:20 ET
Table '1597684117 1' 9-max Seat #2 is the button
Seat 2: JJin91 (92954 in chips)=20
Seat 4: LetsGoMets 6 (124148 in chips)=20
Seat 5: jaysu (52633 in chips)=20
Seat 8: panth26 (142135 in chips)=20
Seat 9: RedHungryHip (118449 in chips)=20
JJin91: posts the ante 875
LetsGoMets 6: posts the ante 875
jaysu: posts the ante 875
panth26: posts the ante 875
RedHungryHip: posts the ante 875
LetsGoMets 6: posts small blind 3500
jaysu: posts big blind 7000
*** HOLE CARDS ***
Dealt to JJin91 [8d 4s]
panth26: folds=20
RedHungryHip: folds=20
JJin91: folds=20
LetsGoMets 6: raises 7000 to 14000
jaysu: calls 7000
*** FLOP *** [7s 4d 5d]
LetsGoMets 6: bets 109273 and is all-in
jaysu: calls 37758 and is all-in
Uncalled bet (71515) returned to LetsGoMets 6
*** TURN *** [7s 4d 5d] [9c]
*** RIVER *** [7s 4d 5d 9c] [Ah]
*** SHOW DOWN ***
LetsGoMets 6: shows [Qd Qh] (a pair of Queens)
jaysu: shows [5c 8c] (a pair of Fives)
LetsGoMets 6 collected 107891 from pot
jaysu finished the tournament in 10th place and received $12.00.
*** SUMMARY ***
Total pot 107891 | Rake 0=20
Board [7s 4d 5d 9c Ah]
Seat 2: JJin91 (button) folded before Flop (didn't bet)
Seat 4: LetsGoMets 6 (small blind) showed [Qd Qh] and won (107891) with=
 a pair of Queens
Seat 5: jaysu (big blind) showed [5c 8c] and lost with a pair of Fives
Seat 8: panth26 folded before Flop (didn't bet)
Seat 9: RedHungryHip folded before Flop (didn't bet)


*********** # 177 **************
PokerStars Hand #169563583512: Tournament #1597684117, $4.55+$0.45 USD =
Hold'em No Limit - Level XXV (3500/7000) - 2017/05/07 23:15:58 ET
Table '1597684117 4' 9-max Seat #3 is the button
Seat 1: njhaar (56955 in chips)=20
Seat 2: LetsGoMets 6 (179406 in chips)=20
Seat 3: mmenz08816 (107380 in chips)=20
Seat 4: CRAIG k9 (158707 in chips)=20
Seat 5: gator856500 (61166 in chips)=20
Seat 6: RedHungryHip (117574 in chips)=20
Seat 7: BIGTIME30829 (145473 in chips)=20
Seat 8: JJin91 (92079 in chips)=20
Seat 9: panth26 (141260 in chips)=20
njhaar: posts the ante 875
LetsGoMets 6: posts the ante 875
mmenz08816: posts the ante 875
CRAIG k9: posts the ante 875
gator856500: posts the ante 875
RedHungryHip: posts the ante 875
BIGTIME30829: posts the ante 875
JJin91: posts the ante 875
panth26: posts the ante 875
CRAIG k9: posts small blind 3500
gator856500: posts big blind 7000
*** HOLE CARDS ***
Dealt to JJin91 [9d 2c]
RedHungryHip: folds=20
BIGTIME30829: calls 7000
JJin91: folds=20
panth26: folds=20
njhaar: folds=20
LetsGoMets 6: raises 14000 to 21000
mmenz08816: folds=20
CRAIG k9: folds=20
gator856500: folds=20
BIGTIME30829: calls 14000
*** FLOP *** [7s 9h Qc]
BIGTIME30829: bets 30188
LetsGoMets 6: raises 127343 to 157531 and is all-in
BIGTIME30829: folds=20
Uncalled bet (127343) returned to LetsGoMets 6
LetsGoMets 6 collected 120751 from pot
LetsGoMets 6: doesn't show hand=20
*** SUMMARY ***
Total pot 120751 | Rake 0=20
Board [7s 9h Qc]
Seat 1: njhaar folded before Flop (didn't bet)
Seat 2: LetsGoMets 6 collected (120751)
Seat 3: mmenz08816 (button) folded before Flop (didn't bet)
Seat 4: CRAIG k9 (small blind) folded before Flop
Seat 5: gator856500 (big blind) folded before Flop
Seat 6: RedHungryHip folded before Flop (didn't bet)
Seat 7: BIGTIME30829 folded on the Flop
Seat 8: JJin91 folded before Flop (didn't bet)
Seat 9: panth26 folded before Flop (didn't bet)


*********** # 178 **************
PokerStars Hand #169563583803: Tournament #1597684117, $4.55+$0.45 USD =
Hold'em No Limit - Level XXV (3500/7000) - 2017/05/07 23:16:57 ET
Table '1597684117 4' 9-max Seat #4 is the button
Seat 1: njhaar (56080 in chips)=20
Seat 2: LetsGoMets 6 (248094 in chips)=20
Seat 3: mmenz08816 (106505 in chips)=20
Seat 4: CRAIG k9 (154332 in chips)=20
Seat 5: gator856500 (53291 in chips)=20
Seat 6: RedHungryHip (116699 in chips)=20
Seat 7: BIGTIME30829 (93410 in chips)=20
Seat 8: JJin91 (91204 in chips)=20
Seat 9: panth26 (140385 in chips)=20
njhaar: posts the ante 875
LetsGoMets 6: posts the ante 875
mmenz08816: posts the ante 875
CRAIG k9: posts the ante 875
gator856500: posts the ante 875
RedHungryHip: posts the ante 875
BIGTIME30829: posts the ante 875
JJin91: posts the ante 875
panth26: posts the ante 875
gator856500: posts small blind 3500
RedHungryHip: posts big blind 7000
*** HOLE CARDS ***
Dealt to JJin91 [Jc 7d]
BIGTIME30829: folds=20
JJin91: folds=20
panth26: folds=20
njhaar: raises 48205 to 55205 and is all-in
LetsGoMets 6: folds=20
mmenz08816: folds=20
CRAIG k9: folds=20
gator856500: folds=20
RedHungryHip: folds=20
Uncalled bet (48205) returned to njhaar
njhaar collected 25375 from pot
njhaar: doesn't show hand=20
*** SUMMARY ***
Total pot 25375 | Rake 0=20
Seat 1: njhaar collected (25375)
Seat 2: LetsGoMets 6 folded before Flop (didn't bet)
Seat 3: mmenz08816 folded before Flop (didn't bet)
Seat 4: CRAIG k9 (button) folded before Flop (didn't bet)
Seat 5: gator856500 (small blind) folded before Flop
Seat 6: RedHungryHip (big blind) folded before Flop
Seat 7: BIGTIME30829 folded before Flop (didn't bet)
Seat 8: JJin91 folded before Flop (didn't bet)
Seat 9: panth26 folded before Flop (didn't bet)


*********** # 179 **************
PokerStars Hand #169563583910: Tournament #1597684117, $4.55+$0.45 USD =
Hold'em No Limit - Level XXVI (4000/8000) - 2017/05/07 23:17:17 ET
Table '1597684117 4' 9-max Seat #5 is the button
Seat 1: njhaar (73580 in chips)=20
Seat 2: LetsGoMets 6 (247219 in chips)=20
Seat 3: mmenz08816 (105630 in chips)=20
Seat 4: CRAIG k9 (153457 in chips)=20
Seat 5: gator856500 (48916 in chips)=20
Seat 6: RedHungryHip (108824 in chips)=20
Seat 7: BIGTIME30829 (92535 in chips)=20
Seat 8: JJin91 (90329 in chips)=20
Seat 9: panth26 (139510 in chips)=20
njhaar: posts the ante 1000
LetsGoMets 6: posts the ante 1000
mmenz08816: posts the ante 1000
CRAIG k9: posts the ante 1000
gator856500: posts the ante 1000
RedHungryHip: posts the ante 1000
BIGTIME30829: posts the ante 1000
JJin91: posts the ante 1000
panth26: posts the ante 1000
RedHungryHip: posts small blind 4000
BIGTIME30829: posts big blind 8000
*** HOLE CARDS ***
Dealt to JJin91 [2h 4c]
JJin91: folds=20
panth26: calls 8000
njhaar: folds=20
LetsGoMets 6: folds=20
mmenz08816: folds=20
CRAIG k9: folds=20
gator856500: folds=20
RedHungryHip: folds=20
BIGTIME30829: checks=20
*** FLOP *** [7h Qd 5d]
BIGTIME30829: bets 14500
panth26: raises 116010 to 130510 and is all-in
BIGTIME30829: folds=20
Uncalled bet (116010) returned to panth26
panth26 collected 58000 from pot
panth26: doesn't show hand=20
*** SUMMARY ***
Total pot 58000 | Rake 0=20
Board [7h Qd 5d]
Seat 1: njhaar folded before Flop (didn't bet)
Seat 2: LetsGoMets 6 folded before Flop (didn't bet)
Seat 3: mmenz08816 folded before Flop (didn't bet)
Seat 4: CRAIG k9 folded before Flop (didn't bet)
Seat 5: gator856500 (button) folded before Flop (didn't bet)
Seat 6: RedHungryHip (small blind) folded before Flop
Seat 7: BIGTIME30829 (big blind) folded on the Flop
Seat 8: JJin91 folded before Flop (didn't bet)
Seat 9: panth26 collected (58000)


*********** # 180 **************
PokerStars Hand #169563584097: Tournament #1597684117, $4.55+$0.45 USD =
Hold'em No Limit - Level XXVI (4000/8000) - 2017/05/07 23:17:57 ET
Table '1597684117 4' 9-max Seat #6 is the button
Seat 1: njhaar (72580 in chips)=20
Seat 2: LetsGoMets 6 (246219 in chips)=20
Seat 3: mmenz08816 (104630 in chips)=20
Seat 4: CRAIG k9 (152457 in chips)=20
Seat 5: gator856500 (47916 in chips)=20
Seat 6: RedHungryHip (103824 in chips)=20
Seat 7: BIGTIME30829 (69035 in chips)=20
Seat 8: JJin91 (89329 in chips)=20
Seat 9: panth26 (174010 in chips)=20
njhaar: posts the ante 1000
LetsGoMets 6: posts the ante 1000
mmenz08816: posts the ante 1000
CRAIG k9: posts the ante 1000
gator856500: posts the ante 1000
RedHungryHip: posts the ante 1000
BIGTIME30829: posts the ante 1000
JJin91: posts the ante 1000
panth26: posts the ante 1000
BIGTIME30829: posts small blind 4000
JJin91: posts big blind 8000
*** HOLE CARDS ***
Dealt to JJin91 [7d 3c]
panth26: folds=20
njhaar: folds=20
LetsGoMets 6: raises 27000 to 35000
mmenz08816: folds=20
CRAIG k9: folds=20
gator856500: folds=20
RedHungryHip: calls 35000
BIGTIME30829: folds=20
JJin91: folds=20
*** FLOP *** [7h Th 2d]
LetsGoMets 6: checks=20
RedHungryHip: checks=20
*** TURN *** [7h Th 2d] [6h]
LetsGoMets 6: bets 8000
RedHungryHip: calls 8000
*** RIVER *** [7h Th 2d 6h] [8s]
LetsGoMets 6: checks=20
RedHungryHip: checks=20
*** SHOW DOWN ***
LetsGoMets 6: shows [9h Ad] (a straight, Six to Ten)
RedHungryHip: mucks hand=20
LetsGoMets 6 collected 107000 from pot
*** SUMMARY ***
Total pot 107000 | Rake 0=20
Board [7h Th 2d 6h 8s]
Seat 1: njhaar folded before Flop (didn't bet)
Seat 2: LetsGoMets 6 showed [9h Ad] and won (107000) with a straight, S=
ix to Ten
Seat 3: mmenz08816 folded before Flop (didn't bet)
Seat 4: CRAIG k9 folded before Flop (didn't bet)
Seat 5: gator856500 folded before Flop (didn't bet)
Seat 6: RedHungryHip (button) mucked [As Js]
Seat 7: BIGTIME30829 (small blind) folded before Flop
Seat 8: JJin91 (big blind) folded before Flop
Seat 9: panth26 folded before Flop (didn't bet)


*********** # 181 **************
PokerStars Hand #169563584518: Tournament #1597684117, $4.55+$0.45 USD =
Hold'em No Limit - Level XXVI (4000/8000) - 2017/05/07 23:19:26 ET
Table '1597684117 4' 9-max Seat #7 is the button
Seat 1: njhaar (71580 in chips)=20
Seat 2: LetsGoMets 6 (309219 in chips)=20
Seat 3: mmenz08816 (103630 in chips)=20
Seat 4: CRAIG k9 (151457 in chips)=20
Seat 5: gator856500 (46916 in chips)=20
Seat 6: RedHungryHip (59824 in chips)=20
Seat 7: BIGTIME30829 (64035 in chips)=20
Seat 8: JJin91 (80329 in chips)=20
Seat 9: panth26 (173010 in chips)=20
njhaar: posts the ante 1000
LetsGoMets 6: posts the ante 1000
mmenz08816: posts the ante 1000
CRAIG k9: posts the ante 1000
gator856500: posts the ante 1000
RedHungryHip: posts the ante 1000
BIGTIME30829: posts the ante 1000
JJin91: posts the ante 1000
panth26: posts the ante 1000
JJin91: posts small blind 4000
panth26: posts big blind 8000
*** HOLE CARDS ***
Dealt to JJin91 [7d Tc]
njhaar: calls 8000
LetsGoMets 6: folds=20
mmenz08816: folds=20
CRAIG k9: folds=20
gator856500: folds=20
RedHungryHip: folds=20
BIGTIME30829: folds=20
JJin91: folds=20
panth26: raises 12800 to 20800
njhaar: calls 12800
*** FLOP *** [6d Td Js]
panth26: bets 54600
njhaar: folds=20
Uncalled bet (54600) returned to panth26
panth26 collected 54600 from pot
panth26: doesn't show hand=20
*** SUMMARY ***
Total pot 54600 | Rake 0=20
Board [6d Td Js]
Seat 1: njhaar folded on the Flop
Seat 2: LetsGoMets 6 folded before Flop (didn't bet)
Seat 3: mmenz08816 folded before Flop (didn't bet)
Seat 4: CRAIG k9 folded before Flop (didn't bet)
Seat 5: gator856500 folded before Flop (didn't bet)
Seat 6: RedHungryHip folded before Flop (didn't bet)
Seat 7: BIGTIME30829 (button) folded before Flop (didn't bet)
Seat 8: JJin91 (small blind) folded before Flop
Seat 9: panth26 (big blind) collected (54600)


*********** # 182 **************
PokerStars Hand #169563584673: Tournament #1597684117, $4.55+$0.45 USD =
Hold'em No Limit - Level XXVI (4000/8000) - 2017/05/07 23:19:58 ET
Table '1597684117 4' 9-max Seat #8 is the button
Seat 1: njhaar (49780 in chips)=20
Seat 2: LetsGoMets 6 (308219 in chips)=20
Seat 3: mmenz08816 (102630 in chips)=20
Seat 4: CRAIG k9 (150457 in chips)=20
Seat 5: gator856500 (45916 in chips)=20
Seat 6: RedHungryHip (58824 in chips)=20
Seat 7: BIGTIME30829 (63035 in chips)=20
Seat 8: JJin91 (75329 in chips)=20
Seat 9: panth26 (205810 in chips)=20
njhaar: posts the ante 1000
LetsGoMets 6: posts the ante 1000
mmenz08816: posts the ante 1000
CRAIG k9: posts the ante 1000
gator856500: posts the ante 1000
RedHungryHip: posts the ante 1000
BIGTIME30829: posts the ante 1000
JJin91: posts the ante 1000
panth26: posts the ante 1000
panth26: posts small blind 4000
njhaar: posts big blind 8000
*** HOLE CARDS ***
Dealt to JJin91 [3s 5h]
LetsGoMets 6: folds=20
mmenz08816: folds=20
CRAIG k9: folds=20
gator856500: raises 36916 to 44916 and is all-in
RedHungryHip: folds=20
BIGTIME30829: folds=20
JJin91: folds=20
panth26: folds=20
njhaar: folds=20
Uncalled bet (36916) returned to gator856500
gator856500 collected 29000 from pot
gator856500: doesn't show hand=20
*** SUMMARY ***
Total pot 29000 | Rake 0=20
Seat 1: njhaar (big blind) folded before Flop
Seat 2: LetsGoMets 6 folded before Flop (didn't bet)
Seat 3: mmenz08816 folded before Flop (didn't bet)
Seat 4: CRAIG k9 folded before Flop (didn't bet)
Seat 5: gator856500 collected (29000)
Seat 6: RedHungryHip folded before Flop (didn't bet)
Seat 7: BIGTIME30829 folded before Flop (didn't bet)
Seat 8: JJin91 (button) folded before Flop (didn't bet)
Seat 9: panth26 (small blind) folded before Flop


*********** # 183 **************
PokerStars Hand #169563584800: Tournament #1597684117, $4.55+$0.45 USD =
Hold'em No Limit - Level XXVI (4000/8000) - 2017/05/07 23:20:25 ET
Table '1597684117 4' 9-max Seat #9 is the button
Seat 1: njhaar (40780 in chips)=20
Seat 2: LetsGoMets 6 (307219 in chips)=20
Seat 3: mmenz08816 (101630 in chips)=20
Seat 4: CRAIG k9 (149457 in chips)=20
Seat 5: gator856500 (65916 in chips)=20
Seat 6: RedHungryHip (57824 in chips)=20
Seat 7: BIGTIME30829 (62035 in chips)=20
Seat 8: JJin91 (74329 in chips)=20
Seat 9: panth26 (200810 in chips)=20
njhaar: posts the ante 1000
LetsGoMets 6: posts the ante 1000
mmenz08816: posts the ante 1000
CRAIG k9: posts the ante 1000
gator856500: posts the ante 1000
RedHungryHip: posts the ante 1000
BIGTIME30829: posts the ante 1000
JJin91: posts the ante 1000
panth26: posts the ante 1000
njhaar: posts small blind 4000
LetsGoMets 6: posts big blind 8000
*** HOLE CARDS ***
Dealt to JJin91 [2d 3c]
mmenz08816: folds=20
CRAIG k9: folds=20
gator856500: calls 8000
RedHungryHip: folds=20
BIGTIME30829: folds=20
JJin91: folds=20
panth26: raises 16000 to 24000
njhaar: folds=20
LetsGoMets 6: folds=20
gator856500: calls 16000
*** FLOP *** [Ks 3h 4h]
gator856500: checks=20
panth26: checks=20
*** TURN *** [Ks 3h 4h] [Qh]
gator856500: bets 40916 and is all-in
panth26: folds=20
Uncalled bet (40916) returned to gator856500
gator856500 collected 69000 from pot
gator856500: doesn't show hand=20
*** SUMMARY ***
Total pot 69000 | Rake 0=20
Board [Ks 3h 4h Qh]
Seat 1: njhaar (small blind) folded before Flop
Seat 2: LetsGoMets 6 (big blind) folded before Flop
Seat 3: mmenz08816 folded before Flop (didn't bet)
Seat 4: CRAIG k9 folded before Flop (didn't bet)
Seat 5: gator856500 collected (69000)
Seat 6: RedHungryHip folded before Flop (didn't bet)
Seat 7: BIGTIME30829 folded before Flop (didn't bet)
Seat 8: JJin91 folded before Flop (didn't bet)
Seat 9: panth26 (button) folded on the Turn


*********** # 184 **************
PokerStars Hand #169563584985: Tournament #1597684117, $4.55+$0.45 USD =
Hold'em No Limit - Level XXVI (4000/8000) - 2017/05/07 23:21:02 ET
Table '1597684117 4' 9-max Seat #1 is the button
Seat 1: njhaar (35780 in chips)=20
Seat 2: LetsGoMets 6 (298219 in chips)=20
Seat 3: mmenz08816 (100630 in chips)=20
Seat 4: CRAIG k9 (148457 in chips)=20
Seat 5: gator856500 (109916 in chips)=20
Seat 6: RedHungryHip (56824 in chips)=20
Seat 7: BIGTIME30829 (61035 in chips)=20
Seat 8: JJin91 (73329 in chips)=20
Seat 9: panth26 (175810 in chips)=20
njhaar: posts the ante 1000
LetsGoMets 6: posts the ante 1000
mmenz08816: posts the ante 1000
CRAIG k9: posts the ante 1000
gator856500: posts the ante 1000
RedHungryHip: posts the ante 1000
BIGTIME30829: posts the ante 1000
JJin91: posts the ante 1000
panth26: posts the ante 1000
LetsGoMets 6: posts small blind 4000
mmenz08816: posts big blind 8000
*** HOLE CARDS ***
Dealt to JJin91 [7s 6h]
CRAIG k9: calls 8000
gator856500: calls 8000
RedHungryHip: folds=20
BIGTIME30829: folds=20
JJin91: folds=20
panth26: folds=20
njhaar: folds=20
LetsGoMets 6: folds=20
mmenz08816: checks=20
*** FLOP *** [Jd 9c Ts]
mmenz08816: checks=20
CRAIG k9: bets 16000
gator856500: calls 16000
mmenz08816: calls 16000
*** TURN *** [Jd 9c Ts] [5d]
mmenz08816: checks=20
CRAIG k9: checks=20
gator856500: checks=20
*** RIVER *** [Jd 9c Ts 5d] [Tc]
mmenz08816: checks=20
CRAIG k9: checks=20
gator856500: checks=20
*** SHOW DOWN ***
mmenz08816: shows [9h 8s] (two pair, Tens and Nines)
CRAIG k9: shows [9d Qd] (two pair, Tens and Nines - Queen kicker)
gator856500: mucks hand=20
CRAIG k9 collected 85000 from pot
*** SUMMARY ***
Total pot 85000 | Rake 0=20
Board [Jd 9c Ts 5d Tc]
Seat 1: njhaar (button) folded before Flop (didn't bet)
Seat 2: LetsGoMets 6 (small blind) folded before Flop
Seat 3: mmenz08816 (big blind) showed [9h 8s] and lost with two pair, T=
ens and Nines
Seat 4: CRAIG k9 showed [9d Qd] and won (85000) with two pair, Tens and=
 Nines
Seat 5: gator856500 mucked [Ah Qh]
Seat 6: RedHungryHip folded before Flop (didn't bet)
Seat 7: BIGTIME30829 folded before Flop (didn't bet)
Seat 8: JJin91 folded before Flop (didn't bet)
Seat 9: panth26 folded before Flop (didn't bet)


*********** # 185 **************
PokerStars Hand #169563585186: Tournament #1597684117, $4.55+$0.45 USD =
Hold'em No Limit - Level XXVI (4000/8000) - 2017/05/07 23:21:47 ET
Table '1597684117 4' 9-max Seat #2 is the button
Seat 1: njhaar (34780 in chips)=20
Seat 2: LetsGoMets 6 (293219 in chips)=20
Seat 3: mmenz08816 (75630 in chips)=20
Seat 4: CRAIG k9 (208457 in chips)=20
Seat 5: gator856500 (84916 in chips)=20
Seat 6: RedHungryHip (55824 in chips)=20
Seat 7: BIGTIME30829 (60035 in chips)=20
Seat 8: JJin91 (72329 in chips)=20
Seat 9: panth26 (174810 in chips)=20
njhaar: posts the ante 1000
LetsGoMets 6: posts the ante 1000
mmenz08816: posts the ante 1000
CRAIG k9: posts the ante 1000
gator856500: posts the ante 1000
RedHungryHip: posts the ante 1000
BIGTIME30829: posts the ante 1000
JJin91: posts the ante 1000
panth26: posts the ante 1000
mmenz08816: posts small blind 4000
CRAIG k9: posts big blind 8000
*** HOLE CARDS ***
Dealt to JJin91 [Kd 4c]
gator856500: folds=20
RedHungryHip: folds=20
BIGTIME30829: folds=20
JJin91: folds=20
panth26: folds=20
njhaar: folds=20
LetsGoMets 6: folds=20
mmenz08816: folds=20
Uncalled bet (4000) returned to CRAIG k9
CRAIG k9 collected 17000 from pot
CRAIG k9: doesn't show hand=20
*** SUMMARY ***
Total pot 17000 | Rake 0=20
Seat 1: njhaar folded before Flop (didn't bet)
Seat 2: LetsGoMets 6 (button) folded before Flop (didn't bet)
Seat 3: mmenz08816 (small blind) folded before Flop
Seat 4: CRAIG k9 (big blind) collected (17000)
Seat 5: gator856500 folded before Flop (didn't bet)
Seat 6: RedHungryHip folded before Flop (didn't bet)
Seat 7: BIGTIME30829 folded before Flop (didn't bet)
Seat 8: JJin91 folded before Flop (didn't bet)
Seat 9: panth26 folded before Flop (didn't bet)


*********** # 186 **************
PokerStars Hand #169563585246: Tournament #1597684117, $4.55+$0.45 USD =
Hold'em No Limit - Level XXVI (4000/8000) - 2017/05/07 23:22:00 ET
Table '1597684117 4' 9-max Seat #3 is the button
Seat 1: njhaar (33780 in chips)=20
Seat 2: LetsGoMets 6 (292219 in chips)=20
Seat 3: mmenz08816 (70630 in chips)=20
Seat 4: CRAIG k9 (220457 in chips)=20
Seat 5: gator856500 (83916 in chips)=20
Seat 6: RedHungryHip (54824 in chips)=20
Seat 7: BIGTIME30829 (59035 in chips)=20
Seat 8: JJin91 (71329 in chips)=20
Seat 9: panth26 (173810 in chips)=20
njhaar: posts the ante 1000
LetsGoMets 6: posts the ante 1000
mmenz08816: posts the ante 1000
CRAIG k9: posts the ante 1000
gator856500: posts the ante 1000
RedHungryHip: posts the ante 1000
BIGTIME30829: posts the ante 1000
JJin91: posts the ante 1000
panth26: posts the ante 1000
CRAIG k9: posts small blind 4000
gator856500: posts big blind 8000
*** HOLE CARDS ***
Dealt to JJin91 [Qd Qs]
RedHungryHip: folds=20
BIGTIME30829: calls 8000
JJin91: raises 62329 to 70329 and is all-in
panth26: folds=20
njhaar: folds=20
LetsGoMets 6: raises 220890 to 291219 and is all-in
mmenz08816: folds=20
CRAIG k9: folds=20
gator856500: folds=20
BIGTIME30829: folds=20
Uncalled bet (220890) returned to LetsGoMets 6
*** FLOP *** [9s 6c 6s]
*** TURN *** [9s 6c 6s] [5c]
*** RIVER *** [9s 6c 6s 5c] [6h]
*** SHOW DOWN ***
JJin91: shows [Qd Qs] (a full house, Sixes full of Queens)
LetsGoMets 6: shows [8s Ah] (three of a kind, Sixes)
JJin91 collected 169658 from pot
*** SUMMARY ***
Total pot 169658 | Rake 0=20
Board [9s 6c 6s 5c 6h]
Seat 1: njhaar folded before Flop (didn't bet)
Seat 2: LetsGoMets 6 showed [8s Ah] and lost with three of a kind, Sixes
Seat 3: mmenz08816 (button) folded before Flop (didn't bet)
Seat 4: CRAIG k9 (small blind) folded before Flop
Seat 5: gator856500 (big blind) folded before Flop
Seat 6: RedHungryHip folded before Flop (didn't bet)
Seat 7: BIGTIME30829 folded before Flop
Seat 8: JJin91 showed [Qd Qs] and won (169658) with a full house, Sixes=
 full of Queens
Seat 9: panth26 folded before Flop (didn't bet)


*********** # 187 **************
PokerStars Hand #169563585372: Tournament #1597684117, $4.55+$0.45 USD =
Hold'em No Limit - Level XXVII (5000/10000) - 2017/05/07 23:22:31 ET
Table '1597684117 4' 9-max Seat #4 is the button
Seat 1: njhaar (32780 in chips)=20
Seat 2: LetsGoMets 6 (220890 in chips)=20
Seat 3: mmenz08816 (69630 in chips)=20
Seat 4: CRAIG k9 (215457 in chips)=20
Seat 5: gator856500 (74916 in chips)=20
Seat 6: RedHungryHip (53824 in chips)=20
Seat 7: BIGTIME30829 (50035 in chips)=20
Seat 8: JJin91 (169658 in chips)=20
Seat 9: panth26 (172810 in chips)=20
njhaar: posts the ante 1250
LetsGoMets 6: posts the ante 1250
mmenz08816: posts the ante 1250
CRAIG k9: posts the ante 1250
gator856500: posts the ante 1250
RedHungryHip: posts the ante 1250
BIGTIME30829: posts the ante 1250
JJin91: posts the ante 1250
panth26: posts the ante 1250
gator856500: posts small blind 5000
RedHungryHip: posts big blind 10000
*** HOLE CARDS ***
Dealt to JJin91 [3h 8h]
BIGTIME30829: folds=20
JJin91: folds=20
panth26: folds=20
njhaar: folds=20
LetsGoMets 6: raises 209640 to 219640 and is all-in
mmenz08816: folds=20
CRAIG k9: folds=20
gator856500: folds=20
RedHungryHip: folds=20
Uncalled bet (209640) returned to LetsGoMets 6
LetsGoMets 6 collected 36250 from pot
LetsGoMets 6: doesn't show hand=20
*** SUMMARY ***
Total pot 36250 | Rake 0=20
Seat 1: njhaar folded before Flop (didn't bet)
Seat 2: LetsGoMets 6 collected (36250)
Seat 3: mmenz08816 folded before Flop (didn't bet)
Seat 4: CRAIG k9 (button) folded before Flop (didn't bet)
Seat 5: gator856500 (small blind) folded before Flop
Seat 6: RedHungryHip (big blind) folded before Flop
Seat 7: BIGTIME30829 folded before Flop (didn't bet)
Seat 8: JJin91 folded before Flop (didn't bet)
Seat 9: panth26 folded before Flop (didn't bet)


*********** # 188 **************
PokerStars Hand #169563585481: Tournament #1597684117, $4.55+$0.45 USD =
Hold'em No Limit - Level XXVII (5000/10000) - 2017/05/07 23:22:53 ET
Table '1597684117 4' 9-max Seat #5 is the button
Seat 1: njhaar (31530 in chips)=20
Seat 2: LetsGoMets 6 (245890 in chips)=20
Seat 3: mmenz08816 (68380 in chips)=20
Seat 4: CRAIG k9 (214207 in chips)=20
Seat 5: gator856500 (68666 in chips)=20
Seat 6: RedHungryHip (42574 in chips)=20
Seat 7: BIGTIME30829 (48785 in chips)=20
Seat 8: JJin91 (168408 in chips)=20
Seat 9: panth26 (171560 in chips)=20
njhaar: posts the ante 1250
LetsGoMets 6: posts the ante 1250
mmenz08816: posts the ante 1250
CRAIG k9: posts the ante 1250
gator856500: posts the ante 1250
RedHungryHip: posts the ante 1250
BIGTIME30829: posts the ante 1250
JJin91: posts the ante 1250
panth26: posts the ante 1250
RedHungryHip: posts small blind 5000
BIGTIME30829: posts big blind 10000
*** HOLE CARDS ***
Dealt to JJin91 [Ks Ts]
JJin91: folds=20
panth26: folds=20
njhaar: folds=20
LetsGoMets 6: folds=20
mmenz08816: raises 57130 to 67130 and is all-in
CRAIG k9: folds=20
gator856500: folds=20
RedHungryHip: folds=20
BIGTIME30829: folds=20
Uncalled bet (57130) returned to mmenz08816
mmenz08816 collected 36250 from pot
mmenz08816: doesn't show hand=20
*** SUMMARY ***
Total pot 36250 | Rake 0=20
Seat 1: njhaar folded before Flop (didn't bet)
Seat 2: LetsGoMets 6 folded before Flop (didn't bet)
Seat 3: mmenz08816 collected (36250)
Seat 4: CRAIG k9 folded before Flop (didn't bet)
Seat 5: gator856500 (button) folded before Flop (didn't bet)
Seat 6: RedHungryHip (small blind) folded before Flop
Seat 7: BIGTIME30829 (big blind) folded before Flop
Seat 8: JJin91 folded before Flop (didn't bet)
Seat 9: panth26 folded before Flop (didn't bet)


*********** # 189 **************
PokerStars Hand #169563585560: Tournament #1597684117, $4.55+$0.45 USD =
Hold'em No Limit - Level XXVII (5000/10000) - 2017/05/07 23:23:09 ET
Table '1597684117 4' 9-max Seat #6 is the button
Seat 1: njhaar (30280 in chips)=20
Seat 2: LetsGoMets 6 (244640 in chips)=20
Seat 3: mmenz08816 (93380 in chips)=20
Seat 4: CRAIG k9 (212957 in chips)=20
Seat 5: gator856500 (67416 in chips)=20
Seat 6: RedHungryHip (36324 in chips)=20
Seat 7: BIGTIME30829 (37535 in chips)=20
Seat 8: JJin91 (167158 in chips)=20
Seat 9: panth26 (170310 in chips)=20
njhaar: posts the ante 1250
LetsGoMets 6: posts the ante 1250
mmenz08816: posts the ante 1250
CRAIG k9: posts the ante 1250
gator856500: posts the ante 1250
RedHungryHip: posts the ante 1250
BIGTIME30829: posts the ante 1250
JJin91: posts the ante 1250
panth26: posts the ante 1250
BIGTIME30829: posts small blind 5000
JJin91: posts big blind 10000
*** HOLE CARDS ***
Dealt to JJin91 [Ac 4d]
panth26: raises 14000 to 24000
njhaar: folds=20
LetsGoMets 6: folds=20
mmenz08816: folds=20
CRAIG k9: folds=20
gator856500: folds=20
RedHungryHip: folds=20
BIGTIME30829: raises 12285 to 36285 and is all-in
JJin91: folds=20
panth26: calls 12285
*** FLOP *** [3s 9s 8h]
*** TURN *** [3s 9s 8h] [4s]
*** RIVER *** [3s 9s 8h 4s] [7h]
*** SHOW DOWN ***
BIGTIME30829: shows [5s 5h] (a pair of Fives)
panth26: shows [Ts Td] (a pair of Tens)
panth26 collected 93820 from pot
BIGTIME30829 finished the tournament in 9th place and received $13.75.
*** SUMMARY ***
Total pot 93820 | Rake 0=20
Board [3s 9s 8h 4s 7h]
Seat 1: njhaar folded before Flop (didn't bet)
Seat 2: LetsGoMets 6 folded before Flop (didn't bet)
Seat 3: mmenz08816 folded before Flop (didn't bet)
Seat 4: CRAIG k9 folded before Flop (didn't bet)
Seat 5: gator856500 folded before Flop (didn't bet)
Seat 6: RedHungryHip (button) folded before Flop (didn't bet)
Seat 7: BIGTIME30829 (small blind) showed [5s 5h] and lost with a pair =
of Fives
Seat 8: JJin91 (big blind) folded before Flop
Seat 9: panth26 showed [Ts Td] and won (93820) with a pair of Tens


*********** # 190 **************
PokerStars Hand #169563585652: Tournament #1597684117, $4.55+$0.45 USD =
Hold'em No Limit - Level XXVII (5000/10000) - 2017/05/07 23:23:31 ET
Table '1597684117 4' 9-max Seat #8 is the button
Seat 1: njhaar (29030 in chips)=20
Seat 2: LetsGoMets 6 (243390 in chips)=20
Seat 3: mmenz08816 (92130 in chips)=20
Seat 4: CRAIG k9 (211707 in chips)=20
Seat 5: gator856500 (66166 in chips)=20
Seat 6: RedHungryHip (35074 in chips)=20
Seat 8: JJin91 (155908 in chips)=20
Seat 9: panth26 (226595 in chips)=20
njhaar: posts the ante 1250
LetsGoMets 6: posts the ante 1250
mmenz08816: posts the ante 1250
CRAIG k9: posts the ante 1250
gator856500: posts the ante 1250
RedHungryHip: posts the ante 1250
JJin91: posts the ante 1250
panth26: posts the ante 1250
panth26: posts small blind 5000
njhaar: posts big blind 10000
*** HOLE CARDS ***
Dealt to JJin91 [6d Qc]
LetsGoMets 6: folds=20
mmenz08816: folds=20
CRAIG k9: folds=20
gator856500: folds=20
RedHungryHip: folds=20
JJin91: raises 144658 to 154658 and is all-in
panth26: folds=20
njhaar: calls 17780 and is all-in
Uncalled bet (126878) returned to JJin91
*** FLOP *** [3h 2s 7d]
*** TURN *** [3h 2s 7d] [Jd]
*** RIVER *** [3h 2s 7d Jd] [5d]
*** SHOW DOWN ***
njhaar: shows [6s 4s] (a straight, Three to Seven)
JJin91: shows [6d Qc] (high card Queen)
njhaar collected 70560 from pot
*** SUMMARY ***
Total pot 70560 | Rake 0=20
Board [3h 2s 7d Jd 5d]
Seat 1: njhaar (big blind) showed [6s 4s] and won (70560) with a straig=
ht, Three to Seven
Seat 2: LetsGoMets 6 folded before Flop (didn't bet)
Seat 3: mmenz08816 folded before Flop (didn't bet)
Seat 4: CRAIG k9 folded before Flop (didn't bet)
Seat 5: gator856500 folded before Flop (didn't bet)
Seat 6: RedHungryHip folded before Flop (didn't bet)
Seat 8: JJin91 (button) showed [6d Qc] and lost with high card Queen
Seat 9: panth26 (small blind) folded before Flop


*********** # 191 **************
PokerStars Hand #169563585767: Tournament #1597684117, $4.55+$0.45 USD =
Hold'em No Limit - Level XXVII (5000/10000) - 2017/05/07 23:23:59 ET
Table '1597684117 4' 9-max Seat #9 is the button
Seat 1: njhaar (70560 in chips)=20
Seat 2: LetsGoMets 6 (242140 in chips)=20
Seat 3: mmenz08816 (90880 in chips)=20
Seat 4: CRAIG k9 (210457 in chips)=20
Seat 5: gator856500 (64916 in chips)=20
Seat 6: RedHungryHip (33824 in chips)=20
Seat 8: JJin91 (126878 in chips)=20
Seat 9: panth26 (220345 in chips)=20
njhaar: posts the ante 1250
LetsGoMets 6: posts the ante 1250
mmenz08816: posts the ante 1250
CRAIG k9: posts the ante 1250
gator856500: posts the ante 1250
RedHungryHip: posts the ante 1250
JJin91: posts the ante 1250
panth26: posts the ante 1250
njhaar: posts small blind 5000
LetsGoMets 6: posts big blind 10000
*** HOLE CARDS ***
Dealt to JJin91 [7c Td]
mmenz08816: folds=20
CRAIG k9: calls 10000
gator856500: folds=20
RedHungryHip: folds=20
JJin91: folds=20
panth26: calls 10000
njhaar: folds=20
LetsGoMets 6: checks=20
*** FLOP *** [Ks Kd 4s]
LetsGoMets 6: checks=20
CRAIG k9: bets 20000
panth26: folds=20
LetsGoMets 6: folds=20
Uncalled bet (20000) returned to CRAIG k9
CRAIG k9 collected 45000 from pot
CRAIG k9: doesn't show hand=20
*** SUMMARY ***
Total pot 45000 | Rake 0=20
Board [Ks Kd 4s]
Seat 1: njhaar (small blind) folded before Flop
Seat 2: LetsGoMets 6 (big blind) folded on the Flop
Seat 3: mmenz08816 folded before Flop (didn't bet)
Seat 4: CRAIG k9 collected (45000)
Seat 5: gator856500 folded before Flop (didn't bet)
Seat 6: RedHungryHip folded before Flop (didn't bet)
Seat 8: JJin91 folded before Flop (didn't bet)
Seat 9: panth26 (button) folded on the Flop


*********** # 192 **************
PokerStars Hand #169563585950: Tournament #1597684117, $4.55+$0.45 USD =
Hold'em No Limit - Level XXVII (5000/10000) - 2017/05/07 23:24:36 ET
Table '1597684117 4' 9-max Seat #1 is the button
Seat 1: njhaar (64310 in chips)=20
Seat 2: LetsGoMets 6 (230890 in chips)=20
Seat 3: mmenz08816 (89630 in chips)=20
Seat 4: CRAIG k9 (244207 in chips)=20
Seat 5: gator856500 (63666 in chips)=20
Seat 6: RedHungryHip (32574 in chips)=20
Seat 8: JJin91 (125628 in chips)=20
Seat 9: panth26 (209095 in chips)=20
njhaar: posts the ante 1250
LetsGoMets 6: posts the ante 1250
mmenz08816: posts the ante 1250
CRAIG k9: posts the ante 1250
gator856500: posts the ante 1250
RedHungryHip: posts the ante 1250
JJin91: posts the ante 1250
panth26: posts the ante 1250
LetsGoMets 6: posts small blind 5000
mmenz08816: posts big blind 10000
*** HOLE CARDS ***
Dealt to JJin91 [Jc Tc]
CRAIG k9: folds=20
gator856500: folds=20
RedHungryHip: folds=20
JJin91: raises 14850 to 24850
panth26: folds=20
njhaar: folds=20
LetsGoMets 6: raises 204790 to 229640 and is all-in
mmenz08816: folds=20
JJin91: folds=20
Uncalled bet (204790) returned to LetsGoMets 6
LetsGoMets 6 collected 69700 from pot
LetsGoMets 6: doesn't show hand=20
*** SUMMARY ***
Total pot 69700 | Rake 0=20
Seat 1: njhaar (button) folded before Flop (didn't bet)
Seat 2: LetsGoMets 6 (small blind) collected (69700)
Seat 3: mmenz08816 (big blind) folded before Flop
Seat 4: CRAIG k9 folded before Flop (didn't bet)
Seat 5: gator856500 folded before Flop (didn't bet)
Seat 6: RedHungryHip folded before Flop (didn't bet)
Seat 8: JJin91 folded before Flop
Seat 9: panth26 folded before Flop (didn't bet)


*********** # 193 **************
PokerStars Hand #169563586101: Tournament #1597684117, $4.55+$0.45 USD =
Hold'em No Limit - Level XXVII (5000/10000) - 2017/05/07 23:25:09 ET
Table '1597684117 4' 9-max Seat #2 is the button
Seat 1: njhaar (63060 in chips)=20
Seat 2: LetsGoMets 6 (274490 in chips)=20
Seat 3: mmenz08816 (78380 in chips)=20
Seat 4: CRAIG k9 (242957 in chips)=20
Seat 5: gator856500 (62416 in chips)=20
Seat 6: RedHungryHip (31324 in chips)=20
Seat 8: JJin91 (99528 in chips)=20
Seat 9: panth26 (207845 in chips)=20
njhaar: posts the ante 1250
LetsGoMets 6: posts the ante 1250
mmenz08816: posts the ante 1250
CRAIG k9: posts the ante 1250
gator856500: posts the ante 1250
RedHungryHip: posts the ante 1250
JJin91: posts the ante 1250
panth26: posts the ante 1250
mmenz08816: posts small blind 5000
CRAIG k9: posts big blind 10000
*** HOLE CARDS ***
Dealt to JJin91 [Kd 8h]
gator856500: folds=20
RedHungryHip: raises 20074 to 30074 and is all-in
JJin91: folds=20
panth26: calls 30074
njhaar: folds=20
LetsGoMets 6: folds=20
mmenz08816 is connected=20
mmenz08816: folds=20
CRAIG k9: folds=20
*** FLOP *** [2s 7c 5s]
*** TURN *** [2s 7c 5s] [Jh]
*** RIVER *** [2s 7c 5s Jh] [Jc]
*** SHOW DOWN ***
RedHungryHip: shows [7d 7s] (a full house, Sevens full of Jacks)
panth26: shows [Jd Ah] (three of a kind, Jacks)
RedHungryHip collected 85148 from pot
*** SUMMARY ***
Total pot 85148 | Rake 0=20
Board [2s 7c 5s Jh Jc]
Seat 1: njhaar folded before Flop (didn't bet)
Seat 2: LetsGoMets 6 (button) folded before Flop (didn't bet)
Seat 3: mmenz08816 (small blind) folded before Flop
Seat 4: CRAIG k9 (big blind) folded before Flop
Seat 5: gator856500 folded before Flop (didn't bet)
Seat 6: RedHungryHip showed [7d 7s] and won (85148) with a full house, =
Sevens full of Jacks
Seat 8: JJin91 folded before Flop (didn't bet)
Seat 9: panth26 showed [Jd Ah] and lost with three of a kind, Jacks


*********** # 194 **************
PokerStars Hand #169563586245: Tournament #1597684117, $4.55+$0.45 USD =
Hold'em No Limit - Level XXVII (5000/10000) - 2017/05/07 23:25:40 ET
Table '1597684117 4' 9-max Seat #3 is the button
Seat 1: njhaar (61810 in chips)=20
Seat 2: LetsGoMets 6 (273240 in chips)=20
Seat 3: mmenz08816 (72130 in chips)=20
Seat 4: CRAIG k9 (231707 in chips)=20
Seat 5: gator856500 (61166 in chips)=20
Seat 6: RedHungryHip (85148 in chips)=20
Seat 8: JJin91 (98278 in chips)=20
Seat 9: panth26 (176521 in chips)=20
njhaar: posts the ante 1250
LetsGoMets 6: posts the ante 1250
mmenz08816: posts the ante 1250
CRAIG k9: posts the ante 1250
gator856500: posts the ante 1250
RedHungryHip: posts the ante 1250
JJin91: posts the ante 1250
panth26: posts the ante 1250
CRAIG k9: posts small blind 5000
gator856500: posts big blind 10000
*** HOLE CARDS ***
Dealt to JJin91 [Th Kd]
RedHungryHip: folds=20
JJin91: folds=20
panth26: folds=20
njhaar: folds=20
LetsGoMets 6: folds=20
mmenz08816: folds=20
CRAIG k9: calls 5000
gator856500: checks=20
*** FLOP *** [6s Jd 4c]
CRAIG k9: bets 10000
gator856500: folds=20
Uncalled bet (10000) returned to CRAIG k9
CRAIG k9 collected 30000 from pot
CRAIG k9: doesn't show hand=20
*** SUMMARY ***
Total pot 30000 | Rake 0=20
Board [6s Jd 4c]
Seat 1: njhaar folded before Flop (didn't bet)
Seat 2: LetsGoMets 6 folded before Flop (didn't bet)
Seat 3: mmenz08816 (button) folded before Flop (didn't bet)
Seat 4: CRAIG k9 (small blind) collected (30000)
Seat 5: gator856500 (big blind) folded on the Flop
Seat 6: RedHungryHip folded before Flop (didn't bet)
Seat 8: JJin91 folded before Flop (didn't bet)
Seat 9: panth26 folded before Flop (didn't bet)


*********** # 195 **************
PokerStars Hand #169563586341: Tournament #1597684117, $4.55+$0.45 USD =
Hold'em No Limit - Level XXVII (5000/10000) - 2017/05/07 23:26:01 ET
Table '1597684117 4' 9-max Seat #4 is the button
Seat 1: njhaar (60560 in chips)=20
Seat 2: LetsGoMets 6 (271990 in chips)=20
Seat 3: mmenz08816 (70880 in chips)=20
Seat 4: CRAIG k9 (250457 in chips)=20
Seat 5: gator856500 (49916 in chips)=20
Seat 6: RedHungryHip (83898 in chips)=20
Seat 8: JJin91 (97028 in chips)=20
Seat 9: panth26 (175271 in chips)=20
njhaar: posts the ante 1250
LetsGoMets 6: posts the ante 1250
mmenz08816: posts the ante 1250
CRAIG k9: posts the ante 1250
gator856500: posts the ante 1250
RedHungryHip: posts the ante 1250
JJin91: posts the ante 1250
panth26: posts the ante 1250
gator856500: posts small blind 5000
RedHungryHip: posts big blind 10000
*** HOLE CARDS ***
Dealt to JJin91 [Th Qs]
JJin91: folds=20
panth26: folds=20
njhaar: folds=20
LetsGoMets 6: folds=20
mmenz08816: raises 59630 to 69630 and is all-in
CRAIG k9: calls 69630
gator856500: folds=20
RedHungryHip: folds=20
*** FLOP *** [Kd Qh 6d]
*** TURN *** [Kd Qh 6d] [4c]
*** RIVER *** [Kd Qh 6d 4c] [Tc]
*** SHOW DOWN ***
mmenz08816: shows [4s 4d] (three of a kind, Fours)
CRAIG k9: shows [Ac Kh] (a pair of Kings)
mmenz08816 collected 164260 from pot
*** SUMMARY ***
Total pot 164260 | Rake 0=20
Board [Kd Qh 6d 4c Tc]
Seat 1: njhaar folded before Flop (didn't bet)
Seat 2: LetsGoMets 6 folded before Flop (didn't bet)
Seat 3: mmenz08816 showed [4s 4d] and won (164260) with three of a kind=
, Fours
Seat 4: CRAIG k9 (button) showed [Ac Kh] and lost with a pair of Kings
Seat 5: gator856500 (small blind) folded before Flop
Seat 6: RedHungryHip (big blind) folded before Flop
Seat 8: JJin91 folded before Flop (didn't bet)
Seat 9: panth26 folded before Flop (didn't bet)


*********** # 196 **************
PokerStars Hand #169563586439: Tournament #1597684117, $4.55+$0.45 USD =
Hold'em No Limit - Level XXVII (5000/10000) - 2017/05/07 23:26:20 ET
Table '1597684117 4' 9-max Seat #5 is the button
Seat 1: njhaar (59310 in chips)=20
Seat 2: LetsGoMets 6 (270740 in chips)=20
Seat 3: mmenz08816 (164260 in chips)=20
Seat 4: CRAIG k9 (179577 in chips)=20
Seat 5: gator856500 (43666 in chips)=20
Seat 6: RedHungryHip (72648 in chips)=20
Seat 8: JJin91 (95778 in chips)=20
Seat 9: panth26 (174021 in chips)=20
njhaar: posts the ante 1250
LetsGoMets 6: posts the ante 1250
mmenz08816: posts the ante 1250
CRAIG k9: posts the ante 1250
gator856500: posts the ante 1250
RedHungryHip: posts the ante 1250
JJin91: posts the ante 1250
panth26: posts the ante 1250
RedHungryHip: posts small blind 5000
JJin91: posts big blind 10000
*** HOLE CARDS ***
Dealt to JJin91 [8h 2c]
panth26: folds=20
njhaar: raises 48060 to 58060 and is all-in
LetsGoMets 6: folds=20
mmenz08816: folds=20
CRAIG k9: folds=20
gator856500: folds=20
RedHungryHip: folds=20
JJin91: folds=20
Uncalled bet (48060) returned to njhaar
njhaar collected 35000 from pot
njhaar: doesn't show hand=20
*** SUMMARY ***
Total pot 35000 | Rake 0=20
Seat 1: njhaar collected (35000)
Seat 2: LetsGoMets 6 folded before Flop (didn't bet)
Seat 3: mmenz08816 folded before Flop (didn't bet)
Seat 4: CRAIG k9 folded before Flop (didn't bet)
Seat 5: gator856500 (button) folded before Flop (didn't bet)
Seat 6: RedHungryHip (small blind) folded before Flop
Seat 8: JJin91 (big blind) folded before Flop
Seat 9: panth26 folded before Flop (didn't bet)


*********** # 197 **************
PokerStars Hand #169563586511: Tournament #1597684117, $4.55+$0.45 USD =
Hold'em No Limit - Level XXVII (5000/10000) - 2017/05/07 23:26:36 ET
Table '1597684117 4' 9-max Seat #6 is the button
Seat 1: njhaar (83060 in chips)=20
Seat 2: LetsGoMets 6 (269490 in chips)=20
Seat 3: mmenz08816 (163010 in chips)=20
Seat 4: CRAIG k9 (178327 in chips)=20
Seat 5: gator856500 (42416 in chips)=20
Seat 6: RedHungryHip (66398 in chips)=20
Seat 8: JJin91 (84528 in chips)=20
Seat 9: panth26 (172771 in chips)=20
njhaar: posts the ante 1250
LetsGoMets 6: posts the ante 1250
mmenz08816: posts the ante 1250
CRAIG k9: posts the ante 1250
gator856500: posts the ante 1250
RedHungryHip: posts the ante 1250
JJin91: posts the ante 1250
panth26: posts the ante 1250
JJin91: posts small blind 5000
panth26: posts big blind 10000
*** HOLE CARDS ***
Dealt to JJin91 [5h 9d]
njhaar: calls 10000
LetsGoMets 6: folds=20
mmenz08816: folds=20
CRAIG k9: calls 10000
gator856500: folds=20
RedHungryHip: folds=20
JJin91: folds=20
panth26: checks=20
*** FLOP *** [Ad Ah 4s]
panth26: checks=20
njhaar: checks=20
CRAIG k9: bets 20000
panth26: folds=20
njhaar: calls 20000
*** TURN *** [Ad Ah 4s] [6s]
njhaar: checks=20
CRAIG k9: bets 40000
njhaar: raises 11810 to 51810 and is all-in
CRAIG k9: folds=20
Uncalled bet (11810) returned to njhaar
njhaar collected 165000 from pot
njhaar: doesn't show hand=20
*** SUMMARY ***
Total pot 165000 | Rake 0=20
Board [Ad Ah 4s 6s]
Seat 1: njhaar collected (165000)
Seat 2: LetsGoMets 6 folded before Flop (didn't bet)
Seat 3: mmenz08816 folded before Flop (didn't bet)
Seat 4: CRAIG k9 folded on the Turn
Seat 5: gator856500 folded before Flop (didn't bet)
Seat 6: RedHungryHip (button) folded before Flop (didn't bet)
Seat 8: JJin91 (small blind) folded before Flop
Seat 9: panth26 (big blind) folded on the Flop


*********** # 198 **************
PokerStars Hand #169563586704: Tournament #1597684117, $4.55+$0.45 USD =
Hold'em No Limit - Level XXVIII (6000/12000) - 2017/05/07 23:27:20 ET
Table '1597684117 4' 9-max Seat #8 is the button
Seat 1: njhaar (176810 in chips)=20
Seat 2: LetsGoMets 6 (268240 in chips)=20
Seat 3: mmenz08816 (161760 in chips)=20
Seat 4: CRAIG k9 (107077 in chips)=20
Seat 5: gator856500 (41166 in chips)=20
Seat 6: RedHungryHip (65148 in chips)=20
Seat 8: JJin91 (78278 in chips)=20
Seat 9: panth26 (161521 in chips)=20
njhaar: posts the ante 1500
LetsGoMets 6: posts the ante 1500
mmenz08816: posts the ante 1500
CRAIG k9: posts the ante 1500
gator856500: posts the ante 1500
RedHungryHip: posts the ante 1500
JJin91: posts the ante 1500
panth26: posts the ante 1500
panth26: posts small blind 6000
njhaar: posts big blind 12000
*** HOLE CARDS ***
Dealt to JJin91 [Ac 8s]
LetsGoMets 6: folds=20
mmenz08816: raises 12000 to 24000
CRAIG k9: folds=20
gator856500: raises 15666 to 39666 and is all-in
RedHungryHip: folds=20
JJin91: folds=20
panth26: folds=20
njhaar: folds=20
mmenz08816: calls 15666
*** FLOP *** [2d 9d 6s]
*** TURN *** [2d 9d 6s] [4s]
*** RIVER *** [2d 9d 6s 4s] [4h]
*** SHOW DOWN ***
mmenz08816: shows [Ad Qs] (a pair of Fours)
gator856500: shows [Th Td] (two pair, Tens and Fours)
gator856500 collected 109332 from pot
*** SUMMARY ***
Total pot 109332 | Rake 0=20
Board [2d 9d 6s 4s 4h]
Seat 1: njhaar (big blind) folded before Flop
Seat 2: LetsGoMets 6 folded before Flop (didn't bet)
Seat 3: mmenz08816 showed [Ad Qs] and lost with a pair of Fours
Seat 4: CRAIG k9 folded before Flop (didn't bet)
Seat 5: gator856500 showed [Th Td] and won (109332) with two pair, Tens=
 and Fours
Seat 6: RedHungryHip folded before Flop (didn't bet)
Seat 8: JJin91 (button) folded before Flop (didn't bet)
Seat 9: panth26 (small blind) folded before Flop


*********** # 199 **************
PokerStars Hand #169563586825: Tournament #1597684117, $4.55+$0.45 USD =
Hold'em No Limit - Level XXVIII (6000/12000) - 2017/05/07 23:27:47 ET
Table '1597684117 4' 9-max Seat #9 is the button
Seat 1: njhaar (163310 in chips)=20
Seat 2: LetsGoMets 6 (266740 in chips)=20
Seat 3: mmenz08816 (120594 in chips)=20
Seat 4: CRAIG k9 (105577 in chips)=20
Seat 5: gator856500 (109332 in chips)=20
Seat 6: RedHungryHip (63648 in chips)=20
Seat 8: JJin91 (76778 in chips)=20
Seat 9: panth26 (154021 in chips)=20
njhaar: posts the ante 1500
LetsGoMets 6: posts the ante 1500
mmenz08816: posts the ante 1500
CRAIG k9: posts the ante 1500
gator856500: posts the ante 1500
RedHungryHip: posts the ante 1500
JJin91: posts the ante 1500
panth26: posts the ante 1500
njhaar: posts small blind 6000
LetsGoMets 6: posts big blind 12000
*** HOLE CARDS ***
Dealt to JJin91 [Tc Js]
mmenz08816: folds=20
CRAIG k9: folds=20
gator856500: folds=20
RedHungryHip: folds=20
JJin91: folds=20
panth26: folds=20
njhaar: calls 6000
LetsGoMets 6: checks=20
*** FLOP *** [Ad Ks 4c]
njhaar: bets 12000
LetsGoMets 6: folds=20
Uncalled bet (12000) returned to njhaar
njhaar collected 36000 from pot
njhaar: doesn't show hand=20
*** SUMMARY ***
Total pot 36000 | Rake 0=20
Board [Ad Ks 4c]
Seat 1: njhaar (small blind) collected (36000)
Seat 2: LetsGoMets 6 (big blind) folded on the Flop
Seat 3: mmenz08816 folded before Flop (didn't bet)
Seat 4: CRAIG k9 folded before Flop (didn't bet)
Seat 5: gator856500 folded before Flop (didn't bet)
Seat 6: RedHungryHip folded before Flop (didn't bet)
Seat 8: JJin91 folded before Flop (didn't bet)
Seat 9: panth26 (button) folded before Flop (didn't bet)


*********** # 200 **************
PokerStars Hand #169563586915: Tournament #1597684117, $4.55+$0.45 USD =
Hold'em No Limit - Level XXVIII (6000/12000) - 2017/05/07 23:28:07 ET
Table '1597684117 4' 9-max Seat #1 is the button
Seat 1: njhaar (185810 in chips)=20
Seat 2: LetsGoMets 6 (253240 in chips)=20
Seat 3: mmenz08816 (119094 in chips)=20
Seat 4: CRAIG k9 (104077 in chips)=20
Seat 5: gator856500 (107832 in chips)=20
Seat 6: RedHungryHip (62148 in chips)=20
Seat 8: JJin91 (75278 in chips)=20
Seat 9: panth26 (152521 in chips)=20
njhaar: posts the ante 1500
LetsGoMets 6: posts the ante 1500
mmenz08816: posts the ante 1500
CRAIG k9: posts the ante 1500
gator856500: posts the ante 1500
RedHungryHip: posts the ante 1500
JJin91: posts the ante 1500
panth26: posts the ante 1500
LetsGoMets 6: posts small blind 6000
mmenz08816: posts big blind 12000
*** HOLE CARDS ***
Dealt to JJin91 [9d Kc]
CRAIG k9: folds=20
gator856500: folds=20
RedHungryHip: folds=20
JJin91: folds=20
panth26: raises 16800 to 28800
njhaar: folds=20
LetsGoMets 6: folds=20
mmenz08816: folds=20
Uncalled bet (16800) returned to panth26
panth26 collected 42000 from pot
panth26: doesn't show hand=20
*** SUMMARY ***
Total pot 42000 | Rake 0=20
Seat 1: njhaar (button) folded before Flop (didn't bet)
Seat 2: LetsGoMets 6 (small blind) folded before Flop
Seat 3: mmenz08816 (big blind) folded before Flop
Seat 4: CRAIG k9 folded before Flop (didn't bet)
Seat 5: gator856500 folded before Flop (didn't bet)
Seat 6: RedHungryHip folded before Flop (didn't bet)
Seat 8: JJin91 folded before Flop (didn't bet)
Seat 9: panth26 collected (42000)


*********** # 201 **************
PokerStars Hand #169563586974: Tournament #1597684117, $4.55+$0.45 USD =
Hold'em No Limit - Level XXVIII (6000/12000) - 2017/05/07 23:28:22 ET
Table '1597684117 4' 9-max Seat #2 is the button
Seat 1: njhaar (184310 in chips)=20
Seat 2: LetsGoMets 6 (245740 in chips)=20
Seat 3: mmenz08816 (105594 in chips)=20
Seat 4: CRAIG k9 (102577 in chips)=20
Seat 5: gator856500 (106332 in chips)=20
Seat 6: RedHungryHip (60648 in chips)=20
Seat 8: JJin91 (73778 in chips)=20
Seat 9: panth26 (181021 in chips)=20
njhaar: posts the ante 1500
LetsGoMets 6: posts the ante 1500
mmenz08816: posts the ante 1500
CRAIG k9: posts the ante 1500
gator856500: posts the ante 1500
RedHungryHip: posts the ante 1500
JJin91: posts the ante 1500
panth26: posts the ante 1500
mmenz08816: posts small blind 6000
CRAIG k9: posts big blind 12000
*** HOLE CARDS ***
Dealt to JJin91 [7d 9h]
gator856500: folds=20
RedHungryHip: folds=20
JJin91: folds=20
panth26: raises 16800 to 28800
njhaar: folds=20
LetsGoMets 6: raises 87600 to 116400
mmenz08816: folds=20
CRAIG k9: folds=20
panth26: raises 63121 to 179521 and is all-in
LetsGoMets 6: folds=20
Uncalled bet (63121) returned to panth26
panth26 collected 262800 from pot
panth26: doesn't show hand=20
*** SUMMARY ***
Total pot 262800 | Rake 0=20
Seat 1: njhaar folded before Flop (didn't bet)
Seat 2: LetsGoMets 6 (button) folded before Flop
Seat 3: mmenz08816 (small blind) folded before Flop
Seat 4: CRAIG k9 (big blind) folded before Flop
Seat 5: gator856500 folded before Flop (didn't bet)
Seat 6: RedHungryHip folded before Flop (didn't bet)
Seat 8: JJin91 folded before Flop (didn't bet)
Seat 9: panth26 collected (262800)


*********** # 202 **************
PokerStars Hand #169563587126: Tournament #1597684117, $4.55+$0.45 USD =
Hold'em No Limit - Level XXVIII (6000/12000) - 2017/05/07 23:28:56 ET
Table '1597684117 4' 9-max Seat #3 is the button
Seat 1: njhaar (182810 in chips)=20
Seat 2: LetsGoMets 6 (127840 in chips)=20
Seat 3: mmenz08816 (98094 in chips)=20
Seat 4: CRAIG k9 (89077 in chips)=20
Seat 5: gator856500 (104832 in chips)=20
Seat 6: RedHungryHip (59148 in chips)=20
Seat 8: JJin91 (72278 in chips)=20
Seat 9: panth26 (325921 in chips)=20
njhaar: posts the ante 1500
LetsGoMets 6: posts the ante 1500
mmenz08816: posts the ante 1500
CRAIG k9: posts the ante 1500
gator856500: posts the ante 1500
RedHungryHip: posts the ante 1500
JJin91: posts the ante 1500
panth26: posts the ante 1500
CRAIG k9: posts small blind 6000
gator856500: posts big blind 12000
*** HOLE CARDS ***
Dealt to JJin91 [8s Kh]
RedHungryHip: raises 45648 to 57648 and is all-in
JJin91: folds=20
panth26: folds=20
njhaar: folds=20
LetsGoMets 6: folds=20
mmenz08816: folds=20
CRAIG k9: folds=20
gator856500: folds=20
Uncalled bet (45648) returned to RedHungryHip
RedHungryHip collected 42000 from pot
RedHungryHip: doesn't show hand=20
*** SUMMARY ***
Total pot 42000 | Rake 0=20
Seat 1: njhaar folded before Flop (didn't bet)
Seat 2: LetsGoMets 6 folded before Flop (didn't bet)
Seat 3: mmenz08816 (button) folded before Flop (didn't bet)
Seat 4: CRAIG k9 (small blind) folded before Flop
Seat 5: gator856500 (big blind) folded before Flop
Seat 6: RedHungryHip collected (42000)
Seat 8: JJin91 folded before Flop (didn't bet)
Seat 9: panth26 folded before Flop (didn't bet)


*********** # 203 **************
PokerStars Hand #169563587279: Tournament #1597684117, $4.55+$0.45 USD =
Hold'em No Limit - Level XXVIII (6000/12000) - 2017/05/07 23:29:32 ET
Table '1597684117 4' 9-max Seat #4 is the button
Seat 1: njhaar (181310 in chips)=20
Seat 2: LetsGoMets 6 (126340 in chips)=20
Seat 3: mmenz08816 (96594 in chips)=20
Seat 4: CRAIG k9 (81577 in chips)=20
Seat 5: gator856500 (91332 in chips)=20
Seat 6: RedHungryHip (87648 in chips)=20
Seat 8: JJin91 (70778 in chips)=20
Seat 9: panth26 (324421 in chips)=20
njhaar: posts the ante 1500
LetsGoMets 6: posts the ante 1500
mmenz08816: posts the ante 1500
CRAIG k9: posts the ante 1500
gator856500: posts the ante 1500
RedHungryHip: posts the ante 1500
JJin91: posts the ante 1500
panth26: posts the ante 1500
gator856500: posts small blind 6000
RedHungryHip: posts big blind 12000
*** HOLE CARDS ***
Dealt to JJin91 [2d Kd]
JJin91: folds=20
panth26: folds=20
njhaar: folds=20
LetsGoMets 6: raises 112840 to 124840 and is all-in
mmenz08816: folds=20
CRAIG k9: folds=20
gator856500: folds=20
RedHungryHip: folds=20
Uncalled bet (112840) returned to LetsGoMets 6
LetsGoMets 6 collected 42000 from pot
LetsGoMets 6: doesn't show hand=20
*** SUMMARY ***
Total pot 42000 | Rake 0=20
Seat 1: njhaar folded before Flop (didn't bet)
Seat 2: LetsGoMets 6 collected (42000)
Seat 3: mmenz08816 folded before Flop (didn't bet)
Seat 4: CRAIG k9 (button) folded before Flop (didn't bet)
Seat 5: gator856500 (small blind) folded before Flop
Seat 6: RedHungryHip (big blind) folded before Flop
Seat 8: JJin91 folded before Flop (didn't bet)
Seat 9: panth26 folded before Flop (didn't bet)


*********** # 204 **************
PokerStars Hand #169563587346: Tournament #1597684117, $4.55+$0.45 USD =
Hold'em No Limit - Level XXVIII (6000/12000) - 2017/05/07 23:29:46 ET
Table '1597684117 4' 9-max Seat #5 is the button
Seat 1: njhaar (179810 in chips)=20
Seat 2: LetsGoMets 6 (154840 in chips)=20
Seat 3: mmenz08816 (95094 in chips)=20
Seat 4: CRAIG k9 (80077 in chips)=20
Seat 5: gator856500 (83832 in chips)=20
Seat 6: RedHungryHip (74148 in chips)=20
Seat 8: JJin91 (69278 in chips)=20
Seat 9: panth26 (322921 in chips)=20
njhaar: posts the ante 1500
LetsGoMets 6: posts the ante 1500
mmenz08816: posts the ante 1500
CRAIG k9: posts the ante 1500
gator856500: posts the ante 1500
RedHungryHip: posts the ante 1500
JJin91: posts the ante 1500
panth26: posts the ante 1500
RedHungryHip: posts small blind 6000
JJin91: posts big blind 12000
*** HOLE CARDS ***
Dealt to JJin91 [Jd 5h]
panth26: folds=20
njhaar: raises 12000 to 24000
LetsGoMets 6: folds=20
mmenz08816: folds=20
CRAIG k9: calls 24000
gator856500: folds=20
RedHungryHip: folds=20
JJin91: folds=20
*** FLOP *** [9s Kd Ks]
njhaar: checks=20
CRAIG k9: checks=20
*** TURN *** [9s Kd Ks] [5s]
njhaar: bets 36000
CRAIG k9: folds=20
Uncalled bet (36000) returned to njhaar
njhaar collected 78000 from pot
njhaar: doesn't show hand=20
*** SUMMARY ***
Total pot 78000 | Rake 0=20
Board [9s Kd Ks 5s]
Seat 1: njhaar collected (78000)
Seat 2: LetsGoMets 6 folded before Flop (didn't bet)
Seat 3: mmenz08816 folded before Flop (didn't bet)
Seat 4: CRAIG k9 folded on the Turn
Seat 5: gator856500 (button) folded before Flop (didn't bet)
Seat 6: RedHungryHip (small blind) folded before Flop
Seat 8: JJin91 (big blind) folded before Flop
Seat 9: panth26 folded before Flop (didn't bet)


*********** # 205 **************
PokerStars Hand #169563587477: Tournament #1597684117, $4.55+$0.45 USD =
Hold'em No Limit - Level XXVIII (6000/12000) - 2017/05/07 23:30:16 ET
Table '1597684117 4' 9-max Seat #6 is the button
Seat 1: njhaar (232310 in chips)=20
Seat 2: LetsGoMets 6 (153340 in chips)=20
Seat 3: mmenz08816 (93594 in chips)=20
Seat 4: CRAIG k9 (54577 in chips)=20
Seat 5: gator856500 (82332 in chips)=20
Seat 6: RedHungryHip (66648 in chips)=20
Seat 8: JJin91 (55778 in chips)=20
Seat 9: panth26 (321421 in chips)=20
njhaar: posts the ante 1500
LetsGoMets 6: posts the ante 1500
mmenz08816: posts the ante 1500
CRAIG k9: posts the ante 1500
gator856500: posts the ante 1500
RedHungryHip: posts the ante 1500
JJin91: posts the ante 1500
panth26: posts the ante 1500
JJin91: posts small blind 6000
panth26: posts big blind 12000
*** HOLE CARDS ***
Dealt to JJin91 [Qs Ks]
njhaar: folds=20
LetsGoMets 6: folds=20
mmenz08816: raises 80094 to 92094 and is all-in
CRAIG k9: folds=20
gator856500: folds=20
RedHungryHip: folds=20
JJin91: calls 48278 and is all-in
panth26: folds=20
Uncalled bet (37816) returned to mmenz08816
*** FLOP *** [6h 5c Kd]
*** TURN *** [6h 5c Kd] [Kh]
*** RIVER *** [6h 5c Kd Kh] [Ah]
*** SHOW DOWN ***
JJin91: shows [Qs Ks] (three of a kind, Kings)
mmenz08816: shows [Jc Qh] (a pair of Kings)
JJin91 collected 132556 from pot
*** SUMMARY ***
Total pot 132556 | Rake 0=20
Board [6h 5c Kd Kh Ah]
Seat 1: njhaar folded before Flop (didn't bet)
Seat 2: LetsGoMets 6 folded before Flop (didn't bet)
Seat 3: mmenz08816 showed [Jc Qh] and lost with a pair of Kings
Seat 4: CRAIG k9 folded before Flop (didn't bet)
Seat 5: gator856500 folded before Flop (didn't bet)
Seat 6: RedHungryHip (button) folded before Flop (didn't bet)
Seat 8: JJin91 (small blind) showed [Qs Ks] and won (132556) with three=
 of a kind, Kings
Seat 9: panth26 (big blind) folded before Flop


*********** # 206 **************
PokerStars Hand #169563587641: Tournament #1597684117, $4.55+$0.45 USD =
Hold'em No Limit - Level XXVIII (6000/12000) - 2017/05/07 23:30:55 ET
Table '1597684117 4' 9-max Seat #8 is the button
Seat 1: njhaar (230810 in chips)=20
Seat 2: LetsGoMets 6 (151840 in chips)=20
Seat 3: mmenz08816 (37816 in chips)=20
Seat 4: CRAIG k9 (53077 in chips)=20
Seat 5: gator856500 (80832 in chips)=20
Seat 6: RedHungryHip (65148 in chips)=20
Seat 8: JJin91 (132556 in chips)=20
Seat 9: panth26 (307921 in chips)=20
njhaar: posts the ante 1500
LetsGoMets 6: posts the ante 1500
mmenz08816: posts the ante 1500
CRAIG k9: posts the ante 1500
gator856500: posts the ante 1500
RedHungryHip: posts the ante 1500
JJin91: posts the ante 1500
panth26: posts the ante 1500
panth26: posts small blind 6000
njhaar: posts big blind 12000
*** HOLE CARDS ***
Dealt to JJin91 [4h 2s]
LetsGoMets 6: folds=20
mmenz08816: raises 24316 to 36316 and is all-in
CRAIG k9: folds=20
gator856500: folds=20
RedHungryHip: folds=20
JJin91: folds=20
panth26: folds=20
njhaar: folds=20
Uncalled bet (24316) returned to mmenz08816
mmenz08816 collected 42000 from pot
mmenz08816: doesn't show hand=20
*** SUMMARY ***
Total pot 42000 | Rake 0=20
Seat 1: njhaar (big blind) folded before Flop
Seat 2: LetsGoMets 6 folded before Flop (didn't bet)
Seat 3: mmenz08816 collected (42000)
Seat 4: CRAIG k9 folded before Flop (didn't bet)
Seat 5: gator856500 folded before Flop (didn't bet)
Seat 6: RedHungryHip folded before Flop (didn't bet)
Seat 8: JJin91 (button) folded before Flop (didn't bet)
Seat 9: panth26 (small blind) folded before Flop


*********** # 207 **************
PokerStars Hand #169563587698: Tournament #1597684117, $4.55+$0.45 USD =
Hold'em No Limit - Level XXVIII (6000/12000) - 2017/05/07 23:31:09 ET
Table '1597684117 4' 9-max Seat #9 is the button
Seat 1: njhaar (217310 in chips)=20
Seat 2: LetsGoMets 6 (150340 in chips)=20
Seat 3: mmenz08816 (66316 in chips)=20
Seat 4: CRAIG k9 (51577 in chips)=20
Seat 5: gator856500 (79332 in chips)=20
Seat 6: RedHungryHip (63648 in chips)=20
Seat 8: JJin91 (131056 in chips)=20
Seat 9: panth26 (300421 in chips)=20
njhaar: posts the ante 1500
LetsGoMets 6: posts the ante 1500
mmenz08816: posts the ante 1500
CRAIG k9: posts the ante 1500
gator856500: posts the ante 1500
RedHungryHip: posts the ante 1500
JJin91: posts the ante 1500
panth26: posts the ante 1500
njhaar: posts small blind 6000
LetsGoMets 6: posts big blind 12000
*** HOLE CARDS ***
Dealt to JJin91 [9h 3d]
mmenz08816: folds=20
CRAIG k9: raises 38077 to 50077 and is all-in
gator856500: raises 27755 to 77832 and is all-in
RedHungryHip: folds=20
JJin91: folds=20
panth26: folds=20
njhaar: calls 71832
LetsGoMets 6: folds=20
*** FLOP *** [Jd 2c 4c]
*** TURN *** [Jd 2c 4c] [5s]
*** RIVER *** [Jd 2c 4c 5s] [2h]
*** SHOW DOWN ***
njhaar: shows [9d 9s] (two pair, Nines and Deuces)
gator856500: shows [Qh As] (a pair of Deuces)
njhaar collected 55510 from side pot
CRAIG k9: shows [8d 8h] (two pair, Eights and Deuces)
njhaar collected 174231 from main pot
gator856500 finished the tournament in 7th place and received $21.25.
CRAIG k9 finished the tournament in 8th place and received $17.50.
*** SUMMARY ***
Total pot 229741 Main pot 174231. Side pot 55510. | Rake 0=20
Board [Jd 2c 4c 5s 2h]
Seat 1: njhaar (small blind) showed [9d 9s] and won (229741) with two p=
air, Nines and Deuces
Seat 2: LetsGoMets 6 (big blind) folded before Flop
Seat 3: mmenz08816 folded before Flop (didn't bet)
Seat 4: CRAIG k9 showed [8d 8h] and lost with two pair, Eights and Deuc=
es
Seat 5: gator856500 showed [Qh As] and lost with a pair of Deuces
Seat 6: RedHungryHip folded before Flop (didn't bet)
Seat 8: JJin91 folded before Flop (didn't bet)
Seat 9: panth26 (button) folded before Flop (didn't bet)


*********** # 208 **************
PokerStars Hand #169563587828: Tournament #1597684117, $4.55+$0.45 USD =
Hold'em No Limit - Level XXVIII (6000/12000) - 2017/05/07 23:31:36 ET
Table '1597684117 4' 9-max Seat #1 is the button
Seat 1: njhaar (367719 in chips)=20
Seat 2: LetsGoMets 6 (136840 in chips)=20
Seat 3: mmenz08816 (64816 in chips)=20
Seat 6: RedHungryHip (62148 in chips)=20
Seat 8: JJin91 (129556 in chips)=20
Seat 9: panth26 (298921 in chips)=20
njhaar: posts the ante 1500
LetsGoMets 6: posts the ante 1500
mmenz08816: posts the ante 1500
RedHungryHip: posts the ante 1500
JJin91: posts the ante 1500
panth26: posts the ante 1500
LetsGoMets 6: posts small blind 6000
mmenz08816: posts big blind 12000
*** HOLE CARDS ***
Dealt to JJin91 [Kc Kd]
RedHungryHip: folds=20
JJin91: raises 12000 to 24000
panth26: folds=20
njhaar: folds=20
LetsGoMets 6: folds=20
mmenz08816: raises 39316 to 63316 and is all-in
JJin91: calls 39316
*** FLOP *** [9d 3c 8h]
*** TURN *** [9d 3c 8h] [Kh]
*** RIVER *** [9d 3c 8h Kh] [As]
*** SHOW DOWN ***
mmenz08816: shows [Ah 4h] (a pair of Aces)
JJin91: shows [Kc Kd] (three of a kind, Kings)
JJin91 collected 141632 from pot
mmenz08816 finished the tournament in 6th place and received $26.25.
*** SUMMARY ***
Total pot 141632 | Rake 0=20
Board [9d 3c 8h Kh As]
Seat 1: njhaar (button) folded before Flop (didn't bet)
Seat 2: LetsGoMets 6 (small blind) folded before Flop
Seat 3: mmenz08816 (big blind) showed [Ah 4h] and lost with a pair of A=
ces
Seat 6: RedHungryHip folded before Flop (didn't bet)
Seat 8: JJin91 showed [Kc Kd] and won (141632) with three of a kind, Ki=
ngs
Seat 9: panth26 folded before Flop (didn't bet)


*********** # 209 **************
PokerStars Hand #169563587972: Tournament #1597684117, $4.55+$0.45 USD =
Hold'em No Limit - Level XXIX (7000/14000) - 2017/05/07 23:32:06 ET
Table '1597684117 4' 9-max Seat #2 is the button
Seat 1: njhaar (366219 in chips)=20
Seat 2: LetsGoMets 6 (129340 in chips)=20
Seat 6: RedHungryHip (60648 in chips)=20
Seat 8: JJin91 (206372 in chips)=20
Seat 9: panth26 (297421 in chips)=20
njhaar: posts the ante 1750
LetsGoMets 6: posts the ante 1750
RedHungryHip: posts the ante 1750
JJin91: posts the ante 1750
panth26: posts the ante 1750
RedHungryHip: posts small blind 7000
JJin91: posts big blind 14000
*** HOLE CARDS ***
Dealt to JJin91 [7s 7c]
panth26: calls 14000
njhaar: calls 14000
LetsGoMets 6: folds=20
RedHungryHip: folds=20
JJin91: raises 28000 to 42000
panth26: raises 44800 to 86800
njhaar: folds=20
JJin91: calls 44800
*** FLOP *** [Ks 4h Ts]
JJin91: bets 117822 and is all-in
panth26: calls 117822
*** TURN *** [Ks 4h Ts] [Qs]
*** RIVER *** [Ks 4h Ts Qs] [9d]
*** SHOW DOWN ***
JJin91: shows [7s 7c] (a pair of Sevens)
panth26: shows [Ad Ac] (a pair of Aces)
panth26 collected 438994 from pot
JJin91 finished the tournament in 5th place and received $32.50.
*** SUMMARY ***
Total pot 438994 | Rake 0=20
Board [Ks 4h Ts Qs 9d]
Seat 1: njhaar folded before Flop
Seat 2: LetsGoMets 6 (button) folded before Flop (didn't bet)
Seat 6: RedHungryHip (small blind) folded before Flop
Seat 8: JJin91 (big blind) showed [7s 7c] and lost with a pair of Sevens
Seat 9: panth26 showed [Ad Ac] and won (438994) with a pair of Aces



If you have any questions, please contact us at "PokerStars Support" <s=
upport@pokerstarsnj.com>


