Transcript for tournament #1597683884 requested by JJin91 (jamiejin91@g=
mail.com)

*********** # 1 **************
PokerStars Hand #169310893522: Tournament #1597683884, $18.20+$1.80 USD=
 Hold'em No Limit - Level IX (150/300) - 2017/05/02 20:36:00 ET
Table '1597683884 1' 9-max Seat #1 is the button
Seat 1: j2157 (7561 in chips)=20
Seat 2: ruskie85 (28553 in chips)=20
Seat 3: rbonessss333 (6480 in chips) is sitting out
Seat 4: moosedeer17 (28782 in chips)=20
Seat 6: Whiteivey64 (18239 in chips)=20
Seat 7: iFoldN0T (16574 in chips)=20
Seat 8: JJin91 (10000 in chips)=20
Seat 9: DaleTDobak (9876 in chips)=20
j2157: posts the ante 40
ruskie85: posts the ante 40
rbonessss333: posts the ante 40
moosedeer17: posts the ante 40
Whiteivey64: posts the ante 40
iFoldN0T: posts the ante 40
JJin91: posts the ante 40
DaleTDobak: posts the ante 40
ruskie85: posts small blind 150
rbonessss333: posts big blind 300
*** HOLE CARDS ***
Dealt to JJin91 [4d 5c]
moosedeer17: folds=20
Whiteivey64: folds=20
iFoldN0T: folds=20
JJin91: folds=20
DaleTDobak: folds=20
j2157: raises 300 to 600
ruskie85: folds=20
rbonessss333: folds=20
Uncalled bet (300) returned to j2157
j2157 collected 1070 from pot
j2157: doesn't show hand=20
*** SUMMARY ***
Total pot 1070 | Rake 0=20
Seat 1: j2157 (button) collected (1070)
Seat 2: ruskie85 (small blind) folded before Flop
Seat 3: rbonessss333 (big blind) folded before Flop
Seat 4: moosedeer17 folded before Flop (didn't bet)
Seat 6: Whiteivey64 folded before Flop (didn't bet)
Seat 7: iFoldN0T folded before Flop (didn't bet)
Seat 8: JJin91 folded before Flop (didn't bet)
Seat 9: DaleTDobak folded before Flop (didn't bet)


*********** # 2 **************
PokerStars Hand #169310893677: Tournament #1597683884, $18.20+$1.80 USD=
 Hold'em No Limit - Level X (200/400) - 2017/05/02 20:36:34 ET
Table '1597683884 1' 9-max Seat #2 is the button
Seat 1: j2157 (8291 in chips)=20
Seat 2: ruskie85 (28363 in chips)=20
Seat 3: rbonessss333 (6140 in chips) is sitting out
Seat 4: moosedeer17 (28742 in chips)=20
Seat 6: Whiteivey64 (18199 in chips)=20
Seat 7: iFoldN0T (16534 in chips)=20
Seat 8: JJin91 (9960 in chips)=20
Seat 9: DaleTDobak (9836 in chips)=20
j2157: posts the ante 50
ruskie85: posts the ante 50
rbonessss333: posts the ante 50
moosedeer17: posts the ante 50
Whiteivey64: posts the ante 50
iFoldN0T: posts the ante 50
JJin91: posts the ante 50
DaleTDobak: posts the ante 50
rbonessss333: posts small blind 200
moosedeer17: posts big blind 400
*** HOLE CARDS ***
Dealt to JJin91 [3s 8h]
Whiteivey64: folds=20
iFoldN0T: folds=20
JJin91: folds=20
DaleTDobak: folds=20
j2157: folds=20
ruskie85: raises 400 to 800
rbonessss333: folds=20
moosedeer17: folds=20
Uncalled bet (400) returned to ruskie85
ruskie85 collected 1400 from pot
ruskie85: doesn't show hand=20
*** SUMMARY ***
Total pot 1400 | Rake 0=20
Seat 1: j2157 folded before Flop (didn't bet)
Seat 2: ruskie85 (button) collected (1400)
Seat 3: rbonessss333 (small blind) folded before Flop
Seat 4: moosedeer17 (big blind) folded before Flop
Seat 6: Whiteivey64 folded before Flop (didn't bet)
Seat 7: iFoldN0T folded before Flop (didn't bet)
Seat 8: JJin91 folded before Flop (didn't bet)
Seat 9: DaleTDobak folded before Flop (didn't bet)


*********** # 3 **************
PokerStars Hand #169310893779: Tournament #1597683884, $18.20+$1.80 USD=
 Hold'em No Limit - Level X (200/400) - 2017/05/02 20:36:57 ET
Table '1597683884 1' 9-max Seat #3 is the button
Seat 1: j2157 (8241 in chips)=20
Seat 2: ruskie85 (29313 in chips)=20
Seat 3: rbonessss333 (5890 in chips) is sitting out
Seat 4: moosedeer17 (28292 in chips)=20
Seat 6: Whiteivey64 (18149 in chips)=20
Seat 7: iFoldN0T (16484 in chips)=20
Seat 8: JJin91 (9910 in chips)=20
Seat 9: DaleTDobak (9786 in chips)=20
j2157: posts the ante 50
ruskie85: posts the ante 50
rbonessss333: posts the ante 50
moosedeer17: posts the ante 50
Whiteivey64: posts the ante 50
iFoldN0T: posts the ante 50
JJin91: posts the ante 50
DaleTDobak: posts the ante 50
moosedeer17: posts small blind 200
Whiteivey64: posts big blind 400
*** HOLE CARDS ***
Dealt to JJin91 [Jd 6h]
iFoldN0T: folds=20
JJin91: folds=20
DaleTDobak: folds=20
j2157: folds=20
ruskie85: folds=20
rbonessss333: folds=20
moosedeer17: raises 596 to 996
Whiteivey64: folds=20
Uncalled bet (596) returned to moosedeer17
moosedeer17 collected 1200 from pot
moosedeer17: doesn't show hand=20
*** SUMMARY ***
Total pot 1200 | Rake 0=20
Seat 1: j2157 folded before Flop (didn't bet)
Seat 2: ruskie85 folded before Flop (didn't bet)
Seat 3: rbonessss333 (button) folded before Flop (didn't bet)
Seat 4: moosedeer17 (small blind) collected (1200)
Seat 6: Whiteivey64 (big blind) folded before Flop
Seat 7: iFoldN0T folded before Flop (didn't bet)
Seat 8: JJin91 folded before Flop (didn't bet)
Seat 9: DaleTDobak folded before Flop (didn't bet)


*********** # 4 **************
PokerStars Hand #169310893932: Tournament #1597683884, $18.20+$1.80 USD=
 Hold'em No Limit - Level X (200/400) - 2017/05/02 20:37:33 ET
Table '1597683884 1' 9-max Seat #4 is the button
Seat 1: j2157 (8191 in chips)=20
Seat 2: ruskie85 (29263 in chips)=20
Seat 3: rbonessss333 (5840 in chips) is sitting out
Seat 4: moosedeer17 (29042 in chips)=20
Seat 6: Whiteivey64 (17699 in chips)=20
Seat 7: iFoldN0T (16434 in chips)=20
Seat 8: JJin91 (9860 in chips)=20
Seat 9: DaleTDobak (9736 in chips)=20
j2157: posts the ante 50
ruskie85: posts the ante 50
rbonessss333: posts the ante 50
moosedeer17: posts the ante 50
Whiteivey64: posts the ante 50
iFoldN0T: posts the ante 50
JJin91: posts the ante 50
DaleTDobak: posts the ante 50
Whiteivey64: posts small blind 200
iFoldN0T: posts big blind 400
*** HOLE CARDS ***
Dealt to JJin91 [5s Qs]
JJin91: folds=20
DaleTDobak: calls 400
j2157: calls 400
ruskie85: folds=20
rbonessss333: folds=20
moosedeer17: raises 800 to 1200
Whiteivey64: folds=20
iFoldN0T: calls 800
DaleTDobak: folds=20
j2157: calls 800
*** FLOP *** [4d Qh 9d]
iFoldN0T: checks=20
j2157: checks=20
moosedeer17: bets 2300
iFoldN0T: folds=20
j2157: raises 4641 to 6941 and is all-in
moosedeer17: calls 4641
*** TURN *** [4d Qh 9d] [Kc]
*** RIVER *** [4d Qh 9d Kc] [9h]
*** SHOW DOWN ***
j2157: shows [Jd Qc] (two pair, Queens and Nines)
moosedeer17: shows [Ah As] (two pair, Aces and Nines)
moosedeer17 collected 18482 from pot
j2157 finished the tournament in 79th place
*** SUMMARY ***
Total pot 18482 | Rake 0=20
Board [4d Qh 9d Kc 9h]
Seat 1: j2157 showed [Jd Qc] and lost with two pair, Queens and Nines
Seat 2: ruskie85 folded before Flop (didn't bet)
Seat 3: rbonessss333 folded before Flop (didn't bet)
Seat 4: moosedeer17 (button) showed [Ah As] and won (18482) with two pa=
ir, Aces and Nines
Seat 6: Whiteivey64 (small blind) folded before Flop
Seat 7: iFoldN0T (big blind) folded on the Flop
Seat 8: JJin91 folded before Flop (didn't bet)
Seat 9: DaleTDobak folded before Flop


*********** # 5 **************
PokerStars Hand #169310894222: Tournament #1597683884, $18.20+$1.80 USD=
 Hold'em No Limit - Level X (200/400) - 2017/05/02 20:38:37 ET
Table '1597683884 1' 9-max Seat #6 is the button
Seat 2: ruskie85 (29213 in chips)=20
Seat 3: rbonessss333 (5790 in chips) is sitting out
Seat 4: moosedeer17 (39333 in chips)=20
Seat 6: Whiteivey64 (17449 in chips)=20
Seat 7: iFoldN0T (15184 in chips)=20
Seat 8: JJin91 (9810 in chips)=20
Seat 9: DaleTDobak (9286 in chips)=20
ruskie85: posts the ante 50
rbonessss333: posts the ante 50
moosedeer17: posts the ante 50
Whiteivey64: posts the ante 50
iFoldN0T: posts the ante 50
JJin91: posts the ante 50
DaleTDobak: posts the ante 50
iFoldN0T: posts small blind 200
JJin91: posts big blind 400
*** HOLE CARDS ***
Dealt to JJin91 [9d Js]
DaleTDobak: raises 1200 to 1600
ruskie85: folds=20
rbonessss333: folds=20
moosedeer17: folds=20
Whiteivey64: folds=20
iFoldN0T: folds=20
JJin91: folds=20
Uncalled bet (1200) returned to DaleTDobak
DaleTDobak collected 1350 from pot
DaleTDobak: doesn't show hand=20
*** SUMMARY ***
Total pot 1350 | Rake 0=20
Seat 2: ruskie85 folded before Flop (didn't bet)
Seat 3: rbonessss333 folded before Flop (didn't bet)
Seat 4: moosedeer17 folded before Flop (didn't bet)
Seat 6: Whiteivey64 (button) folded before Flop (didn't bet)
Seat 7: iFoldN0T (small blind) folded before Flop
Seat 8: JJin91 (big blind) folded before Flop
Seat 9: DaleTDobak collected (1350)


*********** # 6 **************
PokerStars Hand #169310894369: Tournament #1597683884, $18.20+$1.80 USD=
 Hold'em No Limit - Level X (200/400) - 2017/05/02 20:39:11 ET
Table '1597683884 1' 9-max Seat #7 is the button
Seat 2: ruskie85 (29163 in chips)=20
Seat 3: rbonessss333 (5740 in chips) is sitting out
Seat 4: moosedeer17 (39283 in chips)=20
Seat 5: panth26 (9330 in chips)=20
Seat 6: Whiteivey64 (17399 in chips)=20
Seat 7: iFoldN0T (14934 in chips)=20
Seat 8: JJin91 (9360 in chips)=20
Seat 9: DaleTDobak (10186 in chips)=20
ruskie85: posts the ante 50
rbonessss333: posts the ante 50
moosedeer17: posts the ante 50
panth26: posts the ante 50
Whiteivey64: posts the ante 50
iFoldN0T: posts the ante 50
JJin91: posts the ante 50
DaleTDobak: posts the ante 50
JJin91: posts small blind 200
DaleTDobak: posts big blind 400
*** HOLE CARDS ***
Dealt to JJin91 [Ts 9h]
ruskie85: folds=20
rbonessss333: folds=20
moosedeer17: folds=20
panth26: folds=20
Whiteivey64: raises 400 to 800
iFoldN0T: folds=20
JJin91: folds=20
DaleTDobak: folds=20
Uncalled bet (400) returned to Whiteivey64
Whiteivey64 collected 1400 from pot
Whiteivey64: doesn't show hand=20
*** SUMMARY ***
Total pot 1400 | Rake 0=20
Seat 2: ruskie85 folded before Flop (didn't bet)
Seat 3: rbonessss333 folded before Flop (didn't bet)
Seat 4: moosedeer17 folded before Flop (didn't bet)
Seat 5: panth26 folded before Flop (didn't bet)
Seat 6: Whiteivey64 collected (1400)
Seat 7: iFoldN0T (button) folded before Flop (didn't bet)
Seat 8: JJin91 (small blind) folded before Flop
Seat 9: DaleTDobak (big blind) folded before Flop


*********** # 7 **************
PokerStars Hand #169310894610: Tournament #1597683884, $18.20+$1.80 USD=
 Hold'em No Limit - Level X (200/400) - 2017/05/02 20:39:59 ET
Table '1597683884 1' 9-max Seat #8 is the button
Seat 2: ruskie85 (29113 in chips)=20
Seat 3: rbonessss333 (5690 in chips) is sitting out
Seat 4: moosedeer17 (39233 in chips)=20
Seat 5: panth26 (9280 in chips)=20
Seat 6: Whiteivey64 (18349 in chips)=20
Seat 7: iFoldN0T (14884 in chips)=20
Seat 8: JJin91 (9110 in chips)=20
Seat 9: DaleTDobak (9736 in chips)=20
ruskie85: posts the ante 50
rbonessss333: posts the ante 50
moosedeer17: posts the ante 50
panth26: posts the ante 50
Whiteivey64: posts the ante 50
iFoldN0T: posts the ante 50
JJin91: posts the ante 50
DaleTDobak: posts the ante 50
DaleTDobak: posts small blind 200
ruskie85: posts big blind 400
*** HOLE CARDS ***
Dealt to JJin91 [Ts 7s]
rbonessss333: folds=20
moosedeer17: folds=20
panth26: folds=20
Whiteivey64: folds=20
iFoldN0T: folds=20
JJin91: raises 400 to 800
DaleTDobak: raises 400 to 1200
ruskie85: folds=20
JJin91: calls 400
*** FLOP *** [9s 7h 8s]
DaleTDobak: bets 800
JJin91: raises 1200 to 2000
DaleTDobak: calls 1200
*** TURN *** [9s 7h 8s] [Tc]
DaleTDobak: bets 6486 and is all-in
JJin91: calls 5860 and is all-in
Uncalled bet (626) returned to DaleTDobak
*** RIVER *** [9s 7h 8s Tc] [8h]
*** SHOW DOWN ***
DaleTDobak: shows [Qh Kh] (a pair of Eights)
JJin91: shows [Ts 7s] (two pair, Tens and Eights)
JJin91 collected 18920 from pot
*** SUMMARY ***
Total pot 18920 | Rake 0=20
Board [9s 7h 8s Tc 8h]
Seat 2: ruskie85 (big blind) folded before Flop
Seat 3: rbonessss333 folded before Flop (didn't bet)
Seat 4: moosedeer17 folded before Flop (didn't bet)
Seat 5: panth26 folded before Flop (didn't bet)
Seat 6: Whiteivey64 folded before Flop (didn't bet)
Seat 7: iFoldN0T folded before Flop (didn't bet)
Seat 8: JJin91 (button) showed [Ts 7s] and won (18920) with two pair, T=
ens and Eights
Seat 9: DaleTDobak (small blind) showed [Qh Kh] and lost with a pair of=
 Eights


*********** # 8 **************
PokerStars Hand #169310894837: Tournament #1597683884, $18.20+$1.80 USD=
 Hold'em No Limit - Level X (200/400) - 2017/05/02 20:40:52 ET
Table '1597683884 1' 9-max Seat #9 is the button
Seat 2: ruskie85 (28663 in chips)=20
Seat 3: rbonessss333 (5640 in chips) is sitting out
Seat 4: moosedeer17 (39183 in chips)=20
Seat 5: panth26 (9230 in chips)=20
Seat 6: Whiteivey64 (18299 in chips)=20
Seat 7: iFoldN0T (14834 in chips)=20
Seat 8: JJin91 (18920 in chips)=20
Seat 9: DaleTDobak (626 in chips)=20
ruskie85: posts the ante 50
rbonessss333: posts the ante 50
moosedeer17: posts the ante 50
panth26: posts the ante 50
Whiteivey64: posts the ante 50
iFoldN0T: posts the ante 50
JJin91: posts the ante 50
DaleTDobak: posts the ante 50
ruskie85: posts small blind 200
rbonessss333: posts big blind 400
*** HOLE CARDS ***
Dealt to JJin91 [9h Ts]
moosedeer17: folds=20
panth26: raises 560 to 960
Whiteivey64: folds=20
iFoldN0T: folds=20
JJin91: folds=20
DaleTDobak: calls 576 and is all-in
ruskie85: calls 760
rbonessss333: folds=20
*** FLOP *** [Td 2s 4c]
ruskie85: checks=20
panth26: checks=20
*** TURN *** [Td 2s 4c] [5c]
ruskie85: checks=20
panth26: checks=20
*** RIVER *** [Td 2s 4c 5c] [9c]
ruskie85: checks=20
panth26: checks=20
*** SHOW DOWN ***
ruskie85: shows [7d 8h] (high card Ten)
panth26: shows [Qd Kc] (high card King)
panth26 collected 768 from side pot
DaleTDobak: shows [4s 2h] (two pair, Fours and Deuces)
DaleTDobak collected 2528 from main pot
*** SUMMARY ***
Total pot 3296 Main pot 2528. Side pot 768. | Rake 0=20
Board [Td 2s 4c 5c 9c]
Seat 2: ruskie85 (small blind) showed [7d 8h] and lost with high card T=
en
Seat 3: rbonessss333 (big blind) folded before Flop
Seat 4: moosedeer17 folded before Flop (didn't bet)
Seat 5: panth26 showed [Qd Kc] and won (768) with high card King
Seat 6: Whiteivey64 folded before Flop (didn't bet)
Seat 7: iFoldN0T folded before Flop (didn't bet)
Seat 8: JJin91 folded before Flop (didn't bet)
Seat 9: DaleTDobak (button) showed [4s 2h] and won (2528) with two pair=
, Fours and Deuces


*********** # 9 **************
PokerStars Hand #169310895041: Tournament #1597683884, $18.20+$1.80 USD=
 Hold'em No Limit - Level X (200/400) - 2017/05/02 20:41:37 ET
Table '1597683884 1' 9-max Seat #2 is the button
Seat 2: ruskie85 (27653 in chips)=20
Seat 3: rbonessss333 (5190 in chips) is sitting out
Seat 4: moosedeer17 (39133 in chips)=20
Seat 5: panth26 (8988 in chips)=20
Seat 6: Whiteivey64 (18249 in chips)=20
Seat 7: iFoldN0T (14784 in chips)=20
Seat 8: JJin91 (18870 in chips)=20
Seat 9: DaleTDobak (2528 in chips)=20
ruskie85: posts the ante 50
rbonessss333: posts the ante 50
moosedeer17: posts the ante 50
panth26: posts the ante 50
Whiteivey64: posts the ante 50
iFoldN0T: posts the ante 50
JJin91: posts the ante 50
DaleTDobak: posts the ante 50
rbonessss333: posts small blind 200
moosedeer17: posts big blind 400
*** HOLE CARDS ***
Dealt to JJin91 [5c Qc]
panth26: raises 560 to 960
Whiteivey64: folds=20
iFoldN0T: folds=20
JJin91: folds=20
DaleTDobak: folds=20
ruskie85: folds=20
rbonessss333: folds=20
moosedeer17: calls 560
*** FLOP *** [6d Qd 7h]
moosedeer17: checks=20
panth26: bets 1890
moosedeer17: calls 1890
*** TURN *** [6d Qd 7h] [8c]
moosedeer17: checks=20
panth26: bets 6088 and is all-in
moosedeer17: calls 6088
*** RIVER *** [6d Qd 7h 8c] [5s]
*** SHOW DOWN ***
moosedeer17: shows [9s Qs] (a straight, Five to Nine)
panth26: shows [Jh Jc] (a pair of Jacks)
moosedeer17 collected 18476 from pot
panth26 finished the tournament in 76th place
*** SUMMARY ***
Total pot 18476 | Rake 0=20
Board [6d Qd 7h 8c 5s]
Seat 2: ruskie85 (button) folded before Flop (didn't bet)
Seat 3: rbonessss333 (small blind) folded before Flop
Seat 4: moosedeer17 (big blind) showed [9s Qs] and won (18476) with a s=
traight, Five to Nine
Seat 5: panth26 showed [Jh Jc] and lost with a pair of Jacks
Seat 6: Whiteivey64 folded before Flop (didn't bet)
Seat 7: iFoldN0T folded before Flop (didn't bet)
Seat 8: JJin91 folded before Flop (didn't bet)
Seat 9: DaleTDobak folded before Flop (didn't bet)


*********** # 10 **************
PokerStars Hand #169310895270: Tournament #1597683884, $18.20+$1.80 USD=
 Hold'em No Limit - Level X (200/400) - 2017/05/02 20:42:28 ET
Table '1597683884 1' 9-max Seat #3 is the button
Seat 2: ruskie85 (27603 in chips)=20
Seat 3: rbonessss333 (4940 in chips) is sitting out
Seat 4: moosedeer17 (48621 in chips)=20
Seat 6: Whiteivey64 (18199 in chips)=20
Seat 7: iFoldN0T (14734 in chips)=20
Seat 8: JJin91 (18820 in chips)=20
Seat 9: DaleTDobak (2478 in chips)=20
ruskie85: posts the ante 50
rbonessss333: posts the ante 50
moosedeer17: posts the ante 50
Whiteivey64: posts the ante 50
iFoldN0T: posts the ante 50
JJin91: posts the ante 50
DaleTDobak: posts the ante 50
moosedeer17: posts small blind 200
Whiteivey64: posts big blind 400
*** HOLE CARDS ***
Dealt to JJin91 [6d Kh]
iFoldN0T: folds=20
JJin91: folds=20
DaleTDobak: folds=20
ruskie85: calls 400
rbonessss333: folds=20
moosedeer17: calls 200
Whiteivey64: checks=20
*** FLOP *** [Ac Tc 2d]
moosedeer17: checks=20
Whiteivey64: checks=20
ruskie85: bets 400
moosedeer17: calls 400
Whiteivey64: folds=20
*** TURN *** [Ac Tc 2d] [9c]
moosedeer17: checks=20
ruskie85: checks=20
*** RIVER *** [Ac Tc 2d 9c] [7d]
moosedeer17: checks=20
ruskie85: bets 800
moosedeer17: calls 800
*** SHOW DOWN ***
ruskie85: shows [Ad 2h] (two pair, Aces and Deuces)
moosedeer17: mucks hand=20
ruskie85 collected 3950 from pot
*** SUMMARY ***
Total pot 3950 | Rake 0=20
Board [Ac Tc 2d 9c 7d]
Seat 2: ruskie85 showed [Ad 2h] and won (3950) with two pair, Aces and =
Deuces
Seat 3: rbonessss333 (button) folded before Flop (didn't bet)
Seat 4: moosedeer17 (small blind) mucked [8h Th]
Seat 6: Whiteivey64 (big blind) folded on the Flop
Seat 7: iFoldN0T folded before Flop (didn't bet)
Seat 8: JJin91 folded before Flop (didn't bet)
Seat 9: DaleTDobak folded before Flop (didn't bet)


*********** # 11 **************
PokerStars Hand #169310895585: Tournament #1597683884, $18.20+$1.80 USD=
 Hold'em No Limit - Level X (200/400) - 2017/05/02 20:43:35 ET
Table '1597683884 1' 9-max Seat #4 is the button
Seat 1: SAMCRO_1120 (16961 in chips)=20
Seat 2: ruskie85 (29903 in chips)=20
Seat 3: rbonessss333 (4890 in chips) is sitting out
Seat 4: moosedeer17 (46971 in chips)=20
Seat 6: Whiteivey64 (17749 in chips)=20
Seat 7: iFoldN0T (14684 in chips)=20
Seat 8: JJin91 (18770 in chips)=20
Seat 9: DaleTDobak (2428 in chips)=20
SAMCRO_1120: posts the ante 50
ruskie85: posts the ante 50
rbonessss333: posts the ante 50
moosedeer17: posts the ante 50
Whiteivey64: posts the ante 50
iFoldN0T: posts the ante 50
JJin91: posts the ante 50
DaleTDobak: posts the ante 50
Whiteivey64: posts small blind 200
iFoldN0T: posts big blind 400
*** HOLE CARDS ***
Dealt to JJin91 [Ac Js]
JJin91: raises 564 to 964
DaleTDobak: folds=20
SAMCRO_1120: folds=20
ruskie85: folds=20
rbonessss333: folds=20
moosedeer17: folds=20
Whiteivey64: calls 764
iFoldN0T: folds=20
*** FLOP *** [Ah 3s Ks]
Whiteivey64: checks=20
JJin91: bets 1446
Whiteivey64: folds=20
Uncalled bet (1446) returned to JJin91
JJin91 collected 2728 from pot
JJin91: doesn't show hand=20
*** SUMMARY ***
Total pot 2728 | Rake 0=20
Board [Ah 3s Ks]
Seat 1: SAMCRO_1120 folded before Flop (didn't bet)
Seat 2: ruskie85 folded before Flop (didn't bet)
Seat 3: rbonessss333 folded before Flop (didn't bet)
Seat 4: moosedeer17 (button) folded before Flop (didn't bet)
Seat 6: Whiteivey64 (small blind) folded on the Flop
Seat 7: iFoldN0T (big blind) folded before Flop
Seat 8: JJin91 collected (2728)
Seat 9: DaleTDobak folded before Flop (didn't bet)


*********** # 12 **************
PokerStars Hand #169310895713: Tournament #1597683884, $18.20+$1.80 USD=
 Hold'em No Limit - Level X (200/400) - 2017/05/02 20:44:04 ET
Table '1597683884 1' 9-max Seat #6 is the button
Seat 1: SAMCRO_1120 (16911 in chips)=20
Seat 2: ruskie85 (29853 in chips)=20
Seat 3: rbonessss333 (4840 in chips) is sitting out
Seat 4: moosedeer17 (46921 in chips)=20
Seat 6: Whiteivey64 (16735 in chips)=20
Seat 7: iFoldN0T (14234 in chips)=20
Seat 8: JJin91 (20484 in chips)=20
Seat 9: DaleTDobak (2378 in chips)=20
SAMCRO_1120: posts the ante 50
ruskie85: posts the ante 50
rbonessss333: posts the ante 50
moosedeer17: posts the ante 50
Whiteivey64: posts the ante 50
iFoldN0T: posts the ante 50
JJin91: posts the ante 50
DaleTDobak: posts the ante 50
iFoldN0T: posts small blind 200
JJin91: posts big blind 400
*** HOLE CARDS ***
Dealt to JJin91 [5h 9d]
DaleTDobak: raises 1928 to 2328 and is all-in
SAMCRO_1120: folds=20
ruskie85: folds=20
rbonessss333: folds=20
moosedeer17: folds=20
Whiteivey64: folds=20
iFoldN0T: folds=20
JJin91: folds=20
Uncalled bet (1928) returned to DaleTDobak
DaleTDobak collected 1400 from pot
DaleTDobak: doesn't show hand=20
*** SUMMARY ***
Total pot 1400 | Rake 0=20
Seat 1: SAMCRO_1120 folded before Flop (didn't bet)
Seat 2: ruskie85 folded before Flop (didn't bet)
Seat 3: rbonessss333 folded before Flop (didn't bet)
Seat 4: moosedeer17 folded before Flop (didn't bet)
Seat 6: Whiteivey64 (button) folded before Flop (didn't bet)
Seat 7: iFoldN0T (small blind) folded before Flop
Seat 8: JJin91 (big blind) folded before Flop
Seat 9: DaleTDobak collected (1400)


*********** # 13 **************
PokerStars Hand #169310895839: Tournament #1597683884, $18.20+$1.80 USD=
 Hold'em No Limit - Level X (200/400) - 2017/05/02 20:44:32 ET
Table '1597683884 1' 9-max Seat #7 is the button
Seat 1: SAMCRO_1120 (16861 in chips)=20
Seat 2: ruskie85 (29803 in chips)=20
Seat 3: rbonessss333 (4790 in chips) is sitting out
Seat 4: moosedeer17 (46871 in chips)=20
Seat 6: Whiteivey64 (16685 in chips)=20
Seat 7: iFoldN0T (13984 in chips)=20
Seat 8: JJin91 (20034 in chips)=20
Seat 9: DaleTDobak (3328 in chips)=20
SAMCRO_1120: posts the ante 50
ruskie85: posts the ante 50
rbonessss333: posts the ante 50
moosedeer17: posts the ante 50
Whiteivey64: posts the ante 50
iFoldN0T: posts the ante 50
JJin91: posts the ante 50
DaleTDobak: posts the ante 50
JJin91: posts small blind 200
DaleTDobak: posts big blind 400
*** HOLE CARDS ***
Dealt to JJin91 [Th 2s]
SAMCRO_1120: raises 411 to 811
ruskie85: folds=20
rbonessss333: folds=20
moosedeer17: calls 811
Whiteivey64: folds=20
iFoldN0T: folds=20
JJin91: folds=20
DaleTDobak: calls 411
*** FLOP *** [8c 2h 6s]
DaleTDobak: checks=20
SAMCRO_1120: checks=20
moosedeer17: checks=20
*** TURN *** [8c 2h 6s] [9s]
DaleTDobak: checks=20
SAMCRO_1120: bets 1517
moosedeer17: folds=20
DaleTDobak: folds=20
Uncalled bet (1517) returned to SAMCRO_1120
SAMCRO_1120 collected 3033 from pot
*** SUMMARY ***
Total pot 3033 | Rake 0=20
Board [8c 2h 6s 9s]
Seat 1: SAMCRO_1120 collected (3033)
Seat 2: ruskie85 folded before Flop (didn't bet)
Seat 3: rbonessss333 folded before Flop (didn't bet)
Seat 4: moosedeer17 folded on the Turn
Seat 6: Whiteivey64 folded before Flop (didn't bet)
Seat 7: iFoldN0T (button) folded before Flop (didn't bet)
Seat 8: JJin91 (small blind) folded before Flop
Seat 9: DaleTDobak (big blind) folded on the Turn


*********** # 14 **************
PokerStars Hand #169310896172: Tournament #1597683884, $18.20+$1.80 USD=
 Hold'em No Limit - Level X (200/400) - 2017/05/02 20:45:43 ET
Table '1597683884 1' 9-max Seat #8 is the button
Seat 1: SAMCRO_1120 (19033 in chips)=20
Seat 2: ruskie85 (29753 in chips)=20
Seat 3: rbonessss333 (4740 in chips) is sitting out
Seat 4: moosedeer17 (46010 in chips)=20
Seat 6: Whiteivey64 (16635 in chips)=20
Seat 7: iFoldN0T (13934 in chips)=20
Seat 8: JJin91 (19784 in chips)=20
Seat 9: DaleTDobak (2467 in chips)=20
SAMCRO_1120: posts the ante 50
ruskie85: posts the ante 50
rbonessss333: posts the ante 50
moosedeer17: posts the ante 50
Whiteivey64: posts the ante 50
iFoldN0T: posts the ante 50
JJin91: posts the ante 50
DaleTDobak: posts the ante 50
DaleTDobak: posts small blind 200
SAMCRO_1120: posts big blind 400
*** HOLE CARDS ***
Dealt to JJin91 [Jc 9c]
ruskie85: calls 400
rbonessss333: folds=20
moosedeer17: folds=20
Whiteivey64: folds=20
iFoldN0T: folds=20
JJin91: calls 400
DaleTDobak: folds=20
SAMCRO_1120: checks=20
*** FLOP *** [4c 6d 9h]
SAMCRO_1120: checks=20
ruskie85: checks=20
JJin91: bets 954
SAMCRO_1120: folds=20
ruskie85: calls 954
*** TURN *** [4c 6d 9h] [2s]
ruskie85: checks=20
JJin91: bets 2965
ruskie85: folds=20
Uncalled bet (2965) returned to JJin91
JJin91 collected 3708 from pot
JJin91: doesn't show hand=20
*** SUMMARY ***
Total pot 3708 | Rake 0=20
Board [4c 6d 9h 2s]
Seat 1: SAMCRO_1120 (big blind) folded on the Flop
Seat 2: ruskie85 folded on the Turn
Seat 3: rbonessss333 folded before Flop (didn't bet)
Seat 4: moosedeer17 folded before Flop (didn't bet)
Seat 6: Whiteivey64 folded before Flop (didn't bet)
Seat 7: iFoldN0T folded before Flop (didn't bet)
Seat 8: JJin91 (button) collected (3708)
Seat 9: DaleTDobak (small blind) folded before Flop


*********** # 15 **************
PokerStars Hand #169310896493: Tournament #1597683884, $18.20+$1.80 USD=
 Hold'em No Limit - Level XI (250/500) - 2017/05/02 20:46:49 ET
Table '1597683884 1' 9-max Seat #9 is the button
Seat 1: SAMCRO_1120 (18583 in chips)=20
Seat 2: ruskie85 (28349 in chips)=20
Seat 3: rbonessss333 (4690 in chips) is sitting out
Seat 4: moosedeer17 (45960 in chips)=20
Seat 6: Whiteivey64 (16585 in chips)=20
Seat 7: iFoldN0T (13884 in chips)=20
Seat 8: JJin91 (22088 in chips)=20
Seat 9: DaleTDobak (2217 in chips)=20
SAMCRO_1120: posts the ante 60
ruskie85: posts the ante 60
rbonessss333: posts the ante 60
moosedeer17: posts the ante 60
Whiteivey64: posts the ante 60
iFoldN0T: posts the ante 60
JJin91: posts the ante 60
DaleTDobak: posts the ante 60
SAMCRO_1120: posts small blind 250
ruskie85: posts big blind 500
*** HOLE CARDS ***
Dealt to JJin91 [Kh 9s]
rbonessss333: folds=20
moosedeer17: folds=20
Whiteivey64: folds=20
iFoldN0T: folds=20
JJin91: folds=20
DaleTDobak: folds=20
SAMCRO_1120: folds=20
Uncalled bet (250) returned to ruskie85
ruskie85 collected 980 from pot
ruskie85: doesn't show hand=20
*** SUMMARY ***
Total pot 980 | Rake 0=20
Seat 1: SAMCRO_1120 (small blind) folded before Flop
Seat 2: ruskie85 (big blind) collected (980)
Seat 3: rbonessss333 folded before Flop (didn't bet)
Seat 4: moosedeer17 folded before Flop (didn't bet)
Seat 6: Whiteivey64 folded before Flop (didn't bet)
Seat 7: iFoldN0T folded before Flop (didn't bet)
Seat 8: JJin91 folded before Flop (didn't bet)
Seat 9: DaleTDobak (button) folded before Flop (didn't bet)


*********** # 16 **************
PokerStars Hand #169310896560: Tournament #1597683884, $18.20+$1.80 USD=
 Hold'em No Limit - Level XI (250/500) - 2017/05/02 20:47:03 ET
Table '1597683884 1' 9-max Seat #1 is the button
Seat 1: SAMCRO_1120 (18273 in chips)=20
Seat 2: ruskie85 (29019 in chips)=20
Seat 3: rbonessss333 (4630 in chips) is sitting out
Seat 4: moosedeer17 (45900 in chips)=20
Seat 6: Whiteivey64 (16525 in chips)=20
Seat 7: iFoldN0T (13824 in chips)=20
Seat 8: JJin91 (22028 in chips)=20
Seat 9: DaleTDobak (2157 in chips)=20
SAMCRO_1120: posts the ante 60
ruskie85: posts the ante 60
rbonessss333: posts the ante 60
moosedeer17: posts the ante 60
Whiteivey64: posts the ante 60
iFoldN0T: posts the ante 60
JJin91: posts the ante 60
DaleTDobak: posts the ante 60
ruskie85: posts small blind 250
rbonessss333: posts big blind 500
*** HOLE CARDS ***
Dealt to JJin91 [5h Ks]
moosedeer17: folds=20
Whiteivey64: folds=20
iFoldN0T: folds=20
JJin91: folds=20
DaleTDobak: folds=20
SAMCRO_1120: raises 1000 to 1500
ruskie85: calls 1250
rbonessss333: folds=20
*** FLOP *** [7d 8s 4c]
ruskie85: checks=20
SAMCRO_1120: bets 4000
ruskie85: folds=20
Uncalled bet (4000) returned to SAMCRO_1120
SAMCRO_1120 collected 3980 from pot
*** SUMMARY ***
Total pot 3980 | Rake 0=20
Board [7d 8s 4c]
Seat 1: SAMCRO_1120 (button) collected (3980)
Seat 2: ruskie85 (small blind) folded on the Flop
Seat 3: rbonessss333 (big blind) folded before Flop
Seat 4: moosedeer17 folded before Flop (didn't bet)
Seat 6: Whiteivey64 folded before Flop (didn't bet)
Seat 7: iFoldN0T folded before Flop (didn't bet)
Seat 8: JJin91 folded before Flop (didn't bet)
Seat 9: DaleTDobak folded before Flop (didn't bet)


*********** # 17 **************
PokerStars Hand #169310896741: Tournament #1597683884, $18.20+$1.80 USD=
 Hold'em No Limit - Level XI (250/500) - 2017/05/02 20:47:39 ET
Table '1597683884 1' 9-max Seat #2 is the button
Seat 1: SAMCRO_1120 (20693 in chips)=20
Seat 2: ruskie85 (27459 in chips)=20
Seat 3: rbonessss333 (4070 in chips) is sitting out
Seat 4: moosedeer17 (45840 in chips)=20
Seat 5: akbongu1977 (10000 in chips)=20
Seat 6: Whiteivey64 (16465 in chips)=20
Seat 7: iFoldN0T (13764 in chips)=20
Seat 8: JJin91 (21968 in chips)=20
Seat 9: DaleTDobak (2097 in chips)=20
SAMCRO_1120: posts the ante 60
ruskie85: posts the ante 60
rbonessss333: posts the ante 60
moosedeer17: posts the ante 60
akbongu1977: posts the ante 60
Whiteivey64: posts the ante 60
iFoldN0T: posts the ante 60
JJin91: posts the ante 60
DaleTDobak: posts the ante 60
rbonessss333: posts small blind 250
moosedeer17: posts big blind 500
*** HOLE CARDS ***
Dealt to JJin91 [7h Jc]
akbongu1977: folds=20
Whiteivey64: folds=20
iFoldN0T: folds=20
JJin91: folds=20
DaleTDobak: folds=20
SAMCRO_1120: folds=20
ruskie85: folds=20
rbonessss333: folds=20
Uncalled bet (250) returned to moosedeer17
moosedeer17 collected 1040 from pot
moosedeer17: doesn't show hand=20
*** SUMMARY ***
Total pot 1040 | Rake 0=20
Seat 1: SAMCRO_1120 folded before Flop (didn't bet)
Seat 2: ruskie85 (button) folded before Flop (didn't bet)
Seat 3: rbonessss333 (small blind) folded before Flop
Seat 4: moosedeer17 (big blind) collected (1040)
Seat 5: akbongu1977 folded before Flop (didn't bet)
Seat 6: Whiteivey64 folded before Flop (didn't bet)
Seat 7: iFoldN0T folded before Flop (didn't bet)
Seat 8: JJin91 folded before Flop (didn't bet)
Seat 9: DaleTDobak folded before Flop (didn't bet)


*********** # 18 **************
PokerStars Hand #169310896809: Tournament #1597683884, $18.20+$1.80 USD=
 Hold'em No Limit - Level XI (250/500) - 2017/05/02 20:47:55 ET
Table '1597683884 1' 9-max Seat #3 is the button
Seat 1: SAMCRO_1120 (20633 in chips)=20
Seat 2: ruskie85 (27399 in chips)=20
Seat 3: rbonessss333 (3760 in chips) is sitting out
Seat 4: moosedeer17 (46570 in chips)=20
Seat 5: akbongu1977 (9940 in chips)=20
Seat 6: Whiteivey64 (16405 in chips)=20
Seat 7: iFoldN0T (13704 in chips)=20
Seat 8: JJin91 (21908 in chips)=20
Seat 9: DaleTDobak (2037 in chips)=20
SAMCRO_1120: posts the ante 60
ruskie85: posts the ante 60
rbonessss333: posts the ante 60
moosedeer17: posts the ante 60
akbongu1977: posts the ante 60
Whiteivey64: posts the ante 60
iFoldN0T: posts the ante 60
JJin91: posts the ante 60
DaleTDobak: posts the ante 60
moosedeer17: posts small blind 250
akbongu1977: posts big blind 500
*** HOLE CARDS ***
Dealt to JJin91 [8c Js]
Whiteivey64: folds=20
iFoldN0T: folds=20
JJin91: folds=20
DaleTDobak: folds=20
SAMCRO_1120: folds=20
ruskie85: calls 500
rbonessss333: folds=20
moosedeer17: folds=20
akbongu1977: checks=20
*** FLOP *** [9d 4h Kh]
akbongu1977: checks=20
ruskie85: checks=20
*** TURN *** [9d 4h Kh] [Ts]
akbongu1977: bets 500
ruskie85: folds=20
Uncalled bet (500) returned to akbongu1977
akbongu1977 collected 1790 from pot
akbongu1977: doesn't show hand=20
*** SUMMARY ***
Total pot 1790 | Rake 0=20
Board [9d 4h Kh Ts]
Seat 1: SAMCRO_1120 folded before Flop (didn't bet)
Seat 2: ruskie85 folded on the Turn
Seat 3: rbonessss333 (button) folded before Flop (didn't bet)
Seat 4: moosedeer17 (small blind) folded before Flop
Seat 5: akbongu1977 (big blind) collected (1790)
Seat 6: Whiteivey64 folded before Flop (didn't bet)
Seat 7: iFoldN0T folded before Flop (didn't bet)
Seat 8: JJin91 folded before Flop (didn't bet)
Seat 9: DaleTDobak folded before Flop (didn't bet)


*********** # 19 **************
PokerStars Hand #169310897260: Tournament #1597683884, $18.20+$1.80 USD=
 Hold'em No Limit - Level XI (250/500) - 2017/05/02 20:49:26 ET
Table '1597683884 1' 9-max Seat #4 is the button
Seat 1: SAMCRO_1120 (20573 in chips)=20
Seat 2: ruskie85 (26839 in chips)=20
Seat 3: rbonessss333 (3700 in chips) is sitting out
Seat 4: moosedeer17 (46260 in chips)=20
Seat 5: akbongu1977 (11170 in chips)=20
Seat 6: Whiteivey64 (16345 in chips)=20
Seat 7: iFoldN0T (13644 in chips)=20
Seat 8: JJin91 (21848 in chips)=20
Seat 9: DaleTDobak (1977 in chips)=20
SAMCRO_1120: posts the ante 60
ruskie85: posts the ante 60
rbonessss333: posts the ante 60
moosedeer17: posts the ante 60
akbongu1977: posts the ante 60
Whiteivey64: posts the ante 60
iFoldN0T: posts the ante 60
JJin91: posts the ante 60
DaleTDobak: posts the ante 60
akbongu1977: posts small blind 250
Whiteivey64: posts big blind 500
*** HOLE CARDS ***
Dealt to JJin91 [6c 3h]
iFoldN0T: raises 500 to 1000
JJin91: folds=20
DaleTDobak: folds=20
SAMCRO_1120: folds=20
ruskie85: folds=20
rbonessss333: folds=20
moosedeer17: folds=20
akbongu1977 has timed out
akbongu1977: folds=20
akbongu1977 is sitting out
Whiteivey64: folds=20
Uncalled bet (500) returned to iFoldN0T
iFoldN0T collected 1790 from pot
iFoldN0T: doesn't show hand=20
*** SUMMARY ***
Total pot 1790 | Rake 0=20
Seat 1: SAMCRO_1120 folded before Flop (didn't bet)
Seat 2: ruskie85 folded before Flop (didn't bet)
Seat 3: rbonessss333 folded before Flop (didn't bet)
Seat 4: moosedeer17 (button) folded before Flop (didn't bet)
Seat 5: akbongu1977 (small blind) folded before Flop
Seat 6: Whiteivey64 (big blind) folded before Flop
Seat 7: iFoldN0T collected (1790)
Seat 8: JJin91 folded before Flop (didn't bet)
Seat 9: DaleTDobak folded before Flop (didn't bet)


*********** # 20 **************
PokerStars Hand #169310897505: Tournament #1597683884, $18.20+$1.80 USD=
 Hold'em No Limit - Level XI (250/500) - 2017/05/02 20:50:15 ET
Table '1597683884 1' 9-max Seat #5 is the button
Seat 1: SAMCRO_1120 (20513 in chips)=20
Seat 2: ruskie85 (26779 in chips)=20
Seat 3: rbonessss333 (3640 in chips) is sitting out
Seat 4: moosedeer17 (46200 in chips)=20
Seat 5: akbongu1977 (10860 in chips) is sitting out
Seat 6: Whiteivey64 (15785 in chips)=20
Seat 7: iFoldN0T (14874 in chips)=20
Seat 8: JJin91 (21788 in chips)=20
Seat 9: DaleTDobak (1917 in chips)=20
SAMCRO_1120: posts the ante 60
ruskie85: posts the ante 60
rbonessss333: posts the ante 60
moosedeer17: posts the ante 60
akbongu1977: posts the ante 60
Whiteivey64: posts the ante 60
iFoldN0T: posts the ante 60
JJin91: posts the ante 60
DaleTDobak: posts the ante 60
Whiteivey64: posts small blind 250
iFoldN0T: posts big blind 500
*** HOLE CARDS ***
Dealt to JJin91 [6h Th]
akbongu1977 has returned
JJin91: folds=20
DaleTDobak: folds=20
SAMCRO_1120: folds=20
ruskie85: folds=20
rbonessss333: folds=20
moosedeer17: raises 500 to 1000
akbongu1977: raises 9800 to 10800 and is all-in
Whiteivey64 has timed out
Whiteivey64: folds=20
Whiteivey64 is sitting out
Whiteivey64 has returned
iFoldN0T: folds=20
moosedeer17: folds=20
Uncalled bet (9800) returned to akbongu1977
akbongu1977 collected 3290 from pot
akbongu1977: doesn't show hand=20
*** SUMMARY ***
Total pot 3290 | Rake 0=20
Seat 1: SAMCRO_1120 folded before Flop (didn't bet)
Seat 2: ruskie85 folded before Flop (didn't bet)
Seat 3: rbonessss333 folded before Flop (didn't bet)
Seat 4: moosedeer17 folded before Flop
Seat 5: akbongu1977 (button) collected (3290)
Seat 6: Whiteivey64 (small blind) folded before Flop
Seat 7: iFoldN0T (big blind) folded before Flop
Seat 8: JJin91 folded before Flop (didn't bet)
Seat 9: DaleTDobak folded before Flop (didn't bet)


*********** # 21 **************
PokerStars Hand #169310897781: Tournament #1597683884, $18.20+$1.80 USD=
 Hold'em No Limit - Level XI (250/500) - 2017/05/02 20:51:13 ET
Table '1597683884 1' 9-max Seat #6 is the button
Seat 1: SAMCRO_1120 (20453 in chips)=20
Seat 2: ruskie85 (26719 in chips)=20
Seat 3: rbonessss333 (3580 in chips) is sitting out
Seat 4: moosedeer17 (45140 in chips)=20
Seat 5: akbongu1977 (13090 in chips)=20
Seat 6: Whiteivey64 (15475 in chips)=20
Seat 7: iFoldN0T (14314 in chips)=20
Seat 8: JJin91 (21728 in chips)=20
Seat 9: DaleTDobak (1857 in chips)=20
SAMCRO_1120: posts the ante 60
ruskie85: posts the ante 60
rbonessss333: posts the ante 60
moosedeer17: posts the ante 60
akbongu1977: posts the ante 60
Whiteivey64: posts the ante 60
iFoldN0T: posts the ante 60
JJin91: posts the ante 60
DaleTDobak: posts the ante 60
iFoldN0T: posts small blind 250
JJin91: posts big blind 500
*** HOLE CARDS ***
Dealt to JJin91 [3d Js]
DaleTDobak: raises 1297 to 1797 and is all-in
SAMCRO_1120: folds=20
ruskie85: calls 1797
rbonessss333: folds=20
moosedeer17: folds=20
akbongu1977: folds=20
Whiteivey64: folds=20
iFoldN0T: folds=20
JJin91: folds=20
*** FLOP *** [2d 3c Tc]
*** TURN *** [2d 3c Tc] [3s]
*** RIVER *** [2d 3c Tc 3s] [9c]
*** SHOW DOWN ***
DaleTDobak: shows [Ts Ks] (two pair, Tens and Threes)
ruskie85: shows [7h Ah] (a pair of Threes)
DaleTDobak collected 4884 from pot
*** SUMMARY ***
Total pot 4884 | Rake 0=20
Board [2d 3c Tc 3s 9c]
Seat 1: SAMCRO_1120 folded before Flop (didn't bet)
Seat 2: ruskie85 showed [7h Ah] and lost with a pair of Threes
Seat 3: rbonessss333 folded before Flop (didn't bet)
Seat 4: moosedeer17 folded before Flop (didn't bet)
Seat 5: akbongu1977 folded before Flop (didn't bet)
Seat 6: Whiteivey64 (button) folded before Flop (didn't bet)
Seat 7: iFoldN0T (small blind) folded before Flop
Seat 8: JJin91 (big blind) folded before Flop
Seat 9: DaleTDobak showed [Ts Ks] and won (4884) with two pair, Tens an=
d Threes


*********** # 22 **************
PokerStars Hand #169310897899: Tournament #1597683884, $18.20+$1.80 USD=
 Hold'em No Limit - Level XI (250/500) - 2017/05/02 20:51:37 ET
Table '1597683884 1' 9-max Seat #7 is the button
Seat 1: SAMCRO_1120 (20393 in chips)=20
Seat 2: ruskie85 (24862 in chips)=20
Seat 3: rbonessss333 (3520 in chips) is sitting out
Seat 4: moosedeer17 (45080 in chips)=20
Seat 5: akbongu1977 (13030 in chips)=20
Seat 6: Whiteivey64 (15415 in chips)=20
Seat 7: iFoldN0T (14004 in chips)=20
Seat 8: JJin91 (21168 in chips)=20
Seat 9: DaleTDobak (4884 in chips)=20
SAMCRO_1120: posts the ante 60
ruskie85: posts the ante 60
rbonessss333: posts the ante 60
moosedeer17: posts the ante 60
akbongu1977: posts the ante 60
Whiteivey64: posts the ante 60
iFoldN0T: posts the ante 60
JJin91: posts the ante 60
DaleTDobak: posts the ante 60
JJin91: posts small blind 250
DaleTDobak: posts big blind 500
*** HOLE CARDS ***
Dealt to JJin91 [2c Qs]
SAMCRO_1120: folds=20
ruskie85: folds=20
rbonessss333: folds=20
moosedeer17: folds=20
akbongu1977 has timed out
akbongu1977: folds=20
akbongu1977 is sitting out
Whiteivey64: raises 725 to 1225
akbongu1977 has returned
iFoldN0T: raises 12719 to 13944 and is all-in
JJin91: folds=20
DaleTDobak: calls 4324 and is all-in
Whiteivey64: calls 12719
*** FLOP *** [Th 5h Kh]
*** TURN *** [Th 5h Kh] [3s]
*** RIVER *** [Th 5h Kh 3s] [5d]
*** SHOW DOWN ***
Whiteivey64: shows [9s 9h] (two pair, Nines and Fives)
iFoldN0T: shows [6h 6s] (two pair, Sixes and Fives)
Whiteivey64 collected 18240 from side pot
DaleTDobak: shows [Td Ad] (two pair, Tens and Fives)
DaleTDobak collected 15262 from main pot
iFoldN0T finished the tournament in 67th place
*** SUMMARY ***
Total pot 33502 Main pot 15262. Side pot 18240. | Rake 0=20
Board [Th 5h Kh 3s 5d]
Seat 1: SAMCRO_1120 folded before Flop (didn't bet)
Seat 2: ruskie85 folded before Flop (didn't bet)
Seat 3: rbonessss333 folded before Flop (didn't bet)
Seat 4: moosedeer17 folded before Flop (didn't bet)
Seat 5: akbongu1977 folded before Flop (didn't bet)
Seat 6: Whiteivey64 showed [9s 9h] and won (18240) with two pair, Nines=
 and Fives
Seat 7: iFoldN0T (button) showed [6h 6s] and lost with two pair, Sixes =
and Fives
Seat 8: JJin91 (small blind) folded before Flop
Seat 9: DaleTDobak (big blind) showed [Td Ad] and won (15262) with two =
pair, Tens and Fives


*********** # 23 **************
PokerStars Hand #169310898170: Tournament #1597683884, $18.20+$1.80 USD=
 Hold'em No Limit - Level XI (250/500) - 2017/05/02 20:52:36 ET
Table '1597683884 1' 9-max Seat #8 is the button
Seat 1: SAMCRO_1120 (20333 in chips)=20
Seat 2: ruskie85 (24802 in chips)=20
Seat 3: rbonessss333 (3460 in chips) is sitting out
Seat 4: moosedeer17 (45020 in chips)=20
Seat 5: akbongu1977 (12970 in chips)=20
Seat 6: Whiteivey64 (19651 in chips)=20
Seat 8: JJin91 (20858 in chips)=20
Seat 9: DaleTDobak (15262 in chips)=20
SAMCRO_1120: posts the ante 60
ruskie85: posts the ante 60
rbonessss333: posts the ante 60
moosedeer17: posts the ante 60
akbongu1977: posts the ante 60
Whiteivey64: posts the ante 60
JJin91: posts the ante 60
DaleTDobak: posts the ante 60
DaleTDobak: posts small blind 250
SAMCRO_1120: posts big blind 500
*** HOLE CARDS ***
Dealt to JJin91 [8d Ts]
ruskie85: raises 1000 to 1500
rbonessss333: folds=20
moosedeer17: folds=20
akbongu1977: folds=20
Whiteivey64: folds=20
JJin91: folds=20
DaleTDobak: folds=20
SAMCRO_1120: folds [4s]
Uncalled bet (1000) returned to ruskie85
ruskie85 collected 1730 from pot
ruskie85: doesn't show hand=20
*** SUMMARY ***
Total pot 1730 | Rake 0=20
Seat 1: SAMCRO_1120 (big blind) folded before Flop
Seat 2: ruskie85 collected (1730)
Seat 3: rbonessss333 folded before Flop (didn't bet)
Seat 4: moosedeer17 folded before Flop (didn't bet)
Seat 5: akbongu1977 folded before Flop (didn't bet)
Seat 6: Whiteivey64 folded before Flop (didn't bet)
Seat 8: JJin91 (button) folded before Flop (didn't bet)
Seat 9: DaleTDobak (small blind) folded before Flop


*********** # 24 **************
PokerStars Hand #169310898309: Tournament #1597683884, $18.20+$1.80 USD=
 Hold'em No Limit - Level XI (250/500) - 2017/05/02 20:53:04 ET
Table '1597683884 1' 9-max Seat #9 is the button
Seat 1: SAMCRO_1120 (19773 in chips)=20
Seat 2: ruskie85 (25972 in chips)=20
Seat 3: rbonessss333 (3400 in chips) is sitting out
Seat 4: moosedeer17 (44960 in chips)=20
Seat 5: akbongu1977 (12910 in chips)=20
Seat 6: Whiteivey64 (19591 in chips)=20
Seat 8: JJin91 (20798 in chips)=20
Seat 9: DaleTDobak (14952 in chips)=20
SAMCRO_1120: posts the ante 60
ruskie85: posts the ante 60
rbonessss333: posts the ante 60
moosedeer17: posts the ante 60
akbongu1977: posts the ante 60
Whiteivey64: posts the ante 60
JJin91: posts the ante 60
DaleTDobak: posts the ante 60
SAMCRO_1120: posts small blind 250
ruskie85: posts big blind 500
*** HOLE CARDS ***
Dealt to JJin91 [7h 4d]
rbonessss333: folds=20
moosedeer17: folds=20
akbongu1977: folds=20
Whiteivey64: folds=20
JJin91: folds=20
DaleTDobak: folds=20
SAMCRO_1120: calls 250
ruskie85: checks=20
*** FLOP *** [As 3c Th]
SAMCRO_1120: checks=20
ruskie85: bets 500
SAMCRO_1120: folds=20
Uncalled bet (500) returned to ruskie85
ruskie85 collected 1480 from pot
ruskie85: doesn't show hand=20
*** SUMMARY ***
Total pot 1480 | Rake 0=20
Board [As 3c Th]
Seat 1: SAMCRO_1120 (small blind) folded on the Flop
Seat 2: ruskie85 (big blind) collected (1480)
Seat 3: rbonessss333 folded before Flop (didn't bet)
Seat 4: moosedeer17 folded before Flop (didn't bet)
Seat 5: akbongu1977 folded before Flop (didn't bet)
Seat 6: Whiteivey64 folded before Flop (didn't bet)
Seat 8: JJin91 folded before Flop (didn't bet)
Seat 9: DaleTDobak (button) folded before Flop (didn't bet)


*********** # 25 **************
PokerStars Hand #169310898496: Tournament #1597683884, $18.20+$1.80 USD=
 Hold'em No Limit - Level XI (250/500) - 2017/05/02 20:53:43 ET
Table '1597683884 1' 9-max Seat #1 is the button
Seat 1: SAMCRO_1120 (19213 in chips)=20
Seat 2: ruskie85 (26892 in chips)=20
Seat 3: rbonessss333 (3340 in chips) is sitting out
Seat 4: moosedeer17 (44900 in chips)=20
Seat 5: akbongu1977 (12850 in chips)=20
Seat 6: Whiteivey64 (19531 in chips)=20
Seat 8: JJin91 (20738 in chips)=20
Seat 9: DaleTDobak (14892 in chips)=20
SAMCRO_1120: posts the ante 60
ruskie85: posts the ante 60
rbonessss333: posts the ante 60
moosedeer17: posts the ante 60
akbongu1977: posts the ante 60
Whiteivey64: posts the ante 60
JJin91: posts the ante 60
DaleTDobak: posts the ante 60
ruskie85: posts small blind 250
rbonessss333: posts big blind 500
*** HOLE CARDS ***
Dealt to JJin91 [Ks 8s]
moosedeer17: folds=20
akbongu1977: raises 12290 to 12790 and is all-in
Whiteivey64: folds=20
JJin91: folds=20
DaleTDobak: folds=20
SAMCRO_1120: folds=20
ruskie85: folds=20
rbonessss333: folds=20
Uncalled bet (12290) returned to akbongu1977
akbongu1977 collected 1730 from pot
akbongu1977: doesn't show hand=20
*** SUMMARY ***
Total pot 1730 | Rake 0=20
Seat 1: SAMCRO_1120 (button) folded before Flop (didn't bet)
Seat 2: ruskie85 (small blind) folded before Flop
Seat 3: rbonessss333 (big blind) folded before Flop
Seat 4: moosedeer17 folded before Flop (didn't bet)
Seat 5: akbongu1977 collected (1730)
Seat 6: Whiteivey64 folded before Flop (didn't bet)
Seat 8: JJin91 folded before Flop (didn't bet)
Seat 9: DaleTDobak folded before Flop (didn't bet)


*********** # 26 **************
PokerStars Hand #169310898596: Tournament #1597683884, $18.20+$1.80 USD=
 Hold'em No Limit - Level XI (250/500) - 2017/05/02 20:54:06 ET
Table '1597683884 1' 9-max Seat #2 is the button
Seat 1: SAMCRO_1120 (19153 in chips)=20
Seat 2: ruskie85 (26582 in chips)=20
Seat 3: rbonessss333 (2780 in chips) is sitting out
Seat 4: moosedeer17 (44840 in chips)=20
Seat 5: akbongu1977 (14020 in chips)=20
Seat 6: Whiteivey64 (19471 in chips)=20
Seat 8: JJin91 (20678 in chips)=20
Seat 9: DaleTDobak (14832 in chips)=20
SAMCRO_1120: posts the ante 60
ruskie85: posts the ante 60
rbonessss333: posts the ante 60
moosedeer17: posts the ante 60
akbongu1977: posts the ante 60
Whiteivey64: posts the ante 60
JJin91: posts the ante 60
DaleTDobak: posts the ante 60
rbonessss333: posts small blind 250
moosedeer17: posts big blind 500
*** HOLE CARDS ***
Dealt to JJin91 [2d 4h]
akbongu1977: folds=20
Whiteivey64 has timed out
Whiteivey64: folds=20
Whiteivey64 is sitting out
JJin91: folds=20
DaleTDobak: folds=20
SAMCRO_1120: raises 1000 to 1500
ruskie85: folds=20
rbonessss333: folds=20
moosedeer17: calls 1000
*** FLOP *** [3c 3d 2c]
moosedeer17: checks=20
Whiteivey64 has returned
SAMCRO_1120: checks=20
*** TURN *** [3c 3d 2c] [4c]
moosedeer17: checks=20
SAMCRO_1120: bets 3730
moosedeer17: folds=20
Uncalled bet (3730) returned to SAMCRO_1120
SAMCRO_1120 collected 3730 from pot
*** SUMMARY ***
Total pot 3730 | Rake 0=20
Board [3c 3d 2c 4c]
Seat 1: SAMCRO_1120 collected (3730)
Seat 2: ruskie85 (button) folded before Flop (didn't bet)
Seat 3: rbonessss333 (small blind) folded before Flop
Seat 4: moosedeer17 (big blind) folded on the Turn
Seat 5: akbongu1977 folded before Flop (didn't bet)
Seat 6: Whiteivey64 folded before Flop (didn't bet)
Seat 8: JJin91 folded before Flop (didn't bet)
Seat 9: DaleTDobak folded before Flop (didn't bet)


*********** # 27 **************
PokerStars Hand #169310898880: Tournament #1597683884, $18.20+$1.80 USD=
 Hold'em No Limit - Level XI (250/500) - 2017/05/02 20:55:02 ET
Table '1597683884 1' 9-max Seat #3 is the button
Seat 1: SAMCRO_1120 (21323 in chips)=20
Seat 2: ruskie85 (26522 in chips)=20
Seat 3: rbonessss333 (2470 in chips) is sitting out
Seat 4: moosedeer17 (43280 in chips)=20
Seat 5: akbongu1977 (13960 in chips)=20
Seat 6: Whiteivey64 (19411 in chips)=20
Seat 8: JJin91 (20618 in chips)=20
Seat 9: DaleTDobak (14772 in chips)=20
SAMCRO_1120: posts the ante 60
ruskie85: posts the ante 60
rbonessss333: posts the ante 60
moosedeer17: posts the ante 60
akbongu1977: posts the ante 60
Whiteivey64: posts the ante 60
JJin91: posts the ante 60
DaleTDobak: posts the ante 60
moosedeer17: posts small blind 250
akbongu1977: posts big blind 500
*** HOLE CARDS ***
Dealt to JJin91 [6s Kc]
Whiteivey64: folds=20
JJin91: folds=20
DaleTDobak: raises 1000 to 1500
SAMCRO_1120: folds=20
ruskie85: calls 1500
rbonessss333: folds=20
moosedeer17: folds=20
akbongu1977: folds=20
*** FLOP *** [Ad Tc 9d]
DaleTDobak: bets 1000
ruskie85: calls 1000
*** TURN *** [Ad Tc 9d] [2d]
DaleTDobak: bets 1500
ruskie85: calls 1500
*** RIVER *** [Ad Tc 9d 2d] [4c]
DaleTDobak: bets 4615
ruskie85: calls 4615
*** SHOW DOWN ***
DaleTDobak: shows [As 9c] (two pair, Aces and Nines)
ruskie85: mucks hand=20
DaleTDobak collected 18460 from pot
*** SUMMARY ***
Total pot 18460 | Rake 0=20
Board [Ad Tc 9d 2d 4c]
Seat 1: SAMCRO_1120 folded before Flop (didn't bet)
Seat 2: ruskie85 mucked [Td Qs]
Seat 3: rbonessss333 (button) folded before Flop (didn't bet)
Seat 4: moosedeer17 (small blind) folded before Flop
Seat 5: akbongu1977 (big blind) folded before Flop
Seat 6: Whiteivey64 folded before Flop (didn't bet)
Seat 8: JJin91 folded before Flop (didn't bet)
Seat 9: DaleTDobak showed [As 9c] and won (18460) with two pair, Aces a=
nd Nines


*********** # 28 **************
PokerStars Hand #169313363962: Tournament #1597683884, $18.20+$1.80 USD=
 Hold'em No Limit - Level XI (250/500) - 2017/05/02 21:01:02 ET
Table '1597683884 1' 9-max Seat #5 is the button
Seat 1: SAMCRO_1120 (21263 in chips)=20
Seat 2: ruskie85 (17847 in chips)=20
Seat 3: rbonessss333 (2410 in chips) is sitting out
Seat 4: Phil Liger (10000 in chips)=20
Seat 5: akbongu1977 (13400 in chips) is sitting out
Seat 6: Whiteivey64 (19351 in chips)=20
Seat 8: JJin91 (20558 in chips)=20
Seat 9: DaleTDobak (24557 in chips)=20
SAMCRO_1120: posts the ante 60
ruskie85: posts the ante 60
rbonessss333: posts the ante 60
Phil Liger: posts the ante 60
akbongu1977: posts the ante 60
Whiteivey64: posts the ante 60
JJin91: posts the ante 60
DaleTDobak: posts the ante 60
Whiteivey64: posts small blind 250
JJin91: posts big blind 500
*** HOLE CARDS ***
Dealt to JJin91 [3d 2h]
DaleTDobak: calls 500
SAMCRO_1120: folds=20
ruskie85: raises 1000 to 1500
rbonessss333: folds=20
Phil Liger: folds=20
akbongu1977: folds=20
Whiteivey64: folds=20
akbongu1977 has returned
JJin91 has timed out
JJin91: folds=20
JJin91 is sitting out
DaleTDobak: calls 1000
*** FLOP *** [Tc 5h Ts]
DaleTDobak: checks=20
ruskie85: checks=20
*** TURN *** [Tc 5h Ts] [2c]
SourDforMe has returned
DaleTDobak: bets 500
ruskie85: calls 500
*** RIVER *** [Tc 5h Ts 2c] [Th]
JJin91 has returned
DaleTDobak: bets 500
ruskie85: calls 500
*** SHOW DOWN ***
DaleTDobak: shows [As 4s] (three of a kind, Tens)
ruskie85: shows [Ks Ad] (three of a kind, Tens - Ace+King kicker)
ruskie85 collected 6230 from pot
*** SUMMARY ***
Total pot 6230 | Rake 0=20
Board [Tc 5h Ts 2c Th]
Seat 1: SAMCRO_1120 folded before Flop (didn't bet)
Seat 2: ruskie85 showed [Ks Ad] and won (6230) with three of a kind, Te=
ns
Seat 3: rbonessss333 folded before Flop (didn't bet)
Seat 4: Phil Liger folded before Flop (didn't bet)
Seat 5: akbongu1977 (button) folded before Flop (didn't bet)
Seat 6: Whiteivey64 (small blind) folded before Flop
Seat 8: JJin91 (big blind) folded before Flop
Seat 9: DaleTDobak showed [As 4s] and lost with three of a kind, Tens


*********** # 29 **************
PokerStars Hand #169313364498: Tournament #1597683884, $18.20+$1.80 USD=
 Hold'em No Limit - Level XII (300/600) - 2017/05/02 21:03:01 ET
Table '1597683884 1' 9-max Seat #6 is the button
Seat 1: SAMCRO_1120 (21203 in chips)=20
Seat 2: ruskie85 (21517 in chips)=20
Seat 3: rbonessss333 (2350 in chips) is sitting out
Seat 4: Phil Liger (9940 in chips)=20
Seat 5: akbongu1977 (13340 in chips)=20
Seat 6: Whiteivey64 (19041 in chips)=20
Seat 7: SourDforMe (27371 in chips) out of hand (moved from another tab=
le into small blind)
Seat 8: JJin91 (19998 in chips)=20
Seat 9: DaleTDobak (21997 in chips)=20
SAMCRO_1120: posts the ante 70
ruskie85: posts the ante 70
rbonessss333: posts the ante 70
Phil Liger: posts the ante 70
akbongu1977: posts the ante 70
Whiteivey64: posts the ante 70
JJin91: posts the ante 70
DaleTDobak: posts the ante 70
JJin91: posts small blind 300
DaleTDobak: posts big blind 600
*** HOLE CARDS ***
Dealt to JJin91 [2c 4c]
SAMCRO_1120: folds=20
ruskie85: folds=20
rbonessss333: folds=20
Phil Liger: folds=20
akbongu1977: calls 600
Whiteivey64: folds=20
JJin91: calls 300
DaleTDobak: checks=20
*** FLOP *** [6h 4d Js]
JJin91: checks=20
DaleTDobak: checks=20
akbongu1977: bets 2400
JJin91: folds=20
DaleTDobak: folds=20
Uncalled bet (2400) returned to akbongu1977
akbongu1977 collected 2360 from pot
akbongu1977: doesn't show hand=20
*** SUMMARY ***
Total pot 2360 | Rake 0=20
Board [6h 4d Js]
Seat 1: SAMCRO_1120 folded before Flop (didn't bet)
Seat 2: ruskie85 folded before Flop (didn't bet)
Seat 3: rbonessss333 folded before Flop (didn't bet)
Seat 4: Phil Liger folded before Flop (didn't bet)
Seat 5: akbongu1977 collected (2360)
Seat 6: Whiteivey64 (button) folded before Flop (didn't bet)
Seat 8: JJin91 (small blind) folded on the Flop
Seat 9: DaleTDobak (big blind) folded on the Flop


*********** # 30 **************
PokerStars Hand #169313364764: Tournament #1597683884, $18.20+$1.80 USD=
 Hold'em No Limit - Level XII (300/600) - 2017/05/02 21:04:05 ET
Table '1597683884 1' 9-max Seat #8 is the button
Seat 1: SAMCRO_1120 (21133 in chips)=20
Seat 2: ruskie85 (21447 in chips)=20
Seat 3: rbonessss333 (2280 in chips) is sitting out
Seat 4: Phil Liger (9870 in chips)=20
Seat 5: akbongu1977 (15030 in chips)=20
Seat 6: Whiteivey64 (18971 in chips)=20
Seat 7: SourDforMe (27371 in chips)=20
Seat 8: JJin91 (19328 in chips)=20
Seat 9: DaleTDobak (21327 in chips)=20
SAMCRO_1120: posts the ante 70
ruskie85: posts the ante 70
rbonessss333: posts the ante 70
Phil Liger: posts the ante 70
akbongu1977: posts the ante 70
Whiteivey64: posts the ante 70
SourDforMe: posts the ante 70
JJin91: posts the ante 70
DaleTDobak: posts the ante 70
DaleTDobak: posts small blind 300
SAMCRO_1120: posts big blind 600
*** HOLE CARDS ***
Dealt to JJin91 [Qd Ac]
ruskie85: calls 600
rbonessss333: folds=20
Phil Liger: folds=20
akbongu1977: folds=20
Whiteivey64: folds=20
SourDforMe: folds=20
JJin91: raises 1012 to 1612
DaleTDobak: folds=20
SAMCRO_1120: folds=20
ruskie85: calls 1012
*** FLOP *** [Ks Jd 8c]
ruskie85: checks=20
JJin91: bets 1474
ruskie85: folds=20
Uncalled bet (1474) returned to JJin91
JJin91 collected 4754 from pot
JJin91: doesn't show hand=20
*** SUMMARY ***
Total pot 4754 | Rake 0=20
Board [Ks Jd 8c]
Seat 1: SAMCRO_1120 (big blind) folded before Flop
Seat 2: ruskie85 folded on the Flop
Seat 3: rbonessss333 folded before Flop (didn't bet)
Seat 4: Phil Liger folded before Flop (didn't bet)
Seat 5: akbongu1977 folded before Flop (didn't bet)
Seat 6: Whiteivey64 folded before Flop (didn't bet)
Seat 7: SourDforMe folded before Flop (didn't bet)
Seat 8: JJin91 (button) collected (4754)
Seat 9: DaleTDobak (small blind) folded before Flop


*********** # 31 **************
PokerStars Hand #169313365009: Tournament #1597683884, $18.20+$1.80 USD=
 Hold'em No Limit - Level XII (300/600) - 2017/05/02 21:04:58 ET
Table '1597683884 1' 9-max Seat #9 is the button
Seat 1: SAMCRO_1120 (20463 in chips)=20
Seat 2: ruskie85 (19765 in chips)=20
Seat 3: rbonessss333 (2210 in chips) is sitting out
Seat 4: Phil Liger (9800 in chips)=20
Seat 5: akbongu1977 (14960 in chips)=20
Seat 6: Whiteivey64 (18901 in chips)=20
Seat 7: SourDforMe (27301 in chips)=20
Seat 8: JJin91 (22400 in chips)=20
Seat 9: DaleTDobak (20957 in chips)=20
SAMCRO_1120: posts the ante 70
ruskie85: posts the ante 70
rbonessss333: posts the ante 70
Phil Liger: posts the ante 70
akbongu1977: posts the ante 70
Whiteivey64: posts the ante 70
SourDforMe: posts the ante 70
JJin91: posts the ante 70
DaleTDobak: posts the ante 70
SAMCRO_1120: posts small blind 300
ruskie85: posts big blind 600
*** HOLE CARDS ***
Dealt to JJin91 [3h 4d]
rbonessss333: folds=20
Phil Liger: folds=20
akbongu1977: raises 1200 to 1800
Whiteivey64: folds=20
SourDforMe: folds=20
JJin91: folds=20
DaleTDobak: raises 2400 to 4200
SAMCRO_1120: folds=20
ruskie85: folds=20
akbongu1977: calls 2400
*** FLOP *** [5c 3c 4c]
akbongu1977: checks=20
DaleTDobak: bets 7800
akbongu1977: raises 2890 to 10690 and is all-in
DaleTDobak: calls 2890
*** TURN *** [5c 3c 4c] [5h]
*** RIVER *** [5c 3c 4c 5h] [2d]
*** SHOW DOWN ***
akbongu1977: shows [Ad Kc] (a straight, Ace to Five)
DaleTDobak: shows [Kh Ah] (a straight, Ace to Five)
akbongu1977 collected 15655 from pot
DaleTDobak collected 15655 from pot
*** SUMMARY ***
Total pot 31310 | Rake 0=20
Board [5c 3c 4c 5h 2d]
Seat 1: SAMCRO_1120 (small blind) folded before Flop
Seat 2: ruskie85 (big blind) folded before Flop
Seat 3: rbonessss333 folded before Flop (didn't bet)
Seat 4: Phil Liger folded before Flop (didn't bet)
Seat 5: akbongu1977 showed [Ad Kc] and won (15655) with a straight, Ace=
 to Five
Seat 6: Whiteivey64 folded before Flop (didn't bet)
Seat 7: SourDforMe folded before Flop (didn't bet)
Seat 8: JJin91 folded before Flop (didn't bet)
Seat 9: DaleTDobak (button) showed [Kh Ah] and won (15655) with a strai=
ght, Ace to Five


*********** # 32 **************
PokerStars Hand #169313365254: Tournament #1597683884, $18.20+$1.80 USD=
 Hold'em No Limit - Level XII (300/600) - 2017/05/02 21:05:49 ET
Table '1597683884 1' 9-max Seat #1 is the button
Seat 1: SAMCRO_1120 (20093 in chips)=20
Seat 2: ruskie85 (19095 in chips)=20
Seat 3: rbonessss333 (2140 in chips) is sitting out
Seat 4: Phil Liger (9730 in chips)=20
Seat 5: akbongu1977 (15655 in chips)=20
Seat 6: Whiteivey64 (18831 in chips)=20
Seat 7: SourDforMe (27231 in chips)=20
Seat 8: JJin91 (22330 in chips)=20
Seat 9: DaleTDobak (21652 in chips)=20
SAMCRO_1120: posts the ante 70
ruskie85: posts the ante 70
rbonessss333: posts the ante 70
Phil Liger: posts the ante 70
akbongu1977: posts the ante 70
Whiteivey64: posts the ante 70
SourDforMe: posts the ante 70
JJin91: posts the ante 70
DaleTDobak: posts the ante 70
ruskie85: posts small blind 300
rbonessss333: posts big blind 600
*** HOLE CARDS ***
Dealt to JJin91 [6h Qd]
Phil Liger: folds=20
akbongu1977: calls 600
Whiteivey64: folds=20
SourDforMe: folds=20
JJin91: folds=20
DaleTDobak: folds=20
SAMCRO_1120: raises 2400 to 3000
ruskie85: calls 2700
rbonessss333: folds=20
akbongu1977: folds=20
*** FLOP *** [3s 6s 3c]
ruskie85: checks=20
SAMCRO_1120: bets 3915
ruskie85: calls 3915
*** TURN *** [3s 6s 3c] [Jc]
ruskie85: checks=20
SAMCRO_1120: bets 13108 and is all-in
ruskie85: folds=20
Uncalled bet (13108) returned to SAMCRO_1120
SAMCRO_1120 collected 15660 from pot
*** SUMMARY ***
Total pot 15660 | Rake 0=20
Board [3s 6s 3c Jc]
Seat 1: SAMCRO_1120 (button) collected (15660)
Seat 2: ruskie85 (small blind) folded on the Turn
Seat 3: rbonessss333 (big blind) folded before Flop
Seat 4: Phil Liger folded before Flop (didn't bet)
Seat 5: akbongu1977 folded before Flop
Seat 6: Whiteivey64 folded before Flop (didn't bet)
Seat 7: SourDforMe folded before Flop (didn't bet)
Seat 8: JJin91 folded before Flop (didn't bet)
Seat 9: DaleTDobak folded before Flop (didn't bet)


*********** # 33 **************
PokerStars Hand #169313365489: Tournament #1597683884, $18.20+$1.80 USD=
 Hold'em No Limit - Level XII (300/600) - 2017/05/02 21:06:42 ET
Table '1597683884 1' 9-max Seat #2 is the button
Seat 1: SAMCRO_1120 (28768 in chips)=20
Seat 2: ruskie85 (12110 in chips)=20
Seat 3: rbonessss333 (1470 in chips) is sitting out
Seat 4: Phil Liger (9660 in chips)=20
Seat 5: akbongu1977 (14985 in chips)=20
Seat 6: Whiteivey64 (18761 in chips)=20
Seat 7: SourDforMe (27161 in chips)=20
Seat 8: JJin91 (22260 in chips)=20
Seat 9: DaleTDobak (21582 in chips)=20
SAMCRO_1120: posts the ante 70
ruskie85: posts the ante 70
rbonessss333: posts the ante 70
Phil Liger: posts the ante 70
akbongu1977: posts the ante 70
Whiteivey64: posts the ante 70
SourDforMe: posts the ante 70
JJin91: posts the ante 70
DaleTDobak: posts the ante 70
rbonessss333: posts small blind 300
Phil Liger: posts big blind 600
*** HOLE CARDS ***
Dealt to JJin91 [2h 2c]
akbongu1977: folds=20
Whiteivey64: folds=20
SourDforMe: folds=20
JJin91: folds=20
DaleTDobak: folds=20
SAMCRO_1120: folds=20
ruskie85: folds=20
rbonessss333: folds=20
Uncalled bet (300) returned to Phil Liger
Phil Liger collected 1230 from pot
*** SUMMARY ***
Total pot 1230 | Rake 0=20
Seat 1: SAMCRO_1120 folded before Flop (didn't bet)
Seat 2: ruskie85 (button) folded before Flop (didn't bet)
Seat 3: rbonessss333 (small blind) folded before Flop
Seat 4: Phil Liger (big blind) collected (1230)
Seat 5: akbongu1977 folded before Flop (didn't bet)
Seat 6: Whiteivey64 folded before Flop (didn't bet)
Seat 7: SourDforMe folded before Flop (didn't bet)
Seat 8: JJin91 folded before Flop (didn't bet)
Seat 9: DaleTDobak folded before Flop (didn't bet)


*********** # 34 **************
PokerStars Hand #169313365594: Tournament #1597683884, $18.20+$1.80 USD=
 Hold'em No Limit - Level XII (300/600) - 2017/05/02 21:07:04 ET
Table '1597683884 1' 9-max Seat #3 is the button
Seat 1: SAMCRO_1120 (28698 in chips)=20
Seat 2: ruskie85 (12040 in chips)=20
Seat 3: rbonessss333 (1100 in chips) is sitting out
Seat 4: Phil Liger (10520 in chips)=20
Seat 5: akbongu1977 (14915 in chips)=20
Seat 6: Whiteivey64 (18691 in chips)=20
Seat 7: SourDforMe (27091 in chips)=20
Seat 8: JJin91 (22190 in chips)=20
Seat 9: DaleTDobak (21512 in chips)=20
SAMCRO_1120: posts the ante 70
ruskie85: posts the ante 70
rbonessss333: posts the ante 70
Phil Liger: posts the ante 70
akbongu1977: posts the ante 70
Whiteivey64: posts the ante 70
SourDforMe: posts the ante 70
JJin91: posts the ante 70
DaleTDobak: posts the ante 70
Phil Liger: posts small blind 300
akbongu1977: posts big blind 600
*** HOLE CARDS ***
Dealt to JJin91 [8c Qs]
Whiteivey64: folds=20
SourDforMe: folds=20
JJin91: folds=20
DaleTDobak: calls 600
SAMCRO_1120: folds=20
ruskie85: calls 600
rbonessss333: folds=20
Phil Liger: folds=20
akbongu1977: checks=20
*** FLOP *** [5d Qd 3c]
akbongu1977: checks=20
DaleTDobak: bets 1800
ruskie85: calls 1800
akbongu1977: calls 1800
*** TURN *** [5d Qd 3c] [Ac]
akbongu1977: checks=20
DaleTDobak: bets 1200
ruskie85: folds=20
akbongu1977: calls 1200
*** RIVER *** [5d Qd 3c Ac] [9c]
akbongu1977: bets 1200
DaleTDobak: calls 1200
*** SHOW DOWN ***
akbongu1977: shows [2d Jd] (high card Ace)
DaleTDobak: shows [Th Qh] (a pair of Queens)
DaleTDobak collected 12930 from pot
*** SUMMARY ***
Total pot 12930 | Rake 0=20
Board [5d Qd 3c Ac 9c]
Seat 1: SAMCRO_1120 folded before Flop (didn't bet)
Seat 2: ruskie85 folded on the Turn
Seat 3: rbonessss333 (button) folded before Flop (didn't bet)
Seat 4: Phil Liger (small blind) folded before Flop
Seat 5: akbongu1977 (big blind) showed [2d Jd] and lost with high card =
Ace
Seat 6: Whiteivey64 folded before Flop (didn't bet)
Seat 7: SourDforMe folded before Flop (didn't bet)
Seat 8: JJin91 folded before Flop (didn't bet)
Seat 9: DaleTDobak showed [Th Qh] and won (12930) with a pair of Queens


*********** # 35 **************
PokerStars Hand #169313366393: Tournament #1597683884, $18.20+$1.80 USD=
 Hold'em No Limit - Level XII (300/600) - 2017/05/02 21:09:53 ET
Table '1597683884 3' 9-max Seat #9 is the button
Seat 1: MyManPotnPan (34645 in chips)=20
Seat 2: JSkelts (17571 in chips)=20
Seat 3: bobconstruc (18720 in chips)=20
Seat 4: JJin91 (22120 in chips)=20
Seat 5: jrollsup1 (17642 in chips)=20
Seat 6: hainesiv2 (13614 in chips)=20
Seat 8: iFoldN0T (21890 in chips)=20
Seat 9: DomBagz (12997 in chips)=20
MyManPotnPan: posts the ante 70
JSkelts: posts the ante 70
bobconstruc: posts the ante 70
JJin91: posts the ante 70
jrollsup1: posts the ante 70
hainesiv2: posts the ante 70
iFoldN0T: posts the ante 70
DomBagz: posts the ante 70
MyManPotnPan: posts small blind 300
JSkelts: posts big blind 600
*** HOLE CARDS ***
Dealt to JJin91 [5d 9h]
bobconstruc: folds=20
JJin91: folds=20
jrollsup1: folds=20
hainesiv2: raises 12944 to 13544 and is all-in
iFoldN0T: folds=20
DomBagz: folds=20
MyManPotnPan: folds=20
JSkelts: folds=20
Uncalled bet (12944) returned to hainesiv2
hainesiv2 collected 2060 from pot
hainesiv2: doesn't show hand=20
*** SUMMARY ***
Total pot 2060 | Rake 0=20
Seat 1: MyManPotnPan (small blind) folded before Flop
Seat 2: JSkelts (big blind) folded before Flop
Seat 3: bobconstruc folded before Flop (didn't bet)
Seat 4: JJin91 folded before Flop (didn't bet)
Seat 5: jrollsup1 folded before Flop (didn't bet)
Seat 6: hainesiv2 collected (2060)
Seat 8: iFoldN0T folded before Flop (didn't bet)
Seat 9: DomBagz (button) folded before Flop (didn't bet)


*********** # 36 **************
PokerStars Hand #169313366554: Tournament #1597683884, $18.20+$1.80 USD=
 Hold'em No Limit - Level XII (300/600) - 2017/05/02 21:10:26 ET
Table '1597683884 3' 9-max Seat #1 is the button
Seat 1: MyManPotnPan (34275 in chips)=20
Seat 2: JSkelts (16901 in chips)=20
Seat 3: bobconstruc (18650 in chips)=20
Seat 4: JJin91 (22050 in chips)=20
Seat 5: jrollsup1 (17572 in chips)=20
Seat 6: hainesiv2 (15004 in chips)=20
Seat 8: iFoldN0T (21820 in chips)=20
Seat 9: DomBagz (12927 in chips)=20
MyManPotnPan: posts the ante 70
JSkelts: posts the ante 70
bobconstruc: posts the ante 70
JJin91: posts the ante 70
jrollsup1: posts the ante 70
hainesiv2: posts the ante 70
iFoldN0T: posts the ante 70
DomBagz: posts the ante 70
JSkelts: posts small blind 300
bobconstruc: posts big blind 600
*** HOLE CARDS ***
Dealt to JJin91 [4s Kc]
JJin91: folds=20
jrollsup1: folds=20
hainesiv2: raises 1200 to 1800
iFoldN0T: folds=20
DomBagz: folds=20
MyManPotnPan: folds=20
JSkelts: folds=20
bobconstruc: folds=20
Uncalled bet (1200) returned to hainesiv2
hainesiv2 collected 2060 from pot
hainesiv2: doesn't show hand=20
*** SUMMARY ***
Total pot 2060 | Rake 0=20
Seat 1: MyManPotnPan (button) folded before Flop (didn't bet)
Seat 2: JSkelts (small blind) folded before Flop
Seat 3: bobconstruc (big blind) folded before Flop
Seat 4: JJin91 folded before Flop (didn't bet)
Seat 5: jrollsup1 folded before Flop (didn't bet)
Seat 6: hainesiv2 collected (2060)
Seat 8: iFoldN0T folded before Flop (didn't bet)
Seat 9: DomBagz folded before Flop (didn't bet)


*********** # 37 **************
PokerStars Hand #169313366744: Tournament #1597683884, $18.20+$1.80 USD=
 Hold'em No Limit - Level XII (300/600) - 2017/05/02 21:11:00 ET
Table '1597683884 3' 9-max Seat #2 is the button
Seat 1: MyManPotnPan (34205 in chips)=20
Seat 2: JSkelts (16531 in chips)=20
Seat 3: bobconstruc (17980 in chips)=20
Seat 4: JJin91 (21980 in chips)=20
Seat 5: jrollsup1 (17502 in chips)=20
Seat 6: hainesiv2 (16394 in chips)=20
Seat 8: iFoldN0T (21750 in chips)=20
Seat 9: DomBagz (12857 in chips)=20
MyManPotnPan: posts the ante 70
JSkelts: posts the ante 70
bobconstruc: posts the ante 70
JJin91: posts the ante 70
jrollsup1: posts the ante 70
hainesiv2: posts the ante 70
iFoldN0T: posts the ante 70
DomBagz: posts the ante 70
bobconstruc: posts small blind 300
JJin91: posts big blind 600
*** HOLE CARDS ***
Dealt to JJin91 [5c As]
jrollsup1: folds=20
hainesiv2: raises 1200 to 1800
iFoldN0T: folds=20
DomBagz: folds=20
MyManPotnPan: folds=20
JSkelts: folds=20
bobconstruc: folds=20
JJin91: folds=20
Uncalled bet (1200) returned to hainesiv2
hainesiv2 collected 2060 from pot
hainesiv2: doesn't show hand=20
*** SUMMARY ***
Total pot 2060 | Rake 0=20
Seat 1: MyManPotnPan folded before Flop (didn't bet)
Seat 2: JSkelts (button) folded before Flop (didn't bet)
Seat 3: bobconstruc (small blind) folded before Flop
Seat 4: JJin91 (big blind) folded before Flop
Seat 5: jrollsup1 folded before Flop (didn't bet)
Seat 6: hainesiv2 collected (2060)
Seat 8: iFoldN0T folded before Flop (didn't bet)
Seat 9: DomBagz folded before Flop (didn't bet)


*********** # 38 **************
PokerStars Hand #169313366917: Tournament #1597683884, $18.20+$1.80 USD=
 Hold'em No Limit - Level XII (300/600) - 2017/05/02 21:11:39 ET
Table '1597683884 3' 9-max Seat #3 is the button
Seat 1: MyManPotnPan (34135 in chips)=20
Seat 2: JSkelts (16461 in chips)=20
Seat 3: bobconstruc (17610 in chips)=20
Seat 4: JJin91 (21310 in chips)=20
Seat 5: jrollsup1 (17432 in chips)=20
Seat 6: hainesiv2 (17784 in chips)=20
Seat 8: iFoldN0T (21680 in chips)=20
Seat 9: DomBagz (12787 in chips)=20
MyManPotnPan: posts the ante 70
JSkelts: posts the ante 70
bobconstruc: posts the ante 70
JJin91: posts the ante 70
jrollsup1: posts the ante 70
hainesiv2: posts the ante 70
iFoldN0T: posts the ante 70
DomBagz: posts the ante 70
JJin91: posts small blind 300
jrollsup1: posts big blind 600
*** HOLE CARDS ***
Dealt to JJin91 [7s 2c]
hainesiv2: folds=20
iFoldN0T: folds=20
DomBagz: folds=20
MyManPotnPan: folds=20
JSkelts: folds=20
bobconstruc: raises 16940 to 17540 and is all-in
JJin91: folds=20
jrollsup1: folds=20
Uncalled bet (16940) returned to bobconstruc
bobconstruc collected 2060 from pot
bobconstruc: doesn't show hand=20
*** SUMMARY ***
Total pot 2060 | Rake 0=20
Seat 1: MyManPotnPan folded before Flop (didn't bet)
Seat 2: JSkelts folded before Flop (didn't bet)
Seat 3: bobconstruc (button) collected (2060)
Seat 4: JJin91 (small blind) folded before Flop
Seat 5: jrollsup1 (big blind) folded before Flop
Seat 6: hainesiv2 folded before Flop (didn't bet)
Seat 8: iFoldN0T folded before Flop (didn't bet)
Seat 9: DomBagz folded before Flop (didn't bet)


*********** # 39 **************
PokerStars Hand #169313367081: Tournament #1597683884, $18.20+$1.80 USD=
 Hold'em No Limit - Level XIII (350/700) - 2017/05/02 21:12:10 ET
Table '1597683884 3' 9-max Seat #4 is the button
Seat 1: MyManPotnPan (34065 in chips)=20
Seat 2: JSkelts (16391 in chips)=20
Seat 3: bobconstruc (19000 in chips)=20
Seat 4: JJin91 (20940 in chips)=20
Seat 5: jrollsup1 (16762 in chips)=20
Seat 6: hainesiv2 (17714 in chips)=20
Seat 8: iFoldN0T (21610 in chips)=20
Seat 9: DomBagz (12717 in chips)=20
MyManPotnPan: posts the ante 85
JSkelts: posts the ante 85
bobconstruc: posts the ante 85
JJin91: posts the ante 85
jrollsup1: posts the ante 85
hainesiv2: posts the ante 85
iFoldN0T: posts the ante 85
DomBagz: posts the ante 85
jrollsup1: posts small blind 350
hainesiv2: posts big blind 700
*** HOLE CARDS ***
Dealt to JJin91 [7d 3s]
iFoldN0T: folds=20
DomBagz: folds=20
MyManPotnPan: folds=20
JSkelts: folds=20
bobconstruc: folds=20
JJin91: folds=20
jrollsup1: raises 700 to 1400
hainesiv2: calls 700
*** FLOP *** [2h 6s 9h]
jrollsup1: bets 700
hainesiv2: calls 700
*** TURN *** [2h 6s 9h] [7c]
jrollsup1: bets 2440
hainesiv2: calls 2440
*** RIVER *** [2h 6s 9h 7c] [Kd]
jrollsup1: checks=20
hainesiv2: checks=20
*** SHOW DOWN ***
jrollsup1: shows [Jh 7h] (a pair of Sevens)
hainesiv2: mucks hand=20
jrollsup1 collected 9760 from pot
*** SUMMARY ***
Total pot 9760 | Rake 0=20
Board [2h 6s 9h 7c Kd]
Seat 1: MyManPotnPan folded before Flop (didn't bet)
Seat 2: JSkelts folded before Flop (didn't bet)
Seat 3: bobconstruc folded before Flop (didn't bet)
Seat 4: JJin91 (button) folded before Flop (didn't bet)
Seat 5: jrollsup1 (small blind) showed [Jh 7h] and won (9760) with a pa=
ir of Sevens
Seat 6: hainesiv2 (big blind) mucked [6c 5d]
Seat 8: iFoldN0T folded before Flop (didn't bet)
Seat 9: DomBagz folded before Flop (didn't bet)


*********** # 40 **************
PokerStars Hand #169313367496: Tournament #1597683884, $18.20+$1.80 USD=
 Hold'em No Limit - Level XIII (350/700) - 2017/05/02 21:13:30 ET
Table '1597683884 3' 9-max Seat #5 is the button
Seat 1: MyManPotnPan (33980 in chips)=20
Seat 2: JSkelts (16306 in chips)=20
Seat 3: bobconstruc (18915 in chips)=20
Seat 4: JJin91 (20855 in chips)=20
Seat 5: jrollsup1 (21897 in chips)=20
Seat 6: hainesiv2 (13089 in chips)=20
Seat 8: iFoldN0T (21525 in chips)=20
Seat 9: DomBagz (12632 in chips)=20
MyManPotnPan: posts the ante 85
JSkelts: posts the ante 85
bobconstruc: posts the ante 85
JJin91: posts the ante 85
jrollsup1: posts the ante 85
hainesiv2: posts the ante 85
iFoldN0T: posts the ante 85
DomBagz: posts the ante 85
hainesiv2: posts small blind 350
iFoldN0T: posts big blind 700
*** HOLE CARDS ***
Dealt to JJin91 [4h Jh]
DomBagz: folds=20
MyManPotnPan: folds=20
JSkelts: folds=20
bobconstruc: raises 1400 to 2100
JJin91: folds=20
jrollsup1: folds=20
hainesiv2: folds=20
iFoldN0T: folds=20
Uncalled bet (1400) returned to bobconstruc
bobconstruc collected 2430 from pot
bobconstruc: doesn't show hand=20
*** SUMMARY ***
Total pot 2430 | Rake 0=20
Seat 1: MyManPotnPan folded before Flop (didn't bet)
Seat 2: JSkelts folded before Flop (didn't bet)
Seat 3: bobconstruc collected (2430)
Seat 4: JJin91 folded before Flop (didn't bet)
Seat 5: jrollsup1 (button) folded before Flop (didn't bet)
Seat 6: hainesiv2 (small blind) folded before Flop
Seat 8: iFoldN0T (big blind) folded before Flop
Seat 9: DomBagz folded before Flop (didn't bet)


*********** # 41 **************
PokerStars Hand #169313367658: Tournament #1597683884, $18.20+$1.80 USD=
 Hold'em No Limit - Level XIII (350/700) - 2017/05/02 21:13:58 ET
Table '1597683884 3' 9-max Seat #6 is the button
Seat 1: MyManPotnPan (33895 in chips)=20
Seat 2: JSkelts (16221 in chips)=20
Seat 3: bobconstruc (20560 in chips)=20
Seat 4: JJin91 (20770 in chips)=20
Seat 5: jrollsup1 (21812 in chips)=20
Seat 6: hainesiv2 (12654 in chips)=20
Seat 8: iFoldN0T (20740 in chips)=20
Seat 9: DomBagz (12547 in chips)=20
MyManPotnPan: posts the ante 85
JSkelts: posts the ante 85
bobconstruc: posts the ante 85
JJin91: posts the ante 85
jrollsup1: posts the ante 85
hainesiv2: posts the ante 85
iFoldN0T: posts the ante 85
DomBagz: posts the ante 85
iFoldN0T: posts small blind 350
DomBagz: posts big blind 700
*** HOLE CARDS ***
Dealt to JJin91 [6s 5s]
MyManPotnPan: folds=20
JSkelts: calls 700
bobconstruc: folds=20
JJin91: folds=20
jrollsup1: folds=20
hainesiv2: folds=20
iFoldN0T: calls 350
DomBagz: checks=20
*** FLOP *** [9h 5c 7c]
iFoldN0T: bets 1640
DomBagz: calls 1640
JSkelts: folds=20
*** TURN *** [9h 5c 7c] [5d]
iFoldN0T: bets 3575
DomBagz: raises 6547 to 10122 and is all-in
iFoldN0T: folds=20
Uncalled bet (6547) returned to DomBagz
DomBagz collected 13210 from pot
DomBagz: doesn't show hand=20
*** SUMMARY ***
Total pot 13210 | Rake 0=20
Board [9h 5c 7c 5d]
Seat 1: MyManPotnPan folded before Flop (didn't bet)
Seat 2: JSkelts folded on the Flop
Seat 3: bobconstruc folded before Flop (didn't bet)
Seat 4: JJin91 folded before Flop (didn't bet)
Seat 5: jrollsup1 folded before Flop (didn't bet)
Seat 6: hainesiv2 (button) folded before Flop (didn't bet)
Seat 8: iFoldN0T (small blind) folded on the Turn
Seat 9: DomBagz (big blind) collected (13210)


*********** # 42 **************
PokerStars Hand #169313368079: Tournament #1597683884, $18.20+$1.80 USD=
 Hold'em No Limit - Level XIII (350/700) - 2017/05/02 21:15:28 ET
Table '1597683884 3' 9-max Seat #8 is the button
Seat 1: MyManPotnPan (33810 in chips)=20
Seat 2: JSkelts (15436 in chips)=20
Seat 3: bobconstruc (20475 in chips)=20
Seat 4: JJin91 (20685 in chips)=20
Seat 5: jrollsup1 (21727 in chips)=20
Seat 6: hainesiv2 (12569 in chips)=20
Seat 7: dak1616 (9037 in chips)=20
Seat 8: iFoldN0T (14740 in chips)=20
Seat 9: DomBagz (19757 in chips)=20
MyManPotnPan: posts the ante 85
JSkelts: posts the ante 85
bobconstruc: posts the ante 85
JJin91: posts the ante 85
jrollsup1: posts the ante 85
hainesiv2: posts the ante 85
dak1616: posts the ante 85
iFoldN0T: posts the ante 85
DomBagz: posts the ante 85
DomBagz: posts small blind 350
MyManPotnPan: posts big blind 700
*** HOLE CARDS ***
Dealt to JJin91 [Kd Kh]
JSkelts: folds=20
bobconstruc: raises 1400 to 2100
JJin91: raises 4200 to 6300
jrollsup1: folds=20
hainesiv2: folds=20
dak1616: folds=20
iFoldN0T: folds=20
DomBagz: folds=20
MyManPotnPan: folds=20
bobconstruc: raises 14090 to 20390 and is all-in
JJin91: calls 14090
*** FLOP *** [2s Ah 8s]
*** TURN *** [2s Ah 8s] [8c]
*** RIVER *** [2s Ah 8s 8c] [6s]
*** SHOW DOWN ***
bobconstruc: shows [Jd Jc] (two pair, Jacks and Eights)
JJin91: shows [Kd Kh] (two pair, Kings and Eights)
JJin91 collected 42595 from pot
bobconstruc finished the tournament in 53rd place
*** SUMMARY ***
Total pot 42595 | Rake 0=20
Board [2s Ah 8s 8c 6s]
Seat 1: MyManPotnPan (big blind) folded before Flop
Seat 2: JSkelts folded before Flop (didn't bet)
Seat 3: bobconstruc showed [Jd Jc] and lost with two pair, Jacks and Ei=
ghts
Seat 4: JJin91 showed [Kd Kh] and won (42595) with two pair, Kings and =
Eights
Seat 5: jrollsup1 folded before Flop (didn't bet)
Seat 6: hainesiv2 folded before Flop (didn't bet)
Seat 7: dak1616 folded before Flop (didn't bet)
Seat 8: iFoldN0T (button) folded before Flop (didn't bet)
Seat 9: DomBagz (small blind) folded before Flop


*********** # 43 **************
PokerStars Hand #169313368347: Tournament #1597683884, $18.20+$1.80 USD=
 Hold'em No Limit - Level XIII (350/700) - 2017/05/02 21:16:20 ET
Table '1597683884 3' 9-max Seat #9 is the button
Seat 1: MyManPotnPan (33025 in chips)=20
Seat 2: JSkelts (15351 in chips)=20
Seat 4: JJin91 (42805 in chips)=20
Seat 5: jrollsup1 (21642 in chips)=20
Seat 6: hainesiv2 (12484 in chips)=20
Seat 7: dak1616 (8952 in chips)=20
Seat 8: iFoldN0T (14655 in chips)=20
Seat 9: DomBagz (19322 in chips)=20
MyManPotnPan: posts the ante 85
JSkelts: posts the ante 85
JJin91: posts the ante 85
jrollsup1: posts the ante 85
hainesiv2: posts the ante 85
dak1616: posts the ante 85
iFoldN0T: posts the ante 85
DomBagz: posts the ante 85
MyManPotnPan: posts small blind 350
JSkelts: posts big blind 700
*** HOLE CARDS ***
Dealt to JJin91 [6s 7h]
JJin91: folds=20
jrollsup1: calls 700
hainesiv2: raises 11699 to 12399 and is all-in
dak1616: folds=20
iFoldN0T: folds=20
DomBagz: folds=20
MyManPotnPan: folds=20
JSkelts: folds=20
jrollsup1: folds=20
Uncalled bet (11699) returned to hainesiv2
hainesiv2 collected 3130 from pot
hainesiv2: doesn't show hand=20
*** SUMMARY ***
Total pot 3130 | Rake 0=20
Seat 1: MyManPotnPan (small blind) folded before Flop
Seat 2: JSkelts (big blind) folded before Flop
Seat 4: JJin91 folded before Flop (didn't bet)
Seat 5: jrollsup1 folded before Flop
Seat 6: hainesiv2 collected (3130)
Seat 7: dak1616 folded before Flop (didn't bet)
Seat 8: iFoldN0T folded before Flop (didn't bet)
Seat 9: DomBagz (button) folded before Flop (didn't bet)


*********** # 44 **************
PokerStars Hand #169313368523: Tournament #1597683884, $18.20+$1.80 USD=
 Hold'em No Limit - Level XIII (350/700) - 2017/05/02 21:16:57 ET
Table '1597683884 3' 9-max Seat #1 is the button
Seat 1: MyManPotnPan (32590 in chips)=20
Seat 2: JSkelts (14566 in chips)=20
Seat 4: JJin91 (42720 in chips)=20
Seat 5: jrollsup1 (20857 in chips)=20
Seat 6: hainesiv2 (14829 in chips)=20
Seat 7: dak1616 (8867 in chips)=20
Seat 8: iFoldN0T (14570 in chips)=20
Seat 9: DomBagz (19237 in chips)=20
MyManPotnPan: posts the ante 85
JSkelts: posts the ante 85
JJin91: posts the ante 85
jrollsup1: posts the ante 85
hainesiv2: posts the ante 85
dak1616: posts the ante 85
iFoldN0T: posts the ante 85
DomBagz: posts the ante 85
JSkelts: posts small blind 350
JJin91: posts big blind 700
*** HOLE CARDS ***
Dealt to JJin91 [7d 2h]
jrollsup1: folds=20
hainesiv2: folds=20
dak1616: folds=20
iFoldN0T: folds=20
DomBagz: raises 700 to 1400
MyManPotnPan: folds=20
JSkelts: folds=20
JJin91: folds=20
Uncalled bet (700) returned to DomBagz
DomBagz collected 2430 from pot
DomBagz: doesn't show hand=20
*** SUMMARY ***
Total pot 2430 | Rake 0=20
Seat 1: MyManPotnPan (button) folded before Flop (didn't bet)
Seat 2: JSkelts (small blind) folded before Flop
Seat 4: JJin91 (big blind) folded before Flop
Seat 5: jrollsup1 folded before Flop (didn't bet)
Seat 6: hainesiv2 folded before Flop (didn't bet)
Seat 7: dak1616 folded before Flop (didn't bet)
Seat 8: iFoldN0T folded before Flop (didn't bet)
Seat 9: DomBagz collected (2430)


*********** # 45 **************
PokerStars Hand #169313368619: Tournament #1597683884, $18.20+$1.80 USD=
 Hold'em No Limit - Level XIII (350/700) - 2017/05/02 21:17:18 ET
Table '1597683884 3' 9-max Seat #2 is the button
Seat 1: MyManPotnPan (32505 in chips)=20
Seat 2: JSkelts (14131 in chips)=20
Seat 4: JJin91 (41935 in chips)=20
Seat 5: jrollsup1 (20772 in chips)=20
Seat 6: hainesiv2 (14744 in chips)=20
Seat 7: dak1616 (8782 in chips)=20
Seat 8: iFoldN0T (14485 in chips)=20
Seat 9: DomBagz (20882 in chips)=20
MyManPotnPan: posts the ante 85
JSkelts: posts the ante 85
JJin91: posts the ante 85
jrollsup1: posts the ante 85
hainesiv2: posts the ante 85
dak1616: posts the ante 85
iFoldN0T: posts the ante 85
DomBagz: posts the ante 85
JJin91: posts small blind 350
jrollsup1: posts big blind 700
*** HOLE CARDS ***
Dealt to JJin91 [3d Kd]
hainesiv2: calls 700
dak1616: folds=20
iFoldN0T: folds=20
DomBagz: folds=20
MyManPotnPan: folds=20
JSkelts: folds=20
JJin91: calls 350
jrollsup1: checks=20
*** FLOP *** [Qs 8s 6h]
JJin91: bets 2100
jrollsup1: calls 2100
hainesiv2: calls 2100
*** TURN *** [Qs 8s 6h] [4h]
JJin91: checks=20
jrollsup1: bets 6300
hainesiv2: folds=20
JJin91: folds=20
Uncalled bet (6300) returned to jrollsup1
jrollsup1 collected 9080 from pot
jrollsup1: doesn't show hand=20
*** SUMMARY ***
Total pot 9080 | Rake 0=20
Board [Qs 8s 6h 4h]
Seat 1: MyManPotnPan folded before Flop (didn't bet)
Seat 2: JSkelts (button) folded before Flop (didn't bet)
Seat 4: JJin91 (small blind) folded on the Turn
Seat 5: jrollsup1 (big blind) collected (9080)
Seat 6: hainesiv2 folded on the Turn
Seat 7: dak1616 folded before Flop (didn't bet)
Seat 8: iFoldN0T folded before Flop (didn't bet)
Seat 9: DomBagz folded before Flop (didn't bet)


*********** # 46 **************
PokerStars Hand #169313368927: Tournament #1597683884, $18.20+$1.80 USD=
 Hold'em No Limit - Level XIII (350/700) - 2017/05/02 21:18:29 ET
Table '1597683884 3' 9-max Seat #4 is the button
Seat 1: MyManPotnPan (32420 in chips)=20
Seat 2: JSkelts (14046 in chips)=20
Seat 4: JJin91 (39050 in chips)=20
Seat 5: jrollsup1 (26967 in chips)=20
Seat 6: hainesiv2 (11859 in chips)=20
Seat 7: dak1616 (8697 in chips)=20
Seat 8: iFoldN0T (14400 in chips)=20
Seat 9: DomBagz (20797 in chips)=20
MyManPotnPan: posts the ante 85
JSkelts: posts the ante 85
JJin91: posts the ante 85
jrollsup1: posts the ante 85
hainesiv2: posts the ante 85
dak1616: posts the ante 85
iFoldN0T: posts the ante 85
DomBagz: posts the ante 85
jrollsup1: posts small blind 350
hainesiv2: posts big blind 700
*** HOLE CARDS ***
Dealt to JJin91 [5h Ac]
dak1616: folds=20
iFoldN0T: raises 700 to 1400
DomBagz: folds=20
MyManPotnPan: folds=20
JSkelts: folds=20
JJin91: calls 1400
jrollsup1: folds=20
hainesiv2: folds=20
*** FLOP *** [Ts Ks Kh]
iFoldN0T: bets 1400
JJin91: folds=20
Uncalled bet (1400) returned to iFoldN0T
iFoldN0T collected 4530 from pot
iFoldN0T: doesn't show hand=20
*** SUMMARY ***
Total pot 4530 | Rake 0=20
Board [Ts Ks Kh]
Seat 1: MyManPotnPan folded before Flop (didn't bet)
Seat 2: JSkelts folded before Flop (didn't bet)
Seat 4: JJin91 (button) folded on the Flop
Seat 5: jrollsup1 (small blind) folded before Flop
Seat 6: hainesiv2 (big blind) folded before Flop
Seat 7: dak1616 folded before Flop (didn't bet)
Seat 8: iFoldN0T collected (4530)
Seat 9: DomBagz folded before Flop (didn't bet)


*********** # 47 **************
PokerStars Hand #169313369150: Tournament #1597683884, $18.20+$1.80 USD=
 Hold'em No Limit - Level XIII (350/700) - 2017/05/02 21:19:21 ET
Table '1597683884 3' 9-max Seat #5 is the button
Seat 1: MyManPotnPan (32335 in chips)=20
Seat 2: JSkelts (13961 in chips)=20
Seat 4: JJin91 (37565 in chips)=20
Seat 5: jrollsup1 (26532 in chips)=20
Seat 6: hainesiv2 (11074 in chips)=20
Seat 7: dak1616 (8612 in chips)=20
Seat 8: iFoldN0T (17445 in chips)=20
Seat 9: DomBagz (20712 in chips)=20
MyManPotnPan: posts the ante 85
JSkelts: posts the ante 85
JJin91: posts the ante 85
jrollsup1: posts the ante 85
hainesiv2: posts the ante 85
dak1616: posts the ante 85
iFoldN0T: posts the ante 85
DomBagz: posts the ante 85
hainesiv2: posts small blind 350
dak1616: posts big blind 700
*** HOLE CARDS ***
Dealt to JJin91 [Tc Js]
iFoldN0T: folds=20
DomBagz: folds=20
MyManPotnPan: raises 1400 to 2100
JSkelts: folds=20
JJin91: folds=20
jrollsup1: folds=20
hainesiv2: raises 8889 to 10989 and is all-in
dak1616: folds=20
MyManPotnPan: calls 8889
*** FLOP *** [9h 6d 8h]
*** TURN *** [9h 6d 8h] [2d]
*** RIVER *** [9h 6d 8h 2d] [8c]
*** SHOW DOWN ***
hainesiv2: shows [Jc Qh] (a pair of Eights)
MyManPotnPan: shows [Th Kh] (a pair of Eights - King kicker)
MyManPotnPan collected 23358 from pot
hainesiv2 finished the tournament in 46th place
*** SUMMARY ***
Total pot 23358 | Rake 0=20
Board [9h 6d 8h 2d 8c]
Seat 1: MyManPotnPan showed [Th Kh] and won (23358) with a pair of Eigh=
ts
Seat 2: JSkelts folded before Flop (didn't bet)
Seat 4: JJin91 folded before Flop (didn't bet)
Seat 5: jrollsup1 (button) folded before Flop (didn't bet)
Seat 6: hainesiv2 (small blind) showed [Jc Qh] and lost with a pair of =
Eights
Seat 7: dak1616 (big blind) folded before Flop
Seat 8: iFoldN0T folded before Flop (didn't bet)
Seat 9: DomBagz folded before Flop (didn't bet)


*********** # 48 **************
PokerStars Hand #169313369745: Tournament #1597683884, $18.20+$1.80 USD=
 Hold'em No Limit - Level XIII (350/700) - 2017/05/02 21:21:27 ET
Table '1597683884 2' 9-max Seat #6 is the button
Seat 1: Chark626 (20740 in chips)=20
Seat 2: Article332 (7650 in chips)=20
Seat 3: unjai (8391 in chips)=20
Seat 4: JJin91 (37480 in chips)=20
Seat 5: McCarnuts84 (11757 in chips)=20
Seat 6: Scooby-D0O (19300 in chips)=20
Seat 7: JonnyKakes59 (13240 in chips)=20
Seat 8: MyManPotnPan (44619 in chips)=20
Seat 9: Broker RR (29407 in chips)=20
Chark626: posts the ante 85
Article332: posts the ante 85
unjai: posts the ante 85
JJin91: posts the ante 85
McCarnuts84: posts the ante 85
Scooby-D0O: posts the ante 85
JonnyKakes59: posts the ante 85
MyManPotnPan: posts the ante 85
Broker RR: posts the ante 85
JonnyKakes59: posts small blind 350
MyManPotnPan: posts big blind 700
*** HOLE CARDS ***
Dealt to JJin91 [5h Qd]
Broker RR: folds=20
Chark626: folds=20
Article332: folds=20
unjai: folds=20
JJin91: folds=20
McCarnuts84: folds=20
Scooby-D0O: folds=20
JonnyKakes59: folds=20
Uncalled bet (350) returned to MyManPotnPan
MyManPotnPan collected 1465 from pot
MyManPotnPan: doesn't show hand=20
*** SUMMARY ***
Total pot 1465 | Rake 0=20
Seat 1: Chark626 folded before Flop (didn't bet)
Seat 2: Article332 folded before Flop (didn't bet)
Seat 3: unjai folded before Flop (didn't bet)
Seat 4: JJin91 folded before Flop (didn't bet)
Seat 5: McCarnuts84 folded before Flop (didn't bet)
Seat 6: Scooby-D0O (button) folded before Flop (didn't bet)
Seat 7: JonnyKakes59 (small blind) folded before Flop
Seat 8: MyManPotnPan (big blind) collected (1465)
Seat 9: Broker RR folded before Flop (didn't bet)


*********** # 49 **************
PokerStars Hand #169313369919: Tournament #1597683884, $18.20+$1.80 USD=
 Hold'em No Limit - Level XIV (400/800) - 2017/05/02 21:22:05 ET
Table '1597683884 2' 9-max Seat #7 is the button
Seat 1: Chark626 (20655 in chips)=20
Seat 2: Article332 (7565 in chips)=20
Seat 3: unjai (8306 in chips)=20
Seat 4: JJin91 (37395 in chips)=20
Seat 5: McCarnuts84 (11672 in chips)=20
Seat 6: Scooby-D0O (19215 in chips)=20
Seat 7: JonnyKakes59 (12805 in chips)=20
Seat 8: MyManPotnPan (45649 in chips)=20
Seat 9: Broker RR (29322 in chips)=20
Chark626: posts the ante 100
Article332: posts the ante 100
unjai: posts the ante 100
JJin91: posts the ante 100
McCarnuts84: posts the ante 100
Scooby-D0O: posts the ante 100
JonnyKakes59: posts the ante 100
MyManPotnPan: posts the ante 100
Broker RR: posts the ante 100
MyManPotnPan: posts small blind 400
Broker RR: posts big blind 800
*** HOLE CARDS ***
Dealt to JJin91 [6d 7s]
Chark626: folds=20
Article332: folds=20
unjai: folds=20
JJin91: folds=20
McCarnuts84: raises 10772 to 11572 and is all-in
Scooby-D0O: folds=20
JonnyKakes59: folds=20
MyManPotnPan: folds=20
Broker RR: folds=20
Uncalled bet (10772) returned to McCarnuts84
McCarnuts84 collected 2900 from pot
McCarnuts84: doesn't show hand=20
*** SUMMARY ***
Total pot 2900 | Rake 0=20
Seat 1: Chark626 folded before Flop (didn't bet)
Seat 2: Article332 folded before Flop (didn't bet)
Seat 3: unjai folded before Flop (didn't bet)
Seat 4: JJin91 folded before Flop (didn't bet)
Seat 5: McCarnuts84 collected (2900)
Seat 6: Scooby-D0O folded before Flop (didn't bet)
Seat 7: JonnyKakes59 (button) folded before Flop (didn't bet)
Seat 8: MyManPotnPan (small blind) folded before Flop
Seat 9: Broker RR (big blind) folded before Flop


*********** # 50 **************
PokerStars Hand #169315252062: Tournament #1597683884, $18.20+$1.80 USD=
 Hold'em No Limit - Level XIV (400/800) - 2017/05/02 21:22:36 ET
Table '1597683884 2' 9-max Seat #8 is the button
Seat 1: Chark626 (20555 in chips)=20
Seat 2: Article332 (7465 in chips)=20
Seat 3: unjai (8206 in chips)=20
Seat 4: JJin91 (37295 in chips)=20
Seat 5: McCarnuts84 (13672 in chips)=20
Seat 6: Scooby-D0O (19115 in chips)=20
Seat 7: JonnyKakes59 (12705 in chips)=20
Seat 8: MyManPotnPan (45149 in chips)=20
Seat 9: Broker RR (28422 in chips)=20
Chark626: posts the ante 100
Article332: posts the ante 100
unjai: posts the ante 100
JJin91: posts the ante 100
McCarnuts84: posts the ante 100
Scooby-D0O: posts the ante 100
JonnyKakes59: posts the ante 100
MyManPotnPan: posts the ante 100
Broker RR: posts the ante 100
Broker RR: posts small blind 400
Chark626: posts big blind 800
*** HOLE CARDS ***
Dealt to JJin91 [6h 9c]
Article332: folds=20
unjai: folds=20
JJin91: folds=20
McCarnuts84: folds=20
Scooby-D0O: folds=20
JonnyKakes59: raises 11805 to 12605 and is all-in
MyManPotnPan: folds=20
Broker RR: folds=20
Chark626: folds=20
Uncalled bet (11805) returned to JonnyKakes59
JonnyKakes59 collected 2900 from pot
JonnyKakes59: doesn't show hand=20
*** SUMMARY ***
Total pot 2900 | Rake 0=20
Seat 1: Chark626 (big blind) folded before Flop
Seat 2: Article332 folded before Flop (didn't bet)
Seat 3: unjai folded before Flop (didn't bet)
Seat 4: JJin91 folded before Flop (didn't bet)
Seat 5: McCarnuts84 folded before Flop (didn't bet)
Seat 6: Scooby-D0O folded before Flop (didn't bet)
Seat 7: JonnyKakes59 collected (2900)
Seat 8: MyManPotnPan (button) folded before Flop (didn't bet)
Seat 9: Broker RR (small blind) folded before Flop


*********** # 51 **************
PokerStars Hand #169315252233: Tournament #1597683884, $18.20+$1.80 USD=
 Hold'em No Limit - Level XIV (400/800) - 2017/05/02 21:23:12 ET
Table '1597683884 2' 9-max Seat #9 is the button
Seat 1: Chark626 (19655 in chips)=20
Seat 2: Article332 (7365 in chips)=20
Seat 3: unjai (8106 in chips)=20
Seat 4: JJin91 (37195 in chips)=20
Seat 5: McCarnuts84 (13572 in chips)=20
Seat 6: Scooby-D0O (19015 in chips)=20
Seat 7: JonnyKakes59 (14705 in chips)=20
Seat 8: MyManPotnPan (45049 in chips)=20
Seat 9: Broker RR (27922 in chips)=20
Chark626: posts the ante 100
Article332: posts the ante 100
unjai: posts the ante 100
JJin91: posts the ante 100
McCarnuts84: posts the ante 100
Scooby-D0O: posts the ante 100
JonnyKakes59: posts the ante 100
MyManPotnPan: posts the ante 100
Broker RR: posts the ante 100
Chark626: posts small blind 400
Article332: posts big blind 800
*** HOLE CARDS ***
Dealt to JJin91 [Ks 4s]
unjai: folds=20
JJin91: folds=20
McCarnuts84: folds=20
Scooby-D0O: folds=20
JonnyKakes59: folds=20
MyManPotnPan: folds=20
Broker RR: raises 27022 to 27822 and is all-in
Chark626: folds=20
Article332: folds=20
Uncalled bet (27022) returned to Broker RR
Broker RR collected 2900 from pot
Broker RR: doesn't show hand=20
*** SUMMARY ***
Total pot 2900 | Rake 0=20
Seat 1: Chark626 (small blind) folded before Flop
Seat 2: Article332 (big blind) folded before Flop
Seat 3: unjai folded before Flop (didn't bet)
Seat 4: JJin91 folded before Flop (didn't bet)
Seat 5: McCarnuts84 folded before Flop (didn't bet)
Seat 6: Scooby-D0O folded before Flop (didn't bet)
Seat 7: JonnyKakes59 folded before Flop (didn't bet)
Seat 8: MyManPotnPan folded before Flop (didn't bet)
Seat 9: Broker RR (button) collected (2900)


*********** # 52 **************
PokerStars Hand #169315252350: Tournament #1597683884, $18.20+$1.80 USD=
 Hold'em No Limit - Level XIV (400/800) - 2017/05/02 21:23:37 ET
Table '1597683884 2' 9-max Seat #1 is the button
Seat 1: Chark626 (19155 in chips)=20
Seat 2: Article332 (6465 in chips)=20
Seat 3: unjai (8006 in chips)=20
Seat 4: JJin91 (37095 in chips)=20
Seat 5: McCarnuts84 (13472 in chips)=20
Seat 6: Scooby-D0O (18915 in chips)=20
Seat 7: JonnyKakes59 (14605 in chips)=20
Seat 8: MyManPotnPan (44949 in chips)=20
Seat 9: Broker RR (29922 in chips)=20
Chark626: posts the ante 100
Article332: posts the ante 100
unjai: posts the ante 100
JJin91: posts the ante 100
McCarnuts84: posts the ante 100
Scooby-D0O: posts the ante 100
JonnyKakes59: posts the ante 100
MyManPotnPan: posts the ante 100
Broker RR: posts the ante 100
Article332: posts small blind 400
unjai: posts big blind 800
*** HOLE CARDS ***
Dealt to JJin91 [Qs 8h]
JJin91: folds=20
McCarnuts84: folds=20
Scooby-D0O: folds=20
JonnyKakes59: folds=20
MyManPotnPan: folds=20
Broker RR: folds=20
Chark626: folds=20
Article332: raises 5565 to 6365 and is all-in
unjai: folds=20
Uncalled bet (5565) returned to Article332
Article332 collected 2500 from pot
Article332: doesn't show hand=20
*** SUMMARY ***
Total pot 2500 | Rake 0=20
Seat 1: Chark626 (button) folded before Flop (didn't bet)
Seat 2: Article332 (small blind) collected (2500)
Seat 3: unjai (big blind) folded before Flop
Seat 4: JJin91 folded before Flop (didn't bet)
Seat 5: McCarnuts84 folded before Flop (didn't bet)
Seat 6: Scooby-D0O folded before Flop (didn't bet)
Seat 7: JonnyKakes59 folded before Flop (didn't bet)
Seat 8: MyManPotnPan folded before Flop (didn't bet)
Seat 9: Broker RR folded before Flop (didn't bet)


*********** # 53 **************
PokerStars Hand #169315252516: Tournament #1597683884, $18.20+$1.80 USD=
 Hold'em No Limit - Level XIV (400/800) - 2017/05/02 21:24:11 ET
Table '1597683884 2' 9-max Seat #2 is the button
Seat 1: Chark626 (19055 in chips)=20
Seat 2: Article332 (8065 in chips)=20
Seat 3: unjai (7106 in chips)=20
Seat 4: JJin91 (36995 in chips)=20
Seat 5: McCarnuts84 (13372 in chips)=20
Seat 6: Scooby-D0O (18815 in chips)=20
Seat 7: JonnyKakes59 (14505 in chips)=20
Seat 8: MyManPotnPan (44849 in chips)=20
Seat 9: Broker RR (29822 in chips)=20
Chark626: posts the ante 100
Article332: posts the ante 100
unjai: posts the ante 100
JJin91: posts the ante 100
McCarnuts84: posts the ante 100
Scooby-D0O: posts the ante 100
JonnyKakes59: posts the ante 100
MyManPotnPan: posts the ante 100
Broker RR: posts the ante 100
unjai: posts small blind 400
JJin91: posts big blind 800
*** HOLE CARDS ***
Dealt to JJin91 [Jh 9d]
McCarnuts84: folds=20
Scooby-D0O: folds=20
JonnyKakes59: raises 899 to 1699
MyManPotnPan: folds=20
Broker RR: folds=20
Chark626: calls 1699
Article332: raises 6266 to 7965 and is all-in
unjai: folds=20
JJin91: folds=20
JonnyKakes59: calls 6266
Chark626: folds=20
*** FLOP *** [7h Js 5d]
*** TURN *** [7h Js 5d] [9s]
*** RIVER *** [7h Js 5d 9s] [Qs]
*** SHOW DOWN ***
JonnyKakes59: shows [Kh As] (high card Ace)
Article332: shows [4d 4s] (a pair of Fours)
Article332 collected 19729 from pot
*** SUMMARY ***
Total pot 19729 | Rake 0=20
Board [7h Js 5d 9s Qs]
Seat 1: Chark626 folded before Flop
Seat 2: Article332 (button) showed [4d 4s] and won (19729) with a pair =
of Fours
Seat 3: unjai (small blind) folded before Flop
Seat 4: JJin91 (big blind) folded before Flop
Seat 5: McCarnuts84 folded before Flop (didn't bet)
Seat 6: Scooby-D0O folded before Flop (didn't bet)
Seat 7: JonnyKakes59 showed [Kh As] and lost with high card Ace
Seat 8: MyManPotnPan folded before Flop (didn't bet)
Seat 9: Broker RR folded before Flop (didn't bet)


*********** # 54 **************
PokerStars Hand #169315252752: Tournament #1597683884, $18.20+$1.80 USD=
 Hold'em No Limit - Level XIV (400/800) - 2017/05/02 21:25:00 ET
Table '1597683884 2' 9-max Seat #3 is the button
Seat 1: Chark626 (17256 in chips)=20
Seat 2: Article332 (19729 in chips)=20
Seat 3: unjai (6606 in chips)=20
Seat 4: JJin91 (36095 in chips)=20
Seat 5: McCarnuts84 (13272 in chips)=20
Seat 6: Scooby-D0O (18715 in chips)=20
Seat 7: JonnyKakes59 (6440 in chips)=20
Seat 8: MyManPotnPan (44749 in chips)=20
Seat 9: Broker RR (29722 in chips)=20
Chark626: posts the ante 100
Article332: posts the ante 100
unjai: posts the ante 100
JJin91: posts the ante 100
McCarnuts84: posts the ante 100
Scooby-D0O: posts the ante 100
JonnyKakes59: posts the ante 100
MyManPotnPan: posts the ante 100
Broker RR: posts the ante 100
JJin91: posts small blind 400
McCarnuts84: posts big blind 800
*** HOLE CARDS ***
Dealt to JJin91 [Kc 2c]
Scooby-D0O: folds=20
JonnyKakes59: raises 5540 to 6340 and is all-in
MyManPotnPan: folds=20
Broker RR: folds=20
Chark626: folds=20
Article332: folds=20
unjai: folds=20
JJin91: folds=20
McCarnuts84: folds=20
Uncalled bet (5540) returned to JonnyKakes59
JonnyKakes59 collected 2900 from pot
JonnyKakes59: doesn't show hand=20
*** SUMMARY ***
Total pot 2900 | Rake 0=20
Seat 1: Chark626 folded before Flop (didn't bet)
Seat 2: Article332 folded before Flop (didn't bet)
Seat 3: unjai (button) folded before Flop (didn't bet)
Seat 4: JJin91 (small blind) folded before Flop
Seat 5: McCarnuts84 (big blind) folded before Flop
Seat 6: Scooby-D0O folded before Flop (didn't bet)
Seat 7: JonnyKakes59 collected (2900)
Seat 8: MyManPotnPan folded before Flop (didn't bet)
Seat 9: Broker RR folded before Flop (didn't bet)


*********** # 55 **************
PokerStars Hand #169315252977: Tournament #1597683884, $18.20+$1.80 USD=
 Hold'em No Limit - Level XIV (400/800) - 2017/05/02 21:25:45 ET
Table '1597683884 2' 9-max Seat #4 is the button
Seat 1: Chark626 (17156 in chips)=20
Seat 2: Article332 (19629 in chips)=20
Seat 3: unjai (6506 in chips)=20
Seat 4: JJin91 (35595 in chips)=20
Seat 5: McCarnuts84 (12372 in chips)=20
Seat 6: Scooby-D0O (18615 in chips)=20
Seat 7: JonnyKakes59 (8440 in chips)=20
Seat 8: MyManPotnPan (44649 in chips)=20
Seat 9: Broker RR (29622 in chips)=20
Chark626: posts the ante 100
Article332: posts the ante 100
unjai: posts the ante 100
JJin91: posts the ante 100
McCarnuts84: posts the ante 100
Scooby-D0O: posts the ante 100
JonnyKakes59: posts the ante 100
MyManPotnPan: posts the ante 100
Broker RR: posts the ante 100
McCarnuts84: posts small blind 400
Scooby-D0O: posts big blind 800
*** HOLE CARDS ***
Dealt to JJin91 [3d 2d]
JonnyKakes59: folds=20
MyManPotnPan: folds=20
Broker RR: folds=20
Chark626: folds=20
Article332: folds=20
unjai has timed out
unjai: folds=20
unjai is sitting out
unjai has returned
JJin91: raises 1128 to 1928
McCarnuts84: calls 1528
Scooby-D0O: calls 1128
*** FLOP *** [Ac 8h 4c]
McCarnuts84: checks=20
Scooby-D0O: checks=20
JJin91: bets 2272
McCarnuts84: raises 3613 to 5885
Scooby-D0O: folds=20
JJin91: folds=20
Uncalled bet (3613) returned to McCarnuts84
McCarnuts84 collected 11228 from pot
McCarnuts84: doesn't show hand=20
*** SUMMARY ***
Total pot 11228 | Rake 0=20
Board [Ac 8h 4c]
Seat 1: Chark626 folded before Flop (didn't bet)
Seat 2: Article332 folded before Flop (didn't bet)
Seat 3: unjai folded before Flop (didn't bet)
Seat 4: JJin91 (button) folded on the Flop
Seat 5: McCarnuts84 (small blind) collected (11228)
Seat 6: Scooby-D0O (big blind) folded on the Flop
Seat 7: JonnyKakes59 folded before Flop (didn't bet)
Seat 8: MyManPotnPan folded before Flop (didn't bet)
Seat 9: Broker RR folded before Flop (didn't bet)


*********** # 56 **************
PokerStars Hand #169315253381: Tournament #1597683884, $18.20+$1.80 USD=
 Hold'em No Limit - Level XIV (400/800) - 2017/05/02 21:27:10 ET
Table '1597683884 2' 9-max Seat #5 is the button
Seat 1: Chark626 (17056 in chips)=20
Seat 2: Article332 (19529 in chips)=20
Seat 3: unjai (6406 in chips)=20
Seat 4: JJin91 (31295 in chips)=20
Seat 5: McCarnuts84 (19300 in chips)=20
Seat 6: Scooby-D0O (16587 in chips)=20
Seat 7: JonnyKakes59 (8340 in chips)=20
Seat 8: MyManPotnPan (44549 in chips)=20
Seat 9: Broker RR (29522 in chips)=20
Chark626: posts the ante 100
Article332: posts the ante 100
unjai: posts the ante 100
JJin91: posts the ante 100
McCarnuts84: posts the ante 100
Scooby-D0O: posts the ante 100
JonnyKakes59: posts the ante 100
MyManPotnPan: posts the ante 100
Broker RR: posts the ante 100
Scooby-D0O: posts small blind 400
JonnyKakes59: posts big blind 800
*** HOLE CARDS ***
Dealt to JJin91 [Td 7d]
MyManPotnPan: calls 800
Broker RR: folds=20
Chark626: folds=20
Article332: raises 800 to 1600
unjai: folds=20
JJin91: folds=20
McCarnuts84: folds=20
Scooby-D0O: folds=20
JonnyKakes59: folds=20
MyManPotnPan: calls 800
*** FLOP *** [2h 3h Tc]
MyManPotnPan: checks=20
Article332: checks=20
*** TURN *** [2h 3h Tc] [7s]
MyManPotnPan: bets 2650
Article332: calls 2650
*** RIVER *** [2h 3h Tc 7s] [6s]
MyManPotnPan: checks=20
Article332: checks=20
*** SHOW DOWN ***
MyManPotnPan: shows [5d 5h] (a pair of Fives)
Article332: mucks hand=20
MyManPotnPan collected 10600 from pot
*** SUMMARY ***
Total pot 10600 | Rake 0=20
Board [2h 3h Tc 7s 6s]
Seat 1: Chark626 folded before Flop (didn't bet)
Seat 2: Article332 mucked [Ac Ks]
Seat 3: unjai folded before Flop (didn't bet)
Seat 4: JJin91 folded before Flop (didn't bet)
Seat 5: McCarnuts84 (button) folded before Flop (didn't bet)
Seat 6: Scooby-D0O (small blind) folded before Flop
Seat 7: JonnyKakes59 (big blind) folded before Flop
Seat 8: MyManPotnPan showed [5d 5h] and won (10600) with a pair of Fives
Seat 9: Broker RR folded before Flop (didn't bet)


*********** # 57 **************
PokerStars Hand #169315253788: Tournament #1597683884, $18.20+$1.80 USD=
 Hold'em No Limit - Level XIV (400/800) - 2017/05/02 21:28:32 ET
Table '1597683884 2' 9-max Seat #6 is the button
Seat 1: Chark626 (16956 in chips)=20
Seat 2: Article332 (15179 in chips)=20
Seat 3: unjai (6306 in chips)=20
Seat 4: JJin91 (31195 in chips)=20
Seat 5: McCarnuts84 (19200 in chips)=20
Seat 6: Scooby-D0O (16087 in chips)=20
Seat 7: JonnyKakes59 (7440 in chips)=20
Seat 8: MyManPotnPan (50799 in chips)=20
Seat 9: Broker RR (29422 in chips)=20
Chark626: posts the ante 100
Article332: posts the ante 100
unjai: posts the ante 100
JJin91: posts the ante 100
McCarnuts84: posts the ante 100
Scooby-D0O: posts the ante 100
JonnyKakes59: posts the ante 100
MyManPotnPan: posts the ante 100
Broker RR: posts the ante 100
JonnyKakes59: posts small blind 400
MyManPotnPan: posts big blind 800
*** HOLE CARDS ***
Dealt to JJin91 [2c 9s]
Broker RR: folds=20
Chark626: folds=20
Article332: folds=20
unjai: folds=20
JJin91: folds=20
McCarnuts84: folds=20
Scooby-D0O: raises 1200 to 2000
JonnyKakes59: folds=20
MyManPotnPan: calls 1200
*** FLOP *** [Td 9c Jh]
MyManPotnPan: checks=20
Scooby-D0O: checks=20
*** TURN *** [Td 9c Jh] [9d]
MyManPotnPan: checks=20
Scooby-D0O: bets 1590
MyManPotnPan: folds=20
Uncalled bet (1590) returned to Scooby-D0O
Scooby-D0O collected 5300 from pot
*** SUMMARY ***
Total pot 5300 | Rake 0=20
Board [Td 9c Jh 9d]
Seat 1: Chark626 folded before Flop (didn't bet)
Seat 2: Article332 folded before Flop (didn't bet)
Seat 3: unjai folded before Flop (didn't bet)
Seat 4: JJin91 folded before Flop (didn't bet)
Seat 5: McCarnuts84 folded before Flop (didn't bet)
Seat 6: Scooby-D0O (button) collected (5300)
Seat 7: JonnyKakes59 (small blind) folded before Flop
Seat 8: MyManPotnPan (big blind) folded on the Turn
Seat 9: Broker RR folded before Flop (didn't bet)


*********** # 58 **************
PokerStars Hand #169315254162: Tournament #1597683884, $18.20+$1.80 USD=
 Hold'em No Limit - Level XIV (400/800) - 2017/05/02 21:29:44 ET
Table '1597683884 2' 9-max Seat #7 is the button
Seat 1: Chark626 (16856 in chips)=20
Seat 2: Article332 (15079 in chips)=20
Seat 3: unjai (6206 in chips)=20
Seat 4: JJin91 (31095 in chips)=20
Seat 5: McCarnuts84 (19100 in chips)=20
Seat 6: Scooby-D0O (19287 in chips)=20
Seat 7: JonnyKakes59 (6940 in chips)=20
Seat 8: MyManPotnPan (48699 in chips)=20
Seat 9: Broker RR (29322 in chips)=20
Chark626: posts the ante 100
Article332: posts the ante 100
unjai: posts the ante 100
JJin91: posts the ante 100
McCarnuts84: posts the ante 100
Scooby-D0O: posts the ante 100
JonnyKakes59: posts the ante 100
MyManPotnPan: posts the ante 100
Broker RR: posts the ante 100
MyManPotnPan: posts small blind 400
Broker RR: posts big blind 800
*** HOLE CARDS ***
Dealt to JJin91 [7h 8h]
Chark626: calls 800
Article332: folds=20
unjai: folds=20
JJin91: folds=20
McCarnuts84: folds=20
Scooby-D0O: folds=20
JonnyKakes59: folds=20
MyManPotnPan: calls 400
Broker RR: checks=20
*** FLOP *** [5d Ks 6c]
MyManPotnPan: checks=20
Broker RR: checks=20
Chark626: checks=20
*** TURN *** [5d Ks 6c] [8d]
MyManPotnPan: bets 800
Broker RR: calls 800
Chark626: folds=20
*** RIVER *** [5d Ks 6c 8d] [7d]
MyManPotnPan: checks=20
Broker RR: checks=20
*** SHOW DOWN ***
MyManPotnPan: shows [7c Qh] (a pair of Sevens)
Broker RR: shows [8c Jh] (a pair of Eights)
Broker RR collected 4900 from pot
*** SUMMARY ***
Total pot 4900 | Rake 0=20
Board [5d Ks 6c 8d 7d]
Seat 1: Chark626 folded on the Turn
Seat 2: Article332 folded before Flop (didn't bet)
Seat 3: unjai folded before Flop (didn't bet)
Seat 4: JJin91 folded before Flop (didn't bet)
Seat 5: McCarnuts84 folded before Flop (didn't bet)
Seat 6: Scooby-D0O folded before Flop (didn't bet)
Seat 7: JonnyKakes59 (button) folded before Flop (didn't bet)
Seat 8: MyManPotnPan (small blind) showed [7c Qh] and lost with a pair =
of Sevens
Seat 9: Broker RR (big blind) showed [8c Jh] and won (4900) with a pair=
 of Eights


*********** # 59 **************
PokerStars Hand #169315254505: Tournament #1597683884, $18.20+$1.80 USD=
 Hold'em No Limit - Level XIV (400/800) - 2017/05/02 21:31:01 ET
Table '1597683884 2' 9-max Seat #8 is the button
Seat 1: Chark626 (15956 in chips)=20
Seat 2: Article332 (14979 in chips)=20
Seat 3: unjai (6106 in chips)=20
Seat 4: JJin91 (30995 in chips)=20
Seat 5: McCarnuts84 (19000 in chips)=20
Seat 6: Scooby-D0O (19187 in chips)=20
Seat 7: JonnyKakes59 (6840 in chips)=20
Seat 8: MyManPotnPan (46999 in chips)=20
Seat 9: Broker RR (32522 in chips)=20
Chark626: posts the ante 100
Article332: posts the ante 100
unjai: posts the ante 100
JJin91: posts the ante 100
McCarnuts84: posts the ante 100
Scooby-D0O: posts the ante 100
JonnyKakes59: posts the ante 100
MyManPotnPan: posts the ante 100
Broker RR: posts the ante 100
Broker RR: posts small blind 400
Chark626: posts big blind 800
*** HOLE CARDS ***
Dealt to JJin91 [3c Ks]
Article332: folds=20
unjai: folds=20
JJin91: folds=20
McCarnuts84: raises 1400 to 2200
Scooby-D0O: folds=20
JonnyKakes59: raises 4540 to 6740 and is all-in
MyManPotnPan: folds=20
Broker RR: folds=20
Chark626: folds=20
McCarnuts84: calls 4540
*** FLOP *** [Kd 6h 7h]
*** TURN *** [Kd 6h 7h] [2s]
*** RIVER *** [Kd 6h 7h 2s] [5d]
*** SHOW DOWN ***
McCarnuts84: shows [8s Ts] (high card King)
JonnyKakes59: shows [9c 9s] (a pair of Nines)
JonnyKakes59 collected 15580 from pot
*** SUMMARY ***
Total pot 15580 | Rake 0=20
Board [Kd 6h 7h 2s 5d]
Seat 1: Chark626 (big blind) folded before Flop
Seat 2: Article332 folded before Flop (didn't bet)
Seat 3: unjai folded before Flop (didn't bet)
Seat 4: JJin91 folded before Flop (didn't bet)
Seat 5: McCarnuts84 showed [8s Ts] and lost with high card King
Seat 6: Scooby-D0O folded before Flop (didn't bet)
Seat 7: JonnyKakes59 showed [9c 9s] and won (15580) with a pair of Nines
Seat 8: MyManPotnPan (button) folded before Flop (didn't bet)
Seat 9: Broker RR (small blind) folded before Flop


*********** # 60 **************
PokerStars Hand #169315254654: Tournament #1597683884, $18.20+$1.80 USD=
 Hold'em No Limit - Level XIV (400/800) - 2017/05/02 21:31:34 ET
Table '1597683884 2' 9-max Seat #9 is the button
Seat 1: Chark626 (15056 in chips)=20
Seat 2: Article332 (14879 in chips)=20
Seat 3: unjai (6006 in chips)=20
Seat 4: JJin91 (30895 in chips)=20
Seat 5: McCarnuts84 (12160 in chips)=20
Seat 6: Scooby-D0O (19087 in chips)=20
Seat 7: JonnyKakes59 (15580 in chips)=20
Seat 8: MyManPotnPan (46899 in chips)=20
Seat 9: Broker RR (32022 in chips)=20
Chark626: posts the ante 100
Article332: posts the ante 100
unjai: posts the ante 100
JJin91: posts the ante 100
McCarnuts84: posts the ante 100
Scooby-D0O: posts the ante 100
JonnyKakes59: posts the ante 100
MyManPotnPan: posts the ante 100
Broker RR: posts the ante 100
Chark626: posts small blind 400
Article332: posts big blind 800
*** HOLE CARDS ***
Dealt to JJin91 [6d Ac]
unjai: folds=20
JJin91: folds=20
McCarnuts84: folds=20
Scooby-D0O: raises 1200 to 2000
JonnyKakes59: folds=20
MyManPotnPan: folds=20
Broker RR: folds=20
Chark626: folds=20
Article332: calls 1200
*** FLOP *** [3s 8h 9d]
Article332: checks=20
Scooby-D0O: bets 1590
Article332: folds=20
Uncalled bet (1590) returned to Scooby-D0O
Scooby-D0O collected 5300 from pot
*** SUMMARY ***
Total pot 5300 | Rake 0=20
Board [3s 8h 9d]
Seat 1: Chark626 (small blind) folded before Flop
Seat 2: Article332 (big blind) folded on the Flop
Seat 3: unjai folded before Flop (didn't bet)
Seat 4: JJin91 folded before Flop (didn't bet)
Seat 5: McCarnuts84 folded before Flop (didn't bet)
Seat 6: Scooby-D0O collected (5300)
Seat 7: JonnyKakes59 folded before Flop (didn't bet)
Seat 8: MyManPotnPan folded before Flop (didn't bet)
Seat 9: Broker RR (button) folded before Flop (didn't bet)


*********** # 61 **************
PokerStars Hand #169315254967: Tournament #1597683884, $18.20+$1.80 USD=
 Hold'em No Limit - Level XV (500/1000) - 2017/05/02 21:32:41 ET
Table '1597683884 2' 9-max Seat #2 is the button
Seat 2: Article332 (12779 in chips)=20
Seat 3: unjai (5906 in chips)=20
Seat 4: JJin91 (30795 in chips)=20
Seat 5: McCarnuts84 (12060 in chips)=20
Seat 6: Scooby-D0O (22287 in chips)=20
Seat 7: JonnyKakes59 (15480 in chips)=20
Seat 8: MyManPotnPan (46799 in chips)=20
Seat 9: Broker RR (31922 in chips)=20
Article332: posts the ante 125
unjai: posts the ante 125
JJin91: posts the ante 125
McCarnuts84: posts the ante 125
Scooby-D0O: posts the ante 125
JonnyKakes59: posts the ante 125
MyManPotnPan: posts the ante 125
Broker RR: posts the ante 125
unjai: posts small blind 500
JJin91: posts big blind 1000
*** HOLE CARDS ***
Dealt to JJin91 [Ah 7h]
McCarnuts84: folds=20
Scooby-D0O: folds=20
JonnyKakes59: folds=20
MyManPotnPan: folds=20
Broker RR: folds=20
Article332: raises 11654 to 12654 and is all-in
unjai: folds=20
JJin91 has timed out
JJin91: folds=20
Uncalled bet (11654) returned to Article332
JJin91 is sitting out
Article332 collected 3500 from pot
Article332: doesn't show hand=20
*** SUMMARY ***
Total pot 3500 | Rake 0=20
Seat 2: Article332 (button) collected (3500)
Seat 3: unjai (small blind) folded before Flop
Seat 4: JJin91 (big blind) folded before Flop
Seat 5: McCarnuts84 folded before Flop (didn't bet)
Seat 6: Scooby-D0O folded before Flop (didn't bet)
Seat 7: JonnyKakes59 folded before Flop (didn't bet)
Seat 8: MyManPotnPan folded before Flop (didn't bet)
Seat 9: Broker RR folded before Flop (didn't bet)


*********** # 62 **************
PokerStars Hand #169315255181: Tournament #1597683884, $18.20+$1.80 USD=
 Hold'em No Limit - Level XV (500/1000) - 2017/05/02 21:33:30 ET
Table '1597683884 2' 9-max Seat #3 is the button
Seat 2: Article332 (15154 in chips)=20
Seat 3: unjai (5281 in chips)=20
Seat 4: JJin91 (29670 in chips) is sitting out
Seat 5: McCarnuts84 (11935 in chips)=20
Seat 6: Scooby-D0O (22162 in chips)=20
Seat 7: JonnyKakes59 (15355 in chips)=20
Seat 8: MyManPotnPan (46674 in chips)=20
Seat 9: Broker RR (31797 in chips)=20
Article332: posts the ante 125
unjai: posts the ante 125
JJin91: posts the ante 125
McCarnuts84: posts the ante 125
Scooby-D0O: posts the ante 125
JonnyKakes59: posts the ante 125
MyManPotnPan: posts the ante 125
Broker RR: posts the ante 125
JJin91: posts small blind 500
McCarnuts84: posts big blind 1000
*** HOLE CARDS ***
Dealt to JJin91 [2h Jd]
JJin91 has returned
Scooby-D0O: raises 1500 to 2500
JonnyKakes59: folds=20
MyManPotnPan: folds=20
Broker RR: folds=20
Article332: folds=20
unjai: folds=20
JJin91: folds=20
McCarnuts84: calls 1500
*** FLOP *** [Kh 7h 5d]
McCarnuts84: checks=20
Scooby-D0O: checks=20
*** TURN *** [Kh 7h 5d] [5s]
McCarnuts84: bets 4000
Scooby-D0O: folds=20
Uncalled bet (4000) returned to McCarnuts84
McCarnuts84 collected 6500 from pot
McCarnuts84: doesn't show hand=20
*** SUMMARY ***
Total pot 6500 | Rake 0=20
Board [Kh 7h 5d 5s]
Seat 2: Article332 folded before Flop (didn't bet)
Seat 3: unjai (button) folded before Flop (didn't bet)
Seat 4: JJin91 (small blind) folded before Flop
Seat 5: McCarnuts84 (big blind) collected (6500)
Seat 6: Scooby-D0O folded on the Turn
Seat 7: JonnyKakes59 folded before Flop (didn't bet)
Seat 8: MyManPotnPan folded before Flop (didn't bet)
Seat 9: Broker RR folded before Flop (didn't bet)


*********** # 63 **************
PokerStars Hand #169315255542: Tournament #1597683884, $18.20+$1.80 USD=
 Hold'em No Limit - Level XV (500/1000) - 2017/05/02 21:34:46 ET
Table '1597683884 2' 9-max Seat #4 is the button
Seat 2: Article332 (15029 in chips)=20
Seat 3: unjai (5156 in chips)=20
Seat 4: JJin91 (29045 in chips)=20
Seat 5: McCarnuts84 (15810 in chips)=20
Seat 6: Scooby-D0O (19537 in chips)=20
Seat 7: JonnyKakes59 (15230 in chips)=20
Seat 8: MyManPotnPan (46549 in chips)=20
Seat 9: Broker RR (31672 in chips)=20
Article332: posts the ante 125
unjai: posts the ante 125
JJin91: posts the ante 125
McCarnuts84: posts the ante 125
Scooby-D0O: posts the ante 125
JonnyKakes59: posts the ante 125
MyManPotnPan: posts the ante 125
Broker RR: posts the ante 125
McCarnuts84: posts small blind 500
Scooby-D0O: posts big blind 1000
*** HOLE CARDS ***
Dealt to JJin91 [7c 5s]
JonnyKakes59: folds=20
MyManPotnPan: folds=20
Broker RR: raises 1000 to 2000
Article332: folds=20
unjai: folds=20
JJin91: folds=20
McCarnuts84: folds=20
Scooby-D0O: calls 1000
*** FLOP *** [9c 8d 3s]
Scooby-D0O: checks=20
Broker RR: checks=20
*** TURN *** [9c 8d 3s] [9h]
Scooby-D0O: bets 1650
Broker RR: calls 1650
*** RIVER *** [9c 8d 3s 9h] [Ah]
Scooby-D0O: bets 7000
Broker RR: folds=20
Uncalled bet (7000) returned to Scooby-D0O
Scooby-D0O collected 8800 from pot
*** SUMMARY ***
Total pot 8800 | Rake 0=20
Board [9c 8d 3s 9h Ah]
Seat 2: Article332 folded before Flop (didn't bet)
Seat 3: unjai folded before Flop (didn't bet)
Seat 4: JJin91 (button) folded before Flop (didn't bet)
Seat 5: McCarnuts84 (small blind) folded before Flop
Seat 6: Scooby-D0O (big blind) collected (8800)
Seat 7: JonnyKakes59 folded before Flop (didn't bet)
Seat 8: MyManPotnPan folded before Flop (didn't bet)
Seat 9: Broker RR folded on the River


*********** # 64 **************
PokerStars Hand #169315255849: Tournament #1597683884, $18.20+$1.80 USD=
 Hold'em No Limit - Level XV (500/1000) - 2017/05/02 21:35:49 ET
Table '1597683884 2' 9-max Seat #5 is the button
Seat 2: Article332 (14904 in chips)=20
Seat 3: unjai (5031 in chips)=20
Seat 4: JJin91 (28920 in chips)=20
Seat 5: McCarnuts84 (15185 in chips)=20
Seat 6: Scooby-D0O (24562 in chips)=20
Seat 7: JonnyKakes59 (15105 in chips)=20
Seat 8: MyManPotnPan (46424 in chips)=20
Seat 9: Broker RR (27897 in chips)=20
Article332: posts the ante 125
unjai: posts the ante 125
JJin91: posts the ante 125
McCarnuts84: posts the ante 125
Scooby-D0O: posts the ante 125
JonnyKakes59: posts the ante 125
MyManPotnPan: posts the ante 125
Broker RR: posts the ante 125
Scooby-D0O: posts small blind 500
JonnyKakes59: posts big blind 1000
*** HOLE CARDS ***
Dealt to JJin91 [Kc 9h]
MyManPotnPan: folds=20
Broker RR: folds=20
Article332: folds=20
unjai: folds=20
JJin91: folds=20
McCarnuts84: raises 2500 to 3500
Scooby-D0O: folds=20
JonnyKakes59: folds=20
Uncalled bet (2500) returned to McCarnuts84
McCarnuts84 collected 3500 from pot
McCarnuts84: doesn't show hand=20
*** SUMMARY ***
Total pot 3500 | Rake 0=20
Seat 2: Article332 folded before Flop (didn't bet)
Seat 3: unjai folded before Flop (didn't bet)
Seat 4: JJin91 folded before Flop (didn't bet)
Seat 5: McCarnuts84 (button) collected (3500)
Seat 6: Scooby-D0O (small blind) folded before Flop
Seat 7: JonnyKakes59 (big blind) folded before Flop
Seat 8: MyManPotnPan folded before Flop (didn't bet)
Seat 9: Broker RR folded before Flop (didn't bet)


*********** # 65 **************
PokerStars Hand #169315256077: Tournament #1597683884, $18.20+$1.80 USD=
 Hold'em No Limit - Level XV (500/1000) - 2017/05/02 21:36:33 ET
Table '1597683884 2' 9-max Seat #6 is the button
Seat 2: Article332 (14779 in chips)=20
Seat 3: unjai (4906 in chips)=20
Seat 4: JJin91 (28795 in chips)=20
Seat 5: McCarnuts84 (17560 in chips)=20
Seat 6: Scooby-D0O (23937 in chips)=20
Seat 7: JonnyKakes59 (13980 in chips)=20
Seat 8: MyManPotnPan (46299 in chips)=20
Seat 9: Broker RR (27772 in chips)=20
Article332: posts the ante 125
unjai: posts the ante 125
JJin91: posts the ante 125
McCarnuts84: posts the ante 125
Scooby-D0O: posts the ante 125
JonnyKakes59: posts the ante 125
MyManPotnPan: posts the ante 125
Broker RR: posts the ante 125
JonnyKakes59: posts small blind 500
MyManPotnPan: posts big blind 1000
*** HOLE CARDS ***
Dealt to JJin91 [6c 2s]
Broker RR: folds=20
Article332: folds=20
unjai: folds=20
JJin91: folds=20
McCarnuts84: folds=20
Scooby-D0O: raises 1500 to 2500
JonnyKakes59: folds=20
MyManPotnPan: folds=20
Uncalled bet (1500) returned to Scooby-D0O
Scooby-D0O collected 3500 from pot
*** SUMMARY ***
Total pot 3500 | Rake 0=20
Seat 2: Article332 folded before Flop (didn't bet)
Seat 3: unjai folded before Flop (didn't bet)
Seat 4: JJin91 folded before Flop (didn't bet)
Seat 5: McCarnuts84 folded before Flop (didn't bet)
Seat 6: Scooby-D0O (button) collected (3500)
Seat 7: JonnyKakes59 (small blind) folded before Flop
Seat 8: MyManPotnPan (big blind) folded before Flop
Seat 9: Broker RR folded before Flop (didn't bet)


*********** # 66 **************
PokerStars Hand #169315256208: Tournament #1597683884, $18.20+$1.80 USD=
 Hold'em No Limit - Level XV (500/1000) - 2017/05/02 21:37:05 ET
Table '1597683884 2' 9-max Seat #7 is the button
Seat 2: Article332 (14654 in chips)=20
Seat 3: unjai (4781 in chips)=20
Seat 4: JJin91 (28670 in chips)=20
Seat 5: McCarnuts84 (17435 in chips)=20
Seat 6: Scooby-D0O (26312 in chips)=20
Seat 7: JonnyKakes59 (13355 in chips)=20
Seat 8: MyManPotnPan (45174 in chips)=20
Seat 9: Broker RR (27647 in chips)=20
Article332: posts the ante 125
unjai: posts the ante 125
JJin91: posts the ante 125
McCarnuts84: posts the ante 125
Scooby-D0O: posts the ante 125
JonnyKakes59: posts the ante 125
MyManPotnPan: posts the ante 125
Broker RR: posts the ante 125
MyManPotnPan: posts small blind 500
Broker RR: posts big blind 1000
*** HOLE CARDS ***
Dealt to JJin91 [Jd 9d]
Article332: raises 13529 to 14529 and is all-in
unjai: folds=20
JJin91: folds=20
McCarnuts84: folds=20
Scooby-D0O: folds=20
JonnyKakes59: folds=20
MyManPotnPan: folds=20
Broker RR: folds=20
Uncalled bet (13529) returned to Article332
Article332 collected 3500 from pot
Article332: doesn't show hand=20
*** SUMMARY ***
Total pot 3500 | Rake 0=20
Seat 2: Article332 collected (3500)
Seat 3: unjai folded before Flop (didn't bet)
Seat 4: JJin91 folded before Flop (didn't bet)
Seat 5: McCarnuts84 folded before Flop (didn't bet)
Seat 6: Scooby-D0O folded before Flop (didn't bet)
Seat 7: JonnyKakes59 (button) folded before Flop (didn't bet)
Seat 8: MyManPotnPan (small blind) folded before Flop
Seat 9: Broker RR (big blind) folded before Flop


*********** # 67 **************
PokerStars Hand #169315256337: Tournament #1597683884, $18.20+$1.80 USD=
 Hold'em No Limit - Level XV (500/1000) - 2017/05/02 21:37:32 ET
Table '1597683884 2' 9-max Seat #8 is the button
Seat 2: Article332 (17029 in chips)=20
Seat 3: unjai (4656 in chips)=20
Seat 4: JJin91 (28545 in chips)=20
Seat 5: McCarnuts84 (17310 in chips)=20
Seat 6: Scooby-D0O (26187 in chips)=20
Seat 7: JonnyKakes59 (13230 in chips)=20
Seat 8: MyManPotnPan (44549 in chips)=20
Seat 9: Broker RR (26522 in chips)=20
Article332: posts the ante 125
unjai: posts the ante 125
JJin91: posts the ante 125
McCarnuts84: posts the ante 125
Scooby-D0O: posts the ante 125
JonnyKakes59: posts the ante 125
MyManPotnPan: posts the ante 125
Broker RR: posts the ante 125
Broker RR: posts small blind 500
Article332: posts big blind 1000
*** HOLE CARDS ***
Dealt to JJin91 [7s 3d]
unjai: folds=20
JJin91: folds=20
McCarnuts84: folds=20
Scooby-D0O: raises 1500 to 2500
JonnyKakes59: raises 10605 to 13105 and is all-in
MyManPotnPan: folds=20
Broker RR: raises 13292 to 26397 and is all-in
Article332: folds=20
Scooby-D0O: folds=20
Uncalled bet (13292) returned to Broker RR
*** FLOP *** [Ac 6h 8s]
*** TURN *** [Ac 6h 8s] [4h]
*** RIVER *** [Ac 6h 8s 4h] [Kh]
*** SHOW DOWN ***
Broker RR: shows [Ad Ks] (two pair, Aces and Kings)
JonnyKakes59: shows [6s 6c] (three of a kind, Sixes)
JonnyKakes59 collected 30710 from pot
*** SUMMARY ***
Total pot 30710 | Rake 0=20
Board [Ac 6h 8s 4h Kh]
Seat 2: Article332 (big blind) folded before Flop
Seat 3: unjai folded before Flop (didn't bet)
Seat 4: JJin91 folded before Flop (didn't bet)
Seat 5: McCarnuts84 folded before Flop (didn't bet)
Seat 6: Scooby-D0O folded before Flop
Seat 7: JonnyKakes59 showed [6s 6c] and won (30710) with three of a kin=
d, Sixes
Seat 8: MyManPotnPan (button) folded before Flop (didn't bet)
Seat 9: Broker RR (small blind) showed [Ad Ks] and lost with two pair, =
Aces and Kings


*********** # 68 **************
PokerStars Hand #169315256546: Tournament #1597683884, $18.20+$1.80 USD=
 Hold'em No Limit - Level XV (500/1000) - 2017/05/02 21:38:13 ET
Table '1597683884 2' 9-max Seat #9 is the button
Seat 2: Article332 (15904 in chips)=20
Seat 3: unjai (4531 in chips)=20
Seat 4: JJin91 (28420 in chips)=20
Seat 5: McCarnuts84 (17185 in chips)=20
Seat 6: Scooby-D0O (23562 in chips)=20
Seat 7: JonnyKakes59 (30710 in chips)=20
Seat 8: MyManPotnPan (44424 in chips)=20
Seat 9: Broker RR (13292 in chips)=20
Article332: posts the ante 125
unjai: posts the ante 125
JJin91: posts the ante 125
McCarnuts84: posts the ante 125
Scooby-D0O: posts the ante 125
JonnyKakes59: posts the ante 125
MyManPotnPan: posts the ante 125
Broker RR: posts the ante 125
Article332: posts small blind 500
unjai: posts big blind 1000
*** HOLE CARDS ***
Dealt to JJin91 [2s Kh]
JJin91: folds=20
McCarnuts84: raises 2500 to 3500
Scooby-D0O: folds=20
JonnyKakes59: folds=20
MyManPotnPan: folds=20
Broker RR: folds=20
Article332: folds=20
unjai: folds=20
Uncalled bet (2500) returned to McCarnuts84
McCarnuts84 collected 3500 from pot
McCarnuts84: doesn't show hand=20
*** SUMMARY ***
Total pot 3500 | Rake 0=20
Seat 2: Article332 (small blind) folded before Flop
Seat 3: unjai (big blind) folded before Flop
Seat 4: JJin91 folded before Flop (didn't bet)
Seat 5: McCarnuts84 collected (3500)
Seat 6: Scooby-D0O folded before Flop (didn't bet)
Seat 7: JonnyKakes59 folded before Flop (didn't bet)
Seat 8: MyManPotnPan folded before Flop (didn't bet)
Seat 9: Broker RR (button) folded before Flop (didn't bet)


*********** # 69 **************
PokerStars Hand #169315256725: Tournament #1597683884, $18.20+$1.80 USD=
 Hold'em No Limit - Level XV (500/1000) - 2017/05/02 21:38:50 ET
Table '1597683884 2' 9-max Seat #2 is the button
Seat 1: jrollsup1 (34217 in chips)=20
Seat 2: Article332 (15279 in chips)=20
Seat 3: unjai (3406 in chips)=20
Seat 4: JJin91 (28295 in chips)=20
Seat 5: McCarnuts84 (19560 in chips)=20
Seat 6: Scooby-D0O (23437 in chips)=20
Seat 7: JonnyKakes59 (30585 in chips)=20
Seat 8: MyManPotnPan (44299 in chips)=20
Seat 9: Broker RR (13167 in chips)=20
jrollsup1: posts the ante 125
Article332: posts the ante 125
unjai: posts the ante 125
JJin91: posts the ante 125
McCarnuts84: posts the ante 125
Scooby-D0O: posts the ante 125
JonnyKakes59: posts the ante 125
MyManPotnPan: posts the ante 125
Broker RR: posts the ante 125
unjai: posts small blind 500
JJin91: posts big blind 1000
*** HOLE CARDS ***
Dealt to JJin91 [Ks 2h]
McCarnuts84: folds=20
Scooby-D0O: raises 1500 to 2500
JonnyKakes59: folds=20
MyManPotnPan: folds=20
Broker RR: folds=20
jrollsup1: folds=20
Article332: calls 2500
unjai: raises 781 to 3281 and is all-in
JJin91: folds=20
Scooby-D0O: calls 781
Article332: calls 781
*** FLOP *** [Jd As 5h]
Scooby-D0O: checks=20
Article332: checks=20
*** TURN *** [Jd As 5h] [Jh]
Scooby-D0O: checks=20
Article332: bets 11873 and is all-in
Scooby-D0O: folds=20
Uncalled bet (11873) returned to Article332
*** RIVER *** [Jd As 5h Jh] [Tc]
*** SHOW DOWN ***
unjai: shows [Ad Kd] (two pair, Aces and Jacks)
Article332: shows [Qs Kh] (a straight, Ten to Ace)
Article332 collected 11968 from pot
unjai finished the tournament in 36th place
*** SUMMARY ***
Total pot 11968 | Rake 0=20
Board [Jd As 5h Jh Tc]
Seat 1: jrollsup1 folded before Flop (didn't bet)
Seat 2: Article332 (button) showed [Qs Kh] and won (11968) with a strai=
ght, Ten to Ace
Seat 3: unjai (small blind) showed [Ad Kd] and lost with two pair, Aces=
 and Jacks
Seat 4: JJin91 (big blind) folded before Flop
Seat 5: McCarnuts84 folded before Flop (didn't bet)
Seat 6: Scooby-D0O folded on the Turn
Seat 7: JonnyKakes59 folded before Flop (didn't bet)
Seat 8: MyManPotnPan folded before Flop (didn't bet)
Seat 9: Broker RR folded before Flop (didn't bet)


*********** # 70 **************
PokerStars Hand #169315257098: Tournament #1597683884, $18.20+$1.80 USD=
 Hold'em No Limit - Level XV (500/1000) - 2017/05/02 21:40:07 ET
Table '1597683884 2' 9-max Seat #4 is the button
Seat 1: jrollsup1 (34092 in chips)=20
Seat 2: Article332 (23841 in chips)=20
Seat 4: JJin91 (27170 in chips)=20
Seat 5: McCarnuts84 (19435 in chips)=20
Seat 6: Scooby-D0O (20031 in chips)=20
Seat 7: JonnyKakes59 (30460 in chips)=20
Seat 8: MyManPotnPan (44174 in chips)=20
Seat 9: Broker RR (13042 in chips)=20
jrollsup1: posts the ante 125
Article332: posts the ante 125
JJin91: posts the ante 125
McCarnuts84: posts the ante 125
Scooby-D0O: posts the ante 125
JonnyKakes59: posts the ante 125
MyManPotnPan: posts the ante 125
Broker RR: posts the ante 125
McCarnuts84: posts small blind 500
Scooby-D0O: posts big blind 1000
*** HOLE CARDS ***
Dealt to JJin91 [Tc Jh]
JonnyKakes59: folds=20
MyManPotnPan: folds=20
Broker RR: folds=20
jrollsup1: folds=20
Article332: folds=20
JJin91: raises 1110 to 2110
McCarnuts84: folds=20
Scooby-D0O: calls 1110
*** FLOP *** [9d 5c Qh]
Scooby-D0O: checks=20
JJin91: bets 2612
Scooby-D0O: calls 2612
*** TURN *** [9d 5c Qh] [2d]
Scooby-D0O: checks=20
JJin91: bets 7851
Scooby-D0O: folds=20
Uncalled bet (7851) returned to JJin91
JJin91 collected 10944 from pot
JJin91: doesn't show hand=20
*** SUMMARY ***
Total pot 10944 | Rake 0=20
Board [9d 5c Qh 2d]
Seat 1: jrollsup1 folded before Flop (didn't bet)
Seat 2: Article332 folded before Flop (didn't bet)
Seat 4: JJin91 (button) collected (10944)
Seat 5: McCarnuts84 (small blind) folded before Flop
Seat 6: Scooby-D0O (big blind) folded on the Turn
Seat 7: JonnyKakes59 folded before Flop (didn't bet)
Seat 8: MyManPotnPan folded before Flop (didn't bet)
Seat 9: Broker RR folded before Flop (didn't bet)


*********** # 71 **************
PokerStars Hand #169315257594: Tournament #1597683884, $18.20+$1.80 USD=
 Hold'em No Limit - Level XV (500/1000) - 2017/05/02 21:41:39 ET
Table '1597683884 2' 9-max Seat #5 is the button
Seat 1: jrollsup1 (33967 in chips)=20
Seat 2: Article332 (23716 in chips)=20
Seat 4: JJin91 (33267 in chips)=20
Seat 5: McCarnuts84 (18810 in chips)=20
Seat 6: Scooby-D0O (15184 in chips)=20
Seat 7: JonnyKakes59 (30335 in chips)=20
Seat 8: MyManPotnPan (44049 in chips)=20
Seat 9: Broker RR (12917 in chips)=20
jrollsup1: posts the ante 125
Article332: posts the ante 125
JJin91: posts the ante 125
McCarnuts84: posts the ante 125
Scooby-D0O: posts the ante 125
JonnyKakes59: posts the ante 125
MyManPotnPan: posts the ante 125
Broker RR: posts the ante 125
Scooby-D0O: posts small blind 500
JonnyKakes59: posts big blind 1000
*** HOLE CARDS ***
Dealt to JJin91 [Qh Jd]
MyManPotnPan: folds=20
Broker RR: folds=20
jrollsup1: folds=20
Article332: folds=20
JJin91: raises 1110 to 2110
McCarnuts84: folds=20
Scooby-D0O: folds=20
JonnyKakes59: folds=20
Uncalled bet (1110) returned to JJin91
JJin91 collected 3500 from pot
JJin91: doesn't show hand=20
*** SUMMARY ***
Total pot 3500 | Rake 0=20
Seat 1: jrollsup1 folded before Flop (didn't bet)
Seat 2: Article332 folded before Flop (didn't bet)
Seat 4: JJin91 collected (3500)
Seat 5: McCarnuts84 (button) folded before Flop (didn't bet)
Seat 6: Scooby-D0O (small blind) folded before Flop
Seat 7: JonnyKakes59 (big blind) folded before Flop
Seat 8: MyManPotnPan folded before Flop (didn't bet)
Seat 9: Broker RR folded before Flop (didn't bet)


*********** # 72 **************
PokerStars Hand #169315257814: Tournament #1597683884, $18.20+$1.80 USD=
 Hold'em No Limit - Level XVI (600/1200) - 2017/05/02 21:42:19 ET
Table '1597683884 2' 9-max Seat #6 is the button
Seat 1: jrollsup1 (33842 in chips)=20
Seat 2: Article332 (23591 in chips)=20
Seat 4: JJin91 (35642 in chips)=20
Seat 5: McCarnuts84 (18685 in chips)=20
Seat 6: Scooby-D0O (14559 in chips)=20
Seat 7: JonnyKakes59 (29210 in chips)=20
Seat 8: MyManPotnPan (43924 in chips)=20
Seat 9: Broker RR (12792 in chips)=20
jrollsup1: posts the ante 150
Article332: posts the ante 150
JJin91: posts the ante 150
McCarnuts84: posts the ante 150
Scooby-D0O: posts the ante 150
JonnyKakes59: posts the ante 150
MyManPotnPan: posts the ante 150
Broker RR: posts the ante 150
JonnyKakes59: posts small blind 600
MyManPotnPan: posts big blind 1200
*** HOLE CARDS ***
Dealt to JJin91 [5h Kc]
Broker RR: raises 11442 to 12642 and is all-in
jrollsup1: folds=20
Article332: folds=20
JJin91: folds=20
McCarnuts84: folds=20
Scooby-D0O: folds=20
JonnyKakes59: folds=20
MyManPotnPan: folds=20
Uncalled bet (11442) returned to Broker RR
Broker RR collected 4200 from pot
Broker RR: doesn't show hand=20
*** SUMMARY ***
Total pot 4200 | Rake 0=20
Seat 1: jrollsup1 folded before Flop (didn't bet)
Seat 2: Article332 folded before Flop (didn't bet)
Seat 4: JJin91 folded before Flop (didn't bet)
Seat 5: McCarnuts84 folded before Flop (didn't bet)
Seat 6: Scooby-D0O (button) folded before Flop (didn't bet)
Seat 7: JonnyKakes59 (small blind) folded before Flop
Seat 8: MyManPotnPan (big blind) folded before Flop
Seat 9: Broker RR collected (4200)


*********** # 73 **************
PokerStars Hand #169315257930: Tournament #1597683884, $18.20+$1.80 USD=
 Hold'em No Limit - Level XVI (600/1200) - 2017/05/02 21:42:42 ET
Table '1597683884 2' 9-max Seat #7 is the button
Seat 1: jrollsup1 (33692 in chips)=20
Seat 2: Article332 (23441 in chips)=20
Seat 4: JJin91 (35492 in chips)=20
Seat 5: McCarnuts84 (18535 in chips)=20
Seat 6: Scooby-D0O (14409 in chips)=20
Seat 7: JonnyKakes59 (28460 in chips)=20
Seat 8: MyManPotnPan (42574 in chips)=20
Seat 9: Broker RR (15642 in chips)=20
jrollsup1: posts the ante 150
Article332: posts the ante 150
JJin91: posts the ante 150
McCarnuts84: posts the ante 150
Scooby-D0O: posts the ante 150
JonnyKakes59: posts the ante 150
MyManPotnPan: posts the ante 150
Broker RR: posts the ante 150
MyManPotnPan: posts small blind 600
Broker RR: posts big blind 1200
*** HOLE CARDS ***
Dealt to JJin91 [6h Kc]
jrollsup1: folds=20
Article332: folds=20
JJin91: folds=20
McCarnuts84: raises 2000 to 3200
Scooby-D0O: folds=20
JonnyKakes59: folds=20
MyManPotnPan: folds=20
Broker RR: raises 12292 to 15492 and is all-in
McCarnuts84: folds=20
Uncalled bet (12292) returned to Broker RR
Broker RR collected 8200 from pot
Broker RR: doesn't show hand=20
*** SUMMARY ***
Total pot 8200 | Rake 0=20
Seat 1: jrollsup1 folded before Flop (didn't bet)
Seat 2: Article332 folded before Flop (didn't bet)
Seat 4: JJin91 folded before Flop (didn't bet)
Seat 5: McCarnuts84 folded before Flop
Seat 6: Scooby-D0O folded before Flop (didn't bet)
Seat 7: JonnyKakes59 (button) folded before Flop (didn't bet)
Seat 8: MyManPotnPan (small blind) folded before Flop
Seat 9: Broker RR (big blind) collected (8200)


*********** # 74 **************
PokerStars Hand #169315258185: Tournament #1597683884, $18.20+$1.80 USD=
 Hold'em No Limit - Level XVI (600/1200) - 2017/05/02 21:43:33 ET
Table '1597683884 2' 9-max Seat #8 is the button
Seat 1: jrollsup1 (33542 in chips)=20
Seat 2: Article332 (23291 in chips)=20
Seat 4: JJin91 (35342 in chips)=20
Seat 5: McCarnuts84 (15185 in chips)=20
Seat 6: Scooby-D0O (14259 in chips)=20
Seat 7: JonnyKakes59 (28310 in chips)=20
Seat 8: MyManPotnPan (41824 in chips)=20
Seat 9: Broker RR (20492 in chips)=20
jrollsup1: posts the ante 150
Article332: posts the ante 150
JJin91: posts the ante 150
McCarnuts84: posts the ante 150
Scooby-D0O: posts the ante 150
JonnyKakes59: posts the ante 150
MyManPotnPan: posts the ante 150
Broker RR: posts the ante 150
Broker RR: posts small blind 600
jrollsup1: posts big blind 1200
*** HOLE CARDS ***
Dealt to JJin91 [5c 6s]
Article332: folds=20
JJin91: folds=20
McCarnuts84: folds=20
Scooby-D0O: raises 12909 to 14109 and is all-in
JonnyKakes59: folds=20
MyManPotnPan: folds=20
Broker RR: calls 13509
jrollsup1: folds=20
*** FLOP *** [9s 2c 2h]
*** TURN *** [9s 2c 2h] [7d]
*** RIVER *** [9s 2c 2h 7d] [3h]
*** SHOW DOWN ***
Broker RR: shows [Qc Qs] (two pair, Queens and Deuces)
Scooby-D0O: shows [Ac Ts] (a pair of Deuces)
Broker RR collected 30618 from pot
Scooby-D0O finished the tournament in 32nd place
*** SUMMARY ***
Total pot 30618 | Rake 0=20
Board [9s 2c 2h 7d 3h]
Seat 1: jrollsup1 (big blind) folded before Flop
Seat 2: Article332 folded before Flop (didn't bet)
Seat 4: JJin91 folded before Flop (didn't bet)
Seat 5: McCarnuts84 folded before Flop (didn't bet)
Seat 6: Scooby-D0O showed [Ac Ts] and lost with a pair of Deuces
Seat 7: JonnyKakes59 folded before Flop (didn't bet)
Seat 8: MyManPotnPan (button) folded before Flop (didn't bet)
Seat 9: Broker RR (small blind) showed [Qc Qs] and won (30618) with two=
 pair, Queens and Deuces


*********** # 75 **************
PokerStars Hand #169315258413: Tournament #1597683884, $18.20+$1.80 USD=
 Hold'em No Limit - Level XVI (600/1200) - 2017/05/02 21:44:19 ET
Table '1597683884 2' 9-max Seat #9 is the button
Seat 1: jrollsup1 (32192 in chips)=20
Seat 2: Article332 (23141 in chips)=20
Seat 4: JJin91 (35192 in chips)=20
Seat 5: McCarnuts84 (15035 in chips)=20
Seat 7: JonnyKakes59 (28160 in chips)=20
Seat 8: MyManPotnPan (41674 in chips)=20
Seat 9: Broker RR (36851 in chips)=20
jrollsup1: posts the ante 150
Article332: posts the ante 150
JJin91: posts the ante 150
McCarnuts84: posts the ante 150
JonnyKakes59: posts the ante 150
MyManPotnPan: posts the ante 150
Broker RR: posts the ante 150
jrollsup1: posts small blind 600
Article332: posts big blind 1200
*** HOLE CARDS ***
Dealt to JJin91 [8d 7s]
JJin91: folds=20
McCarnuts84: folds=20
JonnyKakes59: folds=20
MyManPotnPan: folds=20
Broker RR: folds=20
jrollsup1: raises 30842 to 32042 and is all-in
Article332: folds=20
Uncalled bet (30842) returned to jrollsup1
jrollsup1 collected 3450 from pot
*** SUMMARY ***
Total pot 3450 | Rake 0=20
Seat 1: jrollsup1 (small blind) collected (3450)
Seat 2: Article332 (big blind) folded before Flop
Seat 4: JJin91 folded before Flop (didn't bet)
Seat 5: McCarnuts84 folded before Flop (didn't bet)
Seat 7: JonnyKakes59 folded before Flop (didn't bet)
Seat 8: MyManPotnPan folded before Flop (didn't bet)
Seat 9: Broker RR (button) folded before Flop (didn't bet)


*********** # 76 **************
PokerStars Hand #169315258689: Tournament #1597683884, $18.20+$1.80 USD=
 Hold'em No Limit - Level XVI (600/1200) - 2017/05/02 21:45:15 ET
Table '1597683884 2' 9-max Seat #1 is the button
Seat 1: jrollsup1 (34292 in chips)=20
Seat 2: Article332 (21791 in chips)=20
Seat 4: JJin91 (35042 in chips)=20
Seat 5: McCarnuts84 (14885 in chips)=20
Seat 7: JonnyKakes59 (28010 in chips)=20
Seat 8: MyManPotnPan (41524 in chips)=20
Seat 9: Broker RR (36701 in chips)=20
jrollsup1: posts the ante 150
Article332: posts the ante 150
JJin91: posts the ante 150
McCarnuts84: posts the ante 150
JonnyKakes59: posts the ante 150
MyManPotnPan: posts the ante 150
Broker RR: posts the ante 150
Article332: posts small blind 600
JJin91: posts big blind 1200
*** HOLE CARDS ***
Dealt to JJin91 [4c 3d]
McCarnuts84: raises 2400 to 3600
JonnyKakes59: folds=20
MyManPotnPan: folds=20
Broker RR: folds=20
jrollsup1: folds=20
Article332: raises 18041 to 21641 and is all-in
JJin91: folds=20
McCarnuts84: calls 11135 and is all-in
Uncalled bet (6906) returned to Article332
*** FLOP *** [3h Jd 7d]
*** TURN *** [3h Jd 7d] [8d]
*** RIVER *** [3h Jd 7d 8d] [Ac]
*** SHOW DOWN ***
Article332: shows [Kh As] (a pair of Aces)
McCarnuts84: shows [4s 4h] (a pair of Fours)
Article332 collected 31720 from pot
McCarnuts84 finished the tournament in 31st place
*** SUMMARY ***
Total pot 31720 | Rake 0=20
Board [3h Jd 7d 8d Ac]
Seat 1: jrollsup1 (button) folded before Flop (didn't bet)
Seat 2: Article332 (small blind) showed [Kh As] and won (31720) with a =
pair of Aces
Seat 4: JJin91 (big blind) folded before Flop
Seat 5: McCarnuts84 showed [4s 4h] and lost with a pair of Fours
Seat 7: JonnyKakes59 folded before Flop (didn't bet)
Seat 8: MyManPotnPan folded before Flop (didn't bet)
Seat 9: Broker RR folded before Flop (didn't bet)


*********** # 77 **************
PokerStars Hand #169315258960: Tournament #1597683884, $18.20+$1.80 USD=
 Hold'em No Limit - Level XVI (600/1200) - 2017/05/02 21:46:07 ET
Table '1597683884 2' 9-max Seat #2 is the button
Seat 1: jrollsup1 (34142 in chips)=20
Seat 2: Article332 (38626 in chips)=20
Seat 4: JJin91 (33692 in chips)=20
Seat 7: JonnyKakes59 (27860 in chips)=20
Seat 8: MyManPotnPan (41374 in chips)=20
Seat 9: Broker RR (36551 in chips)=20
jrollsup1: posts the ante 150
Article332: posts the ante 150
JJin91: posts the ante 150
JonnyKakes59: posts the ante 150
MyManPotnPan: posts the ante 150
Broker RR: posts the ante 150
JJin91: posts small blind 600
JonnyKakes59: posts big blind 1200
*** HOLE CARDS ***
Dealt to JJin91 [Ac Qh]
McCarnuts84 [observer] said, "f!ck you"
MyManPotnPan: folds=20
McCarnuts84 [observer] said, "river"
Broker RR: calls 1200
jrollsup1: folds=20
Article332: calls 1200
JJin91: raises 2521 to 3721
JonnyKakes59: folds=20
Broker RR: calls 2521
Article332: folds=20
*** FLOP *** [Jc 2h 8h]
JJin91: bets 3330
Broker RR: folds=20
Uncalled bet (3330) returned to JJin91
JJin91 collected 10742 from pot
JJin91: doesn't show hand=20
*** SUMMARY ***
Total pot 10742 | Rake 0=20
Board [Jc 2h 8h]
Seat 1: jrollsup1 folded before Flop (didn't bet)
Seat 2: Article332 (button) folded before Flop
Seat 4: JJin91 (small blind) collected (10742)
Seat 7: JonnyKakes59 (big blind) folded before Flop
Seat 8: MyManPotnPan folded before Flop (didn't bet)
Seat 9: Broker RR folded on the Flop


*********** # 78 **************
PokerStars Hand #169315259410: Tournament #1597683884, $18.20+$1.80 USD=
 Hold'em No Limit - Level XVI (600/1200) - 2017/05/02 21:47:38 ET
Table '1597683884 2' 9-max Seat #4 is the button
Seat 1: jrollsup1 (33992 in chips)=20
Seat 2: Article332 (37276 in chips)=20
Seat 3: KerryBella (28177 in chips)=20
Seat 4: JJin91 (40563 in chips)=20
Seat 7: JonnyKakes59 (26510 in chips)=20
Seat 8: MyManPotnPan (41224 in chips)=20
Seat 9: Broker RR (32680 in chips)=20
jrollsup1: posts the ante 150
Article332: posts the ante 150
KerryBella: posts the ante 150
JJin91: posts the ante 150
JonnyKakes59: posts the ante 150
MyManPotnPan: posts the ante 150
Broker RR: posts the ante 150
JonnyKakes59: posts small blind 600
MyManPotnPan: posts big blind 1200
*** HOLE CARDS ***
Dealt to JJin91 [Tc 8h]
Broker RR: folds=20
jrollsup1: folds=20
Article332: folds=20
KerryBella: folds=20
JJin91: raises 1332 to 2532
JonnyKakes59: folds=20
MyManPotnPan: folds=20
Uncalled bet (1332) returned to JJin91
JJin91 collected 4050 from pot
JJin91: doesn't show hand=20
*** SUMMARY ***
Total pot 4050 | Rake 0=20
Seat 1: jrollsup1 folded before Flop (didn't bet)
Seat 2: Article332 folded before Flop (didn't bet)
Seat 3: KerryBella folded before Flop (didn't bet)
Seat 4: JJin91 (button) collected (4050)
Seat 7: JonnyKakes59 (small blind) folded before Flop
Seat 8: MyManPotnPan (big blind) folded before Flop
Seat 9: Broker RR folded before Flop (didn't bet)


*********** # 79 **************
PokerStars Hand #169315259635: Tournament #1597683884, $18.20+$1.80 USD=
 Hold'em No Limit - Level XVI (600/1200) - 2017/05/02 21:48:18 ET
Table '1597683884 2' 9-max Seat #7 is the button
Seat 1: jrollsup1 (33842 in chips)=20
Seat 2: Article332 (37126 in chips)=20
Seat 3: KerryBella (28027 in chips)=20
Seat 4: JJin91 (43263 in chips)=20
Seat 7: JonnyKakes59 (25760 in chips)=20
Seat 8: MyManPotnPan (39874 in chips)=20
Seat 9: Broker RR (32530 in chips)=20
jrollsup1: posts the ante 150
Article332: posts the ante 150
KerryBella: posts the ante 150
JJin91: posts the ante 150
JonnyKakes59: posts the ante 150
MyManPotnPan: posts the ante 150
Broker RR: posts the ante 150
MyManPotnPan: posts small blind 600
Broker RR: posts big blind 1200
*** HOLE CARDS ***
Dealt to JJin91 [9s 5s]
jrollsup1: folds=20
Article332: calls 1200
KerryBella: folds=20
JJin91: folds=20
JonnyKakes59: folds=20
MyManPotnPan: calls 600
Broker RR: checks=20
*** FLOP *** [4c Th Jh]
MyManPotnPan: checks=20
Broker RR: checks=20
Article332: bets 2900
MyManPotnPan: raises 2900 to 5800
Broker RR: folds=20
Article332: calls 2900
*** TURN *** [4c Th Jh] [Qd]
MyManPotnPan: bets 16250
Article332: folds=20
Uncalled bet (16250) returned to MyManPotnPan
MyManPotnPan collected 16250 from pot
MyManPotnPan: doesn't show hand=20
*** SUMMARY ***
Total pot 16250 | Rake 0=20
Board [4c Th Jh Qd]
Seat 1: jrollsup1 folded before Flop (didn't bet)
Seat 2: Article332 folded on the Turn
Seat 3: KerryBella folded before Flop (didn't bet)
Seat 4: JJin91 folded before Flop (didn't bet)
Seat 7: JonnyKakes59 (button) folded before Flop (didn't bet)
Seat 8: MyManPotnPan (small blind) collected (16250)
Seat 9: Broker RR (big blind) folded on the Flop


*********** # 80 **************
PokerStars Hand #169317940781: Tournament #1597683884, $18.20+$1.80 USD=
 Hold'em No Limit - Level XVI (600/1200) - 2017/05/02 21:49:40 ET
Table '1597683884 2' 9-max Seat #8 is the button
Seat 1: jrollsup1 (33692 in chips)=20
Seat 2: Article332 (29976 in chips)=20
Seat 3: KerryBella (27877 in chips)=20
Seat 4: JJin91 (43113 in chips)=20
Seat 7: JonnyKakes59 (25610 in chips)=20
Seat 8: MyManPotnPan (48974 in chips)=20
Seat 9: Broker RR (31180 in chips)=20
jrollsup1: posts the ante 150
Article332: posts the ante 150
KerryBella: posts the ante 150
JJin91: posts the ante 150
JonnyKakes59: posts the ante 150
MyManPotnPan: posts the ante 150
Broker RR: posts the ante 150
Broker RR: posts small blind 600
jrollsup1: posts big blind 1200
*** HOLE CARDS ***
Dealt to JJin91 [4h Jd]
Article332: folds=20
KerryBella: folds=20
JJin91: folds=20
JonnyKakes59: folds=20
MyManPotnPan: folds=20
Broker RR: calls 600
jrollsup1: raises 2400 to 3600
Broker RR: folds=20
Uncalled bet (2400) returned to jrollsup1
jrollsup1 collected 3450 from pot
jrollsup1: doesn't show hand=20
*** SUMMARY ***
Total pot 3450 | Rake 0=20
Seat 1: jrollsup1 (big blind) collected (3450)
Seat 2: Article332 folded before Flop (didn't bet)
Seat 3: KerryBella folded before Flop (didn't bet)
Seat 4: JJin91 folded before Flop (didn't bet)
Seat 7: JonnyKakes59 folded before Flop (didn't bet)
Seat 8: MyManPotnPan (button) folded before Flop (didn't bet)
Seat 9: Broker RR (small blind) folded before Flop


*********** # 81 **************
PokerStars Hand #169317940951: Tournament #1597683884, $18.20+$1.80 USD=
 Hold'em No Limit - Level XVI (600/1200) - 2017/05/02 21:50:10 ET
Table '1597683884 2' 9-max Seat #9 is the button
Seat 1: jrollsup1 (35792 in chips)=20
Seat 2: Article332 (29826 in chips)=20
Seat 3: KerryBella (27727 in chips)=20
Seat 4: JJin91 (42963 in chips)=20
Seat 7: JonnyKakes59 (25460 in chips)=20
Seat 8: MyManPotnPan (48824 in chips)=20
Seat 9: Broker RR (29830 in chips)=20
jrollsup1: posts the ante 150
Article332: posts the ante 150
KerryBella: posts the ante 150
JJin91: posts the ante 150
JonnyKakes59: posts the ante 150
MyManPotnPan: posts the ante 150
Broker RR: posts the ante 150
jrollsup1: posts small blind 600
Article332: posts big blind 1200
*** HOLE CARDS ***
Dealt to JJin91 [4s Kc]
KerryBella: folds=20
JJin91: folds=20
JonnyKakes59: folds=20
MyManPotnPan: raises 1200 to 2400
Broker RR: folds=20
jrollsup1: folds=20
Article332: calls 1200
*** FLOP *** [2h Qc Kd]
Article332: checks=20
MyManPotnPan: bets 3225
Article332: folds=20
Uncalled bet (3225) returned to MyManPotnPan
MyManPotnPan collected 6450 from pot
MyManPotnPan: doesn't show hand=20
*** SUMMARY ***
Total pot 6450 | Rake 0=20
Board [2h Qc Kd]
Seat 1: jrollsup1 (small blind) folded before Flop
Seat 2: Article332 (big blind) folded on the Flop
Seat 3: KerryBella folded before Flop (didn't bet)
Seat 4: JJin91 folded before Flop (didn't bet)
Seat 7: JonnyKakes59 folded before Flop (didn't bet)
Seat 8: MyManPotnPan collected (6450)
Seat 9: Broker RR (button) folded before Flop (didn't bet)


*********** # 82 **************
PokerStars Hand #169317941215: Tournament #1597683884, $18.20+$1.80 USD=
 Hold'em No Limit - Level XVI (600/1200) - 2017/05/02 21:50:54 ET
Table '1597683884 2' 9-max Seat #1 is the button
Seat 1: jrollsup1 (35042 in chips)=20
Seat 2: Article332 (27276 in chips)=20
Seat 3: KerryBella (27577 in chips)=20
Seat 4: JJin91 (42813 in chips)=20
Seat 7: JonnyKakes59 (25310 in chips)=20
Seat 8: MyManPotnPan (52724 in chips)=20
Seat 9: Broker RR (29680 in chips)=20
jrollsup1: posts the ante 150
Article332: posts the ante 150
KerryBella: posts the ante 150
JJin91: posts the ante 150
JonnyKakes59: posts the ante 150
MyManPotnPan: posts the ante 150
Broker RR: posts the ante 150
Article332: posts small blind 600
KerryBella: posts big blind 1200
*** HOLE CARDS ***
Dealt to JJin91 [2d 8s]
JJin91: folds=20
JonnyKakes59: folds=20
MyManPotnPan: calls 1200
Broker RR: folds=20
jrollsup1: folds=20
Article332: calls 600
KerryBella: checks=20
*** FLOP *** [3c Kh Qc]
Article332: checks=20
KerryBella: checks=20
MyManPotnPan: bets 4650
Article332: folds=20
KerryBella: folds=20
Uncalled bet (4650) returned to MyManPotnPan
MyManPotnPan collected 4650 from pot
MyManPotnPan: doesn't show hand=20
*** SUMMARY ***
Total pot 4650 | Rake 0=20
Board [3c Kh Qc]
Seat 1: jrollsup1 (button) folded before Flop (didn't bet)
Seat 2: Article332 (small blind) folded on the Flop
Seat 3: KerryBella (big blind) folded on the Flop
Seat 4: JJin91 folded before Flop (didn't bet)
Seat 7: JonnyKakes59 folded before Flop (didn't bet)
Seat 8: MyManPotnPan collected (4650)
Seat 9: Broker RR folded before Flop (didn't bet)


*********** # 83 **************
PokerStars Hand #169317941490: Tournament #1597683884, $18.20+$1.80 USD=
 Hold'em No Limit - Level XVI (600/1200) - 2017/05/02 21:51:44 ET
Table '1597683884 2' 9-max Seat #2 is the button
Seat 1: jrollsup1 (34892 in chips)=20
Seat 2: Article332 (25926 in chips)=20
Seat 3: KerryBella (26227 in chips)=20
Seat 4: JJin91 (42663 in chips)=20
Seat 7: JonnyKakes59 (25160 in chips)=20
Seat 8: MyManPotnPan (56024 in chips)=20
Seat 9: Broker RR (29530 in chips)=20
jrollsup1: posts the ante 150
Article332: posts the ante 150
KerryBella: posts the ante 150
JJin91: posts the ante 150
JonnyKakes59: posts the ante 150
MyManPotnPan: posts the ante 150
Broker RR: posts the ante 150
KerryBella: posts small blind 600
JJin91: posts big blind 1200
*** HOLE CARDS ***
Dealt to JJin91 [8c Kd]
JonnyKakes59: raises 1355 to 2555
MyManPotnPan: folds=20
Broker RR: folds=20
jrollsup1: folds=20
Article332: calls 2555
KerryBella: folds=20
JJin91: folds=20
*** FLOP *** [4h 2d 3c]
JonnyKakes59: checks=20
Article332: bets 3300
JonnyKakes59: folds=20
Uncalled bet (3300) returned to Article332
Article332 collected 7960 from pot
Article332: doesn't show hand=20
*** SUMMARY ***
Total pot 7960 | Rake 0=20
Board [4h 2d 3c]
Seat 1: jrollsup1 folded before Flop (didn't bet)
Seat 2: Article332 (button) collected (7960)
Seat 3: KerryBella (small blind) folded before Flop
Seat 4: JJin91 (big blind) folded before Flop
Seat 7: JonnyKakes59 folded on the Flop
Seat 8: MyManPotnPan folded before Flop (didn't bet)
Seat 9: Broker RR folded before Flop (didn't bet)


*********** # 84 **************
PokerStars Hand #169317941760: Tournament #1597683884, $18.20+$1.80 USD=
 Hold'em No Limit - Level XVII (700/1400) - 2017/05/02 21:52:34 ET
Table '1597683884 2' 9-max Seat #3 is the button
Seat 1: jrollsup1 (34742 in chips)=20
Seat 2: Article332 (31181 in chips)=20
Seat 3: KerryBella (25477 in chips)=20
Seat 4: JJin91 (41313 in chips)=20
Seat 7: JonnyKakes59 (22455 in chips)=20
Seat 8: MyManPotnPan (55874 in chips)=20
Seat 9: Broker RR (29380 in chips)=20
jrollsup1: posts the ante 175
Article332: posts the ante 175
KerryBella: posts the ante 175
JJin91: posts the ante 175
JonnyKakes59: posts the ante 175
MyManPotnPan: posts the ante 175
Broker RR: posts the ante 175
JJin91: posts small blind 700
JonnyKakes59: posts big blind 1400
*** HOLE CARDS ***
Dealt to JJin91 [Ac 9h]
MyManPotnPan: folds=20
Broker RR: folds=20
jrollsup1: folds=20
Article332: raises 1400 to 2800
KerryBella: folds=20
JJin91: folds=20
JonnyKakes59: folds=20
Uncalled bet (1400) returned to Article332
Article332 collected 4725 from pot
Article332: doesn't show hand=20
*** SUMMARY ***
Total pot 4725 | Rake 0=20
Seat 1: jrollsup1 folded before Flop (didn't bet)
Seat 2: Article332 collected (4725)
Seat 3: KerryBella (button) folded before Flop (didn't bet)
Seat 4: JJin91 (small blind) folded before Flop
Seat 7: JonnyKakes59 (big blind) folded before Flop
Seat 8: MyManPotnPan folded before Flop (didn't bet)
Seat 9: Broker RR folded before Flop (didn't bet)


*********** # 85 **************
PokerStars Hand #169317941966: Tournament #1597683884, $18.20+$1.80 USD=
 Hold'em No Limit - Level XVII (700/1400) - 2017/05/02 21:53:14 ET
Table '1597683884 2' 9-max Seat #4 is the button
Seat 1: jrollsup1 (34567 in chips)=20
Seat 2: Article332 (34331 in chips)=20
Seat 3: KerryBella (25302 in chips)=20
Seat 4: JJin91 (40438 in chips)=20
Seat 7: JonnyKakes59 (20880 in chips)=20
Seat 8: MyManPotnPan (55699 in chips)=20
Seat 9: Broker RR (29205 in chips)=20
jrollsup1: posts the ante 175
Article332: posts the ante 175
KerryBella: posts the ante 175
JJin91: posts the ante 175
JonnyKakes59: posts the ante 175
MyManPotnPan: posts the ante 175
Broker RR: posts the ante 175
JonnyKakes59: posts small blind 700
MyManPotnPan: posts big blind 1400
*** HOLE CARDS ***
Dealt to JJin91 [7d Tc]
Broker RR: folds=20
jrollsup1: folds=20
Article332: raises 2100 to 3500
KerryBella: raises 21627 to 25127 and is all-in
JJin91: folds=20
JonnyKakes59: folds=20
MyManPotnPan: folds=20
Article332: calls 21627
*** FLOP *** [6s 9c 6h]
*** TURN *** [6s 9c 6h] [7s]
*** RIVER *** [6s 9c 6h 7s] [Th]
*** SHOW DOWN ***
Article332: shows [Qd Qs] (two pair, Queens and Sixes)
KerryBella: shows [3d 3s] (two pair, Sixes and Threes)
Article332 collected 53579 from pot
KerryBella finished the tournament in 30th place
*** SUMMARY ***
Total pot 53579 | Rake 0=20
Board [6s 9c 6h 7s Th]
Seat 1: jrollsup1 folded before Flop (didn't bet)
Seat 2: Article332 showed [Qd Qs] and won (53579) with two pair, Queens=
 and Sixes
Seat 3: KerryBella showed [3d 3s] and lost with two pair, Sixes and Thr=
ees
Seat 4: JJin91 (button) folded before Flop (didn't bet)
Seat 7: JonnyKakes59 (small blind) folded before Flop
Seat 8: MyManPotnPan (big blind) folded before Flop
Seat 9: Broker RR folded before Flop (didn't bet)


*********** # 86 **************
PokerStars Hand #169317942197: Tournament #1597683884, $18.20+$1.80 USD=
 Hold'em No Limit - Level XVII (700/1400) - 2017/05/02 21:53:55 ET
Table '1597683884 2' 9-max Seat #7 is the button
Seat 1: jrollsup1 (34392 in chips)=20
Seat 2: Article332 (62608 in chips)=20
Seat 4: JJin91 (40263 in chips)=20
Seat 7: JonnyKakes59 (20005 in chips)=20
Seat 8: MyManPotnPan (54124 in chips)=20
Seat 9: Broker RR (29030 in chips)=20
jrollsup1: posts the ante 175
Article332: posts the ante 175
JJin91: posts the ante 175
JonnyKakes59: posts the ante 175
MyManPotnPan: posts the ante 175
Broker RR: posts the ante 175
MyManPotnPan: posts small blind 700
Broker RR: posts big blind 1400
*** HOLE CARDS ***
Dealt to JJin91 [Td 9d]
jrollsup1: folds=20
Article332: folds=20
JJin91: raises 1554 to 2954
JonnyKakes59: folds=20
MyManPotnPan: folds=20
Broker RR: raises 8246 to 11200
JJin91: folds=20
Uncalled bet (8246) returned to Broker RR
Broker RR collected 7658 from pot
Broker RR: doesn't show hand=20
*** SUMMARY ***
Total pot 7658 | Rake 0=20
Seat 1: jrollsup1 folded before Flop (didn't bet)
Seat 2: Article332 folded before Flop (didn't bet)
Seat 4: JJin91 folded before Flop
Seat 7: JonnyKakes59 (button) folded before Flop (didn't bet)
Seat 8: MyManPotnPan (small blind) folded before Flop
Seat 9: Broker RR (big blind) collected (7658)


*********** # 87 **************
PokerStars Hand #169317942462: Tournament #1597683884, $18.20+$1.80 USD=
 Hold'em No Limit - Level XVII (700/1400) - 2017/05/02 21:54:41 ET
Table '1597683884 2' 9-max Seat #8 is the button
Seat 1: jrollsup1 (34217 in chips)=20
Seat 2: Article332 (62433 in chips)=20
Seat 3: lIlbILLYmAC (58841 in chips)=20
Seat 4: JJin91 (37134 in chips)=20
Seat 7: JonnyKakes59 (19830 in chips)=20
Seat 8: MyManPotnPan (53249 in chips)=20
Seat 9: Broker RR (33559 in chips)=20
jrollsup1: posts the ante 175
Article332: posts the ante 175
lIlbILLYmAC: posts the ante 175
JJin91: posts the ante 175
JonnyKakes59: posts the ante 175
MyManPotnPan: posts the ante 175
Broker RR: posts the ante 175
Broker RR: posts small blind 700
jrollsup1: posts big blind 1400
*** HOLE CARDS ***
Dealt to JJin91 [Qc 3s]
Article332: folds=20
lIlbILLYmAC: folds=20
JJin91: folds=20
JonnyKakes59: folds=20
MyManPotnPan: folds=20
Broker RR: raises 31984 to 33384 and is all-in
jrollsup1: folds=20
Uncalled bet (31984) returned to Broker RR
Broker RR collected 4025 from pot
Broker RR: doesn't show hand=20
*** SUMMARY ***
Total pot 4025 | Rake 0=20
Seat 1: jrollsup1 (big blind) folded before Flop
Seat 2: Article332 folded before Flop (didn't bet)
Seat 3: lIlbILLYmAC folded before Flop (didn't bet)
Seat 4: JJin91 folded before Flop (didn't bet)
Seat 7: JonnyKakes59 folded before Flop (didn't bet)
Seat 8: MyManPotnPan (button) folded before Flop (didn't bet)
Seat 9: Broker RR (small blind) collected (4025)


*********** # 88 **************
PokerStars Hand #169317942598: Tournament #1597683884, $18.20+$1.80 USD=
 Hold'em No Limit - Level XVII (700/1400) - 2017/05/02 21:55:04 ET
Table '1597683884 2' 9-max Seat #9 is the button
Seat 1: jrollsup1 (32642 in chips)=20
Seat 2: Article332 (62258 in chips)=20
Seat 3: lIlbILLYmAC (58666 in chips)=20
Seat 4: JJin91 (36959 in chips)=20
Seat 7: JonnyKakes59 (19655 in chips)=20
Seat 8: MyManPotnPan (53074 in chips)=20
Seat 9: Broker RR (36009 in chips)=20
jrollsup1: posts the ante 175
Article332: posts the ante 175
lIlbILLYmAC: posts the ante 175
JJin91: posts the ante 175
JonnyKakes59: posts the ante 175
MyManPotnPan: posts the ante 175
Broker RR: posts the ante 175
jrollsup1: posts small blind 700
Article332: posts big blind 1400
*** HOLE CARDS ***
Dealt to JJin91 [Qc 6h]
lIlbILLYmAC: folds=20
JJin91: folds=20
JonnyKakes59: raises 18080 to 19480 and is all-in
MyManPotnPan: folds=20
Broker RR: folds=20
jrollsup1: folds=20
Article332: folds=20
Uncalled bet (18080) returned to JonnyKakes59
JonnyKakes59 collected 4725 from pot
JonnyKakes59: doesn't show hand=20
*** SUMMARY ***
Total pot 4725 | Rake 0=20
Seat 1: jrollsup1 (small blind) folded before Flop
Seat 2: Article332 (big blind) folded before Flop
Seat 3: lIlbILLYmAC folded before Flop (didn't bet)
Seat 4: JJin91 folded before Flop (didn't bet)
Seat 7: JonnyKakes59 collected (4725)
Seat 8: MyManPotnPan folded before Flop (didn't bet)
Seat 9: Broker RR (button) folded before Flop (didn't bet)


*********** # 89 **************
PokerStars Hand #169317944200: Tournament #1597683884, $18.20+$1.80 USD=
 Hold'em No Limit - Level XVII (700/1400) - 2017/05/02 22:01:21 ET
Table '1597683884 2' 9-max Seat #1 is the button
Seat 1: jrollsup1 (31767 in chips)=20
Seat 2: Article332 (60683 in chips)=20
Seat 3: lIlbILLYmAC (58491 in chips)=20
Seat 4: JJin91 (36784 in chips)=20
Seat 7: JonnyKakes59 (22805 in chips)=20
Seat 8: MyManPotnPan (52899 in chips)=20
Seat 9: Broker RR (35834 in chips)=20
jrollsup1: posts the ante 175
Article332: posts the ante 175
lIlbILLYmAC: posts the ante 175
JJin91: posts the ante 175
JonnyKakes59: posts the ante 175
MyManPotnPan: posts the ante 175
Broker RR: posts the ante 175
Article332: posts small blind 700
lIlbILLYmAC: posts big blind 1400
*** HOLE CARDS ***
Dealt to JJin91 [Qs 6h]
JJin91: folds=20
JonnyKakes59: folds=20
MyManPotnPan: folds=20
Broker RR: folds=20
jrollsup1: raises 1400 to 2800
Article332: folds=20
lIlbILLYmAC: calls 1400
*** FLOP *** [As 8d 8h]
lIlbILLYmAC: checks=20
jrollsup1: bets 3500
lIlbILLYmAC: folds=20
Uncalled bet (3500) returned to jrollsup1
jrollsup1 collected 7525 from pot
jrollsup1: doesn't show hand=20
*** SUMMARY ***
Total pot 7525 | Rake 0=20
Board [As 8d 8h]
Seat 1: jrollsup1 (button) collected (7525)
Seat 2: Article332 (small blind) folded before Flop
Seat 3: lIlbILLYmAC (big blind) folded on the Flop
Seat 4: JJin91 folded before Flop (didn't bet)
Seat 7: JonnyKakes59 folded before Flop (didn't bet)
Seat 8: MyManPotnPan folded before Flop (didn't bet)
Seat 9: Broker RR folded before Flop (didn't bet)


*********** # 90 **************
PokerStars Hand #169317944426: Tournament #1597683884, $18.20+$1.80 USD=
 Hold'em No Limit - Level XVII (700/1400) - 2017/05/02 22:02:07 ET
Table '1597683884 2' 9-max Seat #2 is the button
Seat 1: jrollsup1 (36317 in chips)=20
Seat 2: Article332 (59808 in chips)=20
Seat 3: lIlbILLYmAC (55516 in chips)=20
Seat 4: JJin91 (36609 in chips)=20
Seat 7: JonnyKakes59 (22630 in chips)=20
Seat 8: MyManPotnPan (52724 in chips)=20
Seat 9: Broker RR (35659 in chips)=20
jrollsup1: posts the ante 175
Article332: posts the ante 175
lIlbILLYmAC: posts the ante 175
JJin91: posts the ante 175
JonnyKakes59: posts the ante 175
MyManPotnPan: posts the ante 175
Broker RR: posts the ante 175
lIlbILLYmAC: posts small blind 700
JJin91: posts big blind 1400
*** HOLE CARDS ***
Dealt to JJin91 [Ad 7s]
JonnyKakes59: folds=20
MyManPotnPan: folds=20
Broker RR: folds=20
jrollsup1: folds=20
Article332: raises 1700 to 3100
lIlbILLYmAC: folds=20
JJin91: calls 1700
*** FLOP *** [Qh 3s 4s]
JJin91: checks=20
Article332: bets 3800
JJin91: folds=20
Uncalled bet (3800) returned to Article332
Article332 collected 8125 from pot
Article332: doesn't show hand=20
*** SUMMARY ***
Total pot 8125 | Rake 0=20
Board [Qh 3s 4s]
Seat 1: jrollsup1 folded before Flop (didn't bet)
Seat 2: Article332 (button) collected (8125)
Seat 3: lIlbILLYmAC (small blind) folded before Flop
Seat 4: JJin91 (big blind) folded on the Flop
Seat 7: JonnyKakes59 folded before Flop (didn't bet)
Seat 8: MyManPotnPan folded before Flop (didn't bet)
Seat 9: Broker RR folded before Flop (didn't bet)


*********** # 91 **************
PokerStars Hand #169317944739: Tournament #1597683884, $18.20+$1.80 USD=
 Hold'em No Limit - Level XVII (700/1400) - 2017/05/02 22:03:10 ET
Table '1597683884 2' 9-max Seat #3 is the button
Seat 1: jrollsup1 (36142 in chips)=20
Seat 2: Article332 (64658 in chips)=20
Seat 3: lIlbILLYmAC (54641 in chips)=20
Seat 4: JJin91 (33334 in chips)=20
Seat 7: JonnyKakes59 (22455 in chips)=20
Seat 8: MyManPotnPan (52549 in chips)=20
Seat 9: Broker RR (35484 in chips)=20
jrollsup1: posts the ante 175
Article332: posts the ante 175
lIlbILLYmAC: posts the ante 175
JJin91: posts the ante 175
JonnyKakes59: posts the ante 175
MyManPotnPan: posts the ante 175
Broker RR: posts the ante 175
JJin91: posts small blind 700
JonnyKakes59: posts big blind 1400
*** HOLE CARDS ***
Dealt to JJin91 [8c Kh]
MyManPotnPan: folds=20
Broker RR: folds=20
jrollsup1: folds=20
Article332: folds=20
lIlbILLYmAC: folds=20
JJin91: raises 1554 to 2954
JonnyKakes59: raises 19326 to 22280 and is all-in
JJin91: folds=20
Uncalled bet (19326) returned to JonnyKakes59
JonnyKakes59 collected 7133 from pot
JonnyKakes59: doesn't show hand=20
*** SUMMARY ***
Total pot 7133 | Rake 0=20
Seat 1: jrollsup1 folded before Flop (didn't bet)
Seat 2: Article332 folded before Flop (didn't bet)
Seat 3: lIlbILLYmAC (button) folded before Flop (didn't bet)
Seat 4: JJin91 (small blind) folded before Flop
Seat 7: JonnyKakes59 (big blind) collected (7133)
Seat 8: MyManPotnPan folded before Flop (didn't bet)
Seat 9: Broker RR folded before Flop (didn't bet)


*********** # 92 **************
PokerStars Hand #169317944935: Tournament #1597683884, $18.20+$1.80 USD=
 Hold'em No Limit - Level XVII (700/1400) - 2017/05/02 22:03:49 ET
Table '1597683884 2' 9-max Seat #4 is the button
Seat 1: jrollsup1 (35967 in chips)=20
Seat 2: Article332 (64483 in chips)=20
Seat 3: lIlbILLYmAC (54466 in chips)=20
Seat 4: JJin91 (30205 in chips)=20
Seat 5: PureWizardry (39951 in chips) out of hand (moved from another t=
able into small blind)
Seat 6: donkeynutz44 (30110 in chips) out of hand (moved from another t=
able into small blind)
Seat 7: JonnyKakes59 (26459 in chips)=20
Seat 8: MyManPotnPan (52374 in chips)=20
Seat 9: Broker RR (35309 in chips)=20
jrollsup1: posts the ante 175
Article332: posts the ante 175
lIlbILLYmAC: posts the ante 175
JJin91: posts the ante 175
JonnyKakes59: posts the ante 175
MyManPotnPan: posts the ante 175
Broker RR: posts the ante 175
JonnyKakes59: posts small blind 700
MyManPotnPan: posts big blind 1400
*** HOLE CARDS ***
Dealt to JJin91 [5d 4h]
Broker RR: folds=20
jrollsup1: folds=20
Article332: folds=20
lIlbILLYmAC: folds=20
JJin91: folds=20
JonnyKakes59: folds=20
Uncalled bet (700) returned to MyManPotnPan
MyManPotnPan collected 2625 from pot
MyManPotnPan: doesn't show hand=20
*** SUMMARY ***
Total pot 2625 | Rake 0=20
Seat 1: jrollsup1 folded before Flop (didn't bet)
Seat 2: Article332 folded before Flop (didn't bet)
Seat 3: lIlbILLYmAC folded before Flop (didn't bet)
Seat 4: JJin91 (button) folded before Flop (didn't bet)
Seat 7: JonnyKakes59 (small blind) folded before Flop
Seat 8: MyManPotnPan (big blind) collected (2625)
Seat 9: Broker RR folded before Flop (didn't bet)


*********** # 93 **************
PokerStars Hand #169317945040: Tournament #1597683884, $18.20+$1.80 USD=
 Hold'em No Limit - Level XVII (700/1400) - 2017/05/02 22:04:12 ET
Table '1597683884 2' 9-max Seat #7 is the button
Seat 1: jrollsup1 (35792 in chips)=20
Seat 2: Article332 (64308 in chips)=20
Seat 3: lIlbILLYmAC (54291 in chips)=20
Seat 4: JJin91 (30030 in chips)=20
Seat 5: PureWizardry (39951 in chips)=20
Seat 6: donkeynutz44 (30110 in chips)=20
Seat 7: JonnyKakes59 (25584 in chips)=20
Seat 8: MyManPotnPan (54124 in chips)=20
Seat 9: Broker RR (35134 in chips)=20
jrollsup1: posts the ante 175
Article332: posts the ante 175
lIlbILLYmAC: posts the ante 175
JJin91: posts the ante 175
PureWizardry: posts the ante 175
donkeynutz44: posts the ante 175
JonnyKakes59: posts the ante 175
MyManPotnPan: posts the ante 175
Broker RR: posts the ante 175
MyManPotnPan: posts small blind 700
Broker RR: posts big blind 1400
*** HOLE CARDS ***
Dealt to JJin91 [6c Kc]
jrollsup1: folds=20
Article332: folds=20
lIlbILLYmAC: raises 1400 to 2800
JJin91: folds=20
PureWizardry: folds=20
donkeynutz44: folds=20
JonnyKakes59: folds=20
MyManPotnPan: folds=20
Broker RR: calls 1400
*** FLOP *** [4c 9s 5s]
Broker RR: checks=20
lIlbILLYmAC: bets 3250
Broker RR: raises 6550 to 9800
lIlbILLYmAC: folds=20
Uncalled bet (6550) returned to Broker RR
Broker RR collected 14375 from pot
Broker RR: doesn't show hand=20
*** SUMMARY ***
Total pot 14375 | Rake 0=20
Board [4c 9s 5s]
Seat 1: jrollsup1 folded before Flop (didn't bet)
Seat 2: Article332 folded before Flop (didn't bet)
Seat 3: lIlbILLYmAC folded on the Flop
Seat 4: JJin91 folded before Flop (didn't bet)
Seat 5: PureWizardry folded before Flop (didn't bet)
Seat 6: donkeynutz44 folded before Flop (didn't bet)
Seat 7: JonnyKakes59 (button) folded before Flop (didn't bet)
Seat 8: MyManPotnPan (small blind) folded before Flop
Seat 9: Broker RR (big blind) collected (14375)


*********** # 94 **************
PokerStars Hand #169317945420: Tournament #1597683884, $18.20+$1.80 USD=
 Hold'em No Limit - Level XVII (700/1400) - 2017/05/02 22:05:31 ET
Table '1597683884 2' 9-max Seat #8 is the button
Seat 1: jrollsup1 (35617 in chips)=20
Seat 2: Article332 (64133 in chips)=20
Seat 3: lIlbILLYmAC (48066 in chips)=20
Seat 4: JJin91 (29855 in chips)=20
Seat 5: PureWizardry (39776 in chips)=20
Seat 6: donkeynutz44 (29935 in chips)=20
Seat 7: JonnyKakes59 (25409 in chips)=20
Seat 8: MyManPotnPan (53249 in chips)=20
Seat 9: Broker RR (43284 in chips)=20
jrollsup1: posts the ante 175
Article332: posts the ante 175
lIlbILLYmAC: posts the ante 175
JJin91: posts the ante 175
PureWizardry: posts the ante 175
donkeynutz44: posts the ante 175
JonnyKakes59: posts the ante 175
MyManPotnPan: posts the ante 175
Broker RR: posts the ante 175
Broker RR: posts small blind 700
jrollsup1: posts big blind 1400
*** HOLE CARDS ***
Dealt to JJin91 [6h Jc]
Article332: folds=20
lIlbILLYmAC: raises 1400 to 2800
JJin91: folds=20
PureWizardry: folds=20
donkeynutz44: folds=20
JonnyKakes59: folds=20
MyManPotnPan: calls 2800
Broker RR: folds=20
jrollsup1: folds=20
*** FLOP *** [8c Tc 4d]
lIlbILLYmAC: bets 4638
MyManPotnPan: raises 4638 to 9276
lIlbILLYmAC: raises 8924 to 18200
MyManPotnPan: raises 32074 to 50274 and is all-in
lIlbILLYmAC: calls 26891 and is all-in
Uncalled bet (5183) returned to MyManPotnPan
*** TURN *** [8c Tc 4d] [7h]
*** RIVER *** [8c Tc 4d 7h] [7c]
*** SHOW DOWN ***
lIlbILLYmAC: shows [Qh Qc] (two pair, Queens and Sevens)
MyManPotnPan: shows [4s 4c] (a full house, Fours full of Sevens)
MyManPotnPan collected 99457 from pot
lIlbILLYmAC finished the tournament in 27th place
*** SUMMARY ***
Total pot 99457 | Rake 0=20
Board [8c Tc 4d 7h 7c]
Seat 1: jrollsup1 (big blind) folded before Flop
Seat 2: Article332 folded before Flop (didn't bet)
Seat 3: lIlbILLYmAC showed [Qh Qc] and lost with two pair, Queens and S=
evens
Seat 4: JJin91 folded before Flop (didn't bet)
Seat 5: PureWizardry folded before Flop (didn't bet)
Seat 6: donkeynutz44 folded before Flop (didn't bet)
Seat 7: JonnyKakes59 folded before Flop (didn't bet)
Seat 8: MyManPotnPan (button) showed [4s 4c] and won (99457) with a ful=
l house, Fours full of Sevens
Seat 9: Broker RR (small blind) folded before Flop


*********** # 95 **************
PokerStars Hand #169317945805: Tournament #1597683884, $18.20+$1.80 USD=
 Hold'em No Limit - Level XVII (700/1400) - 2017/05/02 22:06:54 ET
Table '1597683884 2' 9-max Seat #9 is the button
Seat 1: jrollsup1 (34042 in chips)=20
Seat 2: Article332 (63958 in chips)=20
Seat 4: JJin91 (29680 in chips)=20
Seat 5: PureWizardry (39601 in chips)=20
Seat 6: donkeynutz44 (29760 in chips)=20
Seat 7: JonnyKakes59 (25234 in chips)=20
Seat 8: MyManPotnPan (104640 in chips)=20
Seat 9: Broker RR (42409 in chips)=20
jrollsup1: posts the ante 175
Article332: posts the ante 175
JJin91: posts the ante 175
PureWizardry: posts the ante 175
donkeynutz44: posts the ante 175
JonnyKakes59: posts the ante 175
MyManPotnPan: posts the ante 175
Broker RR: posts the ante 175
jrollsup1: posts small blind 700
Article332: posts big blind 1400
*** HOLE CARDS ***
Dealt to JJin91 [4c 3s]
JJin91: folds=20
PureWizardry: folds=20
donkeynutz44: folds=20
JonnyKakes59: folds=20
MyManPotnPan: folds=20
Broker RR: folds=20
jrollsup1: raises 32467 to 33867 and is all-in
Article332: folds=20
Uncalled bet (32467) returned to jrollsup1
jrollsup1 collected 4200 from pot
jrollsup1: doesn't show hand=20
*** SUMMARY ***
Total pot 4200 | Rake 0=20
Seat 1: jrollsup1 (small blind) collected (4200)
Seat 2: Article332 (big blind) folded before Flop
Seat 4: JJin91 folded before Flop (didn't bet)
Seat 5: PureWizardry folded before Flop (didn't bet)
Seat 6: donkeynutz44 folded before Flop (didn't bet)
Seat 7: JonnyKakes59 folded before Flop (didn't bet)
Seat 8: MyManPotnPan folded before Flop (didn't bet)
Seat 9: Broker RR (button) folded before Flop (didn't bet)


*********** # 96 **************
PokerStars Hand #169317945990: Tournament #1597683884, $18.20+$1.80 USD=
 Hold'em No Limit - Level XVII (700/1400) - 2017/05/02 22:07:32 ET
Table '1597683884 2' 9-max Seat #1 is the button
Seat 1: jrollsup1 (36667 in chips)=20
Seat 2: Article332 (62383 in chips)=20
Seat 4: JJin91 (29505 in chips)=20
Seat 5: PureWizardry (39426 in chips)=20
Seat 6: donkeynutz44 (29585 in chips)=20
Seat 7: JonnyKakes59 (25059 in chips)=20
Seat 8: MyManPotnPan (104465 in chips)=20
Seat 9: Broker RR (42234 in chips)=20
jrollsup1: posts the ante 175
Article332: posts the ante 175
JJin91: posts the ante 175
PureWizardry: posts the ante 175
donkeynutz44: posts the ante 175
JonnyKakes59: posts the ante 175
MyManPotnPan: posts the ante 175
Broker RR: posts the ante 175
Article332: posts small blind 700
JJin91: posts big blind 1400
*** HOLE CARDS ***
Dealt to JJin91 [Tc 3d]
PureWizardry: folds=20
donkeynutz44: folds=20
JonnyKakes59: folds=20
MyManPotnPan: folds=20
Broker RR: folds=20
jrollsup1: raises 1400 to 2800
Article332: calls 2100
JJin91: folds=20
*** FLOP *** [Ac 8c 2c]
Article332: checks=20
jrollsup1: checks=20
*** TURN *** [Ac 8c 2c] [6d]
Article332: checks=20
jrollsup1: bets 3500
Article332: calls 3500
*** RIVER *** [Ac 8c 2c 6d] [5c]
Article332: checks=20
jrollsup1: bets 10500
Article332: calls 10500
*** SHOW DOWN ***
jrollsup1: shows [7h 7s] (a pair of Sevens)
Article332: shows [Ad Kh] (a pair of Aces)
Article332 collected 36400 from pot
*** SUMMARY ***
Total pot 36400 | Rake 0=20
Board [Ac 8c 2c 6d 5c]
Seat 1: jrollsup1 (button) showed [7h 7s] and lost with a pair of Sevens
Seat 2: Article332 (small blind) showed [Ad Kh] and won (36400) with a =
pair of Aces
Seat 4: JJin91 (big blind) folded before Flop
Seat 5: PureWizardry folded before Flop (didn't bet)
Seat 6: donkeynutz44 folded before Flop (didn't bet)
Seat 7: JonnyKakes59 folded before Flop (didn't bet)
Seat 8: MyManPotnPan folded before Flop (didn't bet)
Seat 9: Broker RR folded before Flop (didn't bet)


*********** # 97 **************
PokerStars Hand #169317946373: Tournament #1597683884, $18.20+$1.80 USD=
 Hold'em No Limit - Level XVIII (800/1600) - 2017/05/02 22:08:52 ET
Table '1597683884 2' 9-max Seat #2 is the button
Seat 1: jrollsup1 (19692 in chips)=20
Seat 2: Article332 (81808 in chips)=20
Seat 4: JJin91 (27930 in chips)=20
Seat 5: PureWizardry (39251 in chips)=20
Seat 6: donkeynutz44 (29410 in chips)=20
Seat 7: JonnyKakes59 (24884 in chips)=20
Seat 8: MyManPotnPan (104290 in chips)=20
Seat 9: Broker RR (42059 in chips)=20
jrollsup1: posts the ante 200
Article332: posts the ante 200
JJin91: posts the ante 200
PureWizardry: posts the ante 200
donkeynutz44: posts the ante 200
JonnyKakes59: posts the ante 200
MyManPotnPan: posts the ante 200
Broker RR: posts the ante 200
JJin91: posts small blind 800
PureWizardry: posts big blind 1600
*** HOLE CARDS ***
Dealt to JJin91 [3s 7c]
donkeynutz44: folds=20
JonnyKakes59: folds=20
MyManPotnPan: folds=20
Broker RR: raises 3200 to 4800
jrollsup1: folds=20
Article332: folds=20
JJin91: folds=20
PureWizardry: calls 3200
*** FLOP *** [3c 4d 8c]
PureWizardry: checks=20
Broker RR: bets 6000
PureWizardry: folds=20
Uncalled bet (6000) returned to Broker RR
Broker RR collected 12000 from pot
Broker RR: doesn't show hand=20
*** SUMMARY ***
Total pot 12000 | Rake 0=20
Board [3c 4d 8c]
Seat 1: jrollsup1 folded before Flop (didn't bet)
Seat 2: Article332 (button) folded before Flop (didn't bet)
Seat 4: JJin91 (small blind) folded before Flop
Seat 5: PureWizardry (big blind) folded on the Flop
Seat 6: donkeynutz44 folded before Flop (didn't bet)
Seat 7: JonnyKakes59 folded before Flop (didn't bet)
Seat 8: MyManPotnPan folded before Flop (didn't bet)
Seat 9: Broker RR collected (12000)


*********** # 98 **************
PokerStars Hand #169317946550: Tournament #1597683884, $18.20+$1.80 USD=
 Hold'em No Limit - Level XVIII (800/1600) - 2017/05/02 22:09:31 ET
Table '1597683884 2' 9-max Seat #4 is the button
Seat 1: jrollsup1 (19492 in chips)=20
Seat 2: Article332 (81608 in chips)=20
Seat 4: JJin91 (26930 in chips)=20
Seat 5: PureWizardry (34251 in chips)=20
Seat 6: donkeynutz44 (29210 in chips)=20
Seat 7: JonnyKakes59 (24684 in chips)=20
Seat 8: MyManPotnPan (104090 in chips)=20
Seat 9: Broker RR (49059 in chips)=20
jrollsup1: posts the ante 200
Article332: posts the ante 200
JJin91: posts the ante 200
PureWizardry: posts the ante 200
donkeynutz44: posts the ante 200
JonnyKakes59: posts the ante 200
MyManPotnPan: posts the ante 200
Broker RR: posts the ante 200
PureWizardry: posts small blind 800
donkeynutz44: posts big blind 1600
*** HOLE CARDS ***
Dealt to JJin91 [2d 8h]
JonnyKakes59: folds=20
MyManPotnPan: folds=20
Broker RR: raises 1600 to 3200
jrollsup1: folds=20
Article332: folds=20
JJin91: folds=20
PureWizardry: folds=20
donkeynutz44: calls 1600
*** FLOP *** [6s 9h 8c]
donkeynutz44: checks=20
Broker RR: checks=20
*** TURN *** [6s 9h 8c] [4d]
donkeynutz44: bets 4400
Broker RR: folds=20
Uncalled bet (4400) returned to donkeynutz44
donkeynutz44 collected 8800 from pot
donkeynutz44: doesn't show hand=20
*** SUMMARY ***
Total pot 8800 | Rake 0=20
Board [6s 9h 8c 4d]
Seat 1: jrollsup1 folded before Flop (didn't bet)
Seat 2: Article332 folded before Flop (didn't bet)
Seat 4: JJin91 (button) folded before Flop (didn't bet)
Seat 5: PureWizardry (small blind) folded before Flop
Seat 6: donkeynutz44 (big blind) collected (8800)
Seat 7: JonnyKakes59 folded before Flop (didn't bet)
Seat 8: MyManPotnPan folded before Flop (didn't bet)
Seat 9: Broker RR folded on the Turn


*********** # 99 **************
PokerStars Hand #169317946812: Tournament #1597683884, $18.20+$1.80 USD=
 Hold'em No Limit - Level XVIII (800/1600) - 2017/05/02 22:10:28 ET
Table '1597683884 2' 9-max Seat #5 is the button
Seat 1: jrollsup1 (19292 in chips)=20
Seat 2: Article332 (81408 in chips)=20
Seat 4: JJin91 (26730 in chips)=20
Seat 5: PureWizardry (33251 in chips)=20
Seat 6: donkeynutz44 (34610 in chips)=20
Seat 7: JonnyKakes59 (24484 in chips)=20
Seat 8: MyManPotnPan (103890 in chips)=20
Seat 9: Broker RR (45659 in chips)=20
jrollsup1: posts the ante 200
Article332: posts the ante 200
JJin91: posts the ante 200
PureWizardry: posts the ante 200
donkeynutz44: posts the ante 200
JonnyKakes59: posts the ante 200
MyManPotnPan: posts the ante 200
Broker RR: posts the ante 200
donkeynutz44: posts small blind 800
JonnyKakes59: posts big blind 1600
*** HOLE CARDS ***
Dealt to JJin91 [9d As]
MyManPotnPan: folds=20
Broker RR: folds=20
jrollsup1: folds=20
Article332: folds=20
JJin91: raises 1751 to 3351
PureWizardry: folds=20
donkeynutz44: folds=20
JonnyKakes59: folds=20
Uncalled bet (1751) returned to JJin91
JJin91 collected 5600 from pot
JJin91: doesn't show hand=20
*** SUMMARY ***
Total pot 5600 | Rake 0=20
Seat 1: jrollsup1 folded before Flop (didn't bet)
Seat 2: Article332 folded before Flop (didn't bet)
Seat 4: JJin91 collected (5600)
Seat 5: PureWizardry (button) folded before Flop (didn't bet)
Seat 6: donkeynutz44 (small blind) folded before Flop
Seat 7: JonnyKakes59 (big blind) folded before Flop
Seat 8: MyManPotnPan folded before Flop (didn't bet)
Seat 9: Broker RR folded before Flop (didn't bet)


*********** # 100 **************
PokerStars Hand #169317946969: Tournament #1597683884, $18.20+$1.80 USD=
 Hold'em No Limit - Level XVIII (800/1600) - 2017/05/02 22:11:02 ET
Table '1597683884 2' 9-max Seat #6 is the button
Seat 1: jrollsup1 (19092 in chips)=20
Seat 2: Article332 (81208 in chips)=20
Seat 4: JJin91 (30530 in chips)=20
Seat 5: PureWizardry (33051 in chips)=20
Seat 6: donkeynutz44 (33610 in chips)=20
Seat 7: JonnyKakes59 (22684 in chips)=20
Seat 8: MyManPotnPan (103690 in chips)=20
Seat 9: Broker RR (45459 in chips)=20
jrollsup1: posts the ante 200
Article332: posts the ante 200
JJin91: posts the ante 200
PureWizardry: posts the ante 200
donkeynutz44: posts the ante 200
JonnyKakes59: posts the ante 200
MyManPotnPan: posts the ante 200
Broker RR: posts the ante 200
JonnyKakes59: posts small blind 800
MyManPotnPan: posts big blind 1600
*** HOLE CARDS ***
Dealt to JJin91 [4d 3d]
Broker RR: folds=20
jrollsup1: raises 17292 to 18892 and is all-in
Article332: folds=20
JJin91: folds=20
PureWizardry: folds=20
donkeynutz44: folds=20
JonnyKakes59: folds=20
MyManPotnPan: folds=20
Uncalled bet (17292) returned to jrollsup1
jrollsup1 collected 5600 from pot
jrollsup1: doesn't show hand=20
*** SUMMARY ***
Total pot 5600 | Rake 0=20
Seat 1: jrollsup1 collected (5600)
Seat 2: Article332 folded before Flop (didn't bet)
Seat 4: JJin91 folded before Flop (didn't bet)
Seat 5: PureWizardry folded before Flop (didn't bet)
Seat 6: donkeynutz44 (button) folded before Flop (didn't bet)
Seat 7: JonnyKakes59 (small blind) folded before Flop
Seat 8: MyManPotnPan (big blind) folded before Flop
Seat 9: Broker RR folded before Flop (didn't bet)


*********** # 101 **************
PokerStars Hand #169317947141: Tournament #1597683884, $18.20+$1.80 USD=
 Hold'em No Limit - Level XVIII (800/1600) - 2017/05/02 22:11:37 ET
Table '1597683884 2' 9-max Seat #7 is the button
Seat 1: jrollsup1 (22892 in chips)=20
Seat 2: Article332 (81008 in chips)=20
Seat 4: JJin91 (30330 in chips)=20
Seat 5: PureWizardry (32851 in chips)=20
Seat 6: donkeynutz44 (33410 in chips)=20
Seat 7: JonnyKakes59 (21684 in chips)=20
Seat 8: MyManPotnPan (101890 in chips)=20
Seat 9: Broker RR (45259 in chips)=20
jrollsup1: posts the ante 200
Article332: posts the ante 200
JJin91: posts the ante 200
PureWizardry: posts the ante 200
donkeynutz44: posts the ante 200
JonnyKakes59: posts the ante 200
MyManPotnPan: posts the ante 200
Broker RR: posts the ante 200
MyManPotnPan: posts small blind 800
Broker RR: posts big blind 1600
*** HOLE CARDS ***
Dealt to JJin91 [8d Ts]
jrollsup1: folds=20
Article332: folds=20
JJin91: folds=20
PureWizardry: folds=20
donkeynutz44: folds=20
JonnyKakes59: raises 19884 to 21484 and is all-in
MyManPotnPan: folds=20
Broker RR: folds=20
Uncalled bet (19884) returned to JonnyKakes59
JonnyKakes59 collected 5600 from pot
JonnyKakes59: doesn't show hand=20
*** SUMMARY ***
Total pot 5600 | Rake 0=20
Seat 1: jrollsup1 folded before Flop (didn't bet)
Seat 2: Article332 folded before Flop (didn't bet)
Seat 4: JJin91 folded before Flop (didn't bet)
Seat 5: PureWizardry folded before Flop (didn't bet)
Seat 6: donkeynutz44 folded before Flop (didn't bet)
Seat 7: JonnyKakes59 (button) collected (5600)
Seat 8: MyManPotnPan (small blind) folded before Flop
Seat 9: Broker RR (big blind) folded before Flop


*********** # 102 **************
PokerStars Hand #169317947255: Tournament #1597683884, $18.20+$1.80 USD=
 Hold'em No Limit - Level XVIII (800/1600) - 2017/05/02 22:12:00 ET
Table '1597683884 2' 9-max Seat #8 is the button
Seat 1: jrollsup1 (22692 in chips)=20
Seat 2: Article332 (80808 in chips)=20
Seat 4: JJin91 (30130 in chips)=20
Seat 5: PureWizardry (32651 in chips)=20
Seat 6: donkeynutz44 (33210 in chips)=20
Seat 7: JonnyKakes59 (25484 in chips)=20
Seat 8: MyManPotnPan (100890 in chips)=20
Seat 9: Broker RR (43459 in chips)=20
jrollsup1: posts the ante 200
Article332: posts the ante 200
JJin91: posts the ante 200
PureWizardry: posts the ante 200
donkeynutz44: posts the ante 200
JonnyKakes59: posts the ante 200
MyManPotnPan: posts the ante 200
Broker RR: posts the ante 200
Broker RR: posts small blind 800
jrollsup1: posts big blind 1600
*** HOLE CARDS ***
Dealt to JJin91 [Js 3c]
Article332: folds=20
JJin91: folds=20
PureWizardry: folds=20
donkeynutz44: folds=20
JonnyKakes59: folds=20
MyManPotnPan: raises 3200 to 4800
Broker RR: folds=20
jrollsup1: folds=20
Uncalled bet (3200) returned to MyManPotnPan
MyManPotnPan collected 5600 from pot
MyManPotnPan: doesn't show hand=20
*** SUMMARY ***
Total pot 5600 | Rake 0=20
Seat 1: jrollsup1 (big blind) folded before Flop
Seat 2: Article332 folded before Flop (didn't bet)
Seat 4: JJin91 folded before Flop (didn't bet)
Seat 5: PureWizardry folded before Flop (didn't bet)
Seat 6: donkeynutz44 folded before Flop (didn't bet)
Seat 7: JonnyKakes59 folded before Flop (didn't bet)
Seat 8: MyManPotnPan (button) collected (5600)
Seat 9: Broker RR (small blind) folded before Flop


*********** # 103 **************
PokerStars Hand #169317947399: Tournament #1597683884, $18.20+$1.80 USD=
 Hold'em No Limit - Level XVIII (800/1600) - 2017/05/02 22:12:31 ET
Table '1597683884 2' 9-max Seat #9 is the button
Seat 1: jrollsup1 (20892 in chips)=20
Seat 2: Article332 (80608 in chips)=20
Seat 4: JJin91 (29930 in chips)=20
Seat 5: PureWizardry (32451 in chips)=20
Seat 6: donkeynutz44 (33010 in chips)=20
Seat 7: JonnyKakes59 (25284 in chips)=20
Seat 8: MyManPotnPan (104690 in chips)=20
Seat 9: Broker RR (42459 in chips)=20
jrollsup1: posts the ante 200
Article332: posts the ante 200
JJin91: posts the ante 200
PureWizardry: posts the ante 200
donkeynutz44: posts the ante 200
JonnyKakes59: posts the ante 200
MyManPotnPan: posts the ante 200
Broker RR: posts the ante 200
jrollsup1: posts small blind 800
Article332: posts big blind 1600
*** HOLE CARDS ***
Dealt to JJin91 [Ts Th]
JJin91: raises 2256 to 3856
PureWizardry: folds=20
donkeynutz44: folds=20
JonnyKakes59: folds=20
MyManPotnPan: folds=20
Broker RR: raises 38403 to 42259 and is all-in
jrollsup1: folds=20
Article332: folds=20
JJin91: calls 25874 and is all-in
Uncalled bet (12529) returned to Broker RR
*** FLOP *** [2h 4h 6s]
*** TURN *** [2h 4h 6s] [9c]
*** RIVER *** [2h 4h 6s 9c] [Jh]
*** SHOW DOWN ***
JJin91: shows [Ts Th] (a pair of Tens)
Broker RR: shows [As Td] (high card Ace)
JJin91 collected 63460 from pot
*** SUMMARY ***
Total pot 63460 | Rake 0=20
Board [2h 4h 6s 9c Jh]
Seat 1: jrollsup1 (small blind) folded before Flop
Seat 2: Article332 (big blind) folded before Flop
Seat 4: JJin91 showed [Ts Th] and won (63460) with a pair of Tens
Seat 5: PureWizardry folded before Flop (didn't bet)
Seat 6: donkeynutz44 folded before Flop (didn't bet)
Seat 7: JonnyKakes59 folded before Flop (didn't bet)
Seat 8: MyManPotnPan folded before Flop (didn't bet)
Seat 9: Broker RR (button) showed [As Td] and lost with high card Ace


*********** # 104 **************
PokerStars Hand #169317947711: Tournament #1597683884, $18.20+$1.80 USD=
 Hold'em No Limit - Level XVIII (800/1600) - 2017/05/02 22:13:33 ET
Table '1597683884 2' 9-max Seat #1 is the button
Seat 1: jrollsup1 (19892 in chips)=20
Seat 2: Article332 (78808 in chips)=20
Seat 4: JJin91 (63460 in chips)=20
Seat 5: PureWizardry (32251 in chips)=20
Seat 6: donkeynutz44 (32810 in chips)=20
Seat 7: JonnyKakes59 (25084 in chips)=20
Seat 8: MyManPotnPan (104490 in chips)=20
Seat 9: Broker RR (12529 in chips)=20
jrollsup1: posts the ante 200
Article332: posts the ante 200
JJin91: posts the ante 200
PureWizardry: posts the ante 200
donkeynutz44: posts the ante 200
JonnyKakes59: posts the ante 200
MyManPotnPan: posts the ante 200
Broker RR: posts the ante 200
Article332: posts small blind 800
JJin91: posts big blind 1600
*** HOLE CARDS ***
Dealt to JJin91 [Jd 2s]
PureWizardry: folds=20
donkeynutz44: folds=20
JonnyKakes59: folds=20
MyManPotnPan: raises 3200 to 4800
Broker RR: folds=20
jrollsup1: folds=20
Article332: folds=20
JJin91: folds=20
Uncalled bet (3200) returned to MyManPotnPan
MyManPotnPan collected 5600 from pot
MyManPotnPan: doesn't show hand=20
*** SUMMARY ***
Total pot 5600 | Rake 0=20
Seat 1: jrollsup1 (button) folded before Flop (didn't bet)
Seat 2: Article332 (small blind) folded before Flop
Seat 4: JJin91 (big blind) folded before Flop
Seat 5: PureWizardry folded before Flop (didn't bet)
Seat 6: donkeynutz44 folded before Flop (didn't bet)
Seat 7: JonnyKakes59 folded before Flop (didn't bet)
Seat 8: MyManPotnPan collected (5600)
Seat 9: Broker RR folded before Flop (didn't bet)


*********** # 105 **************
PokerStars Hand #169317947835: Tournament #1597683884, $18.20+$1.80 USD=
 Hold'em No Limit - Level XVIII (800/1600) - 2017/05/02 22:14:02 ET
Table '1597683884 2' 9-max Seat #2 is the button
Seat 1: jrollsup1 (19692 in chips)=20
Seat 2: Article332 (77808 in chips)=20
Seat 4: JJin91 (61660 in chips)=20
Seat 5: PureWizardry (32051 in chips)=20
Seat 6: donkeynutz44 (32610 in chips)=20
Seat 7: JonnyKakes59 (24884 in chips)=20
Seat 8: MyManPotnPan (108290 in chips)=20
Seat 9: Broker RR (12329 in chips)=20
jrollsup1: posts the ante 200
Article332: posts the ante 200
JJin91: posts the ante 200
PureWizardry: posts the ante 200
donkeynutz44: posts the ante 200
JonnyKakes59: posts the ante 200
MyManPotnPan: posts the ante 200
Broker RR: posts the ante 200
JJin91: posts small blind 800
PureWizardry: posts big blind 1600
*** HOLE CARDS ***
Dealt to JJin91 [6d 7s]
donkeynutz44: calls 1600
JonnyKakes59: folds=20
MyManPotnPan: raises 3200 to 4800
Broker RR: folds=20
jrollsup1: folds=20
Article332: calls 4800
JJin91: folds=20
PureWizardry: calls 3200
donkeynutz44: calls 3200
*** FLOP *** [7d 6h 8s]
PureWizardry: checks=20
donkeynutz44: checks=20
MyManPotnPan: checks=20
Article332: bets 8000
PureWizardry: raises 19051 to 27051 and is all-in
donkeynutz44: folds=20
MyManPotnPan: folds=20
Article332: folds=20
Uncalled bet (19051) returned to PureWizardry
PureWizardry collected 37600 from pot
PureWizardry: doesn't show hand=20
*** SUMMARY ***
Total pot 37600 | Rake 0=20
Board [7d 6h 8s]
Seat 1: jrollsup1 folded before Flop (didn't bet)
Seat 2: Article332 (button) folded on the Flop
Seat 4: JJin91 (small blind) folded before Flop
Seat 5: PureWizardry (big blind) collected (37600)
Seat 6: donkeynutz44 folded on the Flop
Seat 7: JonnyKakes59 folded before Flop (didn't bet)
Seat 8: MyManPotnPan folded on the Flop
Seat 9: Broker RR folded before Flop (didn't bet)


*********** # 106 **************
PokerStars Hand #169317948324: Tournament #1597683884, $18.20+$1.80 USD=
 Hold'em No Limit - Level XVIII (800/1600) - 2017/05/02 22:15:38 ET
Table '1597683884 2' 9-max Seat #4 is the button
Seat 1: jrollsup1 (19492 in chips)=20
Seat 2: Article332 (64808 in chips)=20
Seat 4: JJin91 (60660 in chips)=20
Seat 5: PureWizardry (56651 in chips)=20
Seat 6: donkeynutz44 (27610 in chips)=20
Seat 7: JonnyKakes59 (24684 in chips)=20
Seat 8: MyManPotnPan (103290 in chips)=20
Seat 9: Broker RR (12129 in chips)=20
jrollsup1: posts the ante 200
Article332: posts the ante 200
JJin91: posts the ante 200
PureWizardry: posts the ante 200
donkeynutz44: posts the ante 200
JonnyKakes59: posts the ante 200
MyManPotnPan: posts the ante 200
Broker RR: posts the ante 200
PureWizardry: posts small blind 800
donkeynutz44: posts big blind 1600
*** HOLE CARDS ***
Dealt to JJin91 [Js Ac]
JonnyKakes59: folds=20
MyManPotnPan: folds=20
Broker RR: folds=20
jrollsup1: folds=20
Article332: folds=20
JJin91: raises 1776 to 3376
PureWizardry: calls 2576
donkeynutz44: folds=20
*** FLOP *** [Ah 9s 9h]
PureWizardry: checks=20
JJin91: bets 3085
PureWizardry: calls 3085
*** TURN *** [Ah 9s 9h] [Th]
PureWizardry: bets 7200
JJin91: raises 12000 to 19200
PureWizardry: calls 12000
*** RIVER *** [Ah 9s 9h Th] [Ks]
PureWizardry: checks=20
JJin91: checks=20
*** SHOW DOWN ***
PureWizardry: shows [Qh Jh] (a flush, Ace high)
JJin91: mucks hand=20
PureWizardry collected 54522 from pot
*** SUMMARY ***
Total pot 54522 | Rake 0=20
Board [Ah 9s 9h Th Ks]
Seat 1: jrollsup1 folded before Flop (didn't bet)
Seat 2: Article332 folded before Flop (didn't bet)
Seat 4: JJin91 (button) mucked [Js Ac]
Seat 5: PureWizardry (small blind) showed [Qh Jh] and won (54522) with =
a flush, Ace high
Seat 6: donkeynutz44 (big blind) folded before Flop
Seat 7: JonnyKakes59 folded before Flop (didn't bet)
Seat 8: MyManPotnPan folded before Flop (didn't bet)
Seat 9: Broker RR folded before Flop (didn't bet)


*********** # 107 **************
PokerStars Hand #169317948777: Tournament #1597683884, $18.20+$1.80 USD=
 Hold'em No Limit - Level XVIII (800/1600) - 2017/05/02 22:17:02 ET
Table '1597683884 2' 9-max Seat #5 is the button
Seat 1: jrollsup1 (19292 in chips)=20
Seat 2: Article332 (64608 in chips)=20
Seat 4: JJin91 (34799 in chips)=20
Seat 5: PureWizardry (85312 in chips)=20
Seat 6: donkeynutz44 (25810 in chips)=20
Seat 7: JonnyKakes59 (24484 in chips)=20
Seat 8: MyManPotnPan (103090 in chips)=20
Seat 9: Broker RR (11929 in chips)=20
jrollsup1: posts the ante 200
Article332: posts the ante 200
JJin91: posts the ante 200
PureWizardry: posts the ante 200
donkeynutz44: posts the ante 200
JonnyKakes59: posts the ante 200
MyManPotnPan: posts the ante 200
Broker RR: posts the ante 200
donkeynutz44: posts small blind 800
JonnyKakes59: posts big blind 1600
*** HOLE CARDS ***
Dealt to JJin91 [3c Jd]
MyManPotnPan: raises 3200 to 4800
Broker RR: folds=20
jrollsup1: folds=20
Article332: folds=20
JJin91: folds=20
PureWizardry: folds=20
donkeynutz44: folds=20
JonnyKakes59: folds=20
Uncalled bet (3200) returned to MyManPotnPan
MyManPotnPan collected 5600 from pot
MyManPotnPan: doesn't show hand=20
*** SUMMARY ***
Total pot 5600 | Rake 0=20
Seat 1: jrollsup1 folded before Flop (didn't bet)
Seat 2: Article332 folded before Flop (didn't bet)
Seat 4: JJin91 folded before Flop (didn't bet)
Seat 5: PureWizardry (button) folded before Flop (didn't bet)
Seat 6: donkeynutz44 (small blind) folded before Flop
Seat 7: JonnyKakes59 (big blind) folded before Flop
Seat 8: MyManPotnPan collected (5600)
Seat 9: Broker RR folded before Flop (didn't bet)


*********** # 108 **************
PokerStars Hand #169317948917: Tournament #1597683884, $18.20+$1.80 USD=
 Hold'em No Limit - Level XVIII (800/1600) - 2017/05/02 22:17:30 ET
Table '1597683884 2' 9-max Seat #6 is the button
Seat 1: jrollsup1 (19092 in chips)=20
Seat 2: Article332 (64408 in chips)=20
Seat 4: JJin91 (34599 in chips)=20
Seat 5: PureWizardry (85112 in chips)=20
Seat 6: donkeynutz44 (24810 in chips)=20
Seat 7: JonnyKakes59 (22684 in chips)=20
Seat 8: MyManPotnPan (106890 in chips)=20
Seat 9: Broker RR (11729 in chips)=20
jrollsup1: posts the ante 200
Article332: posts the ante 200
JJin91: posts the ante 200
PureWizardry: posts the ante 200
donkeynutz44: posts the ante 200
JonnyKakes59: posts the ante 200
MyManPotnPan: posts the ante 200
Broker RR: posts the ante 200
JonnyKakes59: posts small blind 800
MyManPotnPan: posts big blind 1600
*** HOLE CARDS ***
Dealt to JJin91 [Ks 8c]
Broker RR: raises 9929 to 11529 and is all-in
jrollsup1: folds=20
Article332: folds=20
JJin91: folds=20
PureWizardry: folds=20
donkeynutz44: folds=20
JonnyKakes59: folds=20
MyManPotnPan: calls 9929
*** FLOP *** [5c Qs 7c]
*** TURN *** [5c Qs 7c] [7h]
*** RIVER *** [5c Qs 7c 7h] [Kc]
*** SHOW DOWN ***
MyManPotnPan: shows [Ac Tc] (a flush, Ace high)
Broker RR: shows [6d Ad] (a pair of Sevens)
MyManPotnPan collected 25458 from pot
Broker RR finished the tournament in 24th place
*** SUMMARY ***
Total pot 25458 | Rake 0=20
Board [5c Qs 7c 7h Kc]
Seat 1: jrollsup1 folded before Flop (didn't bet)
Seat 2: Article332 folded before Flop (didn't bet)
Seat 4: JJin91 folded before Flop (didn't bet)
Seat 5: PureWizardry folded before Flop (didn't bet)
Seat 6: donkeynutz44 (button) folded before Flop (didn't bet)
Seat 7: JonnyKakes59 (small blind) folded before Flop
Seat 8: MyManPotnPan (big blind) showed [Ac Tc] and won (25458) with a =
flush, Ace high
Seat 9: Broker RR showed [6d Ad] and lost with a pair of Sevens


*********** # 109 **************
PokerStars Hand #169317949093: Tournament #1597683884, $18.20+$1.80 USD=
 Hold'em No Limit - Level XVIII (800/1600) - 2017/05/02 22:18:05 ET
Table '1597683884 2' 9-max Seat #7 is the button
Seat 1: jrollsup1 (18892 in chips)=20
Seat 2: Article332 (64208 in chips)=20
Seat 4: JJin91 (34399 in chips)=20
Seat 5: PureWizardry (84912 in chips)=20
Seat 6: donkeynutz44 (24610 in chips)=20
Seat 7: JonnyKakes59 (21684 in chips)=20
Seat 8: MyManPotnPan (120619 in chips)=20
jrollsup1: posts the ante 200
Article332: posts the ante 200
JJin91: posts the ante 200
PureWizardry: posts the ante 200
donkeynutz44: posts the ante 200
JonnyKakes59: posts the ante 200
MyManPotnPan: posts the ante 200
MyManPotnPan: posts small blind 800
jrollsup1: posts big blind 1600
*** HOLE CARDS ***
Dealt to JJin91 [Ac 7h]
Article332: folds=20
JJin91: folds=20
PureWizardry: folds=20
donkeynutz44: folds=20
JonnyKakes59: folds=20
MyManPotnPan: folds=20
Uncalled bet (800) returned to jrollsup1
jrollsup1 collected 3000 from pot
jrollsup1: doesn't show hand=20
*** SUMMARY ***
Total pot 3000 | Rake 0=20
Seat 1: jrollsup1 (big blind) collected (3000)
Seat 2: Article332 folded before Flop (didn't bet)
Seat 4: JJin91 folded before Flop (didn't bet)
Seat 5: PureWizardry folded before Flop (didn't bet)
Seat 6: donkeynutz44 folded before Flop (didn't bet)
Seat 7: JonnyKakes59 (button) folded before Flop (didn't bet)
Seat 8: MyManPotnPan (small blind) folded before Flop


*********** # 110 **************
PokerStars Hand #169317949252: Tournament #1597683884, $18.20+$1.80 USD=
 Hold'em No Limit - Level XIX (1000/2000) - 2017/05/02 22:18:36 ET
Table '1597683884 2' 9-max Seat #8 is the button
Seat 1: jrollsup1 (20892 in chips)=20
Seat 2: Article332 (64008 in chips)=20
Seat 4: JJin91 (34199 in chips)=20
Seat 5: PureWizardry (84712 in chips)=20
Seat 6: donkeynutz44 (24410 in chips)=20
Seat 7: JonnyKakes59 (21484 in chips)=20
Seat 8: MyManPotnPan (119619 in chips)=20
jrollsup1: posts the ante 250
Article332: posts the ante 250
JJin91: posts the ante 250
PureWizardry: posts the ante 250
donkeynutz44: posts the ante 250
JonnyKakes59: posts the ante 250
MyManPotnPan: posts the ante 250
jrollsup1: posts small blind 1000
Article332: posts big blind 2000
*** HOLE CARDS ***
Dealt to JJin91 [9c Qs]
JJin91: folds=20
PureWizardry: raises 2400 to 4400
donkeynutz44: folds=20
JonnyKakes59: folds=20
MyManPotnPan: folds=20
jrollsup1: folds=20
Article332: calls 2400
*** FLOP *** [4s Jh 5d]
Article332: checks=20
PureWizardry: checks=20
*** TURN *** [4s Jh 5d] [Tc]
Article332: bets 6000
PureWizardry: calls 6000
*** RIVER *** [4s Jh 5d Tc] [2c]
Article332: bets 14000
PureWizardry: folds=20
Uncalled bet (14000) returned to Article332
Article332 collected 23550 from pot
Article332: doesn't show hand=20
*** SUMMARY ***
Total pot 23550 | Rake 0=20
Board [4s Jh 5d Tc 2c]
Seat 1: jrollsup1 (small blind) folded before Flop
Seat 2: Article332 (big blind) collected (23550)
Seat 4: JJin91 folded before Flop (didn't bet)
Seat 5: PureWizardry folded on the River
Seat 6: donkeynutz44 folded before Flop (didn't bet)
Seat 7: JonnyKakes59 folded before Flop (didn't bet)
Seat 8: MyManPotnPan (button) folded before Flop (didn't bet)


*********** # 111 **************
PokerStars Hand #169317949594: Tournament #1597683884, $18.20+$1.80 USD=
 Hold'em No Limit - Level XIX (1000/2000) - 2017/05/02 22:19:40 ET
Table '1597683884 2' 9-max Seat #1 is the button
Seat 1: jrollsup1 (19642 in chips)=20
Seat 2: Article332 (76908 in chips)=20
Seat 4: JJin91 (33949 in chips)=20
Seat 5: PureWizardry (74062 in chips)=20
Seat 6: donkeynutz44 (24160 in chips)=20
Seat 7: JonnyKakes59 (21234 in chips)=20
Seat 8: MyManPotnPan (119369 in chips)=20
jrollsup1: posts the ante 250
Article332: posts the ante 250
JJin91: posts the ante 250
PureWizardry: posts the ante 250
donkeynutz44: posts the ante 250
JonnyKakes59: posts the ante 250
MyManPotnPan: posts the ante 250
Article332: posts small blind 1000
JJin91: posts big blind 2000
*** HOLE CARDS ***
Dealt to JJin91 [5h 9h]
PureWizardry: folds=20
donkeynutz44: folds=20
JonnyKakes59: raises 18984 to 20984 and is all-in
MyManPotnPan: folds=20
jrollsup1: folds=20
Article332: folds=20
JJin91: folds=20
Uncalled bet (18984) returned to JonnyKakes59
JonnyKakes59 collected 6750 from pot
JonnyKakes59: doesn't show hand=20
*** SUMMARY ***
Total pot 6750 | Rake 0=20
Seat 1: jrollsup1 (button) folded before Flop (didn't bet)
Seat 2: Article332 (small blind) folded before Flop
Seat 4: JJin91 (big blind) folded before Flop
Seat 5: PureWizardry folded before Flop (didn't bet)
Seat 6: donkeynutz44 folded before Flop (didn't bet)
Seat 7: JonnyKakes59 collected (6750)
Seat 8: MyManPotnPan folded before Flop (didn't bet)


*********** # 112 **************
PokerStars Hand #169317949797: Tournament #1597683884, $18.20+$1.80 USD=
 Hold'em No Limit - Level XIX (1000/2000) - 2017/05/02 22:20:19 ET
Table '1597683884 2' 9-max Seat #2 is the button
Seat 1: jrollsup1 (19392 in chips)=20
Seat 2: Article332 (75658 in chips)=20
Seat 4: JJin91 (31699 in chips)=20
Seat 5: PureWizardry (73812 in chips)=20
Seat 6: donkeynutz44 (23910 in chips)=20
Seat 7: JonnyKakes59 (25734 in chips)=20
Seat 8: MyManPotnPan (119119 in chips)=20
jrollsup1: posts the ante 250
Article332: posts the ante 250
JJin91: posts the ante 250
PureWizardry: posts the ante 250
donkeynutz44: posts the ante 250
JonnyKakes59: posts the ante 250
MyManPotnPan: posts the ante 250
JJin91: posts small blind 1000
PureWizardry: posts big blind 2000
*** HOLE CARDS ***
Dealt to JJin91 [Ad Js]
donkeynutz44: folds=20
JonnyKakes59: folds=20
MyManPotnPan: folds=20
jrollsup1: folds=20
Article332: folds=20
JJin91: raises 2820 to 4820
PureWizardry: raises 68742 to 73562 and is all-in
JJin91: calls 26629 and is all-in
Uncalled bet (42113) returned to PureWizardry
*** FLOP *** [As 7c 6c]
*** TURN *** [As 7c 6c] [4s]
*** RIVER *** [As 7c 6c 4s] [8s]
*** SHOW DOWN ***
JJin91: shows [Ad Js] (a pair of Aces)
PureWizardry: shows [6h 9d] (a pair of Sixes)
JJin91 collected 64648 from pot
*** SUMMARY ***
Total pot 64648 | Rake 0=20
Board [As 7c 6c 4s 8s]
Seat 1: jrollsup1 folded before Flop (didn't bet)
Seat 2: Article332 (button) folded before Flop (didn't bet)
Seat 4: JJin91 (small blind) showed [Ad Js] and won (64648) with a pair=
 of Aces
Seat 5: PureWizardry (big blind) showed [6h 9d] and lost with a pair of=
 Sixes
Seat 6: donkeynutz44 folded before Flop (didn't bet)
Seat 7: JonnyKakes59 folded before Flop (didn't bet)
Seat 8: MyManPotnPan folded before Flop (didn't bet)


*********** # 113 **************
PokerStars Hand #169321214884: Tournament #1597683884, $18.20+$1.80 USD=
 Hold'em No Limit - Level XIX (1000/2000) - 2017/05/02 22:21:15 ET
Table '1597683884 2' 9-max Seat #4 is the button
Seat 1: jrollsup1 (19142 in chips)=20
Seat 2: Article332 (75408 in chips)=20
Seat 4: JJin91 (64648 in chips)=20
Seat 5: PureWizardry (42113 in chips)=20
Seat 6: donkeynutz44 (23660 in chips)=20
Seat 7: JonnyKakes59 (25484 in chips)=20
Seat 8: MyManPotnPan (118869 in chips)=20
jrollsup1: posts the ante 250
Article332: posts the ante 250
JJin91: posts the ante 250
PureWizardry: posts the ante 250
donkeynutz44: posts the ante 250
JonnyKakes59: posts the ante 250
MyManPotnPan: posts the ante 250
PureWizardry: posts small blind 1000
donkeynutz44: posts big blind 2000
*** HOLE CARDS ***
Dealt to JJin91 [Tc 2h]
JonnyKakes59: raises 2000 to 4000
MyManPotnPan: folds=20
jrollsup1: folds=20
Article332: folds=20
JJin91: folds=20
PureWizardry: folds=20
donkeynutz44: calls 2000
*** FLOP *** [3s 5h Ks]
donkeynutz44: checks=20
JonnyKakes59: checks=20
*** TURN *** [3s 5h Ks] [8d]
donkeynutz44: bets 5375
JonnyKakes59: folds=20
Uncalled bet (5375) returned to donkeynutz44
donkeynutz44 collected 10750 from pot
donkeynutz44: doesn't show hand=20
*** SUMMARY ***
Total pot 10750 | Rake 0=20
Board [3s 5h Ks 8d]
Seat 1: jrollsup1 folded before Flop (didn't bet)
Seat 2: Article332 folded before Flop (didn't bet)
Seat 4: JJin91 (button) folded before Flop (didn't bet)
Seat 5: PureWizardry (small blind) folded before Flop
Seat 6: donkeynutz44 (big blind) collected (10750)
Seat 7: JonnyKakes59 folded on the Turn
Seat 8: MyManPotnPan folded before Flop (didn't bet)


*********** # 114 **************
PokerStars Hand #169321215079: Tournament #1597683884, $18.20+$1.80 USD=
 Hold'em No Limit - Level XIX (1000/2000) - 2017/05/02 22:21:57 ET
Table '1597683884 2' 9-max Seat #5 is the button
Seat 1: jrollsup1 (18892 in chips)=20
Seat 2: Article332 (75158 in chips)=20
Seat 4: JJin91 (64398 in chips)=20
Seat 5: PureWizardry (40863 in chips)=20
Seat 6: donkeynutz44 (30160 in chips)=20
Seat 7: JonnyKakes59 (21234 in chips)=20
Seat 8: MyManPotnPan (118619 in chips)=20
jrollsup1: posts the ante 250
Article332: posts the ante 250
JJin91: posts the ante 250
PureWizardry: posts the ante 250
donkeynutz44: posts the ante 250
JonnyKakes59: posts the ante 250
MyManPotnPan: posts the ante 250
donkeynutz44: posts small blind 1000
JonnyKakes59: posts big blind 2000
*** HOLE CARDS ***
Dealt to JJin91 [7h Td]
MyManPotnPan: folds=20
jrollsup1: folds=20
Article332: folds=20
JJin91: folds=20
PureWizardry: raises 38613 to 40613 and is all-in
donkeynutz44: folds=20
JonnyKakes59: folds=20
Uncalled bet (38613) returned to PureWizardry
PureWizardry collected 6750 from pot
PureWizardry: doesn't show hand=20
*** SUMMARY ***
Total pot 6750 | Rake 0=20
Seat 1: jrollsup1 folded before Flop (didn't bet)
Seat 2: Article332 folded before Flop (didn't bet)
Seat 4: JJin91 folded before Flop (didn't bet)
Seat 5: PureWizardry (button) collected (6750)
Seat 6: donkeynutz44 (small blind) folded before Flop
Seat 7: JonnyKakes59 (big blind) folded before Flop
Seat 8: MyManPotnPan folded before Flop (didn't bet)


*********** # 115 **************
PokerStars Hand #169321215254: Tournament #1597683884, $18.20+$1.80 USD=
 Hold'em No Limit - Level XIX (1000/2000) - 2017/05/02 22:22:33 ET
Table '1597683884 2' 9-max Seat #6 is the button
Seat 1: jrollsup1 (18642 in chips)=20
Seat 2: Article332 (74908 in chips)=20
Seat 4: JJin91 (64148 in chips)=20
Seat 5: PureWizardry (45363 in chips)=20
Seat 6: donkeynutz44 (28910 in chips)=20
Seat 7: JonnyKakes59 (18984 in chips)=20
Seat 8: MyManPotnPan (118369 in chips)=20
jrollsup1: posts the ante 250
Article332: posts the ante 250
JJin91: posts the ante 250
PureWizardry: posts the ante 250
donkeynutz44: posts the ante 250
JonnyKakes59: posts the ante 250
MyManPotnPan: posts the ante 250
JonnyKakes59: posts small blind 1000
MyManPotnPan: posts big blind 2000
*** HOLE CARDS ***
Dealt to JJin91 [Kd Qh]
jrollsup1: folds=20
Article332: folds=20
JJin91: raises 2220 to 4220
PureWizardry: folds=20
donkeynutz44: folds=20
JonnyKakes59: folds=20
MyManPotnPan: calls 2220
*** FLOP *** [Ad 5h 5c]
MyManPotnPan: checks=20
donkeynutz44 is disconnected=20
JJin91: bets 3732
MyManPotnPan: folds=20
Uncalled bet (3732) returned to JJin91
JJin91 collected 11190 from pot
JJin91: doesn't show hand=20
*** SUMMARY ***
Total pot 11190 | Rake 0=20
Board [Ad 5h 5c]
Seat 1: jrollsup1 folded before Flop (didn't bet)
Seat 2: Article332 folded before Flop (didn't bet)
Seat 4: JJin91 collected (11190)
Seat 5: PureWizardry folded before Flop (didn't bet)
Seat 6: donkeynutz44 (button) folded before Flop (didn't bet)
Seat 7: JonnyKakes59 (small blind) folded before Flop
Seat 8: MyManPotnPan (big blind) folded on the Flop


*********** # 116 **************
PokerStars Hand #169321215443: Tournament #1597683884, $18.20+$1.80 USD=
 Hold'em No Limit - Level XIX (1000/2000) - 2017/05/02 22:23:14 ET
Table '1597683884 2' 9-max Seat #7 is the button
Seat 1: jrollsup1 (18392 in chips)=20
Seat 2: Article332 (74658 in chips)=20
Seat 4: JJin91 (70868 in chips)=20
Seat 5: PureWizardry (45113 in chips)=20
Seat 6: donkeynutz44 (28660 in chips)=20
Seat 7: JonnyKakes59 (17734 in chips)=20
Seat 8: MyManPotnPan (113899 in chips)=20
jrollsup1: posts the ante 250
Article332: posts the ante 250
JJin91: posts the ante 250
PureWizardry: posts the ante 250
donkeynutz44: posts the ante 250
JonnyKakes59: posts the ante 250
MyManPotnPan: posts the ante 250
MyManPotnPan: posts small blind 1000
jrollsup1: posts big blind 2000
*** HOLE CARDS ***
Dealt to JJin91 [8c Ac]
Article332: folds=20
JJin91: raises 2820 to 4820
PureWizardry: folds=20
donkeynutz44: folds=20
JonnyKakes59: folds=20
MyManPotnPan: folds=20
jrollsup1: folds=20
Uncalled bet (2820) returned to JJin91
JJin91 collected 6750 from pot
JJin91: doesn't show hand=20
*** SUMMARY ***
Total pot 6750 | Rake 0=20
Seat 1: jrollsup1 (big blind) folded before Flop
Seat 2: Article332 folded before Flop (didn't bet)
Seat 4: JJin91 collected (6750)
Seat 5: PureWizardry folded before Flop (didn't bet)
Seat 6: donkeynutz44 folded before Flop (didn't bet)
Seat 7: JonnyKakes59 (button) folded before Flop (didn't bet)
Seat 8: MyManPotnPan (small blind) folded before Flop


*********** # 117 **************
PokerStars Hand #169321215566: Tournament #1597683884, $18.20+$1.80 USD=
 Hold'em No Limit - Level XIX (1000/2000) - 2017/05/02 22:23:40 ET
Table '1597683884 2' 9-max Seat #8 is the button
Seat 1: jrollsup1 (16142 in chips)=20
Seat 2: Article332 (74408 in chips)=20
Seat 4: JJin91 (75368 in chips)=20
Seat 5: PureWizardry (44863 in chips)=20
Seat 6: donkeynutz44 (28410 in chips)=20
Seat 7: JonnyKakes59 (17484 in chips)=20
Seat 8: MyManPotnPan (112649 in chips)=20
jrollsup1: posts the ante 250
Article332: posts the ante 250
JJin91: posts the ante 250
PureWizardry: posts the ante 250
donkeynutz44: posts the ante 250
JonnyKakes59: posts the ante 250
MyManPotnPan: posts the ante 250
jrollsup1: posts small blind 1000
Article332: posts big blind 2000
*** HOLE CARDS ***
Dealt to JJin91 [8s Js]
JJin91: folds=20
PureWizardry: raises 2400 to 4400
donkeynutz44: folds=20
JonnyKakes59: folds=20
MyManPotnPan: folds=20
jrollsup1: folds=20
Article332: raises 5600 to 10000
PureWizardry: folds=20
Uncalled bet (5600) returned to Article332
Article332 collected 11550 from pot
Article332: doesn't show hand=20
*** SUMMARY ***
Total pot 11550 | Rake 0=20
Seat 1: jrollsup1 (small blind) folded before Flop
Seat 2: Article332 (big blind) collected (11550)
Seat 4: JJin91 folded before Flop (didn't bet)
Seat 5: PureWizardry folded before Flop
Seat 6: donkeynutz44 folded before Flop (didn't bet)
Seat 7: JonnyKakes59 folded before Flop (didn't bet)
Seat 8: MyManPotnPan (button) folded before Flop (didn't bet)


*********** # 118 **************
PokerStars Hand #169321215834: Tournament #1597683884, $18.20+$1.80 USD=
 Hold'em No Limit - Level XIX (1000/2000) - 2017/05/02 22:24:35 ET
Table '1597683884 2' 9-max Seat #1 is the button
Seat 1: jrollsup1 (14892 in chips)=20
Seat 2: Article332 (81308 in chips)=20
Seat 4: JJin91 (75118 in chips)=20
Seat 5: PureWizardry (40213 in chips)=20
Seat 6: donkeynutz44 (28160 in chips)=20
Seat 7: JonnyKakes59 (17234 in chips)=20
Seat 8: MyManPotnPan (112399 in chips)=20
jrollsup1: posts the ante 250
Article332: posts the ante 250
JJin91: posts the ante 250
PureWizardry: posts the ante 250
donkeynutz44: posts the ante 250
JonnyKakes59: posts the ante 250
MyManPotnPan: posts the ante 250
Article332: posts small blind 1000
JJin91: posts big blind 2000
*** HOLE CARDS ***
Dealt to JJin91 [Jd Th]
PureWizardry: folds=20
donkeynutz44: folds=20
JonnyKakes59: raises 14984 to 16984 and is all-in
MyManPotnPan: folds=20
jrollsup1: folds=20
Article332: folds=20
JJin91: folds=20
Uncalled bet (14984) returned to JonnyKakes59
JonnyKakes59 collected 6750 from pot
JonnyKakes59: doesn't show hand=20
*** SUMMARY ***
Total pot 6750 | Rake 0=20
Seat 1: jrollsup1 (button) folded before Flop (didn't bet)
Seat 2: Article332 (small blind) folded before Flop
Seat 4: JJin91 (big blind) folded before Flop
Seat 5: PureWizardry folded before Flop (didn't bet)
Seat 6: donkeynutz44 folded before Flop (didn't bet)
Seat 7: JonnyKakes59 collected (6750)
Seat 8: MyManPotnPan folded before Flop (didn't bet)


*********** # 119 **************
PokerStars Hand #169321216024: Tournament #1597683884, $18.20+$1.80 USD=
 Hold'em No Limit - Level XIX (1000/2000) - 2017/05/02 22:25:22 ET
Table '1597683884 2' 9-max Seat #2 is the button
Seat 1: jrollsup1 (14642 in chips)=20
Seat 2: Article332 (80058 in chips)=20
Seat 4: JJin91 (72868 in chips)=20
Seat 5: PureWizardry (39963 in chips)=20
Seat 6: donkeynutz44 (27910 in chips)=20
Seat 7: JonnyKakes59 (21734 in chips)=20
Seat 8: MyManPotnPan (112149 in chips)=20
jrollsup1: posts the ante 250
Article332: posts the ante 250
JJin91: posts the ante 250
PureWizardry: posts the ante 250
donkeynutz44: posts the ante 250
JonnyKakes59: posts the ante 250
MyManPotnPan: posts the ante 250
JJin91: posts small blind 1000
PureWizardry: posts big blind 2000
*** HOLE CARDS ***
Dealt to JJin91 [Ks Jd]
donkeynutz44: folds=20
JonnyKakes59: folds=20
MyManPotnPan: folds=20
jrollsup1: folds=20
Article332: raises 2900 to 4900
JJin91: calls 3900
PureWizardry: calls 2900
*** FLOP *** [Ac Jc 3d]
JJin91: checks=20
PureWizardry: checks=20
Article332: bets 10000
JJin91: calls 10000
PureWizardry: folds=20
*** TURN *** [Ac Jc 3d] [Ah]
JJin91: checks=20
Article332: checks=20
*** RIVER *** [Ac Jc 3d Ah] [9h]
JJin91: checks=20
Article332: checks=20
*** SHOW DOWN ***
JJin91: shows [Ks Jd] (two pair, Aces and Jacks)
Article332: mucks hand=20
JJin91 collected 36450 from pot
*** SUMMARY ***
Total pot 36450 | Rake 0=20
Board [Ac Jc 3d Ah 9h]
Seat 1: jrollsup1 folded before Flop (didn't bet)
Seat 2: Article332 (button) mucked [8c 8d]
Seat 4: JJin91 (small blind) showed [Ks Jd] and won (36450) with two pa=
ir, Aces and Jacks
Seat 5: PureWizardry (big blind) folded on the Flop
Seat 6: donkeynutz44 folded before Flop (didn't bet)
Seat 7: JonnyKakes59 folded before Flop (didn't bet)
Seat 8: MyManPotnPan folded before Flop (didn't bet)


*********** # 120 **************
PokerStars Hand #169321216455: Tournament #1597683884, $18.20+$1.80 USD=
 Hold'em No Limit - Level XIX (1000/2000) - 2017/05/02 22:27:01 ET
Table '1597683884 2' 9-max Seat #4 is the button
Seat 1: jrollsup1 (14392 in chips)=20
Seat 2: Article332 (64908 in chips)=20
Seat 4: JJin91 (94168 in chips)=20
Seat 5: PureWizardry (34813 in chips)=20
Seat 6: donkeynutz44 (27660 in chips)=20
Seat 7: JonnyKakes59 (21484 in chips)=20
Seat 8: MyManPotnPan (111899 in chips)=20
jrollsup1: posts the ante 250
Article332: posts the ante 250
JJin91: posts the ante 250
PureWizardry: posts the ante 250
donkeynutz44: posts the ante 250
JonnyKakes59: posts the ante 250
MyManPotnPan: posts the ante 250
PureWizardry: posts small blind 1000
donkeynutz44: posts big blind 2000
*** HOLE CARDS ***
Dealt to JJin91 [Qh 8d]
JonnyKakes59: folds=20
MyManPotnPan: folds=20
jrollsup1: folds=20
Article332: folds=20
JJin91: raises 2220 to 4220
PureWizardry: raises 30343 to 34563 and is all-in
donkeynutz44: folds=20
JJin91: folds=20
Uncalled bet (30343) returned to PureWizardry
PureWizardry collected 12190 from pot
PureWizardry: doesn't show hand=20
*** SUMMARY ***
Total pot 12190 | Rake 0=20
Seat 1: jrollsup1 folded before Flop (didn't bet)
Seat 2: Article332 folded before Flop (didn't bet)
Seat 4: JJin91 (button) folded before Flop
Seat 5: PureWizardry (small blind) collected (12190)
Seat 6: donkeynutz44 (big blind) folded before Flop
Seat 7: JonnyKakes59 folded before Flop (didn't bet)
Seat 8: MyManPotnPan folded before Flop (didn't bet)


*********** # 121 **************
PokerStars Hand #169321216663: Tournament #1597683884, $18.20+$1.80 USD=
 Hold'em No Limit - Level XIX (1000/2000) - 2017/05/02 22:27:49 ET
Table '1597683884 2' 9-max Seat #5 is the button
Seat 1: jrollsup1 (14142 in chips)=20
Seat 2: Article332 (64658 in chips)=20
Seat 4: JJin91 (89698 in chips)=20
Seat 5: PureWizardry (42533 in chips)=20
Seat 6: donkeynutz44 (25410 in chips)=20
Seat 7: JonnyKakes59 (21234 in chips)=20
Seat 8: MyManPotnPan (111649 in chips)=20
jrollsup1: posts the ante 250
Article332: posts the ante 250
JJin91: posts the ante 250
PureWizardry: posts the ante 250
donkeynutz44: posts the ante 250
JonnyKakes59: posts the ante 250
MyManPotnPan: posts the ante 250
donkeynutz44: posts small blind 1000
JonnyKakes59: posts big blind 2000
*** HOLE CARDS ***
Dealt to JJin91 [3d 4c]
MyManPotnPan: folds=20
jrollsup1: folds=20
Article332: raises 2200 to 4200
JJin91: folds=20
PureWizardry: folds=20
donkeynutz44: folds=20
JonnyKakes59: folds=20
Uncalled bet (2200) returned to Article332
Article332 collected 6750 from pot
Article332: doesn't show hand=20
*** SUMMARY ***
Total pot 6750 | Rake 0=20
Seat 1: jrollsup1 folded before Flop (didn't bet)
Seat 2: Article332 collected (6750)
Seat 4: JJin91 folded before Flop (didn't bet)
Seat 5: PureWizardry (button) folded before Flop (didn't bet)
Seat 6: donkeynutz44 (small blind) folded before Flop
Seat 7: JonnyKakes59 (big blind) folded before Flop
Seat 8: MyManPotnPan folded before Flop (didn't bet)


*********** # 122 **************
PokerStars Hand #169321216794: Tournament #1597683884, $18.20+$1.80 USD=
 Hold'em No Limit - Level XX (1250/2500) - 2017/05/02 22:28:23 ET
Table '1597683884 2' 9-max Seat #6 is the button
Seat 1: jrollsup1 (13892 in chips)=20
Seat 2: Article332 (69158 in chips)=20
Seat 4: JJin91 (89448 in chips)=20
Seat 5: PureWizardry (42283 in chips)=20
Seat 6: donkeynutz44 (24160 in chips)=20
Seat 7: JonnyKakes59 (18984 in chips)=20
Seat 8: MyManPotnPan (111399 in chips)=20
jrollsup1: posts the ante 325
Article332: posts the ante 325
JJin91: posts the ante 325
PureWizardry: posts the ante 325
donkeynutz44: posts the ante 325
JonnyKakes59: posts the ante 325
MyManPotnPan: posts the ante 325
JonnyKakes59: posts small blind 1250
MyManPotnPan: posts big blind 2500
*** HOLE CARDS ***
Dealt to JJin91 [8s Qs]
jrollsup1: raises 11067 to 13567 and is all-in
Article332: folds=20
JJin91: folds=20
PureWizardry: folds=20
donkeynutz44: folds=20
JonnyKakes59: folds=20
MyManPotnPan: folds [5h 7c]
Uncalled bet (11067) returned to jrollsup1
jrollsup1 collected 8525 from pot
*** SUMMARY ***
Total pot 8525 | Rake 0=20
Seat 1: jrollsup1 collected (8525)
Seat 2: Article332 folded before Flop (didn't bet)
Seat 4: JJin91 folded before Flop (didn't bet)
Seat 5: PureWizardry folded before Flop (didn't bet)
Seat 6: donkeynutz44 (button) folded before Flop (didn't bet)
Seat 7: JonnyKakes59 (small blind) folded before Flop
Seat 8: MyManPotnPan (big blind) folded before Flop


*********** # 123 **************
PokerStars Hand #169321216926: Tournament #1597683884, $18.20+$1.80 USD=
 Hold'em No Limit - Level XX (1250/2500) - 2017/05/02 22:28:51 ET
Table '1597683884 2' 9-max Seat #7 is the button
Seat 1: jrollsup1 (19592 in chips)=20
Seat 2: Article332 (68833 in chips)=20
Seat 4: JJin91 (89123 in chips)=20
Seat 5: PureWizardry (41958 in chips)=20
Seat 6: donkeynutz44 (23835 in chips)=20
Seat 7: JonnyKakes59 (17409 in chips)=20
Seat 8: MyManPotnPan (108574 in chips)=20
jrollsup1: posts the ante 325
Article332: posts the ante 325
JJin91: posts the ante 325
PureWizardry: posts the ante 325
donkeynutz44: posts the ante 325
JonnyKakes59: posts the ante 325
MyManPotnPan: posts the ante 325
MyManPotnPan: posts small blind 1250
jrollsup1: posts big blind 2500
*** HOLE CARDS ***
Dealt to JJin91 [Ks 9d]
Article332: folds=20
JJin91: folds=20
PureWizardry: folds=20
donkeynutz44: folds=20
JonnyKakes59: raises 14584 to 17084 and is all-in
MyManPotnPan: folds=20
jrollsup1: folds=20
Uncalled bet (14584) returned to JonnyKakes59
JonnyKakes59 collected 8525 from pot
JonnyKakes59: doesn't show hand=20
*** SUMMARY ***
Total pot 8525 | Rake 0=20
Seat 1: jrollsup1 (big blind) folded before Flop
Seat 2: Article332 folded before Flop (didn't bet)
Seat 4: JJin91 folded before Flop (didn't bet)
Seat 5: PureWizardry folded before Flop (didn't bet)
Seat 6: donkeynutz44 folded before Flop (didn't bet)
Seat 7: JonnyKakes59 (button) collected (8525)
Seat 8: MyManPotnPan (small blind) folded before Flop


*********** # 124 **************
PokerStars Hand #169321217057: Tournament #1597683884, $18.20+$1.80 USD=
 Hold'em No Limit - Level XX (1250/2500) - 2017/05/02 22:29:19 ET
Table '1597683884 2' 9-max Seat #8 is the button
Seat 1: jrollsup1 (16767 in chips)=20
Seat 2: Article332 (68508 in chips)=20
Seat 4: JJin91 (88798 in chips)=20
Seat 5: PureWizardry (41633 in chips)=20
Seat 6: donkeynutz44 (23510 in chips)=20
Seat 7: JonnyKakes59 (23109 in chips)=20
Seat 8: MyManPotnPan (106999 in chips)=20
jrollsup1: posts the ante 325
Article332: posts the ante 325
JJin91: posts the ante 325
PureWizardry: posts the ante 325
donkeynutz44: posts the ante 325
JonnyKakes59: posts the ante 325
MyManPotnPan: posts the ante 325
jrollsup1: posts small blind 1250
Article332: posts big blind 2500
*** HOLE CARDS ***
Dealt to JJin91 [Tc 4c]
JJin91: folds=20
PureWizardry: folds=20
donkeynutz44: folds=20
JonnyKakes59: raises 20284 to 22784 and is all-in
MyManPotnPan: folds=20
jrollsup1: folds=20
Article332: folds=20
Uncalled bet (20284) returned to JonnyKakes59
JonnyKakes59 collected 8525 from pot
JonnyKakes59: doesn't show hand=20
*** SUMMARY ***
Total pot 8525 | Rake 0=20
Seat 1: jrollsup1 (small blind) folded before Flop
Seat 2: Article332 (big blind) folded before Flop
Seat 4: JJin91 folded before Flop (didn't bet)
Seat 5: PureWizardry folded before Flop (didn't bet)
Seat 6: donkeynutz44 folded before Flop (didn't bet)
Seat 7: JonnyKakes59 collected (8525)
Seat 8: MyManPotnPan (button) folded before Flop (didn't bet)


*********** # 125 **************
PokerStars Hand #169321217307: Tournament #1597683884, $18.20+$1.80 USD=
 Hold'em No Limit - Level XX (1250/2500) - 2017/05/02 22:30:13 ET
Table '1597683884 2' 9-max Seat #1 is the button
Seat 1: jrollsup1 (15192 in chips)=20
Seat 2: Article332 (65683 in chips)=20
Seat 4: JJin91 (88473 in chips)=20
Seat 5: PureWizardry (41308 in chips)=20
Seat 6: donkeynutz44 (23185 in chips)=20
Seat 7: JonnyKakes59 (28809 in chips)=20
Seat 8: MyManPotnPan (106674 in chips)=20
jrollsup1: posts the ante 325
Article332: posts the ante 325
JJin91: posts the ante 325
PureWizardry: posts the ante 325
donkeynutz44: posts the ante 325
JonnyKakes59: posts the ante 325
MyManPotnPan: posts the ante 325
Article332: posts small blind 1250
JJin91: posts big blind 2500
*** HOLE CARDS ***
Dealt to JJin91 [Qs 3c]
PureWizardry: folds=20
donkeynutz44: folds=20
JonnyKakes59: folds=20
MyManPotnPan: folds=20
jrollsup1: folds=20
Article332: folds=20
Uncalled bet (1250) returned to JJin91
JJin91 collected 4775 from pot
JJin91: doesn't show hand=20
*** SUMMARY ***
Total pot 4775 | Rake 0=20
Seat 1: jrollsup1 (button) folded before Flop (didn't bet)
Seat 2: Article332 (small blind) folded before Flop
Seat 4: JJin91 (big blind) collected (4775)
Seat 5: PureWizardry folded before Flop (didn't bet)
Seat 6: donkeynutz44 folded before Flop (didn't bet)
Seat 7: JonnyKakes59 folded before Flop (didn't bet)
Seat 8: MyManPotnPan folded before Flop (didn't bet)


*********** # 126 **************
PokerStars Hand #169321217580: Tournament #1597683884, $18.20+$1.80 USD=
 Hold'em No Limit - Level XX (1250/2500) - 2017/05/02 22:31:09 ET
Table '1597683884 2' 9-max Seat #2 is the button
Seat 1: jrollsup1 (14867 in chips)=20
Seat 2: Article332 (64108 in chips)=20
Seat 4: JJin91 (91673 in chips)=20
Seat 5: PureWizardry (40983 in chips)=20
Seat 6: donkeynutz44 (22860 in chips)=20
Seat 7: JonnyKakes59 (28484 in chips)=20
Seat 8: MyManPotnPan (106349 in chips)=20
jrollsup1: posts the ante 325
Article332: posts the ante 325
JJin91: posts the ante 325
PureWizardry: posts the ante 325
donkeynutz44: posts the ante 325
JonnyKakes59: posts the ante 325
MyManPotnPan: posts the ante 325
JJin91: posts small blind 1250
PureWizardry: posts big blind 2500
*** HOLE CARDS ***
Dealt to JJin91 [8c Th]
donkeynutz44: folds=20
JonnyKakes59: folds=20
MyManPotnPan: folds=20
jrollsup1: folds=20
Article332: folds=20
JJin91: calls 1250
PureWizardry: raises 38158 to 40658 and is all-in
JJin91: folds=20
Uncalled bet (38158) returned to PureWizardry
PureWizardry collected 7275 from pot
PureWizardry: doesn't show hand=20
*** SUMMARY ***
Total pot 7275 | Rake 0=20
Seat 1: jrollsup1 folded before Flop (didn't bet)
Seat 2: Article332 (button) folded before Flop (didn't bet)
Seat 4: JJin91 (small blind) folded before Flop
Seat 5: PureWizardry (big blind) collected (7275)
Seat 6: donkeynutz44 folded before Flop (didn't bet)
Seat 7: JonnyKakes59 folded before Flop (didn't bet)
Seat 8: MyManPotnPan folded before Flop (didn't bet)


*********** # 127 **************
PokerStars Hand #169321217743: Tournament #1597683884, $18.20+$1.80 USD=
 Hold'em No Limit - Level XX (1250/2500) - 2017/05/02 22:31:43 ET
Table '1597683884 2' 9-max Seat #4 is the button
Seat 1: jrollsup1 (14542 in chips)=20
Seat 2: Article332 (63783 in chips)=20
Seat 4: JJin91 (88848 in chips)=20
Seat 5: PureWizardry (45433 in chips)=20
Seat 6: donkeynutz44 (22535 in chips)=20
Seat 7: JonnyKakes59 (28159 in chips)=20
Seat 8: MyManPotnPan (106024 in chips)=20
jrollsup1: posts the ante 325
Article332: posts the ante 325
JJin91: posts the ante 325
PureWizardry: posts the ante 325
donkeynutz44: posts the ante 325
JonnyKakes59: posts the ante 325
MyManPotnPan: posts the ante 325
PureWizardry: posts small blind 1250
donkeynutz44: posts big blind 2500
*** HOLE CARDS ***
Dealt to JJin91 [Th 8d]
JonnyKakes59: raises 25334 to 27834 and is all-in
MyManPotnPan: folds=20
jrollsup1: folds=20
Article332: folds=20
JJin91: folds=20
PureWizardry: raises 17274 to 45108 and is all-in
donkeynutz44: folds=20
Uncalled bet (17274) returned to PureWizardry
*** FLOP *** [4d 4c 7h]
*** TURN *** [4d 4c 7h] [2c]
*** RIVER *** [4d 4c 7h 2c] [Qd]
*** SHOW DOWN ***
PureWizardry: shows [Ks As] (a pair of Fours)
JonnyKakes59: shows [Ah Kh] (a pair of Fours)
PureWizardry collected 30222 from pot
JonnyKakes59 collected 30221 from pot
*** SUMMARY ***
Total pot 60443 | Rake 0=20
Board [4d 4c 7h 2c Qd]
Seat 1: jrollsup1 folded before Flop (didn't bet)
Seat 2: Article332 folded before Flop (didn't bet)
Seat 4: JJin91 (button) folded before Flop (didn't bet)
Seat 5: PureWizardry (small blind) showed [Ks As] and won (30222) with =
a pair of Fours
Seat 6: donkeynutz44 (big blind) folded before Flop
Seat 7: JonnyKakes59 showed [Ah Kh] and won (30221) with a pair of Fours
Seat 8: MyManPotnPan folded before Flop (didn't bet)


*********** # 128 **************
PokerStars Hand #169321218008: Tournament #1597683884, $18.20+$1.80 USD=
 Hold'em No Limit - Level XX (1250/2500) - 2017/05/02 22:32:35 ET
Table '1597683884 2' 9-max Seat #5 is the button
Seat 1: jrollsup1 (14217 in chips)=20
Seat 2: Article332 (63458 in chips)=20
Seat 4: JJin91 (88523 in chips)=20
Seat 5: PureWizardry (47496 in chips)=20
Seat 6: donkeynutz44 (19710 in chips)=20
Seat 7: JonnyKakes59 (30221 in chips)=20
Seat 8: MyManPotnPan (105699 in chips)=20
jrollsup1: posts the ante 325
Article332: posts the ante 325
JJin91: posts the ante 325
PureWizardry: posts the ante 325
donkeynutz44: posts the ante 325
JonnyKakes59: posts the ante 325
MyManPotnPan: posts the ante 325
donkeynutz44: posts small blind 1250
JonnyKakes59: posts big blind 2500
*** HOLE CARDS ***
Dealt to JJin91 [8c Kd]
MyManPotnPan: folds=20
jrollsup1: folds=20
Article332: folds=20
JJin91: folds=20
PureWizardry: folds=20
donkeynutz44: folds=20
Uncalled bet (1250) returned to JonnyKakes59
JonnyKakes59 collected 4775 from pot
JonnyKakes59: doesn't show hand=20
*** SUMMARY ***
Total pot 4775 | Rake 0=20
Seat 1: jrollsup1 folded before Flop (didn't bet)
Seat 2: Article332 folded before Flop (didn't bet)
Seat 4: JJin91 folded before Flop (didn't bet)
Seat 5: PureWizardry (button) folded before Flop (didn't bet)
Seat 6: donkeynutz44 (small blind) folded before Flop
Seat 7: JonnyKakes59 (big blind) collected (4775)
Seat 8: MyManPotnPan folded before Flop (didn't bet)


*********** # 129 **************
PokerStars Hand #169321218151: Tournament #1597683884, $18.20+$1.80 USD=
 Hold'em No Limit - Level XX (1250/2500) - 2017/05/02 22:33:04 ET
Table '1597683884 2' 9-max Seat #6 is the button
Seat 1: jrollsup1 (13892 in chips)=20
Seat 2: Article332 (63133 in chips)=20
Seat 4: JJin91 (88198 in chips)=20
Seat 5: PureWizardry (47171 in chips)=20
Seat 6: donkeynutz44 (18135 in chips)=20
Seat 7: JonnyKakes59 (33421 in chips)=20
Seat 8: MyManPotnPan (105374 in chips)=20
jrollsup1: posts the ante 325
Article332: posts the ante 325
JJin91: posts the ante 325
PureWizardry: posts the ante 325
donkeynutz44: posts the ante 325
JonnyKakes59: posts the ante 325
MyManPotnPan: posts the ante 325
JonnyKakes59: posts small blind 1250
MyManPotnPan: posts big blind 2500
*** HOLE CARDS ***
Dealt to JJin91 [Td 3c]
jrollsup1: folds=20
Article332: folds=20
JJin91: folds=20
PureWizardry: folds=20
donkeynutz44: folds=20
JonnyKakes59: folds=20
Uncalled bet (1250) returned to MyManPotnPan
MyManPotnPan collected 4775 from pot
MyManPotnPan: doesn't show hand=20
*** SUMMARY ***
Total pot 4775 | Rake 0=20
Seat 1: jrollsup1 folded before Flop (didn't bet)
Seat 2: Article332 folded before Flop (didn't bet)
Seat 4: JJin91 folded before Flop (didn't bet)
Seat 5: PureWizardry folded before Flop (didn't bet)
Seat 6: donkeynutz44 (button) folded before Flop (didn't bet)
Seat 7: JonnyKakes59 (small blind) folded before Flop
Seat 8: MyManPotnPan (big blind) collected (4775)


*********** # 130 **************
PokerStars Hand #169321218271: Tournament #1597683884, $18.20+$1.80 USD=
 Hold'em No Limit - Level XX (1250/2500) - 2017/05/02 22:33:31 ET
Table '1597683884 2' 9-max Seat #7 is the button
Seat 1: jrollsup1 (13567 in chips)=20
Seat 2: Article332 (62808 in chips)=20
Seat 4: JJin91 (87873 in chips)=20
Seat 5: PureWizardry (46846 in chips)=20
Seat 6: donkeynutz44 (17810 in chips)=20
Seat 7: JonnyKakes59 (31846 in chips)=20
Seat 8: MyManPotnPan (108574 in chips)=20
jrollsup1: posts the ante 325
Article332: posts the ante 325
JJin91: posts the ante 325
PureWizardry: posts the ante 325
donkeynutz44: posts the ante 325
JonnyKakes59: posts the ante 325
MyManPotnPan: posts the ante 325
MyManPotnPan: posts small blind 1250
jrollsup1: posts big blind 2500
*** HOLE CARDS ***
Dealt to JJin91 [8s Qc]
Article332: raises 2500 to 5000
JJin91: folds=20
PureWizardry: folds=20
donkeynutz44: folds=20
JonnyKakes59: folds=20
MyManPotnPan: folds=20
jrollsup1: folds=20
Uncalled bet (2500) returned to Article332
Article332 collected 8525 from pot
Article332: doesn't show hand=20
*** SUMMARY ***
Total pot 8525 | Rake 0=20
Seat 1: jrollsup1 (big blind) folded before Flop
Seat 2: Article332 collected (8525)
Seat 4: JJin91 folded before Flop (didn't bet)
Seat 5: PureWizardry folded before Flop (didn't bet)
Seat 6: donkeynutz44 folded before Flop (didn't bet)
Seat 7: JonnyKakes59 (button) folded before Flop (didn't bet)
Seat 8: MyManPotnPan (small blind) folded before Flop


*********** # 131 **************
PokerStars Hand #169321218570: Tournament #1597683884, $18.20+$1.80 USD=
 Hold'em No Limit - Level XX (1250/2500) - 2017/05/02 22:34:43 ET
Table '1597683884 2' 9-max Seat #8 is the button
Seat 1: jrollsup1 (10742 in chips)=20
Seat 2: Article332 (68508 in chips)=20
Seat 4: JJin91 (87548 in chips)=20
Seat 5: PureWizardry (46521 in chips)=20
Seat 6: donkeynutz44 (17485 in chips)=20
Seat 7: JonnyKakes59 (31521 in chips)=20
Seat 8: MyManPotnPan (106999 in chips)=20
jrollsup1: posts the ante 325
Article332: posts the ante 325
JJin91: posts the ante 325
PureWizardry: posts the ante 325
donkeynutz44: posts the ante 325
JonnyKakes59: posts the ante 325
MyManPotnPan: posts the ante 325
jrollsup1: posts small blind 1250
Article332: posts big blind 2500
*** HOLE CARDS ***
Dealt to JJin91 [Js 8d]
JJin91: folds=20
PureWizardry: raises 43696 to 46196 and is all-in
donkeynutz44: folds=20
JonnyKakes59: folds=20
MyManPotnPan: raises 60478 to 106674 and is all-in
jrollsup1: folds=20
Article332: folds=20
Uncalled bet (60478) returned to MyManPotnPan
*** FLOP *** [Kh 8s Td]
*** TURN *** [Kh 8s Td] [Ks]
*** RIVER *** [Kh 8s Td Ks] [6d]
*** SHOW DOWN ***
PureWizardry: shows [Jc Jd] (two pair, Kings and Jacks)
MyManPotnPan: shows [Kd As] (three of a kind, Kings)
MyManPotnPan collected 98417 from pot
PureWizardry finished the tournament in 19th place
*** SUMMARY ***
Total pot 98417 | Rake 0=20
Board [Kh 8s Td Ks 6d]
Seat 1: jrollsup1 (small blind) folded before Flop
Seat 2: Article332 (big blind) folded before Flop
Seat 4: JJin91 folded before Flop (didn't bet)
Seat 5: PureWizardry showed [Jc Jd] and lost with two pair, Kings and J=
acks
Seat 6: donkeynutz44 folded before Flop (didn't bet)
Seat 7: JonnyKakes59 folded before Flop (didn't bet)
Seat 8: MyManPotnPan (button) showed [Kd As] and won (98417) with three=
 of a kind, Kings


*********** # 132 **************
PokerStars Hand #169321218784: Tournament #1597683884, $18.20+$1.80 USD=
 Hold'em No Limit - Level XX (1250/2500) - 2017/05/02 22:35:28 ET
Table '1597683884 6' 9-max Seat #5 is the button
Seat 1: jmaltabes (93866 in chips)=20
Seat 2: pepstargar (11775 in chips)=20
Seat 3: nigock (41741 in chips)=20
Seat 4: Article332 (65683 in chips)=20
Seat 5: Labba609 (79623 in chips)=20
Seat 6: SAMCRO_1120 (69612 in chips)=20
Seat 7: JJin91 (87223 in chips)=20
Seat 8: DaBirds23 (60079 in chips)=20
Seat 9: donkeynutz44 (17160 in chips)=20
jmaltabes: posts the ante 325
pepstargar: posts the ante 325
nigock: posts the ante 325
Article332: posts the ante 325
Labba609: posts the ante 325
SAMCRO_1120: posts the ante 325
JJin91: posts the ante 325
DaBirds23: posts the ante 325
donkeynutz44: posts the ante 325
SAMCRO_1120: posts small blind 1250
JJin91: posts big blind 2500
*** HOLE CARDS ***
Dealt to JJin91 [5s Jh]
SAMCRO_1120 said, "hope so"
DaBirds23: folds=20
donkeynutz44: folds=20
jmaltabes: folds=20
pepstargar: folds=20
nigock: folds=20
SAMCRO_1120 said, "there it is"
pepstargar said, "lol"
pepstargar said, "yep"
Article332: folds=20
Labba609: folds=20
SAMCRO_1120 said, "congrats"
SAMCRO_1120 said, "shove time"
SAMCRO_1120 said, "lol"
SAMCRO_1120: folds=20
Uncalled bet (1250) returned to JJin91
JJin91 collected 5425 from pot
JJin91: doesn't show hand=20
*** SUMMARY ***
Total pot 5425 | Rake 0=20
Seat 1: jmaltabes folded before Flop (didn't bet)
Seat 2: pepstargar folded before Flop (didn't bet)
Seat 3: nigock folded before Flop (didn't bet)
Seat 4: Article332 folded before Flop (didn't bet)
Seat 5: Labba609 (button) folded before Flop (didn't bet)
Seat 6: SAMCRO_1120 (small blind) folded before Flop
Seat 7: JJin91 (big blind) collected (5425)
Seat 8: DaBirds23 folded before Flop (didn't bet)
Seat 9: donkeynutz44 folded before Flop (didn't bet)


*********** # 133 **************
PokerStars Hand #169321218944: Tournament #1597683884, $18.20+$1.80 USD=
 Hold'em No Limit - Level XX (1250/2500) - 2017/05/02 22:36:00 ET
Table '1597683884 6' 9-max Seat #6 is the button
Seat 1: jmaltabes (93541 in chips)=20
Seat 2: pepstargar (11450 in chips)=20
Seat 3: nigock (41416 in chips)=20
Seat 4: Article332 (65358 in chips)=20
Seat 5: Labba609 (79298 in chips)=20
Seat 6: SAMCRO_1120 (68037 in chips)=20
Seat 7: JJin91 (91073 in chips)=20
Seat 8: DaBirds23 (59754 in chips)=20
Seat 9: donkeynutz44 (16835 in chips)=20
jmaltabes: posts the ante 325
pepstargar: posts the ante 325
nigock: posts the ante 325
Article332: posts the ante 325
Labba609: posts the ante 325
SAMCRO_1120: posts the ante 325
JJin91: posts the ante 325
DaBirds23: posts the ante 325
donkeynutz44: posts the ante 325
JJin91: posts small blind 1250
DaBirds23: posts big blind 2500
*** HOLE CARDS ***
Dealt to JJin91 [Th 7d]
donkeynutz44: folds=20
jmaltabes: folds=20
pepstargar: folds=20
nigock: folds=20
Article332: folds=20
Labba609: folds=20
SAMCRO_1120: folds=20
JJin91: folds=20
Uncalled bet (1250) returned to DaBirds23
DaBirds23 collected 5425 from pot
DaBirds23: doesn't show hand=20
*** SUMMARY ***
Total pot 5425 | Rake 0=20
Seat 1: jmaltabes folded before Flop (didn't bet)
Seat 2: pepstargar folded before Flop (didn't bet)
Seat 3: nigock folded before Flop (didn't bet)
Seat 4: Article332 folded before Flop (didn't bet)
Seat 5: Labba609 folded before Flop (didn't bet)
Seat 6: SAMCRO_1120 (button) folded before Flop (didn't bet)
Seat 7: JJin91 (small blind) folded before Flop
Seat 8: DaBirds23 (big blind) collected (5425)
Seat 9: donkeynutz44 folded before Flop (didn't bet)


*********** # 134 **************
PokerStars Hand #169321219066: Tournament #1597683884, $18.20+$1.80 USD=
 Hold'em No Limit - Level XX (1250/2500) - 2017/05/02 22:36:31 ET
Table '1597683884 6' 9-max Seat #7 is the button
Seat 1: jmaltabes (93216 in chips)=20
Seat 2: pepstargar (11125 in chips)=20
Seat 3: nigock (41091 in chips)=20
Seat 4: Article332 (65033 in chips)=20
Seat 5: Labba609 (78973 in chips)=20
Seat 6: SAMCRO_1120 (67712 in chips)=20
Seat 7: JJin91 (89498 in chips)=20
Seat 8: DaBirds23 (63604 in chips)=20
Seat 9: donkeynutz44 (16510 in chips)=20
jmaltabes: posts the ante 325
pepstargar: posts the ante 325
nigock: posts the ante 325
Article332: posts the ante 325
Labba609: posts the ante 325
SAMCRO_1120: posts the ante 325
JJin91: posts the ante 325
DaBirds23: posts the ante 325
donkeynutz44: posts the ante 325
DaBirds23: posts small blind 1250
donkeynutz44: posts big blind 2500
*** HOLE CARDS ***
Dealt to JJin91 [Ac Ah]
jmaltabes: folds=20
pepstargar: folds=20
nigock: folds=20
Article332: folds=20
Labba609: folds=20
SAMCRO_1120: folds=20
JJin91: raises 3525 to 6025
DaBirds23: folds=20
donkeynutz44: raises 10160 to 16185 and is all-in
JJin91: calls 10160
*** FLOP *** [2d 8h 9d]
*** TURN *** [2d 8h 9d] [2s]
SAMCRO_1120 said, "lol"
*** RIVER *** [2d 8h 9d 2s] [Ts]
*** SHOW DOWN ***
donkeynutz44: shows [9h 9s] (a full house, Nines full of Deuces)
JJin91: shows [Ac Ah] (two pair, Aces and Deuces)
donkeynutz44 collected 36545 from pot
*** SUMMARY ***
Total pot 36545 | Rake 0=20
Board [2d 8h 9d 2s Ts]
Seat 1: jmaltabes folded before Flop (didn't bet)
Seat 2: pepstargar folded before Flop (didn't bet)
Seat 3: nigock folded before Flop (didn't bet)
Seat 4: Article332 folded before Flop (didn't bet)
Seat 5: Labba609 folded before Flop (didn't bet)
Seat 6: SAMCRO_1120 folded before Flop (didn't bet)
Seat 7: JJin91 (button) showed [Ac Ah] and lost with two pair, Aces and=
 Deuces
Seat 8: DaBirds23 (small blind) folded before Flop
Seat 9: donkeynutz44 (big blind) showed [9h 9s] and won (36545) with a =
full house, Nines full of Deuces


*********** # 135 **************
PokerStars Hand #169321219309: Tournament #1597683884, $18.20+$1.80 USD=
 Hold'em No Limit - Level XX (1250/2500) - 2017/05/02 22:37:27 ET
Table '1597683884 6' 9-max Seat #8 is the button
Seat 1: jmaltabes (92891 in chips)=20
Seat 2: pepstargar (10800 in chips)=20
Seat 3: nigock (40766 in chips)=20
Seat 4: Article332 (64708 in chips)=20
Seat 5: Labba609 (78648 in chips)=20
Seat 6: SAMCRO_1120 (67387 in chips)=20
Seat 7: JJin91 (72988 in chips)=20
Seat 8: DaBirds23 (62029 in chips)=20
Seat 9: donkeynutz44 (36545 in chips)=20
jmaltabes: posts the ante 325
pepstargar: posts the ante 325
nigock: posts the ante 325
Article332: posts the ante 325
Labba609: posts the ante 325
SAMCRO_1120: posts the ante 325
JJin91: posts the ante 325
DaBirds23: posts the ante 325
donkeynutz44: posts the ante 325
donkeynutz44: posts small blind 1250
jmaltabes: posts big blind 2500
*** HOLE CARDS ***
Dealt to JJin91 [Th 3d]
pepstargar: folds=20
nigock: folds=20
Article332: folds=20
SAMCRO_1120 said, "AA is the worst"
Labba609: folds=20
SAMCRO_1120: folds=20
JJin91: folds=20
DaBirds23: raises 3350 to 5850
pepstargar said, "for real"
JJin91 said, "i agree fam"
JJin91 said, "always fold pre"
donkeynutz44: folds=20
jmaltabes: calls 3350
*** FLOP *** [9s As 3h]
jmaltabes: checks=20
SAMCRO_1120 said, "i get two outed at least 4 times a day no bs"
DaBirds23: bets 7779
pepstargar said, "lemme get a walk next hand"
jmaltabes: folds=20
Uncalled bet (7779) returned to DaBirds23
DaBirds23 collected 15875 from pot
DaBirds23: doesn't show hand=20
*** SUMMARY ***
Total pot 15875 | Rake 0=20
Board [9s As 3h]
Seat 1: jmaltabes (big blind) folded on the Flop
Seat 2: pepstargar folded before Flop (didn't bet)
Seat 3: nigock folded before Flop (didn't bet)
Seat 4: Article332 folded before Flop (didn't bet)
Seat 5: Labba609 folded before Flop (didn't bet)
Seat 6: SAMCRO_1120 folded before Flop (didn't bet)
Seat 7: JJin91 folded before Flop (didn't bet)
Seat 8: DaBirds23 (button) collected (15875)
Seat 9: donkeynutz44 (small blind) folded before Flop


*********** # 136 **************
PokerStars Hand #169321219467: Tournament #1597683884, $18.20+$1.80 USD=
 Hold'em No Limit - Level XX (1250/2500) - 2017/05/02 22:38:05 ET
Table '1597683884 6' 9-max Seat #9 is the button
Seat 1: jmaltabes (86716 in chips)=20
Seat 2: pepstargar (10475 in chips)=20
Seat 3: nigock (40441 in chips)=20
Seat 4: Article332 (64383 in chips)=20
Seat 5: Labba609 (78323 in chips)=20
Seat 6: SAMCRO_1120 (67062 in chips)=20
Seat 7: JJin91 (72663 in chips)=20
Seat 8: DaBirds23 (71729 in chips)=20
Seat 9: donkeynutz44 (34970 in chips)=20
jmaltabes: posts the ante 325
pepstargar: posts the ante 325
nigock: posts the ante 325
Article332: posts the ante 325
Labba609: posts the ante 325
SAMCRO_1120: posts the ante 325
JJin91: posts the ante 325
DaBirds23: posts the ante 325
donkeynutz44: posts the ante 325
jmaltabes: posts small blind 1250
pepstargar: posts big blind 2500
*** HOLE CARDS ***
Dealt to JJin91 [6c Ts]
SAMCRO_1120 said, "lol"
nigock: folds=20
donkeynutz44 is disconnected=20
Article332: folds=20
Labba609: folds=20
SAMCRO_1120: folds=20
JJin91: folds=20
DaBirds23: folds=20
donkeynutz44: folds=20
jmaltabes: folds=20
Uncalled bet (1250) returned to pepstargar
pepstargar collected 5425 from pot
pepstargar: doesn't show hand=20
*** SUMMARY ***
Total pot 5425 | Rake 0=20
Seat 1: jmaltabes (small blind) folded before Flop
Seat 2: pepstargar (big blind) collected (5425)
Seat 3: nigock folded before Flop (didn't bet)
Seat 4: Article332 folded before Flop (didn't bet)
Seat 5: Labba609 folded before Flop (didn't bet)
Seat 6: SAMCRO_1120 folded before Flop (didn't bet)
Seat 7: JJin91 folded before Flop (didn't bet)
Seat 8: DaBirds23 folded before Flop (didn't bet)
Seat 9: donkeynutz44 (button) folded before Flop (didn't bet)


*********** # 137 **************
PokerStars Hand #169321219627: Tournament #1597683884, $18.20+$1.80 USD=
 Hold'em No Limit - Level XXI (1500/3000) - 2017/05/02 22:38:42 ET
Table '1597683884 6' 9-max Seat #1 is the button
Seat 1: jmaltabes (85141 in chips)=20
Seat 2: pepstargar (14325 in chips)=20
Seat 3: nigock (40116 in chips)=20
Seat 4: Article332 (64058 in chips)=20
Seat 5: Labba609 (77998 in chips)=20
Seat 6: SAMCRO_1120 (66737 in chips)=20
Seat 7: JJin91 (72338 in chips)=20
Seat 8: DaBirds23 (71404 in chips)=20
Seat 9: donkeynutz44 (34645 in chips)=20
jmaltabes: posts the ante 375
pepstargar: posts the ante 375
nigock: posts the ante 375
Article332: posts the ante 375
Labba609: posts the ante 375
SAMCRO_1120: posts the ante 375
JJin91: posts the ante 375
DaBirds23: posts the ante 375
donkeynutz44: posts the ante 375
pepstargar: posts small blind 1500
nigock: posts big blind 3000
*** HOLE CARDS ***
Dealt to JJin91 [Qd Td]
pepstargar said, "nice"
jmaltabes said, "welxome"
pepstargar said, "ty"
Article332: folds=20
Labba609: raises 4500 to 7500
pepstargar said, "QTo had put it in"
SAMCRO_1120: folds=20
JJin91: folds=20
DaBirds23: folds=20
donkeynutz44: folds=20
jmaltabes: folds=20
pepstargar: folds=20
nigock: folds=20
Uncalled bet (4500) returned to Labba609
jmaltabes said, ")"
Labba609 collected 10875 from pot
Labba609: doesn't show hand=20
*** SUMMARY ***
Total pot 10875 | Rake 0=20
Seat 1: jmaltabes (button) folded before Flop (didn't bet)
Seat 2: pepstargar (small blind) folded before Flop
Seat 3: nigock (big blind) folded before Flop
Seat 4: Article332 folded before Flop (didn't bet)
Seat 5: Labba609 collected (10875)
Seat 6: SAMCRO_1120 folded before Flop (didn't bet)
Seat 7: JJin91 folded before Flop (didn't bet)
Seat 8: DaBirds23 folded before Flop (didn't bet)
Seat 9: donkeynutz44 folded before Flop (didn't bet)


*********** # 138 **************
PokerStars Hand #169321219748: Tournament #1597683884, $18.20+$1.80 USD=
 Hold'em No Limit - Level XXI (1500/3000) - 2017/05/02 22:39:14 ET
Table '1597683884 6' 9-max Seat #2 is the button
Seat 1: jmaltabes (84766 in chips)=20
Seat 2: pepstargar (12450 in chips)=20
Seat 3: nigock (36741 in chips)=20
Seat 4: Article332 (63683 in chips)=20
Seat 5: Labba609 (85498 in chips)=20
Seat 6: SAMCRO_1120 (66362 in chips)=20
Seat 7: JJin91 (71963 in chips)=20
Seat 8: DaBirds23 (71029 in chips)=20
Seat 9: donkeynutz44 (34270 in chips)=20
jmaltabes: posts the ante 375
pepstargar: posts the ante 375
nigock: posts the ante 375
Article332: posts the ante 375
Labba609: posts the ante 375
SAMCRO_1120: posts the ante 375
JJin91: posts the ante 375
DaBirds23: posts the ante 375
donkeynutz44: posts the ante 375
nigock: posts small blind 1500
Article332: posts big blind 3000
*** HOLE CARDS ***
Dealt to JJin91 [Ks Ac]
jmaltabes said, ";)"
Labba609: folds=20
SAMCRO_1120: raises 5999 to 8999
JJin91: raises 5999 to 14998
DaBirds23: folds=20
donkeynutz44: folds=20
jmaltabes: folds=20
pepstargar: folds=20
nigock: folds=20
Article332: folds=20
SAMCRO_1120: calls 5999
*** FLOP *** [6c 4h 6d]
SAMCRO_1120: bets 50989 and is all-in
JJin91: folds=20
Uncalled bet (50989) returned to SAMCRO_1120
SAMCRO_1120 collected 37871 from pot
*** SUMMARY ***
Total pot 37871 | Rake 0=20
Board [6c 4h 6d]
Seat 1: jmaltabes folded before Flop (didn't bet)
Seat 2: pepstargar (button) folded before Flop (didn't bet)
Seat 3: nigock (small blind) folded before Flop
Seat 4: Article332 (big blind) folded before Flop
Seat 5: Labba609 folded before Flop (didn't bet)
Seat 6: SAMCRO_1120 collected (37871)
Seat 7: JJin91 folded on the Flop
Seat 8: DaBirds23 folded before Flop (didn't bet)
Seat 9: donkeynutz44 folded before Flop (didn't bet)


*********** # 139 **************
PokerStars Hand #169323121934: Tournament #1597683884, $18.20+$1.80 USD=
 Hold'em No Limit - Level XXI (1500/3000) - 2017/05/02 22:40:19 ET
Table '1597683884 6' 9-max Seat #3 is the button
Seat 1: jmaltabes (84391 in chips)=20
Seat 2: pepstargar (12075 in chips)=20
Seat 3: nigock (34866 in chips)=20
Seat 4: Article332 (60308 in chips)=20
Seat 5: Labba609 (85123 in chips)=20
Seat 6: SAMCRO_1120 (88860 in chips)=20
Seat 7: JJin91 (56590 in chips)=20
Seat 8: DaBirds23 (70654 in chips)=20
Seat 9: donkeynutz44 (33895 in chips)=20
jmaltabes: posts the ante 375
pepstargar: posts the ante 375
nigock: posts the ante 375
Article332: posts the ante 375
Labba609: posts the ante 375
SAMCRO_1120: posts the ante 375
JJin91: posts the ante 375
DaBirds23: posts the ante 375
donkeynutz44: posts the ante 375
Article332: posts small blind 1500
Labba609: posts big blind 3000
*** HOLE CARDS ***
Dealt to JJin91 [5d 7c]
SAMCRO_1120: folds=20
JJin91: folds=20
DaBirds23: folds=20
donkeynutz44: folds=20
jmaltabes: folds=20
pepstargar: folds=20
nigock: folds=20
Article332: calls 1500
Labba609: raises 81748 to 84748 and is all-in
Article332: folds=20
Uncalled bet (81748) returned to Labba609
Labba609 collected 9375 from pot
Labba609: doesn't show hand=20
*** SUMMARY ***
Total pot 9375 | Rake 0=20
Seat 1: jmaltabes folded before Flop (didn't bet)
Seat 2: pepstargar folded before Flop (didn't bet)
Seat 3: nigock (button) folded before Flop (didn't bet)
Seat 4: Article332 (small blind) folded before Flop
Seat 5: Labba609 (big blind) collected (9375)
Seat 6: SAMCRO_1120 folded before Flop (didn't bet)
Seat 7: JJin91 folded before Flop (didn't bet)
Seat 8: DaBirds23 folded before Flop (didn't bet)
Seat 9: donkeynutz44 folded before Flop (didn't bet)


*********** # 140 **************
PokerStars Hand #169323122152: Tournament #1597683884, $18.20+$1.80 USD=
 Hold'em No Limit - Level XXI (1500/3000) - 2017/05/02 22:41:13 ET
Table '1597683884 6' 9-max Seat #4 is the button
Seat 1: jmaltabes (84016 in chips)=20
Seat 2: pepstargar (11700 in chips)=20
Seat 3: nigock (34491 in chips)=20
Seat 4: Article332 (56933 in chips)=20
Seat 5: Labba609 (91123 in chips)=20
Seat 6: SAMCRO_1120 (88485 in chips)=20
Seat 7: JJin91 (56215 in chips)=20
Seat 8: DaBirds23 (70279 in chips)=20
Seat 9: donkeynutz44 (33520 in chips)=20
jmaltabes: posts the ante 375
pepstargar: posts the ante 375
nigock: posts the ante 375
Article332: posts the ante 375
Labba609: posts the ante 375
SAMCRO_1120: posts the ante 375
JJin91: posts the ante 375
DaBirds23: posts the ante 375
donkeynutz44: posts the ante 375
Labba609: posts small blind 1500
SAMCRO_1120: posts big blind 3000
*** HOLE CARDS ***
Dealt to JJin91 [Jd 5s]
JJin91: folds=20
DaBirds23: folds=20
donkeynutz44: folds=20
jmaltabes: folds=20
pepstargar: folds=20
nigock: raises 31116 to 34116 and is all-in
Article332: folds=20
Labba609: folds=20
SAMCRO_1120: folds=20
Uncalled bet (31116) returned to nigock
nigock collected 10875 from pot
nigock: doesn't show hand=20
*** SUMMARY ***
Total pot 10875 | Rake 0=20
Seat 1: jmaltabes folded before Flop (didn't bet)
Seat 2: pepstargar folded before Flop (didn't bet)
Seat 3: nigock collected (10875)
Seat 4: Article332 (button) folded before Flop (didn't bet)
Seat 5: Labba609 (small blind) folded before Flop
Seat 6: SAMCRO_1120 (big blind) folded before Flop
Seat 7: JJin91 folded before Flop (didn't bet)
Seat 8: DaBirds23 folded before Flop (didn't bet)
Seat 9: donkeynutz44 folded before Flop (didn't bet)


*********** # 141 **************
PokerStars Hand #169323122296: Tournament #1597683884, $18.20+$1.80 USD=
 Hold'em No Limit - Level XXI (1500/3000) - 2017/05/02 22:41:51 ET
Table '1597683884 6' 9-max Seat #5 is the button
Seat 1: jmaltabes (83641 in chips)=20
Seat 2: pepstargar (11325 in chips)=20
Seat 3: nigock (41991 in chips)=20
Seat 4: Article332 (56558 in chips)=20
Seat 5: Labba609 (89248 in chips)=20
Seat 6: SAMCRO_1120 (85110 in chips)=20
Seat 7: JJin91 (55840 in chips)=20
Seat 8: DaBirds23 (69904 in chips)=20
Seat 9: donkeynutz44 (33145 in chips)=20
jmaltabes: posts the ante 375
pepstargar: posts the ante 375
nigock: posts the ante 375
Article332: posts the ante 375
Labba609: posts the ante 375
SAMCRO_1120: posts the ante 375
JJin91: posts the ante 375
DaBirds23: posts the ante 375
donkeynutz44: posts the ante 375
SAMCRO_1120: posts small blind 1500
JJin91: posts big blind 3000
*** HOLE CARDS ***
Dealt to JJin91 [Ac 4h]
DaBirds23: folds=20
donkeynutz44: folds=20
jmaltabes: folds=20
pepstargar: raises 7950 to 10950 and is all-in
nigock: folds=20
Article332: folds=20
Labba609: folds=20
SAMCRO_1120: folds=20
JJin91: calls 7950
*** FLOP *** [5d 9s 3c]
*** TURN *** [5d 9s 3c] [8s]
*** RIVER *** [5d 9s 3c 8s] [7h]
*** SHOW DOWN ***
JJin91: shows [Ac 4h] (high card Ace)
pepstargar: shows [Ah Kd] (high card Ace - King kicker)
pepstargar collected 26775 from pot
*** SUMMARY ***
Total pot 26775 | Rake 0=20
Board [5d 9s 3c 8s 7h]
Seat 1: jmaltabes folded before Flop (didn't bet)
Seat 2: pepstargar showed [Ah Kd] and won (26775) with high card Ace
Seat 3: nigock folded before Flop (didn't bet)
Seat 4: Article332 folded before Flop (didn't bet)
Seat 5: Labba609 (button) folded before Flop (didn't bet)
Seat 6: SAMCRO_1120 (small blind) folded before Flop
Seat 7: JJin91 (big blind) showed [Ac 4h] and lost with high card Ace
Seat 8: DaBirds23 folded before Flop (didn't bet)
Seat 9: donkeynutz44 folded before Flop (didn't bet)


*********** # 142 **************
PokerStars Hand #169323122475: Tournament #1597683884, $18.20+$1.80 USD=
 Hold'em No Limit - Level XXI (1500/3000) - 2017/05/02 22:42:35 ET
Table '1597683884 6' 9-max Seat #6 is the button
Seat 1: jmaltabes (83266 in chips)=20
Seat 2: pepstargar (26775 in chips)=20
Seat 3: nigock (41616 in chips)=20
Seat 4: Article332 (56183 in chips)=20
Seat 5: Labba609 (88873 in chips)=20
Seat 6: SAMCRO_1120 (83235 in chips)=20
Seat 7: JJin91 (44515 in chips)=20
Seat 8: DaBirds23 (69529 in chips)=20
Seat 9: donkeynutz44 (32770 in chips)=20
jmaltabes: posts the ante 375
pepstargar: posts the ante 375
nigock: posts the ante 375
Article332: posts the ante 375
Labba609: posts the ante 375
SAMCRO_1120: posts the ante 375
JJin91: posts the ante 375
DaBirds23: posts the ante 375
donkeynutz44: posts the ante 375
JJin91: posts small blind 1500
DaBirds23: posts big blind 3000
*** HOLE CARDS ***
Dealt to JJin91 [7h Jh]
donkeynutz44: raises 6000 to 9000
jmaltabes: folds=20
pepstargar: raises 17400 to 26400 and is all-in
nigock: folds=20
Article332: folds=20
Labba609: folds=20
SAMCRO_1120: folds=20
JJin91: folds=20
DaBirds23: folds=20
donkeynutz44 is disconnected=20
donkeynutz44 is connected=20
donkeynutz44: calls 17400
*** FLOP *** [9d 2d 4d]
*** TURN *** [9d 2d 4d] [Ad]
*** RIVER *** [9d 2d 4d Ad] [6c]
*** SHOW DOWN ***
donkeynutz44: shows [8h 8s] (a pair of Eights)
pepstargar: shows [Qd Qc] (a flush, Ace high)
pepstargar collected 60675 from pot
*** SUMMARY ***
Total pot 60675 | Rake 0=20
Board [9d 2d 4d Ad 6c]
Seat 1: jmaltabes folded before Flop (didn't bet)
Seat 2: pepstargar showed [Qd Qc] and won (60675) with a flush, Ace high
Seat 3: nigock folded before Flop (didn't bet)
Seat 4: Article332 folded before Flop (didn't bet)
Seat 5: Labba609 folded before Flop (didn't bet)
Seat 6: SAMCRO_1120 (button) folded before Flop (didn't bet)
Seat 7: JJin91 (small blind) folded before Flop
Seat 8: DaBirds23 (big blind) folded before Flop
Seat 9: donkeynutz44 showed [8h 8s] and lost with a pair of Eights


*********** # 143 **************
PokerStars Hand #169323122695: Tournament #1597683884, $18.20+$1.80 USD=
 Hold'em No Limit - Level XXI (1500/3000) - 2017/05/02 22:43:28 ET
Table '1597683884 6' 9-max Seat #7 is the button
Seat 1: jmaltabes (82891 in chips)=20
Seat 2: pepstargar (60675 in chips)=20
Seat 3: nigock (41241 in chips)=20
Seat 4: Article332 (55808 in chips)=20
Seat 5: Labba609 (88498 in chips)=20
Seat 6: SAMCRO_1120 (82860 in chips)=20
Seat 7: JJin91 (42640 in chips)=20
Seat 8: DaBirds23 (66154 in chips)=20
Seat 9: donkeynutz44 (5995 in chips)=20
jmaltabes: posts the ante 375
pepstargar: posts the ante 375
nigock: posts the ante 375
Article332: posts the ante 375
Labba609: posts the ante 375
SAMCRO_1120: posts the ante 375
JJin91: posts the ante 375
DaBirds23: posts the ante 375
donkeynutz44: posts the ante 375
DaBirds23: posts small blind 1500
donkeynutz44: posts big blind 3000
*** HOLE CARDS ***
Dealt to JJin91 [9d 6d]
SAMCRO_1120 said, "comeback;"
jmaltabes: folds=20
pepstargar: raises 3000 to 6000
nigock: folds=20
pepstargar said, "its easy to play a short stack imo"
Article332: folds=20
Labba609: folds=20
SAMCRO_1120: folds=20
JJin91: folds=20
DaBirds23: folds=20
SAMCRO_1120 said, "def"
donkeynutz44: calls 2620 and is all-in
Uncalled bet (380) returned to pepstargar
*** FLOP *** [Qh 5c Ad]
*** TURN *** [Qh 5c Ad] [Qc]
*** RIVER *** [Qh 5c Ad Qc] [8c]
*** SHOW DOWN ***
donkeynutz44: shows [Kd 2s] (a pair of Queens)
pepstargar: shows [3s 3c] (two pair, Queens and Threes)
pepstargar collected 16115 from pot
donkeynutz44 finished the tournament in 17th place and received $40.66.
*** SUMMARY ***
Total pot 16115 | Rake 0=20
Board [Qh 5c Ad Qc 8c]
Seat 1: jmaltabes folded before Flop (didn't bet)
Seat 2: pepstargar showed [3s 3c] and won (16115) with two pair, Queens=
 and Threes
Seat 3: nigock folded before Flop (didn't bet)
Seat 4: Article332 folded before Flop (didn't bet)
Seat 5: Labba609 folded before Flop (didn't bet)
Seat 6: SAMCRO_1120 folded before Flop (didn't bet)
Seat 7: JJin91 (button) folded before Flop (didn't bet)
Seat 8: DaBirds23 (small blind) folded before Flop
Seat 9: donkeynutz44 (big blind) showed [Kd 2s] and lost with a pair of=
 Queens


*********** # 144 **************
PokerStars Hand #169323122833: Tournament #1597683884, $18.20+$1.80 USD=
 Hold'em No Limit - Level XXI (1500/3000) - 2017/05/02 22:44:02 ET
Table '1597683884 6' 9-max Seat #8 is the button
Seat 1: jmaltabes (82516 in chips)=20
Seat 2: pepstargar (70795 in chips)=20
Seat 3: nigock (40866 in chips)=20
Seat 4: Article332 (55433 in chips)=20
Seat 5: Labba609 (88123 in chips)=20
Seat 6: SAMCRO_1120 (82485 in chips)=20
Seat 7: JJin91 (42265 in chips)=20
Seat 8: DaBirds23 (64279 in chips)=20
jmaltabes: posts the ante 375
pepstargar: posts the ante 375
nigock: posts the ante 375
Article332: posts the ante 375
Labba609: posts the ante 375
SAMCRO_1120: posts the ante 375
JJin91: posts the ante 375
DaBirds23: posts the ante 375
jmaltabes: posts small blind 1500
pepstargar: posts big blind 3000
*** HOLE CARDS ***
Dealt to JJin91 [6d Ad]
nigock: folds=20
Article332: folds=20
Labba609: folds=20
SAMCRO_1120: folds=20
JJin91: raises 38890 to 41890 and is all-in
DaBirds23: folds=20
jmaltabes: folds=20
pepstargar: folds=20
Uncalled bet (38890) returned to JJin91
JJin91 collected 10500 from pot
JJin91: doesn't show hand=20
pepstargar said, "almost at 80k where i shouldve been"
*** SUMMARY ***
Total pot 10500 | Rake 0=20
Seat 1: jmaltabes (small blind) folded before Flop
Seat 2: pepstargar (big blind) folded before Flop
Seat 3: nigock folded before Flop (didn't bet)
Seat 4: Article332 folded before Flop (didn't bet)
Seat 5: Labba609 folded before Flop (didn't bet)
Seat 6: SAMCRO_1120 folded before Flop (didn't bet)
Seat 7: JJin91 collected (10500)
Seat 8: DaBirds23 (button) folded before Flop (didn't bet)


*********** # 145 **************
PokerStars Hand #169323122992: Tournament #1597683884, $18.20+$1.80 USD=
 Hold'em No Limit - Level XXI (1500/3000) - 2017/05/02 22:44:38 ET
Table '1597683884 6' 9-max Seat #1 is the button
Seat 1: jmaltabes (80641 in chips)=20
Seat 2: pepstargar (67420 in chips)=20
Seat 3: nigock (40491 in chips)=20
Seat 4: Article332 (55058 in chips)=20
Seat 5: Labba609 (87748 in chips)=20
Seat 6: SAMCRO_1120 (82110 in chips)=20
Seat 7: JJin91 (49390 in chips)=20
Seat 8: DaBirds23 (63904 in chips)=20
jmaltabes: posts the ante 375
pepstargar: posts the ante 375
nigock: posts the ante 375
Article332: posts the ante 375
Labba609: posts the ante 375
SAMCRO_1120: posts the ante 375
JJin91: posts the ante 375
DaBirds23: posts the ante 375
pepstargar: posts small blind 1500
nigock: posts big blind 3000
*** HOLE CARDS ***
Dealt to JJin91 [2h 4h]
Article332: raises 3000 to 6000
SAMCRO_1120 said, "yeah"
pepstargar said, "oh well"
Labba609: folds=20
SAMCRO_1120: folds=20
JJin91: folds=20
DaBirds23: folds=20
jmaltabes: folds=20
pepstargar: folds=20
nigock: calls 3000
*** FLOP *** [Kd Ad 8s]
nigock: checks=20
pepstargar said, "could use a win, its been a little while"
Article332: bets 8250
nigock: folds=20
Uncalled bet (8250) returned to Article332
Article332 collected 16500 from pot
Article332: doesn't show hand=20
*** SUMMARY ***
Total pot 16500 | Rake 0=20
Board [Kd Ad 8s]
Seat 1: jmaltabes (button) folded before Flop (didn't bet)
Seat 2: pepstargar (small blind) folded before Flop
Seat 3: nigock (big blind) folded on the Flop
Seat 4: Article332 collected (16500)
Seat 5: Labba609 folded before Flop (didn't bet)
Seat 6: SAMCRO_1120 folded before Flop (didn't bet)
Seat 7: JJin91 folded before Flop (didn't bet)
Seat 8: DaBirds23 folded before Flop (didn't bet)


*********** # 146 **************
PokerStars Hand #169323123210: Tournament #1597683884, $18.20+$1.80 USD=
 Hold'em No Limit - Level XXI (1500/3000) - 2017/05/02 22:45:33 ET
Table '1597683884 6' 9-max Seat #2 is the button
Seat 1: jmaltabes (80266 in chips)=20
Seat 2: pepstargar (65545 in chips)=20
Seat 3: nigock (34116 in chips)=20
Seat 4: Article332 (65183 in chips)=20
Seat 5: Labba609 (87373 in chips)=20
Seat 6: SAMCRO_1120 (81735 in chips)=20
Seat 7: JJin91 (49015 in chips)=20
Seat 8: DaBirds23 (63529 in chips)=20
jmaltabes: posts the ante 375
pepstargar: posts the ante 375
nigock: posts the ante 375
Article332: posts the ante 375
Labba609: posts the ante 375
SAMCRO_1120: posts the ante 375
JJin91: posts the ante 375
DaBirds23: posts the ante 375
nigock: posts small blind 1500
Article332: posts big blind 3000
*** HOLE CARDS ***
Dealt to JJin91 [2c 9h]
Labba609: raises 4500 to 7500
SAMCRO_1120: folds=20
JJin91: folds=20
DaBirds23: folds=20
jmaltabes: folds=20
pepstargar: folds=20
nigock: folds=20
Article332: folds=20
Uncalled bet (4500) returned to Labba609
Labba609 collected 10500 from pot
Labba609: doesn't show hand=20
*** SUMMARY ***
Total pot 10500 | Rake 0=20
Seat 1: jmaltabes folded before Flop (didn't bet)
Seat 2: pepstargar (button) folded before Flop (didn't bet)
Seat 3: nigock (small blind) folded before Flop
Seat 4: Article332 (big blind) folded before Flop
Seat 5: Labba609 collected (10500)
Seat 6: SAMCRO_1120 folded before Flop (didn't bet)
Seat 7: JJin91 folded before Flop (didn't bet)
Seat 8: DaBirds23 folded before Flop (didn't bet)


*********** # 147 **************
PokerStars Hand #169323123366: Tournament #1597683884, $18.20+$1.80 USD=
 Hold'em No Limit - Level XXI (1500/3000) - 2017/05/02 22:46:11 ET
Table '1597683884 6' 9-max Seat #3 is the button
Seat 1: jmaltabes (79891 in chips)=20
Seat 2: pepstargar (65170 in chips)=20
Seat 3: nigock (32241 in chips)=20
Seat 4: Article332 (61808 in chips)=20
Seat 5: Labba609 (94498 in chips)=20
Seat 6: SAMCRO_1120 (81360 in chips)=20
Seat 7: JJin91 (48640 in chips)=20
Seat 8: DaBirds23 (63154 in chips)=20
jmaltabes: posts the ante 375
pepstargar: posts the ante 375
nigock: posts the ante 375
Article332: posts the ante 375
Labba609: posts the ante 375
SAMCRO_1120: posts the ante 375
JJin91: posts the ante 375
DaBirds23: posts the ante 375
Article332: posts small blind 1500
Labba609: posts big blind 3000
*** HOLE CARDS ***
Dealt to JJin91 [Qc 4s]
SAMCRO_1120: folds=20
JJin91: folds=20
DaBirds23: folds=20
jmaltabes: folds=20
pepstargar: raises 3000 to 6000
nigock: folds=20
Article332: folds=20
Labba609: calls 3000
*** FLOP *** [2c 9s 4c]
Labba609: checks=20
pepstargar: checks=20
*** TURN *** [2c 9s 4c] [Td]
Labba609: checks=20
pepstargar: checks=20
*** RIVER *** [2c 9s 4c Td] [5d]
Labba609: checks=20
pepstargar: checks=20
*** SHOW DOWN ***
Labba609: shows [Qh Jd] (high card Queen)
pepstargar: shows [7h 7c] (a pair of Sevens)
pepstargar collected 16500 from pot
*** SUMMARY ***
Total pot 16500 | Rake 0=20
Board [2c 9s 4c Td 5d]
Seat 1: jmaltabes folded before Flop (didn't bet)
Seat 2: pepstargar showed [7h 7c] and won (16500) with a pair of Sevens
Seat 3: nigock (button) folded before Flop (didn't bet)
Seat 4: Article332 (small blind) folded before Flop
Seat 5: Labba609 (big blind) showed [Qh Jd] and lost with high card Que=
en
Seat 6: SAMCRO_1120 folded before Flop (didn't bet)
Seat 7: JJin91 folded before Flop (didn't bet)
Seat 8: DaBirds23 folded before Flop (didn't bet)


*********** # 148 **************
PokerStars Hand #169323123606: Tournament #1597683884, $18.20+$1.80 USD=
 Hold'em No Limit - Level XXI (1500/3000) - 2017/05/02 22:47:05 ET
Table '1597683884 6' 9-max Seat #4 is the button
Seat 1: jmaltabes (79516 in chips)=20
Seat 2: pepstargar (75295 in chips)=20
Seat 3: nigock (31866 in chips)=20
Seat 4: Article332 (59933 in chips)=20
Seat 5: Labba609 (88123 in chips)=20
Seat 6: SAMCRO_1120 (80985 in chips)=20
Seat 7: JJin91 (48265 in chips)=20
Seat 8: DaBirds23 (62779 in chips)=20
jmaltabes: posts the ante 375
pepstargar: posts the ante 375
nigock: posts the ante 375
Article332: posts the ante 375
Labba609: posts the ante 375
SAMCRO_1120: posts the ante 375
JJin91: posts the ante 375
DaBirds23: posts the ante 375
Labba609: posts small blind 1500
SAMCRO_1120: posts big blind 3000
*** HOLE CARDS ***
Dealt to JJin91 [9d 2c]
JJin91: folds=20
DaBirds23: folds=20
jmaltabes: raises 3000 to 6000
pepstargar: folds=20
nigock: folds=20
Article332: folds=20
Labba609: folds=20
SAMCRO_1120: calls 3000
*** FLOP *** [9s 8d Ac]
SAMCRO_1120: checks=20
jmaltabes: bets 6000
SAMCRO_1120: calls 6000
*** TURN *** [9s 8d Ac] [8h]
SAMCRO_1120: checks=20
jmaltabes: checks=20
*** RIVER *** [9s 8d Ac 8h] [2d]
SAMCRO_1120: checks=20
jmaltabes: checks=20
*** SHOW DOWN ***
SAMCRO_1120: shows [Ah 5d] (two pair, Aces and Eights)
jmaltabes: mucks hand=20
SAMCRO_1120 collected 28500 from pot
*** SUMMARY ***
Total pot 28500 | Rake 0=20
Board [9s 8d Ac 8h 2d]
Seat 1: jmaltabes mucked [Jc Td]
Seat 2: pepstargar folded before Flop (didn't bet)
Seat 3: nigock folded before Flop (didn't bet)
Seat 4: Article332 (button) folded before Flop (didn't bet)
Seat 5: Labba609 (small blind) folded before Flop
Seat 6: SAMCRO_1120 (big blind) showed [Ah 5d] and won (28500) with two=
 pair, Aces and Eights
Seat 7: JJin91 folded before Flop (didn't bet)
Seat 8: DaBirds23 folded before Flop (didn't bet)


*********** # 149 **************
PokerStars Hand #169323123837: Tournament #1597683884, $18.20+$1.80 USD=
 Hold'em No Limit - Level XXI (1500/3000) - 2017/05/02 22:47:58 ET
Table '1597683884 6' 9-max Seat #5 is the button
Seat 1: jmaltabes (67141 in chips)=20
Seat 2: pepstargar (74920 in chips)=20
Seat 3: nigock (31491 in chips)=20
Seat 4: Article332 (59558 in chips)=20
Seat 5: Labba609 (86248 in chips)=20
Seat 6: SAMCRO_1120 (97110 in chips)=20
Seat 7: JJin91 (47890 in chips)=20
jmaltabes: posts the ante 375
pepstargar: posts the ante 375
nigock: posts the ante 375
Article332: posts the ante 375
Labba609: posts the ante 375
SAMCRO_1120: posts the ante 375
JJin91: posts the ante 375
SAMCRO_1120: posts small blind 1500
JJin91: posts big blind 3000
*** HOLE CARDS ***
Dealt to JJin91 [Ac 4s]
jmaltabes: folds=20
pepstargar: folds=20
nigock: folds=20
Article332: folds=20
Labba609: folds=20
SAMCRO_1120: raises 93735 to 96735 and is all-in
JJin91: calls 44515 and is all-in
Uncalled bet (49220) returned to SAMCRO_1120
*** FLOP *** [8c 9c 5s]
*** TURN *** [8c 9c 5s] [4h]
*** RIVER *** [8c 9c 5s 4h] [Qh]
*** SHOW DOWN ***
SAMCRO_1120: shows [Ad Jh] (high card Ace)
JJin91: shows [Ac 4s] (a pair of Fours)
JJin91 collected 97655 from pot
*** SUMMARY ***
Total pot 97655 | Rake 0=20
Board [8c 9c 5s 4h Qh]
Seat 1: jmaltabes folded before Flop (didn't bet)
Seat 2: pepstargar folded before Flop (didn't bet)
Seat 3: nigock folded before Flop (didn't bet)
Seat 4: Article332 folded before Flop (didn't bet)
Seat 5: Labba609 (button) folded before Flop (didn't bet)
Seat 6: SAMCRO_1120 (small blind) showed [Ad Jh] and lost with high car=
d Ace
Seat 7: JJin91 (big blind) showed [Ac 4s] and won (97655) with a pair o=
f Fours


*********** # 150 **************
PokerStars Hand #169323124014: Tournament #1597683884, $18.20+$1.80 USD=
 Hold'em No Limit - Level XXII (2000/4000) - 2017/05/02 22:48:38 ET
Table '1597683884 6' 9-max Seat #6 is the button
Seat 1: jmaltabes (66766 in chips)=20
Seat 2: pepstargar (74545 in chips)=20
Seat 3: nigock (31116 in chips)=20
Seat 4: Article332 (59183 in chips)=20
Seat 5: Labba609 (85873 in chips)=20
Seat 6: SAMCRO_1120 (49220 in chips)=20
Seat 7: JJin91 (97655 in chips)=20
jmaltabes: posts the ante 500
pepstargar: posts the ante 500
nigock: posts the ante 500
Article332: posts the ante 500
Labba609: posts the ante 500
SAMCRO_1120: posts the ante 500
JJin91: posts the ante 500
JJin91: posts small blind 2000
jmaltabes: posts big blind 4000
*** HOLE CARDS ***
Dealt to JJin91 [6s 9c]
SAMCRO_1120 said, "fucking terrrible"
pepstargar: folds=20
nigock: folds=20
Article332: folds=20
Labba609: raises 6000 to 10000
SAMCRO_1120: raises 38720 to 48720 and is all-in
JJin91: folds=20
jmaltabes is connected=20
jmaltabes: raises 17546 to 66266 and is all-in
Labba609: folds=20
Uncalled bet (17546) returned to jmaltabes
*** FLOP *** [5d 6h Jd]
*** TURN *** [5d 6h Jd] [2h]
*** RIVER *** [5d 6h Jd 2h] [9h]
*** SHOW DOWN ***
jmaltabes: shows [Ks Ah] (high card Ace)
SAMCRO_1120: shows [5c As] (a pair of Fives)
SAMCRO_1120 collected 112940 from pot
SAMCRO_1120 said, "ok ok"
*** SUMMARY ***
Total pot 112940 | Rake 0=20
Board [5d 6h Jd 2h 9h]
Seat 1: jmaltabes (big blind) showed [Ks Ah] and lost with high card Ace
Seat 2: pepstargar folded before Flop (didn't bet)
Seat 3: nigock folded before Flop (didn't bet)
Seat 4: Article332 folded before Flop (didn't bet)
Seat 5: Labba609 folded before Flop
Seat 6: SAMCRO_1120 (button) showed [5c As] and won (112940) with a pai=
r of Fives
Seat 7: JJin91 (small blind) folded before Flop


*********** # 151 **************
PokerStars Hand #169323124329: Tournament #1597683884, $18.20+$1.80 USD=
 Hold'em No Limit - Level XXII (2000/4000) - 2017/05/02 22:49:46 ET
Table '1597683884 6' 9-max Seat #7 is the button
Seat 1: jmaltabes (17546 in chips)=20
Seat 2: pepstargar (74045 in chips)=20
Seat 3: nigock (30616 in chips)=20
Seat 4: Article332 (58683 in chips)=20
Seat 5: Labba609 (75373 in chips)=20
Seat 6: SAMCRO_1120 (112940 in chips)=20
Seat 7: JJin91 (95155 in chips)=20
jmaltabes: posts the ante 500
pepstargar: posts the ante 500
nigock: posts the ante 500
Article332: posts the ante 500
Labba609: posts the ante 500
SAMCRO_1120: posts the ante 500
JJin91: posts the ante 500
jmaltabes: posts small blind 2000
pepstargar: posts big blind 4000
*** HOLE CARDS ***
Dealt to JJin91 [2s Tc]
jmaltabes said, "same"
nigock: folds=20
pepstargar said, "lol"
Article332: folds=20
Labba609: folds=20
SAMCRO_1120: folds=20
Labba609 said, "buhaahhaha"
Labba609 said, "play better brah"
JJin91: folds=20
jmaltabes: calls 2000
pepstargar: raises 69545 to 73545 and is all-in
jmaltabes: folds=20
Uncalled bet (69545) returned to pepstargar
Labba609 said, "he flatsssss"
pepstargar collected 11500 from pot
pepstargar: doesn't show hand=20
*** SUMMARY ***
Total pot 11500 | Rake 0=20
Seat 1: jmaltabes (small blind) folded before Flop
Seat 2: pepstargar (big blind) collected (11500)
Seat 3: nigock folded before Flop (didn't bet)
Seat 4: Article332 folded before Flop (didn't bet)
Seat 5: Labba609 folded before Flop (didn't bet)
Seat 6: SAMCRO_1120 folded before Flop (didn't bet)
Seat 7: JJin91 (button) folded before Flop (didn't bet)


*********** # 152 **************
PokerStars Hand #169323124451: Tournament #1597683884, $18.20+$1.80 USD=
 Hold'em No Limit - Level XXII (2000/4000) - 2017/05/02 22:50:11 ET
Table '1597683884 6' 9-max Seat #1 is the button
Seat 1: jmaltabes (13046 in chips)=20
Seat 2: pepstargar (81045 in chips)=20
Seat 3: nigock (30116 in chips)=20
Seat 4: Article332 (58183 in chips)=20
Seat 5: Labba609 (74873 in chips)=20
Seat 6: SAMCRO_1120 (112440 in chips)=20
Seat 7: JJin91 (94655 in chips)=20
jmaltabes: posts the ante 500
pepstargar: posts the ante 500
nigock: posts the ante 500
Article332: posts the ante 500
Labba609: posts the ante 500
SAMCRO_1120: posts the ante 500
JJin91: posts the ante 500
pepstargar: posts small blind 2000
nigock: posts big blind 4000
*** HOLE CARDS ***
Dealt to JJin91 [Kc 4h]
SAMCRO_1120 said, "i had 10 bigs bro"
Article332: folds=20
Labba609 said, "ok cool"
jmaltabes said, "i give u a walk n u ship pep lol"
Labba609: folds=20
jmaltabes said, "gotcha"
SAMCRO_1120 said, "with the top heavy payouts too"
Labba609 said, "cause i was talking to you...."
SAMCRO_1120: folds=20
JJin91: folds=20
jmaltabes: raises 8546 to 12546 and is all-in
pepstargar: folds=20
nigock: calls 8546
*** FLOP *** [As 3s 9h]
*** TURN *** [As 3s 9h] [8h]
*** RIVER *** [As 3s 9h 8h] [Qc]
*** SHOW DOWN ***
nigock: shows [Ks 3d] (a pair of Threes)
jmaltabes: shows [Kh 8c] (a pair of Eights)
jmaltabes collected 30592 from pot
*** SUMMARY ***
Total pot 30592 | Rake 0=20
Board [As 3s 9h 8h Qc]
Seat 1: jmaltabes (button) showed [Kh 8c] and won (30592) with a pair o=
f Eights
Seat 2: pepstargar (small blind) folded before Flop
Seat 3: nigock (big blind) showed [Ks 3d] and lost with a pair of Threes
Seat 4: Article332 folded before Flop (didn't bet)
Seat 5: Labba609 folded before Flop (didn't bet)
Seat 6: SAMCRO_1120 folded before Flop (didn't bet)
Seat 7: JJin91 folded before Flop (didn't bet)


*********** # 153 **************
PokerStars Hand #169323124699: Tournament #1597683884, $18.20+$1.80 USD=
 Hold'em No Limit - Level XXII (2000/4000) - 2017/05/02 22:51:06 ET
Table '1597683884 6' 9-max Seat #2 is the button
Seat 1: jmaltabes (30592 in chips)=20
Seat 2: pepstargar (78545 in chips)=20
Seat 3: nigock (17070 in chips)=20
Seat 4: Article332 (57683 in chips)=20
Seat 5: Labba609 (74373 in chips)=20
Seat 6: SAMCRO_1120 (111940 in chips)=20
Seat 7: JJin91 (94155 in chips)=20
jmaltabes: posts the ante 500
pepstargar: posts the ante 500
nigock: posts the ante 500
Article332: posts the ante 500
Labba609: posts the ante 500
SAMCRO_1120: posts the ante 500
JJin91: posts the ante 500
nigock: posts small blind 2000
Article332: posts big blind 4000
*** HOLE CARDS ***
Dealt to JJin91 [3c Jd]
Labba609: folds=20
nigock said, "nh"
SAMCRO_1120: folds=20
JJin91: folds=20
jmaltabes: raises 4000 to 8000
pepstargar: folds=20
nigock: folds=20
Article332: calls 4000
*** FLOP *** [Ad 4h Jc]
Article332: bets 21500
jmaltabes: folds=20
Uncalled bet (21500) returned to Article332
Article332 collected 21500 from pot
Article332: doesn't show hand=20
*** SUMMARY ***
Total pot 21500 | Rake 0=20
Board [Ad 4h Jc]
Seat 1: jmaltabes folded on the Flop
Seat 2: pepstargar (button) folded before Flop (didn't bet)
Seat 3: nigock (small blind) folded before Flop
Seat 4: Article332 (big blind) collected (21500)
Seat 5: Labba609 folded before Flop (didn't bet)
Seat 6: SAMCRO_1120 folded before Flop (didn't bet)
Seat 7: JJin91 folded before Flop (didn't bet)


*********** # 154 **************
PokerStars Hand #169323124896: Tournament #1597683884, $18.20+$1.80 USD=
 Hold'em No Limit - Level XXII (2000/4000) - 2017/05/02 22:51:47 ET
Table '1597683884 6' 9-max Seat #3 is the button
Seat 1: jmaltabes (22092 in chips)=20
Seat 2: pepstargar (78045 in chips)=20
Seat 3: nigock (14570 in chips)=20
Seat 4: Article332 (70683 in chips)=20
Seat 5: Labba609 (73873 in chips)=20
Seat 6: SAMCRO_1120 (111440 in chips)=20
Seat 7: JJin91 (93655 in chips)=20
jmaltabes: posts the ante 500
pepstargar: posts the ante 500
nigock: posts the ante 500
Article332: posts the ante 500
Labba609: posts the ante 500
SAMCRO_1120: posts the ante 500
JJin91: posts the ante 500
Article332: posts small blind 2000
Labba609: posts big blind 4000
*** HOLE CARDS ***
Dealt to JJin91 [4c Jc]
SAMCRO_1120: folds=20
JJin91: folds=20
jmaltabes: folds=20
pepstargar: folds=20
nigock: folds=20
Article332: calls 2000
Labba609: checks=20
*** FLOP *** [Qs Js 7d]
Article332: bets 4000
Labba609: raises 4000 to 8000
Article332: calls 4000
*** TURN *** [Qs Js 7d] [Th]
Article332: checks=20
Labba609: bets 11000
Article332: folds=20
Uncalled bet (11000) returned to Labba609
Labba609 collected 27500 from pot
Labba609: doesn't show hand=20
*** SUMMARY ***
Total pot 27500 | Rake 0=20
Board [Qs Js 7d Th]
Seat 1: jmaltabes folded before Flop (didn't bet)
Seat 2: pepstargar folded before Flop (didn't bet)
Seat 3: nigock (button) folded before Flop (didn't bet)
Seat 4: Article332 (small blind) folded on the Turn
Seat 5: Labba609 (big blind) collected (27500)
Seat 6: SAMCRO_1120 folded before Flop (didn't bet)
Seat 7: JJin91 folded before Flop (didn't bet)


*********** # 155 **************
PokerStars Hand #169323125188: Tournament #1597683884, $18.20+$1.80 USD=
 Hold'em No Limit - Level XXII (2000/4000) - 2017/05/02 22:52:45 ET
Table '1597683884 6' 9-max Seat #4 is the button
Seat 1: jmaltabes (21592 in chips)=20
Seat 2: pepstargar (77545 in chips)=20
Seat 4: Article332 (58183 in chips)=20
Seat 5: Labba609 (88873 in chips)=20
Seat 6: SAMCRO_1120 (110940 in chips)=20
Seat 7: JJin91 (93155 in chips)=20
jmaltabes: posts the ante 500
pepstargar: posts the ante 500
Article332: posts the ante 500
Labba609: posts the ante 500
SAMCRO_1120: posts the ante 500
JJin91: posts the ante 500
Labba609: posts small blind 2000
SAMCRO_1120: posts big blind 4000
*** HOLE CARDS ***
Dealt to JJin91 [Js Kh]
JJin91: folds=20
jmaltabes: folds=20
pepstargar: folds=20
Article332: folds=20
Labba609: folds=20
Uncalled bet (2000) returned to SAMCRO_1120
SAMCRO_1120 collected 7000 from pot
*** SUMMARY ***
Total pot 7000 | Rake 0=20
Seat 1: jmaltabes folded before Flop (didn't bet)
Seat 2: pepstargar folded before Flop (didn't bet)
Seat 4: Article332 (button) folded before Flop (didn't bet)
Seat 5: Labba609 (small blind) folded before Flop
Seat 6: SAMCRO_1120 (big blind) collected (7000)
Seat 7: JJin91 folded before Flop (didn't bet)


*********** # 156 **************
PokerStars Hand #169323125289: Tournament #1597683884, $18.20+$1.80 USD=
 Hold'em No Limit - Level XXII (2000/4000) - 2017/05/02 22:53:07 ET
Table '1597683884 6' 9-max Seat #5 is the button
Seat 1: jmaltabes (21092 in chips)=20
Seat 2: pepstargar (77045 in chips)=20
Seat 4: Article332 (57683 in chips)=20
Seat 5: Labba609 (86373 in chips)=20
Seat 6: SAMCRO_1120 (115440 in chips)=20
Seat 7: JJin91 (92655 in chips)=20
jmaltabes: posts the ante 500
pepstargar: posts the ante 500
Article332: posts the ante 500
Labba609: posts the ante 500
SAMCRO_1120: posts the ante 500
JJin91: posts the ante 500
SAMCRO_1120: posts small blind 2000
JJin91: posts big blind 4000
*** HOLE CARDS ***
Dealt to JJin91 [8c Kc]
jmaltabes: raises 16592 to 20592 and is all-in
pepstargar: folds=20
Article332: folds=20
Labba609: folds=20
SAMCRO_1120: folds=20
JJin91: calls 16592
*** FLOP *** [5h Jc Ac]
*** TURN *** [5h Jc Ac] [9h]
*** RIVER *** [5h Jc Ac 9h] [8d]
*** SHOW DOWN ***
JJin91: shows [8c Kc] (a pair of Eights)
jmaltabes: shows [7s Kd] (high card Ace)
JJin91 collected 46184 from pot
jmaltabes finished the tournament in 12th place and received $44.63.
*** SUMMARY ***
Total pot 46184 | Rake 0=20
Board [5h Jc Ac 9h 8d]
Seat 1: jmaltabes showed [7s Kd] and lost with high card Ace
Seat 2: pepstargar folded before Flop (didn't bet)
Seat 4: Article332 folded before Flop (didn't bet)
Seat 5: Labba609 (button) folded before Flop (didn't bet)
Seat 6: SAMCRO_1120 (small blind) folded before Flop
Seat 7: JJin91 (big blind) showed [8c Kc] and won (46184) with a pair o=
f Eights


*********** # 157 **************
PokerStars Hand #169323125424: Tournament #1597683884, $18.20+$1.80 USD=
 Hold'em No Limit - Level XXII (2000/4000) - 2017/05/02 22:53:36 ET
Table '1597683884 6' 9-max Seat #6 is the button
Seat 2: pepstargar (76545 in chips)=20
Seat 4: Article332 (57183 in chips)=20
Seat 5: Labba609 (85873 in chips)=20
Seat 6: SAMCRO_1120 (112940 in chips)=20
Seat 7: JJin91 (117747 in chips)=20
pepstargar: posts the ante 500
Article332: posts the ante 500
Labba609: posts the ante 500
SAMCRO_1120: posts the ante 500
JJin91: posts the ante 500
JJin91: posts small blind 2000
pepstargar: posts big blind 4000
*** HOLE CARDS ***
Dealt to JJin91 [Ac Kh]
Article332: folds=20
Labba609: raises 6000 to 10000
SAMCRO_1120: calls 10000
JJin91: calls 8000
pepstargar: calls 6000
*** FLOP *** [3h 7c 3c]
JJin91: checks=20
pepstargar: checks=20
Labba609: bets 21250
SAMCRO_1120: folds=20
JJin91: folds=20
pepstargar: folds=20
Uncalled bet (21250) returned to Labba609
Labba609 collected 42500 from pot
Labba609: doesn't show hand=20
Labba609 said, "flat flat flat buahhahahha"
*** SUMMARY ***
Total pot 42500 | Rake 0=20
Board [3h 7c 3c]
Seat 2: pepstargar (big blind) folded on the Flop
Seat 4: Article332 folded before Flop (didn't bet)
Seat 5: Labba609 collected (42500)
Seat 6: SAMCRO_1120 (button) folded on the Flop
Seat 7: JJin91 (small blind) folded on the Flop


*********** # 158 **************
PokerStars Hand #169323125662: Tournament #1597683884, $18.20+$1.80 USD=
 Hold'em No Limit - Level XXII (2000/4000) - 2017/05/02 22:54:25 ET
Table '1597683884 6' 9-max Seat #7 is the button
Seat 2: pepstargar (66045 in chips)=20
Seat 4: Article332 (56683 in chips)=20
Seat 5: Labba609 (117873 in chips)=20
Seat 6: SAMCRO_1120 (102440 in chips)=20
Seat 7: JJin91 (107247 in chips)=20
pepstargar: posts the ante 500
Article332: posts the ante 500
Labba609: posts the ante 500
SAMCRO_1120: posts the ante 500
JJin91: posts the ante 500
pepstargar: posts small blind 2000
Article332: posts big blind 4000
*** HOLE CARDS ***
Dealt to JJin91 [Js Tc]
Labba609: folds=20
SAMCRO_1120: folds=20
Labba609 said, "just give up on poker for real guys"
SAMCRO_1120 said, "set mining"
JJin91: raises 4440 to 8440
pepstargar: folds=20
Labba609 said, "cool"
Labba609 said, "dm me for coaching"
Article332: calls 4440
*** FLOP *** [5d 2d 4h]
Labba609 said, "shouldnt be doing that 30bb or less"
Article332: checks=20
Labba609 said, "especailly short handed"
Labba609 said, "net lesson"
pepstargar said, "not folding QJ in big for 6k more"
SAMCRO_1120 said, "yeah your such a beast playing a $20 tourney"
Labba609 said, "ok cool"
JJin91: bets 11331
SAMCRO_1120 said, "you play cash?"
Labba609 said, "buhahahah do your homework kiddos"
Article332: folds=20
Uncalled bet (11331) returned to JJin91
JJin91 collected 21380 from pot
JJin91: doesn't show hand=20
*** SUMMARY ***
Total pot 21380 | Rake 0=20
Board [5d 2d 4h]
Seat 2: pepstargar (small blind) folded before Flop
Seat 4: Article332 (big blind) folded on the Flop
Seat 5: Labba609 folded before Flop (didn't bet)
Seat 6: SAMCRO_1120 folded before Flop (didn't bet)
Seat 7: JJin91 (button) collected (21380)


*********** # 159 **************
PokerStars Hand #169323127188: Tournament #1597683884, $18.20+$1.80 USD=
 Hold'em No Limit - Level XXII (2000/4000) - 2017/05/02 23:00:46 ET
Table '1597683884 6' 9-max Seat #2 is the button
Seat 2: pepstargar (63545 in chips)=20
Seat 4: Article332 (47743 in chips)=20
Seat 5: Labba609 (117373 in chips)=20
Seat 6: SAMCRO_1120 (101940 in chips)=20
Seat 7: JJin91 (119687 in chips)=20
pepstargar: posts the ante 500
Article332: posts the ante 500
Labba609: posts the ante 500
SAMCRO_1120: posts the ante 500
JJin91: posts the ante 500
Article332: posts small blind 2000
Labba609: posts big blind 4000
*** HOLE CARDS ***
Dealt to JJin91 [Qc 8d]
SAMCRO_1120: raises 7440 to 11440
JJin91: folds=20
pepstargar: folds=20
Article332: folds=20
Labba609: folds=20
Uncalled bet (7440) returned to SAMCRO_1120
SAMCRO_1120 collected 12500 from pot
*** SUMMARY ***
Total pot 12500 | Rake 0=20
Seat 2: pepstargar (button) folded before Flop (didn't bet)
Seat 4: Article332 (small blind) folded before Flop
Seat 5: Labba609 (big blind) folded before Flop
Seat 6: SAMCRO_1120 collected (12500)
Seat 7: JJin91 folded before Flop (didn't bet)


*********** # 160 **************
PokerStars Hand #169323127335: Tournament #1597683884, $18.20+$1.80 USD=
 Hold'em No Limit - Level XXII (2000/4000) - 2017/05/02 23:01:15 ET
Table '1597683884 6' 9-max Seat #4 is the button
Seat 2: pepstargar (63045 in chips)=20
Seat 4: Article332 (45243 in chips)=20
Seat 5: Labba609 (112873 in chips)=20
Seat 6: SAMCRO_1120 (109940 in chips)=20
Seat 7: JJin91 (119187 in chips)=20
pepstargar: posts the ante 500
Article332: posts the ante 500
Labba609: posts the ante 500
SAMCRO_1120: posts the ante 500
JJin91: posts the ante 500
Labba609: posts small blind 2000
SAMCRO_1120: posts big blind 4000
*** HOLE CARDS ***
Dealt to JJin91 [4h 4s]
JJin91: raises 4440 to 8440
pepstargar: folds=20
Article332: folds=20
Labba609: folds=20
SAMCRO_1120: raises 11560 to 20000
JJin91: folds=20
Uncalled bet (11560) returned to SAMCRO_1120
SAMCRO_1120 collected 21380 from pot
*** SUMMARY ***
Total pot 21380 | Rake 0=20
Seat 2: pepstargar folded before Flop (didn't bet)
Seat 4: Article332 (button) folded before Flop (didn't bet)
Seat 5: Labba609 (small blind) folded before Flop
Seat 6: SAMCRO_1120 (big blind) collected (21380)
Seat 7: JJin91 folded before Flop


*********** # 161 **************
PokerStars Hand #169323127519: Tournament #1597683884, $18.20+$1.80 USD=
 Hold'em No Limit - Level XXII (2000/4000) - 2017/05/02 23:01:56 ET
Table '1597683884 6' 9-max Seat #5 is the button
Seat 2: pepstargar (62545 in chips)=20
Seat 4: Article332 (44743 in chips)=20
Seat 5: Labba609 (110373 in chips)=20
Seat 6: SAMCRO_1120 (122380 in chips)=20
Seat 7: JJin91 (110247 in chips)=20
pepstargar: posts the ante 500
Article332: posts the ante 500
Labba609: posts the ante 500
SAMCRO_1120: posts the ante 500
JJin91: posts the ante 500
SAMCRO_1120: posts small blind 2000
JJin91: posts big blind 4000
*** HOLE CARDS ***
Dealt to JJin91 [9c 8c]
pepstargar: raises 4000 to 8000
Article332: calls 8000
Labba609: folds=20
SAMCRO_1120: folds=20
JJin91: calls 4000
*** FLOP *** [5d Tc 9h]
JJin91: bets 15105
pepstargar: raises 38940 to 54045 and is all-in
Article332: folds=20
JJin91: folds=20
Uncalled bet (38940) returned to pepstargar
pepstargar collected 58710 from pot
pepstargar: doesn't show hand=20
*** SUMMARY ***
Total pot 58710 | Rake 0=20
Board [5d Tc 9h]
Seat 2: pepstargar collected (58710)
Seat 4: Article332 folded on the Flop
Seat 5: Labba609 (button) folded before Flop (didn't bet)
Seat 6: SAMCRO_1120 (small blind) folded before Flop
Seat 7: JJin91 (big blind) folded on the Flop


*********** # 162 **************
PokerStars Hand #169323127878: Tournament #1597683884, $18.20+$1.80 USD=
 Hold'em No Limit - Level XXII (2000/4000) - 2017/05/02 23:03:14 ET
Table '1597683884 6' 9-max Seat #6 is the button
Seat 2: pepstargar (97650 in chips)=20
Seat 4: Article332 (36243 in chips)=20
Seat 5: Labba609 (109873 in chips)=20
Seat 6: SAMCRO_1120 (119880 in chips)=20
Seat 7: JJin91 (86642 in chips)=20
pepstargar: posts the ante 500
Article332: posts the ante 500
Labba609: posts the ante 500
SAMCRO_1120: posts the ante 500
JJin91: posts the ante 500
JJin91: posts small blind 2000
pepstargar: posts big blind 4000
*** HOLE CARDS ***
Dealt to JJin91 [3s 9h]
Article332: folds=20
Labba609: folds=20
SAMCRO_1120: folds=20
JJin91: folds=20
Uncalled bet (2000) returned to pepstargar
pepstargar collected 6500 from pot
pepstargar: doesn't show hand=20
*** SUMMARY ***
Total pot 6500 | Rake 0=20
Seat 2: pepstargar (big blind) collected (6500)
Seat 4: Article332 folded before Flop (didn't bet)
Seat 5: Labba609 folded before Flop (didn't bet)
Seat 6: SAMCRO_1120 (button) folded before Flop (didn't bet)
Seat 7: JJin91 (small blind) folded before Flop


*********** # 163 **************
PokerStars Hand #169323128005: Tournament #1597683884, $18.20+$1.80 USD=
 Hold'em No Limit - Level XXII (2000/4000) - 2017/05/02 23:03:40 ET
Table '1597683884 6' 9-max Seat #7 is the button
Seat 2: pepstargar (101650 in chips)=20
Seat 4: Article332 (35743 in chips)=20
Seat 5: Labba609 (109373 in chips)=20
Seat 6: SAMCRO_1120 (119380 in chips)=20
Seat 7: JJin91 (84142 in chips)=20
pepstargar: posts the ante 500
Article332: posts the ante 500
Labba609: posts the ante 500
SAMCRO_1120: posts the ante 500
JJin91: posts the ante 500
pepstargar: posts small blind 2000
Article332: posts big blind 4000
*** HOLE CARDS ***
Dealt to JJin91 [Tc 3s]
Labba609: folds=20
SAMCRO_1120: folds=20
JJin91: folds=20
pepstargar: raises 97150 to 101150 and is all-in
Article332: folds=20
Uncalled bet (97150) returned to pepstargar
pepstargar collected 10500 from pot
pepstargar: doesn't show hand=20
*** SUMMARY ***
Total pot 10500 | Rake 0=20
Seat 2: pepstargar (small blind) collected (10500)
Seat 4: Article332 (big blind) folded before Flop
Seat 5: Labba609 folded before Flop (didn't bet)
Seat 6: SAMCRO_1120 folded before Flop (didn't bet)
Seat 7: JJin91 (button) folded before Flop (didn't bet)


*********** # 164 **************
PokerStars Hand #169323128186: Tournament #1597683884, $18.20+$1.80 USD=
 Hold'em No Limit - Level XXIII (2500/5000) - 2017/05/02 23:04:18 ET
Table '1597683884 6' 9-max Seat #2 is the button
Seat 2: pepstargar (107650 in chips)=20
Seat 4: Article332 (31243 in chips)=20
Seat 5: Labba609 (108873 in chips)=20
Seat 6: SAMCRO_1120 (118880 in chips)=20
Seat 7: JJin91 (83642 in chips)=20
pepstargar: posts the ante 625
Article332: posts the ante 625
Labba609: posts the ante 625
SAMCRO_1120: posts the ante 625
JJin91: posts the ante 625
Article332: posts small blind 2500
Labba609: posts big blind 5000
*** HOLE CARDS ***
Dealt to JJin91 [2d 6c]
SAMCRO_1120: folds=20
JJin91: folds=20
pepstargar: calls 5000
Article332: raises 25618 to 30618 and is all-in
Labba609: calls 25618
pepstargar: folds=20
*** FLOP *** [Qs 5c 2h]
*** TURN *** [Qs 5c 2h] [5s]
*** RIVER *** [Qs 5c 2h 5s] [Ks]
*** SHOW DOWN ***
Article332: shows [4d As] (a pair of Fives)
Labba609: shows [Ac Ad] (two pair, Aces and Fives)
Labba609 collected 69361 from pot
Article332 finished the tournament in 10th place and received $44.63.
*** SUMMARY ***
Total pot 69361 | Rake 0=20
Board [Qs 5c 2h 5s Ks]
Seat 2: pepstargar (button) folded before Flop
Seat 4: Article332 (small blind) showed [4d As] and lost with a pair of=
 Fives
Seat 5: Labba609 (big blind) showed [Ac Ad] and won (69361) with two pa=
ir, Aces and Fives
Seat 6: SAMCRO_1120 folded before Flop (didn't bet)
Seat 7: JJin91 folded before Flop (didn't bet)


*********** # 165 **************
PokerStars Hand #169323128365: Tournament #1597683884, $18.20+$1.80 USD=
 Hold'em No Limit - Level XXIII (2500/5000) - 2017/05/02 23:04:56 ET
Table '1597683884 5' 9-max Seat #5 is the button
Seat 1: Labba609 (146991 in chips)=20
Seat 2: pepstargar (102025 in chips)=20
Seat 3: JJin91 (83017 in chips)=20
Seat 4: MyManPotnPan (182829 in chips)=20
Seat 5: trucker45599 (159046 in chips)=20
Seat 6: Chark626 (92613 in chips)=20
Seat 7: SAMCRO_1120 (118255 in chips)=20
Seat 8: moosedeer17 (103700 in chips)=20
Seat 9: namesor362 (101524 in chips)=20
Labba609: posts the ante 625
pepstargar: posts the ante 625
JJin91: posts the ante 625
MyManPotnPan: posts the ante 625
trucker45599: posts the ante 625
Chark626: posts the ante 625
SAMCRO_1120: posts the ante 625
moosedeer17: posts the ante 625
namesor362: posts the ante 625
Chark626: posts small blind 2500
SAMCRO_1120: posts big blind 5000
*** HOLE CARDS ***
Dealt to JJin91 [3c 8d]
moosedeer17: folds=20
namesor362: folds=20
Labba609: folds=20
pepstargar: folds=20
JJin91: folds=20
MyManPotnPan: folds=20
trucker45599: raises 5000 to 10000
Chark626: folds=20
SAMCRO_1120: folds=20
Uncalled bet (5000) returned to trucker45599
trucker45599 collected 18125 from pot
trucker45599: doesn't show hand=20
*** SUMMARY ***
Total pot 18125 | Rake 0=20
Seat 1: Labba609 folded before Flop (didn't bet)
Seat 2: pepstargar folded before Flop (didn't bet)
Seat 3: JJin91 folded before Flop (didn't bet)
Seat 4: MyManPotnPan folded before Flop (didn't bet)
Seat 5: trucker45599 (button) collected (18125)
Seat 6: Chark626 (small blind) folded before Flop
Seat 7: SAMCRO_1120 (big blind) folded before Flop
Seat 8: moosedeer17 folded before Flop (didn't bet)
Seat 9: namesor362 folded before Flop (didn't bet)


*********** # 166 **************
PokerStars Hand #169323128488: Tournament #1597683884, $18.20+$1.80 USD=
 Hold'em No Limit - Level XXIII (2500/5000) - 2017/05/02 23:05:21 ET
Table '1597683884 5' 9-max Seat #6 is the button
Seat 1: Labba609 (146366 in chips)=20
Seat 2: pepstargar (101400 in chips)=20
Seat 3: JJin91 (82392 in chips)=20
Seat 4: MyManPotnPan (182204 in chips)=20
Seat 5: trucker45599 (171546 in chips)=20
Seat 6: Chark626 (89488 in chips)=20
Seat 7: SAMCRO_1120 (112630 in chips)=20
Seat 8: moosedeer17 (103075 in chips)=20
Seat 9: namesor362 (100899 in chips)=20
Labba609: posts the ante 625
pepstargar: posts the ante 625
JJin91: posts the ante 625
MyManPotnPan: posts the ante 625
trucker45599: posts the ante 625
Chark626: posts the ante 625
SAMCRO_1120: posts the ante 625
moosedeer17: posts the ante 625
namesor362: posts the ante 625
SAMCRO_1120: posts small blind 2500
moosedeer17: posts big blind 5000
*** HOLE CARDS ***
Dealt to JJin91 [5h Jd]
namesor362: folds=20
Labba609: folds=20
pepstargar: folds=20
JJin91: folds=20
MyManPotnPan: folds=20
trucker45599: raises 5000 to 10000
Chark626: folds=20
SAMCRO_1120: raises 20000 to 30000
moosedeer17: folds=20
MyManPotnPan said, "lab we meet again"
trucker45599: folds=20
Uncalled bet (20000) returned to SAMCRO_1120
SAMCRO_1120 collected 30625 from pot
*** SUMMARY ***
Total pot 30625 | Rake 0=20
Seat 1: Labba609 folded before Flop (didn't bet)
Seat 2: pepstargar folded before Flop (didn't bet)
Seat 3: JJin91 folded before Flop (didn't bet)
Seat 4: MyManPotnPan folded before Flop (didn't bet)
Seat 5: trucker45599 folded before Flop
Seat 6: Chark626 (button) folded before Flop (didn't bet)
Seat 7: SAMCRO_1120 (small blind) collected (30625)
Seat 8: moosedeer17 (big blind) folded before Flop
Seat 9: namesor362 folded before Flop (didn't bet)


*********** # 167 **************
PokerStars Hand #169323128706: Tournament #1597683884, $18.20+$1.80 USD=
 Hold'em No Limit - Level XXIII (2500/5000) - 2017/05/02 23:06:10 ET
Table '1597683884 5' 9-max Seat #7 is the button
Seat 1: Labba609 (145741 in chips)=20
Seat 2: pepstargar (100775 in chips)=20
Seat 3: JJin91 (81767 in chips)=20
Seat 4: MyManPotnPan (181579 in chips)=20
Seat 5: trucker45599 (160921 in chips)=20
Seat 6: Chark626 (88863 in chips)=20
Seat 7: SAMCRO_1120 (132630 in chips)=20
Seat 8: moosedeer17 (97450 in chips)=20
Seat 9: namesor362 (100274 in chips)=20
Labba609: posts the ante 625
pepstargar: posts the ante 625
JJin91: posts the ante 625
MyManPotnPan: posts the ante 625
trucker45599: posts the ante 625
Chark626: posts the ante 625
SAMCRO_1120: posts the ante 625
moosedeer17: posts the ante 625
namesor362: posts the ante 625
moosedeer17: posts small blind 2500
namesor362: posts big blind 5000
*** HOLE CARDS ***
Dealt to JJin91 [9c Ah]
Labba609: folds=20
pepstargar: raises 5000 to 10000
JJin91: folds=20
MyManPotnPan: folds=20
trucker45599: folds=20
Chark626: folds=20
SAMCRO_1120: folds=20
moosedeer17: folds=20
namesor362: calls 5000
*** FLOP *** [Kd 4c 8h]
namesor362: checks=20
pepstargar: checks=20
*** TURN *** [Kd 4c 8h] [Tc]
namesor362: bets 15343
pepstargar: calls 15343
*** RIVER *** [Kd 4c 8h Tc] [6d]
namesor362: bets 30456
pepstargar: calls 30456
*** SHOW DOWN ***
namesor362: shows [7s Qs] (high card King)
pepstargar: shows [Kc Qc] (a pair of Kings)
pepstargar collected 119723 from pot
*** SUMMARY ***
Total pot 119723 | Rake 0=20
Board [Kd 4c 8h Tc 6d]
Seat 1: Labba609 folded before Flop (didn't bet)
Seat 2: pepstargar showed [Kc Qc] and won (119723) with a pair of Kings
Seat 3: JJin91 folded before Flop (didn't bet)
Seat 4: MyManPotnPan folded before Flop (didn't bet)
Seat 5: trucker45599 folded before Flop (didn't bet)
Seat 6: Chark626 folded before Flop (didn't bet)
Seat 7: SAMCRO_1120 (button) folded before Flop (didn't bet)
Seat 8: moosedeer17 (small blind) folded before Flop
Seat 9: namesor362 (big blind) showed [7s Qs] and lost with high card K=
ing


*********** # 168 **************
PokerStars Hand #169323129208: Tournament #1597683884, $18.20+$1.80 USD=
 Hold'em No Limit - Level XXIII (2500/5000) - 2017/05/02 23:08:01 ET
Table '1597683884 5' 9-max Seat #8 is the button
Seat 1: Labba609 (145116 in chips)=20
Seat 2: pepstargar (164074 in chips)=20
Seat 3: JJin91 (81142 in chips)=20
Seat 4: MyManPotnPan (180954 in chips)=20
Seat 5: trucker45599 (160296 in chips)=20
Seat 6: Chark626 (88238 in chips)=20
Seat 7: SAMCRO_1120 (132005 in chips)=20
Seat 8: moosedeer17 (94325 in chips)=20
Seat 9: namesor362 (43850 in chips)=20
Labba609: posts the ante 625
pepstargar: posts the ante 625
JJin91: posts the ante 625
MyManPotnPan: posts the ante 625
trucker45599: posts the ante 625
Chark626: posts the ante 625
SAMCRO_1120: posts the ante 625
moosedeer17: posts the ante 625
namesor362: posts the ante 625
namesor362: posts small blind 2500
Labba609: posts big blind 5000
*** HOLE CARDS ***
Dealt to JJin91 [Ts Qc]
pepstargar: folds=20
JJin91: folds=20
MyManPotnPan: folds=20
trucker45599: folds=20
Chark626: folds=20
SAMCRO_1120: folds=20
moosedeer17: folds=20
namesor362: folds=20
Uncalled bet (2500) returned to Labba609
Labba609 collected 10625 from pot
Labba609: doesn't show hand=20
*** SUMMARY ***
Total pot 10625 | Rake 0=20
Seat 1: Labba609 (big blind) collected (10625)
Seat 2: pepstargar folded before Flop (didn't bet)
Seat 3: JJin91 folded before Flop (didn't bet)
Seat 4: MyManPotnPan folded before Flop (didn't bet)
Seat 5: trucker45599 folded before Flop (didn't bet)
Seat 6: Chark626 folded before Flop (didn't bet)
Seat 7: SAMCRO_1120 folded before Flop (didn't bet)
Seat 8: moosedeer17 (button) folded before Flop (didn't bet)
Seat 9: namesor362 (small blind) folded before Flop


*********** # 169 **************
PokerStars Hand #169323129351: Tournament #1597683884, $18.20+$1.80 USD=
 Hold'em No Limit - Level XXIII (2500/5000) - 2017/05/02 23:08:36 ET
Table '1597683884 5' 9-max Seat #9 is the button
Seat 1: Labba609 (152616 in chips)=20
Seat 2: pepstargar (163449 in chips)=20
Seat 3: JJin91 (80517 in chips)=20
Seat 4: MyManPotnPan (180329 in chips)=20
Seat 5: trucker45599 (159671 in chips)=20
Seat 6: Chark626 (87613 in chips)=20
Seat 7: SAMCRO_1120 (131380 in chips)=20
Seat 8: moosedeer17 (93700 in chips)=20
Seat 9: namesor362 (40725 in chips)=20
Labba609: posts the ante 625
pepstargar: posts the ante 625
JJin91: posts the ante 625
MyManPotnPan: posts the ante 625
trucker45599: posts the ante 625
Chark626: posts the ante 625
SAMCRO_1120: posts the ante 625
moosedeer17: posts the ante 625
namesor362: posts the ante 625
Labba609: posts small blind 2500
pepstargar: posts big blind 5000
*** HOLE CARDS ***
Dealt to JJin91 [5d 3c]
JJin91: folds=20
MyManPotnPan: folds=20
trucker45599: folds=20
Chark626: folds=20
SAMCRO_1120: folds=20
moosedeer17: folds=20
namesor362: calls 5000
Labba609: folds=20
pepstargar: checks=20
*** FLOP *** [Ah Jd 4c]
pepstargar: checks=20
namesor362: checks=20
*** TURN *** [Ah Jd 4c] [5c]
pepstargar: checks=20
namesor362: bets 7000
pepstargar: calls 7000
*** RIVER *** [Ah Jd 4c 5c] [Ad]
pepstargar: checks=20
namesor362: bets 28100 and is all-in
pepstargar: folds=20
Uncalled bet (28100) returned to namesor362
namesor362 collected 32125 from pot
namesor362: doesn't show hand=20
*** SUMMARY ***
Total pot 32125 | Rake 0=20
Board [Ah Jd 4c 5c Ad]
Seat 1: Labba609 (small blind) folded before Flop
Seat 2: pepstargar (big blind) folded on the River
Seat 3: JJin91 folded before Flop (didn't bet)
Seat 4: MyManPotnPan folded before Flop (didn't bet)
Seat 5: trucker45599 folded before Flop (didn't bet)
Seat 6: Chark626 folded before Flop (didn't bet)
Seat 7: SAMCRO_1120 folded before Flop (didn't bet)
Seat 8: moosedeer17 folded before Flop (didn't bet)
Seat 9: namesor362 (button) collected (32125)


*********** # 170 **************
PokerStars Hand #169323129772: Tournament #1597683884, $18.20+$1.80 USD=
 Hold'em No Limit - Level XXIII (2500/5000) - 2017/05/02 23:10:02 ET
Table '1597683884 5' 9-max Seat #1 is the button
Seat 1: Labba609 (149491 in chips)=20
Seat 2: pepstargar (150824 in chips)=20
Seat 3: JJin91 (79892 in chips)=20
Seat 4: MyManPotnPan (179704 in chips)=20
Seat 5: trucker45599 (159046 in chips)=20
Seat 6: Chark626 (86988 in chips)=20
Seat 7: SAMCRO_1120 (130755 in chips)=20
Seat 8: moosedeer17 (93075 in chips)=20
Seat 9: namesor362 (60225 in chips)=20
Labba609: posts the ante 625
pepstargar: posts the ante 625
JJin91: posts the ante 625
MyManPotnPan: posts the ante 625
trucker45599: posts the ante 625
Chark626: posts the ante 625
SAMCRO_1120: posts the ante 625
moosedeer17: posts the ante 625
namesor362: posts the ante 625
pepstargar: posts small blind 2500
JJin91: posts big blind 5000
*** HOLE CARDS ***
Dealt to JJin91 [2h Qh]
MyManPotnPan: raises 10000 to 15000
trucker45599: folds=20
Chark626: folds=20
SAMCRO_1120: folds=20
moosedeer17: folds=20
namesor362: raises 44600 to 59600 and is all-in
Labba609: folds=20
pepstargar: folds=20
JJin91: folds=20
MyManPotnPan: calls 44600
*** FLOP *** [5h 6s Jd]
*** TURN *** [5h 6s Jd] [8c]
*** RIVER *** [5h 6s Jd 8c] [Ts]
*** SHOW DOWN ***
MyManPotnPan: shows [Tc Th] (three of a kind, Tens)
namesor362: shows [Qc Qd] (a pair of Queens)
MyManPotnPan collected 132325 from pot
namesor362 finished the tournament in 9th place and received $49.59.
*** SUMMARY ***
Total pot 132325 | Rake 0=20
Board [5h 6s Jd 8c Ts]
Seat 1: Labba609 (button) folded before Flop (didn't bet)
Seat 2: pepstargar (small blind) folded before Flop
Seat 3: JJin91 (big blind) folded before Flop
Seat 4: MyManPotnPan showed [Tc Th] and won (132325) with three of a ki=
nd, Tens
Seat 5: trucker45599 folded before Flop (didn't bet)
Seat 6: Chark626 folded before Flop (didn't bet)
Seat 7: SAMCRO_1120 folded before Flop (didn't bet)
Seat 8: moosedeer17 folded before Flop (didn't bet)
Seat 9: namesor362 showed [Qc Qd] and lost with a pair of Queens


*********** # 171 **************
PokerStars Hand #169323129963: Tournament #1597683884, $18.20+$1.80 USD=
 Hold'em No Limit - Level XXIII (2500/5000) - 2017/05/02 23:10:43 ET
Table '1597683884 5' 9-max Seat #2 is the button
Seat 1: Labba609 (148866 in chips)=20
Seat 2: pepstargar (147699 in chips)=20
Seat 3: JJin91 (74267 in chips)=20
Seat 4: MyManPotnPan (251804 in chips)=20
Seat 5: trucker45599 (158421 in chips)=20
Seat 6: Chark626 (86363 in chips)=20
Seat 7: SAMCRO_1120 (130130 in chips)=20
Seat 8: moosedeer17 (92450 in chips)=20
Labba609: posts the ante 625
pepstargar: posts the ante 625
JJin91: posts the ante 625
MyManPotnPan: posts the ante 625
trucker45599: posts the ante 625
Chark626: posts the ante 625
SAMCRO_1120: posts the ante 625
moosedeer17: posts the ante 625
JJin91: posts small blind 2500
MyManPotnPan: posts big blind 5000
*** HOLE CARDS ***
Dealt to JJin91 [2c 9c]
trucker45599: folds=20
Chark626: folds=20
SAMCRO_1120: raises 10000 to 15000
moosedeer17: folds=20
Labba609: folds=20
pepstargar: calls 15000
JJin91: folds=20
MyManPotnPan: folds=20
*** FLOP *** [Js Jc 9s]
SAMCRO_1120: checks=20
pepstargar: checks=20
*** TURN *** [Js Jc 9s] [5s]
SAMCRO_1120: bets 20000
pepstargar: calls 20000
*** RIVER *** [Js Jc 9s 5s] [8s]
SAMCRO_1120: checks=20
pepstargar: checks=20
*** SHOW DOWN ***
SAMCRO_1120: shows [Qh Ad] (a pair of Jacks)
pepstargar: shows [Qs Qc] (a flush, Queen high)
pepstargar collected 82500 from pot
*** SUMMARY ***
Total pot 82500 | Rake 0=20
Board [Js Jc 9s 5s 8s]
Seat 1: Labba609 folded before Flop (didn't bet)
Seat 2: pepstargar (button) showed [Qs Qc] and won (82500) with a flush=
, Queen high
Seat 3: JJin91 (small blind) folded before Flop
Seat 4: MyManPotnPan (big blind) folded before Flop
Seat 5: trucker45599 folded before Flop (didn't bet)
Seat 6: Chark626 folded before Flop (didn't bet)
Seat 7: SAMCRO_1120 showed [Qh Ad] and lost with a pair of Jacks
Seat 8: moosedeer17 folded before Flop (didn't bet)


*********** # 172 **************
PokerStars Hand #169325433344: Tournament #1597683884, $18.20+$1.80 USD=
 Hold'em No Limit - Level XXIII (2500/5000) - 2017/05/02 23:11:25 ET
Table '1597683884 5' 9-max Seat #3 is the button
Seat 1: Labba609 (148241 in chips)=20
Seat 2: pepstargar (194574 in chips)=20
Seat 3: JJin91 (71142 in chips)=20
Seat 4: MyManPotnPan (246179 in chips)=20
Seat 5: trucker45599 (157796 in chips)=20
Seat 6: Chark626 (85738 in chips)=20
Seat 7: SAMCRO_1120 (94505 in chips)=20
Seat 8: moosedeer17 (91825 in chips)=20
Labba609: posts the ante 625
pepstargar: posts the ante 625
JJin91: posts the ante 625
MyManPotnPan: posts the ante 625
trucker45599: posts the ante 625
Chark626: posts the ante 625
SAMCRO_1120: posts the ante 625
moosedeer17: posts the ante 625
MyManPotnPan: posts small blind 2500
trucker45599: posts big blind 5000
*** HOLE CARDS ***
Dealt to JJin91 [Ad Ks]
Chark626: folds=20
SAMCRO_1120: folds=20
moosedeer17: raises 5000 to 10000
Labba609: folds=20
pepstargar: folds=20
JJin91: raises 60517 to 70517 and is all-in
MyManPotnPan: folds=20
trucker45599: folds=20
moosedeer17: folds=20
Uncalled bet (60517) returned to JJin91
JJin91 collected 32500 from pot
JJin91: doesn't show hand=20
*** SUMMARY ***
Total pot 32500 | Rake 0=20
Seat 1: Labba609 folded before Flop (didn't bet)
Seat 2: pepstargar folded before Flop (didn't bet)
Seat 3: JJin91 (button) collected (32500)
Seat 4: MyManPotnPan (small blind) folded before Flop
Seat 5: trucker45599 (big blind) folded before Flop
Seat 6: Chark626 folded before Flop (didn't bet)
Seat 7: SAMCRO_1120 folded before Flop (didn't bet)
Seat 8: moosedeer17 folded before Flop


*********** # 173 **************
PokerStars Hand #169325433460: Tournament #1597683884, $18.20+$1.80 USD=
 Hold'em No Limit - Level XXIII (2500/5000) - 2017/05/02 23:11:53 ET
Table '1597683884 5' 9-max Seat #4 is the button
Seat 1: Labba609 (147616 in chips)=20
Seat 2: pepstargar (193949 in chips)=20
Seat 3: JJin91 (93017 in chips)=20
Seat 4: MyManPotnPan (243054 in chips)=20
Seat 5: trucker45599 (152171 in chips)=20
Seat 6: Chark626 (85113 in chips)=20
Seat 7: SAMCRO_1120 (93880 in chips)=20
Seat 8: moosedeer17 (81200 in chips)=20
Labba609: posts the ante 625
pepstargar: posts the ante 625
JJin91: posts the ante 625
MyManPotnPan: posts the ante 625
trucker45599: posts the ante 625
Chark626: posts the ante 625
SAMCRO_1120: posts the ante 625
moosedeer17: posts the ante 625
trucker45599: posts small blind 2500
Chark626: posts big blind 5000
*** HOLE CARDS ***
Dealt to JJin91 [3h Jh]
SAMCRO_1120: raises 10000 to 15000
moosedeer17: folds=20
Labba609: folds=20
pepstargar: folds=20
JJin91: folds=20
MyManPotnPan: folds=20
trucker45599: folds=20
Chark626: raises 20000 to 35000
SAMCRO_1120: raises 58255 to 93255 and is all-in
Chark626: calls 49488 and is all-in
Uncalled bet (8767) returned to SAMCRO_1120
*** FLOP *** [5d 3s 8h]
*** TURN *** [5d 3s 8h] [2c]
*** RIVER *** [5d 3s 8h 2c] [Js]
*** SHOW DOWN ***
Chark626: shows [As Ad] (a pair of Aces)
SAMCRO_1120: shows [9d 9h] (a pair of Nines)
Chark626 collected 176476 from pot
SAMCRO_1120 said, "gg"
*** SUMMARY ***
Total pot 176476 | Rake 0=20
Board [5d 3s 8h 2c Js]
Seat 1: Labba609 folded before Flop (didn't bet)
Seat 2: pepstargar folded before Flop (didn't bet)
Seat 3: JJin91 folded before Flop (didn't bet)
Seat 4: MyManPotnPan (button) folded before Flop (didn't bet)
Seat 5: trucker45599 (small blind) folded before Flop
Seat 6: Chark626 (big blind) showed [As Ad] and won (176476) with a pai=
r of Aces
Seat 7: SAMCRO_1120 showed [9d 9h] and lost with a pair of Nines
Seat 8: moosedeer17 folded before Flop (didn't bet)


*********** # 174 **************
PokerStars Hand #169325433622: Tournament #1597683884, $18.20+$1.80 USD=
 Hold'em No Limit - Level XXIII (2500/5000) - 2017/05/02 23:12:34 ET
Table '1597683884 5' 9-max Seat #5 is the button
Seat 1: Labba609 (146991 in chips)=20
Seat 2: pepstargar (193324 in chips)=20
Seat 3: JJin91 (92392 in chips)=20
Seat 4: MyManPotnPan (242429 in chips)=20
Seat 5: trucker45599 (149046 in chips)=20
Seat 6: Chark626 (176476 in chips)=20
Seat 7: SAMCRO_1120 (8767 in chips)=20
Seat 8: moosedeer17 (80575 in chips)=20
Labba609: posts the ante 625
pepstargar: posts the ante 625
JJin91: posts the ante 625
MyManPotnPan: posts the ante 625
trucker45599: posts the ante 625
Chark626: posts the ante 625
SAMCRO_1120: posts the ante 625
moosedeer17: posts the ante 625
Chark626: posts small blind 2500
SAMCRO_1120: posts big blind 5000
*** HOLE CARDS ***
Dealt to JJin91 [Th Tc]
moosedeer17: folds=20
Labba609: folds=20
pepstargar: folds=20
JJin91: raises 7050 to 12050
MyManPotnPan: folds=20
trucker45599: folds=20
Chark626: folds=20
SAMCRO_1120: calls 3142 and is all-in
Uncalled bet (3908) returned to JJin91
*** FLOP *** [Kh 7h Ks]
*** TURN *** [Kh 7h Ks] [4d]
*** RIVER *** [Kh 7h Ks 4d] [Qs]
*** SHOW DOWN ***
SAMCRO_1120: shows [3d 8d] (a pair of Kings)
JJin91: shows [Th Tc] (two pair, Kings and Tens)
JJin91 collected 23784 from pot
SAMCRO_1120 finished the tournament in 8th place and received $59.51.
*** SUMMARY ***
Total pot 23784 | Rake 0=20
Board [Kh 7h Ks 4d Qs]
Seat 1: Labba609 folded before Flop (didn't bet)
Seat 2: pepstargar folded before Flop (didn't bet)
Seat 3: JJin91 showed [Th Tc] and won (23784) with two pair, Kings and =
Tens
Seat 4: MyManPotnPan folded before Flop (didn't bet)
Seat 5: trucker45599 (button) folded before Flop (didn't bet)
Seat 6: Chark626 (small blind) folded before Flop
Seat 7: SAMCRO_1120 (big blind) showed [3d 8d] and lost with a pair of =
Kings
Seat 8: moosedeer17 folded before Flop (didn't bet)


*********** # 175 **************
PokerStars Hand #169325433733: Tournament #1597683884, $18.20+$1.80 USD=
 Hold'em No Limit - Level XXIII (2500/5000) - 2017/05/02 23:13:01 ET
Table '1597683884 5' 9-max Seat #6 is the button
Seat 1: Labba609 (146366 in chips)=20
Seat 2: pepstargar (192699 in chips)=20
Seat 3: JJin91 (107409 in chips)=20
Seat 4: MyManPotnPan (241804 in chips)=20
Seat 5: trucker45599 (148421 in chips)=20
Seat 6: Chark626 (173351 in chips)=20
Seat 8: moosedeer17 (79950 in chips)=20
Labba609: posts the ante 625
pepstargar: posts the ante 625
JJin91: posts the ante 625
MyManPotnPan: posts the ante 625
trucker45599: posts the ante 625
Chark626: posts the ante 625
moosedeer17: posts the ante 625
moosedeer17: posts small blind 2500
Labba609: posts big blind 5000
*** HOLE CARDS ***
Dealt to JJin91 [Qd Qh]
pepstargar: folds=20
JJin91: raises 7050 to 12050
MyManPotnPan: folds=20
trucker45599: folds=20
Chark626: folds=20
moosedeer17: folds=20
Labba609: folds=20
Uncalled bet (7050) returned to JJin91
JJin91 collected 16875 from pot
JJin91: doesn't show hand=20
*** SUMMARY ***
Total pot 16875 | Rake 0=20
Seat 1: Labba609 (big blind) folded before Flop
Seat 2: pepstargar folded before Flop (didn't bet)
Seat 3: JJin91 collected (16875)
Seat 4: MyManPotnPan folded before Flop (didn't bet)
Seat 5: trucker45599 folded before Flop (didn't bet)
Seat 6: Chark626 (button) folded before Flop (didn't bet)
Seat 8: moosedeer17 (small blind) folded before Flop


*********** # 176 **************
PokerStars Hand #169325433867: Tournament #1597683884, $18.20+$1.80 USD=
 Hold'em No Limit - Level XXIII (2500/5000) - 2017/05/02 23:13:32 ET
Table '1597683884 5' 9-max Seat #8 is the button
Seat 1: Labba609 (140741 in chips)=20
Seat 2: pepstargar (192074 in chips)=20
Seat 3: JJin91 (118659 in chips)=20
Seat 4: MyManPotnPan (241179 in chips)=20
Seat 5: trucker45599 (147796 in chips)=20
Seat 6: Chark626 (172726 in chips)=20
Seat 8: moosedeer17 (76825 in chips)=20
Labba609: posts the ante 625
pepstargar: posts the ante 625
JJin91: posts the ante 625
MyManPotnPan: posts the ante 625
trucker45599: posts the ante 625
Chark626: posts the ante 625
moosedeer17: posts the ante 625
Labba609: posts small blind 2500
pepstargar: posts big blind 5000
*** HOLE CARDS ***
Dealt to JJin91 [2d 8c]
JJin91: folds=20
MyManPotnPan: folds=20
trucker45599: raises 5000 to 10000
Chark626: folds=20
moosedeer17: folds=20
Labba609: folds=20
pepstargar: calls 5000
*** FLOP *** [3h Jc 7s]
pepstargar: checks=20
trucker45599: bets 15000
pepstargar: folds=20
Uncalled bet (15000) returned to trucker45599
trucker45599 collected 26875 from pot
trucker45599: doesn't show hand=20
*** SUMMARY ***
Total pot 26875 | Rake 0=20
Board [3h Jc 7s]
Seat 1: Labba609 (small blind) folded before Flop
Seat 2: pepstargar (big blind) folded on the Flop
Seat 3: JJin91 folded before Flop (didn't bet)
Seat 4: MyManPotnPan folded before Flop (didn't bet)
Seat 5: trucker45599 collected (26875)
Seat 6: Chark626 folded before Flop (didn't bet)
Seat 8: moosedeer17 (button) folded before Flop (didn't bet)


*********** # 177 **************
PokerStars Hand #169325434079: Tournament #1597683884, $18.20+$1.80 USD=
 Hold'em No Limit - Level XXIV (3000/6000) - 2017/05/02 23:14:22 ET
Table '1597683884 5' 9-max Seat #1 is the button
Seat 1: Labba609 (137616 in chips)=20
Seat 2: pepstargar (181449 in chips)=20
Seat 3: JJin91 (118034 in chips)=20
Seat 4: MyManPotnPan (240554 in chips)=20
Seat 5: trucker45599 (164046 in chips)=20
Seat 6: Chark626 (172101 in chips)=20
Seat 8: moosedeer17 (76200 in chips)=20
Labba609: posts the ante 750
pepstargar: posts the ante 750
JJin91: posts the ante 750
MyManPotnPan: posts the ante 750
trucker45599: posts the ante 750
Chark626: posts the ante 750
moosedeer17: posts the ante 750
pepstargar: posts small blind 3000
JJin91: posts big blind 6000
*** HOLE CARDS ***
Dealt to JJin91 [Th Qs]
MyManPotnPan: raises 12000 to 18000
trucker45599: folds=20
Chark626: folds=20
moosedeer17: folds=20
Labba609: folds=20
pepstargar: folds=20
JJin91: folds=20
Uncalled bet (12000) returned to MyManPotnPan
MyManPotnPan collected 20250 from pot
MyManPotnPan: doesn't show hand=20
*** SUMMARY ***
Total pot 20250 | Rake 0=20
Seat 1: Labba609 (button) folded before Flop (didn't bet)
Seat 2: pepstargar (small blind) folded before Flop
Seat 3: JJin91 (big blind) folded before Flop
Seat 4: MyManPotnPan collected (20250)
Seat 5: trucker45599 folded before Flop (didn't bet)
Seat 6: Chark626 folded before Flop (didn't bet)
Seat 8: moosedeer17 folded before Flop (didn't bet)


*********** # 178 **************
PokerStars Hand #169325434168: Tournament #1597683884, $18.20+$1.80 USD=
 Hold'em No Limit - Level XXIV (3000/6000) - 2017/05/02 23:14:44 ET
Table '1597683884 5' 9-max Seat #2 is the button
Seat 1: Labba609 (136866 in chips)=20
Seat 2: pepstargar (177699 in chips)=20
Seat 3: JJin91 (111284 in chips)=20
Seat 4: MyManPotnPan (254054 in chips)=20
Seat 5: trucker45599 (163296 in chips)=20
Seat 6: Chark626 (171351 in chips)=20
Seat 8: moosedeer17 (75450 in chips)=20
Labba609: posts the ante 750
pepstargar: posts the ante 750
JJin91: posts the ante 750
MyManPotnPan: posts the ante 750
trucker45599: posts the ante 750
Chark626: posts the ante 750
moosedeer17: posts the ante 750
JJin91: posts small blind 3000
MyManPotnPan: posts big blind 6000
*** HOLE CARDS ***
Dealt to JJin91 [Jd Ah]
trucker45599: raises 6000 to 12000
Chark626: folds=20
moosedeer17: raises 62700 to 74700 and is all-in
Labba609: folds=20
pepstargar: folds=20
JJin91: folds=20
MyManPotnPan: folds=20
trucker45599: folds=20
Uncalled bet (62700) returned to moosedeer17
moosedeer17 collected 38250 from pot
moosedeer17: doesn't show hand=20
*** SUMMARY ***
Total pot 38250 | Rake 0=20
Seat 1: Labba609 folded before Flop (didn't bet)
Seat 2: pepstargar (button) folded before Flop (didn't bet)
Seat 3: JJin91 (small blind) folded before Flop
Seat 4: MyManPotnPan (big blind) folded before Flop
Seat 5: trucker45599 folded before Flop
Seat 6: Chark626 folded before Flop (didn't bet)
Seat 8: moosedeer17 collected (38250)


*********** # 179 **************
PokerStars Hand #169325434513: Tournament #1597683884, $18.20+$1.80 USD=
 Hold'em No Limit - Level XXIV (3000/6000) - 2017/05/02 23:16:07 ET
Table '1597683884 5' 9-max Seat #3 is the button
Seat 1: Labba609 (136116 in chips)=20
Seat 2: pepstargar (176949 in chips)=20
Seat 3: JJin91 (107534 in chips)=20
Seat 4: MyManPotnPan (247304 in chips)=20
Seat 5: trucker45599 (150546 in chips)=20
Seat 6: Chark626 (170601 in chips)=20
Seat 8: moosedeer17 (100950 in chips)=20
Labba609: posts the ante 750
pepstargar: posts the ante 750
JJin91: posts the ante 750
MyManPotnPan: posts the ante 750
trucker45599: posts the ante 750
Chark626: posts the ante 750
moosedeer17: posts the ante 750
MyManPotnPan: posts small blind 3000
trucker45599: posts big blind 6000
*** HOLE CARDS ***
Dealt to JJin91 [4c 7h]
Chark626: folds=20
moosedeer17: folds=20
Labba609: folds=20
pepstargar: raises 6000 to 12000
JJin91: folds=20
MyManPotnPan: folds=20
trucker45599: calls 6000
*** FLOP *** [9d 8c Tc]
trucker45599: checks=20
pepstargar: checks=20
*** TURN *** [9d 8c Tc] [Qs]
trucker45599: bets 18000
pepstargar: folds=20
Uncalled bet (18000) returned to trucker45599
trucker45599 collected 32250 from pot
trucker45599: doesn't show hand=20
*** SUMMARY ***
Total pot 32250 | Rake 0=20
Board [9d 8c Tc Qs]
Seat 1: Labba609 folded before Flop (didn't bet)
Seat 2: pepstargar folded on the Turn
Seat 3: JJin91 (button) folded before Flop (didn't bet)
Seat 4: MyManPotnPan (small blind) folded before Flop
Seat 5: trucker45599 (big blind) collected (32250)
Seat 6: Chark626 folded before Flop (didn't bet)
Seat 8: moosedeer17 folded before Flop (didn't bet)


*********** # 180 **************
PokerStars Hand #169325434774: Tournament #1597683884, $18.20+$1.80 USD=
 Hold'em No Limit - Level XXIV (3000/6000) - 2017/05/02 23:17:06 ET
Table '1597683884 5' 9-max Seat #4 is the button
Seat 1: Labba609 (135366 in chips)=20
Seat 2: pepstargar (164199 in chips)=20
Seat 3: JJin91 (106784 in chips)=20
Seat 4: MyManPotnPan (243554 in chips)=20
Seat 5: trucker45599 (170046 in chips)=20
Seat 6: Chark626 (169851 in chips)=20
Seat 8: moosedeer17 (100200 in chips)=20
Labba609: posts the ante 750
pepstargar: posts the ante 750
JJin91: posts the ante 750
MyManPotnPan: posts the ante 750
trucker45599: posts the ante 750
Chark626: posts the ante 750
moosedeer17: posts the ante 750
trucker45599: posts small blind 3000
Chark626: posts big blind 6000
*** HOLE CARDS ***
Dealt to JJin91 [2s 7d]
moosedeer17: folds=20
Labba609: folds=20
pepstargar: folds=20
JJin91: folds=20
MyManPotnPan: folds=20
trucker45599: calls 3000
Chark626: checks=20
*** FLOP *** [7c 2h 8c]
trucker45599: checks=20
Chark626: checks=20
*** TURN *** [7c 2h 8c] [4d]
trucker45599: bets 12000
Chark626: folds=20
Uncalled bet (12000) returned to trucker45599
trucker45599 collected 17250 from pot
trucker45599: doesn't show hand=20
*** SUMMARY ***
Total pot 17250 | Rake 0=20
Board [7c 2h 8c 4d]
Seat 1: Labba609 folded before Flop (didn't bet)
Seat 2: pepstargar folded before Flop (didn't bet)
Seat 3: JJin91 folded before Flop (didn't bet)
Seat 4: MyManPotnPan (button) folded before Flop (didn't bet)
Seat 5: trucker45599 (small blind) collected (17250)
Seat 6: Chark626 (big blind) folded on the Turn
Seat 8: moosedeer17 folded before Flop (didn't bet)


*********** # 181 **************
PokerStars Hand #169325435036: Tournament #1597683884, $18.20+$1.80 USD=
 Hold'em No Limit - Level XXIV (3000/6000) - 2017/05/02 23:18:04 ET
Table '1597683884 5' 9-max Seat #5 is the button
Seat 1: Labba609 (134616 in chips)=20
Seat 2: pepstargar (163449 in chips)=20
Seat 3: JJin91 (106034 in chips)=20
Seat 4: MyManPotnPan (242804 in chips)=20
Seat 5: trucker45599 (180546 in chips)=20
Seat 6: Chark626 (163101 in chips)=20
Seat 8: moosedeer17 (99450 in chips)=20
Labba609: posts the ante 750
pepstargar: posts the ante 750
JJin91: posts the ante 750
MyManPotnPan: posts the ante 750
trucker45599: posts the ante 750
Chark626: posts the ante 750
moosedeer17: posts the ante 750
Chark626: posts small blind 3000
moosedeer17: posts big blind 6000
*** HOLE CARDS ***
Dealt to JJin91 [Qc 8d]
Labba609: folds=20
pepstargar: folds=20
JJin91: folds=20
MyManPotnPan: folds=20
trucker45599: raises 6000 to 12000
Chark626: calls 9000
moosedeer17: folds=20
*** FLOP *** [2s 6c 5s]
Chark626: checks=20
trucker45599: bets 12000
Chark626: folds=20
Uncalled bet (12000) returned to trucker45599
trucker45599 collected 35250 from pot
trucker45599: doesn't show hand=20
*** SUMMARY ***
Total pot 35250 | Rake 0=20
Board [2s 6c 5s]
Seat 1: Labba609 folded before Flop (didn't bet)
Seat 2: pepstargar folded before Flop (didn't bet)
Seat 3: JJin91 folded before Flop (didn't bet)
Seat 4: MyManPotnPan folded before Flop (didn't bet)
Seat 5: trucker45599 (button) collected (35250)
Seat 6: Chark626 (small blind) folded on the Flop
Seat 8: moosedeer17 (big blind) folded before Flop


*********** # 182 **************
PokerStars Hand #169325435258: Tournament #1597683884, $18.20+$1.80 USD=
 Hold'em No Limit - Level XXIV (3000/6000) - 2017/05/02 23:18:51 ET
Table '1597683884 5' 9-max Seat #6 is the button
Seat 1: Labba609 (133866 in chips)=20
Seat 2: pepstargar (162699 in chips)=20
Seat 3: JJin91 (105284 in chips)=20
Seat 4: MyManPotnPan (242054 in chips)=20
Seat 5: trucker45599 (203046 in chips)=20
Seat 6: Chark626 (150351 in chips)=20
Seat 8: moosedeer17 (92700 in chips)=20
Labba609: posts the ante 750
pepstargar: posts the ante 750
JJin91: posts the ante 750
MyManPotnPan: posts the ante 750
trucker45599: posts the ante 750
Chark626: posts the ante 750
moosedeer17: posts the ante 750
moosedeer17: posts small blind 3000
Labba609: posts big blind 6000
*** HOLE CARDS ***
Dealt to JJin91 [9c Qc]
pepstargar: folds=20
JJin91: raises 8460 to 14460
MyManPotnPan: folds=20
trucker45599: folds=20
Chark626: folds=20
moosedeer17: folds=20
Labba609: folds=20
Uncalled bet (8460) returned to JJin91
JJin91 collected 20250 from pot
JJin91: doesn't show hand=20
*** SUMMARY ***
Total pot 20250 | Rake 0=20
Seat 1: Labba609 (big blind) folded before Flop
Seat 2: pepstargar folded before Flop (didn't bet)
Seat 3: JJin91 collected (20250)
Seat 4: MyManPotnPan folded before Flop (didn't bet)
Seat 5: trucker45599 folded before Flop (didn't bet)
Seat 6: Chark626 (button) folded before Flop (didn't bet)
Seat 8: moosedeer17 (small blind) folded before Flop


*********** # 183 **************
PokerStars Hand #169325435405: Tournament #1597683884, $18.20+$1.80 USD=
 Hold'em No Limit - Level XXIV (3000/6000) - 2017/05/02 23:19:19 ET
Table '1597683884 5' 9-max Seat #8 is the button
Seat 1: Labba609 (127116 in chips)=20
Seat 2: pepstargar (161949 in chips)=20
Seat 3: JJin91 (118784 in chips)=20
Seat 4: MyManPotnPan (241304 in chips)=20
Seat 5: trucker45599 (202296 in chips)=20
Seat 6: Chark626 (149601 in chips)=20
Seat 8: moosedeer17 (88950 in chips)=20
Labba609: posts the ante 750
pepstargar: posts the ante 750
JJin91: posts the ante 750
MyManPotnPan: posts the ante 750
trucker45599: posts the ante 750
Chark626: posts the ante 750
moosedeer17: posts the ante 750
Labba609: posts small blind 3000
pepstargar: posts big blind 6000
*** HOLE CARDS ***
Dealt to JJin91 [Ts 4d]
JJin91: folds=20
MyManPotnPan: calls 6000
trucker45599: folds=20
Chark626: folds=20
moosedeer17: folds=20
Labba609: folds=20
pepstargar: checks=20
*** FLOP *** [Qc Qh 2h]
pepstargar: checks=20
MyManPotnPan: bets 10125
pepstargar: folds=20
Uncalled bet (10125) returned to MyManPotnPan
MyManPotnPan collected 20250 from pot
MyManPotnPan: doesn't show hand=20
*** SUMMARY ***
Total pot 20250 | Rake 0=20
Board [Qc Qh 2h]
Seat 1: Labba609 (small blind) folded before Flop
Seat 2: pepstargar (big blind) folded on the Flop
Seat 3: JJin91 folded before Flop (didn't bet)
Seat 4: MyManPotnPan collected (20250)
Seat 5: trucker45599 folded before Flop (didn't bet)
Seat 6: Chark626 folded before Flop (didn't bet)
Seat 8: moosedeer17 (button) folded before Flop (didn't bet)


*********** # 184 **************
PokerStars Hand #169325435532: Tournament #1597683884, $18.20+$1.80 USD=
 Hold'em No Limit - Level XXIV (3000/6000) - 2017/05/02 23:19:48 ET
Table '1597683884 5' 9-max Seat #1 is the button
Seat 1: Labba609 (123366 in chips)=20
Seat 2: pepstargar (155199 in chips)=20
Seat 3: JJin91 (118034 in chips)=20
Seat 4: MyManPotnPan (254804 in chips)=20
Seat 5: trucker45599 (201546 in chips)=20
Seat 6: Chark626 (148851 in chips)=20
Seat 8: moosedeer17 (88200 in chips)=20
Labba609: posts the ante 750
pepstargar: posts the ante 750
JJin91: posts the ante 750
MyManPotnPan: posts the ante 750
trucker45599: posts the ante 750
Chark626: posts the ante 750
moosedeer17: posts the ante 750
pepstargar: posts small blind 3000
JJin91: posts big blind 6000
*** HOLE CARDS ***
Dealt to JJin91 [9h Ad]
MyManPotnPan: folds=20
trucker45599: folds=20
Chark626: folds=20
moosedeer17: folds=20
Labba609: raises 9000 to 15000
pepstargar: folds=20
JJin91: folds=20
Uncalled bet (9000) returned to Labba609
Labba609 collected 20250 from pot
Labba609: doesn't show hand=20
*** SUMMARY ***
Total pot 20250 | Rake 0=20
Seat 1: Labba609 (button) collected (20250)
Seat 2: pepstargar (small blind) folded before Flop
Seat 3: JJin91 (big blind) folded before Flop
Seat 4: MyManPotnPan folded before Flop (didn't bet)
Seat 5: trucker45599 folded before Flop (didn't bet)
Seat 6: Chark626 folded before Flop (didn't bet)
Seat 8: moosedeer17 folded before Flop (didn't bet)


*********** # 185 **************
PokerStars Hand #169325435667: Tournament #1597683884, $18.20+$1.80 USD=
 Hold'em No Limit - Level XXIV (3000/6000) - 2017/05/02 23:20:20 ET
Table '1597683884 5' 9-max Seat #2 is the button
Seat 1: Labba609 (136866 in chips)=20
Seat 2: pepstargar (151449 in chips)=20
Seat 3: JJin91 (111284 in chips)=20
Seat 4: MyManPotnPan (254054 in chips)=20
Seat 5: trucker45599 (200796 in chips)=20
Seat 6: Chark626 (148101 in chips)=20
Seat 8: moosedeer17 (87450 in chips)=20
Labba609: posts the ante 750
pepstargar: posts the ante 750
JJin91: posts the ante 750
MyManPotnPan: posts the ante 750
trucker45599: posts the ante 750
Chark626: posts the ante 750
moosedeer17: posts the ante 750
JJin91: posts small blind 3000
MyManPotnPan: posts big blind 6000
*** HOLE CARDS ***
Dealt to JJin91 [Ts 9h]
trucker45599: raises 6000 to 12000
Chark626: calls 12000
moosedeer17: folds=20
Labba609: folds=20
pepstargar: folds=20
JJin91: folds=20
MyManPotnPan: calls 6000
*** FLOP *** [Qc Ac 3d]
MyManPotnPan: checks=20
trucker45599: bets 24000
Chark626: folds=20
MyManPotnPan: folds=20
Uncalled bet (24000) returned to trucker45599
trucker45599 collected 44250 from pot
trucker45599: doesn't show hand=20
*** SUMMARY ***
Total pot 44250 | Rake 0=20
Board [Qc Ac 3d]
Seat 1: Labba609 folded before Flop (didn't bet)
Seat 2: pepstargar (button) folded before Flop (didn't bet)
Seat 3: JJin91 (small blind) folded before Flop
Seat 4: MyManPotnPan (big blind) folded on the Flop
Seat 5: trucker45599 collected (44250)
Seat 6: Chark626 folded on the Flop
Seat 8: moosedeer17 folded before Flop (didn't bet)


*********** # 186 **************
PokerStars Hand #169325435882: Tournament #1597683884, $18.20+$1.80 USD=
 Hold'em No Limit - Level XXIV (3000/6000) - 2017/05/02 23:21:06 ET
Table '1597683884 5' 9-max Seat #3 is the button
Seat 1: Labba609 (136116 in chips)=20
Seat 2: pepstargar (150699 in chips)=20
Seat 3: JJin91 (107534 in chips)=20
Seat 4: MyManPotnPan (241304 in chips)=20
Seat 5: trucker45599 (232296 in chips)=20
Seat 6: Chark626 (135351 in chips)=20
Seat 8: moosedeer17 (86700 in chips)=20
Labba609: posts the ante 750
pepstargar: posts the ante 750
JJin91: posts the ante 750
MyManPotnPan: posts the ante 750
trucker45599: posts the ante 750
Chark626: posts the ante 750
moosedeer17: posts the ante 750
MyManPotnPan: posts small blind 3000
trucker45599: posts big blind 6000
*** HOLE CARDS ***
Dealt to JJin91 [Tc 3h]
Chark626: raises 12000 to 18000
moosedeer17: folds=20
Labba609: folds=20
pepstargar: folds=20
JJin91: folds=20
MyManPotnPan: folds=20
trucker45599: folds=20
Uncalled bet (12000) returned to Chark626
Chark626 collected 20250 from pot
Chark626: doesn't show hand=20
*** SUMMARY ***
Total pot 20250 | Rake 0=20
Seat 1: Labba609 folded before Flop (didn't bet)
Seat 2: pepstargar folded before Flop (didn't bet)
Seat 3: JJin91 (button) folded before Flop (didn't bet)
Seat 4: MyManPotnPan (small blind) folded before Flop
Seat 5: trucker45599 (big blind) folded before Flop
Seat 6: Chark626 collected (20250)
Seat 8: moosedeer17 folded before Flop (didn't bet)


*********** # 187 **************
PokerStars Hand #169325436027: Tournament #1597683884, $18.20+$1.80 USD=
 Hold'em No Limit - Level XXIV (3000/6000) - 2017/05/02 23:21:39 ET
Table '1597683884 5' 9-max Seat #4 is the button
Seat 1: Labba609 (135366 in chips)=20
Seat 2: pepstargar (149949 in chips)=20
Seat 3: JJin91 (106784 in chips)=20
Seat 4: MyManPotnPan (237554 in chips)=20
Seat 5: trucker45599 (225546 in chips)=20
Seat 6: Chark626 (148851 in chips)=20
Seat 8: moosedeer17 (85950 in chips)=20
Labba609: posts the ante 750
pepstargar: posts the ante 750
JJin91: posts the ante 750
MyManPotnPan: posts the ante 750
trucker45599: posts the ante 750
Chark626: posts the ante 750
moosedeer17: posts the ante 750
trucker45599: posts small blind 3000
Chark626: posts big blind 6000
*** HOLE CARDS ***
Dealt to JJin91 [7h 2h]
moosedeer17: raises 79200 to 85200 and is all-in
Labba609: folds=20
pepstargar: folds=20
JJin91: folds=20
MyManPotnPan: folds=20
trucker45599: folds=20
Chark626: folds=20
Uncalled bet (79200) returned to moosedeer17
moosedeer17 collected 20250 from pot
moosedeer17: doesn't show hand=20
*** SUMMARY ***
Total pot 20250 | Rake 0=20
Seat 1: Labba609 folded before Flop (didn't bet)
Seat 2: pepstargar folded before Flop (didn't bet)
Seat 3: JJin91 folded before Flop (didn't bet)
Seat 4: MyManPotnPan (button) folded before Flop (didn't bet)
Seat 5: trucker45599 (small blind) folded before Flop
Seat 6: Chark626 (big blind) folded before Flop
Seat 8: moosedeer17 collected (20250)


*********** # 188 **************
PokerStars Hand #169325436215: Tournament #1597683884, $18.20+$1.80 USD=
 Hold'em No Limit - Level XXIV (3000/6000) - 2017/05/02 23:22:22 ET
Table '1597683884 5' 9-max Seat #5 is the button
Seat 1: Labba609 (134616 in chips)=20
Seat 2: pepstargar (149199 in chips)=20
Seat 3: JJin91 (106034 in chips)=20
Seat 4: MyManPotnPan (236804 in chips)=20
Seat 5: trucker45599 (221796 in chips)=20
Seat 6: Chark626 (142101 in chips)=20
Seat 8: moosedeer17 (99450 in chips)=20
Labba609: posts the ante 750
pepstargar: posts the ante 750
JJin91: posts the ante 750
MyManPotnPan: posts the ante 750
trucker45599: posts the ante 750
Chark626: posts the ante 750
moosedeer17: posts the ante 750
Chark626: posts small blind 3000
moosedeer17: posts big blind 6000
*** HOLE CARDS ***
Dealt to JJin91 [Jc Td]
Labba609: folds=20
pepstargar: folds=20
JJin91: folds=20
MyManPotnPan: folds=20
trucker45599: folds=20
Chark626: calls 3000
moosedeer17: raises 92700 to 98700 and is all-in
Chark626: folds=20
Uncalled bet (92700) returned to moosedeer17
moosedeer17 collected 17250 from pot
moosedeer17: doesn't show hand=20
*** SUMMARY ***
Total pot 17250 | Rake 0=20
Seat 1: Labba609 folded before Flop (didn't bet)
Seat 2: pepstargar folded before Flop (didn't bet)
Seat 3: JJin91 folded before Flop (didn't bet)
Seat 4: MyManPotnPan folded before Flop (didn't bet)
Seat 5: trucker45599 (button) folded before Flop (didn't bet)
Seat 6: Chark626 (small blind) folded before Flop
Seat 8: moosedeer17 (big blind) collected (17250)


*********** # 189 **************
PokerStars Hand #169325436330: Tournament #1597683884, $18.20+$1.80 USD=
 Hold'em No Limit - Level XXIV (3000/6000) - 2017/05/02 23:22:47 ET
Table '1597683884 5' 9-max Seat #6 is the button
Seat 1: Labba609 (133866 in chips)=20
Seat 2: pepstargar (148449 in chips)=20
Seat 3: JJin91 (105284 in chips)=20
Seat 4: MyManPotnPan (236054 in chips)=20
Seat 5: trucker45599 (221046 in chips)=20
Seat 6: Chark626 (135351 in chips)=20
Seat 8: moosedeer17 (109950 in chips)=20
Labba609: posts the ante 750
pepstargar: posts the ante 750
JJin91: posts the ante 750
MyManPotnPan: posts the ante 750
trucker45599: posts the ante 750
Chark626: posts the ante 750
moosedeer17: posts the ante 750
moosedeer17: posts small blind 3000
Labba609: posts big blind 6000
*** HOLE CARDS ***
Dealt to JJin91 [Qs 3h]
pepstargar: folds=20
JJin91: folds=20
MyManPotnPan: calls 6000
trucker45599: folds=20
Chark626: folds=20
moosedeer17: folds=20
Labba609: checks=20
*** FLOP *** [As 9c Qd]
Labba609: checks=20
MyManPotnPan: bets 10125
Labba609: folds=20
Uncalled bet (10125) returned to MyManPotnPan
MyManPotnPan collected 20250 from pot
MyManPotnPan: doesn't show hand=20
*** SUMMARY ***
Total pot 20250 | Rake 0=20
Board [As 9c Qd]
Seat 1: Labba609 (big blind) folded on the Flop
Seat 2: pepstargar folded before Flop (didn't bet)
Seat 3: JJin91 folded before Flop (didn't bet)
Seat 4: MyManPotnPan collected (20250)
Seat 5: trucker45599 folded before Flop (didn't bet)
Seat 6: Chark626 (button) folded before Flop (didn't bet)
Seat 8: moosedeer17 (small blind) folded before Flop


*********** # 190 **************
PokerStars Hand #169325436607: Tournament #1597683884, $18.20+$1.80 USD=
 Hold'em No Limit - Level XXIV (3000/6000) - 2017/05/02 23:23:48 ET
Table '1597683884 5' 9-max Seat #8 is the button
Seat 1: Labba609 (127116 in chips)=20
Seat 2: pepstargar (147699 in chips)=20
Seat 3: JJin91 (104534 in chips)=20
Seat 4: MyManPotnPan (249554 in chips)=20
Seat 5: trucker45599 (220296 in chips)=20
Seat 6: Chark626 (134601 in chips)=20
Seat 8: moosedeer17 (106200 in chips)=20
Labba609: posts the ante 750
pepstargar: posts the ante 750
JJin91: posts the ante 750
MyManPotnPan: posts the ante 750
trucker45599: posts the ante 750
Chark626: posts the ante 750
moosedeer17: posts the ante 750
Labba609: posts small blind 3000
pepstargar: posts big blind 6000
*** HOLE CARDS ***
Dealt to JJin91 [Qs Jc]
JJin91: raises 8460 to 14460
MyManPotnPan: folds=20
trucker45599: folds=20
Chark626: folds=20
moosedeer17: folds=20
Labba609: folds=20
pepstargar: folds=20
Uncalled bet (8460) returned to JJin91
JJin91 collected 20250 from pot
JJin91: doesn't show hand=20
*** SUMMARY ***
Total pot 20250 | Rake 0=20
Seat 1: Labba609 (small blind) folded before Flop
Seat 2: pepstargar (big blind) folded before Flop
Seat 3: JJin91 collected (20250)
Seat 4: MyManPotnPan folded before Flop (didn't bet)
Seat 5: trucker45599 folded before Flop (didn't bet)
Seat 6: Chark626 folded before Flop (didn't bet)
Seat 8: moosedeer17 (button) folded before Flop (didn't bet)


*********** # 191 **************
PokerStars Hand #169325436754: Tournament #1597683884, $18.20+$1.80 USD=
 Hold'em No Limit - Level XXV (3500/7000) - 2017/05/02 23:24:23 ET
Table '1597683884 5' 9-max Seat #1 is the button
Seat 1: Labba609 (123366 in chips)=20
Seat 2: pepstargar (140949 in chips)=20
Seat 3: JJin91 (118034 in chips)=20
Seat 4: MyManPotnPan (248804 in chips)=20
Seat 5: trucker45599 (219546 in chips)=20
Seat 6: Chark626 (133851 in chips)=20
Seat 8: moosedeer17 (105450 in chips)=20
Labba609: posts the ante 875
pepstargar: posts the ante 875
JJin91: posts the ante 875
MyManPotnPan: posts the ante 875
trucker45599: posts the ante 875
Chark626: posts the ante 875
moosedeer17: posts the ante 875
pepstargar: posts small blind 3500
JJin91: posts big blind 7000
*** HOLE CARDS ***
Dealt to JJin91 [3h Ac]
MyManPotnPan: folds=20
trucker45599: folds=20
Chark626: folds=20
moosedeer17: folds=20
Labba609: folds=20
pepstargar: calls 3500
JJin91: checks=20
*** FLOP *** [Ts Kd Td]
pepstargar: checks=20
JJin91: bets 10666
pepstargar: calls 10666
*** TURN *** [Ts Kd Td] [Js]
pepstargar: checks=20
JJin91: bets 7000
pepstargar: calls 7000
*** RIVER *** [Ts Kd Td Js] [Jd]
pepstargar: checks=20
JJin91: checks=20
*** SHOW DOWN ***
pepstargar: shows [Ad 6d] (a flush, Ace high)
JJin91: mucks hand=20
pepstargar collected 55457 from pot
*** SUMMARY ***
Total pot 55457 | Rake 0=20
Board [Ts Kd Td Js Jd]
Seat 1: Labba609 (button) folded before Flop (didn't bet)
Seat 2: pepstargar (small blind) showed [Ad 6d] and won (55457) with a =
flush, Ace high
Seat 3: JJin91 (big blind) mucked [3h Ac]
Seat 4: MyManPotnPan folded before Flop (didn't bet)
Seat 5: trucker45599 folded before Flop (didn't bet)
Seat 6: Chark626 folded before Flop (didn't bet)
Seat 8: moosedeer17 folded before Flop (didn't bet)


*********** # 192 **************
PokerStars Hand #169325437029: Tournament #1597683884, $18.20+$1.80 USD=
 Hold'em No Limit - Level XXV (3500/7000) - 2017/05/02 23:25:31 ET
Table '1597683884 5' 9-max Seat #2 is the button
Seat 1: Labba609 (122491 in chips)=20
Seat 2: pepstargar (170865 in chips)=20
Seat 3: JJin91 (92493 in chips)=20
Seat 4: MyManPotnPan (247929 in chips)=20
Seat 5: trucker45599 (218671 in chips)=20
Seat 6: Chark626 (132976 in chips)=20
Seat 8: moosedeer17 (104575 in chips)=20
Labba609: posts the ante 875
pepstargar: posts the ante 875
JJin91: posts the ante 875
MyManPotnPan: posts the ante 875
trucker45599: posts the ante 875
Chark626: posts the ante 875
moosedeer17: posts the ante 875
JJin91: posts small blind 3500
MyManPotnPan: posts big blind 7000
*** HOLE CARDS ***
Dealt to JJin91 [Js Kd]
trucker45599: folds=20
Chark626: raises 14000 to 21000
moosedeer17: folds=20
Labba609: folds=20
pepstargar: folds=20
JJin91: calls 17500
MyManPotnPan: folds=20
*** FLOP *** [Kh 2d 9d]
JJin91: bets 70618 and is all-in
Chark626: calls 70618
*** TURN *** [Kh 2d 9d] [4h]
*** RIVER *** [Kh 2d 9d 4h] [5c]
*** SHOW DOWN ***
JJin91: shows [Js Kd] (a pair of Kings)
Chark626: shows [Ks Qd] (a pair of Kings - Queen kicker)
Chark626 collected 196361 from pot
JJin91 finished the tournament in 7th place and received $79.35.
*** SUMMARY ***
Total pot 196361 | Rake 0=20
Board [Kh 2d 9d 4h 5c]
Seat 1: Labba609 folded before Flop (didn't bet)
Seat 2: pepstargar (button) folded before Flop (didn't bet)
Seat 3: JJin91 (small blind) showed [Js Kd] and lost with a pair of Kin=
gs
Seat 4: MyManPotnPan (big blind) folded before Flop
Seat 5: trucker45599 folded before Flop (didn't bet)
Seat 6: Chark626 showed [Ks Qd] and won (196361) with a pair of Kings
Seat 8: moosedeer17 folded before Flop (didn't bet)



If you have any questions, please contact us at "PokerStars Support" <s=
upport@pokerstarsnj.com>


