Transcript for tournament #1597684008 requested by JJin91 (jamiejin91@g=
mail.com)

*********** # 1 **************
PokerStars Hand #169424997136: Tournament #1597684008, $13.50+$1.50 USD=
 Hold'em No Limit - Level I (25/50) - 2017/05/05 13:33:49 ET
Table '1597684008 2' 6-max Seat #2 is the button
Seat 1: excon tyrone (9836 in chips)=20
Seat 2: mysticbricks (11363 in chips)=20
Seat 3: nfc4ever (9850 in chips)=20
Seat 4: Funkyphill99 (8801 in chips)=20
Seat 5: romogarg (10150 in chips)=20
Seat 6: JJin91 (10000 in chips)=20
nfc4ever: posts small blind 25
Funkyphill99: posts big blind 50
*** HOLE CARDS ***
Dealt to JJin91 [4s 7c]
romogarg: calls 50
JJin91: folds=20
excon tyrone: folds=20
mysticbricks: calls 50
nfc4ever: folds=20
Funkyphill99: raises 250 to 300
romogarg: calls 250
mysticbricks: folds=20
*** FLOP *** [4d Qh Ad]
Funkyphill99: checks=20
romogarg: checks=20
*** TURN *** [4d Qh Ad] [5s]
Funkyphill99: bets 800
romogarg: calls 800
*** RIVER *** [4d Qh Ad 5s] [Tc]
Funkyphill99: bets 1995
romogarg: raises 1995 to 3990
Funkyphill99: folds=20
Uncalled bet (1995) returned to romogarg
romogarg collected 6265 from pot
romogarg: doesn't show hand=20
*** SUMMARY ***
Total pot 6265 | Rake 0=20
Board [4d Qh Ad 5s Tc]
Seat 1: excon tyrone folded before Flop (didn't bet)
Seat 2: mysticbricks (button) folded before Flop
Seat 3: nfc4ever (small blind) folded before Flop
Seat 4: Funkyphill99 (big blind) folded on the River
Seat 5: romogarg collected (6265)
Seat 6: JJin91 folded before Flop (didn't bet)


*********** # 2 **************
PokerStars Hand #169424997347: Tournament #1597684008, $13.50+$1.50 USD=
 Hold'em No Limit - Level I (25/50) - 2017/05/05 13:35:05 ET
Table '1597684008 2' 6-max Seat #3 is the button
Seat 1: excon tyrone (9836 in chips)=20
Seat 2: mysticbricks (11313 in chips)=20
Seat 3: nfc4ever (9825 in chips)=20
Seat 4: Funkyphill99 (5706 in chips)=20
Seat 5: romogarg (13320 in chips)=20
Seat 6: JJin91 (10000 in chips)=20
Funkyphill99: posts small blind 25
romogarg: posts big blind 50
*** HOLE CARDS ***
Dealt to JJin91 [Jc Kh]
JJin91: folds=20
excon tyrone: calls 50
mysticbricks: raises 250 to 300
nfc4ever: folds=20
Funkyphill99: folds=20
romogarg: calls 250
excon tyrone: calls 250
*** FLOP *** [Js 4d 4s]
romogarg: checks=20
excon tyrone: checks=20
mysticbricks: bets 300
romogarg: calls 300
excon tyrone: folds=20
*** TURN *** [Js 4d 4s] [9c]
romogarg: checks=20
mysticbricks: checks=20
*** RIVER *** [Js 4d 4s 9c] [9d]
romogarg: checks=20
mysticbricks: checks=20
*** SHOW DOWN ***
romogarg: shows [8d 8s] (two pair, Nines and Eights)
mysticbricks: shows [Th Ts] (two pair, Tens and Nines)
mysticbricks collected 1525 from pot
*** SUMMARY ***
Total pot 1525 | Rake 0=20
Board [Js 4d 4s 9c 9d]
Seat 1: excon tyrone folded on the Flop
Seat 2: mysticbricks showed [Th Ts] and won (1525) with two pair, Tens =
and Nines
Seat 3: nfc4ever (button) folded before Flop (didn't bet)
Seat 4: Funkyphill99 (small blind) folded before Flop
Seat 5: romogarg (big blind) showed [8d 8s] and lost with two pair, Nin=
es and Eights
Seat 6: JJin91 folded before Flop (didn't bet)


*********** # 3 **************
PokerStars Hand #169424997474: Tournament #1597684008, $13.50+$1.50 USD=
 Hold'em No Limit - Level I (25/50) - 2017/05/05 13:35:53 ET
Table '1597684008 2' 6-max Seat #4 is the button
Seat 1: excon tyrone (9536 in chips)=20
Seat 2: mysticbricks (12238 in chips)=20
Seat 3: nfc4ever (9825 in chips)=20
Seat 4: Funkyphill99 (5681 in chips)=20
Seat 5: romogarg (12720 in chips)=20
Seat 6: JJin91 (10000 in chips)=20
romogarg: posts small blind 25
JJin91: posts big blind 50
*** HOLE CARDS ***
Dealt to JJin91 [Ah 6h]
excon tyrone: calls 50
mysticbricks: folds=20
nfc4ever: folds=20
Funkyphill99: folds=20
romogarg: calls 25
JJin91: checks=20
*** FLOP *** [Kh 6d 4h]
romogarg: checks=20
JJin91: bets 100
excon tyrone: folds=20
romogarg: calls 100
*** TURN *** [Kh 6d 4h] [2c]
romogarg: checks=20
JJin91: checks=20
*** RIVER *** [Kh 6d 4h 2c] [Jd]
romogarg: checks=20
JJin91: bets 150
romogarg: calls 150
*** SHOW DOWN ***
JJin91: shows [Ah 6h] (a pair of Sixes)
romogarg: shows [Kd Qh] (a pair of Kings)
romogarg collected 650 from pot
*** SUMMARY ***
Total pot 650 | Rake 0=20
Board [Kh 6d 4h 2c Jd]
Seat 1: excon tyrone folded on the Flop
Seat 2: mysticbricks folded before Flop (didn't bet)
Seat 3: nfc4ever folded before Flop (didn't bet)
Seat 4: Funkyphill99 (button) folded before Flop (didn't bet)
Seat 5: romogarg (small blind) showed [Kd Qh] and won (650) with a pair=
 of Kings
Seat 6: JJin91 (big blind) showed [Ah 6h] and lost with a pair of Sixes


*********** # 4 **************
PokerStars Hand #169424997606: Tournament #1597684008, $13.50+$1.50 USD=
 Hold'em No Limit - Level I (25/50) - 2017/05/05 13:36:37 ET
Table '1597684008 2' 6-max Seat #5 is the button
Seat 1: excon tyrone (9486 in chips)=20
Seat 2: mysticbricks (12238 in chips)=20
Seat 3: nfc4ever (9825 in chips)=20
Seat 4: Funkyphill99 (5681 in chips)=20
Seat 5: romogarg (13070 in chips)=20
Seat 6: JJin91 (9700 in chips)=20
JJin91: posts small blind 25
excon tyrone: posts big blind 50
*** HOLE CARDS ***
Dealt to JJin91 [Ad 3h]
mysticbricks: folds=20
nfc4ever: folds=20
Funkyphill99: folds=20
romogarg: calls 50
JJin91: calls 25
excon tyrone: checks=20
*** FLOP *** [Qs 2h Jc]
JJin91: checks=20
excon tyrone: bets 50
romogarg: calls 50
JJin91: folds=20
*** TURN *** [Qs 2h Jc] [5h]
excon tyrone: bets 50
romogarg: calls 50
*** RIVER *** [Qs 2h Jc 5h] [6d]
excon tyrone: bets 50
romogarg: folds=20
Uncalled bet (50) returned to excon tyrone
excon tyrone collected 350 from pot
*** SUMMARY ***
Total pot 350 | Rake 0=20
Board [Qs 2h Jc 5h 6d]
Seat 1: excon tyrone (big blind) collected (350)
Seat 2: mysticbricks folded before Flop (didn't bet)
Seat 3: nfc4ever folded before Flop (didn't bet)
Seat 4: Funkyphill99 folded before Flop (didn't bet)
Seat 5: romogarg (button) folded on the River
Seat 6: JJin91 (small blind) folded on the Flop


*********** # 5 **************
PokerStars Hand #169424997709: Tournament #1597684008, $13.50+$1.50 USD=
 Hold'em No Limit - Level I (25/50) - 2017/05/05 13:37:11 ET
Table '1597684008 2' 6-max Seat #6 is the button
Seat 1: excon tyrone (9686 in chips)=20
Seat 2: mysticbricks (12238 in chips)=20
Seat 3: nfc4ever (9825 in chips)=20
Seat 4: Funkyphill99 (5681 in chips)=20
Seat 5: romogarg (12920 in chips)=20
Seat 6: JJin91 (9650 in chips)=20
excon tyrone: posts small blind 25
mysticbricks: posts big blind 50
*** HOLE CARDS ***
Dealt to JJin91 [Th Ad]
nfc4ever: calls 50
Funkyphill99: folds=20
romogarg: calls 50
JJin91: raises 250 to 300
excon tyrone: folds=20
mysticbricks: folds=20
nfc4ever: calls 250
romogarg: calls 250
*** FLOP *** [2h Kh Jh]
nfc4ever: checks=20
romogarg: checks=20
JJin91: bets 650
nfc4ever: folds=20
romogarg: calls 650
*** TURN *** [2h Kh Jh] [Kc]
romogarg: checks=20
JJin91: bets 2300
romogarg: raises 9670 to 11970 and is all-in
JJin91: folds=20
Uncalled bet (9670) returned to romogarg
romogarg collected 6875 from pot
romogarg: doesn't show hand=20
*** SUMMARY ***
Total pot 6875 | Rake 0=20
Board [2h Kh Jh Kc]
Seat 1: excon tyrone (small blind) folded before Flop
Seat 2: mysticbricks (big blind) folded before Flop
Seat 3: nfc4ever folded on the Flop
Seat 4: Funkyphill99 folded before Flop (didn't bet)
Seat 5: romogarg collected (6875)
Seat 6: JJin91 (button) folded on the Turn


*********** # 6 **************
PokerStars Hand #169424997922: Tournament #1597684008, $13.50+$1.50 USD=
 Hold'em No Limit - Level I (25/50) - 2017/05/05 13:38:21 ET
Table '1597684008 2' 6-max Seat #1 is the button
Seat 1: excon tyrone (9661 in chips)=20
Seat 2: mysticbricks (12188 in chips)=20
Seat 3: nfc4ever (9525 in chips)=20
Seat 4: Funkyphill99 (5681 in chips)=20
Seat 5: romogarg (16545 in chips)=20
Seat 6: JJin91 (6400 in chips)=20
mysticbricks: posts small blind 25
nfc4ever: posts big blind 50
*** HOLE CARDS ***
Dealt to JJin91 [Qd 7c]
Funkyphill99: folds=20
romogarg: calls 50
JJin91: folds=20
excon tyrone: calls 50
mysticbricks: calls 25
nfc4ever: raises 9475 to 9525 and is all-in
romogarg: folds=20
excon tyrone: folds=20
mysticbricks: folds=20
Uncalled bet (9475) returned to nfc4ever
nfc4ever collected 200 from pot
nfc4ever: doesn't show hand=20
*** SUMMARY ***
Total pot 200 | Rake 0=20
Seat 1: excon tyrone (button) folded before Flop
Seat 2: mysticbricks (small blind) folded before Flop
Seat 3: nfc4ever (big blind) collected (200)
Seat 4: Funkyphill99 folded before Flop (didn't bet)
Seat 5: romogarg folded before Flop
Seat 6: JJin91 folded before Flop (didn't bet)


*********** # 7 **************
PokerStars Hand #169424998030: Tournament #1597684008, $13.50+$1.50 USD=
 Hold'em No Limit - Level I (25/50) - 2017/05/05 13:39:03 ET
Table '1597684008 2' 6-max Seat #2 is the button
Seat 1: excon tyrone (9611 in chips)=20
Seat 2: mysticbricks (12138 in chips)=20
Seat 3: nfc4ever (9675 in chips)=20
Seat 4: Funkyphill99 (5681 in chips)=20
Seat 5: romogarg (16495 in chips)=20
Seat 6: JJin91 (6400 in chips)=20
nfc4ever: posts small blind 25
Funkyphill99: posts big blind 50
*** HOLE CARDS ***
Dealt to JJin91 [Ah Ac]
excon tyrone said, "nice bet"
romogarg: calls 50
nfc4ever said, ":D"
JJin91: raises 200 to 250
excon tyrone said, "Corky from "Life Goes On""
excon tyrone: folds=20
mysticbricks: calls 250
nfc4ever: calls 225
nfc4ever said, "3:)"
Funkyphill99: raises 1225 to 1475
romogarg: folds=20
JJin91: raises 4925 to 6400 and is all-in
mysticbricks: folds=20
nfc4ever: folds=20
Funkyphill99: folds=20
Uncalled bet (4925) returned to JJin91
JJin91 collected 3500 from pot
*** SUMMARY ***
Total pot 3500 | Rake 0=20
Seat 1: excon tyrone folded before Flop (didn't bet)
Seat 2: mysticbricks (button) folded before Flop
Seat 3: nfc4ever (small blind) folded before Flop
Seat 4: Funkyphill99 (big blind) folded before Flop
Seat 5: romogarg folded before Flop
Seat 6: JJin91 collected (3500)


*********** # 8 **************
PokerStars Hand #169424998283: Tournament #1597684008, $13.50+$1.50 USD=
 Hold'em No Limit - Level II (30/60) - 2017/05/05 13:40:36 ET
Table '1597684008 2' 6-max Seat #3 is the button
Seat 1: excon tyrone (9611 in chips)=20
Seat 2: mysticbricks (11888 in chips)=20
Seat 3: nfc4ever (9425 in chips)=20
Seat 4: Funkyphill99 (4206 in chips)=20
Seat 5: romogarg (16445 in chips)=20
Seat 6: JJin91 (8425 in chips)=20
Funkyphill99: posts small blind 30
romogarg: posts big blind 60
*** HOLE CARDS ***
Dealt to JJin91 [Th 6s]
JJin91: folds=20
excon tyrone: calls 60
mysticbricks: folds=20
nfc4ever: folds=20
Funkyphill99: folds=20
romogarg: checks=20
*** FLOP *** [3s Js 8c]
romogarg: checks=20
excon tyrone: checks=20
*** TURN *** [3s Js 8c] [Qh]
romogarg: checks=20
excon tyrone: checks=20
*** RIVER *** [3s Js 8c Qh] [7c]
romogarg: checks=20
excon tyrone: bets 60
romogarg: folds=20
Uncalled bet (60) returned to excon tyrone
excon tyrone collected 150 from pot
*** SUMMARY ***
Total pot 150 | Rake 0=20
Board [3s Js 8c Qh 7c]
Seat 1: excon tyrone collected (150)
Seat 2: mysticbricks folded before Flop (didn't bet)
Seat 3: nfc4ever (button) folded before Flop (didn't bet)
Seat 4: Funkyphill99 (small blind) folded before Flop
Seat 5: romogarg (big blind) folded on the River
Seat 6: JJin91 folded before Flop (didn't bet)


*********** # 9 **************
PokerStars Hand #169424998376: Tournament #1597684008, $13.50+$1.50 USD=
 Hold'em No Limit - Level II (30/60) - 2017/05/05 13:41:10 ET
Table '1597684008 4' 6-max Seat #1 is the button
Seat 1: JJin91 (8425 in chips)=20
Seat 2: Kauaibaby14 (10100 in chips)=20
Kauaibaby14: posts small blind 30
JJin91: posts big blind 60
*** HOLE CARDS ***
Dealt to JJin91 [8c 4s]
Kauaibaby14 is connected=20
Kauaibaby14: calls 30
JJin91: checks=20
*** FLOP *** [2h 8d Qs]
Kauaibaby14: checks=20
JJin91: bets 75
Kauaibaby14: folds=20
Uncalled bet (75) returned to JJin91
JJin91 collected 120 from pot
*** SUMMARY ***
Total pot 120 | Rake 0=20
Board [2h 8d Qs]
Seat 1: JJin91 (button) (big blind) collected (120)
Seat 2: Kauaibaby14 (small blind) folded on the Flop


*********** # 10 **************
PokerStars Hand #169424998431: Tournament #1597684008, $13.50+$1.50 USD=
 Hold'em No Limit - Level II (30/60) - 2017/05/05 13:41:33 ET
Table '1597684008 4' 6-max Seat #2 is the button
Seat 1: JJin91 (8485 in chips)=20
Seat 2: Kauaibaby14 (10040 in chips)=20
Seat 3: Mkyz419 (9660 in chips) out of hand (moved from another table i=
nto small blind)
JJin91: posts small blind 30
Kauaibaby14: posts big blind 60
*** HOLE CARDS ***
Dealt to JJin91 [4s Qs]
JJin91: raises 60 to 120
Kauaibaby14: calls 60
*** FLOP *** [9c 8d Jc]
JJin91: checks=20
Kauaibaby14: bets 240
JJin91: folds=20
Uncalled bet (240) returned to Kauaibaby14
Kauaibaby14 collected 240 from pot
Kauaibaby14: doesn't show hand=20
*** SUMMARY ***
Total pot 240 | Rake 0=20
Board [9c 8d Jc]
Seat 1: JJin91 (small blind) folded on the Flop
Seat 2: Kauaibaby14 (button) (big blind) collected (240)


*********** # 11 **************
PokerStars Hand #169424998498: Tournament #1597684008, $13.50+$1.50 USD=
 Hold'em No Limit - Level II (30/60) - 2017/05/05 13:41:56 ET
Table '1597684008 4' 6-max Seat #1 is the button
Seat 1: JJin91 (8365 in chips)=20
Seat 2: Kauaibaby14 (10160 in chips)=20
Seat 3: Mkyz419 (9660 in chips)=20
Kauaibaby14: posts small blind 30
Mkyz419: posts big blind 60
*** HOLE CARDS ***
Dealt to JJin91 [3h Th]
JJin91: raises 120 to 180
Kauaibaby14: folds=20
Mkyz419: folds=20
Uncalled bet (120) returned to JJin91
JJin91 collected 150 from pot
*** SUMMARY ***
Total pot 150 | Rake 0=20
Seat 1: JJin91 (button) collected (150)
Seat 2: Kauaibaby14 (small blind) folded before Flop
Seat 3: Mkyz419 (big blind) folded before Flop


*********** # 12 **************
PokerStars Hand #169424998536: Tournament #1597684008, $13.50+$1.50 USD=
 Hold'em No Limit - Level II (30/60) - 2017/05/05 13:42:12 ET
Table '1597684008 4' 6-max Seat #2 is the button
Seat 1: JJin91 (8455 in chips)=20
Seat 2: Kauaibaby14 (10130 in chips)=20
Seat 3: Mkyz419 (9600 in chips)=20
Seat 4: OneHottie (11400 in chips)=20
Mkyz419: posts small blind 30
OneHottie: posts big blind 60
*** HOLE CARDS ***
Dealt to JJin91 [Ts Jd]
JJin91: folds=20
Kauaibaby14: folds=20
Mkyz419: folds=20
Uncalled bet (30) returned to OneHottie
OneHottie collected 60 from pot
*** SUMMARY ***
Total pot 60 | Rake 0=20
Seat 1: JJin91 folded before Flop (didn't bet)
Seat 2: Kauaibaby14 (button) folded before Flop (didn't bet)
Seat 3: Mkyz419 (small blind) folded before Flop
Seat 4: OneHottie (big blind) collected (60)


*********** # 13 **************
PokerStars Hand #169424998559: Tournament #1597684008, $13.50+$1.50 USD=
 Hold'em No Limit - Level II (30/60) - 2017/05/05 13:42:20 ET
Table '1597684008 4' 6-max Seat #3 is the button
Seat 1: JJin91 (8455 in chips)=20
Seat 2: Kauaibaby14 (10130 in chips)=20
Seat 3: Mkyz419 (9570 in chips)=20
Seat 4: OneHottie (11430 in chips)=20
OneHottie: posts small blind 30
JJin91: posts big blind 60
*** HOLE CARDS ***
Dealt to JJin91 [2s 5s]
Kauaibaby14: calls 60
Mkyz419: raises 120 to 180
OneHottie: calls 150
JJin91: folds=20
Kauaibaby14: calls 120
*** FLOP *** [Ks 3d Qc]
OneHottie: checks=20
Kauaibaby14: checks=20
Mkyz419: checks=20
*** TURN *** [Ks 3d Qc] [6s]
OneHottie: bets 66
Kauaibaby14: calls 66
Mkyz419: calls 66
*** RIVER *** [Ks 3d Qc 6s] [5d]
OneHottie: bets 77
Kauaibaby14: folds=20
Mkyz419: calls 77
*** SHOW DOWN ***
OneHottie: shows [Jh Jd] (a pair of Jacks)
Mkyz419: mucks hand=20
OneHottie collected 952 from pot
*** SUMMARY ***
Total pot 952 | Rake 0=20
Board [Ks 3d Qc 6s 5d]
Seat 1: JJin91 (big blind) folded before Flop
Seat 2: Kauaibaby14 folded on the River
Seat 3: Mkyz419 (button) mucked [Tc Ts]
Seat 4: OneHottie (small blind) showed [Jh Jd] and won (952) with a pai=
r of Jacks


*********** # 14 **************
PokerStars Hand #169424998673: Tournament #1597684008, $13.50+$1.50 USD=
 Hold'em No Limit - Level II (30/60) - 2017/05/05 13:42:59 ET
Table '1597684008 4' 6-max Seat #4 is the button
Seat 1: JJin91 (8395 in chips)=20
Seat 2: Kauaibaby14 (9884 in chips)=20
Seat 3: Mkyz419 (9247 in chips)=20
Seat 4: OneHottie (12059 in chips)=20
JJin91: posts small blind 30
Kauaibaby14: posts big blind 60
*** HOLE CARDS ***
Dealt to JJin91 [Kh Js]
Mkyz419: folds=20
OneHottie: calls 60
JJin91: raises 180 to 240
Kauaibaby14: calls 180
OneHottie: folds=20
*** FLOP *** [4s Ac Jh]
JJin91: checks=20
Kauaibaby14: bets 240
JJin91: calls 240
*** TURN *** [4s Ac Jh] [6c]
JJin91: checks=20
Kauaibaby14: bets 720
JJin91: folds=20
Uncalled bet (720) returned to Kauaibaby14
Kauaibaby14 collected 1020 from pot
Kauaibaby14: doesn't show hand=20
*** SUMMARY ***
Total pot 1020 | Rake 0=20
Board [4s Ac Jh 6c]
Seat 1: JJin91 (small blind) folded on the Turn
Seat 2: Kauaibaby14 (big blind) collected (1020)
Seat 3: Mkyz419 folded before Flop (didn't bet)
Seat 4: OneHottie (button) folded before Flop


*********** # 15 **************
PokerStars Hand #169424998773: Tournament #1597684008, $13.50+$1.50 USD=
 Hold'em No Limit - Level II (30/60) - 2017/05/05 13:43:41 ET
Table '1597684008 4' 6-max Seat #1 is the button
Seat 1: JJin91 (7915 in chips)=20
Seat 2: Kauaibaby14 (10424 in chips)=20
Seat 3: Mkyz419 (9247 in chips)=20
Seat 4: OneHottie (11999 in chips)=20
Seat 5: mysticbricks (11528 in chips)=20
Seat 6: excon tyrone (9511 in chips)=20
Kauaibaby14: posts small blind 30
Mkyz419: posts big blind 60
*** HOLE CARDS ***
Dealt to JJin91 [2s Js]
OneHottie: folds=20
mysticbricks: folds=20
excon tyrone: folds=20
JJin91: folds=20
Kauaibaby14: folds=20
Uncalled bet (30) returned to Mkyz419
Mkyz419 collected 60 from pot
Mkyz419: doesn't show hand=20
*** SUMMARY ***
Total pot 60 | Rake 0=20
Seat 1: JJin91 (button) folded before Flop (didn't bet)
Seat 2: Kauaibaby14 (small blind) folded before Flop
Seat 3: Mkyz419 (big blind) collected (60)
Seat 4: OneHottie folded before Flop (didn't bet)
Seat 5: mysticbricks folded before Flop (didn't bet)
Seat 6: excon tyrone folded before Flop (didn't bet)


*********** # 16 **************
PokerStars Hand #169424998803: Tournament #1597684008, $13.50+$1.50 USD=
 Hold'em No Limit - Level II (30/60) - 2017/05/05 13:43:51 ET
Table '1597684008 4' 6-max Seat #2 is the button
Seat 1: JJin91 (7915 in chips)=20
Seat 2: Kauaibaby14 (10394 in chips)=20
Seat 3: Mkyz419 (9277 in chips)=20
Seat 4: OneHottie (11999 in chips)=20
Seat 6: excon tyrone (9511 in chips)=20
Mkyz419: posts small blind 30
OneHottie: posts big blind 60
*** HOLE CARDS ***
Dealt to JJin91 [Qc 6s]
excon tyrone: folds=20
JJin91: folds=20
Kauaibaby14: calls 60
Mkyz419: folds=20
OneHottie: checks=20
*** FLOP *** [Td Ac 3d]
OneHottie: checks=20
Kauaibaby14: checks=20
*** TURN *** [Td Ac 3d] [Th]
OneHottie: bets 120
Kauaibaby14: calls 120
*** RIVER *** [Td Ac 3d Th] [2s]
OneHottie: bets 300
Kauaibaby14: raises 495 to 795
OneHottie: calls 495
*** SHOW DOWN ***
Kauaibaby14: shows [Qs Ts] (three of a kind, Tens)
OneHottie: mucks hand=20
Kauaibaby14 collected 1980 from pot
*** SUMMARY ***
Total pot 1980 | Rake 0=20
Board [Td Ac 3d Th 2s]
Seat 1: JJin91 folded before Flop (didn't bet)
Seat 2: Kauaibaby14 (button) showed [Qs Ts] and won (1980) with three o=
f a kind, Tens
Seat 3: Mkyz419 (small blind) folded before Flop
Seat 4: OneHottie (big blind) mucked [Js Ah]
Seat 6: excon tyrone folded before Flop (didn't bet)


*********** # 17 **************
PokerStars Hand #169424998890: Tournament #1597684008, $13.50+$1.50 USD=
 Hold'em No Limit - Level II (30/60) - 2017/05/05 13:44:22 ET
Table '1597684008 4' 6-max Seat #3 is the button
Seat 1: JJin91 (7915 in chips)=20
Seat 3: Mkyz419 (9247 in chips)=20
Seat 4: OneHottie (11024 in chips)=20
Seat 6: excon tyrone (9511 in chips)=20
OneHottie: posts small blind 30
excon tyrone: posts big blind 60
*** HOLE CARDS ***
Dealt to JJin91 [2c 8c]
JJin91: folds=20
Mkyz419: folds=20
OneHottie: folds=20
Uncalled bet (30) returned to excon tyrone
excon tyrone collected 60 from pot
*** SUMMARY ***
Total pot 60 | Rake 0=20
Seat 1: JJin91 folded before Flop (didn't bet)
Seat 3: Mkyz419 (button) folded before Flop (didn't bet)
Seat 4: OneHottie (small blind) folded before Flop
Seat 6: excon tyrone (big blind) collected (60)


*********** # 18 **************
PokerStars Hand #169424998908: Tournament #1597684008, $13.50+$1.50 USD=
 Hold'em No Limit - Level II (30/60) - 2017/05/05 13:44:29 ET
Table '1597684008 4' 6-max Seat #4 is the button
Seat 1: JJin91 (7915 in chips)=20
Seat 3: Mkyz419 (9247 in chips)=20
Seat 4: OneHottie (10994 in chips)=20
Seat 6: excon tyrone (9541 in chips)=20
excon tyrone: posts small blind 30
JJin91: posts big blind 60
*** HOLE CARDS ***
Dealt to JJin91 [Jh 5d]
Mkyz419: folds=20
OneHottie: raises 120 to 180
excon tyrone: calls 150
JJin91: folds=20
*** FLOP *** [7c 8s 6d]
excon tyrone: checks=20
OneHottie: bets 210
excon tyrone: raises 210 to 420
OneHottie: calls 210
*** TURN *** [7c 8s 6d] [3s]
excon tyrone: bets 3240
OneHottie: folds=20
Uncalled bet (3240) returned to excon tyrone
excon tyrone collected 1260 from pot
*** SUMMARY ***
Total pot 1260 | Rake 0=20
Board [7c 8s 6d 3s]
Seat 1: JJin91 (big blind) folded before Flop
Seat 3: Mkyz419 folded before Flop (didn't bet)
Seat 4: OneHottie (button) folded on the Turn
Seat 6: excon tyrone (small blind) collected (1260)


*********** # 19 **************
PokerStars Hand #169424998980: Tournament #1597684008, $13.50+$1.50 USD=
 Hold'em No Limit - Level II (30/60) - 2017/05/05 13:44:57 ET
Table '1597684008 4' 6-max Seat #6 is the button
Seat 1: JJin91 (7855 in chips)=20
Seat 3: Mkyz419 (9247 in chips)=20
Seat 4: OneHottie (10394 in chips)=20
Seat 6: excon tyrone (10201 in chips)=20
JJin91: posts small blind 30
Mkyz419: posts big blind 60
*** HOLE CARDS ***
Dealt to JJin91 [9s 8s]
OneHottie: folds=20
excon tyrone: calls 60
JJin91: calls 30
Mkyz419: checks=20
*** FLOP *** [Js 9d 2s]
JJin91: checks=20
Mkyz419: checks=20
excon tyrone: bets 180
JJin91: raises 300 to 480
Mkyz419: folds=20
excon tyrone: calls 300
*** TURN *** [Js 9d 2s] [Qd]
JJin91: checks=20
excon tyrone: bets 2640
JJin91: calls 2640
*** RIVER *** [Js 9d 2s Qd] [2d]
JJin91: bets 4675 and is all-in
excon tyrone: calls 4675
*** SHOW DOWN ***
JJin91: shows [9s 8s] (two pair, Nines and Deuces)
excon tyrone: shows [8h Th] (a straight, Eight to Queen)
excon tyrone collected 15770 from pot
JJin91 finished the tournament in 103rd place
*** SUMMARY ***
Total pot 15770 | Rake 0=20
Board [Js 9d 2s Qd 2d]
Seat 1: JJin91 (small blind) showed [9s 8s] and lost with two pair, Nin=
es and Deuces
Seat 3: Mkyz419 (big blind) folded on the Flop
Seat 4: OneHottie folded before Flop (didn't bet)
Seat 6: excon tyrone (button) showed [8h Th] and won (15770) with a str=
aight, Eight to Queen


*********** # 20 **************
PokerStars Hand #169424999210: Tournament #1597684008, $13.50+$1.50 USD=
 Hold'em No Limit - Level II (30/60) - 2017/05/05 13:46:19 ET
Table '1597684008 5' 6-max Seat #3 is the button
Seat 1: deeeeeeeeez (18712 in chips)=20
Seat 2: silverfox749 (9313 in chips)=20
Seat 3: mysticbricks (12248 in chips)=20
Seat 4: Kauaibaby14 (11339 in chips)=20
Seat 5: JJin91 (10000 in chips)=20
Seat 6: robertg68 (9940 in chips)=20
Kauaibaby14: posts small blind 30
JJin91: posts big blind 60
*** HOLE CARDS ***
Dealt to JJin91 [Ah 2s]
robertg68: folds=20
deeeeeeeeez: raises 120 to 180
silverfox749: calls 180
mysticbricks: folds=20
Kauaibaby14: folds=20
JJin91: calls 120
*** FLOP *** [Qc 6s 3d]
JJin91: checks=20
deeeeeeeeez: checks=20
silverfox749: checks=20
*** TURN *** [Qc 6s 3d] [6h]
JJin91: checks=20
deeeeeeeeez: bets 300
silverfox749: folds=20
JJin91: folds=20
Uncalled bet (300) returned to deeeeeeeeez
deeeeeeeeez collected 570 from pot
*** SUMMARY ***
Total pot 570 | Rake 0=20
Board [Qc 6s 3d 6h]
Seat 1: deeeeeeeeez collected (570)
Seat 2: silverfox749 folded on the Turn
Seat 3: mysticbricks (button) folded before Flop (didn't bet)
Seat 4: Kauaibaby14 (small blind) folded before Flop
Seat 5: JJin91 (big blind) folded on the Turn
Seat 6: robertg68 folded before Flop (didn't bet)


*********** # 21 **************
PokerStars Hand #169424999346: Tournament #1597684008, $13.50+$1.50 USD=
 Hold'em No Limit - Level II (30/60) - 2017/05/05 13:47:09 ET
Table '1597684008 5' 6-max Seat #4 is the button
Seat 1: deeeeeeeeez (19102 in chips)=20
Seat 2: silverfox749 (9133 in chips)=20
Seat 3: mysticbricks (12248 in chips)=20
Seat 4: Kauaibaby14 (11309 in chips)=20
Seat 5: JJin91 (9820 in chips)=20
Seat 6: robertg68 (9940 in chips)=20
JJin91: posts small blind 30
robertg68: posts big blind 60
*** HOLE CARDS ***
Dealt to JJin91 [Kd 4d]
deeeeeeeeez: folds=20
silverfox749: folds=20
mysticbricks: folds=20
Kauaibaby14: folds=20
JJin91: raises 120 to 180
robertg68: calls 120
*** FLOP *** [7d Jc Ac]
JJin91: checks=20
robertg68: checks=20
*** TURN *** [7d Jc Ac] [Kc]
JJin91: checks=20
robertg68: bets 60
JJin91: calls 60
*** RIVER *** [7d Jc Ac Kc] [Ah]
JJin91: checks=20
robertg68: checks=20
*** SHOW DOWN ***
JJin91: shows [Kd 4d] (two pair, Aces and Kings)
robertg68: shows [9c Kh] (two pair, Aces and Kings)
JJin91 collected 240 from pot
robertg68 collected 240 from pot
*** SUMMARY ***
Total pot 480 | Rake 0=20
Board [7d Jc Ac Kc Ah]
Seat 1: deeeeeeeeez folded before Flop (didn't bet)
Seat 2: silverfox749 folded before Flop (didn't bet)
Seat 3: mysticbricks folded before Flop (didn't bet)
Seat 4: Kauaibaby14 (button) folded before Flop (didn't bet)
Seat 5: JJin91 (small blind) showed [Kd 4d] and won (240) with two pair=
, Aces and Kings
Seat 6: robertg68 (big blind) showed [9c Kh] and won (240) with two pai=
r, Aces and Kings


*********** # 22 **************
PokerStars Hand #169424999432: Tournament #1597684008, $13.50+$1.50 USD=
 Hold'em No Limit - Level II (30/60) - 2017/05/05 13:47:38 ET
Table '1597684008 5' 6-max Seat #5 is the button
Seat 1: deeeeeeeeez (19102 in chips)=20
Seat 2: silverfox749 (9133 in chips)=20
Seat 3: mysticbricks (12248 in chips)=20
Seat 4: Kauaibaby14 (11309 in chips)=20
Seat 5: JJin91 (9820 in chips)=20
Seat 6: robertg68 (9940 in chips)=20
robertg68: posts small blind 30
deeeeeeeeez: posts big blind 60
*** HOLE CARDS ***
Dealt to JJin91 [6h 5s]
silverfox749: folds=20
mysticbricks: calls 60
Kauaibaby14: calls 60
JJin91: folds=20
robertg68: calls 30
deeeeeeeeez: checks=20
*** FLOP *** [3s 3d Tc]
robertg68: bets 60
deeeeeeeeez: folds=20
mysticbricks: folds=20
Kauaibaby14: folds=20
Uncalled bet (60) returned to robertg68
robertg68 collected 240 from pot
*** SUMMARY ***
Total pot 240 | Rake 0=20
Board [3s 3d Tc]
Seat 1: deeeeeeeeez (big blind) folded on the Flop
Seat 2: silverfox749 folded before Flop (didn't bet)
Seat 3: mysticbricks folded on the Flop
Seat 4: Kauaibaby14 folded on the Flop
Seat 5: JJin91 (button) folded before Flop (didn't bet)
Seat 6: robertg68 (small blind) collected (240)


*********** # 23 **************
PokerStars Hand #169424999529: Tournament #1597684008, $13.50+$1.50 USD=
 Hold'em No Limit - Level II (30/60) - 2017/05/05 13:48:09 ET
Table '1597684008 5' 6-max Seat #6 is the button
Seat 1: deeeeeeeeez (19042 in chips)=20
Seat 2: silverfox749 (9133 in chips)=20
Seat 3: mysticbricks (12188 in chips)=20
Seat 4: Kauaibaby14 (11249 in chips)=20
Seat 5: JJin91 (9820 in chips)=20
Seat 6: robertg68 (10120 in chips)=20
deeeeeeeeez: posts small blind 30
silverfox749: posts big blind 60
*** HOLE CARDS ***
Dealt to JJin91 [9s 6c]
mysticbricks: folds=20
Kauaibaby14: folds=20
JJin91: folds=20
robertg68: calls 60
deeeeeeeeez: raises 180 to 240
silverfox749: folds=20
robertg68: folds=20
Uncalled bet (180) returned to deeeeeeeeez
deeeeeeeeez collected 180 from pot
*** SUMMARY ***
Total pot 180 | Rake 0=20
Seat 1: deeeeeeeeez (small blind) collected (180)
Seat 2: silverfox749 (big blind) folded before Flop
Seat 3: mysticbricks folded before Flop (didn't bet)
Seat 4: Kauaibaby14 folded before Flop (didn't bet)
Seat 5: JJin91 folded before Flop (didn't bet)
Seat 6: robertg68 (button) folded before Flop


*********** # 24 **************
PokerStars Hand #169424999584: Tournament #1597684008, $13.50+$1.50 USD=
 Hold'em No Limit - Level II (30/60) - 2017/05/05 13:48:32 ET
Table '1597684008 5' 6-max Seat #1 is the button
Seat 1: deeeeeeeeez (19162 in chips)=20
Seat 2: silverfox749 (9073 in chips)=20
Seat 3: mysticbricks (12188 in chips)=20
Seat 4: Kauaibaby14 (11249 in chips)=20
Seat 5: JJin91 (9820 in chips)=20
Seat 6: robertg68 (10060 in chips)=20
silverfox749: posts small blind 30
mysticbricks: posts big blind 60
*** HOLE CARDS ***
Dealt to JJin91 [3d Ks]
Kauaibaby14: folds=20
JJin91: folds=20
robertg68: calls 60
deeeeeeeeez: folds=20
silverfox749: calls 30
mysticbricks: checks=20
*** FLOP *** [Ac 3s 2d]
silverfox749: checks=20
mysticbricks: checks=20
robertg68: checks=20
*** TURN *** [Ac 3s 2d] [Ts]
silverfox749: bets 135
mysticbricks: folds=20
robertg68: calls 135
*** RIVER *** [Ac 3s 2d Ts] [Js]
silverfox749: bets 338
robertg68: calls 338
*** SHOW DOWN ***
silverfox749: shows [9s 5s] (a flush, Jack high)
robertg68: mucks hand=20
silverfox749 collected 1126 from pot
*** SUMMARY ***
Total pot 1126 | Rake 0=20
Board [Ac 3s 2d Ts Js]
Seat 1: deeeeeeeeez (button) folded before Flop (didn't bet)
Seat 2: silverfox749 (small blind) showed [9s 5s] and won (1126) with a=
 flush, Jack high
Seat 3: mysticbricks (big blind) folded on the Turn
Seat 4: Kauaibaby14 folded before Flop (didn't bet)
Seat 5: JJin91 folded before Flop (didn't bet)
Seat 6: robertg68 mucked [Jd Th]


*********** # 25 **************
PokerStars Hand #169424999704: Tournament #1597684008, $13.50+$1.50 USD=
 Hold'em No Limit - Level II (30/60) - 2017/05/05 13:49:14 ET
Table '1597684008 5' 6-max Seat #2 is the button
Seat 1: deeeeeeeeez (19162 in chips)=20
Seat 2: silverfox749 (9666 in chips)=20
Seat 3: mysticbricks (12128 in chips)=20
Seat 4: Kauaibaby14 (11249 in chips)=20
Seat 5: JJin91 (9820 in chips)=20
Seat 6: robertg68 (9527 in chips)=20
mysticbricks: posts small blind 30
Kauaibaby14: posts big blind 60
*** HOLE CARDS ***
Dealt to JJin91 [4h 5h]
JJin91: folds=20
robertg68: folds=20
deeeeeeeeez: calls 60
silverfox749: calls 60
mysticbricks: calls 30
Kauaibaby14: raises 120 to 180
deeeeeeeeez: calls 120
silverfox749: calls 120
mysticbricks: calls 120
*** FLOP *** [Ah 9s Js]
mysticbricks: checks=20
Kauaibaby14: bets 360
deeeeeeeeez: folds=20
silverfox749: folds=20
mysticbricks: folds=20
Uncalled bet (360) returned to Kauaibaby14
Kauaibaby14 collected 720 from pot
Kauaibaby14: doesn't show hand=20
*** SUMMARY ***
Total pot 720 | Rake 0=20
Board [Ah 9s Js]
Seat 1: deeeeeeeeez folded on the Flop
Seat 2: silverfox749 (button) folded on the Flop
Seat 3: mysticbricks (small blind) folded on the Flop
Seat 4: Kauaibaby14 (big blind) collected (720)
Seat 5: JJin91 folded before Flop (didn't bet)
Seat 6: robertg68 folded before Flop (didn't bet)


*********** # 26 **************
PokerStars Hand #169424999795: Tournament #1597684008, $13.50+$1.50 USD=
 Hold'em No Limit - Level II (30/60) - 2017/05/05 13:49:53 ET
Table '1597684008 5' 6-max Seat #3 is the button
Seat 1: deeeeeeeeez (18982 in chips)=20
Seat 2: silverfox749 (9486 in chips)=20
Seat 3: mysticbricks (11948 in chips)=20
Seat 4: Kauaibaby14 (11789 in chips)=20
Seat 5: JJin91 (9820 in chips)=20
Seat 6: robertg68 (9527 in chips)=20
Kauaibaby14: posts small blind 30
JJin91: posts big blind 60
*** HOLE CARDS ***
Dealt to JJin91 [8d Ac]
robertg68: folds=20
deeeeeeeeez: folds=20
silverfox749: folds=20
mysticbricks: raises 120 to 180
Kauaibaby14: folds=20
JJin91: calls 120
*** FLOP *** [2c Js Th]
JJin91: checks=20
mysticbricks: bets 390
JJin91: folds=20
Uncalled bet (390) returned to mysticbricks
mysticbricks collected 390 from pot
mysticbricks: doesn't show hand=20
*** SUMMARY ***
Total pot 390 | Rake 0=20
Board [2c Js Th]
Seat 1: deeeeeeeeez folded before Flop (didn't bet)
Seat 2: silverfox749 folded before Flop (didn't bet)
Seat 3: mysticbricks (button) collected (390)
Seat 4: Kauaibaby14 (small blind) folded before Flop
Seat 5: JJin91 (big blind) folded on the Flop
Seat 6: robertg68 folded before Flop (didn't bet)


*********** # 27 **************
PokerStars Hand #169424999875: Tournament #1597684008, $13.50+$1.50 USD=
 Hold'em No Limit - Level III (40/80) - 2017/05/05 13:50:28 ET
Table '1597684008 5' 6-max Seat #4 is the button
Seat 1: deeeeeeeeez (18982 in chips)=20
Seat 2: silverfox749 (9486 in chips)=20
Seat 3: mysticbricks (12158 in chips)=20
Seat 4: Kauaibaby14 (11759 in chips)=20
Seat 5: JJin91 (9640 in chips)=20
Seat 6: robertg68 (9527 in chips)=20
JJin91: posts small blind 40
robertg68: posts big blind 80
*** HOLE CARDS ***
Dealt to JJin91 [4s 9c]
deeeeeeeeez: raises 160 to 240
silverfox749: folds=20
mysticbricks: folds=20
Kauaibaby14: folds=20
JJin91: folds=20
robertg68: folds=20
Uncalled bet (160) returned to deeeeeeeeez
deeeeeeeeez collected 200 from pot
*** SUMMARY ***
Total pot 200 | Rake 0=20
Seat 1: deeeeeeeeez collected (200)
Seat 2: silverfox749 folded before Flop (didn't bet)
Seat 3: mysticbricks folded before Flop (didn't bet)
Seat 4: Kauaibaby14 (button) folded before Flop (didn't bet)
Seat 5: JJin91 (small blind) folded before Flop
Seat 6: robertg68 (big blind) folded before Flop


*********** # 28 **************
PokerStars Hand #169424999910: Tournament #1597684008, $13.50+$1.50 USD=
 Hold'em No Limit - Level III (40/80) - 2017/05/05 13:50:45 ET
Table '1597684008 5' 6-max Seat #5 is the button
Seat 1: deeeeeeeeez (19102 in chips)=20
Seat 2: silverfox749 (9486 in chips)=20
Seat 3: mysticbricks (12158 in chips)=20
Seat 4: Kauaibaby14 (11759 in chips)=20
Seat 5: JJin91 (9600 in chips)=20
Seat 6: robertg68 (9447 in chips)=20
robertg68: posts small blind 40
deeeeeeeeez: posts big blind 80
*** HOLE CARDS ***
Dealt to JJin91 [5s Jh]
silverfox749: folds=20
mysticbricks: folds=20
Kauaibaby14: folds=20
JJin91: folds=20
robertg68: folds=20
Uncalled bet (40) returned to deeeeeeeeez
deeeeeeeeez collected 80 from pot
*** SUMMARY ***
Total pot 80 | Rake 0=20
Seat 1: deeeeeeeeez (big blind) collected (80)
Seat 2: silverfox749 folded before Flop (didn't bet)
Seat 3: mysticbricks folded before Flop (didn't bet)
Seat 4: Kauaibaby14 folded before Flop (didn't bet)
Seat 5: JJin91 (button) folded before Flop (didn't bet)
Seat 6: robertg68 (small blind) folded before Flop


*********** # 29 **************
PokerStars Hand #169424999939: Tournament #1597684008, $13.50+$1.50 USD=
 Hold'em No Limit - Level III (40/80) - 2017/05/05 13:50:54 ET
Table '1597684008 5' 6-max Seat #6 is the button
Seat 1: deeeeeeeeez (19142 in chips)=20
Seat 2: silverfox749 (9486 in chips)=20
Seat 3: mysticbricks (12158 in chips)=20
Seat 4: Kauaibaby14 (11759 in chips)=20
Seat 5: JJin91 (9600 in chips)=20
Seat 6: robertg68 (9407 in chips)=20
deeeeeeeeez: posts small blind 40
silverfox749: posts big blind 80
*** HOLE CARDS ***
Dealt to JJin91 [4c 2c]
mysticbricks: folds=20
Kauaibaby14: folds=20
JJin91: raises 160 to 240
robertg68: calls 240
deeeeeeeeez: calls 200
silverfox749: folds=20
*** FLOP *** [Jd 6h Qd]
deeeeeeeeez: checks=20
JJin91: bets 480
robertg68: folds=20
deeeeeeeeez: folds=20
Uncalled bet (480) returned to JJin91
JJin91 collected 800 from pot
*** SUMMARY ***
Total pot 800 | Rake 0=20
Board [Jd 6h Qd]
Seat 1: deeeeeeeeez (small blind) folded on the Flop
Seat 2: silverfox749 (big blind) folded before Flop
Seat 3: mysticbricks folded before Flop (didn't bet)
Seat 4: Kauaibaby14 folded before Flop (didn't bet)
Seat 5: JJin91 collected (800)
Seat 6: robertg68 (button) folded on the Flop


*********** # 30 **************
PokerStars Hand #169425793069: Tournament #1597684008, $13.50+$1.50 USD=
 Hold'em No Limit - Level III (40/80) - 2017/05/05 13:51:40 ET
Table '1597684008 5' 6-max Seat #1 is the button
Seat 1: deeeeeeeeez (18902 in chips)=20
Seat 2: silverfox749 (9406 in chips)=20
Seat 4: Kauaibaby14 (11759 in chips)=20
Seat 5: JJin91 (10160 in chips)=20
Seat 6: robertg68 (9167 in chips)=20
silverfox749: posts small blind 40
Kauaibaby14: posts big blind 80
*** HOLE CARDS ***
Dealt to JJin91 [3c Jd]
JJin91: folds=20
robertg68: folds=20
deeeeeeeeez: raises 160 to 240
silverfox749: folds=20
Kauaibaby14: raises 1920 to 2160
deeeeeeeeez: folds=20
Uncalled bet (1920) returned to Kauaibaby14
Kauaibaby14 collected 520 from pot
Kauaibaby14: doesn't show hand=20
*** SUMMARY ***
Total pot 520 | Rake 0=20
Seat 1: deeeeeeeeez (button) folded before Flop
Seat 2: silverfox749 (small blind) folded before Flop
Seat 4: Kauaibaby14 (big blind) collected (520)
Seat 5: JJin91 folded before Flop (didn't bet)
Seat 6: robertg68 folded before Flop (didn't bet)


*********** # 31 **************
PokerStars Hand #169425793157: Tournament #1597684008, $13.50+$1.50 USD=
 Hold'em No Limit - Level III (40/80) - 2017/05/05 13:52:11 ET
Table '1597684008 5' 6-max Seat #2 is the button
Seat 1: deeeeeeeeez (18662 in chips)=20
Seat 2: silverfox749 (9366 in chips)=20
Seat 4: Kauaibaby14 (12039 in chips)=20
Seat 5: JJin91 (10160 in chips)=20
Seat 6: robertg68 (9167 in chips)=20
Kauaibaby14: posts small blind 40
JJin91: posts big blind 80
*** HOLE CARDS ***
Dealt to JJin91 [8c 3d]
robertg68: calls 80
deeeeeeeeez: folds=20
silverfox749: raises 200 to 280
Kauaibaby14: calls 240
JJin91: folds=20
robertg68: folds=20
*** FLOP *** [Ah 6h Th]
Kauaibaby14: checks=20
silverfox749: checks=20
*** TURN *** [Ah 6h Th] [7h]
Kauaibaby14: bets 720
silverfox749: folds=20
Uncalled bet (720) returned to Kauaibaby14
Kauaibaby14 collected 720 from pot
Kauaibaby14: doesn't show hand=20
*** SUMMARY ***
Total pot 720 | Rake 0=20
Board [Ah 6h Th 7h]
Seat 1: deeeeeeeeez folded before Flop (didn't bet)
Seat 2: silverfox749 (button) folded on the Turn
Seat 4: Kauaibaby14 (small blind) collected (720)
Seat 5: JJin91 (big blind) folded before Flop
Seat 6: robertg68 folded before Flop


*********** # 32 **************
PokerStars Hand #169425793231: Tournament #1597684008, $13.50+$1.50 USD=
 Hold'em No Limit - Level III (40/80) - 2017/05/05 13:52:39 ET
Table '1597684008 5' 6-max Seat #4 is the button
Seat 1: deeeeeeeeez (18662 in chips)=20
Seat 2: silverfox749 (9086 in chips)=20
Seat 4: Kauaibaby14 (12479 in chips)=20
Seat 5: JJin91 (10080 in chips)=20
Seat 6: robertg68 (9087 in chips)=20
JJin91: posts small blind 40
robertg68: posts big blind 80
*** HOLE CARDS ***
Dealt to JJin91 [5h 7c]
deeeeeeeeez: raises 240 to 320
silverfox749: folds=20
Kauaibaby14: folds=20
JJin91: folds=20
robertg68: folds=20
Uncalled bet (240) returned to deeeeeeeeez
deeeeeeeeez collected 200 from pot
*** SUMMARY ***
Total pot 200 | Rake 0=20
Seat 1: deeeeeeeeez collected (200)
Seat 2: silverfox749 folded before Flop (didn't bet)
Seat 4: Kauaibaby14 (button) folded before Flop (didn't bet)
Seat 5: JJin91 (small blind) folded before Flop
Seat 6: robertg68 (big blind) folded before Flop


*********** # 33 **************
PokerStars Hand #169425793272: Tournament #1597684008, $13.50+$1.50 USD=
 Hold'em No Limit - Level III (40/80) - 2017/05/05 13:52:53 ET
Table '1597684008 5' 6-max Seat #5 is the button
Seat 1: deeeeeeeeez (18782 in chips)=20
Seat 2: silverfox749 (9086 in chips)=20
Seat 4: Kauaibaby14 (12479 in chips)=20
Seat 5: JJin91 (10040 in chips)=20
Seat 6: robertg68 (9007 in chips)=20
robertg68: posts small blind 40
deeeeeeeeez: posts big blind 80
*** HOLE CARDS ***
Dealt to JJin91 [Qh Jh]
silverfox749: folds=20
Kauaibaby14: calls 80
JJin91: raises 160 to 240
robertg68: folds=20
deeeeeeeeez: raises 720 to 960
Kauaibaby14: calls 880
JJin91: folds=20
*** FLOP *** [9s 5s 7s]
deeeeeeeeez: checks=20
Kauaibaby14: bets 320
deeeeeeeeez: calls 320
*** TURN *** [9s 5s 7s] [Ts]
deeeeeeeeez: checks=20
Kauaibaby14: bets 11199 and is all-in
deeeeeeeeez: calls 11199
*** RIVER *** [9s 5s 7s Ts] [9c]
*** SHOW DOWN ***
deeeeeeeeez: shows [Ad Qs] (a flush, Queen high)
Kauaibaby14: shows [Ks Ac] (a flush, King high)
Kauaibaby14 collected 25238 from pot
*** SUMMARY ***
Total pot 25238 | Rake 0=20
Board [9s 5s 7s Ts 9c]
Seat 1: deeeeeeeeez (big blind) showed [Ad Qs] and lost with a flush, Q=
ueen high
Seat 2: silverfox749 folded before Flop (didn't bet)
Seat 4: Kauaibaby14 showed [Ks Ac] and won (25238) with a flush, King h=
igh
Seat 5: JJin91 (button) folded before Flop
Seat 6: robertg68 (small blind) folded before Flop


*********** # 34 **************
PokerStars Hand #169425793425: Tournament #1597684008, $13.50+$1.50 USD=
 Hold'em No Limit - Level III (40/80) - 2017/05/05 13:53:49 ET
Table '1597684008 5' 6-max Seat #6 is the button
Seat 1: deeeeeeeeez (6303 in chips)=20
Seat 2: silverfox749 (9086 in chips)=20
Seat 4: Kauaibaby14 (25238 in chips)=20
Seat 5: JJin91 (9800 in chips)=20
Seat 6: robertg68 (8967 in chips)=20
deeeeeeeeez: posts small blind 40
silverfox749: posts big blind 80
*** HOLE CARDS ***
Dealt to JJin91 [Qc Ts]
Kauaibaby14: calls 80
JJin91: folds=20
deeeeeeeeez said, "nh"
robertg68: calls 80
Kauaibaby14 said, "close"
deeeeeeeeez: calls 40
silverfox749: checks=20
*** FLOP *** [5d 8s 3h]
deeeeeeeeez: checks=20
silverfox749: bets 240
Kauaibaby14: folds=20
robertg68: calls 240
deeeeeeeeez: raises 5983 to 6223 and is all-in
silverfox749: folds=20
robertg68: folds=20
Uncalled bet (5983) returned to deeeeeeeeez
deeeeeeeeez collected 1040 from pot
Kauaibaby14 said, "snap call..thought you had me"
*** SUMMARY ***
Total pot 1040 | Rake 0=20
Board [5d 8s 3h]
Seat 1: deeeeeeeeez (small blind) collected (1040)
Seat 2: silverfox749 (big blind) folded on the Flop
Seat 4: Kauaibaby14 folded on the Flop
Seat 5: JJin91 folded before Flop (didn't bet)
Seat 6: robertg68 (button) folded on the Flop


*********** # 35 **************
PokerStars Hand #169425793517: Tournament #1597684008, $13.50+$1.50 USD=
 Hold'em No Limit - Level III (40/80) - 2017/05/05 13:54:24 ET
Table '1597684008 5' 6-max Seat #1 is the button
Seat 1: deeeeeeeeez (7023 in chips)=20
Seat 2: silverfox749 (8766 in chips)=20
Seat 4: Kauaibaby14 (25158 in chips)=20
Seat 5: JJin91 (9800 in chips)=20
Seat 6: robertg68 (8647 in chips)=20
silverfox749: posts small blind 40
Kauaibaby14: posts big blind 80
*** HOLE CARDS ***
Dealt to JJin91 [Ad Qh]
JJin91: raises 160 to 240
robertg68: calls 240
deeeeeeeeez: calls 240
silverfox749: folds=20
Kauaibaby14: folds=20
*** FLOP *** [5h 2c 8s]
JJin91: checks=20
robertg68: checks=20
deeeeeeeeez: checks=20
*** TURN *** [5h 2c 8s] [3c]
JJin91: checks=20
robertg68: checks=20
deeeeeeeeez: checks=20
*** RIVER *** [5h 2c 8s 3c] [6h]
deeeeeeeeez said, "how do I fold that idk maybe"
JJin91: checks=20
robertg68: checks=20
deeeeeeeeez: bets 1120
JJin91: folds=20
robertg68: folds=20
Uncalled bet (1120) returned to deeeeeeeeez
deeeeeeeeez collected 840 from pot
*** SUMMARY ***
Total pot 840 | Rake 0=20
Board [5h 2c 8s 3c 6h]
Seat 1: deeeeeeeeez (button) collected (840)
Seat 2: silverfox749 (small blind) folded before Flop
Seat 4: Kauaibaby14 (big blind) folded before Flop
Seat 5: JJin91 folded on the River
Seat 6: robertg68 folded on the River


*********** # 36 **************
PokerStars Hand #169425794761: Tournament #1597684008, $13.50+$1.50 USD=
 Hold'em No Limit - Level III (40/80) - 2017/05/05 14:01:34 ET
Table '1597684008 5' 6-max Seat #2 is the button
Seat 1: deeeeeeeeez (7623 in chips)=20
Seat 2: silverfox749 (8726 in chips)=20
Seat 4: Kauaibaby14 (25078 in chips)=20
Seat 5: JJin91 (9560 in chips)=20
Seat 6: robertg68 (8407 in chips)=20
Kauaibaby14: posts small blind 40
JJin91: posts big blind 80
*** HOLE CARDS ***
Dealt to JJin91 [Jd Td]
robertg68: folds=20
deeeeeeeeez: folds=20
silverfox749: folds=20
Kauaibaby14: calls 40
JJin91: checks=20
*** FLOP *** [9d 8c 7c]
Kauaibaby14: checks=20
JJin91: checks=20
*** TURN *** [9d 8c 7c] [Kc]
Kauaibaby14: checks=20
JJin91: bets 80
Kauaibaby14: folds=20
Uncalled bet (80) returned to JJin91
JJin91 collected 160 from pot
*** SUMMARY ***
Total pot 160 | Rake 0=20
Board [9d 8c 7c Kc]
Seat 1: deeeeeeeeez folded before Flop (didn't bet)
Seat 2: silverfox749 (button) folded before Flop (didn't bet)
Seat 4: Kauaibaby14 (small blind) folded on the Turn
Seat 5: JJin91 (big blind) collected (160)
Seat 6: robertg68 folded before Flop (didn't bet)


*********** # 37 **************
PokerStars Hand #169425794854: Tournament #1597684008, $13.50+$1.50 USD=
 Hold'em No Limit - Level III (40/80) - 2017/05/05 14:02:00 ET
Table '1597684008 5' 6-max Seat #4 is the button
Seat 1: deeeeeeeeez (7623 in chips)=20
Seat 2: silverfox749 (8726 in chips)=20
Seat 4: Kauaibaby14 (24998 in chips)=20
Seat 5: JJin91 (9640 in chips)=20
Seat 6: robertg68 (8407 in chips)=20
JJin91: posts small blind 40
robertg68: posts big blind 80
*** HOLE CARDS ***
Dealt to JJin91 [4c 5c]
deeeeeeeeez: raises 240 to 320
silverfox749: folds=20
Kauaibaby14: folds=20
JJin91: folds=20
robertg68: folds=20
Uncalled bet (240) returned to deeeeeeeeez
deeeeeeeeez collected 200 from pot
*** SUMMARY ***
Total pot 200 | Rake 0=20
Seat 1: deeeeeeeeez collected (200)
Seat 2: silverfox749 folded before Flop (didn't bet)
Seat 4: Kauaibaby14 (button) folded before Flop (didn't bet)
Seat 5: JJin91 (small blind) folded before Flop
Seat 6: robertg68 (big blind) folded before Flop


*********** # 38 **************
PokerStars Hand #169425794905: Tournament #1597684008, $13.50+$1.50 USD=
 Hold'em No Limit - Level III (40/80) - 2017/05/05 14:02:16 ET
Table '1597684008 5' 6-max Seat #5 is the button
Seat 1: deeeeeeeeez (7743 in chips)=20
Seat 2: silverfox749 (8726 in chips)=20
Seat 4: Kauaibaby14 (24998 in chips)=20
Seat 5: JJin91 (9600 in chips)=20
Seat 6: robertg68 (8327 in chips)=20
robertg68: posts small blind 40
deeeeeeeeez: posts big blind 80
*** HOLE CARDS ***
Dealt to JJin91 [Qh 2h]
silverfox749: folds=20
Kauaibaby14: folds=20
JJin91: raises 160 to 240
robertg68: calls 200
deeeeeeeeez: calls 160
*** FLOP *** [Th 6s Kh]
robertg68: checks=20
deeeeeeeeez: checks=20
JJin91: bets 320
robertg68: folds=20
deeeeeeeeez: raises 1040 to 1360
JJin91: calls 1040
*** TURN *** [Th 6s Kh] [Jh]
deeeeeeeeez: bets 6143 and is all-in
JJin91: calls 6143
*** RIVER *** [Th 6s Kh Jh] [8h]
*** SHOW DOWN ***
deeeeeeeeez: shows [9d Ks] (a pair of Kings)
JJin91: shows [Qh 2h] (a flush, King high)
JJin91 collected 15726 from pot
deeeeeeeeez finished the tournament in 101st place
*** SUMMARY ***
Total pot 15726 | Rake 0=20
Board [Th 6s Kh Jh 8h]
Seat 1: deeeeeeeeez (big blind) showed [9d Ks] and lost with a pair of =
Kings
Seat 2: silverfox749 folded before Flop (didn't bet)
Seat 4: Kauaibaby14 folded before Flop (didn't bet)
Seat 5: JJin91 (button) showed [Qh 2h] and won (15726) with a flush, Ki=
ng high
Seat 6: robertg68 (small blind) folded on the Flop


*********** # 39 **************
PokerStars Hand #169425795133: Tournament #1597684008, $13.50+$1.50 USD=
 Hold'em No Limit - Level III (40/80) - 2017/05/05 14:03:32 ET
Table '1597684008 5' 6-max Seat #6 is the button
Seat 2: silverfox749 (8726 in chips)=20
Seat 3: VinnieB118 (10000 in chips)=20
Seat 4: Kauaibaby14 (24998 in chips)=20
Seat 5: JJin91 (17583 in chips)=20
Seat 6: robertg68 (8087 in chips)=20
silverfox749: posts small blind 40
VinnieB118: posts big blind 80
*** HOLE CARDS ***
Dealt to JJin91 [Ah Ks]
Kauaibaby14: folds=20
JJin91: raises 160 to 240
robertg68: folds=20
silverfox749: folds=20
VinnieB118: folds=20
Uncalled bet (160) returned to JJin91
JJin91 collected 200 from pot
*** SUMMARY ***
Total pot 200 | Rake 0=20
Seat 2: silverfox749 (small blind) folded before Flop
Seat 3: VinnieB118 (big blind) folded before Flop
Seat 4: Kauaibaby14 folded before Flop (didn't bet)
Seat 5: JJin91 collected (200)
Seat 6: robertg68 (button) folded before Flop (didn't bet)


*********** # 40 **************
PokerStars Hand #169425795172: Tournament #1597684008, $13.50+$1.50 USD=
 Hold'em No Limit - Level III (40/80) - 2017/05/05 14:03:48 ET
Table '1597684008 5' 6-max Seat #2 is the button
Seat 2: silverfox749 (8686 in chips)=20
Seat 3: VinnieB118 (9920 in chips)=20
Seat 4: Kauaibaby14 (24998 in chips)=20
Seat 5: JJin91 (17703 in chips)=20
Seat 6: robertg68 (8087 in chips)=20
VinnieB118: posts small blind 40
Kauaibaby14: posts big blind 80
*** HOLE CARDS ***
Dealt to JJin91 [8c 7s]
JJin91: folds=20
robertg68: folds=20
silverfox749: folds=20
VinnieB118: folds=20
Uncalled bet (40) returned to Kauaibaby14
Kauaibaby14 collected 80 from pot
Kauaibaby14: doesn't show hand=20
*** SUMMARY ***
Total pot 80 | Rake 0=20
Seat 2: silverfox749 (button) folded before Flop (didn't bet)
Seat 3: VinnieB118 (small blind) folded before Flop
Seat 4: Kauaibaby14 (big blind) collected (80)
Seat 5: JJin91 folded before Flop (didn't bet)
Seat 6: robertg68 folded before Flop (didn't bet)


*********** # 41 **************
PokerStars Hand #169425795198: Tournament #1597684008, $13.50+$1.50 USD=
 Hold'em No Limit - Level III (40/80) - 2017/05/05 14:03:58 ET
Table '1597684008 5' 6-max Seat #3 is the button
Seat 2: silverfox749 (8686 in chips)=20
Seat 3: VinnieB118 (9880 in chips)=20
Seat 4: Kauaibaby14 (25038 in chips)=20
Seat 5: JJin91 (17703 in chips)=20
Seat 6: robertg68 (8087 in chips)=20
Kauaibaby14: posts small blind 40
JJin91: posts big blind 80
*** HOLE CARDS ***
Dealt to JJin91 [Qh 6h]
robertg68: folds=20
silverfox749: raises 80 to 160
VinnieB118: folds=20
Kauaibaby14: folds=20
JJin91: calls 80
*** FLOP *** [6c Ah 5d]
JJin91: checks=20
silverfox749: bets 270
JJin91: calls 270
*** TURN *** [6c Ah 5d] [3c]
JJin91: checks=20
silverfox749: checks=20
*** RIVER *** [6c Ah 5d 3c] [Th]
JJin91: checks=20
silverfox749: checks=20
*** SHOW DOWN ***
JJin91: shows [Qh 6h] (a pair of Sixes)
silverfox749: mucks hand=20
JJin91 collected 900 from pot
*** SUMMARY ***
Total pot 900 | Rake 0=20
Board [6c Ah 5d 3c Th]
Seat 2: silverfox749 mucked [4c 4d]
Seat 3: VinnieB118 (button) folded before Flop (didn't bet)
Seat 4: Kauaibaby14 (small blind) folded before Flop
Seat 5: JJin91 (big blind) showed [Qh 6h] and won (900) with a pair of =
Sixes
Seat 6: robertg68 folded before Flop (didn't bet)


*********** # 42 **************
PokerStars Hand #169425795298: Tournament #1597684008, $13.50+$1.50 USD=
 Hold'em No Limit - Level III (40/80) - 2017/05/05 14:04:32 ET
Table '1597684008 5' 6-max Seat #4 is the button
Seat 1: se3dog (10000 in chips)=20
Seat 2: silverfox749 (8256 in chips)=20
Seat 3: VinnieB118 (9880 in chips)=20
Seat 4: Kauaibaby14 (24998 in chips)=20
Seat 5: JJin91 (18173 in chips)=20
Seat 6: robertg68 (8087 in chips)=20
JJin91: posts small blind 40
robertg68: posts big blind 80
*** HOLE CARDS ***
Dealt to JJin91 [Ts 4c]
se3dog: folds=20
silverfox749: raises 280 to 360
VinnieB118: folds=20
Kauaibaby14: calls 360
JJin91: folds=20
robertg68: folds=20
*** FLOP *** [5d Js 2h]
silverfox749: bets 630
Kauaibaby14: raises 630 to 1260
silverfox749: calls 630
*** TURN *** [5d Js 2h] [3c]
silverfox749: checks=20
Kauaibaby14: bets 7040
silverfox749: folds=20
Uncalled bet (7040) returned to Kauaibaby14
Kauaibaby14 collected 3360 from pot
Kauaibaby14: doesn't show hand=20
*** SUMMARY ***
Total pot 3360 | Rake 0=20
Board [5d Js 2h 3c]
Seat 1: se3dog folded before Flop (didn't bet)
Seat 2: silverfox749 folded on the Turn
Seat 3: VinnieB118 folded before Flop (didn't bet)
Seat 4: Kauaibaby14 (button) collected (3360)
Seat 5: JJin91 (small blind) folded before Flop
Seat 6: robertg68 (big blind) folded before Flop


*********** # 43 **************
PokerStars Hand #169425795420: Tournament #1597684008, $13.50+$1.50 USD=
 Hold'em No Limit - Level III (40/80) - 2017/05/05 14:05:10 ET
Table '1597684008 5' 6-max Seat #5 is the button
Seat 1: se3dog (10000 in chips)=20
Seat 2: silverfox749 (6636 in chips)=20
Seat 3: VinnieB118 (9880 in chips)=20
Seat 4: Kauaibaby14 (26738 in chips)=20
Seat 5: JJin91 (18133 in chips)=20
Seat 6: robertg68 (8007 in chips)=20
robertg68: posts small blind 40
se3dog: posts big blind 80
*** HOLE CARDS ***
Dealt to JJin91 [4h Td]
silverfox749: folds=20
VinnieB118: folds=20
Kauaibaby14: calls 80
JJin91: folds=20
robertg68: calls 40
se3dog: checks=20
*** FLOP *** [8h Th Jc]
robertg68: checks=20
se3dog: bets 80
Kauaibaby14: calls 80
robertg68: calls 80
*** TURN *** [8h Th Jc] [2c]
robertg68: checks=20
se3dog: checks=20
Kauaibaby14: checks=20
*** RIVER *** [8h Th Jc 2c] [2s]
robertg68: checks=20
se3dog: checks=20
Kauaibaby14: checks=20
*** SHOW DOWN ***
robertg68: shows [8c 5d] (two pair, Eights and Deuces)
se3dog: shows [6h 8s] (two pair, Eights and Deuces)
Kauaibaby14: mucks hand=20
robertg68 collected 240 from pot
se3dog collected 240 from pot
*** SUMMARY ***
Total pot 480 | Rake 0=20
Board [8h Th Jc 2c 2s]
Seat 1: se3dog (big blind) showed [6h 8s] and won (240) with two pair, =
Eights and Deuces
Seat 2: silverfox749 folded before Flop (didn't bet)
Seat 3: VinnieB118 folded before Flop (didn't bet)
Seat 4: Kauaibaby14 mucked [Qd Kc]
Seat 5: JJin91 (button) folded before Flop (didn't bet)
Seat 6: robertg68 (small blind) showed [8c 5d] and won (240) with two p=
air, Eights and Deuces


*********** # 44 **************
PokerStars Hand #169425795504: Tournament #1597684008, $13.50+$1.50 USD=
 Hold'em No Limit - Level III (40/80) - 2017/05/05 14:05:41 ET
Table '1597684008 5' 6-max Seat #6 is the button
Seat 1: se3dog (10080 in chips)=20
Seat 2: silverfox749 (6636 in chips)=20
Seat 3: VinnieB118 (9880 in chips)=20
Seat 4: Kauaibaby14 (26578 in chips)=20
Seat 5: JJin91 (18133 in chips)=20
Seat 6: robertg68 (8087 in chips)=20
se3dog: posts small blind 40
silverfox749: posts big blind 80
*** HOLE CARDS ***
Dealt to JJin91 [Jc 5s]
VinnieB118: folds=20
Kauaibaby14: folds=20
JJin91: folds=20
robertg68: calls 80
se3dog: calls 40
silverfox749: checks=20
*** FLOP *** [Kh 7s Tc]
se3dog: bets 240
silverfox749: folds=20
robertg68: calls 240
*** TURN *** [Kh 7s Tc] [Js]
se3dog: bets 80
robertg68: calls 80
*** RIVER *** [Kh 7s Tc Js] [Qd]
se3dog: checks=20
robertg68: checks=20
*** SHOW DOWN ***
se3dog: shows [Kc 9c] (a straight, Nine to King)
robertg68: mucks hand=20
se3dog collected 880 from pot
*** SUMMARY ***
Total pot 880 | Rake 0=20
Board [Kh 7s Tc Js Qd]
Seat 1: se3dog (small blind) showed [Kc 9c] and won (880) with a straig=
ht, Nine to King
Seat 2: silverfox749 (big blind) folded on the Flop
Seat 3: VinnieB118 folded before Flop (didn't bet)
Seat 4: Kauaibaby14 folded before Flop (didn't bet)
Seat 5: JJin91 folded before Flop (didn't bet)
Seat 6: robertg68 (button) mucked [Th 4h]


*********** # 45 **************
PokerStars Hand #169425795592: Tournament #1597684008, $13.50+$1.50 USD=
 Hold'em No Limit - Level III (40/80) - 2017/05/05 14:06:18 ET
Table '1597684008 5' 6-max Seat #1 is the button
Seat 1: se3dog (10560 in chips)=20
Seat 2: silverfox749 (6556 in chips)=20
Seat 3: VinnieB118 (9880 in chips)=20
Seat 4: Kauaibaby14 (26578 in chips)=20
Seat 5: JJin91 (18133 in chips)=20
Seat 6: robertg68 (7687 in chips)=20
silverfox749: posts small blind 40
VinnieB118: posts big blind 80
*** HOLE CARDS ***
Dealt to JJin91 [Tc Qc]
Kauaibaby14: folds=20
JJin91: folds=20
robertg68: calls 80
se3dog: calls 80
silverfox749: folds=20
VinnieB118: checks=20
*** FLOP *** [2h 3s Ad]
VinnieB118: checks=20
robertg68: checks=20
se3dog: checks=20
*** TURN *** [2h 3s Ad] [3c]
VinnieB118: checks=20
robertg68: checks=20
se3dog: checks=20
*** RIVER *** [2h 3s Ad 3c] [Td]
VinnieB118: checks=20
robertg68: checks=20
se3dog: checks=20
*** SHOW DOWN ***
VinnieB118: shows [7c 6c] (a pair of Threes)
robertg68: shows [Jh 7d] (a pair of Threes - Ace+Jack kicker)
se3dog: shows [Qs Kh] (a pair of Threes - Ace+King kicker)
se3dog collected 280 from pot
*** SUMMARY ***
Total pot 280 | Rake 0=20
Board [2h 3s Ad 3c Td]
Seat 1: se3dog (button) showed [Qs Kh] and won (280) with a pair of Thr=
ees
Seat 2: silverfox749 (small blind) folded before Flop
Seat 3: VinnieB118 (big blind) showed [7c 6c] and lost with a pair of T=
hrees
Seat 4: Kauaibaby14 folded before Flop (didn't bet)
Seat 5: JJin91 folded before Flop (didn't bet)
Seat 6: robertg68 showed [Jh 7d] and lost with a pair of Threes


*********** # 46 **************
PokerStars Hand #169425795684: Tournament #1597684008, $13.50+$1.50 USD=
 Hold'em No Limit - Level IV (50/100) - 2017/05/05 14:06:59 ET
Table '1597684008 5' 6-max Seat #2 is the button
Seat 1: se3dog (10760 in chips)=20
Seat 2: silverfox749 (6516 in chips)=20
Seat 3: VinnieB118 (9800 in chips)=20
Seat 4: Kauaibaby14 (26578 in chips)=20
Seat 5: JJin91 (18133 in chips)=20
Seat 6: robertg68 (7607 in chips)=20
se3dog: posts the ante 10
silverfox749: posts the ante 10
VinnieB118: posts the ante 10
Kauaibaby14: posts the ante 10
JJin91: posts the ante 10
robertg68: posts the ante 10
VinnieB118: posts small blind 50
Kauaibaby14: posts big blind 100
*** HOLE CARDS ***
Dealt to JJin91 [4s Ks]
JJin91: folds=20
robertg68: folds=20
se3dog: calls 100
silverfox749: raises 250 to 350
VinnieB118: folds=20
Kauaibaby14: folds=20
se3dog: calls 250
*** FLOP *** [Qd 8h 7s]
se3dog: checks=20
silverfox749: bets 683
se3dog: folds=20
Uncalled bet (683) returned to silverfox749
silverfox749 collected 910 from pot
*** SUMMARY ***
Total pot 910 | Rake 0=20
Board [Qd 8h 7s]
Seat 1: se3dog folded on the Flop
Seat 2: silverfox749 (button) collected (910)
Seat 3: VinnieB118 (small blind) folded before Flop
Seat 4: Kauaibaby14 (big blind) folded before Flop
Seat 5: JJin91 folded before Flop (didn't bet)
Seat 6: robertg68 folded before Flop (didn't bet)


*********** # 47 **************
PokerStars Hand #169425795779: Tournament #1597684008, $13.50+$1.50 USD=
 Hold'em No Limit - Level IV (50/100) - 2017/05/05 14:07:39 ET
Table '1597684008 5' 6-max Seat #3 is the button
Seat 1: se3dog (10400 in chips)=20
Seat 2: silverfox749 (7066 in chips)=20
Seat 3: VinnieB118 (9740 in chips)=20
Seat 4: Kauaibaby14 (26468 in chips)=20
Seat 5: JJin91 (18123 in chips)=20
Seat 6: robertg68 (7597 in chips)=20
se3dog: posts the ante 10
silverfox749: posts the ante 10
VinnieB118: posts the ante 10
Kauaibaby14: posts the ante 10
JJin91: posts the ante 10
robertg68: posts the ante 10
Kauaibaby14: posts small blind 50
JJin91: posts big blind 100
*** HOLE CARDS ***
Dealt to JJin91 [Ac 3h]
robertg68: calls 100
se3dog: folds=20
silverfox749: folds=20
VinnieB118: folds=20
Kauaibaby14: calls 50
JJin91: checks=20
*** FLOP *** [5d Js Kd]
Kauaibaby14: checks=20
JJin91: checks=20
robertg68: checks=20
*** TURN *** [5d Js Kd] [8h]
Kauaibaby14: checks=20
JJin91: checks=20
robertg68: checks=20
*** RIVER *** [5d Js Kd 8h] [3d]
Kauaibaby14: checks=20
JJin91: checks=20
robertg68: checks=20
*** SHOW DOWN ***
Kauaibaby14: shows [Qc Th] (high card King)
JJin91: shows [Ac 3h] (a pair of Threes)
robertg68: mucks hand=20
JJin91 collected 360 from pot
*** SUMMARY ***
Total pot 360 | Rake 0=20
Board [5d Js Kd 8h 3d]
Seat 1: se3dog folded before Flop (didn't bet)
Seat 2: silverfox749 folded before Flop (didn't bet)
Seat 3: VinnieB118 (button) folded before Flop (didn't bet)
Seat 4: Kauaibaby14 (small blind) showed [Qc Th] and lost with high car=
d King
Seat 5: JJin91 (big blind) showed [Ac 3h] and won (360) with a pair of =
Threes
Seat 6: robertg68 mucked [Ah Td]


*********** # 48 **************
PokerStars Hand #169425795859: Tournament #1597684008, $13.50+$1.50 USD=
 Hold'em No Limit - Level IV (50/100) - 2017/05/05 14:08:11 ET
Table '1597684008 5' 6-max Seat #4 is the button
Seat 1: se3dog (10390 in chips)=20
Seat 2: silverfox749 (7056 in chips)=20
Seat 3: VinnieB118 (9730 in chips)=20
Seat 4: Kauaibaby14 (26358 in chips)=20
Seat 5: JJin91 (18373 in chips)=20
Seat 6: robertg68 (7487 in chips)=20
se3dog: posts the ante 10
silverfox749: posts the ante 10
VinnieB118: posts the ante 10
Kauaibaby14: posts the ante 10
JJin91: posts the ante 10
robertg68: posts the ante 10
JJin91: posts small blind 50
robertg68: posts big blind 100
*** HOLE CARDS ***
Dealt to JJin91 [8c 5c]
se3dog: calls 100
silverfox749: folds=20
VinnieB118: folds=20
Kauaibaby14: folds=20
JJin91: folds=20
robertg68: checks=20
*** FLOP *** [Js 7h 5d]
robertg68: checks=20
se3dog: checks=20
*** TURN *** [Js 7h 5d] [6d]
robertg68: checks=20
se3dog: bets 100
robertg68: folds=20
Uncalled bet (100) returned to se3dog
se3dog collected 310 from pot
se3dog: doesn't show hand=20
*** SUMMARY ***
Total pot 310 | Rake 0=20
Board [Js 7h 5d 6d]
Seat 1: se3dog collected (310)
Seat 2: silverfox749 folded before Flop (didn't bet)
Seat 3: VinnieB118 folded before Flop (didn't bet)
Seat 4: Kauaibaby14 (button) folded before Flop (didn't bet)
Seat 5: JJin91 (small blind) folded before Flop
Seat 6: robertg68 (big blind) folded on the Turn


*********** # 49 **************
PokerStars Hand #169425795962: Tournament #1597684008, $13.50+$1.50 USD=
 Hold'em No Limit - Level IV (50/100) - 2017/05/05 14:08:50 ET
Table '1597684008 5' 6-max Seat #5 is the button
Seat 1: se3dog (10590 in chips)=20
Seat 2: silverfox749 (7046 in chips)=20
Seat 3: VinnieB118 (9720 in chips)=20
Seat 4: Kauaibaby14 (26348 in chips)=20
Seat 5: JJin91 (18313 in chips)=20
Seat 6: robertg68 (7377 in chips)=20
se3dog: posts the ante 10
silverfox749: posts the ante 10
VinnieB118: posts the ante 10
Kauaibaby14: posts the ante 10
JJin91: posts the ante 10
robertg68: posts the ante 10
robertg68: posts small blind 50
se3dog: posts big blind 100
*** HOLE CARDS ***
Dealt to JJin91 [Qh 2h]
silverfox749: folds=20
VinnieB118: folds=20
Kauaibaby14: calls 100
JJin91: folds=20
robertg68: calls 50
se3dog: checks=20
*** FLOP *** [Td Th Ts]
robertg68: checks=20
se3dog: checks=20
Kauaibaby14: checks=20
*** TURN *** [Td Th Ts] [9h]
robertg68: checks=20
se3dog: bets 100
Kauaibaby14: calls 100
robertg68: folds=20
*** RIVER *** [Td Th Ts 9h] [3c]
se3dog: bets 100
Kauaibaby14: calls 100
*** SHOW DOWN ***
se3dog: shows [6d 9s] (a full house, Tens full of Nines)
Kauaibaby14: shows [Ac 9c] (a full house, Tens full of Nines)
se3dog collected 380 from pot
Kauaibaby14 collected 380 from pot
*** SUMMARY ***
Total pot 760 | Rake 0=20
Board [Td Th Ts 9h 3c]
Seat 1: se3dog (big blind) showed [6d 9s] and won (380) with a full hou=
se, Tens full of Nines
Seat 2: silverfox749 folded before Flop (didn't bet)
Seat 3: VinnieB118 folded before Flop (didn't bet)
Seat 4: Kauaibaby14 showed [Ac 9c] and won (380) with a full house, Ten=
s full of Nines
Seat 5: JJin91 (button) folded before Flop (didn't bet)
Seat 6: robertg68 (small blind) folded on the Turn


*********** # 50 **************
PokerStars Hand #169425796056: Tournament #1597684008, $13.50+$1.50 USD=
 Hold'em No Limit - Level IV (50/100) - 2017/05/05 14:09:21 ET
Table '1597684008 5' 6-max Seat #6 is the button
Seat 1: se3dog (10660 in chips)=20
Seat 2: silverfox749 (7036 in chips)=20
Seat 3: VinnieB118 (9710 in chips)=20
Seat 4: Kauaibaby14 (26418 in chips)=20
Seat 5: JJin91 (18303 in chips)=20
Seat 6: robertg68 (7267 in chips)=20
se3dog: posts the ante 10
silverfox749: posts the ante 10
VinnieB118: posts the ante 10
Kauaibaby14: posts the ante 10
JJin91: posts the ante 10
robertg68: posts the ante 10
se3dog: posts small blind 50
silverfox749: posts big blind 100
*** HOLE CARDS ***
Dealt to JJin91 [Ac 2d]
VinnieB118: folds=20
Kauaibaby14: folds=20
JJin91: folds=20
robertg68: raises 200 to 300
se3dog: folds=20
silverfox749: folds=20
Uncalled bet (200) returned to robertg68
robertg68 collected 310 from pot
*** SUMMARY ***
Total pot 310 | Rake 0=20
Seat 1: se3dog (small blind) folded before Flop
Seat 2: silverfox749 (big blind) folded before Flop
Seat 3: VinnieB118 folded before Flop (didn't bet)
Seat 4: Kauaibaby14 folded before Flop (didn't bet)
Seat 5: JJin91 folded before Flop (didn't bet)
Seat 6: robertg68 (button) collected (310)


*********** # 51 **************
PokerStars Hand #169425796116: Tournament #1597684008, $13.50+$1.50 USD=
 Hold'em No Limit - Level IV (50/100) - 2017/05/05 14:09:37 ET
Table '1597684008 5' 6-max Seat #1 is the button
Seat 1: se3dog (10600 in chips)=20
Seat 2: silverfox749 (6926 in chips)=20
Seat 3: VinnieB118 (9700 in chips)=20
Seat 4: Kauaibaby14 (26408 in chips)=20
Seat 5: JJin91 (18293 in chips)=20
Seat 6: robertg68 (7467 in chips)=20
se3dog: posts the ante 10
silverfox749: posts the ante 10
VinnieB118: posts the ante 10
Kauaibaby14: posts the ante 10
JJin91: posts the ante 10
robertg68: posts the ante 10
silverfox749: posts small blind 50
VinnieB118: posts big blind 100
*** HOLE CARDS ***
Dealt to JJin91 [7s 4s]
Kauaibaby14: folds=20
JJin91: folds=20
robertg68: calls 100
se3dog: folds=20
silverfox749: calls 50
VinnieB118: checks=20
*** FLOP *** [Js Jd Ts]
silverfox749: bets 270
VinnieB118: folds=20
robertg68: folds=20
Uncalled bet (270) returned to silverfox749
silverfox749 collected 360 from pot
silverfox749: doesn't show hand=20
*** SUMMARY ***
Total pot 360 | Rake 0=20
Board [Js Jd Ts]
Seat 1: se3dog (button) folded before Flop (didn't bet)
Seat 2: silverfox749 (small blind) collected (360)
Seat 3: VinnieB118 (big blind) folded on the Flop
Seat 4: Kauaibaby14 folded before Flop (didn't bet)
Seat 5: JJin91 folded before Flop (didn't bet)
Seat 6: robertg68 folded on the Flop


*********** # 52 **************
PokerStars Hand #169425796171: Tournament #1597684008, $13.50+$1.50 USD=
 Hold'em No Limit - Level IV (50/100) - 2017/05/05 14:09:57 ET
Table '1597684008 5' 6-max Seat #2 is the button
Seat 1: se3dog (10590 in chips)=20
Seat 2: silverfox749 (7176 in chips)=20
Seat 3: VinnieB118 (9590 in chips)=20
Seat 4: Kauaibaby14 (26398 in chips)=20
Seat 5: JJin91 (18283 in chips)=20
Seat 6: robertg68 (7357 in chips)=20
se3dog: posts the ante 10
silverfox749: posts the ante 10
VinnieB118: posts the ante 10
Kauaibaby14: posts the ante 10
JJin91: posts the ante 10
robertg68: posts the ante 10
VinnieB118: posts small blind 50
Kauaibaby14: posts big blind 100
*** HOLE CARDS ***
Dealt to JJin91 [9h 2d]
JJin91: folds=20
robertg68: folds=20
se3dog: folds=20
silverfox749: raises 100 to 200
VinnieB118: folds=20
Kauaibaby14: calls 100
*** FLOP *** [8h Jc 2s]
Kauaibaby14: checks=20
silverfox749: checks=20
*** TURN *** [8h Jc 2s] [Qh]
Kauaibaby14: checks=20
silverfox749: bets 383
Kauaibaby14: folds=20
Uncalled bet (383) returned to silverfox749
silverfox749 collected 510 from pot
silverfox749: doesn't show hand=20
*** SUMMARY ***
Total pot 510 | Rake 0=20
Board [8h Jc 2s Qh]
Seat 1: se3dog folded before Flop (didn't bet)
Seat 2: silverfox749 (button) collected (510)
Seat 3: VinnieB118 (small blind) folded before Flop
Seat 4: Kauaibaby14 (big blind) folded on the Turn
Seat 5: JJin91 folded before Flop (didn't bet)
Seat 6: robertg68 folded before Flop (didn't bet)


*********** # 53 **************
PokerStars Hand #169425796239: Tournament #1597684008, $13.50+$1.50 USD=
 Hold'em No Limit - Level IV (50/100) - 2017/05/05 14:10:18 ET
Table '1597684008 5' 6-max Seat #3 is the button
Seat 1: se3dog (10580 in chips)=20
Seat 2: silverfox749 (7476 in chips)=20
Seat 3: VinnieB118 (9530 in chips)=20
Seat 4: Kauaibaby14 (26188 in chips)=20
Seat 5: JJin91 (18273 in chips)=20
Seat 6: robertg68 (7347 in chips)=20
se3dog: posts the ante 10
silverfox749: posts the ante 10
VinnieB118: posts the ante 10
Kauaibaby14: posts the ante 10
JJin91: posts the ante 10
robertg68: posts the ante 10
Kauaibaby14: posts small blind 50
JJin91: posts big blind 100
*** HOLE CARDS ***
Dealt to JJin91 [Qs 3d]
robertg68: calls 100
se3dog: folds=20
silverfox749: raises 250 to 350
VinnieB118: folds=20
Kauaibaby14: folds=20
JJin91: folds=20
robertg68: calls 250
*** FLOP *** [8h Jc 5s]
robertg68: checks=20
silverfox749: bets 910
robertg68: folds=20
Uncalled bet (910) returned to silverfox749
silverfox749 collected 910 from pot
silverfox749: doesn't show hand=20
*** SUMMARY ***
Total pot 910 | Rake 0=20
Board [8h Jc 5s]
Seat 1: se3dog folded before Flop (didn't bet)
Seat 2: silverfox749 collected (910)
Seat 3: VinnieB118 (button) folded before Flop (didn't bet)
Seat 4: Kauaibaby14 (small blind) folded before Flop
Seat 5: JJin91 (big blind) folded before Flop
Seat 6: robertg68 folded on the Flop


*********** # 54 **************
PokerStars Hand #169425796299: Tournament #1597684008, $13.50+$1.50 USD=
 Hold'em No Limit - Level IV (50/100) - 2017/05/05 14:10:39 ET
Table '1597684008 5' 6-max Seat #4 is the button
Seat 1: se3dog (10570 in chips)=20
Seat 2: silverfox749 (8026 in chips)=20
Seat 3: VinnieB118 (9520 in chips)=20
Seat 4: Kauaibaby14 (26128 in chips)=20
Seat 5: JJin91 (18163 in chips)=20
Seat 6: robertg68 (6987 in chips)=20
se3dog: posts the ante 10
silverfox749: posts the ante 10
VinnieB118: posts the ante 10
Kauaibaby14: posts the ante 10
JJin91: posts the ante 10
robertg68: posts the ante 10
JJin91: posts small blind 50
robertg68: posts big blind 100
*** HOLE CARDS ***
Dealt to JJin91 [8d Tc]
se3dog: folds=20
silverfox749: folds=20
VinnieB118: folds=20
Kauaibaby14: folds=20
JJin91: folds=20
Uncalled bet (50) returned to robertg68
robertg68 collected 160 from pot
*** SUMMARY ***
Total pot 160 | Rake 0=20
Seat 1: se3dog folded before Flop (didn't bet)
Seat 2: silverfox749 folded before Flop (didn't bet)
Seat 3: VinnieB118 folded before Flop (didn't bet)
Seat 4: Kauaibaby14 (button) folded before Flop (didn't bet)
Seat 5: JJin91 (small blind) folded before Flop
Seat 6: robertg68 (big blind) collected (160)


*********** # 55 **************
PokerStars Hand #169425796332: Tournament #1597684008, $13.50+$1.50 USD=
 Hold'em No Limit - Level IV (50/100) - 2017/05/05 14:10:49 ET
Table '1597684008 5' 6-max Seat #5 is the button
Seat 1: se3dog (10560 in chips)=20
Seat 2: silverfox749 (8016 in chips)=20
Seat 3: VinnieB118 (9510 in chips)=20
Seat 4: Kauaibaby14 (26118 in chips)=20
Seat 5: JJin91 (18103 in chips)=20
Seat 6: robertg68 (7087 in chips)=20
se3dog: posts the ante 10
silverfox749: posts the ante 10
VinnieB118: posts the ante 10
Kauaibaby14: posts the ante 10
JJin91: posts the ante 10
robertg68: posts the ante 10
robertg68: posts small blind 50
se3dog: posts big blind 100
*** HOLE CARDS ***
Dealt to JJin91 [Tc 6h]
silverfox749: folds=20
VinnieB118: folds=20
Kauaibaby14: folds=20
JJin91: raises 200 to 300
robertg68: folds=20
se3dog: calls 200
*** FLOP *** [Js 2s 5d]
se3dog: checks=20
JJin91: bets 300
se3dog: folds=20
Uncalled bet (300) returned to JJin91
JJin91 collected 710 from pot
*** SUMMARY ***
Total pot 710 | Rake 0=20
Board [Js 2s 5d]
Seat 1: se3dog (big blind) folded on the Flop
Seat 2: silverfox749 folded before Flop (didn't bet)
Seat 3: VinnieB118 folded before Flop (didn't bet)
Seat 4: Kauaibaby14 folded before Flop (didn't bet)
Seat 5: JJin91 (button) collected (710)
Seat 6: robertg68 (small blind) folded before Flop


*********** # 56 **************
PokerStars Hand #169425796410: Tournament #1597684008, $13.50+$1.50 USD=
 Hold'em No Limit - Level IV (50/100) - 2017/05/05 14:11:18 ET
Table '1597684008 5' 6-max Seat #6 is the button
Seat 1: se3dog (10250 in chips)=20
Seat 2: silverfox749 (8006 in chips)=20
Seat 3: VinnieB118 (9500 in chips)=20
Seat 4: Kauaibaby14 (26108 in chips)=20
Seat 5: JJin91 (18503 in chips)=20
Seat 6: robertg68 (7027 in chips)=20
se3dog: posts the ante 10
silverfox749: posts the ante 10
VinnieB118: posts the ante 10
Kauaibaby14: posts the ante 10
JJin91: posts the ante 10
robertg68: posts the ante 10
se3dog: posts small blind 50
silverfox749: posts big blind 100
*** HOLE CARDS ***
Dealt to JJin91 [3c 3s]
VinnieB118: folds=20
Kauaibaby14: folds=20
JJin91: calls 100
robertg68: calls 100
se3dog: calls 50
silverfox749: checks=20
*** FLOP *** [Jh 4s 5h]
se3dog: checks=20
silverfox749: checks=20
JJin91: checks=20
robertg68: bets 100
se3dog: folds=20
silverfox749: folds=20
JJin91: calls 100
*** TURN *** [Jh 4s 5h] [4h]
JJin91: checks=20
robertg68: checks=20
*** RIVER *** [Jh 4s 5h 4h] [9c]
JJin91: bets 400
robertg68: calls 400
*** SHOW DOWN ***
JJin91: shows [3c 3s] (two pair, Fours and Threes)
robertg68: shows [Js Qs] (two pair, Jacks and Fours)
robertg68 collected 1460 from pot
*** SUMMARY ***
Total pot 1460 | Rake 0=20
Board [Jh 4s 5h 4h 9c]
Seat 1: se3dog (small blind) folded on the Flop
Seat 2: silverfox749 (big blind) folded on the Flop
Seat 3: VinnieB118 folded before Flop (didn't bet)
Seat 4: Kauaibaby14 folded before Flop (didn't bet)
Seat 5: JJin91 showed [3c 3s] and lost with two pair, Fours and Threes
Seat 6: robertg68 (button) showed [Js Qs] and won (1460) with two pair,=
 Jacks and Fours


*********** # 57 **************
PokerStars Hand #169425796546: Tournament #1597684008, $13.50+$1.50 USD=
 Hold'em No Limit - Level IV (50/100) - 2017/05/05 14:12:03 ET
Table '1597684008 5' 6-max Seat #1 is the button
Seat 1: se3dog (10140 in chips)=20
Seat 2: silverfox749 (7896 in chips)=20
Seat 3: VinnieB118 (9490 in chips)=20
Seat 4: Kauaibaby14 (26098 in chips)=20
Seat 5: JJin91 (17893 in chips)=20
Seat 6: robertg68 (7877 in chips)=20
se3dog: posts the ante 10
silverfox749: posts the ante 10
VinnieB118: posts the ante 10
Kauaibaby14: posts the ante 10
JJin91: posts the ante 10
robertg68: posts the ante 10
silverfox749: posts small blind 50
VinnieB118: posts big blind 100
*** HOLE CARDS ***
Dealt to JJin91 [4h 2d]
Kauaibaby14: folds=20
JJin91: folds=20
robertg68: folds=20
se3dog: folds=20
silverfox749: folds=20
Uncalled bet (50) returned to VinnieB118
VinnieB118 collected 160 from pot
VinnieB118: doesn't show hand=20
*** SUMMARY ***
Total pot 160 | Rake 0=20
Seat 1: se3dog (button) folded before Flop (didn't bet)
Seat 2: silverfox749 (small blind) folded before Flop
Seat 3: VinnieB118 (big blind) collected (160)
Seat 4: Kauaibaby14 folded before Flop (didn't bet)
Seat 5: JJin91 folded before Flop (didn't bet)
Seat 6: robertg68 folded before Flop (didn't bet)


*********** # 58 **************
PokerStars Hand #169425796582: Tournament #1597684008, $13.50+$1.50 USD=
 Hold'em No Limit - Level IV (50/100) - 2017/05/05 14:12:18 ET
Table '1597684008 5' 6-max Seat #2 is the button
Seat 1: se3dog (10130 in chips)=20
Seat 2: silverfox749 (7836 in chips)=20
Seat 3: VinnieB118 (9590 in chips)=20
Seat 4: Kauaibaby14 (26088 in chips)=20
Seat 5: JJin91 (17883 in chips)=20
Seat 6: robertg68 (7867 in chips)=20
se3dog: posts the ante 10
silverfox749: posts the ante 10
VinnieB118: posts the ante 10
Kauaibaby14: posts the ante 10
JJin91: posts the ante 10
robertg68: posts the ante 10
VinnieB118: posts small blind 50
Kauaibaby14: posts big blind 100
*** HOLE CARDS ***
Dealt to JJin91 [5h As]
JJin91: folds=20
robertg68: calls 100
se3dog: folds=20
silverfox749: folds=20
VinnieB118: folds=20
Kauaibaby14: checks=20
*** FLOP *** [6h 5c Qh]
Kauaibaby14: checks=20
robertg68: checks=20
*** TURN *** [6h 5c Qh] [8d]
Kauaibaby14: bets 300
robertg68: folds=20
Uncalled bet (300) returned to Kauaibaby14
Kauaibaby14 collected 310 from pot
Kauaibaby14: doesn't show hand=20
*** SUMMARY ***
Total pot 310 | Rake 0=20
Board [6h 5c Qh 8d]
Seat 1: se3dog folded before Flop (didn't bet)
Seat 2: silverfox749 (button) folded before Flop (didn't bet)
Seat 3: VinnieB118 (small blind) folded before Flop
Seat 4: Kauaibaby14 (big blind) collected (310)
Seat 5: JJin91 folded before Flop (didn't bet)
Seat 6: robertg68 folded on the Turn


*********** # 59 **************
PokerStars Hand #169425796683: Tournament #1597684008, $13.50+$1.50 USD=
 Hold'em No Limit - Level IV (50/100) - 2017/05/05 14:12:55 ET
Table '1597684008 3' 6-max Seat #5 is the button
Seat 1: JJin91 (17873 in chips)=20
Seat 3: romogarg (20377 in chips)=20
Seat 4: lilmikey321 (17291 in chips)=20
Seat 5: TIUQ~I (11803 in chips)=20
Seat 6: rre6 (10370 in chips)=20
JJin91: posts the ante 10
romogarg: posts the ante 10
lilmikey321: posts the ante 10
TIUQ~I: posts the ante 10
rre6: posts the ante 10
rre6: posts small blind 50
JJin91: posts big blind 100
*** HOLE CARDS ***
Dealt to JJin91 [3h 6s]
romogarg: folds=20
lilmikey321: raises 200 to 300
TIUQ~I: folds=20
rre6: folds=20
JJin91: folds=20
Uncalled bet (200) returned to lilmikey321
lilmikey321 collected 300 from pot
lilmikey321: doesn't show hand=20
*** SUMMARY ***
Total pot 300 | Rake 0=20
Seat 1: JJin91 (big blind) folded before Flop
Seat 3: romogarg folded before Flop (didn't bet)
Seat 4: lilmikey321 collected (300)
Seat 5: TIUQ~I (button) folded before Flop (didn't bet)
Seat 6: rre6 (small blind) folded before Flop


*********** # 60 **************
PokerStars Hand #169425796728: Tournament #1597684008, $13.50+$1.50 USD=
 Hold'em No Limit - Level IV (50/100) - 2017/05/05 14:13:10 ET
Table '1597684008 3' 6-max Seat #6 is the button
Seat 1: JJin91 (17763 in chips)=20
Seat 3: romogarg (20367 in chips)=20
Seat 4: lilmikey321 (17481 in chips)=20
Seat 5: TIUQ~I (11793 in chips)=20
Seat 6: rre6 (10310 in chips)=20
JJin91: posts the ante 10
romogarg: posts the ante 10
lilmikey321: posts the ante 10
TIUQ~I: posts the ante 10
rre6: posts the ante 10
JJin91: posts small blind 50
romogarg: posts big blind 100
*** HOLE CARDS ***
Dealt to JJin91 [8s Qc]
lilmikey321: calls 100
TIUQ~I: folds=20
rre6: raises 300 to 400
JJin91: folds=20
romogarg: folds=20
lilmikey321: calls 300
*** FLOP *** [4s 4c 7c]
lilmikey321: checks=20
rre6: bets 500
lilmikey321: raises 4400 to 4900
rre6: raises 5000 to 9900 and is all-in
lilmikey321: calls 5000
*** TURN *** [4s 4c 7c] [8c]
*** RIVER *** [4s 4c 7c 8c] [Kc]
*** SHOW DOWN ***
lilmikey321: shows [9s 9c] (a flush, King high)
rre6: shows [Jd Js] (two pair, Jacks and Fours)
lilmikey321 collected 20800 from pot
rre6 finished the tournament in 99th place
*** SUMMARY ***
Total pot 20800 | Rake 0=20
Board [4s 4c 7c 8c Kc]
Seat 1: JJin91 (small blind) folded before Flop
Seat 3: romogarg (big blind) folded before Flop
Seat 4: lilmikey321 showed [9s 9c] and won (20800) with a flush, King h=
igh
Seat 5: TIUQ~I folded before Flop (didn't bet)
Seat 6: rre6 (button) showed [Jd Js] and lost with two pair, Jacks and =
Fours


*********** # 61 **************
PokerStars Hand #169425796826: Tournament #1597684008, $13.50+$1.50 USD=
 Hold'em No Limit - Level IV (50/100) - 2017/05/05 14:13:45 ET
Table '1597684008 3' 6-max Seat #1 is the button
Seat 1: JJin91 (17703 in chips)=20
Seat 3: romogarg (20257 in chips)=20
Seat 4: lilmikey321 (27971 in chips)=20
Seat 5: TIUQ~I (11783 in chips)=20
JJin91: posts the ante 10
romogarg: posts the ante 10
lilmikey321: posts the ante 10
TIUQ~I: posts the ante 10
romogarg: posts small blind 50
lilmikey321: posts big blind 100
*** HOLE CARDS ***
Dealt to JJin91 [3c 3h]
TIUQ~I: folds=20
JJin91: raises 200 to 300
romogarg: folds=20
lilmikey321: calls 200
*** FLOP *** [5h 7h 4s]
lilmikey321: bets 2200
JJin91: folds=20
Uncalled bet (2200) returned to lilmikey321
lilmikey321 collected 690 from pot
lilmikey321: doesn't show hand=20
*** SUMMARY ***
Total pot 690 | Rake 0=20
Board [5h 7h 4s]
Seat 1: JJin91 (button) folded on the Flop
Seat 3: romogarg (small blind) folded before Flop
Seat 4: lilmikey321 (big blind) collected (690)
Seat 5: TIUQ~I folded before Flop (didn't bet)


*********** # 62 **************
PokerStars Hand #169425796931: Tournament #1597684008, $13.50+$1.50 USD=
 Hold'em No Limit - Level IV (50/100) - 2017/05/05 14:14:23 ET
Table '1597684008 3' 6-max Seat #3 is the button
Seat 1: JJin91 (17393 in chips)=20
Seat 3: romogarg (20197 in chips)=20
Seat 4: lilmikey321 (28351 in chips)=20
Seat 5: TIUQ~I (11773 in chips)=20
Seat 6: SquadooshBag (12115 in chips)=20
JJin91: posts the ante 10
romogarg: posts the ante 10
lilmikey321: posts the ante 10
TIUQ~I: posts the ante 10
SquadooshBag: posts the ante 10
lilmikey321: posts small blind 50
TIUQ~I: posts big blind 100
*** HOLE CARDS ***
Dealt to JJin91 [Qs 8h]
SquadooshBag: calls 100
JJin91: folds=20
romogarg: folds=20
lilmikey321: calls 50
TIUQ~I: checks=20
*** FLOP *** [3d 3h 2h]
lilmikey321: checks=20
TIUQ~I: bets 200
SquadooshBag: folds=20
lilmikey321: folds=20
Uncalled bet (200) returned to TIUQ~I
TIUQ~I collected 350 from pot
TIUQ~I: doesn't show hand=20
*** SUMMARY ***
Total pot 350 | Rake 0=20
Board [3d 3h 2h]
Seat 1: JJin91 folded before Flop (didn't bet)
Seat 3: romogarg (button) folded before Flop (didn't bet)
Seat 4: lilmikey321 (small blind) folded on the Flop
Seat 5: TIUQ~I (big blind) collected (350)
Seat 6: SquadooshBag folded on the Flop


*********** # 63 **************
PokerStars Hand #169425797056: Tournament #1597684008, $13.50+$1.50 USD=
 Hold'em No Limit - Level IV (50/100) - 2017/05/05 14:15:13 ET
Table '1597684008 3' 6-max Seat #4 is the button
Seat 1: JJin91 (17383 in chips)=20
Seat 3: romogarg (20187 in chips)=20
Seat 4: lilmikey321 (28241 in chips)=20
Seat 5: TIUQ~I (12013 in chips)=20
Seat 6: SquadooshBag (12005 in chips)=20
JJin91: posts the ante 10
romogarg: posts the ante 10
lilmikey321: posts the ante 10
TIUQ~I: posts the ante 10
SquadooshBag: posts the ante 10
TIUQ~I: posts small blind 50
SquadooshBag: posts big blind 100
*** HOLE CARDS ***
Dealt to JJin91 [3s 9s]
JJin91: folds=20
romogarg: calls 100
lilmikey321: folds=20
TIUQ~I: raises 100 to 200
SquadooshBag is disconnected=20
SquadooshBag is connected=20
SquadooshBag: calls 100
romogarg: raises 650 to 850
TIUQ~I: folds=20
SquadooshBag: folds=20
Uncalled bet (650) returned to romogarg
romogarg collected 650 from pot
romogarg: doesn't show hand=20
*** SUMMARY ***
Total pot 650 | Rake 0=20
Seat 1: JJin91 folded before Flop (didn't bet)
Seat 3: romogarg collected (650)
Seat 4: lilmikey321 (button) folded before Flop (didn't bet)
Seat 5: TIUQ~I (small blind) folded before Flop
Seat 6: SquadooshBag (big blind) folded before Flop


*********** # 64 **************
PokerStars Hand #169425797229: Tournament #1597684008, $13.50+$1.50 USD=
 Hold'em No Limit - Level IV (50/100) - 2017/05/05 14:16:21 ET
Table '1597684008 3' 6-max Seat #5 is the button
Seat 1: JJin91 (17373 in chips)=20
Seat 3: romogarg (20627 in chips)=20
Seat 4: lilmikey321 (28231 in chips)=20
Seat 5: TIUQ~I (11803 in chips)=20
Seat 6: SquadooshBag (11795 in chips)=20
JJin91: posts the ante 10
romogarg: posts the ante 10
lilmikey321: posts the ante 10
TIUQ~I: posts the ante 10
SquadooshBag: posts the ante 10
SquadooshBag: posts small blind 50
JJin91: posts big blind 100
*** HOLE CARDS ***
Dealt to JJin91 [5s 5h]
romogarg: raises 100 to 200
lilmikey321: calls 200
TIUQ~I: folds=20
SquadooshBag: calls 150
JJin91: calls 100
*** FLOP *** [2s Ks 2h]
SquadooshBag: checks=20
JJin91: bets 500
romogarg: calls 500
lilmikey321: calls 500
SquadooshBag: folds=20
*** TURN *** [2s Ks 2h] [4d]
JJin91: checks=20
romogarg: checks=20
lilmikey321: checks=20
*** RIVER *** [2s Ks 2h 4d] [7d]
JJin91: checks=20
romogarg: bets 1175
lilmikey321: calls 1175
JJin91: folds=20
*** SHOW DOWN ***
romogarg: shows [Kc 8c] (two pair, Kings and Deuces)
lilmikey321: shows [Js Kd] (two pair, Kings and Deuces - Jack kicker)
lilmikey321 collected 4700 from pot
*** SUMMARY ***
Total pot 4700 | Rake 0=20
Board [2s Ks 2h 4d 7d]
Seat 1: JJin91 (big blind) folded on the River
Seat 3: romogarg showed [Kc 8c] and lost with two pair, Kings and Deuces
Seat 4: lilmikey321 showed [Js Kd] and won (4700) with two pair, Kings =
and Deuces
Seat 5: TIUQ~I (button) folded before Flop (didn't bet)
Seat 6: SquadooshBag (small blind) folded on the Flop


*********** # 65 **************
PokerStars Hand #169425797421: Tournament #1597684008, $13.50+$1.50 USD=
 Hold'em No Limit - Level V (60/120) - 2017/05/05 14:17:28 ET
Table '1597684008 3' 6-max Seat #6 is the button
Seat 1: JJin91 (16663 in chips)=20
Seat 2: SAFTB24 (10000 in chips)=20
Seat 3: romogarg (18742 in chips)=20
Seat 4: lilmikey321 (31046 in chips)=20
Seat 5: TIUQ~I (11793 in chips)=20
Seat 6: SquadooshBag (11585 in chips)=20
JJin91: posts the ante 15
SAFTB24: posts the ante 15
romogarg: posts the ante 15
lilmikey321: posts the ante 15
TIUQ~I: posts the ante 15
SquadooshBag: posts the ante 15
JJin91: posts small blind 60
SAFTB24: posts big blind 120
*** HOLE CARDS ***
Dealt to JJin91 [Tc As]
romogarg: raises 120 to 240
lilmikey321: folds=20
TIUQ~I: folds=20
SquadooshBag: folds=20
JJin91: folds=20
SAFTB24: calls 120
*** FLOP *** [Qs Qd 3s]
SAFTB24: checks=20
romogarg: bets 630
SAFTB24: folds=20
Uncalled bet (630) returned to romogarg
romogarg collected 630 from pot
romogarg: doesn't show hand=20
*** SUMMARY ***
Total pot 630 | Rake 0=20
Board [Qs Qd 3s]
Seat 1: JJin91 (small blind) folded before Flop
Seat 2: SAFTB24 (big blind) folded on the Flop
Seat 3: romogarg collected (630)
Seat 4: lilmikey321 folded before Flop (didn't bet)
Seat 5: TIUQ~I folded before Flop (didn't bet)
Seat 6: SquadooshBag (button) folded before Flop (didn't bet)


*********** # 66 **************
PokerStars Hand #169425797555: Tournament #1597684008, $13.50+$1.50 USD=
 Hold'em No Limit - Level V (60/120) - 2017/05/05 14:18:13 ET
Table '1597684008 3' 6-max Seat #1 is the button
Seat 1: JJin91 (16588 in chips)=20
Seat 2: SAFTB24 (9745 in chips)=20
Seat 3: romogarg (19117 in chips)=20
Seat 4: lilmikey321 (31031 in chips)=20
Seat 5: TIUQ~I (11778 in chips)=20
Seat 6: SquadooshBag (11570 in chips)=20
JJin91: posts the ante 15
SAFTB24: posts the ante 15
romogarg: posts the ante 15
lilmikey321: posts the ante 15
TIUQ~I: posts the ante 15
SquadooshBag: posts the ante 15
SAFTB24: posts small blind 60
romogarg: posts big blind 120
*** HOLE CARDS ***
Dealt to JJin91 [4c 5d]
lilmikey321: calls 120
TIUQ~I: raises 120 to 240
SquadooshBag: folds=20
JJin91: folds=20
SAFTB24: calls 180
romogarg: folds=20
lilmikey321: calls 120
*** FLOP *** [Jc Qc 2d]
SAFTB24: checks=20
lilmikey321: checks=20
TIUQ~I: bets 465
SAFTB24: folds=20
lilmikey321: folds=20
Uncalled bet (465) returned to TIUQ~I
TIUQ~I collected 930 from pot
TIUQ~I: doesn't show hand=20
*** SUMMARY ***
Total pot 930 | Rake 0=20
Board [Jc Qc 2d]
Seat 1: JJin91 (button) folded before Flop (didn't bet)
Seat 2: SAFTB24 (small blind) folded on the Flop
Seat 3: romogarg (big blind) folded before Flop
Seat 4: lilmikey321 folded on the Flop
Seat 5: TIUQ~I collected (930)
Seat 6: SquadooshBag folded before Flop (didn't bet)


*********** # 67 **************
PokerStars Hand #169425797670: Tournament #1597684008, $13.50+$1.50 USD=
 Hold'em No Limit - Level V (60/120) - 2017/05/05 14:19:03 ET
Table '1597684008 3' 6-max Seat #2 is the button
Seat 1: JJin91 (16573 in chips)=20
Seat 2: SAFTB24 (9490 in chips)=20
Seat 3: romogarg (18982 in chips)=20
Seat 4: lilmikey321 (30776 in chips)=20
Seat 5: TIUQ~I (12453 in chips)=20
Seat 6: SquadooshBag (11555 in chips)=20
JJin91: posts the ante 15
SAFTB24: posts the ante 15
romogarg: posts the ante 15
lilmikey321: posts the ante 15
TIUQ~I: posts the ante 15
SquadooshBag: posts the ante 15
romogarg: posts small blind 60
lilmikey321: posts big blind 120
*** HOLE CARDS ***
Dealt to JJin91 [6h Th]
TIUQ~I: folds=20
SquadooshBag: calls 120
JJin91: folds=20
SAFTB24: raises 240 to 360
romogarg: folds=20
lilmikey321: calls 240
SquadooshBag: calls 240
*** FLOP *** [9d 2s 2d]
lilmikey321: checks=20
SquadooshBag: bets 120
SAFTB24: raises 600 to 720
lilmikey321: calls 720
SquadooshBag: calls 600
*** TURN *** [9d 2s 2d] [5c]
lilmikey321: checks=20
SquadooshBag: checks=20
SAFTB24: bets 2040
lilmikey321: calls 2040
SquadooshBag: calls 2040
*** RIVER *** [9d 2s 2d 5c] [Js]
lilmikey321: checks=20
SquadooshBag: bets 8420 and is all-in
SAFTB24: folds=20
lilmikey321: folds=20
Uncalled bet (8420) returned to SquadooshBag
SquadooshBag collected 9510 from pot
SquadooshBag: doesn't show hand=20
*** SUMMARY ***
Total pot 9510 | Rake 0=20
Board [9d 2s 2d 5c Js]
Seat 1: JJin91 folded before Flop (didn't bet)
Seat 2: SAFTB24 (button) folded on the River
Seat 3: romogarg (small blind) folded before Flop
Seat 4: lilmikey321 (big blind) folded on the River
Seat 5: TIUQ~I folded before Flop (didn't bet)
Seat 6: SquadooshBag collected (9510)


*********** # 68 **************
PokerStars Hand #169425797886: Tournament #1597684008, $13.50+$1.50 USD=
 Hold'em No Limit - Level V (60/120) - 2017/05/05 14:20:37 ET
Table '1597684008 3' 6-max Seat #3 is the button
Seat 1: JJin91 (16558 in chips)=20
Seat 2: SAFTB24 (6355 in chips)=20
Seat 3: romogarg (18907 in chips)=20
Seat 4: lilmikey321 (27641 in chips)=20
Seat 5: TIUQ~I (12438 in chips)=20
Seat 6: SquadooshBag (17930 in chips)=20
JJin91: posts the ante 15
SAFTB24: posts the ante 15
romogarg: posts the ante 15
lilmikey321: posts the ante 15
TIUQ~I: posts the ante 15
SquadooshBag: posts the ante 15
lilmikey321: posts small blind 60
TIUQ~I: posts big blind 120
*** HOLE CARDS ***
Dealt to JJin91 [6d 7s]
SquadooshBag: calls 120
JJin91: folds=20
SAFTB24: calls 120
romogarg: calls 120
lilmikey321: calls 60
TIUQ~I: checks=20
*** FLOP *** [Jd Ad Ks]
lilmikey321: bets 120
TIUQ~I: calls 120
SquadooshBag: calls 120
SAFTB24: calls 120
romogarg: calls 120
*** TURN *** [Jd Ad Ks] [7c]
lilmikey321: checks=20
TIUQ~I: checks=20
SquadooshBag: bets 120
SAFTB24: calls 120
romogarg: calls 120
lilmikey321: calls 120
TIUQ~I: calls 120
*** RIVER *** [Jd Ad Ks 7c] [3c]
lilmikey321: checks=20
TIUQ~I: bets 480
SquadooshBag: folds=20
SAFTB24: folds=20
romogarg: folds=20
lilmikey321: folds=20
Uncalled bet (480) returned to TIUQ~I
TIUQ~I collected 1890 from pot
TIUQ~I: doesn't show hand=20
*** SUMMARY ***
Total pot 1890 | Rake 0=20
Board [Jd Ad Ks 7c 3c]
Seat 1: JJin91 folded before Flop (didn't bet)
Seat 2: SAFTB24 folded on the River
Seat 3: romogarg (button) folded on the River
Seat 4: lilmikey321 (small blind) folded on the River
Seat 5: TIUQ~I (big blind) collected (1890)
Seat 6: SquadooshBag folded on the River


*********** # 69 **************
PokerStars Hand #169425798060: Tournament #1597684008, $13.50+$1.50 USD=
 Hold'em No Limit - Level V (60/120) - 2017/05/05 14:21:53 ET
Table '1597684008 3' 6-max Seat #4 is the button
Seat 1: JJin91 (16543 in chips)=20
Seat 2: SAFTB24 (5980 in chips)=20
Seat 3: romogarg (18532 in chips)=20
Seat 4: lilmikey321 (27266 in chips)=20
Seat 5: TIUQ~I (13953 in chips)=20
Seat 6: SquadooshBag (17555 in chips)=20
JJin91: posts the ante 15
SAFTB24: posts the ante 15
romogarg: posts the ante 15
lilmikey321: posts the ante 15
TIUQ~I: posts the ante 15
SquadooshBag: posts the ante 15
TIUQ~I: posts small blind 60
SquadooshBag: posts big blind 120
*** HOLE CARDS ***
Dealt to JJin91 [5d 2s]
JJin91: folds=20
SAFTB24: folds=20
romogarg: calls 120
lilmikey321: folds=20
TIUQ~I: calls 60
SquadooshBag: checks=20
*** FLOP *** [5c 8c Ah]
TIUQ~I: bets 240
SquadooshBag: folds=20
romogarg: folds=20
Uncalled bet (240) returned to TIUQ~I
SAFTB24 is disconnected=20
TIUQ~I collected 450 from pot
TIUQ~I: doesn't show hand=20
*** SUMMARY ***
Total pot 450 | Rake 0=20
Board [5c 8c Ah]
Seat 1: JJin91 folded before Flop (didn't bet)
Seat 2: SAFTB24 folded before Flop (didn't bet)
Seat 3: romogarg folded on the Flop
Seat 4: lilmikey321 (button) folded before Flop (didn't bet)
Seat 5: TIUQ~I (small blind) collected (450)
Seat 6: SquadooshBag (big blind) folded on the Flop


*********** # 70 **************
PokerStars Hand #169425798166: Tournament #1597684008, $13.50+$1.50 USD=
 Hold'em No Limit - Level V (60/120) - 2017/05/05 14:22:35 ET
Table '1597684008 3' 6-max Seat #5 is the button
Seat 1: JJin91 (16528 in chips)=20
Seat 2: SAFTB24 (5965 in chips)=20
Seat 3: romogarg (18397 in chips)=20
Seat 4: lilmikey321 (27251 in chips)=20
Seat 5: TIUQ~I (14268 in chips)=20
Seat 6: SquadooshBag (17420 in chips)=20
JJin91: posts the ante 15
SAFTB24: posts the ante 15
romogarg: posts the ante 15
lilmikey321: posts the ante 15
TIUQ~I: posts the ante 15
SquadooshBag: posts the ante 15
SquadooshBag: posts small blind 60
JJin91: posts big blind 120
*** HOLE CARDS ***
Dealt to JJin91 [Qd 5h]
SquadooshBag is disconnected=20
SAFTB24 has timed out while disconnected
SAFTB24: folds=20
SAFTB24 is sitting out
romogarg: folds=20
lilmikey321: folds=20
SAFTB24 has returned
TIUQ~I: folds=20
SquadooshBag: calls 60
JJin91: checks=20
*** FLOP *** [8c 8h Kh]
SquadooshBag: checks=20
JJin91: checks=20
*** TURN *** [8c 8h Kh] [Ad]
SquadooshBag: checks=20
TIUQ~I said, "you from NY B24?"
JJin91: checks=20
*** RIVER *** [8c 8h Kh Ad] [7d]
SquadooshBag: checks=20
JJin91: bets 240
SquadooshBag: folds=20
Uncalled bet (240) returned to JJin91
JJin91 collected 330 from pot
*** SUMMARY ***
Total pot 330 | Rake 0=20
Board [8c 8h Kh Ad 7d]
Seat 1: JJin91 (big blind) collected (330)
Seat 2: SAFTB24 folded before Flop (didn't bet)
Seat 3: romogarg folded before Flop (didn't bet)
Seat 4: lilmikey321 folded before Flop (didn't bet)
Seat 5: TIUQ~I (button) folded before Flop (didn't bet)
Seat 6: SquadooshBag (small blind) folded on the River


*********** # 71 **************
PokerStars Hand #169425798395: Tournament #1597684008, $13.50+$1.50 USD=
 Hold'em No Limit - Level V (60/120) - 2017/05/05 14:23:57 ET
Table '1597684008 3' 6-max Seat #6 is the button
Seat 1: JJin91 (16723 in chips)=20
Seat 2: SAFTB24 (5950 in chips)=20
Seat 3: romogarg (18382 in chips)=20
Seat 4: lilmikey321 (27236 in chips)=20
Seat 5: TIUQ~I (14253 in chips)=20
Seat 6: SquadooshBag (17285 in chips)=20
JJin91: posts the ante 15
SAFTB24: posts the ante 15
romogarg: posts the ante 15
lilmikey321: posts the ante 15
TIUQ~I: posts the ante 15
SquadooshBag: posts the ante 15
JJin91: posts small blind 60
SAFTB24: posts big blind 120
*** HOLE CARDS ***
Dealt to JJin91 [7d 8h]
SAFTB24 said, "yes"
TIUQ~I said, "me too"
romogarg: calls 120
lilmikey321: raises 360 to 480
TIUQ~I: folds=20
SquadooshBag: folds=20
JJin91: folds=20
SAFTB24: raises 480 to 960
romogarg: calls 840
lilmikey321: calls 480
*** FLOP *** [6h Ks 3s]
SAFTB24: checks=20
romogarg: checks=20
lilmikey321: bets 960
SAFTB24: calls 960
romogarg: folds=20
*** TURN *** [6h Ks 3s] [Ts]
SAFTB24: bets 4015 and is all-in
lilmikey321: calls 4015
*** RIVER *** [6h Ks 3s Ts] [Jd]
*** SHOW DOWN ***
SAFTB24: shows [Ah Qc] (a straight, Ten to Ace)
lilmikey321: shows [6s 4d] (a pair of Sixes)
SAFTB24 collected 12980 from pot
*** SUMMARY ***
Total pot 12980 | Rake 0=20
Board [6h Ks 3s Ts Jd]
Seat 1: JJin91 (small blind) folded before Flop
Seat 2: SAFTB24 (big blind) showed [Ah Qc] and won (12980) with a strai=
ght, Ten to Ace
Seat 3: romogarg folded on the Flop
Seat 4: lilmikey321 showed [6s 4d] and lost with a pair of Sixes
Seat 5: TIUQ~I folded before Flop (didn't bet)
Seat 6: SquadooshBag (button) folded before Flop (didn't bet)


*********** # 72 **************
PokerStars Hand #169425798608: Tournament #1597684008, $13.50+$1.50 USD=
 Hold'em No Limit - Level V (60/120) - 2017/05/05 14:25:25 ET
Table '1597684008 3' 6-max Seat #1 is the button
Seat 1: JJin91 (16648 in chips)=20
Seat 2: SAFTB24 (12980 in chips)=20
Seat 3: romogarg (17407 in chips)=20
Seat 4: lilmikey321 (21286 in chips)=20
Seat 5: TIUQ~I (14238 in chips)=20
Seat 6: SquadooshBag (17270 in chips)=20
JJin91: posts the ante 15
SAFTB24: posts the ante 15
romogarg: posts the ante 15
lilmikey321: posts the ante 15
TIUQ~I: posts the ante 15
SquadooshBag: posts the ante 15
SAFTB24: posts small blind 60
romogarg: posts big blind 120
*** HOLE CARDS ***
Dealt to JJin91 [8c 5h]
lilmikey321: calls 120
TIUQ~I: folds=20
SquadooshBag: calls 120
JJin91: folds=20
SAFTB24: calls 60
romogarg: raises 17272 to 17392 and is all-in
lilmikey321: folds=20
SquadooshBag: folds=20
SAFTB24: folds=20
Uncalled bet (17272) returned to romogarg
romogarg collected 570 from pot
romogarg: doesn't show hand=20
*** SUMMARY ***
Total pot 570 | Rake 0=20
Seat 1: JJin91 (button) folded before Flop (didn't bet)
Seat 2: SAFTB24 (small blind) folded before Flop
Seat 3: romogarg (big blind) collected (570)
Seat 4: lilmikey321 folded before Flop
Seat 5: TIUQ~I folded before Flop (didn't bet)
Seat 6: SquadooshBag folded before Flop


*********** # 73 **************
PokerStars Hand #169425798731: Tournament #1597684008, $13.50+$1.50 USD=
 Hold'em No Limit - Level V (60/120) - 2017/05/05 14:26:14 ET
Table '1597684008 3' 6-max Seat #2 is the button
Seat 1: JJin91 (16633 in chips)=20
Seat 2: SAFTB24 (12845 in chips)=20
Seat 3: romogarg (17842 in chips)=20
Seat 4: lilmikey321 (21151 in chips)=20
Seat 5: TIUQ~I (14223 in chips)=20
Seat 6: SquadooshBag (17135 in chips)=20
JJin91: posts the ante 15
SAFTB24: posts the ante 15
romogarg: posts the ante 15
lilmikey321: posts the ante 15
TIUQ~I: posts the ante 15
SquadooshBag: posts the ante 15
romogarg: posts small blind 60
lilmikey321: posts big blind 120
*** HOLE CARDS ***
Dealt to JJin91 [Kc Ts]
TIUQ~I: folds=20
SquadooshBag: raises 120 to 240
JJin91: folds=20
SAFTB24 is disconnected=20
SAFTB24 is connected=20
SAFTB24: folds=20
romogarg: calls 180
lilmikey321: calls 120
*** FLOP *** [Ad 3c 7h]
romogarg: checks=20
lilmikey321: checks=20
SquadooshBag: bets 840
romogarg: calls 840
lilmikey321: calls 840
*** TURN *** [Ad 3c 7h] [Jc]
romogarg: checks=20
lilmikey321: checks=20
SquadooshBag: bets 3360
romogarg: calls 3360
lilmikey321: calls 3360
*** RIVER *** [Ad 3c 7h Jc] [6s]
romogarg: checks=20
lilmikey321: bets 16696 and is all-in
SquadooshBag is disconnected=20
SquadooshBag is connected=20
SquadooshBag: folds=20
romogarg: folds=20
Uncalled bet (16696) returned to lilmikey321
lilmikey321 collected 13410 from pot
lilmikey321: doesn't show hand=20
*** SUMMARY ***
Total pot 13410 | Rake 0=20
Board [Ad 3c 7h Jc 6s]
Seat 1: JJin91 folded before Flop (didn't bet)
Seat 2: SAFTB24 (button) folded before Flop (didn't bet)
Seat 3: romogarg (small blind) folded on the River
Seat 4: lilmikey321 (big blind) collected (13410)
Seat 5: TIUQ~I folded before Flop (didn't bet)
Seat 6: SquadooshBag folded on the River


*********** # 74 **************
PokerStars Hand #169425799145: Tournament #1597684008, $13.50+$1.50 USD=
 Hold'em No Limit - Level VI (75/150) - 2017/05/05 14:28:53 ET
Table '1597684008 3' 6-max Seat #3 is the button
Seat 1: JJin91 (16618 in chips)=20
Seat 2: SAFTB24 (12830 in chips)=20
Seat 3: romogarg (13387 in chips)=20
Seat 4: lilmikey321 (30106 in chips)=20
Seat 5: TIUQ~I (14208 in chips)=20
Seat 6: SquadooshBag (12680 in chips)=20
JJin91: posts the ante 20
SAFTB24: posts the ante 20
romogarg: posts the ante 20
lilmikey321: posts the ante 20
TIUQ~I: posts the ante 20
SquadooshBag: posts the ante 20
lilmikey321: posts small blind 75
TIUQ~I: posts big blind 150
*** HOLE CARDS ***
Dealt to JJin91 [Td Qs]
SquadooshBag: calls 150
JJin91: folds=20
SAFTB24: folds=20
romogarg: folds=20
lilmikey321: calls 75
TIUQ~I: checks=20
*** FLOP *** [Ks 8h Jh]
lilmikey321: bets 150
TIUQ~I: calls 150
SquadooshBag: calls 150
*** TURN *** [Ks 8h Jh] [6d]
lilmikey321: checks=20
TIUQ~I: bets 510
SquadooshBag: folds=20
lilmikey321: folds=20
Uncalled bet (510) returned to TIUQ~I
TIUQ~I collected 1020 from pot
TIUQ~I: doesn't show hand=20
*** SUMMARY ***
Total pot 1020 | Rake 0=20
Board [Ks 8h Jh 6d]
Seat 1: JJin91 folded before Flop (didn't bet)
Seat 2: SAFTB24 folded before Flop (didn't bet)
Seat 3: romogarg (button) folded before Flop (didn't bet)
Seat 4: lilmikey321 (small blind) folded on the Turn
Seat 5: TIUQ~I (big blind) collected (1020)
Seat 6: SquadooshBag folded on the Turn


*********** # 75 **************
PokerStars Hand #169425799268: Tournament #1597684008, $13.50+$1.50 USD=
 Hold'em No Limit - Level VI (75/150) - 2017/05/05 14:29:33 ET
Table '1597684008 3' 6-max Seat #4 is the button
Seat 1: JJin91 (16598 in chips)=20
Seat 2: SAFTB24 (12810 in chips)=20
Seat 3: romogarg (13367 in chips)=20
Seat 4: lilmikey321 (29786 in chips)=20
Seat 5: TIUQ~I (14908 in chips)=20
Seat 6: SquadooshBag (12360 in chips)=20
JJin91: posts the ante 20
SAFTB24: posts the ante 20
romogarg: posts the ante 20
lilmikey321: posts the ante 20
TIUQ~I: posts the ante 20
SquadooshBag: posts the ante 20
TIUQ~I: posts small blind 75
SquadooshBag: posts big blind 150
*** HOLE CARDS ***
Dealt to JJin91 [Jc 2d]
JJin91: folds=20
SAFTB24: raises 150 to 300
romogarg: calls 300
lilmikey321: folds=20
TIUQ~I: folds=20
SquadooshBag is disconnected=20
SquadooshBag is connected=20
SquadooshBag: calls 150
*** FLOP *** [9h 6c 8c]
SquadooshBag: bets 150
SAFTB24: calls 150
romogarg: folds=20
*** TURN *** [9h 6c 8c] [3c]
SquadooshBag: bets 300
SAFTB24: calls 300
*** RIVER *** [9h 6c 8c 3c] [Th]
SquadooshBag: bets 150
SAFTB24: raises 1500 to 1650
SquadooshBag: folds=20
Uncalled bet (1500) returned to SAFTB24
SAFTB24 collected 2295 from pot
SAFTB24: doesn't show hand=20
*** SUMMARY ***
Total pot 2295 | Rake 0=20
Board [9h 6c 8c 3c Th]
Seat 1: JJin91 folded before Flop (didn't bet)
Seat 2: SAFTB24 collected (2295)
Seat 3: romogarg folded on the Flop
Seat 4: lilmikey321 (button) folded before Flop (didn't bet)
Seat 5: TIUQ~I (small blind) folded before Flop
Seat 6: SquadooshBag (big blind) folded on the River


*********** # 76 **************
PokerStars Hand #169425799524: Tournament #1597684008, $13.50+$1.50 USD=
 Hold'em No Limit - Level VI (75/150) - 2017/05/05 14:31:07 ET
Table '1597684008 8' 6-max Seat #2 is the button
Seat 1: M456G (6848 in chips)=20
Seat 2: bretlaviola (17255 in chips)=20
Seat 3: pokernutt420 (12581 in chips)=20
Seat 4: excon tyrone (8943 in chips)=20
Seat 5: JJin91 (16578 in chips)=20
M456G: posts the ante 20
bretlaviola: posts the ante 20
pokernutt420: posts the ante 20
excon tyrone: posts the ante 20
JJin91: posts the ante 20
pokernutt420: posts small blind 75
excon tyrone: posts big blind 150
*** HOLE CARDS ***
Dealt to JJin91 [Kc Th]
JJin91: raises 300 to 450
M456G: folds=20
bretlaviola: folds=20
pokernutt420: folds=20
excon tyrone: folds=20
Uncalled bet (300) returned to JJin91
JJin91 collected 475 from pot
*** SUMMARY ***
Total pot 475 | Rake 0=20
Seat 1: M456G folded before Flop (didn't bet)
Seat 2: bretlaviola (button) folded before Flop (didn't bet)
Seat 3: pokernutt420 (small blind) folded before Flop
Seat 4: excon tyrone (big blind) folded before Flop
Seat 5: JJin91 collected (475)


*********** # 77 **************
PokerStars Hand #169425799567: Tournament #1597684008, $13.50+$1.50 USD=
 Hold'em No Limit - Level VI (75/150) - 2017/05/05 14:31:23 ET
Table '1597684008 8' 6-max Seat #3 is the button
Seat 1: M456G (6828 in chips)=20
Seat 2: bretlaviola (17235 in chips)=20
Seat 3: pokernutt420 (12486 in chips)=20
Seat 4: excon tyrone (8773 in chips)=20
Seat 5: JJin91 (16883 in chips)=20
M456G: posts the ante 20
bretlaviola: posts the ante 20
pokernutt420: posts the ante 20
excon tyrone: posts the ante 20
JJin91: posts the ante 20
excon tyrone: posts small blind 75
JJin91: posts big blind 150
*** HOLE CARDS ***
Dealt to JJin91 [5d As]
M456G: folds=20
bretlaviola: raises 300 to 450
pokernutt420: calls 450
excon tyrone: folds=20
JJin91: folds=20
*** FLOP *** [9c 2h 8s]
bretlaviola: checks=20
pokernutt420: checks=20
*** TURN *** [9c 2h 8s] [6s]
bretlaviola: checks=20
pokernutt420: bets 600
bretlaviola: raises 2425 to 3025
pokernutt420: folds=20
Uncalled bet (2425) returned to bretlaviola
bretlaviola collected 2425 from pot
bretlaviola: shows [6d]
*** SUMMARY ***
Total pot 2425 | Rake 0=20
Board [9c 2h 8s 6s]
Seat 1: M456G folded before Flop (didn't bet)
Seat 2: bretlaviola collected (2425)
Seat 3: pokernutt420 (button) folded on the Turn
Seat 4: excon tyrone (small blind) folded before Flop
Seat 5: JJin91 (big blind) folded before Flop


*********** # 78 **************
PokerStars Hand #169425799664: Tournament #1597684008, $13.50+$1.50 USD=
 Hold'em No Limit - Level VI (75/150) - 2017/05/05 14:31:59 ET
Table '1597684008 8' 6-max Seat #4 is the button
Seat 1: M456G (6808 in chips)=20
Seat 2: bretlaviola (18590 in chips)=20
Seat 3: pokernutt420 (11416 in chips)=20
Seat 4: excon tyrone (8678 in chips)=20
Seat 5: JJin91 (16713 in chips)=20
M456G: posts the ante 20
bretlaviola: posts the ante 20
pokernutt420: posts the ante 20
excon tyrone: posts the ante 20
JJin91: posts the ante 20
JJin91: posts small blind 75
M456G: posts big blind 150
*** HOLE CARDS ***
Dealt to JJin91 [Kc Ad]
bretlaviola: raises 475 to 625
pokernutt420: folds=20
excon tyrone: folds=20
JJin91: calls 550
M456G: calls 475
*** FLOP *** [7h Ks 4s]
JJin91: checks=20
M456G: bets 1050
bretlaviola: raises 2038 to 3088
JJin91: raises 12980 to 16068 and is all-in
M456G: folds=20
bretlaviola: calls 12980
*** TURN *** [7h Ks 4s] [5d]
*** RIVER *** [7h Ks 4s 5d] [Ts]
*** SHOW DOWN ***
JJin91: shows [Kc Ad] (a pair of Kings)
bretlaviola: shows [Ah Kh] (a pair of Kings)
JJin91 collected 17581 from pot
bretlaviola collected 17580 from pot
*** SUMMARY ***
Total pot 35161 | Rake 0=20
Board [7h Ks 4s 5d Ts]
Seat 1: M456G (big blind) folded on the Flop
Seat 2: bretlaviola showed [Ah Kh] and won (17580) with a pair of Kings
Seat 3: pokernutt420 folded before Flop (didn't bet)
Seat 4: excon tyrone (button) folded before Flop (didn't bet)
Seat 5: JJin91 (small blind) showed [Kc Ad] and won (17581) with a pair=
 of Kings


*********** # 79 **************
PokerStars Hand #169425799796: Tournament #1597684008, $13.50+$1.50 USD=
 Hold'em No Limit - Level VI (75/150) - 2017/05/05 14:32:42 ET
Table '1597684008 8' 6-max Seat #5 is the button
Seat 1: M456G (5113 in chips)=20
Seat 2: bretlaviola (19457 in chips)=20
Seat 3: pokernutt420 (11396 in chips)=20
Seat 4: excon tyrone (8658 in chips)=20
Seat 5: JJin91 (17581 in chips)=20
M456G: posts the ante 20
bretlaviola: posts the ante 20
pokernutt420: posts the ante 20
excon tyrone: posts the ante 20
JJin91: posts the ante 20
M456G: posts small blind 75
bretlaviola: posts big blind 150
*** HOLE CARDS ***
Dealt to JJin91 [6s 3d]
bretlaviola said, "nh"
pokernutt420: folds=20
excon tyrone: calls 150
JJin91: folds=20
M456G: calls 75
bretlaviola: checks=20
*** FLOP *** [2c 5s Th]
bretlaviola said, "your not that good"
M456G: checks=20
bretlaviola: checks=20
excon tyrone: checks=20
*** TURN *** [2c 5s Th] [Qd]
M456G: checks=20
bretlaviola: checks=20
excon tyrone: bets 275
M456G: folds=20
bretlaviola: folds=20
Uncalled bet (275) returned to excon tyrone
JJin91 said, "thx u2"
excon tyrone collected 550 from pot
*** SUMMARY ***
Total pot 550 | Rake 0=20
Board [2c 5s Th Qd]
Seat 1: M456G (small blind) folded on the Turn
Seat 2: bretlaviola (big blind) folded on the Turn
Seat 3: pokernutt420 folded before Flop (didn't bet)
Seat 4: excon tyrone collected (550)
Seat 5: JJin91 (button) folded before Flop (didn't bet)


*********** # 80 **************
PokerStars Hand #169425799883: Tournament #1597684008, $13.50+$1.50 USD=
 Hold'em No Limit - Level VI (75/150) - 2017/05/05 14:33:09 ET
Table '1597684008 8' 6-max Seat #1 is the button
Seat 1: M456G (4943 in chips)=20
Seat 2: bretlaviola (19287 in chips)=20
Seat 3: pokernutt420 (11376 in chips)=20
Seat 4: excon tyrone (9038 in chips)=20
Seat 5: JJin91 (17561 in chips)=20
M456G: posts the ante 20
bretlaviola: posts the ante 20
pokernutt420: posts the ante 20
excon tyrone: posts the ante 20
JJin91: posts the ante 20
bretlaviola: posts small blind 75
pokernutt420: posts big blind 150
*** HOLE CARDS ***
Dealt to JJin91 [4s 5h]
excon tyrone: folds=20
JJin91: folds=20
M456G: folds=20
bretlaviola said, "m4 should of paid us"
bretlaviola: folds=20
Uncalled bet (75) returned to pokernutt420
pokernutt420 collected 250 from pot
pokernutt420: doesn't show hand=20
*** SUMMARY ***
Total pot 250 | Rake 0=20
Seat 1: M456G (button) folded before Flop (didn't bet)
Seat 2: bretlaviola (small blind) folded before Flop
Seat 3: pokernutt420 (big blind) collected (250)
Seat 4: excon tyrone folded before Flop (didn't bet)
Seat 5: JJin91 folded before Flop (didn't bet)


*********** # 81 **************
PokerStars Hand #169425799908: Tournament #1597684008, $13.50+$1.50 USD=
 Hold'em No Limit - Level VI (75/150) - 2017/05/05 14:33:18 ET
Table '1597684008 8' 6-max Seat #2 is the button
Seat 1: M456G (4923 in chips)=20
Seat 2: bretlaviola (19192 in chips)=20
Seat 3: pokernutt420 (11531 in chips)=20
Seat 4: excon tyrone (9018 in chips)=20
Seat 5: JJin91 (17541 in chips)=20
M456G: posts the ante 20
bretlaviola: posts the ante 20
pokernutt420: posts the ante 20
excon tyrone: posts the ante 20
JJin91: posts the ante 20
pokernutt420: posts small blind 75
excon tyrone: posts big blind 150
*** HOLE CARDS ***
Dealt to JJin91 [6c 7c]
JJin91: folds=20
M456G: calls 150
bretlaviola said, "<3"
bretlaviola: calls 150
pokernutt420: folds=20
excon tyrone: checks=20
*** FLOP *** [4h 9c Ad]
excon tyrone: checks=20
M456G: checks=20
bretlaviola: checks=20
*** TURN *** [4h 9c Ad] [Ac]
excon tyrone: checks=20
M456G: checks=20
bretlaviola: checks=20
*** RIVER *** [4h 9c Ad Ac] [Jd]
excon tyrone: bets 150
M456G: folds=20
bretlaviola: folds=20
Uncalled bet (150) returned to excon tyrone
excon tyrone collected 625 from pot
*** SUMMARY ***
Total pot 625 | Rake 0=20
Board [4h 9c Ad Ac Jd]
Seat 1: M456G folded on the River
Seat 2: bretlaviola (button) folded on the River
Seat 3: pokernutt420 (small blind) folded before Flop
Seat 4: excon tyrone (big blind) collected (625)
Seat 5: JJin91 folded before Flop (didn't bet)


*********** # 82 **************
PokerStars Hand #169425799981: Tournament #1597684008, $13.50+$1.50 USD=
 Hold'em No Limit - Level VI (75/150) - 2017/05/05 14:33:47 ET
Table '1597684008 8' 6-max Seat #3 is the button
Seat 1: M456G (4753 in chips)=20
Seat 2: bretlaviola (19022 in chips)=20
Seat 3: pokernutt420 (11436 in chips)=20
Seat 4: excon tyrone (9473 in chips)=20
Seat 5: JJin91 (17521 in chips)=20
M456G: posts the ante 20
bretlaviola: posts the ante 20
pokernutt420: posts the ante 20
excon tyrone: posts the ante 20
JJin91: posts the ante 20
excon tyrone: posts small blind 75
JJin91: posts big blind 150
*** HOLE CARDS ***
Dealt to JJin91 [5d 3c]
M456G: folds=20
bretlaviola said, "for a sec i thought you flop set"
bretlaviola: calls 150
pokernutt420: calls 150
excon tyrone: calls 75
JJin91: checks=20
*** FLOP *** [2s Ad Ks]
excon tyrone: checks=20
bretlaviola said, "so i was like i paid you"
JJin91: checks=20
bretlaviola: bets 350
pokernutt420: folds=20
excon tyrone: folds=20
JJin91: folds=20
Uncalled bet (350) returned to bretlaviola
bretlaviola collected 700 from pot
bretlaviola: shows [Ah]
*** SUMMARY ***
Total pot 700 | Rake 0=20
Board [2s Ad Ks]
Seat 1: M456G folded before Flop (didn't bet)
Seat 2: bretlaviola collected (700)
Seat 3: pokernutt420 (button) folded on the Flop
Seat 4: excon tyrone (small blind) folded on the Flop
Seat 5: JJin91 (big blind) folded on the Flop


*********** # 83 **************
PokerStars Hand #169426540886: Tournament #1597684008, $13.50+$1.50 USD=
 Hold'em No Limit - Level VI (75/150) - 2017/05/05 14:34:21 ET
Table '1597684008 8' 6-max Seat #4 is the button
Seat 1: M456G (4733 in chips)=20
Seat 2: bretlaviola (19552 in chips)=20
Seat 3: pokernutt420 (11266 in chips)=20
Seat 4: excon tyrone (9303 in chips)=20
Seat 5: JJin91 (17351 in chips)=20
M456G: posts the ante 20
bretlaviola: posts the ante 20
pokernutt420: posts the ante 20
excon tyrone: posts the ante 20
JJin91: posts the ante 20
JJin91: posts small blind 75
M456G: posts big blind 150
*** HOLE CARDS ***
Dealt to JJin91 [4c 3c]
bretlaviola: calls 150
pokernutt420: folds=20
excon tyrone: folds=20
JJin91: calls 75
M456G: checks=20
*** FLOP *** [6h 9h Tc]
JJin91: checks=20
M456G: checks=20
JJin91 said, "wS the plan"
bretlaviola: bets 378
JJin91: folds=20
M456G: calls 378
*** TURN *** [6h 9h Tc] [9s]
M456G: checks=20
bretlaviola: checks=20
*** RIVER *** [6h 9h Tc 9s] [Th]
M456G: checks=20
bretlaviola said, "come onnnnnnn"
bretlaviola: checks=20
*** SHOW DOWN ***
M456G: shows [Jh 7d] (two pair, Tens and Nines)
bretlaviola: shows [5h 2h] (a flush, Ten high)
bretlaviola collected 1306 from pot
*** SUMMARY ***
Total pot 1306 | Rake 0=20
Board [6h 9h Tc 9s Th]
Seat 1: M456G (big blind) showed [Jh 7d] and lost with two pair, Tens a=
nd Nines
Seat 2: bretlaviola showed [5h 2h] and won (1306) with a flush, Ten high
Seat 3: pokernutt420 folded before Flop (didn't bet)
Seat 4: excon tyrone (button) folded before Flop (didn't bet)
Seat 5: JJin91 (small blind) folded on the Flop


*********** # 84 **************
PokerStars Hand #169426541007: Tournament #1597684008, $13.50+$1.50 USD=
 Hold'em No Limit - Level VI (75/150) - 2017/05/05 14:35:02 ET
Table '1597684008 8' 6-max Seat #5 is the button
Seat 1: M456G (4185 in chips)=20
Seat 2: bretlaviola (20310 in chips)=20
Seat 3: pokernutt420 (11246 in chips)=20
Seat 4: excon tyrone (9283 in chips)=20
Seat 5: JJin91 (17181 in chips)=20
M456G: posts the ante 20
bretlaviola: posts the ante 20
pokernutt420: posts the ante 20
excon tyrone: posts the ante 20
JJin91: posts the ante 20
M456G: posts small blind 75
bretlaviola: posts big blind 150
*** HOLE CARDS ***
Dealt to JJin91 [7h 6s]
pokernutt420: folds=20
excon tyrone: folds=20
bretlaviola said, "thought he boated"
JJin91: folds=20
bretlaviola said, "lol"
M456G: raises 150 to 300
bretlaviola: calls 150
*** FLOP *** [Js Qs 4d]
M456G: bets 150
bretlaviola: folds=20
Uncalled bet (150) returned to M456G
M456G collected 700 from pot
M456G: doesn't show hand=20
bretlaviola said, "keep it"
*** SUMMARY ***
Total pot 700 | Rake 0=20
Board [Js Qs 4d]
Seat 1: M456G (small blind) collected (700)
Seat 2: bretlaviola (big blind) folded on the Flop
Seat 3: pokernutt420 folded before Flop (didn't bet)
Seat 4: excon tyrone folded before Flop (didn't bet)
Seat 5: JJin91 (button) folded before Flop (didn't bet)


*********** # 85 **************
PokerStars Hand #169426541080: Tournament #1597684008, $13.50+$1.50 USD=
 Hold'em No Limit - Level VI (75/150) - 2017/05/05 14:35:28 ET
Table '1597684008 8' 6-max Seat #1 is the button
Seat 1: M456G (4565 in chips)=20
Seat 2: bretlaviola (19990 in chips)=20
Seat 3: pokernutt420 (11226 in chips)=20
Seat 4: excon tyrone (9263 in chips)=20
Seat 5: JJin91 (17161 in chips)=20
M456G: posts the ante 20
bretlaviola: posts the ante 20
pokernutt420: posts the ante 20
excon tyrone: posts the ante 20
JJin91: posts the ante 20
bretlaviola: posts small blind 75
pokernutt420: posts big blind 150
*** HOLE CARDS ***
Dealt to JJin91 [2c 8d]
excon tyrone: folds=20
M456G said, "lol"
JJin91: folds=20
M456G: raises 450 to 600
bretlaviola: folds=20
pokernutt420: folds=20
Uncalled bet (450) returned to M456G
M456G collected 475 from pot
M456G: doesn't show hand=20
bretlaviola said, "im here to win"
*** SUMMARY ***
Total pot 475 | Rake 0=20
Seat 1: M456G (button) collected (475)
Seat 2: bretlaviola (small blind) folded before Flop
Seat 3: pokernutt420 (big blind) folded before Flop
Seat 4: excon tyrone folded before Flop (didn't bet)
Seat 5: JJin91 folded before Flop (didn't bet)


*********** # 86 **************
PokerStars Hand #169426541127: Tournament #1597684008, $13.50+$1.50 USD=
 Hold'em No Limit - Level VI (75/150) - 2017/05/05 14:35:46 ET
Table '1597684008 8' 6-max Seat #2 is the button
Seat 1: M456G (4870 in chips)=20
Seat 2: bretlaviola (19895 in chips)=20
Seat 3: pokernutt420 (11056 in chips)=20
Seat 4: excon tyrone (9243 in chips)=20
Seat 5: JJin91 (17141 in chips)=20
M456G: posts the ante 20
bretlaviola: posts the ante 20
pokernutt420: posts the ante 20
excon tyrone: posts the ante 20
JJin91: posts the ante 20
pokernutt420: posts small blind 75
excon tyrone: posts big blind 150
*** HOLE CARDS ***
Dealt to JJin91 [Ac Jd]
JJin91: raises 300 to 450
M456G: folds=20
bretlaviola: folds=20
pokernutt420: folds=20
excon tyrone: calls 300
*** FLOP *** [3h Ah 2c]
excon tyrone: checks=20
JJin91: checks=20
*** TURN *** [3h Ah 2c] [Kd]
excon tyrone: bets 1350
bretlaviola said, "i need to build up a bankroll"
M456G said, "had qj"
JJin91: calls 1350
*** RIVER *** [3h Ah 2c Kd] [8c]
excon tyrone: bets 1200
JJin91: calls 1200
*** SHOW DOWN ***
excon tyrone: shows [Ad Th] (a pair of Aces)
JJin91: shows [Ac Jd] (a pair of Aces - King+Jack kicker)
JJin91 collected 6175 from pot
*** SUMMARY ***
Total pot 6175 | Rake 0=20
Board [3h Ah 2c Kd 8c]
Seat 1: M456G folded before Flop (didn't bet)
Seat 2: bretlaviola (button) folded before Flop (didn't bet)
Seat 3: pokernutt420 (small blind) folded before Flop
Seat 4: excon tyrone (big blind) showed [Ad Th] and lost with a pair of=
 Aces
Seat 5: JJin91 showed [Ac Jd] and won (6175) with a pair of Aces


*********** # 87 **************
PokerStars Hand #169426541273: Tournament #1597684008, $13.50+$1.50 USD=
 Hold'em No Limit - Level VI (75/150) - 2017/05/05 14:36:30 ET
Table '1597684008 8' 6-max Seat #3 is the button
Seat 1: M456G (4850 in chips)=20
Seat 2: bretlaviola (19875 in chips)=20
Seat 3: pokernutt420 (10961 in chips)=20
Seat 4: excon tyrone (6223 in chips)=20
Seat 5: JJin91 (20296 in chips)=20
M456G: posts the ante 20
bretlaviola: posts the ante 20
pokernutt420: posts the ante 20
excon tyrone: posts the ante 20
JJin91: posts the ante 20
excon tyrone: posts small blind 75
JJin91: posts big blind 150
*** HOLE CARDS ***
Dealt to JJin91 [Qs 7h]
M456G: calls 150
bretlaviola said, "nh"
bretlaviola: folds=20
pokernutt420: folds=20
excon tyrone: calls 75
JJin91: checks=20
*** FLOP *** [4c Kc 5d]
excon tyrone: checks=20
JJin91: checks=20
M456G: checks=20
*** TURN *** [4c Kc 5d] [7d]
excon tyrone: checks=20
JJin91: bets 300
M456G: calls 300
excon tyrone: raises 1200 to 1500
JJin91: calls 1200
M456G: folds=20
*** RIVER *** [4c Kc 5d 7d] [Qd]
excon tyrone: bets 4553 and is all-in
JJin91: folds=20
Uncalled bet (4553) returned to excon tyrone
excon tyrone collected 3850 from pot
*** SUMMARY ***
Total pot 3850 | Rake 0=20
Board [4c Kc 5d 7d Qd]
Seat 1: M456G folded on the Turn
Seat 2: bretlaviola folded before Flop (didn't bet)
Seat 3: pokernutt420 (button) folded before Flop (didn't bet)
Seat 4: excon tyrone (small blind) collected (3850)
Seat 5: JJin91 (big blind) folded on the River


*********** # 88 **************
PokerStars Hand #169426541429: Tournament #1597684008, $13.50+$1.50 USD=
 Hold'em No Limit - Level VII (100/200) - 2017/05/05 14:37:28 ET
Table '1597684008 8' 6-max Seat #4 is the button
Seat 1: M456G (4380 in chips)=20
Seat 2: bretlaviola (19855 in chips)=20
Seat 3: pokernutt420 (10941 in chips)=20
Seat 4: excon tyrone (8403 in chips)=20
Seat 5: JJin91 (18626 in chips)=20
M456G: posts the ante 25
bretlaviola: posts the ante 25
pokernutt420: posts the ante 25
excon tyrone: posts the ante 25
JJin91: posts the ante 25
JJin91: posts small blind 100
M456G: posts big blind 200
*** HOLE CARDS ***
Dealt to JJin91 [3d 4d]
bretlaviola: folds=20
pokernutt420: raises 400 to 600
excon tyrone: folds=20
JJin91: folds=20
M456G: calls 400
*** FLOP *** [Ts 4h 8h]
M456G: checks=20
pokernutt420: bets 713
M456G: calls 713
*** TURN *** [Ts 4h 8h] [6c]
M456G: checks=20
pokernutt420: bets 1426
M456G: folds=20
Uncalled bet (1426) returned to pokernutt420
pokernutt420 collected 2851 from pot
pokernutt420: doesn't show hand=20
*** SUMMARY ***
Total pot 2851 | Rake 0=20
Board [Ts 4h 8h 6c]
Seat 1: M456G (big blind) folded on the Turn
Seat 2: bretlaviola folded before Flop (didn't bet)
Seat 3: pokernutt420 collected (2851)
Seat 4: excon tyrone (button) folded before Flop (didn't bet)
Seat 5: JJin91 (small blind) folded before Flop


*********** # 89 **************
PokerStars Hand #169426541597: Tournament #1597684008, $13.50+$1.50 USD=
 Hold'em No Limit - Level VII (100/200) - 2017/05/05 14:38:20 ET
Table '1597684008 8' 6-max Seat #5 is the button
Seat 1: M456G (3042 in chips)=20
Seat 2: bretlaviola (19830 in chips)=20
Seat 3: pokernutt420 (12454 in chips)=20
Seat 4: excon tyrone (8378 in chips)=20
Seat 5: JJin91 (18501 in chips)=20
M456G: posts the ante 25
bretlaviola: posts the ante 25
pokernutt420: posts the ante 25
excon tyrone: posts the ante 25
JJin91: posts the ante 25
M456G: posts small blind 100
bretlaviola: posts big blind 200
*** HOLE CARDS ***
Dealt to JJin91 [3d Ad]
pokernutt420: folds=20
excon tyrone: folds=20
JJin91: raises 400 to 600
M456G: calls 500
bretlaviola: calls 400
*** FLOP *** [Qs 3s 4d]
M456G: checks=20
bretlaviola: checks=20
JJin91: checks=20
*** TURN *** [Qs 3s 4d] [9d]
M456G: checks=20
bretlaviola: checks=20
JJin91: bets 1000
M456G: folds=20
bretlaviola: calls 1000
*** RIVER *** [Qs 3s 4d 9d] [Ac]
bretlaviola: checks=20
JJin91: bets 2854
bretlaviola said, "ace?"
bretlaviola said, "big bet"
JJin91 said, "find out"
bretlaviola: folds=20
Uncalled bet (2854) returned to JJin91
JJin91 collected 3925 from pot
*** SUMMARY ***
Total pot 3925 | Rake 0=20
Board [Qs 3s 4d 9d Ac]
Seat 1: M456G (small blind) folded on the Turn
Seat 2: bretlaviola (big blind) folded on the River
Seat 3: pokernutt420 folded before Flop (didn't bet)
Seat 4: excon tyrone folded before Flop (didn't bet)
Seat 5: JJin91 (button) collected (3925)


*********** # 90 **************
PokerStars Hand #169426541797: Tournament #1597684008, $13.50+$1.50 USD=
 Hold'em No Limit - Level VII (100/200) - 2017/05/05 14:39:33 ET
Table '1597684008 8' 6-max Seat #1 is the button
Seat 1: M456G (2417 in chips)=20
Seat 2: bretlaviola (18205 in chips)=20
Seat 3: pokernutt420 (12429 in chips)=20
Seat 4: excon tyrone (8353 in chips)=20
Seat 5: JJin91 (20801 in chips)=20
M456G: posts the ante 25
bretlaviola: posts the ante 25
pokernutt420: posts the ante 25
excon tyrone: posts the ante 25
JJin91: posts the ante 25
bretlaviola: posts small blind 100
pokernutt420: posts big blind 200
*** HOLE CARDS ***
Dealt to JJin91 [Td 6h]
excon tyrone: folds=20
JJin91: folds=20
M456G: calls 200
bretlaviola said, "could of told me"
bretlaviola: calls 100
pokernutt420: checks=20
*** FLOP *** [Jh 5s 6s]
bretlaviola said, "lol"
bretlaviola: bets 725
pokernutt420: calls 725
M456G: folds=20
*** TURN *** [Jh 5s 6s] [3h]
bretlaviola: checks=20
JJin91 said, "a3ss"
pokernutt420: bets 1088
bretlaviola: calls 1088
*** RIVER *** [Jh 5s 6s 3h] [7d]
bretlaviola: checks=20
pokernutt420: bets 4351
bretlaviola: folds=20
Uncalled bet (4351) returned to pokernutt420
pokernutt420 collected 4351 from pot
pokernutt420: doesn't show hand=20
*** SUMMARY ***
Total pot 4351 | Rake 0=20
Board [Jh 5s 6s 3h 7d]
Seat 1: M456G (button) folded on the Flop
Seat 2: bretlaviola (small blind) folded on the River
Seat 3: pokernutt420 (big blind) collected (4351)
Seat 4: excon tyrone folded before Flop (didn't bet)
Seat 5: JJin91 folded before Flop (didn't bet)


*********** # 91 **************
PokerStars Hand #169426541883: Tournament #1597684008, $13.50+$1.50 USD=
 Hold'em No Limit - Level VII (100/200) - 2017/05/05 14:40:06 ET
Table '1597684008 8' 6-max Seat #2 is the button
Seat 1: M456G (2192 in chips)=20
Seat 2: bretlaviola (16167 in chips)=20
Seat 3: pokernutt420 (14742 in chips)=20
Seat 4: excon tyrone (8328 in chips)=20
Seat 5: JJin91 (20776 in chips)=20
M456G: posts the ante 25
bretlaviola: posts the ante 25
pokernutt420: posts the ante 25
excon tyrone: posts the ante 25
JJin91: posts the ante 25
pokernutt420: posts small blind 100
excon tyrone: posts big blind 200
*** HOLE CARDS ***
Dealt to JJin91 [9s 2s]
JJin91: folds=20
M456G: calls 200
bretlaviola: folds=20
pokernutt420: calls 100
bretlaviola said, "here come the 4 card shit"
excon tyrone: checks=20
*** FLOP *** [Td 7s 3d]
pokernutt420: checks=20
excon tyrone: bets 1800
bretlaviola said, "watch"
M456G: folds=20
pokernutt420: folds=20
Uncalled bet (1800) returned to excon tyrone
excon tyrone collected 725 from pot
*** SUMMARY ***
Total pot 725 | Rake 0=20
Board [Td 7s 3d]
Seat 1: M456G folded on the Flop
Seat 2: bretlaviola (button) folded before Flop (didn't bet)
Seat 3: pokernutt420 (small blind) folded on the Flop
Seat 4: excon tyrone (big blind) collected (725)
Seat 5: JJin91 folded before Flop (didn't bet)


*********** # 92 **************
PokerStars Hand #169426541951: Tournament #1597684008, $13.50+$1.50 USD=
 Hold'em No Limit - Level VII (100/200) - 2017/05/05 14:40:32 ET
Table '1597684008 8' 6-max Seat #3 is the button
Seat 1: M456G (1967 in chips)=20
Seat 2: bretlaviola (16142 in chips)=20
Seat 3: pokernutt420 (14517 in chips)=20
Seat 4: excon tyrone (8828 in chips)=20
Seat 5: JJin91 (20751 in chips)=20
M456G: posts the ante 25
bretlaviola: posts the ante 25
pokernutt420: posts the ante 25
excon tyrone: posts the ante 25
JJin91: posts the ante 25
excon tyrone: posts small blind 100
JJin91: posts big blind 200
*** HOLE CARDS ***
Dealt to JJin91 [9d Qh]
bretlaviola said, "4 card st8 and flushes are coming"
M456G: calls 200
bretlaviola: folds=20
pokernutt420: folds=20
excon tyrone: folds=20
JJin91: checks=20
*** FLOP *** [Kd Jh 6s]
JJin91: checks=20
M456G: checks=20
*** TURN *** [Kd Jh 6s] [8c]
JJin91: checks=20
M456G: checks=20
*** RIVER *** [Kd Jh 6s 8c] [3c]
JJin91: checks=20
M456G: checks=20
*** SHOW DOWN ***
JJin91: shows [9d Qh] (high card King)
M456G: shows [7c As] (high card Ace)
M456G collected 625 from pot
*** SUMMARY ***
Total pot 625 | Rake 0=20
Board [Kd Jh 6s 8c 3c]
Seat 1: M456G showed [7c As] and won (625) with high card Ace
Seat 2: bretlaviola folded before Flop (didn't bet)
Seat 3: pokernutt420 (button) folded before Flop (didn't bet)
Seat 4: excon tyrone (small blind) folded before Flop
Seat 5: JJin91 (big blind) showed [9d Qh] and lost with high card King


*********** # 93 **************
PokerStars Hand #169426542022: Tournament #1597684008, $13.50+$1.50 USD=
 Hold'em No Limit - Level VII (100/200) - 2017/05/05 14:41:02 ET
Table '1597684008 8' 6-max Seat #4 is the button
Seat 1: M456G (2367 in chips)=20
Seat 2: bretlaviola (16117 in chips)=20
Seat 3: pokernutt420 (14492 in chips)=20
Seat 4: excon tyrone (8703 in chips)=20
Seat 5: JJin91 (20526 in chips)=20
M456G: posts the ante 25
bretlaviola: posts the ante 25
pokernutt420: posts the ante 25
excon tyrone: posts the ante 25
JJin91: posts the ante 25
JJin91: posts small blind 100
M456G: posts big blind 200
*** HOLE CARDS ***
Dealt to JJin91 [Ks 5s]
bretlaviola: folds=20
pokernutt420: calls 200
excon tyrone: folds=20
JJin91: folds=20
M456G: checks=20
*** FLOP *** [Ad 3d Jd]
M456G: checks=20
pokernutt420: checks=20
*** TURN *** [Ad 3d Jd] [Qh]
M456G: bets 200
pokernutt420: calls 200
*** RIVER *** [Ad 3d Jd Qh] [8d]
M456G: bets 200
pokernutt420: calls 200
*** SHOW DOWN ***
M456G: shows [3h 4d] (a flush, Ace high)
pokernutt420: mucks hand=20
M456G collected 1425 from pot
*** SUMMARY ***
Total pot 1425 | Rake 0=20
Board [Ad 3d Jd Qh 8d]
Seat 1: M456G (big blind) showed [3h 4d] and won (1425) with a flush, A=
ce high
Seat 2: bretlaviola folded before Flop (didn't bet)
Seat 3: pokernutt420 mucked [Jc 9s]
Seat 4: excon tyrone (button) folded before Flop (didn't bet)
Seat 5: JJin91 (small blind) folded before Flop


*********** # 94 **************
PokerStars Hand #169426542092: Tournament #1597684008, $13.50+$1.50 USD=
 Hold'em No Limit - Level VII (100/200) - 2017/05/05 14:41:28 ET
Table '1597684008 8' 6-max Seat #5 is the button
Seat 1: M456G (3167 in chips)=20
Seat 2: bretlaviola (16092 in chips)=20
Seat 3: pokernutt420 (13867 in chips)=20
Seat 4: excon tyrone (8678 in chips)=20
Seat 5: JJin91 (20401 in chips)=20
M456G: posts the ante 25
bretlaviola: posts the ante 25
pokernutt420: posts the ante 25
excon tyrone: posts the ante 25
JJin91: posts the ante 25
M456G: posts small blind 100
bretlaviola: posts big blind 200
*** HOLE CARDS ***
Dealt to JJin91 [Jd Th]
pokernutt420: folds=20
excon tyrone: folds=20
JJin91: raises 400 to 600
M456G: folds=20
bretlaviola: folds=20
Uncalled bet (400) returned to JJin91
JJin91 collected 625 from pot
*** SUMMARY ***
Total pot 625 | Rake 0=20
Seat 1: M456G (small blind) folded before Flop
Seat 2: bretlaviola (big blind) folded before Flop
Seat 3: pokernutt420 folded before Flop (didn't bet)
Seat 4: excon tyrone folded before Flop (didn't bet)
Seat 5: JJin91 (button) collected (625)


*********** # 95 **************
PokerStars Hand #169426542146: Tournament #1597684008, $13.50+$1.50 USD=
 Hold'em No Limit - Level VII (100/200) - 2017/05/05 14:41:45 ET
Table '1597684008 8' 6-max Seat #1 is the button
Seat 1: M456G (3042 in chips)=20
Seat 2: bretlaviola (15867 in chips)=20
Seat 3: pokernutt420 (13842 in chips)=20
Seat 4: excon tyrone (8653 in chips)=20
Seat 5: JJin91 (20801 in chips)=20
M456G: posts the ante 25
bretlaviola: posts the ante 25
pokernutt420: posts the ante 25
excon tyrone: posts the ante 25
JJin91: posts the ante 25
bretlaviola: posts small blind 100
pokernutt420: posts big blind 200
*** HOLE CARDS ***
Dealt to JJin91 [Ac 8c]
excon tyrone: folds=20
JJin91: raises 400 to 600
M456G: folds=20
bretlaviola: folds=20
pokernutt420: folds=20
Uncalled bet (400) returned to JJin91
JJin91 collected 625 from pot
*** SUMMARY ***
Total pot 625 | Rake 0=20
Seat 1: M456G (button) folded before Flop (didn't bet)
Seat 2: bretlaviola (small blind) folded before Flop
Seat 3: pokernutt420 (big blind) folded before Flop
Seat 4: excon tyrone folded before Flop (didn't bet)
Seat 5: JJin91 collected (625)


*********** # 96 **************
PokerStars Hand #169426542182: Tournament #1597684008, $13.50+$1.50 USD=
 Hold'em No Limit - Level VII (100/200) - 2017/05/05 14:42:04 ET
Table '1597684008 8' 6-max Seat #2 is the button
Seat 1: M456G (3017 in chips)=20
Seat 2: bretlaviola (15742 in chips)=20
Seat 3: pokernutt420 (13617 in chips)=20
Seat 4: excon tyrone (8628 in chips)=20
Seat 5: JJin91 (21201 in chips)=20
M456G: posts the ante 25
bretlaviola: posts the ante 25
pokernutt420: posts the ante 25
excon tyrone: posts the ante 25
JJin91: posts the ante 25
pokernutt420: posts small blind 100
excon tyrone: posts big blind 200
*** HOLE CARDS ***
Dealt to JJin91 [8s 9c]
JJin91: folds=20
M456G: folds=20
bretlaviola: folds=20
pokernutt420: calls 100
excon tyrone: checks=20
*** FLOP *** [6c Ac Js]
pokernutt420: bets 400
excon tyrone: folds=20
Uncalled bet (400) returned to pokernutt420
pokernutt420 collected 525 from pot
pokernutt420: doesn't show hand=20
*** SUMMARY ***
Total pot 525 | Rake 0=20
Board [6c Ac Js]
Seat 1: M456G folded before Flop (didn't bet)
Seat 2: bretlaviola (button) folded before Flop (didn't bet)
Seat 3: pokernutt420 (small blind) collected (525)
Seat 4: excon tyrone (big blind) folded on the Flop
Seat 5: JJin91 folded before Flop (didn't bet)


*********** # 97 **************
PokerStars Hand #169426542248: Tournament #1597684008, $13.50+$1.50 USD=
 Hold'em No Limit - Level VII (100/200) - 2017/05/05 14:42:27 ET
Table '1597684008 8' 6-max Seat #3 is the button
Seat 1: M456G (2992 in chips)=20
Seat 2: bretlaviola (15717 in chips)=20
Seat 3: pokernutt420 (13917 in chips)=20
Seat 4: excon tyrone (8403 in chips)=20
Seat 5: JJin91 (21176 in chips)=20
M456G: posts the ante 25
bretlaviola: posts the ante 25
pokernutt420: posts the ante 25
excon tyrone: posts the ante 25
JJin91: posts the ante 25
excon tyrone: posts small blind 100
JJin91: posts big blind 200
*** HOLE CARDS ***
Dealt to JJin91 [4s 5c]
M456G: folds=20
bretlaviola: raises 200 to 400
pokernutt420: calls 400
excon tyrone: folds=20
JJin91: folds=20
*** FLOP *** [Kd 3h 7d]
bretlaviola: checks=20
pokernutt420: bets 613
bretlaviola: folds=20
Uncalled bet (613) returned to pokernutt420
pokernutt420 collected 1225 from pot
pokernutt420: doesn't show hand=20
*** SUMMARY ***
Total pot 1225 | Rake 0=20
Board [Kd 3h 7d]
Seat 1: M456G folded before Flop (didn't bet)
Seat 2: bretlaviola folded on the Flop
Seat 3: pokernutt420 (button) collected (1225)
Seat 4: excon tyrone (small blind) folded before Flop
Seat 5: JJin91 (big blind) folded before Flop


*********** # 98 **************
PokerStars Hand #169426542331: Tournament #1597684008, $13.50+$1.50 USD=
 Hold'em No Limit - Level VII (100/200) - 2017/05/05 14:42:57 ET
Table '1597684008 8' 6-max Seat #4 is the button
Seat 1: M456G (2967 in chips)=20
Seat 2: bretlaviola (15292 in chips)=20
Seat 3: pokernutt420 (14717 in chips)=20
Seat 4: excon tyrone (8278 in chips)=20
Seat 5: JJin91 (20951 in chips)=20
Seat 6: WwSalwW (10000 in chips)=20
M456G: posts the ante 25
bretlaviola: posts the ante 25
pokernutt420: posts the ante 25
excon tyrone: posts the ante 25
JJin91: posts the ante 25
WwSalwW: posts the ante 25
JJin91: posts small blind 100
WwSalwW: posts big blind 200
*** HOLE CARDS ***
Dealt to JJin91 [Ts 9h]
M456G: folds=20
bretlaviola: folds=20
pokernutt420: folds=20
excon tyrone: folds=20
JJin91: calls 100
WwSalwW: checks=20
*** FLOP *** [As Ac 3d]
JJin91: checks=20
WwSalwW: checks=20
*** TURN *** [As Ac 3d] [Jh]
JJin91: checks=20
WwSalwW: bets 200
JJin91: folds=20
Uncalled bet (200) returned to WwSalwW
WwSalwW collected 550 from pot
*** SUMMARY ***
Total pot 550 | Rake 0=20
Board [As Ac 3d Jh]
Seat 1: M456G folded before Flop (didn't bet)
Seat 2: bretlaviola folded before Flop (didn't bet)
Seat 3: pokernutt420 folded before Flop (didn't bet)
Seat 4: excon tyrone (button) folded before Flop (didn't bet)
Seat 5: JJin91 (small blind) folded on the Turn
Seat 6: WwSalwW (big blind) collected (550)


*********** # 99 **************
PokerStars Hand #169426542433: Tournament #1597684008, $13.50+$1.50 USD=
 Hold'em No Limit - Level VII (100/200) - 2017/05/05 14:43:37 ET
Table '1597684008 8' 6-max Seat #5 is the button
Seat 1: M456G (2942 in chips)=20
Seat 2: bretlaviola (15267 in chips)=20
Seat 3: pokernutt420 (14692 in chips)=20
Seat 4: excon tyrone (8253 in chips)=20
Seat 5: JJin91 (20726 in chips)=20
Seat 6: WwSalwW (10325 in chips)=20
M456G: posts the ante 25
bretlaviola: posts the ante 25
pokernutt420: posts the ante 25
excon tyrone: posts the ante 25
JJin91: posts the ante 25
WwSalwW: posts the ante 25
WwSalwW: posts small blind 100
M456G: posts big blind 200
*** HOLE CARDS ***
Dealt to JJin91 [7h 3c]
bretlaviola: calls 200
pokernutt420: folds=20
excon tyrone: calls 200
JJin91: folds=20
WwSalwW: calls 100
M456G: checks=20
*** FLOP *** [3h 5c Ah]
WwSalwW: bets 200
M456G: folds=20
bretlaviola: raises 200 to 400
excon tyrone: calls 400
WwSalwW: folds=20
*** TURN *** [3h 5c Ah] [Td]
bretlaviola: checks=20
excon tyrone: checks=20
*** RIVER *** [3h 5c Ah Td] [Kd]
bretlaviola: checks=20
excon tyrone: bets 4200
bretlaviola: raises 10442 to 14642 and is all-in
excon tyrone: calls 3428 and is all-in
Uncalled bet (7014) returned to bretlaviola
*** SHOW DOWN ***
bretlaviola: shows [3d 3s] (three of a kind, Threes)
excon tyrone: shows [Jh Qh] (a straight, Ten to Ace)
excon tyrone collected 17206 from pot
*** SUMMARY ***
Total pot 17206 | Rake 0=20
Board [3h 5c Ah Td Kd]
Seat 1: M456G (big blind) folded on the Flop
Seat 2: bretlaviola showed [3d 3s] and lost with three of a kind, Threes
Seat 3: pokernutt420 folded before Flop (didn't bet)
Seat 4: excon tyrone showed [Jh Qh] and won (17206) with a straight, Te=
n to Ace
Seat 5: JJin91 (button) folded before Flop (didn't bet)
Seat 6: WwSalwW (small blind) folded on the Flop


*********** # 100 **************
PokerStars Hand #169426542594: Tournament #1597684008, $13.50+$1.50 USD=
 Hold'em No Limit - Level VII (100/200) - 2017/05/05 14:44:30 ET
Table '1597684008 8' 6-max Seat #6 is the button
Seat 1: M456G (2717 in chips)=20
Seat 2: bretlaviola (7014 in chips)=20
Seat 3: pokernutt420 (14667 in chips)=20
Seat 4: excon tyrone (17206 in chips)=20
Seat 5: JJin91 (20701 in chips)=20
Seat 6: WwSalwW (9900 in chips)=20
M456G: posts the ante 25
bretlaviola: posts the ante 25
pokernutt420: posts the ante 25
excon tyrone: posts the ante 25
JJin91: posts the ante 25
WwSalwW: posts the ante 25
M456G: posts small blind 100
bretlaviola: posts big blind 200
*** HOLE CARDS ***
Dealt to JJin91 [4d 6h]
bretlaviola said, "joke"
pokernutt420: folds=20
excon tyrone: folds=20
JJin91: folds=20
WwSalwW: folds=20
M456G: calls 100
bretlaviola: raises 6789 to 6989 and is all-in
M456G: folds=20
Uncalled bet (6789) returned to bretlaviola
bretlaviola collected 550 from pot
excon tyrone said, "what shoving with a straight out there"
*** SUMMARY ***
Total pot 550 | Rake 0=20
Seat 1: M456G (small blind) folded before Flop
Seat 2: bretlaviola (big blind) collected (550)
Seat 3: pokernutt420 folded before Flop (didn't bet)
Seat 4: excon tyrone folded before Flop (didn't bet)
Seat 5: JJin91 folded before Flop (didn't bet)
Seat 6: WwSalwW (button) folded before Flop (didn't bet)


*********** # 101 **************
PokerStars Hand #169426542636: Tournament #1597684008, $13.50+$1.50 USD=
 Hold'em No Limit - Level VII (100/200) - 2017/05/05 14:44:48 ET
Table '1597684008 8' 6-max Seat #1 is the button
Seat 1: M456G (2492 in chips)=20
Seat 2: bretlaviola (7339 in chips)=20
Seat 3: pokernutt420 (14642 in chips)=20
Seat 4: excon tyrone (17181 in chips)=20
Seat 5: JJin91 (20676 in chips)=20
Seat 6: WwSalwW (9875 in chips)=20
M456G: posts the ante 25
bretlaviola: posts the ante 25
pokernutt420: posts the ante 25
excon tyrone: posts the ante 25
JJin91: posts the ante 25
WwSalwW: posts the ante 25
bretlaviola: posts small blind 100
pokernutt420: posts big blind 200
*** HOLE CARDS ***
Dealt to JJin91 [Ts 5c]
excon tyrone: folds=20
JJin91: folds=20
WwSalwW: calls 200
M456G: calls 200
bretlaviola said, "u ran turn a river its called nigg a luck"
bretlaviola: calls 100
pokernutt420: raises 400 to 600
WwSalwW: calls 400
M456G: calls 400
bretlaviola said, "site loves doing that"
bretlaviola: calls 400
*** FLOP *** [3d Kd Qc]
excon tyrone said, "i flopped flush draw and u checked turn"
bretlaviola: checks=20
pokernutt420: bets 1275
excon tyrone said, "DUMB"
WwSalwW: raises 1275 to 2550
M456G: calls 1867 and is all-in
bretlaviola: folds=20
pokernutt420: calls 1275
*** TURN *** [3d Kd Qc] [8c]
pokernutt420: checks=20
WwSalwW: bets 200
pokernutt420: calls 200
*** RIVER *** [3d Kd Qc 8c] [9s]
pokernutt420: checks=20
WwSalwW: checks=20
*** SHOW DOWN ***
pokernutt420: shows [Jh Ah] (high card Ace)
WwSalwW: shows [Kc Td] (a pair of Kings)
WwSalwW collected 1766 from side pot
M456G: mucks hand=20
WwSalwW collected 8151 from main pot
M456G finished the tournament in 82nd place
*** SUMMARY ***
Total pot 9917 Main pot 8151. Side pot 1766. | Rake 0=20
Board [3d Kd Qc 8c 9s]
Seat 1: M456G (button) mucked [4d Ad]
Seat 2: bretlaviola (small blind) folded on the Flop
Seat 3: pokernutt420 (big blind) showed [Jh Ah] and lost with high card=
 Ace
Seat 4: excon tyrone folded before Flop (didn't bet)
Seat 5: JJin91 folded before Flop (didn't bet)
Seat 6: WwSalwW showed [Kc Td] and won (9917) with a pair of Kings


*********** # 102 **************
PokerStars Hand #169426542833: Tournament #1597684008, $13.50+$1.50 USD=
 Hold'em No Limit - Level VII (100/200) - 2017/05/05 14:46:01 ET
Table '1597684008 8' 6-max Seat #2 is the button
Seat 2: bretlaviola (6714 in chips)=20
Seat 3: pokernutt420 (11267 in chips)=20
Seat 4: excon tyrone (17156 in chips)=20
Seat 5: JJin91 (20651 in chips)=20
Seat 6: WwSalwW (16417 in chips)=20
bretlaviola: posts the ante 25
pokernutt420: posts the ante 25
excon tyrone: posts the ante 25
JJin91: posts the ante 25
WwSalwW: posts the ante 25
pokernutt420: posts small blind 100
excon tyrone: posts big blind 200
*** HOLE CARDS ***
Dealt to JJin91 [Jc Js]
JJin91: raises 400 to 600
WwSalwW: calls 600
bretlaviola: folds=20
pokernutt420: raises 10642 to 11242 and is all-in
excon tyrone: folds=20
JJin91: folds=20
WwSalwW: folds=20
Uncalled bet (10642) returned to pokernutt420
bretlaviola said, "i did not see the flush draw but it ok"
pokernutt420 collected 2125 from pot
pokernutt420: doesn't show hand=20
*** SUMMARY ***
Total pot 2125 | Rake 0=20
Seat 2: bretlaviola (button) folded before Flop (didn't bet)
Seat 3: pokernutt420 (small blind) collected (2125)
Seat 4: excon tyrone (big blind) folded before Flop
Seat 5: JJin91 folded before Flop
Seat 6: WwSalwW folded before Flop


*********** # 103 **************
PokerStars Hand #169426542899: Tournament #1597684008, $13.50+$1.50 USD=
 Hold'em No Limit - Level VII (100/200) - 2017/05/05 14:46:27 ET
Table '1597684008 8' 6-max Seat #3 is the button
Seat 2: bretlaviola (6689 in chips)=20
Seat 3: pokernutt420 (12767 in chips)=20
Seat 4: excon tyrone (16931 in chips)=20
Seat 5: JJin91 (20026 in chips)=20
Seat 6: WwSalwW (15792 in chips)=20
bretlaviola: posts the ante 25
pokernutt420: posts the ante 25
excon tyrone: posts the ante 25
JJin91: posts the ante 25
WwSalwW: posts the ante 25
excon tyrone: posts small blind 100
JJin91: posts big blind 200
*** HOLE CARDS ***
Dealt to JJin91 [Kd 6c]
WwSalwW: folds=20
bretlaviola said, "i rather lose that way"
bretlaviola: raises 800 to 1000
pokernutt420: folds=20
excon tyrone: folds=20
JJin91: folds=20
Uncalled bet (800) returned to bretlaviola
bretlaviola collected 625 from pot
*** SUMMARY ***
Total pot 625 | Rake 0=20
Seat 2: bretlaviola collected (625)
Seat 3: pokernutt420 (button) folded before Flop (didn't bet)
Seat 4: excon tyrone (small blind) folded before Flop
Seat 5: JJin91 (big blind) folded before Flop
Seat 6: WwSalwW folded before Flop (didn't bet)


*********** # 104 **************
PokerStars Hand #169426542962: Tournament #1597684008, $13.50+$1.50 USD=
 Hold'em No Limit - Level VIII (125/250) - 2017/05/05 14:46:53 ET
Table '1597684008 8' 6-max Seat #4 is the button
Seat 2: bretlaviola (7089 in chips)=20
Seat 3: pokernutt420 (12742 in chips)=20
Seat 4: excon tyrone (16806 in chips)=20
Seat 5: JJin91 (19801 in chips)=20
Seat 6: WwSalwW (15767 in chips)=20
bretlaviola: posts the ante 30
pokernutt420: posts the ante 30
excon tyrone: posts the ante 30
JJin91: posts the ante 30
WwSalwW: posts the ante 30
JJin91: posts small blind 125
WwSalwW: posts big blind 250
*** HOLE CARDS ***
Dealt to JJin91 [9d Ah]
bretlaviola: calls 250
excon tyrone said, "only reason i stayed"
pokernutt420: folds=20
bretlaviola said, "your right"
excon tyrone said, "u make it 3k i have to think"
excon tyrone: folds=20
JJin91: calls 125
WwSalwW: checks=20
*** FLOP *** [5d 4h 7h]
JJin91: checks=20
WwSalwW: checks=20
bretlaviola said, "i rather you have caught the fluash then lose that w=
ay"
bretlaviola: checks=20
*** TURN *** [5d 4h 7h] [2d]
JJin91: checks=20
WwSalwW: checks=20
bretlaviola: bets 900
JJin91: folds=20
WwSalwW: calls 900
*** RIVER *** [5d 4h 7h 2d] [Kh]
WwSalwW: checks=20
bretlaviola: bets 1350
WwSalwW: calls 1350
*** SHOW DOWN ***
bretlaviola: shows [Ad Js] (high card Ace)
WwSalwW: shows [7s Ts] (a pair of Sevens)
WwSalwW collected 5400 from pot
*** SUMMARY ***
Total pot 5400 | Rake 0=20
Board [5d 4h 7h 2d Kh]
Seat 2: bretlaviola showed [Ad Js] and lost with high card Ace
Seat 3: pokernutt420 folded before Flop (didn't bet)
Seat 4: excon tyrone (button) folded before Flop (didn't bet)
Seat 5: JJin91 (small blind) folded on the Turn
Seat 6: WwSalwW (big blind) showed [7s Ts] and won (5400) with a pair o=
f Sevens


*********** # 105 **************
PokerStars Hand #169426543146: Tournament #1597684008, $13.50+$1.50 USD=
 Hold'em No Limit - Level VIII (125/250) - 2017/05/05 14:47:54 ET
Table '1597684008 8' 6-max Seat #5 is the button
Seat 2: bretlaviola (4559 in chips)=20
Seat 3: pokernutt420 (12712 in chips)=20
Seat 4: excon tyrone (16776 in chips)=20
Seat 5: JJin91 (19521 in chips)=20
Seat 6: WwSalwW (18637 in chips)=20
bretlaviola: posts the ante 30
pokernutt420: posts the ante 30
excon tyrone: posts the ante 30
JJin91: posts the ante 30
WwSalwW: posts the ante 30
WwSalwW: posts small blind 125
bretlaviola: posts big blind 250
*** HOLE CARDS ***
Dealt to JJin91 [Kd Js]
pokernutt420: calls 250
excon tyrone: folds=20
JJin91: raises 500 to 750
WwSalwW: folds=20
bretlaviola: folds=20
pokernutt420: calls 500
*** FLOP *** [Ad 4c 9h]
pokernutt420: checks=20
JJin91: bets 1142
pokernutt420: folds=20
Uncalled bet (1142) returned to JJin91
JJin91 collected 2025 from pot
*** SUMMARY ***
Total pot 2025 | Rake 0=20
Board [Ad 4c 9h]
Seat 2: bretlaviola (big blind) folded before Flop
Seat 3: pokernutt420 folded on the Flop
Seat 4: excon tyrone folded before Flop (didn't bet)
Seat 5: JJin91 (button) collected (2025)
Seat 6: WwSalwW (small blind) folded before Flop


*********** # 106 **************
PokerStars Hand #169426543229: Tournament #1597684008, $13.50+$1.50 USD=
 Hold'em No Limit - Level VIII (125/250) - 2017/05/05 14:48:23 ET
Table '1597684008 8' 6-max Seat #6 is the button
Seat 2: bretlaviola (4279 in chips)=20
Seat 3: pokernutt420 (11932 in chips)=20
Seat 4: excon tyrone (16746 in chips)=20
Seat 5: JJin91 (20766 in chips)=20
Seat 6: WwSalwW (18482 in chips)=20
bretlaviola: posts the ante 30
pokernutt420: posts the ante 30
excon tyrone: posts the ante 30
JJin91: posts the ante 30
WwSalwW: posts the ante 30
bretlaviola: posts small blind 125
pokernutt420: posts big blind 250
*** HOLE CARDS ***
Dealt to JJin91 [Tc 9d]
excon tyrone: folds=20
JJin91: folds=20
WwSalwW: folds=20
bretlaviola: raises 3999 to 4249 and is all-in
pokernutt420: folds=20
Uncalled bet (3999) returned to bretlaviola
bretlaviola collected 650 from pot
*** SUMMARY ***
Total pot 650 | Rake 0=20
Seat 2: bretlaviola (small blind) collected (650)
Seat 3: pokernutt420 (big blind) folded before Flop
Seat 4: excon tyrone folded before Flop (didn't bet)
Seat 5: JJin91 folded before Flop (didn't bet)
Seat 6: WwSalwW (button) folded before Flop (didn't bet)


*********** # 107 **************
PokerStars Hand #169426543271: Tournament #1597684008, $13.50+$1.50 USD=
 Hold'em No Limit - Level VIII (125/250) - 2017/05/05 14:48:38 ET
Table '1597684008 8' 6-max Seat #2 is the button
Seat 2: bretlaviola (4649 in chips)=20
Seat 3: pokernutt420 (11652 in chips)=20
Seat 4: excon tyrone (16716 in chips)=20
Seat 5: JJin91 (20736 in chips)=20
Seat 6: WwSalwW (18452 in chips)=20
bretlaviola: posts the ante 30
pokernutt420: posts the ante 30
excon tyrone: posts the ante 30
JJin91: posts the ante 30
WwSalwW: posts the ante 30
pokernutt420: posts small blind 125
excon tyrone: posts big blind 250
*** HOLE CARDS ***
Dealt to JJin91 [Ah 6c]
JJin91: folds=20
WwSalwW: folds=20
bretlaviola: calls 250
pokernutt420: folds=20
excon tyrone: checks=20
*** FLOP *** [Ks 3h Jh]
excon tyrone: bets 250
bretlaviola: calls 250
*** TURN *** [Ks 3h Jh] [Qd]
excon tyrone: bets 250
bretlaviola: calls 250
*** RIVER *** [Ks 3h Jh Qd] [3d]
excon tyrone: checks=20
bretlaviola: checks=20
*** SHOW DOWN ***
excon tyrone: shows [9s Js] (two pair, Jacks and Threes)
bretlaviola: shows [2h Qh] (two pair, Queens and Threes)
bretlaviola collected 1775 from pot
*** SUMMARY ***
Total pot 1775 | Rake 0=20
Board [Ks 3h Jh Qd 3d]
Seat 2: bretlaviola (button) showed [2h Qh] and won (1775) with two pai=
r, Queens and Threes
Seat 3: pokernutt420 (small blind) folded before Flop
Seat 4: excon tyrone (big blind) showed [9s Js] and lost with two pair,=
 Jacks and Threes
Seat 5: JJin91 folded before Flop (didn't bet)
Seat 6: WwSalwW folded before Flop (didn't bet)


*********** # 108 **************
PokerStars Hand #169426543326: Tournament #1597684008, $13.50+$1.50 USD=
 Hold'em No Limit - Level VIII (125/250) - 2017/05/05 14:48:57 ET
Table '1597684008 8' 6-max Seat #3 is the button
Seat 2: bretlaviola (5644 in chips)=20
Seat 3: pokernutt420 (11497 in chips)=20
Seat 4: excon tyrone (15936 in chips)=20
Seat 5: JJin91 (20706 in chips)=20
Seat 6: WwSalwW (18422 in chips)=20
bretlaviola: posts the ante 30
pokernutt420: posts the ante 30
excon tyrone: posts the ante 30
JJin91: posts the ante 30
WwSalwW: posts the ante 30
excon tyrone: posts small blind 125
JJin91: posts big blind 250
*** HOLE CARDS ***
Dealt to JJin91 [3h 7d]
WwSalwW: folds=20
bretlaviola: raises 5364 to 5614 and is all-in
pokernutt420: folds=20
excon tyrone: folds=20
JJin91: folds=20
Uncalled bet (5364) returned to bretlaviola
bretlaviola collected 775 from pot
*** SUMMARY ***
Total pot 775 | Rake 0=20
Seat 2: bretlaviola collected (775)
Seat 3: pokernutt420 (button) folded before Flop (didn't bet)
Seat 4: excon tyrone (small blind) folded before Flop
Seat 5: JJin91 (big blind) folded before Flop
Seat 6: WwSalwW folded before Flop (didn't bet)


*********** # 109 **************
PokerStars Hand #169426543365: Tournament #1597684008, $13.50+$1.50 USD=
 Hold'em No Limit - Level VIII (125/250) - 2017/05/05 14:49:13 ET
Table '1597684008 8' 6-max Seat #4 is the button
Seat 2: bretlaviola (6139 in chips)=20
Seat 3: pokernutt420 (11467 in chips)=20
Seat 4: excon tyrone (15781 in chips)=20
Seat 5: JJin91 (20426 in chips)=20
Seat 6: WwSalwW (18392 in chips)=20
bretlaviola: posts the ante 30
pokernutt420: posts the ante 30
excon tyrone: posts the ante 30
JJin91: posts the ante 30
WwSalwW: posts the ante 30
JJin91: posts small blind 125
WwSalwW: posts big blind 250
*** HOLE CARDS ***
Dealt to JJin91 [4c Td]
bretlaviola: folds=20
pokernutt420: folds=20
excon tyrone: folds=20
JJin91: folds=20
Uncalled bet (125) returned to WwSalwW
WwSalwW collected 400 from pot
*** SUMMARY ***
Total pot 400 | Rake 0=20
Seat 2: bretlaviola folded before Flop (didn't bet)
Seat 3: pokernutt420 folded before Flop (didn't bet)
Seat 4: excon tyrone (button) folded before Flop (didn't bet)
Seat 5: JJin91 (small blind) folded before Flop
Seat 6: WwSalwW (big blind) collected (400)


*********** # 110 **************
PokerStars Hand #169426543418: Tournament #1597684008, $13.50+$1.50 USD=
 Hold'em No Limit - Level VIII (125/250) - 2017/05/05 14:49:31 ET
Table '1597684008 8' 6-max Seat #5 is the button
Seat 2: bretlaviola (6109 in chips)=20
Seat 3: pokernutt420 (11437 in chips)=20
Seat 4: excon tyrone (15751 in chips)=20
Seat 5: JJin91 (20271 in chips)=20
Seat 6: WwSalwW (18637 in chips)=20
bretlaviola: posts the ante 30
pokernutt420: posts the ante 30
excon tyrone: posts the ante 30
JJin91: posts the ante 30
WwSalwW: posts the ante 30
WwSalwW: posts small blind 125
bretlaviola: posts big blind 250
*** HOLE CARDS ***
Dealt to JJin91 [2c 5h]
pokernutt420: folds=20
excon tyrone: folds=20
JJin91: folds=20
WwSalwW: folds=20
Uncalled bet (125) returned to bretlaviola
bretlaviola collected 400 from pot
bretlaviola: doesn't show hand=20
*** SUMMARY ***
Total pot 400 | Rake 0=20
Seat 2: bretlaviola (big blind) collected (400)
Seat 3: pokernutt420 folded before Flop (didn't bet)
Seat 4: excon tyrone folded before Flop (didn't bet)
Seat 5: JJin91 (button) folded before Flop (didn't bet)
Seat 6: WwSalwW (small blind) folded before Flop


*********** # 111 **************
PokerStars Hand #169426543444: Tournament #1597684008, $13.50+$1.50 USD=
 Hold'em No Limit - Level VIII (125/250) - 2017/05/05 14:49:42 ET
Table '1597684008 8' 6-max Seat #6 is the button
Seat 2: bretlaviola (6354 in chips)=20
Seat 3: pokernutt420 (11407 in chips)=20
Seat 4: excon tyrone (15721 in chips)=20
Seat 5: JJin91 (20241 in chips)=20
Seat 6: WwSalwW (18482 in chips)=20
bretlaviola: posts the ante 30
pokernutt420: posts the ante 30
excon tyrone: posts the ante 30
JJin91: posts the ante 30
WwSalwW: posts the ante 30
bretlaviola: posts small blind 125
pokernutt420: posts big blind 250
*** HOLE CARDS ***
Dealt to JJin91 [7h Qd]
excon tyrone: folds=20
JJin91: folds=20
WwSalwW: folds=20
bretlaviola: raises 750 to 1000
pokernutt420: calls 750
*** FLOP *** [Jc 7d Tc]
bretlaviola: checks=20
pokernutt420: checks=20
*** TURN *** [Jc 7d Tc] [Ac]
bretlaviola: checks=20
pokernutt420: checks=20
*** RIVER *** [Jc 7d Tc Ac] [8c]
bretlaviola: checks=20
pokernutt420: checks=20
*** SHOW DOWN ***
bretlaviola: shows [Jd Jh] (three of a kind, Jacks)
pokernutt420: shows [9d Ah] (a straight, Seven to Jack)
pokernutt420 collected 2150 from pot
*** SUMMARY ***
Total pot 2150 | Rake 0=20
Board [Jc 7d Tc Ac 8c]
Seat 2: bretlaviola (small blind) showed [Jd Jh] and lost with three of=
 a kind, Jacks
Seat 3: pokernutt420 (big blind) showed [9d Ah] and won (2150) with a s=
traight, Seven to Jack
Seat 4: excon tyrone folded before Flop (didn't bet)
Seat 5: JJin91 folded before Flop (didn't bet)
Seat 6: WwSalwW (button) folded before Flop (didn't bet)


*********** # 112 **************
PokerStars Hand #169426543516: Tournament #1597684008, $13.50+$1.50 USD=
 Hold'em No Limit - Level VIII (125/250) - 2017/05/05 14:50:07 ET
Table '1597684008 8' 6-max Seat #2 is the button
Seat 2: bretlaviola (5324 in chips)=20
Seat 3: pokernutt420 (12527 in chips)=20
Seat 4: excon tyrone (15691 in chips)=20
Seat 5: JJin91 (20211 in chips)=20
Seat 6: WwSalwW (18452 in chips)=20
bretlaviola: posts the ante 30
pokernutt420: posts the ante 30
excon tyrone: posts the ante 30
JJin91: posts the ante 30
WwSalwW: posts the ante 30
pokernutt420: posts small blind 125
excon tyrone: posts big blind 250
*** HOLE CARDS ***
Dealt to JJin91 [3s Kd]
bretlaviola said, "seee"
JJin91: folds=20
bretlaviola said, "so bad"
bretlaviola said, "i bet he called"
bretlaviola said, "lol"
WwSalwW: folds=20
bretlaviola: calls 250
pokernutt420: calls 125
bretlaviola said, "this site su cks"
excon tyrone: raises 1250 to 1500
bretlaviola: calls 1250
pokernutt420: folds=20
*** FLOP *** [9h 7h Qc]
excon tyrone: bets 6250
bretlaviola: calls 3794 and is all-in
Uncalled bet (2456) returned to excon tyrone
*** TURN *** [9h 7h Qc] [Td]
*** RIVER *** [9h 7h Qc Td] [5d]
*** SHOW DOWN ***
excon tyrone: shows [Js Ac] (high card Ace)
bretlaviola: shows [3h Jh] (high card Queen)
excon tyrone collected 10988 from pot
bretlaviola finished the tournament in 78th place
*** SUMMARY ***
Total pot 10988 | Rake 0=20
Board [9h 7h Qc Td 5d]
Seat 2: bretlaviola (button) showed [3h Jh] and lost with high card Que=
en
Seat 3: pokernutt420 (small blind) folded before Flop
Seat 4: excon tyrone (big blind) showed [Js Ac] and won (10988) with hi=
gh card Ace
Seat 5: JJin91 folded before Flop (didn't bet)
Seat 6: WwSalwW folded before Flop (didn't bet)


*********** # 113 **************
PokerStars Hand #169426543643: Tournament #1597684008, $13.50+$1.50 USD=
 Hold'em No Limit - Level VIII (125/250) - 2017/05/05 14:50:52 ET
Table '1597684008 8' 6-max Seat #3 is the button
Seat 3: pokernutt420 (12247 in chips)=20
Seat 4: excon tyrone (21355 in chips)=20
Seat 5: JJin91 (20181 in chips)=20
Seat 6: WwSalwW (18422 in chips)=20
pokernutt420: posts the ante 30
excon tyrone: posts the ante 30
JJin91: posts the ante 30
WwSalwW: posts the ante 30
excon tyrone: posts small blind 125
JJin91: posts big blind 250
*** HOLE CARDS ***
Dealt to JJin91 [5c 2h]
excon tyrone said, "gg"
WwSalwW: calls 250
pokernutt420: folds=20
excon tyrone: folds=20
JJin91: checks=20
*** FLOP *** [Ad 2d 5d]
JJin91: bets 500
WwSalwW: calls 500
*** TURN *** [Ad 2d 5d] [6s]
pokerazmus said, "oh, tyron is back!"
JJin91: checks=20
WwSalwW: checks=20
*** RIVER *** [Ad 2d 5d 6s] [As]
JJin91: checks=20
pokerazmus said, "welcome back man"
WwSalwW: checks=20
*** SHOW DOWN ***
JJin91: shows [5c 2h] (two pair, Aces and Fives)
WwSalwW: mucks hand=20
JJin91 collected 1745 from pot
*** SUMMARY ***
Total pot 1745 | Rake 0=20
Board [Ad 2d 5d 6s As]
Seat 3: pokernutt420 (button) folded before Flop (didn't bet)
Seat 4: excon tyrone (small blind) folded before Flop
Seat 5: JJin91 (big blind) showed [5c 2h] and won (1745) with two pair,=
 Aces and Fives
Seat 6: WwSalwW mucked [9h Qd]


*********** # 114 **************
PokerStars Hand #169426543724: Tournament #1597684008, $13.50+$1.50 USD=
 Hold'em No Limit - Level VIII (125/250) - 2017/05/05 14:51:21 ET
Table '1597684008 8' 6-max Seat #4 is the button
Seat 1: pokerazmus (17793 in chips)=20
Seat 3: pokernutt420 (12217 in chips)=20
Seat 4: excon tyrone (21200 in chips)=20
Seat 5: JJin91 (21146 in chips)=20
Seat 6: WwSalwW (17642 in chips)=20
pokerazmus: posts the ante 30
pokernutt420: posts the ante 30
excon tyrone: posts the ante 30
JJin91: posts the ante 30
WwSalwW: posts the ante 30
JJin91: posts small blind 125
WwSalwW: posts big blind 250
*** HOLE CARDS ***
Dealt to JJin91 [9c 6c]
pokerazmus said, "I see you quadrupeled up :)"
pokerazmus: folds=20
pokernutt420: calls 250
excon tyrone: folds=20
pokerazmus said, "nice, congrats!"
JJin91: calls 125
WwSalwW: checks=20
*** FLOP *** [Td 7h Jd]
JJin91: checks=20
WwSalwW: checks=20
pokernutt420: checks=20
*** TURN *** [Td 7h Jd] [Ks]
excon tyrone said, "the aj 99 hand was bs"
JJin91: bets 500
WwSalwW: calls 500
pokernutt420: folds=20
*** RIVER *** [Td 7h Jd Ks] [3h]
JJin91: checks=20
WwSalwW: bets 500
JJin91: folds=20
Uncalled bet (500) returned to WwSalwW
WwSalwW collected 1900 from pot
*** SUMMARY ***
Total pot 1900 | Rake 0=20
Board [Td 7h Jd Ks 3h]
Seat 1: pokerazmus folded before Flop (didn't bet)
Seat 3: pokernutt420 folded on the Turn
Seat 4: excon tyrone (button) folded before Flop (didn't bet)
Seat 5: JJin91 (small blind) folded on the River
Seat 6: WwSalwW (big blind) collected (1900)


*********** # 115 **************
PokerStars Hand #169426543845: Tournament #1597684008, $13.50+$1.50 USD=
 Hold'em No Limit - Level VIII (125/250) - 2017/05/05 14:52:06 ET
Table '1597684008 8' 6-max Seat #5 is the button
Seat 1: pokerazmus (17763 in chips)=20
Seat 3: pokernutt420 (11937 in chips)=20
Seat 4: excon tyrone (21170 in chips)=20
Seat 5: JJin91 (20366 in chips)=20
Seat 6: WwSalwW (18762 in chips)=20
pokerazmus: posts the ante 30
pokernutt420: posts the ante 30
excon tyrone: posts the ante 30
JJin91: posts the ante 30
WwSalwW: posts the ante 30
WwSalwW: posts small blind 125
pokerazmus: posts big blind 250
*** HOLE CARDS ***
Dealt to JJin91 [9s Qs]
pokernutt420: calls 250
pokerazmus said, "u didnt have to go all crazy there though, only the h=
and that beats you there calls you"
excon tyrone said, "AA89J"
excon tyrone said, "Get real"
excon tyrone: folds=20
JJin91: calls 250
WwSalwW: folds=20
pokerazmus said, "any ace below AQ would probably fold"
pokerazmus: checks=20
*** FLOP *** [5s 2h Jd]
pokerazmus said, "if he is a good player"
excon tyrone said, "no way"
pokerazmus: checks=20
pokernutt420: checks=20
JJin91: checks=20
*** TURN *** [5s 2h Jd] [5h]
pokerazmus: checks=20
pokernutt420: checks=20
excon tyrone said, "i made it 5k on the turn"
JJin91: checks=20
*** RIVER *** [5s 2h Jd 5h] [5d]
pokerazmus said, "but not in $15 donkaments :)"
pokerazmus: checks=20
excon tyrone said, "had to or no way he folds"
pokernutt420: checks=20
JJin91: checks=20
*** SHOW DOWN ***
pokerazmus: shows [9h 8d] (three of a kind, Fives)
pokernutt420: shows [Kd 4d] (three of a kind, Fives - King kicker)
JJin91: mucks hand=20
pokernutt420 collected 1025 from pot
*** SUMMARY ***
Total pot 1025 | Rake 0=20
Board [5s 2h Jd 5h 5d]
Seat 1: pokerazmus (big blind) showed [9h 8d] and lost with three of a =
kind, Fives
Seat 3: pokernutt420 showed [Kd 4d] and won (1025) with three of a kind=
, Fives
Seat 4: excon tyrone folded before Flop (didn't bet)
Seat 5: JJin91 (button) mucked [9s Qs]
Seat 6: WwSalwW (small blind) folded before Flop


*********** # 116 **************
PokerStars Hand #169426544051: Tournament #1597684008, $13.50+$1.50 USD=
 Hold'em No Limit - Level VIII (125/250) - 2017/05/05 14:53:22 ET
Table '1597684008 8' 6-max Seat #6 is the button
Seat 1: pokerazmus (17483 in chips)=20
Seat 3: pokernutt420 (12682 in chips)=20
Seat 4: excon tyrone (21140 in chips)=20
Seat 5: JJin91 (20086 in chips)=20
Seat 6: WwSalwW (18607 in chips)=20
pokerazmus: posts the ante 30
pokernutt420: posts the ante 30
excon tyrone: posts the ante 30
JJin91: posts the ante 30
WwSalwW: posts the ante 30
pokerazmus: posts small blind 125
pokernutt420: posts big blind 250
*** HOLE CARDS ***
Dealt to JJin91 [9h 5h]
excon tyrone: folds=20
JJin91: folds=20
WwSalwW: folds=20
pokerazmus said, "if you are playing for big $ people will fold"
pokerazmus: folds=20
Uncalled bet (125) returned to pokernutt420
pokernutt420 collected 400 from pot
pokernutt420: doesn't show hand=20
*** SUMMARY ***
Total pot 400 | Rake 0=20
Seat 1: pokerazmus (small blind) folded before Flop
Seat 3: pokernutt420 (big blind) collected (400)
Seat 4: excon tyrone folded before Flop (didn't bet)
Seat 5: JJin91 folded before Flop (didn't bet)
Seat 6: WwSalwW (button) folded before Flop (didn't bet)


*********** # 117 **************
PokerStars Hand #169426544092: Tournament #1597684008, $13.50+$1.50 USD=
 Hold'em No Limit - Level VIII (125/250) - 2017/05/05 14:53:35 ET
Table '1597684008 8' 6-max Seat #1 is the button
Seat 1: pokerazmus (17328 in chips)=20
Seat 3: pokernutt420 (12927 in chips)=20
Seat 4: excon tyrone (21110 in chips)=20
Seat 5: JJin91 (20056 in chips)=20
Seat 6: WwSalwW (18577 in chips)=20
pokerazmus: posts the ante 30
pokernutt420: posts the ante 30
excon tyrone: posts the ante 30
JJin91: posts the ante 30
WwSalwW: posts the ante 30
pokernutt420: posts small blind 125
excon tyrone: posts big blind 250
*** HOLE CARDS ***
Dealt to JJin91 [Tc Qs]
excon tyrone said, "my flop bet told me he had ace"
JJin91: folds=20
WwSalwW: folds=20
pokerazmus: raises 500 to 750
pokernutt420: folds=20
excon tyrone said, "i was out after turn,,unless i hit a nine"
excon tyrone: raises 20330 to 21080 and is all-in
pokerazmus: folds [Ad]
Uncalled bet (20330) returned to excon tyrone
excon tyrone collected 1775 from pot
excon tyrone: shows [Js Jc]
pokerazmus said, "this is $272 for first... what do you expect"
*** SUMMARY ***
Total pot 1775 | Rake 0=20
Seat 1: pokerazmus (button) folded before Flop
Seat 3: pokernutt420 (small blind) folded before Flop
Seat 4: excon tyrone (big blind) collected (1775)
Seat 5: JJin91 folded before Flop (didn't bet)
Seat 6: WwSalwW folded before Flop (didn't bet)


*********** # 118 **************
PokerStars Hand #169426544185: Tournament #1597684008, $13.50+$1.50 USD=
 Hold'em No Limit - Level VIII (125/250) - 2017/05/05 14:54:10 ET
Table '1597684008 8' 6-max Seat #3 is the button
Seat 1: pokerazmus (16548 in chips)=20
Seat 2: bretlaviola (10000 in chips)=20
Seat 3: pokernutt420 (12772 in chips)=20
Seat 4: excon tyrone (22105 in chips)=20
Seat 5: JJin91 (20026 in chips)=20
Seat 6: WwSalwW (18547 in chips)=20
pokerazmus: posts the ante 30
bretlaviola: posts the ante 30
pokernutt420: posts the ante 30
excon tyrone: posts the ante 30
JJin91: posts the ante 30
WwSalwW: posts the ante 30
excon tyrone: posts small blind 125
JJin91: posts big blind 250
*** HOLE CARDS ***
Dealt to JJin91 [4h Jh]
WwSalwW: folds=20
pokerazmus said, "what are you showing with there? QQ?"
pokerazmus: raises 500 to 750
bretlaviola: folds=20
pokernutt420: folds=20
excon tyrone said, "no need to see that flop"
excon tyrone: folds=20
JJin91: folds=20
Uncalled bet (500) returned to pokerazmus
pokerazmus collected 805 from pot
*** SUMMARY ***
Total pot 805 | Rake 0=20
Seat 1: pokerazmus collected (805)
Seat 2: bretlaviola folded before Flop (didn't bet)
Seat 3: pokernutt420 (button) folded before Flop (didn't bet)
Seat 4: excon tyrone (small blind) folded before Flop
Seat 5: JJin91 (big blind) folded before Flop
Seat 6: WwSalwW folded before Flop (didn't bet)


*********** # 119 **************
PokerStars Hand #169426544273: Tournament #1597684008, $13.50+$1.50 USD=
 Hold'em No Limit - Level VIII (125/250) - 2017/05/05 14:54:41 ET
Table '1597684008 8' 6-max Seat #4 is the button
Seat 1: pokerazmus (17073 in chips)=20
Seat 2: bretlaviola (9970 in chips)=20
Seat 3: pokernutt420 (12742 in chips)=20
Seat 4: excon tyrone (21950 in chips)=20
Seat 5: JJin91 (19746 in chips)=20
Seat 6: WwSalwW (18517 in chips)=20
pokerazmus: posts the ante 30
bretlaviola: posts the ante 30
pokernutt420: posts the ante 30
excon tyrone: posts the ante 30
JJin91: posts the ante 30
WwSalwW: posts the ante 30
JJin91: posts small blind 125
WwSalwW: posts big blind 250
*** HOLE CARDS ***
Dealt to JJin91 [4c Ac]
pokerazmus said, "was flipping wiht your QQ"
pokerazmus: folds=20
bretlaviola: calls 250
pokernutt420: folds=20
excon tyrone: folds=20
JJin91: raises 750 to 1000
WwSalwW: folds=20
bretlaviola: calls 750
*** FLOP *** [Kd As 6d]
JJin91: bets 1500
bretlaviola: folds=20
Uncalled bet (1500) returned to JJin91
JJin91 collected 2430 from pot
*** SUMMARY ***
Total pot 2430 | Rake 0=20
Board [Kd As 6d]
Seat 1: pokerazmus folded before Flop (didn't bet)
Seat 2: bretlaviola folded on the Flop
Seat 3: pokernutt420 folded before Flop (didn't bet)
Seat 4: excon tyrone (button) folded before Flop (didn't bet)
Seat 5: JJin91 (small blind) collected (2430)
Seat 6: WwSalwW (big blind) folded before Flop


*********** # 120 **************
PokerStars Hand #169426545033: Tournament #1597684008, $13.50+$1.50 USD=
 Hold'em No Limit - Level VIII (125/250) - 2017/05/05 15:00:38 ET
Table '1597684008 8' 6-max Seat #5 is the button
Seat 1: pokerazmus (17043 in chips)=20
Seat 2: bretlaviola (8940 in chips)=20
Seat 4: excon tyrone (21920 in chips)=20
Seat 5: JJin91 (21146 in chips)=20
Seat 6: WwSalwW (18237 in chips)=20
pokerazmus: posts the ante 30
bretlaviola: posts the ante 30
excon tyrone: posts the ante 30
JJin91: posts the ante 30
WwSalwW: posts the ante 30
WwSalwW: posts small blind 125
pokerazmus: posts big blind 250
*** HOLE CARDS ***
Dealt to JJin91 [Th 3h]
bretlaviola: folds=20
excon tyrone: folds=20
JJin91: folds=20
WwSalwW: folds=20
Uncalled bet (125) returned to pokerazmus
pokerazmus collected 400 from pot
*** SUMMARY ***
Total pot 400 | Rake 0=20
Seat 1: pokerazmus (big blind) collected (400)
Seat 2: bretlaviola folded before Flop (didn't bet)
Seat 4: excon tyrone folded before Flop (didn't bet)
Seat 5: JJin91 (button) folded before Flop (didn't bet)
Seat 6: WwSalwW (small blind) folded before Flop


*********** # 121 **************
PokerStars Hand #169426545085: Tournament #1597684008, $13.50+$1.50 USD=
 Hold'em No Limit - Level VIII (125/250) - 2017/05/05 15:00:57 ET
Table '1597684008 8' 6-max Seat #6 is the button
Seat 1: pokerazmus (17288 in chips)=20
Seat 2: bretlaviola (8910 in chips)=20
Seat 4: excon tyrone (21890 in chips)=20
Seat 5: JJin91 (21116 in chips)=20
Seat 6: WwSalwW (18082 in chips)=20
pokerazmus: posts the ante 30
bretlaviola: posts the ante 30
excon tyrone: posts the ante 30
JJin91: posts the ante 30
WwSalwW: posts the ante 30
pokerazmus: posts small blind 125
bretlaviola: posts big blind 250
*** HOLE CARDS ***
Dealt to JJin91 [4c Qd]
excon tyrone: folds=20
JJin91: folds=20
WwSalwW: calls 250
pokerazmus: calls 125
bretlaviola: checks=20
*** FLOP *** [6h 8c 9c]
pokerazmus: bets 550
bretlaviola: raises 1200 to 1750
WwSalwW: calls 1750
pokerazmus: folds=20
*** TURN *** [6h 8c 9c] [3s]
bretlaviola: bets 2500
WwSalwW: calls 2500
*** RIVER *** [6h 8c 9c 3s] [7h]
bretlaviola: bets 4380 and is all-in
WwSalwW: folds=20
Uncalled bet (4380) returned to bretlaviola
bretlaviola collected 9950 from pot
bretlaviola: shows [7s Tc] (a straight, Six to Ten)
*** SUMMARY ***
Total pot 9950 | Rake 0=20
Board [6h 8c 9c 3s 7h]
Seat 1: pokerazmus (small blind) folded on the Flop
Seat 2: bretlaviola (big blind) collected (9950)
Seat 4: excon tyrone folded before Flop (didn't bet)
Seat 5: JJin91 folded before Flop (didn't bet)
Seat 6: WwSalwW (button) folded on the River


*********** # 122 **************
PokerStars Hand #169426545313: Tournament #1597684008, $13.50+$1.50 USD=
 Hold'em No Limit - Level IX (150/300) - 2017/05/05 15:02:26 ET
Table '1597684008 5' 6-max Seat #1 is the button
Seat 1: lilmikey321 (66547 in chips)=20
Seat 2: elliottko (13082 in chips)=20
Seat 3: hamid.felted (19545 in chips) is sitting out
Seat 4: JJin91 (21086 in chips)=20
Seat 6: robertg68 (12376 in chips)=20
lilmikey321: posts the ante 40
elliottko: posts the ante 40
hamid.felted: posts the ante 40
JJin91: posts the ante 40
robertg68: posts the ante 40
elliottko: posts small blind 150
hamid.felted: posts big blind 300
*** HOLE CARDS ***
Dealt to JJin91 [Qc Th]
JJin91: folds=20
robertg68: calls 300
lilmikey321: folds=20
elliottko: calls 150
hamid.felted: folds=20
*** FLOP *** [8s Qs 2s]
elliottko: bets 400
robertg68: calls 400
*** TURN *** [8s Qs 2s] [8c]
elliottko: bets 800
robertg68: calls 800
*** RIVER *** [8s Qs 2s 8c] [Jd]
elliottko: bets 1300
robertg68: folds=20
Uncalled bet (1300) returned to elliottko
elliottko collected 3500 from pot
*** SUMMARY ***
Total pot 3500 | Rake 0=20
Board [8s Qs 2s 8c Jd]
Seat 1: lilmikey321 (button) folded before Flop (didn't bet)
Seat 2: elliottko (small blind) collected (3500)
Seat 3: hamid.felted (big blind) folded before Flop
Seat 4: JJin91 folded before Flop (didn't bet)
Seat 6: robertg68 folded on the River


*********** # 123 **************
PokerStars Hand #169426545425: Tournament #1597684008, $13.50+$1.50 USD=
 Hold'em No Limit - Level IX (150/300) - 2017/05/05 15:03:08 ET
Table '1597684008 5' 6-max Seat #2 is the button
Seat 1: lilmikey321 (66507 in chips)=20
Seat 2: elliottko (15042 in chips)=20
Seat 3: hamid.felted (19205 in chips) is sitting out
Seat 4: JJin91 (21046 in chips)=20
Seat 5: inspector260 (10000 in chips)=20
Seat 6: robertg68 (10836 in chips)=20
lilmikey321: posts the ante 40
elliottko: posts the ante 40
hamid.felted: posts the ante 40
JJin91: posts the ante 40
inspector260: posts the ante 40
robertg68: posts the ante 40
hamid.felted: posts small blind 150
JJin91: posts big blind 300
*** HOLE CARDS ***
Dealt to JJin91 [6c Ts]
inspector260: calls 300
robertg68: folds=20
hamid.felted has returned
lilmikey321: folds=20
elliottko: calls 300
hamid.felted: folds=20
JJin91: checks=20
*** FLOP *** [4s 9s 8d]
JJin91: checks=20
inspector260: checks=20
elliottko: bets 645
JJin91: folds=20
inspector260: folds=20
Uncalled bet (645) returned to elliottko
elliottko collected 1290 from pot
*** SUMMARY ***
Total pot 1290 | Rake 0=20
Board [4s 9s 8d]
Seat 1: lilmikey321 folded before Flop (didn't bet)
Seat 2: elliottko (button) collected (1290)
Seat 3: hamid.felted (small blind) folded before Flop
Seat 4: JJin91 (big blind) folded on the Flop
Seat 5: inspector260 folded on the Flop
Seat 6: robertg68 folded before Flop (didn't bet)


*********** # 124 **************
PokerStars Hand #169426545560: Tournament #1597684008, $13.50+$1.50 USD=
 Hold'em No Limit - Level IX (150/300) - 2017/05/05 15:03:57 ET
Table '1597684008 5' 6-max Seat #3 is the button
Seat 1: lilmikey321 (66467 in chips)=20
Seat 2: elliottko (15992 in chips)=20
Seat 3: hamid.felted (19015 in chips)=20
Seat 4: JJin91 (20706 in chips)=20
Seat 5: inspector260 (9660 in chips)=20
Seat 6: robertg68 (10796 in chips)=20
lilmikey321: posts the ante 40
elliottko: posts the ante 40
hamid.felted: posts the ante 40
JJin91: posts the ante 40
inspector260: posts the ante 40
robertg68: posts the ante 40
JJin91: posts small blind 150
inspector260: posts big blind 300
*** HOLE CARDS ***
Dealt to JJin91 [6d 3h]
robertg68: folds=20
lilmikey321: calls 300
elliottko: calls 300
hamid.felted: raises 600 to 900
JJin91: folds=20
inspector260: raises 600 to 1500
lilmikey321: calls 1200
elliottko: folds=20
hamid.felted: raises 3900 to 5400
inspector260: raises 3900 to 9300
lilmikey321: folds=20
hamid.felted: calls 3900
*** FLOP *** [5s 9h 7d]
inspector260: bets 320 and is all-in
hamid.felted: calls 320
*** TURN *** [5s 9h 7d] [Jd]
*** RIVER *** [5s 9h 7d Jd] [Qs]
*** SHOW DOWN ***
inspector260: shows [Jh Js] (three of a kind, Jacks)
hamid.felted: shows [Ks Jc] (a pair of Jacks)
inspector260 collected 21430 from pot
*** SUMMARY ***
Total pot 21430 | Rake 0=20
Board [5s 9h 7d Jd Qs]
Seat 1: lilmikey321 folded before Flop
Seat 2: elliottko folded before Flop
Seat 3: hamid.felted (button) showed [Ks Jc] and lost with a pair of Ja=
cks
Seat 4: JJin91 (small blind) folded before Flop
Seat 5: inspector260 (big blind) showed [Jh Js] and won (21430) with th=
ree of a kind, Jacks
Seat 6: robertg68 folded before Flop (didn't bet)


*********** # 125 **************
PokerStars Hand #169426545756: Tournament #1597684008, $13.50+$1.50 USD=
 Hold'em No Limit - Level IX (150/300) - 2017/05/05 15:05:03 ET
Table '1597684008 5' 6-max Seat #4 is the button
Seat 1: lilmikey321 (64927 in chips)=20
Seat 2: elliottko (15652 in chips)=20
Seat 3: hamid.felted (9355 in chips)=20
Seat 4: JJin91 (20516 in chips)=20
Seat 5: inspector260 (21430 in chips)=20
Seat 6: robertg68 (10756 in chips)=20
lilmikey321: posts the ante 40
elliottko: posts the ante 40
hamid.felted: posts the ante 40
JJin91: posts the ante 40
inspector260: posts the ante 40
robertg68: posts the ante 40
inspector260: posts small blind 150
robertg68: posts big blind 300
*** HOLE CARDS ***
Dealt to JJin91 [Jc 8s]
lilmikey321: calls 300
elliottko: raises 600 to 900
hamid.felted: folds=20
JJin91: folds=20
inspector260: folds=20
robertg68: folds=20
lilmikey321: calls 600
*** FLOP *** [Ah 2h 4d]
lilmikey321: checks=20
elliottko: bets 1300
lilmikey321: folds=20
Uncalled bet (1300) returned to elliottko
elliottko collected 2490 from pot
*** SUMMARY ***
Total pot 2490 | Rake 0=20
Board [Ah 2h 4d]
Seat 1: lilmikey321 folded on the Flop
Seat 2: elliottko collected (2490)
Seat 3: hamid.felted folded before Flop (didn't bet)
Seat 4: JJin91 (button) folded before Flop (didn't bet)
Seat 5: inspector260 (small blind) folded before Flop
Seat 6: robertg68 (big blind) folded before Flop


*********** # 126 **************
PokerStars Hand #169426545823: Tournament #1597684008, $13.50+$1.50 USD=
 Hold'em No Limit - Level IX (150/300) - 2017/05/05 15:05:28 ET
Table '1597684008 5' 6-max Seat #5 is the button
Seat 1: lilmikey321 (63987 in chips)=20
Seat 2: elliottko (17202 in chips)=20
Seat 3: hamid.felted (9315 in chips)=20
Seat 4: JJin91 (20476 in chips)=20
Seat 5: inspector260 (21240 in chips)=20
Seat 6: robertg68 (10416 in chips)=20
lilmikey321: posts the ante 40
elliottko: posts the ante 40
hamid.felted: posts the ante 40
JJin91: posts the ante 40
inspector260: posts the ante 40
robertg68: posts the ante 40
robertg68: posts small blind 150
lilmikey321: posts big blind 300
*** HOLE CARDS ***
Dealt to JJin91 [Js 5c]
elliottko: folds=20
hamid.felted: raises 600 to 900
JJin91: folds=20
inspector260: folds=20
robertg68: folds=20
lilmikey321: calls 600
*** FLOP *** [3d 9c 9h]
lilmikey321: checks=20
hamid.felted: bets 1500
lilmikey321: calls 1500
*** TURN *** [3d 9c 9h] [4c]
lilmikey321: checks=20
hamid.felted: bets 2700
lilmikey321: calls 2700
*** RIVER *** [3d 9c 9h 4c] [Th]
lilmikey321: checks=20
hamid.felted: bets 4175 and is all-in
lilmikey321: folds=20
Uncalled bet (4175) returned to hamid.felted
hamid.felted collected 10590 from pot
hamid.felted: doesn't show hand=20
*** SUMMARY ***
Total pot 10590 | Rake 0=20
Board [3d 9c 9h 4c Th]
Seat 1: lilmikey321 (big blind) folded on the River
Seat 2: elliottko folded before Flop (didn't bet)
Seat 3: hamid.felted collected (10590)
Seat 4: JJin91 folded before Flop (didn't bet)
Seat 5: inspector260 (button) folded before Flop (didn't bet)
Seat 6: robertg68 (small blind) folded before Flop


*********** # 127 **************
PokerStars Hand #169426545979: Tournament #1597684008, $13.50+$1.50 USD=
 Hold'em No Limit - Level IX (150/300) - 2017/05/05 15:06:23 ET
Table '1597684008 5' 6-max Seat #1 is the button
Seat 1: lilmikey321 (58847 in chips)=20
Seat 2: elliottko (17162 in chips)=20
Seat 3: hamid.felted (14765 in chips)=20
Seat 4: JJin91 (20436 in chips)=20
Seat 5: inspector260 (21200 in chips)=20
Seat 6: jbodey52 (10000 in chips)=20
lilmikey321: posts the ante 40
elliottko: posts the ante 40
hamid.felted: posts the ante 40
JJin91: posts the ante 40
inspector260: posts the ante 40
jbodey52: posts the ante 40
elliottko: posts small blind 150
hamid.felted: posts big blind 300
*** HOLE CARDS ***
Dealt to JJin91 [6s Qs]
JJin91: folds=20
inspector260: folds=20
jbodey52: raises 450 to 750
lilmikey321: calls 750
elliottko: folds=20
hamid.felted: calls 450
*** FLOP *** [9s 8s Qd]
hamid.felted: checks=20
jbodey52: checks=20
lilmikey321: checks=20
*** TURN *** [9s 8s Qd] [7h]
hamid.felted: checks=20
jbodey52: bets 2640
lilmikey321: calls 2640
hamid.felted: folds=20
*** RIVER *** [9s 8s Qd 7h] [6d]
jbodey52: bets 6570 and is all-in
lilmikey321: folds=20
Uncalled bet (6570) returned to jbodey52
jbodey52 collected 7920 from pot
jbodey52: doesn't show hand=20
*** SUMMARY ***
Total pot 7920 | Rake 0=20
Board [9s 8s Qd 7h 6d]
Seat 1: lilmikey321 (button) folded on the River
Seat 2: elliottko (small blind) folded before Flop
Seat 3: hamid.felted (big blind) folded on the Turn
Seat 4: JJin91 folded before Flop (didn't bet)
Seat 5: inspector260 folded before Flop (didn't bet)
Seat 6: jbodey52 collected (7920)


*********** # 128 **************
PokerStars Hand #169426546102: Tournament #1597684008, $13.50+$1.50 USD=
 Hold'em No Limit - Level IX (150/300) - 2017/05/05 15:07:06 ET
Table '1597684008 5' 6-max Seat #2 is the button
Seat 1: lilmikey321 (55417 in chips)=20
Seat 2: elliottko (16972 in chips)=20
Seat 3: hamid.felted (13975 in chips)=20
Seat 4: JJin91 (20396 in chips)=20
Seat 5: inspector260 (21160 in chips)=20
Seat 6: jbodey52 (14490 in chips)=20
lilmikey321: posts the ante 40
elliottko: posts the ante 40
hamid.felted: posts the ante 40
JJin91: posts the ante 40
inspector260: posts the ante 40
jbodey52: posts the ante 40
hamid.felted: posts small blind 150
JJin91: posts big blind 300
*** HOLE CARDS ***
Dealt to JJin91 [Kh Kc]
inspector260: folds=20
jbodey52: folds=20
lilmikey321: raises 1200 to 1500
elliottko: folds=20
hamid.felted: folds=20
JJin91: raises 2758 to 4258
lilmikey321: raises 51119 to 55377 and is all-in
JJin91: calls 16098 and is all-in
Uncalled bet (35021) returned to lilmikey321
*** FLOP *** [8h 7d 8c]
*** TURN *** [8h 7d 8c] [9c]
*** RIVER *** [8h 7d 8c 9c] [6d]
*** SHOW DOWN ***
JJin91: shows [Kh Kc] (two pair, Kings and Eights)
lilmikey321: shows [Ac Qs] (a pair of Eights)
JJin91 collected 41102 from pot
*** SUMMARY ***
Total pot 41102 | Rake 0=20
Board [8h 7d 8c 9c 6d]
Seat 1: lilmikey321 showed [Ac Qs] and lost with a pair of Eights
Seat 2: elliottko (button) folded before Flop (didn't bet)
Seat 3: hamid.felted (small blind) folded before Flop
Seat 4: JJin91 (big blind) showed [Kh Kc] and won (41102) with two pair=
, Kings and Eights
Seat 5: inspector260 folded before Flop (didn't bet)
Seat 6: jbodey52 folded before Flop (didn't bet)


*********** # 129 **************
PokerStars Hand #169426546217: Tournament #1597684008, $13.50+$1.50 USD=
 Hold'em No Limit - Level IX (150/300) - 2017/05/05 15:07:51 ET
Table '1597684008 5' 6-max Seat #3 is the button
Seat 1: lilmikey321 (35021 in chips)=20
Seat 2: elliottko (16932 in chips)=20
Seat 3: hamid.felted (13785 in chips)=20
Seat 4: JJin91 (41102 in chips)=20
Seat 5: inspector260 (21120 in chips)=20
Seat 6: jbodey52 (14450 in chips)=20
lilmikey321: posts the ante 40
elliottko: posts the ante 40
hamid.felted: posts the ante 40
JJin91: posts the ante 40
inspector260: posts the ante 40
jbodey52: posts the ante 40
JJin91: posts small blind 150
inspector260: posts big blind 300
*** HOLE CARDS ***
Dealt to JJin91 [Ks 2s]
jbodey52: raises 450 to 750
lilmikey321: calls 750
elliottko: folds=20
hamid.felted: calls 750
JJin91: folds=20
inspector260: calls 450
*** FLOP *** [8h 4c 4d]
inspector260: checks=20
jbodey52: checks=20
lilmikey321: bets 300
hamid.felted: calls 300
inspector260: folds=20
jbodey52: raises 13360 to 13660 and is all-in
lilmikey321: folds=20
hamid.felted: folds=20
Uncalled bet (13360) returned to jbodey52
jbodey52 collected 4290 from pot
jbodey52: doesn't show hand=20
*** SUMMARY ***
Total pot 4290 | Rake 0=20
Board [8h 4c 4d]
Seat 1: lilmikey321 folded on the Flop
Seat 2: elliottko folded before Flop (didn't bet)
Seat 3: hamid.felted (button) folded on the Flop
Seat 4: JJin91 (small blind) folded before Flop
Seat 5: inspector260 (big blind) folded on the Flop
Seat 6: jbodey52 collected (4290)


*********** # 130 **************
PokerStars Hand #169426546316: Tournament #1597684008, $13.50+$1.50 USD=
 Hold'em No Limit - Level IX (150/300) - 2017/05/05 15:08:31 ET
Table '1597684008 5' 6-max Seat #4 is the button
Seat 1: lilmikey321 (33931 in chips)=20
Seat 2: elliottko (16892 in chips)=20
Seat 3: hamid.felted (12695 in chips)=20
Seat 4: JJin91 (40912 in chips)=20
Seat 5: inspector260 (20330 in chips)=20
Seat 6: jbodey52 (17650 in chips)=20
lilmikey321: posts the ante 40
elliottko: posts the ante 40
hamid.felted: posts the ante 40
JJin91: posts the ante 40
inspector260: posts the ante 40
jbodey52: posts the ante 40
inspector260: posts small blind 150
jbodey52: posts big blind 300
*** HOLE CARDS ***
Dealt to JJin91 [4h Qc]
lilmikey321: calls 300
elliottko: raises 600 to 900
hamid.felted: folds=20
JJin91: folds=20
inspector260: calls 750
jbodey52: calls 600
lilmikey321: calls 600
*** FLOP *** [2h 8h 5c]
inspector260: checks=20
jbodey52: bets 1999
lilmikey321: calls 1999
elliottko: raises 13953 to 15952 and is all-in
inspector260: folds=20
jbodey52: folds=20
lilmikey321: folds=20
Uncalled bet (13953) returned to elliottko
elliottko collected 9837 from pot
*** SUMMARY ***
Total pot 9837 | Rake 0=20
Board [2h 8h 5c]
Seat 1: lilmikey321 folded on the Flop
Seat 2: elliottko collected (9837)
Seat 3: hamid.felted folded before Flop (didn't bet)
Seat 4: JJin91 (button) folded before Flop (didn't bet)
Seat 5: inspector260 (small blind) folded on the Flop
Seat 6: jbodey52 (big blind) folded on the Flop


*********** # 131 **************
PokerStars Hand #169426546537: Tournament #1597684008, $13.50+$1.50 USD=
 Hold'em No Limit - Level IX (150/300) - 2017/05/05 15:09:53 ET
Table '1597684008 5' 6-max Seat #5 is the button
Seat 1: lilmikey321 (30992 in chips)=20
Seat 2: elliottko (23790 in chips)=20
Seat 3: hamid.felted (12655 in chips)=20
Seat 4: JJin91 (40872 in chips)=20
Seat 5: inspector260 (19390 in chips)=20
Seat 6: jbodey52 (14711 in chips)=20
lilmikey321: posts the ante 40
elliottko: posts the ante 40
hamid.felted: posts the ante 40
JJin91: posts the ante 40
inspector260: posts the ante 40
jbodey52: posts the ante 40
jbodey52: posts small blind 150
lilmikey321: posts big blind 300
*** HOLE CARDS ***
Dealt to JJin91 [4c 8s]
elliottko: folds=20
hamid.felted: folds=20
JJin91: folds=20
inspector260: calls 300
jbodey52: raises 1140 to 1440
lilmikey321: folds=20
inspector260: folds=20
Uncalled bet (1140) returned to jbodey52
jbodey52 collected 1140 from pot
jbodey52: doesn't show hand=20
*** SUMMARY ***
Total pot 1140 | Rake 0=20
Seat 1: lilmikey321 (big blind) folded before Flop
Seat 2: elliottko folded before Flop (didn't bet)
Seat 3: hamid.felted folded before Flop (didn't bet)
Seat 4: JJin91 folded before Flop (didn't bet)
Seat 5: inspector260 (button) folded before Flop
Seat 6: jbodey52 (small blind) collected (1140)


*********** # 132 **************
PokerStars Hand #169426546591: Tournament #1597684008, $13.50+$1.50 USD=
 Hold'em No Limit - Level IX (150/300) - 2017/05/05 15:10:14 ET
Table '1597684008 5' 6-max Seat #6 is the button
Seat 1: lilmikey321 (30652 in chips)=20
Seat 2: elliottko (23750 in chips)=20
Seat 3: hamid.felted (12615 in chips)=20
Seat 4: JJin91 (40832 in chips)=20
Seat 5: inspector260 (19050 in chips)=20
Seat 6: jbodey52 (15511 in chips)=20
lilmikey321: posts the ante 40
elliottko: posts the ante 40
hamid.felted: posts the ante 40
JJin91: posts the ante 40
inspector260: posts the ante 40
jbodey52: posts the ante 40
lilmikey321: posts small blind 150
elliottko: posts big blind 300
*** HOLE CARDS ***
Dealt to JJin91 [Qh Ts]
hamid.felted: folds=20
JJin91: folds=20
inspector260: folds=20
jbodey52: raises 600 to 900
lilmikey321: calls 750
elliottko: folds=20
*** FLOP *** [Jc 7c 6h]
lilmikey321: checks=20
jbodey52: checks=20
*** TURN *** [Jc 7c 6h] [5h]
lilmikey321: bets 600
jbodey52: raises 899 to 1499
lilmikey321: calls 899
*** RIVER *** [Jc 7c 6h 5h] [4s]
lilmikey321: bets 5100
jbodey52: calls 5100
*** SHOW DOWN ***
lilmikey321: shows [Kc 5d] (a pair of Fives)
jbodey52: shows [4c 3c] (a straight, Three to Seven)
jbodey52 collected 15538 from pot
*** SUMMARY ***
Total pot 15538 | Rake 0=20
Board [Jc 7c 6h 5h 4s]
Seat 1: lilmikey321 (small blind) showed [Kc 5d] and lost with a pair o=
f Fives
Seat 2: elliottko (big blind) folded before Flop
Seat 3: hamid.felted folded before Flop (didn't bet)
Seat 4: JJin91 folded before Flop (didn't bet)
Seat 5: inspector260 folded before Flop (didn't bet)
Seat 6: jbodey52 (button) showed [4c 3c] and won (15538) with a straigh=
t, Three to Seven


*********** # 133 **************
PokerStars Hand #169426546760: Tournament #1597684008, $13.50+$1.50 USD=
 Hold'em No Limit - Level IX (150/300) - 2017/05/05 15:11:18 ET
Table '1597684008 5' 6-max Seat #1 is the button
Seat 1: lilmikey321 (23113 in chips)=20
Seat 2: elliottko (23410 in chips)=20
Seat 3: hamid.felted (12575 in chips)=20
Seat 4: JJin91 (40792 in chips)=20
Seat 5: inspector260 (19010 in chips)=20
Seat 6: jbodey52 (23510 in chips)=20
lilmikey321: posts the ante 40
elliottko: posts the ante 40
hamid.felted: posts the ante 40
JJin91: posts the ante 40
inspector260: posts the ante 40
jbodey52: posts the ante 40
elliottko: posts small blind 150
hamid.felted: posts big blind 300
*** HOLE CARDS ***
Dealt to JJin91 [Ah 3s]
JJin91: folds=20
inspector260: folds=20
jbodey52: folds=20
lilmikey321: calls 300
elliottko: calls 150
hamid.felted: checks=20
*** FLOP *** [Kd 3c 5h]
elliottko: checks=20
hamid.felted: checks=20
lilmikey321: bets 300
elliottko: folds=20
hamid.felted: folds=20
Uncalled bet (300) returned to lilmikey321
lilmikey321 collected 1140 from pot
lilmikey321: doesn't show hand=20
*** SUMMARY ***
Total pot 1140 | Rake 0=20
Board [Kd 3c 5h]
Seat 1: lilmikey321 (button) collected (1140)
Seat 2: elliottko (small blind) folded on the Flop
Seat 3: hamid.felted (big blind) folded on the Flop
Seat 4: JJin91 folded before Flop (didn't bet)
Seat 5: inspector260 folded before Flop (didn't bet)
Seat 6: jbodey52 folded before Flop (didn't bet)


*********** # 134 **************
PokerStars Hand #169426546870: Tournament #1597684008, $13.50+$1.50 USD=
 Hold'em No Limit - Level IX (150/300) - 2017/05/05 15:12:00 ET
Table '1597684008 5' 6-max Seat #2 is the button
Seat 1: lilmikey321 (23913 in chips)=20
Seat 2: elliottko (23070 in chips)=20
Seat 3: hamid.felted (12235 in chips)=20
Seat 4: JJin91 (40752 in chips)=20
Seat 5: inspector260 (18970 in chips)=20
Seat 6: jbodey52 (23470 in chips)=20
lilmikey321: posts the ante 40
elliottko: posts the ante 40
hamid.felted: posts the ante 40
JJin91: posts the ante 40
inspector260: posts the ante 40
jbodey52: posts the ante 40
hamid.felted: posts small blind 150
JJin91: posts big blind 300
*** HOLE CARDS ***
Dealt to JJin91 [4s Jc]
inspector260: folds=20
jbodey52: raises 450 to 750
lilmikey321: folds=20
elliottko: raises 1250 to 2000
hamid.felted: folds=20
JJin91: folds=20
jbodey52: calls 1250
*** FLOP *** [7c 5d Th]
jbodey52: checks=20
elliottko: bets 21030 and is all-in
jbodey52: folds [Qs As]
Uncalled bet (21030) returned to elliottko
elliottko collected 4690 from pot
elliottko: shows [Qd Qc] (a pair of Queens)
*** SUMMARY ***
Total pot 4690 | Rake 0=20
Board [7c 5d Th]
Seat 1: lilmikey321 folded before Flop (didn't bet)
Seat 2: elliottko (button) collected (4690)
Seat 3: hamid.felted (small blind) folded before Flop
Seat 4: JJin91 (big blind) folded before Flop
Seat 5: inspector260 folded before Flop (didn't bet)
Seat 6: jbodey52 folded on the Flop


*********** # 135 **************
PokerStars Hand #169426547042: Tournament #1597684008, $13.50+$1.50 USD=
 Hold'em No Limit - Level X (200/400) - 2017/05/05 15:13:06 ET
Table '1597684008 5' 6-max Seat #3 is the button
Seat 1: lilmikey321 (23873 in chips)=20
Seat 2: elliottko (25720 in chips)=20
Seat 3: hamid.felted (12045 in chips)=20
Seat 4: JJin91 (40412 in chips)=20
Seat 5: inspector260 (18930 in chips)=20
Seat 6: jbodey52 (21430 in chips)=20
lilmikey321: posts the ante 50
elliottko: posts the ante 50
hamid.felted: posts the ante 50
JJin91: posts the ante 50
inspector260: posts the ante 50
jbodey52: posts the ante 50
JJin91: posts small blind 200
inspector260: posts big blind 400
*** HOLE CARDS ***
Dealt to JJin91 [Jd 9c]
jbodey52: folds=20
lilmikey321: calls 400
elliottko: folds=20
hamid.felted: raises 560 to 960
JJin91: folds=20
inspector260: calls 560
lilmikey321: calls 560
*** FLOP *** [Kd 9h Ts]
inspector260: checks=20
lilmikey321: bets 1200
hamid.felted: folds=20
inspector260: calls 1200
*** TURN *** [Kd 9h Ts] [5c]
inspector260: checks=20
lilmikey321: bets 3600
inspector260: folds=20
Uncalled bet (3600) returned to lilmikey321
lilmikey321 collected 5780 from pot
lilmikey321: doesn't show hand=20
*** SUMMARY ***
Total pot 5780 | Rake 0=20
Board [Kd 9h Ts 5c]
Seat 1: lilmikey321 collected (5780)
Seat 2: elliottko folded before Flop (didn't bet)
Seat 3: hamid.felted (button) folded on the Flop
Seat 4: JJin91 (small blind) folded before Flop
Seat 5: inspector260 (big blind) folded on the Turn
Seat 6: jbodey52 folded before Flop (didn't bet)


*********** # 136 **************
PokerStars Hand #169426547211: Tournament #1597684008, $13.50+$1.50 USD=
 Hold'em No Limit - Level X (200/400) - 2017/05/05 15:14:02 ET
Table '1597684008 5' 6-max Seat #4 is the button
Seat 1: lilmikey321 (27443 in chips)=20
Seat 2: elliottko (25670 in chips)=20
Seat 3: hamid.felted (11035 in chips)=20
Seat 4: JJin91 (40162 in chips)=20
Seat 5: inspector260 (16720 in chips)=20
Seat 6: jbodey52 (21380 in chips)=20
lilmikey321: posts the ante 50
elliottko: posts the ante 50
hamid.felted: posts the ante 50
JJin91: posts the ante 50
inspector260: posts the ante 50
jbodey52: posts the ante 50
inspector260: posts small blind 200
jbodey52: posts big blind 400
*** HOLE CARDS ***
Dealt to JJin91 [Jh 7h]
lilmikey321: raises 400 to 800
elliottko: folds=20
hamid.felted: folds=20
JJin91: calls 800
inspector260: calls 600
jbodey52: raises 9200 to 10000
lilmikey321: folds=20
JJin91: folds=20
inspector260: folds=20
Uncalled bet (9200) returned to jbodey52
jbodey52 collected 3500 from pot
jbodey52: doesn't show hand=20
*** SUMMARY ***
Total pot 3500 | Rake 0=20
Seat 1: lilmikey321 folded before Flop
Seat 2: elliottko folded before Flop (didn't bet)
Seat 3: hamid.felted folded before Flop (didn't bet)
Seat 4: JJin91 (button) folded before Flop
Seat 5: inspector260 (small blind) folded before Flop
Seat 6: jbodey52 (big blind) collected (3500)


*********** # 137 **************
PokerStars Hand #169426547333: Tournament #1597684008, $13.50+$1.50 USD=
 Hold'em No Limit - Level X (200/400) - 2017/05/05 15:14:45 ET
Table '1597684008 5' 6-max Seat #5 is the button
Seat 1: lilmikey321 (26593 in chips)=20
Seat 2: elliottko (25620 in chips)=20
Seat 3: hamid.felted (10985 in chips)=20
Seat 4: JJin91 (39312 in chips)=20
Seat 5: inspector260 (15870 in chips)=20
Seat 6: jbodey52 (24030 in chips)=20
lilmikey321: posts the ante 50
elliottko: posts the ante 50
hamid.felted: posts the ante 50
JJin91: posts the ante 50
inspector260: posts the ante 50
jbodey52: posts the ante 50
jbodey52: posts small blind 200
lilmikey321: posts big blind 400
*** HOLE CARDS ***
Dealt to JJin91 [Qh 9c]
elliottko: folds=20
hamid.felted: folds=20
JJin91: folds=20
inspector260: folds=20
jbodey52: calls 200
lilmikey321: raises 400 to 800
jbodey52: calls 400
*** FLOP *** [2c 7h 3d]
jbodey52: checks=20
lilmikey321: checks=20
*** TURN *** [2c 7h 3d] [6c]
jbodey52: checks=20
lilmikey321: bets 1600
jbodey52: calls 1600
*** RIVER *** [2c 7h 3d 6c] [As]
jbodey52: bets 2700
lilmikey321: calls 2700
*** SHOW DOWN ***
jbodey52: shows [8s 5d] (high card Ace)
lilmikey321: shows [6d Kd] (a pair of Sixes)
lilmikey321 collected 10500 from pot
*** SUMMARY ***
Total pot 10500 | Rake 0=20
Board [2c 7h 3d 6c As]
Seat 1: lilmikey321 (big blind) showed [6d Kd] and won (10500) with a p=
air of Sixes
Seat 2: elliottko folded before Flop (didn't bet)
Seat 3: hamid.felted folded before Flop (didn't bet)
Seat 4: JJin91 folded before Flop (didn't bet)
Seat 5: inspector260 (button) folded before Flop (didn't bet)
Seat 6: jbodey52 (small blind) showed [8s 5d] and lost with high card A=
ce


*********** # 138 **************
PokerStars Hand #169426547464: Tournament #1597684008, $13.50+$1.50 USD=
 Hold'em No Limit - Level X (200/400) - 2017/05/05 15:15:36 ET
Table '1597684008 5' 6-max Seat #6 is the button
Seat 1: lilmikey321 (31943 in chips)=20
Seat 2: elliottko (25570 in chips)=20
Seat 3: hamid.felted (10935 in chips)=20
Seat 4: JJin91 (39262 in chips)=20
Seat 5: inspector260 (15820 in chips)=20
Seat 6: jbodey52 (18880 in chips)=20
lilmikey321: posts the ante 50
elliottko: posts the ante 50
hamid.felted: posts the ante 50
JJin91: posts the ante 50
inspector260: posts the ante 50
jbodey52: posts the ante 50
lilmikey321: posts small blind 200
elliottko: posts big blind 400
*** HOLE CARDS ***
Dealt to JJin91 [6d 5h]
hamid.felted: folds=20
JJin91: folds=20
inspector260: raises 400 to 800
jbodey52: raises 2500 to 3300
lilmikey321: raises 28593 to 31893 and is all-in
elliottko: folds=20
inspector260: calls 14970 and is all-in
jbodey52: calls 15530 and is all-in
Uncalled bet (13063) returned to lilmikey321
*** FLOP *** [6h Qc 5d]
*** TURN *** [6h Qc 5d] [Jh]
*** RIVER *** [6h Qc 5d Jh] [Td]
*** SHOW DOWN ***
lilmikey321: shows [Ah Kh] (a straight, Ten to Ace)
jbodey52: shows [Ts Tc] (three of a kind, Tens)
lilmikey321 collected 6120 from side pot
inspector260: shows [Qs Ac] (a pair of Queens)
lilmikey321 collected 48010 from main pot
jbodey52 finished the tournament in 59th place
inspector260 finished the tournament in 60th place
*** SUMMARY ***
Total pot 54130 Main pot 48010. Side pot 6120. | Rake 0=20
Board [6h Qc 5d Jh Td]
Seat 1: lilmikey321 (small blind) showed [Ah Kh] and won (54130) with a=
 straight, Ten to Ace
Seat 2: elliottko (big blind) folded before Flop
Seat 3: hamid.felted folded before Flop (didn't bet)
Seat 4: JJin91 folded before Flop (didn't bet)
Seat 5: inspector260 showed [Qs Ac] and lost with a pair of Queens
Seat 6: jbodey52 (button) showed [Ts Tc] and lost with three of a kind,=
 Tens


*********** # 139 **************
PokerStars Hand #169426547575: Tournament #1597684008, $13.50+$1.50 USD=
 Hold'em No Limit - Level X (200/400) - 2017/05/05 15:16:18 ET
Table '1597684008 5' 6-max Seat #1 is the button
Seat 1: lilmikey321 (67193 in chips)=20
Seat 2: elliottko (25120 in chips)=20
Seat 3: hamid.felted (10885 in chips)=20
Seat 4: JJin91 (39212 in chips)=20
lilmikey321: posts the ante 50
elliottko: posts the ante 50
hamid.felted: posts the ante 50
JJin91: posts the ante 50
elliottko: posts small blind 200
hamid.felted: posts big blind 400
*** HOLE CARDS ***
Dealt to JJin91 [Ac 6h]
JJin91: folds=20
lilmikey321: calls 400
elliottko: calls 200
hamid.felted: raises 1200 to 1600
lilmikey321: folds=20
elliottko: folds=20
Uncalled bet (1200) returned to hamid.felted
hamid.felted collected 1400 from pot
hamid.felted: doesn't show hand=20
*** SUMMARY ***
Total pot 1400 | Rake 0=20
Seat 1: lilmikey321 (button) folded before Flop
Seat 2: elliottko (small blind) folded before Flop
Seat 3: hamid.felted (big blind) collected (1400)
Seat 4: JJin91 folded before Flop (didn't bet)


*********** # 140 **************
PokerStars Hand #169426547631: Tournament #1597684008, $13.50+$1.50 USD=
 Hold'em No Limit - Level X (200/400) - 2017/05/05 15:16:40 ET
Table '1597684008 5' 6-max Seat #2 is the button
Seat 1: lilmikey321 (66743 in chips)=20
Seat 2: elliottko (24670 in chips)=20
Seat 3: hamid.felted (11835 in chips)=20
Seat 4: JJin91 (39162 in chips)=20
Seat 6: jbodey52 (10000 in chips)=20
lilmikey321: posts the ante 50
elliottko: posts the ante 50
hamid.felted: posts the ante 50
JJin91: posts the ante 50
jbodey52: posts the ante 50
hamid.felted: posts small blind 200
JJin91: posts big blind 400
*** HOLE CARDS ***
Dealt to JJin91 [7s 3c]
jbodey52: folds=20
lilmikey321: raises 800 to 1200
elliottko: folds=20
hamid.felted: folds=20
JJin91: folds=20
Uncalled bet (800) returned to lilmikey321
lilmikey321 collected 1250 from pot
lilmikey321: doesn't show hand=20
*** SUMMARY ***
Total pot 1250 | Rake 0=20
Seat 1: lilmikey321 collected (1250)
Seat 2: elliottko (button) folded before Flop (didn't bet)
Seat 3: hamid.felted (small blind) folded before Flop
Seat 4: JJin91 (big blind) folded before Flop
Seat 6: jbodey52 folded before Flop (didn't bet)


*********** # 141 **************
PokerStars Hand #169426547665: Tournament #1597684008, $13.50+$1.50 USD=
 Hold'em No Limit - Level X (200/400) - 2017/05/05 15:16:55 ET
Table '1597684008 5' 6-max Seat #3 is the button
Seat 1: lilmikey321 (67543 in chips)=20
Seat 2: elliottko (24620 in chips)=20
Seat 3: hamid.felted (11585 in chips)=20
Seat 4: JJin91 (38712 in chips)=20
Seat 6: jbodey52 (9950 in chips)=20
lilmikey321: posts the ante 50
elliottko: posts the ante 50
hamid.felted: posts the ante 50
JJin91: posts the ante 50
jbodey52: posts the ante 50
JJin91: posts small blind 200
jbodey52: posts big blind 400
*** HOLE CARDS ***
Dealt to JJin91 [9s 7c]
lilmikey321: folds=20
elliottko: folds=20
hamid.felted: raises 560 to 960
JJin91: folds=20
jbodey52: folds=20
Uncalled bet (560) returned to hamid.felted
hamid.felted collected 1250 from pot
hamid.felted: doesn't show hand=20
*** SUMMARY ***
Total pot 1250 | Rake 0=20
Seat 1: lilmikey321 folded before Flop (didn't bet)
Seat 2: elliottko folded before Flop (didn't bet)
Seat 3: hamid.felted (button) collected (1250)
Seat 4: JJin91 (small blind) folded before Flop
Seat 6: jbodey52 (big blind) folded before Flop


*********** # 142 **************
PokerStars Hand #169426547721: Tournament #1597684008, $13.50+$1.50 USD=
 Hold'em No Limit - Level X (200/400) - 2017/05/05 15:17:15 ET
Table '1597684008 5' 6-max Seat #4 is the button
Seat 1: lilmikey321 (67493 in chips)=20
Seat 2: elliottko (24570 in chips)=20
Seat 3: hamid.felted (12385 in chips)=20
Seat 4: JJin91 (38462 in chips)=20
Seat 6: jbodey52 (9500 in chips)=20
lilmikey321: posts the ante 50
elliottko: posts the ante 50
hamid.felted: posts the ante 50
JJin91: posts the ante 50
jbodey52: posts the ante 50
jbodey52: posts small blind 200
lilmikey321: posts big blind 400
*** HOLE CARDS ***
Dealt to JJin91 [2h Qd]
elliottko: folds=20
hamid.felted: folds=20
JJin91: raises 553 to 953
jbodey52: folds=20
lilmikey321: calls 553
*** FLOP *** [Kc 6h Jd]
lilmikey321: checks=20
JJin91: bets 1274
lilmikey321: folds=20
Uncalled bet (1274) returned to JJin91
JJin91 collected 2356 from pot
*** SUMMARY ***
Total pot 2356 | Rake 0=20
Board [Kc 6h Jd]
Seat 1: lilmikey321 (big blind) folded on the Flop
Seat 2: elliottko folded before Flop (didn't bet)
Seat 3: hamid.felted folded before Flop (didn't bet)
Seat 4: JJin91 (button) collected (2356)
Seat 6: jbodey52 (small blind) folded before Flop


*********** # 143 **************
PokerStars Hand #169426547806: Tournament #1597684008, $13.50+$1.50 USD=
 Hold'em No Limit - Level X (200/400) - 2017/05/05 15:17:46 ET
Table '1597684008 5' 6-max Seat #6 is the button
Seat 1: lilmikey321 (66490 in chips)=20
Seat 2: elliottko (24520 in chips)=20
Seat 3: hamid.felted (12335 in chips)=20
Seat 4: JJin91 (39815 in chips)=20
Seat 6: jbodey52 (9250 in chips)=20
lilmikey321: posts the ante 50
elliottko: posts the ante 50
hamid.felted: posts the ante 50
JJin91: posts the ante 50
jbodey52: posts the ante 50
lilmikey321: posts small blind 200
elliottko: posts big blind 400
*** HOLE CARDS ***
Dealt to JJin91 [Qd 6s]
hamid.felted: folds=20
JJin91: folds=20
jbodey52: calls 400
lilmikey321: calls 200
elliottko: checks=20
*** FLOP *** [Kc 3h Kh]
lilmikey321: bets 400
elliottko: folds=20
jbodey52: folds=20
Uncalled bet (400) returned to lilmikey321
lilmikey321 collected 1450 from pot
lilmikey321: doesn't show hand=20
*** SUMMARY ***
Total pot 1450 | Rake 0=20
Board [Kc 3h Kh]
Seat 1: lilmikey321 (small blind) collected (1450)
Seat 2: elliottko (big blind) folded on the Flop
Seat 3: hamid.felted folded before Flop (didn't bet)
Seat 4: JJin91 folded before Flop (didn't bet)
Seat 6: jbodey52 (button) folded on the Flop


*********** # 144 **************
PokerStars Hand #169426547875: Tournament #1597684008, $13.50+$1.50 USD=
 Hold'em No Limit - Level X (200/400) - 2017/05/05 15:18:12 ET
Table '1597684008 5' 6-max Seat #1 is the button
Seat 1: lilmikey321 (67490 in chips)=20
Seat 2: elliottko (24070 in chips)=20
Seat 3: hamid.felted (12285 in chips)=20
Seat 4: JJin91 (39765 in chips)=20
Seat 6: jbodey52 (8800 in chips)=20
lilmikey321: posts the ante 50
elliottko: posts the ante 50
hamid.felted: posts the ante 50
JJin91: posts the ante 50
jbodey52: posts the ante 50
elliottko: posts small blind 200
hamid.felted: posts big blind 400
*** HOLE CARDS ***
Dealt to JJin91 [Tc 8h]
JJin91: folds=20
jbodey52: raises 600 to 1000
lilmikey321: calls 1000
elliottko: calls 800
hamid.felted: raises 11235 to 12235 and is all-in
jbodey52: calls 7750 and is all-in
lilmikey321: folds=20
elliottko: folds=20
Uncalled bet (3485) returned to hamid.felted
*** FLOP *** [7c Ac 6h]
*** TURN *** [7c Ac 6h] [Kh]
*** RIVER *** [7c Ac 6h Kh] [3s]
*** SHOW DOWN ***
hamid.felted: shows [Ks Jd] (a pair of Kings)
jbodey52: shows [Qs 5s] (high card Ace)
hamid.felted collected 19750 from pot
jbodey52 finished the tournament in 58th place
*** SUMMARY ***
Total pot 19750 | Rake 0=20
Board [7c Ac 6h Kh 3s]
Seat 1: lilmikey321 (button) folded before Flop
Seat 2: elliottko (small blind) folded before Flop
Seat 3: hamid.felted (big blind) showed [Ks Jd] and won (19750) with a =
pair of Kings
Seat 4: JJin91 folded before Flop (didn't bet)
Seat 6: jbodey52 showed [Qs 5s] and lost with high card Ace


*********** # 145 **************
PokerStars Hand #169426548017: Tournament #1597684008, $13.50+$1.50 USD=
 Hold'em No Limit - Level X (200/400) - 2017/05/05 15:19:02 ET
Table '1597684008 5' 6-max Seat #2 is the button
Seat 1: lilmikey321 (66440 in chips)=20
Seat 2: elliottko (23020 in chips)=20
Seat 3: hamid.felted (23235 in chips)=20
Seat 4: JJin91 (39715 in chips)=20
Seat 5: DaBirds23 (10000 in chips)=20
lilmikey321: posts the ante 50
elliottko: posts the ante 50
hamid.felted: posts the ante 50
JJin91: posts the ante 50
DaBirds23: posts the ante 50
hamid.felted: posts small blind 200
JJin91: posts big blind 400
*** HOLE CARDS ***
Dealt to JJin91 [8c 4s]
DaBirds23: folds=20
lilmikey321: folds=20
elliottko: raises 800 to 1200
hamid.felted: folds=20
JJin91: folds=20
Uncalled bet (800) returned to elliottko
elliottko collected 1250 from pot
*** SUMMARY ***
Total pot 1250 | Rake 0=20
Seat 1: lilmikey321 folded before Flop (didn't bet)
Seat 2: elliottko (button) collected (1250)
Seat 3: hamid.felted (small blind) folded before Flop
Seat 4: JJin91 (big blind) folded before Flop
Seat 5: DaBirds23 folded before Flop (didn't bet)


*********** # 146 **************
PokerStars Hand #169426548074: Tournament #1597684008, $13.50+$1.50 USD=
 Hold'em No Limit - Level X (200/400) - 2017/05/05 15:19:19 ET
Table '1597684008 5' 6-max Seat #3 is the button
Seat 1: lilmikey321 (66390 in chips)=20
Seat 2: elliottko (23820 in chips)=20
Seat 3: hamid.felted (22985 in chips)=20
Seat 4: JJin91 (39265 in chips)=20
Seat 5: DaBirds23 (9950 in chips)=20
lilmikey321: posts the ante 50
elliottko: posts the ante 50
hamid.felted: posts the ante 50
JJin91: posts the ante 50
DaBirds23: posts the ante 50
JJin91: posts small blind 200
DaBirds23: posts big blind 400
*** HOLE CARDS ***
Dealt to JJin91 [3c 4d]
lilmikey321: folds=20
elliottko: raises 800 to 1200
hamid.felted: raises 3200 to 4400
JJin91: folds=20
DaBirds23: raises 5500 to 9900 and is all-in
elliottko: folds=20
hamid.felted: calls 5500
*** FLOP *** [3s 8c Tc]
*** TURN *** [3s 8c Tc] [8d]
*** RIVER *** [3s 8c Tc 8d] [2c]
*** SHOW DOWN ***
DaBirds23: shows [Kd As] (a pair of Eights)
hamid.felted: shows [Qh Qd] (two pair, Queens and Eights)
hamid.felted collected 21450 from pot
DaBirds23 finished the tournament in 56th place
*** SUMMARY ***
Total pot 21450 | Rake 0=20
Board [3s 8c Tc 8d 2c]
Seat 1: lilmikey321 folded before Flop (didn't bet)
Seat 2: elliottko folded before Flop
Seat 3: hamid.felted (button) showed [Qh Qd] and won (21450) with two p=
air, Queens and Eights
Seat 4: JJin91 (small blind) folded before Flop
Seat 5: DaBirds23 (big blind) showed [Kd As] and lost with a pair of Ei=
ghts


*********** # 147 **************
PokerStars Hand #169426548164: Tournament #1597684008, $13.50+$1.50 USD=
 Hold'em No Limit - Level X (200/400) - 2017/05/05 15:19:55 ET
Table '1597684008 5' 6-max Seat #4 is the button
Seat 1: lilmikey321 (66340 in chips)=20
Seat 2: elliottko (22570 in chips)=20
Seat 3: hamid.felted (34485 in chips)=20
Seat 4: JJin91 (39015 in chips)=20
lilmikey321: posts the ante 50
elliottko: posts the ante 50
hamid.felted: posts the ante 50
JJin91: posts the ante 50
lilmikey321: posts small blind 200
elliottko: posts big blind 400
*** HOLE CARDS ***
Dealt to JJin91 [3h 7h]
hamid.felted: folds=20
JJin91: folds=20
lilmikey321: raises 400 to 800
elliottko: calls 400
*** FLOP *** [7c 2h 4h]
lilmikey321: bets 400
elliottko: calls 400
*** TURN *** [7c 2h 4h] [Jh]
lilmikey321: bets 400
elliottko: calls 400
*** RIVER *** [7c 2h 4h Jh] [Ad]
lilmikey321: bets 2000
elliottko: calls 2000
*** SHOW DOWN ***
lilmikey321: shows [9s 2d] (a pair of Deuces)
elliottko: shows [8s Ah] (a pair of Aces)
elliottko collected 7400 from pot
*** SUMMARY ***
Total pot 7400 | Rake 0=20
Board [7c 2h 4h Jh Ad]
Seat 1: lilmikey321 (small blind) showed [9s 2d] and lost with a pair o=
f Deuces
Seat 2: elliottko (big blind) showed [8s Ah] and won (7400) with a pair=
 of Aces
Seat 3: hamid.felted folded before Flop (didn't bet)
Seat 4: JJin91 (button) folded before Flop (didn't bet)


*********** # 148 **************
PokerStars Hand #169426548241: Tournament #1597684008, $13.50+$1.50 USD=
 Hold'em No Limit - Level X (200/400) - 2017/05/05 15:20:20 ET
Table '1597684008 5' 6-max Seat #1 is the button
Seat 1: lilmikey321 (62690 in chips)=20
Seat 2: elliottko (26320 in chips)=20
Seat 3: hamid.felted (34435 in chips)=20
Seat 4: JJin91 (38965 in chips)=20
Seat 5: DaBirds23 (10000 in chips)=20
lilmikey321: posts the ante 50
elliottko: posts the ante 50
hamid.felted: posts the ante 50
JJin91: posts the ante 50
DaBirds23: posts the ante 50
elliottko: posts small blind 200
hamid.felted: posts big blind 400
*** HOLE CARDS ***
Dealt to JJin91 [7h Jh]
JJin91: raises 800 to 1200
DaBirds23: folds=20
lilmikey321: folds=20
elliottko: folds=20
hamid.felted: folds=20
Uncalled bet (800) returned to JJin91
JJin91 collected 1250 from pot
*** SUMMARY ***
Total pot 1250 | Rake 0=20
Seat 1: lilmikey321 (button) folded before Flop (didn't bet)
Seat 2: elliottko (small blind) folded before Flop
Seat 3: hamid.felted (big blind) folded before Flop
Seat 4: JJin91 collected (1250)
Seat 5: DaBirds23 folded before Flop (didn't bet)


*********** # 149 **************
PokerStars Hand #169426548274: Tournament #1597684008, $13.50+$1.50 USD=
 Hold'em No Limit - Level X (200/400) - 2017/05/05 15:20:31 ET
Table '1597684008 5' 6-max Seat #2 is the button
Seat 1: lilmikey321 (62640 in chips)=20
Seat 2: elliottko (26070 in chips)=20
Seat 3: hamid.felted (33985 in chips)=20
Seat 4: JJin91 (39765 in chips)=20
Seat 5: DaBirds23 (9950 in chips)=20
lilmikey321: posts the ante 50
elliottko: posts the ante 50
hamid.felted: posts the ante 50
JJin91: posts the ante 50
DaBirds23: posts the ante 50
hamid.felted: posts small blind 200
JJin91: posts big blind 400
*** HOLE CARDS ***
Dealt to JJin91 [6d Ad]
DaBirds23: folds=20
lilmikey321: raises 400 to 800
elliottko: calls 800
hamid.felted: folds=20
JJin91: calls 400
*** FLOP *** [Jc Jd 9c]
JJin91: checks=20
lilmikey321: bets 800
elliottko: calls 800
JJin91: calls 800
*** TURN *** [Jc Jd 9c] [6h]
JJin91: checks=20
lilmikey321: checks=20
elliottko: checks=20
*** RIVER *** [Jc Jd 9c 6h] [5c]
JJin91: checks=20
lilmikey321: bets 1600
elliottko: folds=20
JJin91: calls 1600
*** SHOW DOWN ***
lilmikey321: shows [Kc Qs] (a pair of Jacks)
JJin91: shows [6d Ad] (two pair, Jacks and Sixes)
JJin91 collected 8450 from pot
*** SUMMARY ***
Total pot 8450 | Rake 0=20
Board [Jc Jd 9c 6h 5c]
Seat 1: lilmikey321 showed [Kc Qs] and lost with a pair of Jacks
Seat 2: elliottko (button) folded on the River
Seat 3: hamid.felted (small blind) folded before Flop
Seat 4: JJin91 (big blind) showed [6d Ad] and won (8450) with two pair,=
 Jacks and Sixes
Seat 5: DaBirds23 folded before Flop (didn't bet)


*********** # 150 **************
PokerStars Hand #169426548416: Tournament #1597684008, $13.50+$1.50 USD=
 Hold'em No Limit - Level X (200/400) - 2017/05/05 15:21:18 ET
Table '1597684008 5' 6-max Seat #3 is the button
Seat 1: lilmikey321 (59390 in chips)=20
Seat 2: elliottko (24420 in chips)=20
Seat 3: hamid.felted (33735 in chips)=20
Seat 4: JJin91 (44965 in chips)=20
Seat 5: DaBirds23 (9900 in chips)=20
Seat 6: STI809 (10000 in chips)=20
lilmikey321: posts the ante 50
elliottko: posts the ante 50
hamid.felted: posts the ante 50
JJin91: posts the ante 50
DaBirds23: posts the ante 50
STI809: posts the ante 50
JJin91: posts small blind 200
DaBirds23: posts big blind 400
*** HOLE CARDS ***
Dealt to JJin91 [6s Ks]
STI809: folds=20
lilmikey321: folds=20
elliottko: folds=20
hamid.felted: folds=20
JJin91: raises 400 to 800
DaBirds23: raises 9050 to 9850 and is all-in
JJin91: folds=20
Uncalled bet (9050) returned to DaBirds23
DaBirds23 collected 1900 from pot
DaBirds23: doesn't show hand=20
*** SUMMARY ***
Total pot 1900 | Rake 0=20
Seat 1: lilmikey321 folded before Flop (didn't bet)
Seat 2: elliottko folded before Flop (didn't bet)
Seat 3: hamid.felted (button) folded before Flop (didn't bet)
Seat 4: JJin91 (small blind) folded before Flop
Seat 5: DaBirds23 (big blind) collected (1900)
Seat 6: STI809 folded before Flop (didn't bet)


*********** # 151 **************
PokerStars Hand #169426548464: Tournament #1597684008, $13.50+$1.50 USD=
 Hold'em No Limit - Level X (200/400) - 2017/05/05 15:21:40 ET
Table '1597684008 5' 6-max Seat #4 is the button
Seat 1: lilmikey321 (59340 in chips)=20
Seat 2: elliottko (24370 in chips)=20
Seat 3: hamid.felted (33685 in chips)=20
Seat 4: JJin91 (44115 in chips)=20
Seat 5: DaBirds23 (10950 in chips)=20
Seat 6: STI809 (9950 in chips)=20
lilmikey321: posts the ante 50
elliottko: posts the ante 50
hamid.felted: posts the ante 50
JJin91: posts the ante 50
DaBirds23: posts the ante 50
STI809: posts the ante 50
DaBirds23: posts small blind 200
STI809: posts big blind 400
*** HOLE CARDS ***
Dealt to JJin91 [Kd Th]
lilmikey321: calls 400
elliottko: folds=20
hamid.felted: folds=20
JJin91: calls 400
DaBirds23: calls 200
STI809: raises 1900 to 2300
lilmikey321: folds=20
JJin91: folds=20
DaBirds23: folds=20
Uncalled bet (1900) returned to STI809
STI809 collected 1900 from pot
STI809: shows [Ac]
*** SUMMARY ***
Total pot 1900 | Rake 0=20
Seat 1: lilmikey321 folded before Flop
Seat 2: elliottko folded before Flop (didn't bet)
Seat 3: hamid.felted folded before Flop (didn't bet)
Seat 4: JJin91 (button) folded before Flop
Seat 5: DaBirds23 (small blind) folded before Flop
Seat 6: STI809 (big blind) collected (1900)


*********** # 152 **************
PokerStars Hand #169426548556: Tournament #1597684008, $13.50+$1.50 USD=
 Hold'em No Limit - Level X (200/400) - 2017/05/05 15:22:15 ET
Table '1597684008 5' 6-max Seat #5 is the button
Seat 1: lilmikey321 (58890 in chips)=20
Seat 2: elliottko (24320 in chips)=20
Seat 3: hamid.felted (33635 in chips)=20
Seat 4: JJin91 (43665 in chips)=20
Seat 5: DaBirds23 (10500 in chips)=20
Seat 6: STI809 (11400 in chips)=20
lilmikey321: posts the ante 50
elliottko: posts the ante 50
hamid.felted: posts the ante 50
JJin91: posts the ante 50
DaBirds23: posts the ante 50
STI809: posts the ante 50
STI809: posts small blind 200
lilmikey321: posts big blind 400
*** HOLE CARDS ***
Dealt to JJin91 [9h Jc]
elliottko: folds=20
hamid.felted: folds=20
JJin91: folds=20
DaBirds23: folds=20
STI809: calls 200
lilmikey321: checks=20
*** FLOP *** [3s 2c Ks]
STI809: checks=20
lilmikey321: bets 800
STI809: folds=20
Uncalled bet (800) returned to lilmikey321
lilmikey321 collected 1100 from pot
lilmikey321: doesn't show hand=20
*** SUMMARY ***
Total pot 1100 | Rake 0=20
Board [3s 2c Ks]
Seat 1: lilmikey321 (big blind) collected (1100)
Seat 2: elliottko folded before Flop (didn't bet)
Seat 3: hamid.felted folded before Flop (didn't bet)
Seat 4: JJin91 folded before Flop (didn't bet)
Seat 5: DaBirds23 (button) folded before Flop (didn't bet)
Seat 6: STI809 (small blind) folded on the Flop


*********** # 153 **************
PokerStars Hand #169426548647: Tournament #1597684008, $13.50+$1.50 USD=
 Hold'em No Limit - Level XI (250/500) - 2017/05/05 15:22:51 ET
Table '1597684008 5' 6-max Seat #6 is the button
Seat 1: lilmikey321 (59540 in chips)=20
Seat 2: elliottko (24270 in chips)=20
Seat 3: hamid.felted (33585 in chips)=20
Seat 4: JJin91 (43615 in chips)=20
Seat 5: DaBirds23 (10450 in chips)=20
Seat 6: STI809 (10950 in chips)=20
lilmikey321: posts the ante 60
elliottko: posts the ante 60
hamid.felted: posts the ante 60
JJin91: posts the ante 60
DaBirds23: posts the ante 60
STI809: posts the ante 60
lilmikey321: posts small blind 250
elliottko: posts big blind 500
*** HOLE CARDS ***
Dealt to JJin91 [7d 8s]
hamid.felted: calls 500
JJin91: folds=20
DaBirds23: folds=20
STI809: folds=20
lilmikey321: calls 250
elliottko: checks=20
*** FLOP *** [3d Qh 4d]
lilmikey321: bets 1000
elliottko: folds=20
hamid.felted: raises 3500 to 4500
lilmikey321: calls 3500
*** TURN *** [3d Qh 4d] [Tc]
lilmikey321: checks=20
hamid.felted: bets 9500
lilmikey321: folds=20
Uncalled bet (9500) returned to hamid.felted
hamid.felted collected 10860 from pot
hamid.felted: doesn't show hand=20
*** SUMMARY ***
Total pot 10860 | Rake 0=20
Board [3d Qh 4d Tc]
Seat 1: lilmikey321 (small blind) folded on the Turn
Seat 2: elliottko (big blind) folded on the Flop
Seat 3: hamid.felted collected (10860)
Seat 4: JJin91 folded before Flop (didn't bet)
Seat 5: DaBirds23 folded before Flop (didn't bet)
Seat 6: STI809 (button) folded before Flop (didn't bet)


*********** # 154 **************
PokerStars Hand #169426548809: Tournament #1597684008, $13.50+$1.50 USD=
 Hold'em No Limit - Level XI (250/500) - 2017/05/05 15:23:52 ET
Table '1597684008 5' 6-max Seat #1 is the button
Seat 1: lilmikey321 (54480 in chips)=20
Seat 2: elliottko (23710 in chips)=20
Seat 3: hamid.felted (39385 in chips)=20
Seat 4: JJin91 (43555 in chips)=20
Seat 5: DaBirds23 (10390 in chips)=20
Seat 6: STI809 (10890 in chips)=20
lilmikey321: posts the ante 60
elliottko: posts the ante 60
hamid.felted: posts the ante 60
JJin91: posts the ante 60
DaBirds23: posts the ante 60
STI809: posts the ante 60
elliottko: posts small blind 250
hamid.felted: posts big blind 500
*** HOLE CARDS ***
Dealt to JJin91 [5s 6h]
JJin91: folds=20
DaBirds23: folds=20
STI809: folds=20
lilmikey321: raises 500 to 1000
elliottko: folds=20
hamid.felted: calls 500
*** FLOP *** [6s 5d Ks]
hamid.felted: checks=20
lilmikey321: bets 2500
hamid.felted: folds=20
Uncalled bet (2500) returned to lilmikey321
lilmikey321 collected 2610 from pot
lilmikey321: doesn't show hand=20
*** SUMMARY ***
Total pot 2610 | Rake 0=20
Board [6s 5d Ks]
Seat 1: lilmikey321 (button) collected (2610)
Seat 2: elliottko (small blind) folded before Flop
Seat 3: hamid.felted (big blind) folded on the Flop
Seat 4: JJin91 folded before Flop (didn't bet)
Seat 5: DaBirds23 folded before Flop (didn't bet)
Seat 6: STI809 folded before Flop (didn't bet)


*********** # 155 **************
PokerStars Hand #169426548928: Tournament #1597684008, $13.50+$1.50 USD=
 Hold'em No Limit - Level XI (250/500) - 2017/05/05 15:24:39 ET
Table '1597684008 5' 6-max Seat #2 is the button
Seat 1: lilmikey321 (56030 in chips)=20
Seat 2: elliottko (23400 in chips)=20
Seat 3: hamid.felted (38325 in chips)=20
Seat 4: JJin91 (43495 in chips)=20
Seat 5: DaBirds23 (10330 in chips)=20
Seat 6: STI809 (10830 in chips)=20
lilmikey321: posts the ante 60
elliottko: posts the ante 60
hamid.felted: posts the ante 60
JJin91: posts the ante 60
DaBirds23: posts the ante 60
STI809: posts the ante 60
hamid.felted: posts small blind 250
JJin91: posts big blind 500
*** HOLE CARDS ***
Dealt to JJin91 [9h 8h]
DaBirds23: folds=20
STI809: folds=20
lilmikey321: calls 500
elliottko: calls 500
hamid.felted: calls 250
JJin91: checks=20
*** FLOP *** [9s 5h Kh]
hamid.felted: checks=20
JJin91: bets 1285
lilmikey321: folds=20
elliottko: folds=20
hamid.felted: folds=20
Uncalled bet (1285) returned to JJin91
JJin91 collected 2360 from pot
*** SUMMARY ***
Total pot 2360 | Rake 0=20
Board [9s 5h Kh]
Seat 1: lilmikey321 folded on the Flop
Seat 2: elliottko (button) folded on the Flop
Seat 3: hamid.felted (small blind) folded on the Flop
Seat 4: JJin91 (big blind) collected (2360)
Seat 5: DaBirds23 folded before Flop (didn't bet)
Seat 6: STI809 folded before Flop (didn't bet)


*********** # 156 **************
PokerStars Hand #169426549076: Tournament #1597684008, $13.50+$1.50 USD=
 Hold'em No Limit - Level XI (250/500) - 2017/05/05 15:25:32 ET
Table '1597684008 5' 6-max Seat #3 is the button
Seat 1: lilmikey321 (55470 in chips)=20
Seat 2: elliottko (22840 in chips)=20
Seat 3: hamid.felted (37765 in chips)=20
Seat 4: JJin91 (45295 in chips)=20
Seat 5: DaBirds23 (10270 in chips)=20
Seat 6: STI809 (10770 in chips)=20
lilmikey321: posts the ante 60
elliottko: posts the ante 60
hamid.felted: posts the ante 60
JJin91: posts the ante 60
DaBirds23: posts the ante 60
STI809: posts the ante 60
JJin91: posts small blind 250
DaBirds23: posts big blind 500
*** HOLE CARDS ***
Dealt to JJin91 [4h Jc]
STI809: folds=20
lilmikey321: folds=20
elliottko: folds=20
hamid.felted: folds=20
JJin91: folds=20
Uncalled bet (250) returned to DaBirds23
DaBirds23 collected 860 from pot
*** SUMMARY ***
Total pot 860 | Rake 0=20
Seat 1: lilmikey321 folded before Flop (didn't bet)
Seat 2: elliottko folded before Flop (didn't bet)
Seat 3: hamid.felted (button) folded before Flop (didn't bet)
Seat 4: JJin91 (small blind) folded before Flop
Seat 5: DaBirds23 (big blind) collected (860)
Seat 6: STI809 folded before Flop (didn't bet)


*********** # 157 **************
PokerStars Hand #169426549158: Tournament #1597684008, $13.50+$1.50 USD=
 Hold'em No Limit - Level XI (250/500) - 2017/05/05 15:26:00 ET
Table '1597684008 5' 6-max Seat #4 is the button
Seat 1: lilmikey321 (55410 in chips)=20
Seat 2: elliottko (22780 in chips)=20
Seat 3: hamid.felted (37705 in chips)=20
Seat 4: JJin91 (44985 in chips)=20
Seat 5: DaBirds23 (10820 in chips)=20
Seat 6: STI809 (10710 in chips)=20
lilmikey321: posts the ante 60
elliottko: posts the ante 60
hamid.felted: posts the ante 60
JJin91: posts the ante 60
DaBirds23: posts the ante 60
STI809: posts the ante 60
DaBirds23: posts small blind 250
STI809: posts big blind 500
*** HOLE CARDS ***
Dealt to JJin91 [8d 6d]
lilmikey321: calls 500
elliottko: folds=20
hamid.felted: folds=20
JJin91: folds=20
DaBirds23: folds=20
STI809: checks=20
*** FLOP *** [5s Qc Ah]
STI809: checks=20
lilmikey321: bets 1000
STI809: folds=20
Uncalled bet (1000) returned to lilmikey321
lilmikey321 collected 1610 from pot
lilmikey321: doesn't show hand=20
*** SUMMARY ***
Total pot 1610 | Rake 0=20
Board [5s Qc Ah]
Seat 1: lilmikey321 collected (1610)
Seat 2: elliottko folded before Flop (didn't bet)
Seat 3: hamid.felted folded before Flop (didn't bet)
Seat 4: JJin91 (button) folded before Flop (didn't bet)
Seat 5: DaBirds23 (small blind) folded before Flop
Seat 6: STI809 (big blind) folded on the Flop


*********** # 158 **************
PokerStars Hand #169426549362: Tournament #1597684008, $13.50+$1.50 USD=
 Hold'em No Limit - Level XI (250/500) - 2017/05/05 15:27:16 ET
Table '1597684008 5' 6-max Seat #5 is the button
Seat 1: lilmikey321 (56460 in chips)=20
Seat 2: elliottko (22720 in chips)=20
Seat 3: hamid.felted (37645 in chips)=20
Seat 4: JJin91 (44925 in chips)=20
Seat 5: DaBirds23 (10510 in chips)=20
Seat 6: STI809 (10150 in chips)=20
lilmikey321: posts the ante 60
elliottko: posts the ante 60
hamid.felted: posts the ante 60
JJin91: posts the ante 60
DaBirds23: posts the ante 60
STI809: posts the ante 60
STI809: posts small blind 250
lilmikey321: posts big blind 500
*** HOLE CARDS ***
Dealt to JJin91 [8s 7c]
elliottko: folds=20
hamid.felted: raises 750 to 1250
JJin91: folds=20
DaBirds23: folds=20
STI809: folds=20
lilmikey321: calls 750
*** FLOP *** [4c 8h 3c]
lilmikey321: checks=20
hamid.felted: bets 1500
lilmikey321: folds=20
Uncalled bet (1500) returned to hamid.felted
hamid.felted collected 3110 from pot
hamid.felted: doesn't show hand=20
*** SUMMARY ***
Total pot 3110 | Rake 0=20
Board [4c 8h 3c]
Seat 1: lilmikey321 (big blind) folded on the Flop
Seat 2: elliottko folded before Flop (didn't bet)
Seat 3: hamid.felted collected (3110)
Seat 4: JJin91 folded before Flop (didn't bet)
Seat 5: DaBirds23 (button) folded before Flop (didn't bet)
Seat 6: STI809 (small blind) folded before Flop


*********** # 159 **************
PokerStars Hand #169426549437: Tournament #1597684008, $13.50+$1.50 USD=
 Hold'em No Limit - Level XI (250/500) - 2017/05/05 15:27:47 ET
Table '1597684008 5' 6-max Seat #6 is the button
Seat 1: lilmikey321 (55150 in chips)=20
Seat 2: elliottko (22660 in chips)=20
Seat 3: hamid.felted (39445 in chips)=20
Seat 4: JJin91 (44865 in chips)=20
Seat 5: DaBirds23 (10450 in chips)=20
Seat 6: STI809 (9840 in chips)=20
lilmikey321: posts the ante 60
elliottko: posts the ante 60
hamid.felted: posts the ante 60
JJin91: posts the ante 60
DaBirds23: posts the ante 60
STI809: posts the ante 60
lilmikey321: posts small blind 250
elliottko: posts big blind 500
*** HOLE CARDS ***
Dealt to JJin91 [3h 4d]
hamid.felted: folds=20
JJin91: folds=20
DaBirds23: folds=20
STI809: folds=20
lilmikey321: calls 250
elliottko: checks=20
*** FLOP *** [Qd 4c 3c]
lilmikey321: checks=20
elliottko: checks=20
*** TURN *** [Qd 4c 3c] [9c]
lilmikey321: bets 500
elliottko: folds=20
Uncalled bet (500) returned to lilmikey321
lilmikey321 collected 1360 from pot
lilmikey321: doesn't show hand=20
*** SUMMARY ***
Total pot 1360 | Rake 0=20
Board [Qd 4c 3c 9c]
Seat 1: lilmikey321 (small blind) collected (1360)
Seat 2: elliottko (big blind) folded on the Turn
Seat 3: hamid.felted folded before Flop (didn't bet)
Seat 4: JJin91 folded before Flop (didn't bet)
Seat 5: DaBirds23 folded before Flop (didn't bet)
Seat 6: STI809 (button) folded before Flop (didn't bet)


*********** # 160 **************
PokerStars Hand #169426549537: Tournament #1597684008, $13.50+$1.50 USD=
 Hold'em No Limit - Level XI (250/500) - 2017/05/05 15:28:29 ET
Table '1597684008 5' 6-max Seat #1 is the button
Seat 1: lilmikey321 (55950 in chips)=20
Seat 2: elliottko (22100 in chips)=20
Seat 3: hamid.felted (39385 in chips)=20
Seat 4: JJin91 (44805 in chips)=20
Seat 5: DaBirds23 (10390 in chips)=20
Seat 6: STI809 (9780 in chips)=20
lilmikey321: posts the ante 60
elliottko: posts the ante 60
hamid.felted: posts the ante 60
JJin91: posts the ante 60
DaBirds23: posts the ante 60
STI809: posts the ante 60
elliottko: posts small blind 250
hamid.felted: posts big blind 500
*** HOLE CARDS ***
Dealt to JJin91 [4s 3c]
JJin91: folds=20
DaBirds23: folds=20
STI809: folds=20
lilmikey321: raises 1000 to 1500
elliottko: folds=20
hamid.felted: calls 1000
*** FLOP *** [2c 2s Th]
hamid.felted: checks=20
lilmikey321: bets 5000
hamid.felted: folds=20
Uncalled bet (5000) returned to lilmikey321
lilmikey321 collected 3610 from pot
lilmikey321: doesn't show hand=20
*** SUMMARY ***
Total pot 3610 | Rake 0=20
Board [2c 2s Th]
Seat 1: lilmikey321 (button) collected (3610)
Seat 2: elliottko (small blind) folded before Flop
Seat 3: hamid.felted (big blind) folded on the Flop
Seat 4: JJin91 folded before Flop (didn't bet)
Seat 5: DaBirds23 folded before Flop (didn't bet)
Seat 6: STI809 folded before Flop (didn't bet)


*********** # 161 **************
PokerStars Hand #169426549675: Tournament #1597684008, $13.50+$1.50 USD=
 Hold'em No Limit - Level XI (250/500) - 2017/05/05 15:29:25 ET
Table '1597684008 5' 6-max Seat #2 is the button
Seat 1: lilmikey321 (58000 in chips)=20
Seat 2: elliottko (21790 in chips)=20
Seat 3: hamid.felted (37825 in chips)=20
Seat 4: JJin91 (44745 in chips)=20
Seat 5: DaBirds23 (10330 in chips)=20
Seat 6: STI809 (9720 in chips)=20
lilmikey321: posts the ante 60
elliottko: posts the ante 60
hamid.felted: posts the ante 60
JJin91: posts the ante 60
DaBirds23: posts the ante 60
STI809: posts the ante 60
hamid.felted: posts small blind 250
JJin91: posts big blind 500
*** HOLE CARDS ***
Dealt to JJin91 [3h Ac]
DaBirds23: raises 500 to 1000
STI809: folds=20
lilmikey321: calls 1000
elliottko: calls 1000
hamid.felted: folds=20
JJin91: calls 500
*** FLOP *** [2h Td 7d]
JJin91: checks=20
DaBirds23: checks=20
lilmikey321: bets 2500
elliottko: folds=20
JJin91: folds=20
DaBirds23: folds=20
Uncalled bet (2500) returned to lilmikey321
lilmikey321 collected 4610 from pot
lilmikey321: doesn't show hand=20
*** SUMMARY ***
Total pot 4610 | Rake 0=20
Board [2h Td 7d]
Seat 1: lilmikey321 collected (4610)
Seat 2: elliottko (button) folded on the Flop
Seat 3: hamid.felted (small blind) folded before Flop
Seat 4: JJin91 (big blind) folded on the Flop
Seat 5: DaBirds23 folded on the Flop
Seat 6: STI809 folded before Flop (didn't bet)


*********** # 162 **************
PokerStars Hand #169426549762: Tournament #1597684008, $13.50+$1.50 USD=
 Hold'em No Limit - Level XI (250/500) - 2017/05/05 15:29:58 ET
Table '1597684008 5' 6-max Seat #3 is the button
Seat 1: lilmikey321 (61550 in chips)=20
Seat 2: elliottko (20730 in chips)=20
Seat 3: hamid.felted (37515 in chips)=20
Seat 4: JJin91 (43685 in chips)=20
Seat 5: DaBirds23 (9270 in chips)=20
Seat 6: STI809 (9660 in chips)=20
lilmikey321: posts the ante 60
elliottko: posts the ante 60
hamid.felted: posts the ante 60
JJin91: posts the ante 60
DaBirds23: posts the ante 60
STI809: posts the ante 60
JJin91: posts small blind 250
DaBirds23: posts big blind 500
*** HOLE CARDS ***
Dealt to JJin91 [Ad Js]
STI809: folds=20
lilmikey321: calls 500
elliottko: calls 500
hamid.felted: calls 500
JJin91: raises 2500 to 3000
DaBirds23: folds=20
lilmikey321: folds=20
elliottko: folds=20
hamid.felted: folds=20
Uncalled bet (2500) returned to JJin91
JJin91 collected 2860 from pot
*** SUMMARY ***
Total pot 2860 | Rake 0=20
Seat 1: lilmikey321 folded before Flop
Seat 2: elliottko folded before Flop
Seat 3: hamid.felted (button) folded before Flop
Seat 4: JJin91 (small blind) collected (2860)
Seat 5: DaBirds23 (big blind) folded before Flop
Seat 6: STI809 folded before Flop (didn't bet)


*********** # 163 **************
PokerStars Hand #169426549882: Tournament #1597684008, $13.50+$1.50 USD=
 Hold'em No Limit - Level XI (250/500) - 2017/05/05 15:30:40 ET
Table '1597684008 5' 6-max Seat #4 is the button
Seat 1: lilmikey321 (60990 in chips)=20
Seat 2: elliottko (20170 in chips)=20
Seat 3: hamid.felted (36955 in chips)=20
Seat 4: JJin91 (45985 in chips)=20
Seat 5: DaBirds23 (8710 in chips)=20
Seat 6: STI809 (9600 in chips)=20
lilmikey321: posts the ante 60
elliottko: posts the ante 60
hamid.felted: posts the ante 60
JJin91: posts the ante 60
DaBirds23: posts the ante 60
STI809: posts the ante 60
DaBirds23: posts small blind 250
STI809: posts big blind 500
*** HOLE CARDS ***
Dealt to JJin91 [4c 2d]
lilmikey321: calls 500
elliottko: raises 1000 to 1500
hamid.felted: folds=20
JJin91: folds=20
DaBirds23: raises 7150 to 8650 and is all-in
STI809: folds=20
lilmikey321: folds=20
elliottko: folds=20
Uncalled bet (7150) returned to DaBirds23
DaBirds23 collected 4360 from pot
*** SUMMARY ***
Total pot 4360 | Rake 0=20
Seat 1: lilmikey321 folded before Flop
Seat 2: elliottko folded before Flop
Seat 3: hamid.felted folded before Flop (didn't bet)
Seat 4: JJin91 (button) folded before Flop (didn't bet)
Seat 5: DaBirds23 (small blind) collected (4360)
Seat 6: STI809 (big blind) folded before Flop


*********** # 164 **************
PokerStars Hand #169426549975: Tournament #1597684008, $13.50+$1.50 USD=
 Hold'em No Limit - Level XI (250/500) - 2017/05/05 15:31:12 ET
Table '1597684008 5' 6-max Seat #5 is the button
Seat 1: lilmikey321 (60430 in chips)=20
Seat 2: elliottko (18610 in chips)=20
Seat 3: hamid.felted (36895 in chips)=20
Seat 4: JJin91 (45925 in chips)=20
Seat 5: DaBirds23 (11510 in chips)=20
Seat 6: STI809 (9040 in chips)=20
lilmikey321: posts the ante 60
elliottko: posts the ante 60
hamid.felted: posts the ante 60
JJin91: posts the ante 60
DaBirds23: posts the ante 60
STI809: posts the ante 60
STI809: posts small blind 250
lilmikey321: posts big blind 500
*** HOLE CARDS ***
Dealt to JJin91 [Jd 2s]
elliottko: folds=20
hamid.felted: folds=20
JJin91: folds=20
DaBirds23: raises 500 to 1000
STI809: folds=20
lilmikey321: calls 500
*** FLOP *** [As Qs 9h]
lilmikey321: checks=20
DaBirds23: bets 940
lilmikey321: folds=20
Uncalled bet (940) returned to DaBirds23
DaBirds23 collected 2610 from pot
DaBirds23: doesn't show hand=20
*** SUMMARY ***
Total pot 2610 | Rake 0=20
Board [As Qs 9h]
Seat 1: lilmikey321 (big blind) folded on the Flop
Seat 2: elliottko folded before Flop (didn't bet)
Seat 3: hamid.felted folded before Flop (didn't bet)
Seat 4: JJin91 folded before Flop (didn't bet)
Seat 5: DaBirds23 (button) collected (2610)
Seat 6: STI809 (small blind) folded before Flop


*********** # 165 **************
PokerStars Hand #169427455237: Tournament #1597684008, $13.50+$1.50 USD=
 Hold'em No Limit - Level XI (250/500) - 2017/05/05 15:31:35 ET
Table '1597684008 5' 6-max Seat #6 is the button
Seat 1: lilmikey321 (59370 in chips)=20
Seat 2: elliottko (18550 in chips)=20
Seat 3: hamid.felted (36835 in chips)=20
Seat 4: JJin91 (45865 in chips)=20
Seat 5: DaBirds23 (13060 in chips)=20
Seat 6: STI809 (8730 in chips)=20
lilmikey321: posts the ante 60
elliottko: posts the ante 60
hamid.felted: posts the ante 60
JJin91: posts the ante 60
DaBirds23: posts the ante 60
STI809: posts the ante 60
lilmikey321: posts small blind 250
elliottko: posts big blind 500
*** HOLE CARDS ***
Dealt to JJin91 [Jc Ad]
hamid.felted: raises 750 to 1250
JJin91: calls 1250
DaBirds23: folds=20
STI809: folds=20
lilmikey321: calls 1000
elliottko: raises 17240 to 18490 and is all-in
hamid.felted: folds=20
JJin91: folds=20
lilmikey321: calls 17240
*** FLOP *** [Qs 2d 4h]
*** TURN *** [Qs 2d 4h] [3s]
*** RIVER *** [Qs 2d 4h 3s] [9c]
*** SHOW DOWN ***
lilmikey321: shows [Qh Kc] (a pair of Queens)
elliottko: shows [Tc Th] (a pair of Tens)
lilmikey321 collected 39840 from pot
elliottko finished the tournament in 42nd place
*** SUMMARY ***
Total pot 39840 | Rake 0=20
Board [Qs 2d 4h 3s 9c]
Seat 1: lilmikey321 (small blind) showed [Qh Kc] and won (39840) with a=
 pair of Queens
Seat 2: elliottko (big blind) showed [Tc Th] and lost with a pair of Te=
ns
Seat 3: hamid.felted folded before Flop
Seat 4: JJin91 folded before Flop
Seat 5: DaBirds23 folded before Flop (didn't bet)
Seat 6: STI809 (button) folded before Flop (didn't bet)


*********** # 166 **************
PokerStars Hand #169427455534: Tournament #1597684008, $13.50+$1.50 USD=
 Hold'em No Limit - Level XII (300/600) - 2017/05/05 15:33:25 ET
Table '1597684008 5' 6-max Seat #1 is the button
Seat 1: lilmikey321 (80660 in chips)=20
Seat 3: hamid.felted (35525 in chips)=20
Seat 4: JJin91 (44555 in chips)=20
Seat 5: DaBirds23 (13000 in chips)=20
Seat 6: STI809 (8670 in chips)=20
lilmikey321: posts the ante 70
hamid.felted: posts the ante 70
JJin91: posts the ante 70
DaBirds23: posts the ante 70
STI809: posts the ante 70
hamid.felted: posts small blind 300
JJin91: posts big blind 600
*** HOLE CARDS ***
Dealt to JJin91 [Jh 6h]
DaBirds23: raises 600 to 1200
STI809: folds=20
lilmikey321: folds=20
hamid.felted: folds=20
JJin91: calls 600
*** FLOP *** [9s 3h Kc]
JJin91: checks=20
DaBirds23: bets 1098
JJin91: folds=20
Uncalled bet (1098) returned to DaBirds23
DaBirds23 collected 3050 from pot
DaBirds23: doesn't show hand=20
*** SUMMARY ***
Total pot 3050 | Rake 0=20
Board [9s 3h Kc]
Seat 1: lilmikey321 (button) folded before Flop (didn't bet)
Seat 3: hamid.felted (small blind) folded before Flop
Seat 4: JJin91 (big blind) folded on the Flop
Seat 5: DaBirds23 collected (3050)
Seat 6: STI809 folded before Flop (didn't bet)


*********** # 167 **************
PokerStars Hand #169427455598: Tournament #1597684008, $13.50+$1.50 USD=
 Hold'em No Limit - Level XII (300/600) - 2017/05/05 15:33:48 ET
Table '1597684008 5' 6-max Seat #3 is the button
Seat 1: lilmikey321 (80590 in chips)=20
Seat 3: hamid.felted (35155 in chips)=20
Seat 4: JJin91 (43285 in chips)=20
Seat 5: DaBirds23 (14780 in chips)=20
Seat 6: STI809 (8600 in chips)=20
lilmikey321: posts the ante 70
hamid.felted: posts the ante 70
JJin91: posts the ante 70
DaBirds23: posts the ante 70
STI809: posts the ante 70
JJin91: posts small blind 300
DaBirds23: posts big blind 600
*** HOLE CARDS ***
Dealt to JJin91 [3c 9d]
STI809: folds=20
lilmikey321: calls 600
hamid.felted: raises 1200 to 1800
JJin91: folds=20
DaBirds23: raises 12910 to 14710 and is all-in
lilmikey321: folds=20
hamid.felted: calls 12910
*** FLOP *** [8d Ts Ks]
*** TURN *** [8d Ts Ks] [Ad]
*** RIVER *** [8d Ts Ks Ad] [Tc]
*** SHOW DOWN ***
DaBirds23: shows [9s 9h] (two pair, Tens and Nines)
hamid.felted: shows [7h 7d] (two pair, Tens and Sevens)
DaBirds23 collected 30670 from pot
*** SUMMARY ***
Total pot 30670 | Rake 0=20
Board [8d Ts Ks Ad Tc]
Seat 1: lilmikey321 folded before Flop
Seat 3: hamid.felted (button) showed [7h 7d] and lost with two pair, Te=
ns and Sevens
Seat 4: JJin91 (small blind) folded before Flop
Seat 5: DaBirds23 (big blind) showed [9s 9h] and won (30670) with two p=
air, Tens and Nines
Seat 6: STI809 folded before Flop (didn't bet)


*********** # 168 **************
PokerStars Hand #169427455698: Tournament #1597684008, $13.50+$1.50 USD=
 Hold'em No Limit - Level XII (300/600) - 2017/05/05 15:34:24 ET
Table '1597684008 5' 6-max Seat #4 is the button
Seat 1: lilmikey321 (79920 in chips)=20
Seat 3: hamid.felted (20375 in chips)=20
Seat 4: JJin91 (42915 in chips)=20
Seat 5: DaBirds23 (30670 in chips)=20
Seat 6: STI809 (8530 in chips)=20
lilmikey321: posts the ante 70
hamid.felted: posts the ante 70
JJin91: posts the ante 70
DaBirds23: posts the ante 70
STI809: posts the ante 70
DaBirds23: posts small blind 300
STI809: posts big blind 600
*** HOLE CARDS ***
Dealt to JJin91 [Qs Ac]
lilmikey321: raises 1200 to 1800
hamid.felted: folds=20
JJin91: calls 1800
DaBirds23: calls 1500
STI809: folds=20
*** FLOP *** [Kh 9h 5c]
DaBirds23: checks=20
lilmikey321: bets 4200
JJin91: folds=20
DaBirds23: folds=20
Uncalled bet (4200) returned to lilmikey321
lilmikey321 collected 6350 from pot
lilmikey321: doesn't show hand=20
*** SUMMARY ***
Total pot 6350 | Rake 0=20
Board [Kh 9h 5c]
Seat 1: lilmikey321 collected (6350)
Seat 3: hamid.felted folded before Flop (didn't bet)
Seat 4: JJin91 (button) folded on the Flop
Seat 5: DaBirds23 (small blind) folded on the Flop
Seat 6: STI809 (big blind) folded before Flop


*********** # 169 **************
PokerStars Hand #169427455860: Tournament #1597684008, $13.50+$1.50 USD=
 Hold'em No Limit - Level XII (300/600) - 2017/05/05 15:35:25 ET
Table '1597684008 5' 6-max Seat #5 is the button
Seat 1: lilmikey321 (84400 in chips)=20
Seat 3: hamid.felted (20305 in chips)=20
Seat 4: JJin91 (41045 in chips)=20
Seat 5: DaBirds23 (28800 in chips)=20
Seat 6: STI809 (7860 in chips)=20
lilmikey321: posts the ante 70
hamid.felted: posts the ante 70
JJin91: posts the ante 70
DaBirds23: posts the ante 70
STI809: posts the ante 70
STI809: posts small blind 300
lilmikey321: posts big blind 600
*** HOLE CARDS ***
Dealt to JJin91 [Ad Kd]
hamid.felted: raises 1200 to 1800
JJin91: raises 2400 to 4200
DaBirds23: folds=20
STI809: folds=20
lilmikey321: folds=20
hamid.felted: raises 9600 to 13800
JJin91: raises 27175 to 40975 and is all-in
hamid.felted: calls 6435 and is all-in
Uncalled bet (20740) returned to JJin91
*** FLOP *** [Kc 3s 9d]
*** TURN *** [Kc 3s 9d] [5d]
*** RIVER *** [Kc 3s 9d 5d] [9h]
*** SHOW DOWN ***
hamid.felted: shows [Qh Qd] (two pair, Queens and Nines)
JJin91: shows [Ad Kd] (two pair, Kings and Nines)
JJin91 collected 41720 from pot
hamid.felted finished the tournament in 39th place
*** SUMMARY ***
Total pot 41720 | Rake 0=20
Board [Kc 3s 9d 5d 9h]
Seat 1: lilmikey321 (big blind) folded before Flop
Seat 3: hamid.felted showed [Qh Qd] and lost with two pair, Queens and =
Nines
Seat 4: JJin91 showed [Ad Kd] and won (41720) with two pair, Kings and =
Nines
Seat 5: DaBirds23 (button) folded before Flop (didn't bet)
Seat 6: STI809 (small blind) folded before Flop


*********** # 170 **************
PokerStars Hand #169427455965: Tournament #1597684008, $13.50+$1.50 USD=
 Hold'em No Limit - Level XII (300/600) - 2017/05/05 15:36:06 ET
Table '1597684008 5' 6-max Seat #6 is the button
Seat 1: lilmikey321 (83730 in chips)=20
Seat 4: JJin91 (62460 in chips)=20
Seat 5: DaBirds23 (28730 in chips)=20
Seat 6: STI809 (7490 in chips)=20
lilmikey321: posts the ante 70
JJin91: posts the ante 70
DaBirds23: posts the ante 70
STI809: posts the ante 70
lilmikey321: posts small blind 300
JJin91: posts big blind 600
*** HOLE CARDS ***
Dealt to JJin91 [Jh 4c]
DaBirds23: folds=20
STI809: folds=20
lilmikey321: raises 600 to 1200
JJin91: folds=20
Uncalled bet (600) returned to lilmikey321
lilmikey321 collected 1480 from pot
lilmikey321: doesn't show hand=20
*** SUMMARY ***
Total pot 1480 | Rake 0=20
Seat 1: lilmikey321 (small blind) collected (1480)
Seat 4: JJin91 (big blind) folded before Flop
Seat 5: DaBirds23 folded before Flop (didn't bet)
Seat 6: STI809 (button) folded before Flop (didn't bet)


*********** # 171 **************
PokerStars Hand #169427456008: Tournament #1597684008, $13.50+$1.50 USD=
 Hold'em No Limit - Level XII (300/600) - 2017/05/05 15:36:20 ET
Table '1597684008 5' 6-max Seat #1 is the button
Seat 1: lilmikey321 (84540 in chips)=20
Seat 2: justin66lee (34416 in chips) out of hand (moved from another ta=
ble into small blind)
Seat 4: JJin91 (61790 in chips)=20
Seat 5: DaBirds23 (28660 in chips)=20
Seat 6: STI809 (7420 in chips)=20
lilmikey321: posts the ante 70
JJin91: posts the ante 70
DaBirds23: posts the ante 70
STI809: posts the ante 70
JJin91: posts small blind 300
DaBirds23: posts big blind 600
*** HOLE CARDS ***
Dealt to JJin91 [4c 5c]
STI809: raises 1067 to 1667
lilmikey321: folds=20
JJin91: folds=20
DaBirds23: folds=20
Uncalled bet (1067) returned to STI809
STI809 collected 1780 from pot
*** SUMMARY ***
Total pot 1780 | Rake 0=20
Seat 1: lilmikey321 (button) folded before Flop (didn't bet)
Seat 4: JJin91 (small blind) folded before Flop
Seat 5: DaBirds23 (big blind) folded before Flop
Seat 6: STI809 collected (1780)


*********** # 172 **************
PokerStars Hand #169427456059: Tournament #1597684008, $13.50+$1.50 USD=
 Hold'em No Limit - Level XII (300/600) - 2017/05/05 15:36:42 ET
Table '1597684008 5' 6-max Seat #4 is the button
Seat 1: lilmikey321 (84470 in chips)=20
Seat 2: justin66lee (34416 in chips)=20
Seat 4: JJin91 (61420 in chips)=20
Seat 5: DaBirds23 (27990 in chips)=20
Seat 6: STI809 (8530 in chips)=20
lilmikey321: posts the ante 70
justin66lee: posts the ante 70
JJin91: posts the ante 70
DaBirds23: posts the ante 70
STI809: posts the ante 70
DaBirds23: posts small blind 300
STI809: posts big blind 600
*** HOLE CARDS ***
Dealt to JJin91 [4d As]
lilmikey321: folds=20
justin66lee: folds=20
JJin91: raises 812 to 1412
DaBirds23: folds=20
STI809: folds=20
Uncalled bet (812) returned to JJin91
JJin91 collected 1850 from pot
*** SUMMARY ***
Total pot 1850 | Rake 0=20
Seat 1: lilmikey321 folded before Flop (didn't bet)
Seat 2: justin66lee folded before Flop (didn't bet)
Seat 4: JJin91 (button) collected (1850)
Seat 5: DaBirds23 (small blind) folded before Flop
Seat 6: STI809 (big blind) folded before Flop


*********** # 173 **************
PokerStars Hand #169427456132: Tournament #1597684008, $13.50+$1.50 USD=
 Hold'em No Limit - Level XII (300/600) - 2017/05/05 15:37:09 ET
Table '1597684008 5' 6-max Seat #5 is the button
Seat 1: lilmikey321 (84400 in chips)=20
Seat 2: justin66lee (34346 in chips)=20
Seat 4: JJin91 (62600 in chips)=20
Seat 5: DaBirds23 (27620 in chips)=20
Seat 6: STI809 (7860 in chips)=20
lilmikey321: posts the ante 70
justin66lee: posts the ante 70
JJin91: posts the ante 70
DaBirds23: posts the ante 70
STI809: posts the ante 70
STI809: posts small blind 300
lilmikey321: posts big blind 600
*** HOLE CARDS ***
Dealt to JJin91 [6s Qd]
justin66lee: folds=20
JJin91: folds=20
DaBirds23: raises 600 to 1200
STI809: folds=20
lilmikey321: calls 600
*** FLOP *** [6h Ts Qc]
lilmikey321: bets 1200
DaBirds23: raises 1800 to 3000
lilmikey321: folds=20
Uncalled bet (1800) returned to DaBirds23
DaBirds23 collected 5450 from pot
DaBirds23: doesn't show hand=20
*** SUMMARY ***
Total pot 5450 | Rake 0=20
Board [6h Ts Qc]
Seat 1: lilmikey321 (big blind) folded on the Flop
Seat 2: justin66lee folded before Flop (didn't bet)
Seat 4: JJin91 folded before Flop (didn't bet)
Seat 5: DaBirds23 (button) collected (5450)
Seat 6: STI809 (small blind) folded before Flop


*********** # 174 **************
PokerStars Hand #169427456206: Tournament #1597684008, $13.50+$1.50 USD=
 Hold'em No Limit - Level XII (300/600) - 2017/05/05 15:37:38 ET
Table '1597684008 5' 6-max Seat #6 is the button
Seat 1: lilmikey321 (81930 in chips)=20
Seat 2: justin66lee (34276 in chips)=20
Seat 4: JJin91 (62530 in chips)=20
Seat 5: DaBirds23 (30600 in chips)=20
Seat 6: STI809 (7490 in chips)=20
lilmikey321: posts the ante 70
justin66lee: posts the ante 70
JJin91: posts the ante 70
DaBirds23: posts the ante 70
STI809: posts the ante 70
lilmikey321: posts small blind 300
justin66lee: posts big blind 600
*** HOLE CARDS ***
Dealt to JJin91 [5c 4c]
JJin91: folds=20
DaBirds23: folds=20
STI809: folds=20
lilmikey321: calls 300
justin66lee: checks=20
*** FLOP *** [Ac 8c 4s]
lilmikey321: bets 1800
justin66lee: folds=20
Uncalled bet (1800) returned to lilmikey321
lilmikey321 collected 1550 from pot
lilmikey321: doesn't show hand=20
*** SUMMARY ***
Total pot 1550 | Rake 0=20
Board [Ac 8c 4s]
Seat 1: lilmikey321 (small blind) collected (1550)
Seat 2: justin66lee (big blind) folded on the Flop
Seat 4: JJin91 folded before Flop (didn't bet)
Seat 5: DaBirds23 folded before Flop (didn't bet)
Seat 6: STI809 (button) folded before Flop (didn't bet)


*********** # 175 **************
PokerStars Hand #169427456270: Tournament #1597684008, $13.50+$1.50 USD=
 Hold'em No Limit - Level XII (300/600) - 2017/05/05 15:38:02 ET
Table '1597684008 5' 6-max Seat #1 is the button
Seat 1: lilmikey321 (82810 in chips)=20
Seat 2: justin66lee (33606 in chips)=20
Seat 4: JJin91 (62460 in chips)=20
Seat 5: DaBirds23 (30530 in chips)=20
Seat 6: STI809 (7420 in chips)=20
lilmikey321: posts the ante 70
justin66lee: posts the ante 70
JJin91: posts the ante 70
DaBirds23: posts the ante 70
STI809: posts the ante 70
justin66lee: posts small blind 300
JJin91: posts big blind 600
*** HOLE CARDS ***
Dealt to JJin91 [Kd Qd]
DaBirds23: folds=20
STI809 has timed out
STI809: folds=20
STI809 is sitting out
STI809 has returned
lilmikey321: raises 1200 to 1800
justin66lee: folds=20
JJin91: calls 1200
*** FLOP *** [3h 5h Qc]
JJin91: bets 2865
lilmikey321: folds=20
Uncalled bet (2865) returned to JJin91
JJin91 collected 4250 from pot
*** SUMMARY ***
Total pot 4250 | Rake 0=20
Board [3h 5h Qc]
Seat 1: lilmikey321 (button) folded on the Flop
Seat 2: justin66lee (small blind) folded before Flop
Seat 4: JJin91 (big blind) collected (4250)
Seat 5: DaBirds23 folded before Flop (didn't bet)
Seat 6: STI809 folded before Flop (didn't bet)


*********** # 176 **************
PokerStars Hand #169427456434: Tournament #1597684008, $13.50+$1.50 USD=
 Hold'em No Limit - Level XII (300/600) - 2017/05/05 15:38:58 ET
Table '1597684008 5' 6-max Seat #2 is the button
Seat 1: lilmikey321 (80940 in chips)=20
Seat 2: justin66lee (33236 in chips)=20
Seat 3: FnSmooth45 (27790 in chips) out of hand (moved from another tab=
le into small blind)
Seat 4: JJin91 (64840 in chips)=20
Seat 5: DaBirds23 (30460 in chips)=20
Seat 6: STI809 (7350 in chips)=20
lilmikey321: posts the ante 70
justin66lee: posts the ante 70
JJin91: posts the ante 70
DaBirds23: posts the ante 70
STI809: posts the ante 70
JJin91: posts small blind 300
DaBirds23: posts big blind 600
*** HOLE CARDS ***
Dealt to JJin91 [5h 8s]
STI809: folds=20
lilmikey321: folds=20
justin66lee: folds=20
JJin91: folds=20
Uncalled bet (300) returned to DaBirds23
DaBirds23 collected 950 from pot
*** SUMMARY ***
Total pot 950 | Rake 0=20
Seat 1: lilmikey321 folded before Flop (didn't bet)
Seat 2: justin66lee (button) folded before Flop (didn't bet)
Seat 4: JJin91 (small blind) folded before Flop
Seat 5: DaBirds23 (big blind) collected (950)
Seat 6: STI809 folded before Flop (didn't bet)


*********** # 177 **************
PokerStars Hand #169427456477: Tournament #1597684008, $13.50+$1.50 USD=
 Hold'em No Limit - Level XII (300/600) - 2017/05/05 15:39:14 ET
Table '1597684008 5' 6-max Seat #4 is the button
Seat 1: lilmikey321 (80870 in chips)=20
Seat 2: justin66lee (33166 in chips)=20
Seat 3: FnSmooth45 (27790 in chips)=20
Seat 4: JJin91 (64470 in chips)=20
Seat 5: DaBirds23 (31040 in chips)=20
Seat 6: STI809 (7280 in chips)=20
lilmikey321: posts the ante 70
justin66lee: posts the ante 70
FnSmooth45: posts the ante 70
JJin91: posts the ante 70
DaBirds23: posts the ante 70
STI809: posts the ante 70
DaBirds23: posts small blind 300
STI809: posts big blind 600
*** HOLE CARDS ***
Dealt to JJin91 [As 5h]
lilmikey321: calls 600
justin66lee: folds=20
FnSmooth45: folds=20
JJin91: folds=20
DaBirds23: calls 300
STI809: checks=20
*** FLOP *** [8d 9c 3d]
DaBirds23: checks=20
STI809: checks=20
lilmikey321: bets 1200
DaBirds23: folds=20
STI809: folds=20
Uncalled bet (1200) returned to lilmikey321
lilmikey321 collected 2220 from pot
lilmikey321: doesn't show hand=20
*** SUMMARY ***
Total pot 2220 | Rake 0=20
Board [8d 9c 3d]
Seat 1: lilmikey321 collected (2220)
Seat 2: justin66lee folded before Flop (didn't bet)
Seat 3: FnSmooth45 folded before Flop (didn't bet)
Seat 4: JJin91 (button) folded before Flop (didn't bet)
Seat 5: DaBirds23 (small blind) folded on the Flop
Seat 6: STI809 (big blind) folded on the Flop


*********** # 178 **************
PokerStars Hand #169427456639: Tournament #1597684008, $13.50+$1.50 USD=
 Hold'em No Limit - Level XII (300/600) - 2017/05/05 15:40:14 ET
Table '1597684008 5' 6-max Seat #5 is the button
Seat 1: lilmikey321 (82420 in chips)=20
Seat 2: justin66lee (33096 in chips)=20
Seat 3: FnSmooth45 (27720 in chips)=20
Seat 4: JJin91 (64400 in chips)=20
Seat 5: DaBirds23 (30370 in chips)=20
Seat 6: STI809 (6610 in chips)=20
lilmikey321: posts the ante 70
justin66lee: posts the ante 70
FnSmooth45: posts the ante 70
JJin91: posts the ante 70
DaBirds23: posts the ante 70
STI809: posts the ante 70
STI809: posts small blind 300
lilmikey321: posts big blind 600
*** HOLE CARDS ***
Dealt to JJin91 [7s 3h]
justin66lee: folds=20
FnSmooth45: folds=20
JJin91: folds=20
DaBirds23: folds=20
STI809: folds=20
Uncalled bet (300) returned to lilmikey321
lilmikey321 collected 1020 from pot
lilmikey321: doesn't show hand=20
*** SUMMARY ***
Total pot 1020 | Rake 0=20
Seat 1: lilmikey321 (big blind) collected (1020)
Seat 2: justin66lee folded before Flop (didn't bet)
Seat 3: FnSmooth45 folded before Flop (didn't bet)
Seat 4: JJin91 folded before Flop (didn't bet)
Seat 5: DaBirds23 (button) folded before Flop (didn't bet)
Seat 6: STI809 (small blind) folded before Flop


*********** # 179 **************
PokerStars Hand #169427456719: Tournament #1597684008, $13.50+$1.50 USD=
 Hold'em No Limit - Level XII (300/600) - 2017/05/05 15:40:44 ET
Table '1597684008 5' 6-max Seat #6 is the button
Seat 1: lilmikey321 (83070 in chips)=20
Seat 2: justin66lee (33026 in chips)=20
Seat 3: FnSmooth45 (27650 in chips)=20
Seat 4: JJin91 (64330 in chips)=20
Seat 5: DaBirds23 (30300 in chips)=20
Seat 6: STI809 (6240 in chips)=20
lilmikey321: posts the ante 70
justin66lee: posts the ante 70
FnSmooth45: posts the ante 70
JJin91: posts the ante 70
DaBirds23: posts the ante 70
STI809: posts the ante 70
lilmikey321: posts small blind 300
justin66lee: posts big blind 600
*** HOLE CARDS ***
Dealt to JJin91 [9d 6d]
FnSmooth45: raises 1200 to 1800
JJin91: folds=20
DaBirds23: folds=20
STI809: folds=20
lilmikey321: folds=20
justin66lee: folds=20
Uncalled bet (1200) returned to FnSmooth45
FnSmooth45 collected 1920 from pot
FnSmooth45: doesn't show hand=20
*** SUMMARY ***
Total pot 1920 | Rake 0=20
Seat 1: lilmikey321 (small blind) folded before Flop
Seat 2: justin66lee (big blind) folded before Flop
Seat 3: FnSmooth45 collected (1920)
Seat 4: JJin91 folded before Flop (didn't bet)
Seat 5: DaBirds23 folded before Flop (didn't bet)
Seat 6: STI809 (button) folded before Flop (didn't bet)


*********** # 180 **************
PokerStars Hand #169427456781: Tournament #1597684008, $13.50+$1.50 USD=
 Hold'em No Limit - Level XII (300/600) - 2017/05/05 15:41:06 ET
Table '1597684008 5' 6-max Seat #1 is the button
Seat 1: lilmikey321 (82700 in chips)=20
Seat 2: justin66lee (32356 in chips)=20
Seat 3: FnSmooth45 (28900 in chips)=20
Seat 4: JJin91 (64260 in chips)=20
Seat 5: DaBirds23 (30230 in chips)=20
Seat 6: STI809 (6170 in chips)=20
lilmikey321: posts the ante 70
justin66lee: posts the ante 70
FnSmooth45: posts the ante 70
JJin91: posts the ante 70
DaBirds23: posts the ante 70
STI809: posts the ante 70
justin66lee: posts small blind 300
FnSmooth45: posts big blind 600
*** HOLE CARDS ***
Dealt to JJin91 [7d 4c]
JJin91: folds=20
DaBirds23: folds=20
STI809: folds=20
lilmikey321: folds=20
justin66lee: raises 600 to 1200
FnSmooth45: calls 600
*** FLOP *** [6c Qh 2c]
justin66lee: bets 1200
FnSmooth45: folds=20
Uncalled bet (1200) returned to justin66lee
justin66lee collected 2820 from pot
justin66lee: doesn't show hand=20
*** SUMMARY ***
Total pot 2820 | Rake 0=20
Board [6c Qh 2c]
Seat 1: lilmikey321 (button) folded before Flop (didn't bet)
Seat 2: justin66lee (small blind) collected (2820)
Seat 3: FnSmooth45 (big blind) folded on the Flop
Seat 4: JJin91 folded before Flop (didn't bet)
Seat 5: DaBirds23 folded before Flop (didn't bet)
Seat 6: STI809 folded before Flop (didn't bet)


*********** # 181 **************
PokerStars Hand #169427456851: Tournament #1597684008, $13.50+$1.50 USD=
 Hold'em No Limit - Level XII (300/600) - 2017/05/05 15:41:35 ET
Table '1597684008 5' 6-max Seat #2 is the button
Seat 1: lilmikey321 (82630 in chips)=20
Seat 2: justin66lee (33906 in chips)=20
Seat 3: FnSmooth45 (27630 in chips)=20
Seat 4: JJin91 (64190 in chips)=20
Seat 5: DaBirds23 (30160 in chips)=20
Seat 6: STI809 (6100 in chips)=20
lilmikey321: posts the ante 70
justin66lee: posts the ante 70
FnSmooth45: posts the ante 70
JJin91: posts the ante 70
DaBirds23: posts the ante 70
STI809: posts the ante 70
FnSmooth45: posts small blind 300
JJin91: posts big blind 600
*** HOLE CARDS ***
Dealt to JJin91 [8h 2d]
DaBirds23: folds=20
STI809: calls 600
lilmikey321: calls 600
justin66lee: folds=20
FnSmooth45: calls 300
JJin91: checks=20
*** FLOP *** [Ad 4d 6c]
FnSmooth45: checks=20
JJin91: checks=20
STI809: bets 5430 and is all-in
lilmikey321: folds=20
FnSmooth45: calls 5430
JJin91: folds=20
*** TURN *** [Ad 4d 6c] [2s]
*** RIVER *** [Ad 4d 6c 2s] [Jc]
*** SHOW DOWN ***
FnSmooth45: shows [Js As] (two pair, Aces and Jacks)
STI809: shows [6d 7d] (a pair of Sixes)
FnSmooth45 collected 13680 from pot
STI809 finished the tournament in 34th place
*** SUMMARY ***
Total pot 13680 | Rake 0=20
Board [Ad 4d 6c 2s Jc]
Seat 1: lilmikey321 folded on the Flop
Seat 2: justin66lee (button) folded before Flop (didn't bet)
Seat 3: FnSmooth45 (small blind) showed [Js As] and won (13680) with tw=
o pair, Aces and Jacks
Seat 4: JJin91 (big blind) folded on the Flop
Seat 5: DaBirds23 folded before Flop (didn't bet)
Seat 6: STI809 showed [6d 7d] and lost with a pair of Sixes


*********** # 182 **************
PokerStars Hand #169427456986: Tournament #1597684008, $13.50+$1.50 USD=
 Hold'em No Limit - Level XIII (350/700) - 2017/05/05 15:42:26 ET
Table '1597684008 5' 6-max Seat #3 is the button
Seat 1: lilmikey321 (81960 in chips)=20
Seat 2: justin66lee (33836 in chips)=20
Seat 3: FnSmooth45 (35210 in chips)=20
Seat 4: JJin91 (63520 in chips)=20
Seat 5: DaBirds23 (30090 in chips)=20
lilmikey321: posts the ante 85
justin66lee: posts the ante 85
FnSmooth45: posts the ante 85
JJin91: posts the ante 85
DaBirds23: posts the ante 85
JJin91: posts small blind 350
DaBirds23: posts big blind 700
*** HOLE CARDS ***
Dealt to JJin91 [6s 2c]
lilmikey321: calls 700
justin66lee: folds=20
FnSmooth45: calls 700
JJin91: folds=20
DaBirds23: checks=20
*** FLOP *** [Ts Kd Jh]
DaBirds23: checks=20
lilmikey321: bets 700
FnSmooth45: calls 700
DaBirds23: folds=20
*** TURN *** [Ts Kd Jh] [8d]
lilmikey321: bets 2100
FnSmooth45: folds=20
Uncalled bet (2100) returned to lilmikey321
lilmikey321 collected 4275 from pot
lilmikey321: doesn't show hand=20
*** SUMMARY ***
Total pot 4275 | Rake 0=20
Board [Ts Kd Jh 8d]
Seat 1: lilmikey321 collected (4275)
Seat 2: justin66lee folded before Flop (didn't bet)
Seat 3: FnSmooth45 (button) folded on the Turn
Seat 4: JJin91 (small blind) folded before Flop
Seat 5: DaBirds23 (big blind) folded on the Flop


*********** # 183 **************
PokerStars Hand #169427457091: Tournament #1597684008, $13.50+$1.50 USD=
 Hold'em No Limit - Level XIII (350/700) - 2017/05/05 15:43:01 ET
Table '1597684008 5' 6-max Seat #4 is the button
Seat 1: lilmikey321 (84750 in chips)=20
Seat 2: justin66lee (33751 in chips)=20
Seat 3: FnSmooth45 (33725 in chips)=20
Seat 4: JJin91 (63085 in chips)=20
Seat 5: DaBirds23 (29305 in chips)=20
lilmikey321: posts the ante 85
justin66lee: posts the ante 85
FnSmooth45: posts the ante 85
JJin91: posts the ante 85
DaBirds23: posts the ante 85
DaBirds23: posts small blind 350
lilmikey321: posts big blind 700
*** HOLE CARDS ***
Dealt to JJin91 [Kd Qh]
justin66lee: folds=20
FnSmooth45: raises 1400 to 2100
JJin91: folds=20
DaBirds23: folds=20
lilmikey321: folds=20
Uncalled bet (1400) returned to FnSmooth45
FnSmooth45 collected 2175 from pot
FnSmooth45: doesn't show hand=20
*** SUMMARY ***
Total pot 2175 | Rake 0=20
Seat 1: lilmikey321 (big blind) folded before Flop
Seat 2: justin66lee folded before Flop (didn't bet)
Seat 3: FnSmooth45 collected (2175)
Seat 4: JJin91 (button) folded before Flop (didn't bet)
Seat 5: DaBirds23 (small blind) folded before Flop


*********** # 184 **************
PokerStars Hand #169427457141: Tournament #1597684008, $13.50+$1.50 USD=
 Hold'em No Limit - Level XIII (350/700) - 2017/05/05 15:43:22 ET
Table '1597684008 5' 6-max Seat #5 is the button
Seat 1: lilmikey321 (83965 in chips)=20
Seat 2: justin66lee (33666 in chips)=20
Seat 3: FnSmooth45 (35115 in chips)=20
Seat 4: JJin91 (63000 in chips)=20
Seat 5: DaBirds23 (28870 in chips)=20
lilmikey321: posts the ante 85
justin66lee: posts the ante 85
FnSmooth45: posts the ante 85
JJin91: posts the ante 85
DaBirds23: posts the ante 85
lilmikey321: posts small blind 350
justin66lee: posts big blind 700
*** HOLE CARDS ***
Dealt to JJin91 [2h Tc]
FnSmooth45: folds=20
JJin91: folds=20
DaBirds23: folds=20
lilmikey321: raises 700 to 1400
justin66lee: calls 700
*** FLOP *** [Jd 7s Jh]
lilmikey321: bets 2100
justin66lee: folds=20
Uncalled bet (2100) returned to lilmikey321
lilmikey321 collected 3225 from pot
lilmikey321: doesn't show hand=20
*** SUMMARY ***
Total pot 3225 | Rake 0=20
Board [Jd 7s Jh]
Seat 1: lilmikey321 (small blind) collected (3225)
Seat 2: justin66lee (big blind) folded on the Flop
Seat 3: FnSmooth45 folded before Flop (didn't bet)
Seat 4: JJin91 folded before Flop (didn't bet)
Seat 5: DaBirds23 (button) folded before Flop (didn't bet)


*********** # 185 **************
PokerStars Hand #169427457206: Tournament #1597684008, $13.50+$1.50 USD=
 Hold'em No Limit - Level XIII (350/700) - 2017/05/05 15:43:50 ET
Table '1597684008 5' 6-max Seat #1 is the button
Seat 1: lilmikey321 (85705 in chips)=20
Seat 2: justin66lee (32181 in chips)=20
Seat 3: FnSmooth45 (35030 in chips)=20
Seat 4: JJin91 (62915 in chips)=20
Seat 5: DaBirds23 (28785 in chips)=20
lilmikey321: posts the ante 85
justin66lee: posts the ante 85
FnSmooth45: posts the ante 85
JJin91: posts the ante 85
DaBirds23: posts the ante 85
justin66lee: posts small blind 350
FnSmooth45: posts big blind 700
*** HOLE CARDS ***
Dealt to JJin91 [3d Qh]
JJin91: folds=20
DaBirds23: raises 700 to 1400
lilmikey321: calls 1400
justin66lee: calls 1050
FnSmooth45: folds=20
*** FLOP *** [7s 6s 7h]
justin66lee: checks=20
DaBirds23: bets 1917
lilmikey321: folds=20
justin66lee: folds=20
Uncalled bet (1917) returned to DaBirds23
DaBirds23 collected 5325 from pot
*** SUMMARY ***
Total pot 5325 | Rake 0=20
Board [7s 6s 7h]
Seat 1: lilmikey321 (button) folded on the Flop
Seat 2: justin66lee (small blind) folded on the Flop
Seat 3: FnSmooth45 (big blind) folded before Flop
Seat 4: JJin91 folded before Flop (didn't bet)
Seat 5: DaBirds23 collected (5325)


*********** # 186 **************
PokerStars Hand #169427457264: Tournament #1597684008, $13.50+$1.50 USD=
 Hold'em No Limit - Level XIII (350/700) - 2017/05/05 15:44:15 ET
Table '1597684008 5' 6-max Seat #2 is the button
Seat 1: lilmikey321 (84220 in chips)=20
Seat 2: justin66lee (30696 in chips)=20
Seat 3: FnSmooth45 (34245 in chips)=20
Seat 4: JJin91 (62830 in chips)=20
Seat 5: DaBirds23 (32625 in chips)=20
lilmikey321: posts the ante 85
justin66lee: posts the ante 85
FnSmooth45: posts the ante 85
JJin91: posts the ante 85
DaBirds23: posts the ante 85
FnSmooth45: posts small blind 350
JJin91: posts big blind 700
*** HOLE CARDS ***
Dealt to JJin91 [2s 8d]
DaBirds23: folds=20
lilmikey321: folds=20
justin66lee: folds=20
FnSmooth45: raises 1400 to 2100
JJin91: folds=20
Uncalled bet (1400) returned to FnSmooth45
FnSmooth45 collected 1825 from pot
FnSmooth45: doesn't show hand=20
*** SUMMARY ***
Total pot 1825 | Rake 0=20
Seat 1: lilmikey321 folded before Flop (didn't bet)
Seat 2: justin66lee (button) folded before Flop (didn't bet)
Seat 3: FnSmooth45 (small blind) collected (1825)
Seat 4: JJin91 (big blind) folded before Flop
Seat 5: DaBirds23 folded before Flop (didn't bet)


*********** # 187 **************
PokerStars Hand #169427457287: Tournament #1597684008, $13.50+$1.50 USD=
 Hold'em No Limit - Level XIII (350/700) - 2017/05/05 15:44:25 ET
Table '1597684008 5' 6-max Seat #3 is the button
Seat 1: lilmikey321 (84135 in chips)=20
Seat 2: justin66lee (30611 in chips)=20
Seat 3: FnSmooth45 (35285 in chips)=20
Seat 4: JJin91 (62045 in chips)=20
Seat 5: DaBirds23 (32540 in chips)=20
lilmikey321: posts the ante 85
justin66lee: posts the ante 85
FnSmooth45: posts the ante 85
JJin91: posts the ante 85
DaBirds23: posts the ante 85
JJin91: posts small blind 350
DaBirds23: posts big blind 700
*** HOLE CARDS ***
Dealt to JJin91 [6d 3h]
lilmikey321: raises 1400 to 2100
justin66lee: folds=20
FnSmooth45: folds=20
JJin91: folds=20
DaBirds23: folds=20
Uncalled bet (1400) returned to lilmikey321
lilmikey321 collected 2175 from pot
lilmikey321: doesn't show hand=20
*** SUMMARY ***
Total pot 2175 | Rake 0=20
Seat 1: lilmikey321 collected (2175)
Seat 2: justin66lee folded before Flop (didn't bet)
Seat 3: FnSmooth45 (button) folded before Flop (didn't bet)
Seat 4: JJin91 (small blind) folded before Flop
Seat 5: DaBirds23 (big blind) folded before Flop


*********** # 188 **************
PokerStars Hand #169427457312: Tournament #1597684008, $13.50+$1.50 USD=
 Hold'em No Limit - Level XIII (350/700) - 2017/05/05 15:44:36 ET
Table '1597684008 5' 6-max Seat #4 is the button
Seat 1: lilmikey321 (85525 in chips)=20
Seat 2: justin66lee (30526 in chips)=20
Seat 3: FnSmooth45 (35200 in chips)=20
Seat 4: JJin91 (61610 in chips)=20
Seat 5: DaBirds23 (31755 in chips)=20
lilmikey321: posts the ante 85
justin66lee: posts the ante 85
FnSmooth45: posts the ante 85
JJin91: posts the ante 85
DaBirds23: posts the ante 85
DaBirds23: posts small blind 350
lilmikey321: posts big blind 700
*** HOLE CARDS ***
Dealt to JJin91 [8s Ac]
justin66lee: folds=20
FnSmooth45: folds=20
JJin91: raises 924 to 1624
DaBirds23: folds=20
lilmikey321: calls 924
*** FLOP *** [Qs 4c Qc]
lilmikey321: checks=20
JJin91: checks=20
*** TURN *** [Qs 4c Qc] [7s]
lilmikey321: bets 4200
JJin91: folds=20
Uncalled bet (4200) returned to lilmikey321
lilmikey321 collected 4023 from pot
lilmikey321: doesn't show hand=20
*** SUMMARY ***
Total pot 4023 | Rake 0=20
Board [Qs 4c Qc 7s]
Seat 1: lilmikey321 (big blind) collected (4023)
Seat 2: justin66lee folded before Flop (didn't bet)
Seat 3: FnSmooth45 folded before Flop (didn't bet)
Seat 4: JJin91 (button) folded on the Turn
Seat 5: DaBirds23 (small blind) folded before Flop


*********** # 189 **************
PokerStars Hand #169427457406: Tournament #1597684008, $13.50+$1.50 USD=
 Hold'em No Limit - Level XIII (350/700) - 2017/05/05 15:45:15 ET
Table '1597684008 5' 6-max Seat #5 is the button
Seat 1: lilmikey321 (87839 in chips)=20
Seat 2: justin66lee (30441 in chips)=20
Seat 3: FnSmooth45 (35115 in chips)=20
Seat 4: JJin91 (59901 in chips)=20
Seat 5: DaBirds23 (31320 in chips)=20
lilmikey321: posts the ante 85
justin66lee: posts the ante 85
FnSmooth45: posts the ante 85
JJin91: posts the ante 85
DaBirds23: posts the ante 85
lilmikey321: posts small blind 350
justin66lee: posts big blind 700
*** HOLE CARDS ***
Dealt to JJin91 [9d 7d]
FnSmooth45: raises 1400 to 2100
JJin91: folds=20
DaBirds23: folds=20
lilmikey321: calls 1750
justin66lee: folds=20
*** FLOP *** [Kh 6c Qd]
lilmikey321: checks=20
FnSmooth45: bets 2800
lilmikey321: raises 82854 to 85654 and is all-in
FnSmooth45: folds=20
Uncalled bet (82854) returned to lilmikey321
lilmikey321 collected 10925 from pot
lilmikey321: doesn't show hand=20
*** SUMMARY ***
Total pot 10925 | Rake 0=20
Board [Kh 6c Qd]
Seat 1: lilmikey321 (small blind) collected (10925)
Seat 2: justin66lee (big blind) folded before Flop
Seat 3: FnSmooth45 folded on the Flop
Seat 4: JJin91 folded before Flop (didn't bet)
Seat 5: DaBirds23 (button) folded before Flop (didn't bet)


*********** # 190 **************
PokerStars Hand #169427457564: Tournament #1597684008, $13.50+$1.50 USD=
 Hold'em No Limit - Level XIII (350/700) - 2017/05/05 15:46:14 ET
Table '1597684008 5' 6-max Seat #1 is the button
Seat 1: lilmikey321 (93779 in chips)=20
Seat 2: justin66lee (29656 in chips)=20
Seat 3: FnSmooth45 (30130 in chips)=20
Seat 4: JJin91 (59816 in chips)=20
Seat 5: DaBirds23 (31235 in chips)=20
Seat 6: walnuttz (50555 in chips)=20
lilmikey321: posts the ante 85
justin66lee: posts the ante 85
FnSmooth45: posts the ante 85
JJin91: posts the ante 85
DaBirds23: posts the ante 85
walnuttz: posts the ante 85
justin66lee: posts small blind 350
FnSmooth45: posts big blind 700
*** HOLE CARDS ***
Dealt to JJin91 [2h 7c]
JJin91: folds=20
DaBirds23: folds=20
walnuttz: raises 1050 to 1750
lilmikey321: calls 1750
justin66lee: folds=20
FnSmooth45: folds=20
*** FLOP *** [Kh 8d 3c]
walnuttz: checks=20
lilmikey321: bets 2100
walnuttz: calls 2100
*** TURN *** [Kh 8d 3c] [8s]
walnuttz: checks=20
lilmikey321: bets 3500
walnuttz: folds=20
Uncalled bet (3500) returned to lilmikey321
lilmikey321 collected 9260 from pot
lilmikey321: doesn't show hand=20
*** SUMMARY ***
Total pot 9260 | Rake 0=20
Board [Kh 8d 3c 8s]
Seat 1: lilmikey321 (button) collected (9260)
Seat 2: justin66lee (small blind) folded before Flop
Seat 3: FnSmooth45 (big blind) folded before Flop
Seat 4: JJin91 folded before Flop (didn't bet)
Seat 5: DaBirds23 folded before Flop (didn't bet)
Seat 6: walnuttz folded on the Turn


*********** # 191 **************
PokerStars Hand #169427457656: Tournament #1597684008, $13.50+$1.50 USD=
 Hold'em No Limit - Level XIII (350/700) - 2017/05/05 15:46:45 ET
Table '1597684008 5' 6-max Seat #2 is the button
Seat 1: lilmikey321 (99104 in chips)=20
Seat 2: justin66lee (29221 in chips)=20
Seat 3: FnSmooth45 (29345 in chips)=20
Seat 4: JJin91 (59731 in chips)=20
Seat 5: DaBirds23 (31150 in chips)=20
Seat 6: walnuttz (46620 in chips)=20
lilmikey321: posts the ante 85
justin66lee: posts the ante 85
FnSmooth45: posts the ante 85
JJin91: posts the ante 85
DaBirds23: posts the ante 85
walnuttz: posts the ante 85
FnSmooth45: posts small blind 350
JJin91: posts big blind 700
*** HOLE CARDS ***
Dealt to JJin91 [Qd 4h]
DaBirds23: folds=20
walnuttz: folds=20
lilmikey321: raises 700 to 1400
justin66lee: folds=20
FnSmooth45: folds=20
JJin91: folds=20
Uncalled bet (700) returned to lilmikey321
lilmikey321 collected 2260 from pot
lilmikey321: doesn't show hand=20
*** SUMMARY ***
Total pot 2260 | Rake 0=20
Seat 1: lilmikey321 collected (2260)
Seat 2: justin66lee (button) folded before Flop (didn't bet)
Seat 3: FnSmooth45 (small blind) folded before Flop
Seat 4: JJin91 (big blind) folded before Flop
Seat 5: DaBirds23 folded before Flop (didn't bet)
Seat 6: walnuttz folded before Flop (didn't bet)


*********** # 192 **************
PokerStars Hand #169427457700: Tournament #1597684008, $13.50+$1.50 USD=
 Hold'em No Limit - Level XIII (350/700) - 2017/05/05 15:47:00 ET
Table '1597684008 5' 6-max Seat #3 is the button
Seat 1: lilmikey321 (100579 in chips)=20
Seat 2: justin66lee (29136 in chips)=20
Seat 3: FnSmooth45 (28910 in chips)=20
Seat 4: JJin91 (58946 in chips)=20
Seat 5: DaBirds23 (31065 in chips)=20
Seat 6: walnuttz (46535 in chips)=20
lilmikey321: posts the ante 85
justin66lee: posts the ante 85
FnSmooth45: posts the ante 85
JJin91: posts the ante 85
DaBirds23: posts the ante 85
walnuttz: posts the ante 85
JJin91: posts small blind 350
DaBirds23: posts big blind 700
*** HOLE CARDS ***
Dealt to JJin91 [Qh 6d]
walnuttz: folds=20
lilmikey321: folds=20
justin66lee: folds=20
FnSmooth45: folds=20
JJin91: raises 952 to 1652
DaBirds23: folds=20
Uncalled bet (952) returned to JJin91
JJin91 collected 1910 from pot
*** SUMMARY ***
Total pot 1910 | Rake 0=20
Seat 1: lilmikey321 folded before Flop (didn't bet)
Seat 2: justin66lee folded before Flop (didn't bet)
Seat 3: FnSmooth45 (button) folded before Flop (didn't bet)
Seat 4: JJin91 (small blind) collected (1910)
Seat 5: DaBirds23 (big blind) folded before Flop
Seat 6: walnuttz folded before Flop (didn't bet)


*********** # 193 **************
PokerStars Hand #169427457772: Tournament #1597684008, $13.50+$1.50 USD=
 Hold'em No Limit - Level XIII (350/700) - 2017/05/05 15:47:22 ET
Table '1597684008 5' 6-max Seat #4 is the button
Seat 1: lilmikey321 (100494 in chips)=20
Seat 2: justin66lee (29051 in chips)=20
Seat 3: FnSmooth45 (28825 in chips)=20
Seat 4: JJin91 (60071 in chips)=20
Seat 5: DaBirds23 (30280 in chips)=20
Seat 6: walnuttz (46450 in chips)=20
lilmikey321: posts the ante 85
justin66lee: posts the ante 85
FnSmooth45: posts the ante 85
JJin91: posts the ante 85
DaBirds23: posts the ante 85
walnuttz: posts the ante 85
DaBirds23: posts small blind 350
walnuttz: posts big blind 700
*** HOLE CARDS ***
Dealt to JJin91 [6s 9h]
lilmikey321: calls 700
justin66lee: folds=20
FnSmooth45: folds=20
JJin91: folds=20
DaBirds23: calls 350
walnuttz: checks=20
*** FLOP *** [2h 9s 5c]
DaBirds23: checks=20
walnuttz: checks=20
lilmikey321: bets 700
DaBirds23: raises 1444 to 2144
walnuttz: folds=20
lilmikey321: calls 1444
*** TURN *** [2h 9s 5c] [Jh]
DaBirds23: bets 3380
lilmikey321: calls 3380
*** RIVER *** [2h 9s 5c Jh] [3h]
DaBirds23: bets 4917
lilmikey321: folds=20
Uncalled bet (4917) returned to DaBirds23
DaBirds23 collected 13658 from pot
*** SUMMARY ***
Total pot 13658 | Rake 0=20
Board [2h 9s 5c Jh 3h]
Seat 1: lilmikey321 folded on the River
Seat 2: justin66lee folded before Flop (didn't bet)
Seat 3: FnSmooth45 folded before Flop (didn't bet)
Seat 4: JJin91 (button) folded before Flop (didn't bet)
Seat 5: DaBirds23 (small blind) collected (13658)
Seat 6: walnuttz (big blind) folded on the Flop


*********** # 194 **************
PokerStars Hand #169427457874: Tournament #1597684008, $13.50+$1.50 USD=
 Hold'em No Limit - Level XIII (350/700) - 2017/05/05 15:48:03 ET
Table '1597684008 5' 6-max Seat #5 is the button
Seat 1: lilmikey321 (94185 in chips)=20
Seat 2: justin66lee (28966 in chips)=20
Seat 3: FnSmooth45 (28740 in chips)=20
Seat 4: JJin91 (59986 in chips)=20
Seat 5: DaBirds23 (37629 in chips)=20
Seat 6: walnuttz (45665 in chips)=20
lilmikey321: posts the ante 85
justin66lee: posts the ante 85
FnSmooth45: posts the ante 85
JJin91: posts the ante 85
DaBirds23: posts the ante 85
walnuttz: posts the ante 85
walnuttz: posts small blind 350
lilmikey321: posts big blind 700
*** HOLE CARDS ***
Dealt to JJin91 [6s Ks]
justin66lee: folds=20
FnSmooth45: folds=20
JJin91: folds=20
DaBirds23: folds=20
walnuttz: folds=20
Uncalled bet (350) returned to lilmikey321
lilmikey321 collected 1210 from pot
lilmikey321: doesn't show hand=20
*** SUMMARY ***
Total pot 1210 | Rake 0=20
Seat 1: lilmikey321 (big blind) collected (1210)
Seat 2: justin66lee folded before Flop (didn't bet)
Seat 3: FnSmooth45 folded before Flop (didn't bet)
Seat 4: JJin91 folded before Flop (didn't bet)
Seat 5: DaBirds23 (button) folded before Flop (didn't bet)
Seat 6: walnuttz (small blind) folded before Flop


*********** # 195 **************
PokerStars Hand #169427457912: Tournament #1597684008, $13.50+$1.50 USD=
 Hold'em No Limit - Level XIII (350/700) - 2017/05/05 15:48:18 ET
Table '1597684008 5' 6-max Seat #6 is the button
Seat 1: lilmikey321 (94960 in chips)=20
Seat 2: justin66lee (28881 in chips)=20
Seat 3: FnSmooth45 (28655 in chips)=20
Seat 4: JJin91 (59901 in chips)=20
Seat 5: DaBirds23 (37544 in chips)=20
Seat 6: walnuttz (45230 in chips)=20
lilmikey321: posts the ante 85
justin66lee: posts the ante 85
FnSmooth45: posts the ante 85
JJin91: posts the ante 85
DaBirds23: posts the ante 85
walnuttz: posts the ante 85
lilmikey321: posts small blind 350
justin66lee: posts big blind 700
*** HOLE CARDS ***
Dealt to JJin91 [Th Qc]
FnSmooth45: folds=20
JJin91: folds=20
DaBirds23: folds=20
walnuttz: folds=20
lilmikey321: raises 700 to 1400
justin66lee: calls 700
*** FLOP *** [9d Td 6c]
lilmikey321: bets 1400
justin66lee: calls 1400
*** TURN *** [9d Td 6c] [Kh]
lilmikey321: checks=20
justin66lee: bets 2100
lilmikey321: calls 2100
*** RIVER *** [9d Td 6c Kh] [7d]
lilmikey321: checks=20
justin66lee: checks=20
*** SHOW DOWN ***
lilmikey321: shows [Ah 7s] (a pair of Sevens)
justin66lee: shows [Qs 9s] (a pair of Nines)
justin66lee collected 10310 from pot
*** SUMMARY ***
Total pot 10310 | Rake 0=20
Board [9d Td 6c Kh 7d]
Seat 1: lilmikey321 (small blind) showed [Ah 7s] and lost with a pair o=
f Sevens
Seat 2: justin66lee (big blind) showed [Qs 9s] and won (10310) with a p=
air of Nines
Seat 3: FnSmooth45 folded before Flop (didn't bet)
Seat 4: JJin91 folded before Flop (didn't bet)
Seat 5: DaBirds23 folded before Flop (didn't bet)
Seat 6: walnuttz (button) folded before Flop (didn't bet)


*********** # 196 **************
PokerStars Hand #169427457984: Tournament #1597684008, $13.50+$1.50 USD=
 Hold'em No Limit - Level XIII (350/700) - 2017/05/05 15:48:45 ET
Table '1597684008 5' 6-max Seat #1 is the button
Seat 1: lilmikey321 (89975 in chips)=20
Seat 2: justin66lee (34206 in chips)=20
Seat 3: FnSmooth45 (28570 in chips)=20
Seat 4: JJin91 (59816 in chips)=20
Seat 5: DaBirds23 (37459 in chips)=20
Seat 6: walnuttz (45145 in chips)=20
lilmikey321: posts the ante 85
justin66lee: posts the ante 85
FnSmooth45: posts the ante 85
JJin91: posts the ante 85
DaBirds23: posts the ante 85
walnuttz: posts the ante 85
justin66lee: posts small blind 350
FnSmooth45: posts big blind 700
*** HOLE CARDS ***
Dealt to JJin91 [8d 9c]
JJin91: folds=20
DaBirds23: folds=20
walnuttz: folds=20
lilmikey321: folds=20
justin66lee: folds=20
Uncalled bet (350) returned to FnSmooth45
FnSmooth45 collected 1210 from pot
FnSmooth45: doesn't show hand=20
*** SUMMARY ***
Total pot 1210 | Rake 0=20
Seat 1: lilmikey321 (button) folded before Flop (didn't bet)
Seat 2: justin66lee (small blind) folded before Flop
Seat 3: FnSmooth45 (big blind) collected (1210)
Seat 4: JJin91 folded before Flop (didn't bet)
Seat 5: DaBirds23 folded before Flop (didn't bet)
Seat 6: walnuttz folded before Flop (didn't bet)


*********** # 197 **************
PokerStars Hand #169427458028: Tournament #1597684008, $13.50+$1.50 USD=
 Hold'em No Limit - Level XIII (350/700) - 2017/05/05 15:49:03 ET
Table '1597684008 5' 6-max Seat #2 is the button
Seat 1: lilmikey321 (89890 in chips)=20
Seat 2: justin66lee (33771 in chips)=20
Seat 3: FnSmooth45 (29345 in chips)=20
Seat 4: JJin91 (59731 in chips)=20
Seat 5: DaBirds23 (37374 in chips)=20
Seat 6: walnuttz (45060 in chips)=20
lilmikey321: posts the ante 85
justin66lee: posts the ante 85
FnSmooth45: posts the ante 85
JJin91: posts the ante 85
DaBirds23: posts the ante 85
walnuttz: posts the ante 85
FnSmooth45: posts small blind 350
JJin91: posts big blind 700
*** HOLE CARDS ***
Dealt to JJin91 [6h Ts]
DaBirds23: folds=20
walnuttz: raises 1050 to 1750
lilmikey321: folds=20
justin66lee: folds=20
FnSmooth45: folds=20
JJin91: folds=20
Uncalled bet (1050) returned to walnuttz
walnuttz collected 2260 from pot
walnuttz: doesn't show hand=20
*** SUMMARY ***
Total pot 2260 | Rake 0=20
Seat 1: lilmikey321 folded before Flop (didn't bet)
Seat 2: justin66lee (button) folded before Flop (didn't bet)
Seat 3: FnSmooth45 (small blind) folded before Flop
Seat 4: JJin91 (big blind) folded before Flop
Seat 5: DaBirds23 folded before Flop (didn't bet)
Seat 6: walnuttz collected (2260)


*********** # 198 **************
PokerStars Hand #169427458082: Tournament #1597684008, $13.50+$1.50 USD=
 Hold'em No Limit - Level XIII (350/700) - 2017/05/05 15:49:19 ET
Table '1597684008 5' 6-max Seat #3 is the button
Seat 1: lilmikey321 (89805 in chips)=20
Seat 2: justin66lee (33686 in chips)=20
Seat 3: FnSmooth45 (28910 in chips)=20
Seat 4: JJin91 (58946 in chips)=20
Seat 5: DaBirds23 (37289 in chips)=20
Seat 6: walnuttz (46535 in chips)=20
lilmikey321: posts the ante 85
justin66lee: posts the ante 85
FnSmooth45: posts the ante 85
JJin91: posts the ante 85
DaBirds23: posts the ante 85
walnuttz: posts the ante 85
JJin91: posts small blind 350
DaBirds23: posts big blind 700
*** HOLE CARDS ***
Dealt to JJin91 [2c 9h]
walnuttz: folds=20
lilmikey321: raises 700 to 1400
justin66lee: folds=20
FnSmooth45: folds=20
JJin91: folds=20
DaBirds23: folds=20
Uncalled bet (700) returned to lilmikey321
lilmikey321 collected 2260 from pot
lilmikey321: doesn't show hand=20
*** SUMMARY ***
Total pot 2260 | Rake 0=20
Seat 1: lilmikey321 collected (2260)
Seat 2: justin66lee folded before Flop (didn't bet)
Seat 3: FnSmooth45 (button) folded before Flop (didn't bet)
Seat 4: JJin91 (small blind) folded before Flop
Seat 5: DaBirds23 (big blind) folded before Flop
Seat 6: walnuttz folded before Flop (didn't bet)


*********** # 199 **************
PokerStars Hand #169427458143: Tournament #1597684008, $13.50+$1.50 USD=
 Hold'em No Limit - Level XIII (350/700) - 2017/05/05 15:49:40 ET
Table '1597684008 5' 6-max Seat #4 is the button
Seat 1: lilmikey321 (91280 in chips)=20
Seat 2: justin66lee (33601 in chips)=20
Seat 3: FnSmooth45 (28825 in chips)=20
Seat 4: JJin91 (58511 in chips)=20
Seat 5: DaBirds23 (36504 in chips)=20
Seat 6: walnuttz (46450 in chips)=20
lilmikey321: posts the ante 85
justin66lee: posts the ante 85
FnSmooth45: posts the ante 85
JJin91: posts the ante 85
DaBirds23: posts the ante 85
walnuttz: posts the ante 85
DaBirds23: posts small blind 350
walnuttz: posts big blind 700
*** HOLE CARDS ***
Dealt to JJin91 [9s Jd]
lilmikey321: folds=20
justin66lee: folds=20
FnSmooth45: folds=20
JJin91: raises 925 to 1625
DaBirds23: raises 2576 to 4201
walnuttz: folds=20
JJin91: folds=20
Uncalled bet (2576) returned to DaBirds23
DaBirds23 collected 4460 from pot
DaBirds23: doesn't show hand=20
*** SUMMARY ***
Total pot 4460 | Rake 0=20
Seat 1: lilmikey321 folded before Flop (didn't bet)
Seat 2: justin66lee folded before Flop (didn't bet)
Seat 3: FnSmooth45 folded before Flop (didn't bet)
Seat 4: JJin91 (button) folded before Flop
Seat 5: DaBirds23 (small blind) collected (4460)
Seat 6: walnuttz (big blind) folded before Flop


*********** # 200 **************
PokerStars Hand #169427458236: Tournament #1597684008, $13.50+$1.50 USD=
 Hold'em No Limit - Level XIII (350/700) - 2017/05/05 15:50:13 ET
Table '1597684008 5' 6-max Seat #5 is the button
Seat 1: lilmikey321 (91195 in chips)=20
Seat 2: justin66lee (33516 in chips)=20
Seat 3: FnSmooth45 (28740 in chips)=20
Seat 4: JJin91 (56801 in chips)=20
Seat 5: DaBirds23 (39254 in chips)=20
Seat 6: walnuttz (45665 in chips)=20
lilmikey321: posts the ante 85
justin66lee: posts the ante 85
FnSmooth45: posts the ante 85
JJin91: posts the ante 85
DaBirds23: posts the ante 85
walnuttz: posts the ante 85
walnuttz: posts small blind 350
lilmikey321: posts big blind 700
*** HOLE CARDS ***
Dealt to JJin91 [6h Qs]
justin66lee: folds=20
FnSmooth45: folds=20
JJin91: folds=20
DaBirds23: folds=20
walnuttz: folds=20
Uncalled bet (350) returned to lilmikey321
lilmikey321 collected 1210 from pot
lilmikey321: doesn't show hand=20
*** SUMMARY ***
Total pot 1210 | Rake 0=20
Seat 1: lilmikey321 (big blind) collected (1210)
Seat 2: justin66lee folded before Flop (didn't bet)
Seat 3: FnSmooth45 folded before Flop (didn't bet)
Seat 4: JJin91 folded before Flop (didn't bet)
Seat 5: DaBirds23 (button) folded before Flop (didn't bet)
Seat 6: walnuttz (small blind) folded before Flop


*********** # 201 **************
PokerStars Hand #169427458318: Tournament #1597684008, $13.50+$1.50 USD=
 Hold'em No Limit - Level XIII (350/700) - 2017/05/05 15:50:39 ET
Table '1597684008 10' 6-max Seat #3 is the button
Seat 1: JJin91 (56716 in chips)=20
Seat 3: CHIEFKILLER4 (11290 in chips)=20
Seat 4: bvays (43270 in chips)=20
Seat 5: LarryDavid33 (11766 in chips)=20
Seat 6: pokernutt420 (63971 in chips)=20
JJin91: posts the ante 85
CHIEFKILLER4: posts the ante 85
bvays: posts the ante 85
LarryDavid33: posts the ante 85
pokernutt420: posts the ante 85
bvays: posts small blind 350
LarryDavid33: posts big blind 700
*** HOLE CARDS ***
Dealt to JJin91 [8h 4h]
pokernutt420: folds=20
JJin91: folds=20
CHIEFKILLER4: folds=20
bvays: calls 350
LarryDavid33: checks=20
*** FLOP *** [4s 2d Js]
bvays: bets 700
LarryDavid33: folds=20
Uncalled bet (700) returned to bvays
bvays collected 1825 from pot
bvays: doesn't show hand=20
*** SUMMARY ***
Total pot 1825 | Rake 0=20
Board [4s 2d Js]
Seat 1: JJin91 folded before Flop (didn't bet)
Seat 3: CHIEFKILLER4 (button) folded before Flop (didn't bet)
Seat 4: bvays (small blind) collected (1825)
Seat 5: LarryDavid33 (big blind) folded on the Flop
Seat 6: pokernutt420 folded before Flop (didn't bet)


*********** # 202 **************
PokerStars Hand #169427458409: Tournament #1597684008, $13.50+$1.50 USD=
 Hold'em No Limit - Level XIII (350/700) - 2017/05/05 15:51:06 ET
Table '1597684008 10' 6-max Seat #4 is the button
Seat 1: JJin91 (56631 in chips)=20
Seat 3: CHIEFKILLER4 (11205 in chips)=20
Seat 4: bvays (44310 in chips)=20
Seat 5: LarryDavid33 (10981 in chips)=20
Seat 6: pokernutt420 (63886 in chips)=20
JJin91: posts the ante 85
CHIEFKILLER4: posts the ante 85
bvays: posts the ante 85
LarryDavid33: posts the ante 85
pokernutt420: posts the ante 85
LarryDavid33: posts small blind 350
pokernutt420: posts big blind 700
*** HOLE CARDS ***
Dealt to JJin91 [Qd As]
JJin91: raises 1025 to 1725
CHIEFKILLER4: folds=20
bvays: folds=20
LarryDavid33: folds=20
pokernutt420: calls 1025
*** FLOP *** [6s Ts 4c]
pokernutt420: bets 1400
JJin91: raises 2452 to 3852
pokernutt420: calls 2452
*** TURN *** [6s Ts 4c] [9h]
pokernutt420: checks=20
JJin91: bets 7125
pokernutt420: calls 7125
*** RIVER *** [6s Ts 4c 9h] [5s]
pokernutt420: checks=20
JJin91: bets 13688
pokernutt420: folds=20
Uncalled bet (13688) returned to JJin91
JJin91 collected 26179 from pot
*** SUMMARY ***
Total pot 26179 | Rake 0=20
Board [6s Ts 4c 9h 5s]
Seat 1: JJin91 collected (26179)
Seat 3: CHIEFKILLER4 folded before Flop (didn't bet)
Seat 4: bvays (button) folded before Flop (didn't bet)
Seat 5: LarryDavid33 (small blind) folded before Flop
Seat 6: pokernutt420 (big blind) folded on the River


*********** # 203 **************
PokerStars Hand #169427458662: Tournament #1597684008, $13.50+$1.50 USD=
 Hold'em No Limit - Level XIV (400/800) - 2017/05/05 15:52:30 ET
Table '1597684008 10' 6-max Seat #5 is the button
Seat 1: JJin91 (70023 in chips)=20
Seat 2: jbodey52 (36091 in chips)=20
Seat 3: CHIEFKILLER4 (11120 in chips)=20
Seat 4: bvays (44225 in chips)=20
Seat 5: LarryDavid33 (10546 in chips)=20
Seat 6: pokernutt420 (51099 in chips)=20
JJin91: posts the ante 100
jbodey52: posts the ante 100
CHIEFKILLER4: posts the ante 100
bvays: posts the ante 100
LarryDavid33: posts the ante 100
pokernutt420: posts the ante 100
pokernutt420: posts small blind 400
JJin91: posts big blind 800
*** HOLE CARDS ***
Dealt to JJin91 [6h 6c]
jbodey52: folds=20
CHIEFKILLER4: folds=20
bvays: raises 800 to 1600
LarryDavid33: folds=20
pokernutt420: calls 1200
JJin91: calls 800
*** FLOP *** [Qc 2c 2d]
pokernutt420: checks=20
JJin91: checks=20
bvays: checks=20
*** TURN *** [Qc 2c 2d] [4c]
pokernutt420: checks=20
JJin91: checks=20
bvays: bets 2400
pokernutt420: folds=20
JJin91: calls 2400
*** RIVER *** [Qc 2c 2d 4c] [2h]
JJin91: checks=20
bvays: bets 4480
JJin91: calls 4480
*** SHOW DOWN ***
bvays: shows [Kc Qd] (a full house, Deuces full of Queens)
JJin91: mucks hand=20
bvays collected 19160 from pot
*** SUMMARY ***
Total pot 19160 | Rake 0=20
Board [Qc 2c 2d 4c 2h]
Seat 1: JJin91 (big blind) mucked [6h 6c]
Seat 2: jbodey52 folded before Flop (didn't bet)
Seat 3: CHIEFKILLER4 folded before Flop (didn't bet)
Seat 4: bvays showed [Kc Qd] and won (19160) with a full house, Deuces =
full of Queens
Seat 5: LarryDavid33 (button) folded before Flop (didn't bet)
Seat 6: pokernutt420 (small blind) folded on the Turn


*********** # 204 **************
PokerStars Hand #169427458864: Tournament #1597684008, $13.50+$1.50 USD=
 Hold'em No Limit - Level XIV (400/800) - 2017/05/05 15:53:40 ET
Table '1597684008 10' 6-max Seat #6 is the button
Seat 1: JJin91 (61443 in chips)=20
Seat 2: jbodey52 (35991 in chips)=20
Seat 3: CHIEFKILLER4 (11020 in chips)=20
Seat 4: bvays (54805 in chips)=20
Seat 5: LarryDavid33 (10446 in chips)=20
Seat 6: pokernutt420 (49399 in chips)=20
JJin91: posts the ante 100
jbodey52: posts the ante 100
CHIEFKILLER4: posts the ante 100
bvays: posts the ante 100
LarryDavid33: posts the ante 100
pokernutt420: posts the ante 100
JJin91: posts small blind 400
jbodey52: posts big blind 800
*** HOLE CARDS ***
Dealt to JJin91 [2c 7d]
CHIEFKILLER4: folds=20
bvays: folds=20
LarryDavid33: raises 9546 to 10346 and is all-in
pokernutt420: raises 38953 to 49299 and is all-in
JJin91: folds=20
jbodey52: folds=20
Uncalled bet (38953) returned to pokernutt420
*** FLOP *** [9c Jc 4h]
*** TURN *** [9c Jc 4h] [2s]
*** RIVER *** [9c Jc 4h 2s] [Td]
*** SHOW DOWN ***
LarryDavid33: shows [6s 5s] (high card Jack)
pokernutt420: shows [8h 8c] (a pair of Eights)
pokernutt420 collected 22492 from pot
LarryDavid33 finished the tournament in 23rd place
*** SUMMARY ***
Total pot 22492 | Rake 0=20
Board [9c Jc 4h 2s Td]
Seat 1: JJin91 (small blind) folded before Flop
Seat 2: jbodey52 (big blind) folded before Flop
Seat 3: CHIEFKILLER4 folded before Flop (didn't bet)
Seat 4: bvays folded before Flop (didn't bet)
Seat 5: LarryDavid33 showed [6s 5s] and lost with high card Jack
Seat 6: pokernutt420 (button) showed [8h 8c] and won (22492) with a pai=
r of Eights


*********** # 205 **************
PokerStars Hand #169427458990: Tournament #1597684008, $13.50+$1.50 USD=
 Hold'em No Limit - Level XIV (400/800) - 2017/05/05 15:54:17 ET
Table '1597684008 10' 6-max Seat #1 is the button
Seat 1: JJin91 (60943 in chips)=20
Seat 2: jbodey52 (35091 in chips)=20
Seat 3: CHIEFKILLER4 (10920 in chips)=20
Seat 4: bvays (54705 in chips)=20
Seat 6: pokernutt420 (61445 in chips)=20
JJin91: posts the ante 100
jbodey52: posts the ante 100
CHIEFKILLER4: posts the ante 100
bvays: posts the ante 100
pokernutt420: posts the ante 100
jbodey52: posts small blind 400
CHIEFKILLER4: posts big blind 800
*** HOLE CARDS ***
Dealt to JJin91 [Ac Kd]
bvays: raises 1000 to 1800
pokernutt420: folds=20
JJin91: calls 1800
jbodey52: folds=20
CHIEFKILLER4: calls 1000
*** FLOP *** [Jh Th 3d]
CHIEFKILLER4: checks=20
bvays: bets 2400
JJin91: calls 2400
CHIEFKILLER4: raises 6620 to 9020 and is all-in
bvays: folds=20
JJin91: calls 6620
*** TURN *** [Jh Th 3d] [9d]
*** RIVER *** [Jh Th 3d 9d] [3c]
*** SHOW DOWN ***
CHIEFKILLER4: shows [Jc Qs] (two pair, Jacks and Threes)
JJin91: shows [Ac Kd] (a pair of Threes)
CHIEFKILLER4 collected 26740 from pot
*** SUMMARY ***
Total pot 26740 | Rake 0=20
Board [Jh Th 3d 9d 3c]
Seat 1: JJin91 (button) showed [Ac Kd] and lost with a pair of Threes
Seat 2: jbodey52 (small blind) folded before Flop
Seat 3: CHIEFKILLER4 (big blind) showed [Jc Qs] and won (26740) with tw=
o pair, Jacks and Threes
Seat 4: bvays folded on the Flop
Seat 6: pokernutt420 folded before Flop (didn't bet)


*********** # 206 **************
PokerStars Hand #169427870202: Tournament #1597684008, $13.50+$1.50 USD=
 Hold'em No Limit - Level XIV (400/800) - 2017/05/05 16:00:51 ET
Table '1597684008 10' 6-max Seat #2 is the button
Seat 1: JJin91 (50023 in chips)=20
Seat 2: jbodey52 (34591 in chips)=20
Seat 3: CHIEFKILLER4 (26740 in chips)=20
Seat 4: bvays (50405 in chips)=20
Seat 6: pokernutt420 (61345 in chips)=20
JJin91: posts the ante 100
jbodey52: posts the ante 100
CHIEFKILLER4: posts the ante 100
bvays: posts the ante 100
pokernutt420: posts the ante 100
CHIEFKILLER4: posts small blind 400
bvays: posts big blind 800
*** HOLE CARDS ***
Dealt to JJin91 [9h Qd]
pokernutt420: folds=20
JJin91: raises 1600 to 2400
jbodey52: folds=20
CHIEFKILLER4: folds=20
bvays has timed out while disconnected
bvays: folds=20
Uncalled bet (1600) returned to JJin91
bvays is sitting out
JJin91 collected 2500 from pot
bvays has returned
*** SUMMARY ***
Total pot 2500 | Rake 0=20
Seat 1: JJin91 collected (2500)
Seat 2: jbodey52 (button) folded before Flop (didn't bet)
Seat 3: CHIEFKILLER4 (small blind) folded before Flop
Seat 4: bvays (big blind) folded before Flop
Seat 6: pokernutt420 folded before Flop (didn't bet)


*********** # 207 **************
PokerStars Hand #169427870317: Tournament #1597684008, $13.50+$1.50 USD=
 Hold'em No Limit - Level XIV (400/800) - 2017/05/05 16:01:32 ET
Table '1597684008 10' 6-max Seat #3 is the button
Seat 1: JJin91 (51623 in chips)=20
Seat 2: jbodey52 (34491 in chips)=20
Seat 3: CHIEFKILLER4 (26240 in chips)=20
Seat 4: bvays (49505 in chips)=20
Seat 6: pokernutt420 (61245 in chips)=20
JJin91: posts the ante 100
jbodey52: posts the ante 100
CHIEFKILLER4: posts the ante 100
bvays: posts the ante 100
pokernutt420: posts the ante 100
bvays: posts small blind 400
pokernutt420: posts big blind 800
*** HOLE CARDS ***
Dealt to JJin91 [3d 5c]
JJin91: folds=20
jbodey52: folds=20
CHIEFKILLER4: folds=20
bvays: calls 400
pokernutt420: checks=20
*** FLOP *** [2h 3h Ad]
bvays: bets 800
pokernutt420: calls 800
*** TURN *** [2h 3h Ad] [Jd]
bvays: bets 1800
pokernutt420: raises 1800 to 3600
bvays: raises 5200 to 8800
pokernutt420: folds=20
Uncalled bet (5200) returned to bvays
bvays collected 10900 from pot
bvays: doesn't show hand=20
*** SUMMARY ***
Total pot 10900 | Rake 0=20
Board [2h 3h Ad Jd]
Seat 1: JJin91 folded before Flop (didn't bet)
Seat 2: jbodey52 folded before Flop (didn't bet)
Seat 3: CHIEFKILLER4 (button) folded before Flop (didn't bet)
Seat 4: bvays (small blind) collected (10900)
Seat 6: pokernutt420 (big blind) folded on the Turn


*********** # 208 **************
PokerStars Hand #169427870511: Tournament #1597684008, $13.50+$1.50 USD=
 Hold'em No Limit - Level XIV (400/800) - 2017/05/05 16:02:39 ET
Table '1597684008 10' 6-max Seat #4 is the button
Seat 1: JJin91 (51523 in chips)=20
Seat 2: jbodey52 (34391 in chips)=20
Seat 3: CHIEFKILLER4 (26140 in chips)=20
Seat 4: bvays (55105 in chips)=20
Seat 6: pokernutt420 (55945 in chips)=20
JJin91: posts the ante 100
jbodey52: posts the ante 100
CHIEFKILLER4: posts the ante 100
bvays: posts the ante 100
pokernutt420: posts the ante 100
pokernutt420: posts small blind 400
JJin91: posts big blind 800
*** HOLE CARDS ***
Dealt to JJin91 [Ks Qh]
jbodey52: folds=20
CHIEFKILLER4: folds=20
bvays: folds=20
pokernutt420: folds=20
Uncalled bet (400) returned to JJin91
JJin91 collected 1300 from pot
*** SUMMARY ***
Total pot 1300 | Rake 0=20
Seat 1: JJin91 (big blind) collected (1300)
Seat 2: jbodey52 folded before Flop (didn't bet)
Seat 3: CHIEFKILLER4 folded before Flop (didn't bet)
Seat 4: bvays (button) folded before Flop (didn't bet)
Seat 6: pokernutt420 (small blind) folded before Flop


*********** # 209 **************
PokerStars Hand #169427870591: Tournament #1597684008, $13.50+$1.50 USD=
 Hold'em No Limit - Level XIV (400/800) - 2017/05/05 16:03:01 ET
Table '1597684008 10' 6-max Seat #6 is the button
Seat 1: JJin91 (52323 in chips)=20
Seat 2: jbodey52 (34291 in chips)=20
Seat 3: CHIEFKILLER4 (26040 in chips)=20
Seat 4: bvays (55005 in chips)=20
Seat 6: pokernutt420 (55445 in chips)=20
JJin91: posts the ante 100
jbodey52: posts the ante 100
CHIEFKILLER4: posts the ante 100
bvays: posts the ante 100
pokernutt420: posts the ante 100
JJin91: posts small blind 400
jbodey52: posts big blind 800
*** HOLE CARDS ***
Dealt to JJin91 [Ts 4c]
CHIEFKILLER4: folds=20
bvays: folds=20
pokernutt420: raises 800 to 1600
JJin91: folds=20
jbodey52: calls 800
*** FLOP *** [4s 3s Jc]
jbodey52: checks=20
pokernutt420: bets 2400
jbodey52: folds=20
Uncalled bet (2400) returned to pokernutt420
pokernutt420 collected 4100 from pot
pokernutt420: doesn't show hand=20
*** SUMMARY ***
Total pot 4100 | Rake 0=20
Board [4s 3s Jc]
Seat 1: JJin91 (small blind) folded before Flop
Seat 2: jbodey52 (big blind) folded on the Flop
Seat 3: CHIEFKILLER4 folded before Flop (didn't bet)
Seat 4: bvays folded before Flop (didn't bet)
Seat 6: pokernutt420 (button) collected (4100)


*********** # 210 **************
PokerStars Hand #169427870740: Tournament #1597684008, $13.50+$1.50 USD=
 Hold'em No Limit - Level XIV (400/800) - 2017/05/05 16:03:44 ET
Table '1597684008 10' 6-max Seat #1 is the button
Seat 1: JJin91 (51823 in chips)=20
Seat 2: jbodey52 (32591 in chips)=20
Seat 3: CHIEFKILLER4 (25940 in chips)=20
Seat 4: bvays (54905 in chips)=20
Seat 6: pokernutt420 (57845 in chips)=20
JJin91: posts the ante 100
jbodey52: posts the ante 100
CHIEFKILLER4: posts the ante 100
bvays: posts the ante 100
pokernutt420: posts the ante 100
jbodey52: posts small blind 400
CHIEFKILLER4: posts big blind 800
*** HOLE CARDS ***
Dealt to JJin91 [6c 6h]
bvays: raises 1000 to 1800
pokernutt420: folds=20
JJin91: calls 1800
jbodey52: raises 3199 to 4999
CHIEFKILLER4: folds=20
bvays: calls 3199
JJin91: calls 3199
*** FLOP *** [2h Ah 9s]
jbodey52: checks=20
bvays: checks=20
JJin91: checks=20
*** TURN *** [2h Ah 9s] [6d]
jbodey52: bets 5555
bvays: folds=20
JJin91: calls 5555
*** RIVER *** [2h Ah 9s 6d] [2d]
jbodey52: checks=20
JJin91: bets 41169 and is all-in
jbodey52: folds=20
Uncalled bet (41169) returned to JJin91
JJin91 collected 27407 from pot
*** SUMMARY ***
Total pot 27407 | Rake 0=20
Board [2h Ah 9s 6d 2d]
Seat 1: JJin91 (button) collected (27407)
Seat 2: jbodey52 (small blind) folded on the River
Seat 3: CHIEFKILLER4 (big blind) folded before Flop
Seat 4: bvays folded on the Turn
Seat 6: pokernutt420 folded before Flop (didn't bet)


*********** # 211 **************
PokerStars Hand #169427871036: Tournament #1597684008, $13.50+$1.50 USD=
 Hold'em No Limit - Level XIV (400/800) - 2017/05/05 16:05:21 ET
Table '1597684008 10' 6-max Seat #2 is the button
Seat 1: JJin91 (68576 in chips)=20
Seat 2: jbodey52 (21937 in chips)=20
Seat 3: CHIEFKILLER4 (25040 in chips)=20
Seat 4: bvays (49806 in chips)=20
Seat 6: pokernutt420 (57745 in chips)=20
JJin91: posts the ante 100
jbodey52: posts the ante 100
CHIEFKILLER4: posts the ante 100
bvays: posts the ante 100
pokernutt420: posts the ante 100
CHIEFKILLER4: posts small blind 400
bvays: posts big blind 800
*** HOLE CARDS ***
Dealt to JJin91 [Kh 2h]
pokernutt420: folds=20
JJin91: folds=20
jbodey52: raises 1200 to 2000
CHIEFKILLER4: calls 1600
bvays: folds=20
*** FLOP *** [4s 9h 2c]
CHIEFKILLER4: checks=20
jbodey52: bets 2650
CHIEFKILLER4: folds=20
Uncalled bet (2650) returned to jbodey52
jbodey52 collected 5300 from pot
jbodey52: doesn't show hand=20
*** SUMMARY ***
Total pot 5300 | Rake 0=20
Board [4s 9h 2c]
Seat 1: JJin91 folded before Flop (didn't bet)
Seat 2: jbodey52 (button) collected (5300)
Seat 3: CHIEFKILLER4 (small blind) folded on the Flop
Seat 4: bvays (big blind) folded before Flop
Seat 6: pokernutt420 folded before Flop (didn't bet)


*********** # 212 **************
PokerStars Hand #169427871132: Tournament #1597684008, $13.50+$1.50 USD=
 Hold'em No Limit - Level XIV (400/800) - 2017/05/05 16:05:54 ET
Table '1597684008 10' 6-max Seat #3 is the button
Seat 1: JJin91 (68476 in chips)=20
Seat 2: jbodey52 (25137 in chips)=20
Seat 3: CHIEFKILLER4 (22940 in chips)=20
Seat 4: bvays (48906 in chips)=20
Seat 6: pokernutt420 (57645 in chips)=20
JJin91: posts the ante 100
jbodey52: posts the ante 100
CHIEFKILLER4: posts the ante 100
bvays: posts the ante 100
pokernutt420: posts the ante 100
bvays: posts small blind 400
pokernutt420: posts big blind 800
*** HOLE CARDS ***
Dealt to JJin91 [3s 4c]
JJin91: folds=20
jbodey52: raises 1200 to 2000
CHIEFKILLER4: folds=20
bvays: folds=20
pokernutt420: folds=20
Uncalled bet (1200) returned to jbodey52
jbodey52 collected 2500 from pot
jbodey52: doesn't show hand=20
*** SUMMARY ***
Total pot 2500 | Rake 0=20
Seat 1: JJin91 folded before Flop (didn't bet)
Seat 2: jbodey52 collected (2500)
Seat 3: CHIEFKILLER4 (button) folded before Flop (didn't bet)
Seat 4: bvays (small blind) folded before Flop
Seat 6: pokernutt420 (big blind) folded before Flop


*********** # 213 **************
PokerStars Hand #169427871190: Tournament #1597684008, $13.50+$1.50 USD=
 Hold'em No Limit - Level XIV (400/800) - 2017/05/05 16:06:15 ET
Table '1597684008 10' 6-max Seat #4 is the button
Seat 1: JJin91 (68376 in chips)=20
Seat 2: jbodey52 (26737 in chips)=20
Seat 3: CHIEFKILLER4 (22840 in chips)=20
Seat 4: bvays (48406 in chips)=20
Seat 6: pokernutt420 (56745 in chips)=20
JJin91: posts the ante 100
jbodey52: posts the ante 100
CHIEFKILLER4: posts the ante 100
bvays: posts the ante 100
pokernutt420: posts the ante 100
pokernutt420: posts small blind 400
JJin91: posts big blind 800
*** HOLE CARDS ***
Dealt to JJin91 [Qs Jd]
jbodey52: folds=20
CHIEFKILLER4: folds=20
bvays: raises 1000 to 1800
pokernutt420: folds=20
JJin91: calls 1000
*** FLOP *** [Qc 8d 2c]
JJin91: checks=20
bvays: bets 1600
JJin91: calls 1600
*** TURN *** [Qc 8d 2c] [6h]
JJin91: checks=20
bvays: checks=20
*** RIVER *** [Qc 8d 2c 6h] [5s]
JJin91: bets 4632
bvays: raises 10168 to 14800
JJin91: calls 10168
*** SHOW DOWN ***
bvays: shows [Kh 6s] (a pair of Sixes)
JJin91: shows [Qs Jd] (a pair of Queens)
JJin91 collected 37300 from pot
*** SUMMARY ***
Total pot 37300 | Rake 0=20
Board [Qc 8d 2c 6h 5s]
Seat 1: JJin91 (big blind) showed [Qs Jd] and won (37300) with a pair o=
f Queens
Seat 2: jbodey52 folded before Flop (didn't bet)
Seat 3: CHIEFKILLER4 folded before Flop (didn't bet)
Seat 4: bvays (button) showed [Kh 6s] and lost with a pair of Sixes
Seat 6: pokernutt420 (small blind) folded before Flop


*********** # 214 **************
PokerStars Hand #169427871415: Tournament #1597684008, $13.50+$1.50 USD=
 Hold'em No Limit - Level XIV (400/800) - 2017/05/05 16:07:32 ET
Table '1597684008 10' 6-max Seat #6 is the button
Seat 1: JJin91 (87376 in chips)=20
Seat 2: jbodey52 (26637 in chips)=20
Seat 3: CHIEFKILLER4 (22740 in chips)=20
Seat 4: bvays (30106 in chips)=20
Seat 6: pokernutt420 (56245 in chips)=20
JJin91: posts the ante 100
jbodey52: posts the ante 100
CHIEFKILLER4: posts the ante 100
bvays: posts the ante 100
pokernutt420: posts the ante 100
JJin91: posts small blind 400
jbodey52: posts big blind 800
*** HOLE CARDS ***
Dealt to JJin91 [5s 6d]
CHIEFKILLER4: raises 800 to 1600
bvays: folds=20
pokernutt420: calls 1600
JJin91: folds=20
jbodey52: raises 22000 to 23600
CHIEFKILLER4: folds=20
pokernutt420: folds=20
Uncalled bet (22000) returned to jbodey52
jbodey52 collected 5700 from pot
jbodey52: doesn't show hand=20
*** SUMMARY ***
Total pot 5700 | Rake 0=20
Seat 1: JJin91 (small blind) folded before Flop
Seat 2: jbodey52 (big blind) collected (5700)
Seat 3: CHIEFKILLER4 folded before Flop
Seat 4: bvays folded before Flop (didn't bet)
Seat 6: pokernutt420 (button) folded before Flop


*********** # 215 **************
PokerStars Hand #169427871569: Tournament #1597684008, $13.50+$1.50 USD=
 Hold'em No Limit - Level XV (500/1000) - 2017/05/05 16:08:20 ET
Table '1597684008 10' 6-max Seat #1 is the button
Seat 1: JJin91 (86876 in chips)=20
Seat 2: jbodey52 (30637 in chips)=20
Seat 3: CHIEFKILLER4 (21040 in chips)=20
Seat 4: bvays (30006 in chips)=20
Seat 6: pokernutt420 (54545 in chips)=20
JJin91: posts the ante 125
jbodey52: posts the ante 125
CHIEFKILLER4: posts the ante 125
bvays: posts the ante 125
pokernutt420: posts the ante 125
jbodey52: posts small blind 500
CHIEFKILLER4: posts big blind 1000
*** HOLE CARDS ***
Dealt to JJin91 [8c 7s]
bvays: raises 1000 to 2000
pokernutt420: folds=20
JJin91: folds=20
jbodey52: raises 26000 to 28000
CHIEFKILLER4: folds=20
bvays: folds=20
Uncalled bet (26000) returned to jbodey52
jbodey52 collected 5625 from pot
jbodey52: doesn't show hand=20
*** SUMMARY ***
Total pot 5625 | Rake 0=20
Seat 1: JJin91 (button) folded before Flop (didn't bet)
Seat 2: jbodey52 (small blind) collected (5625)
Seat 3: CHIEFKILLER4 (big blind) folded before Flop
Seat 4: bvays folded before Flop
Seat 6: pokernutt420 folded before Flop (didn't bet)


*********** # 216 **************
PokerStars Hand #169427871662: Tournament #1597684008, $13.50+$1.50 USD=
 Hold'em No Limit - Level XV (500/1000) - 2017/05/05 16:08:46 ET
Table '1597684008 10' 6-max Seat #2 is the button
Seat 1: JJin91 (86751 in chips)=20
Seat 2: jbodey52 (34137 in chips)=20
Seat 3: CHIEFKILLER4 (19915 in chips)=20
Seat 4: bvays (27881 in chips)=20
Seat 6: pokernutt420 (54420 in chips)=20
JJin91: posts the ante 125
jbodey52: posts the ante 125
CHIEFKILLER4: posts the ante 125
bvays: posts the ante 125
pokernutt420: posts the ante 125
CHIEFKILLER4: posts small blind 500
bvays: posts big blind 1000
*** HOLE CARDS ***
Dealt to JJin91 [Td Qd]
pokernutt420: folds=20
JJin91: raises 1285 to 2285
jbodey52: folds=20
CHIEFKILLER4: folds=20
bvays: calls 1285
*** FLOP *** [7h 5h Kd]
bvays: checks=20
JJin91: bets 3000
bvays: calls 3000
*** TURN *** [7h 5h Kd] [3d]
bvays: checks=20
JJin91: checks=20
*** RIVER *** [7h 5h Kd 3d] [7d]
bvays: bets 4400
JJin91: raises 76941 to 81341 and is all-in
bvays: folds=20
Uncalled bet (76941) returned to JJin91
JJin91 collected 20495 from pot
*** SUMMARY ***
Total pot 20495 | Rake 0=20
Board [7h 5h Kd 3d 7d]
Seat 1: JJin91 collected (20495)
Seat 2: jbodey52 (button) folded before Flop (didn't bet)
Seat 3: CHIEFKILLER4 (small blind) folded before Flop
Seat 4: bvays (big blind) folded on the River
Seat 6: pokernutt420 folded before Flop (didn't bet)


*********** # 217 **************
PokerStars Hand #169427871908: Tournament #1597684008, $13.50+$1.50 USD=
 Hold'em No Limit - Level XV (500/1000) - 2017/05/05 16:09:53 ET
Table '1597684008 10' 6-max Seat #3 is the button
Seat 1: JJin91 (97436 in chips)=20
Seat 2: jbodey52 (34012 in chips)=20
Seat 3: CHIEFKILLER4 (19290 in chips)=20
Seat 4: bvays (18071 in chips)=20
Seat 6: pokernutt420 (54295 in chips)=20
JJin91: posts the ante 125
jbodey52: posts the ante 125
CHIEFKILLER4: posts the ante 125
bvays: posts the ante 125
pokernutt420: posts the ante 125
bvays: posts small blind 500
pokernutt420: posts big blind 1000
*** HOLE CARDS ***
Dealt to JJin91 [Ad 9h]
JJin91: folds=20
jbodey52: folds=20
CHIEFKILLER4: raises 18165 to 19165 and is all-in
bvays: folds=20
pokernutt420: folds=20
Uncalled bet (18165) returned to CHIEFKILLER4
CHIEFKILLER4 collected 3125 from pot
*** SUMMARY ***
Total pot 3125 | Rake 0=20
Seat 1: JJin91 folded before Flop (didn't bet)
Seat 2: jbodey52 folded before Flop (didn't bet)
Seat 3: CHIEFKILLER4 (button) collected (3125)
Seat 4: bvays (small blind) folded before Flop
Seat 6: pokernutt420 (big blind) folded before Flop


*********** # 218 **************
PokerStars Hand #169427871967: Tournament #1597684008, $13.50+$1.50 USD=
 Hold'em No Limit - Level XV (500/1000) - 2017/05/05 16:10:10 ET
Table '1597684008 10' 6-max Seat #4 is the button
Seat 1: JJin91 (97311 in chips)=20
Seat 2: jbodey52 (33887 in chips)=20
Seat 3: CHIEFKILLER4 (21290 in chips)=20
Seat 4: bvays (17446 in chips)=20
Seat 6: pokernutt420 (53170 in chips)=20
JJin91: posts the ante 125
jbodey52: posts the ante 125
CHIEFKILLER4: posts the ante 125
bvays: posts the ante 125
pokernutt420: posts the ante 125
pokernutt420: posts small blind 500
JJin91: posts big blind 1000
*** HOLE CARDS ***
Dealt to JJin91 [Qd Qs]
jbodey52: folds=20
CHIEFKILLER4: folds=20
bvays: raises 16321 to 17321 and is all-in
pokernutt420: folds=20
JJin91: calls 16321
*** FLOP *** [2s Kh 7h]
*** TURN *** [2s Kh 7h] [8c]
*** RIVER *** [2s Kh 7h 8c] [6c]
*** SHOW DOWN ***
JJin91: shows [Qd Qs] (a pair of Queens)
bvays: shows [Ad 6s] (a pair of Sixes)
JJin91 collected 35767 from pot
bvays finished the tournament in 20th place
*** SUMMARY ***
Total pot 35767 | Rake 0=20
Board [2s Kh 7h 8c 6c]
Seat 1: JJin91 (big blind) showed [Qd Qs] and won (35767) with a pair o=
f Queens
Seat 2: jbodey52 folded before Flop (didn't bet)
Seat 3: CHIEFKILLER4 folded before Flop (didn't bet)
Seat 4: bvays (button) showed [Ad 6s] and lost with a pair of Sixes
Seat 6: pokernutt420 (small blind) folded before Flop


*********** # 219 **************
PokerStars Hand #169427872052: Tournament #1597684008, $13.50+$1.50 USD=
 Hold'em No Limit - Level XV (500/1000) - 2017/05/05 16:10:40 ET
Table '1597684008 10' 6-max Seat #6 is the button
Seat 1: JJin91 (115632 in chips)=20
Seat 2: jbodey52 (33762 in chips)=20
Seat 3: CHIEFKILLER4 (21165 in chips)=20
Seat 6: pokernutt420 (52545 in chips)=20
JJin91: posts the ante 125
jbodey52: posts the ante 125
CHIEFKILLER4: posts the ante 125
pokernutt420: posts the ante 125
JJin91: posts small blind 500
jbodey52: posts big blind 1000
*** HOLE CARDS ***
Dealt to JJin91 [Ts 8h]
CHIEFKILLER4: folds=20
pokernutt420: folds=20
JJin91: folds=20
Uncalled bet (500) returned to jbodey52
jbodey52 collected 1500 from pot
jbodey52: doesn't show hand=20
*** SUMMARY ***
Total pot 1500 | Rake 0=20
Seat 1: JJin91 (small blind) folded before Flop
Seat 2: jbodey52 (big blind) collected (1500)
Seat 3: CHIEFKILLER4 folded before Flop (didn't bet)
Seat 6: pokernutt420 (button) folded before Flop (didn't bet)


*********** # 220 **************
PokerStars Hand #169427872107: Tournament #1597684008, $13.50+$1.50 USD=
 Hold'em No Limit - Level XV (500/1000) - 2017/05/05 16:10:55 ET
Table '1597684008 10' 6-max Seat #1 is the button
Seat 1: JJin91 (115007 in chips)=20
Seat 2: jbodey52 (34637 in chips)=20
Seat 3: CHIEFKILLER4 (21040 in chips)=20
Seat 4: DaBirds23 (32270 in chips)=20
Seat 6: pokernutt420 (52420 in chips)=20
JJin91: posts the ante 125
jbodey52: posts the ante 125
CHIEFKILLER4: posts the ante 125
DaBirds23: posts the ante 125
pokernutt420: posts the ante 125
jbodey52: posts small blind 500
CHIEFKILLER4: posts big blind 1000
*** HOLE CARDS ***
Dealt to JJin91 [8c Ah]
DaBirds23: folds=20
jbodey52 said, "birds how it is ?"
pokernutt420: folds=20
JJin91: raises 1000 to 2000
jbodey52: folds=20
CHIEFKILLER4: folds=20
Uncalled bet (1000) returned to JJin91
JJin91 collected 3125 from pot
*** SUMMARY ***
Total pot 3125 | Rake 0=20
Seat 1: JJin91 (button) collected (3125)
Seat 2: jbodey52 (small blind) folded before Flop
Seat 3: CHIEFKILLER4 (big blind) folded before Flop
Seat 4: DaBirds23 folded before Flop (didn't bet)
Seat 6: pokernutt420 folded before Flop (didn't bet)


*********** # 221 **************
PokerStars Hand #169427872197: Tournament #1597684008, $13.50+$1.50 USD=
 Hold'em No Limit - Level XV (500/1000) - 2017/05/05 16:11:23 ET
Table '1597684008 10' 6-max Seat #2 is the button
Seat 1: JJin91 (117007 in chips)=20
Seat 2: jbodey52 (34012 in chips)=20
Seat 3: CHIEFKILLER4 (19915 in chips)=20
Seat 4: DaBirds23 (32145 in chips)=20
Seat 6: pokernutt420 (52295 in chips)=20
JJin91: posts the ante 125
jbodey52: posts the ante 125
CHIEFKILLER4: posts the ante 125
DaBirds23: posts the ante 125
pokernutt420: posts the ante 125
CHIEFKILLER4: posts small blind 500
DaBirds23: posts big blind 1000
*** HOLE CARDS ***
Dealt to JJin91 [Jd Qs]
pokernutt420: folds=20
JJin91: raises 1215 to 2215
jbodey52: folds=20
CHIEFKILLER4: folds=20
DaBirds23: folds=20
Uncalled bet (1215) returned to JJin91
JJin91 collected 3125 from pot
*** SUMMARY ***
Total pot 3125 | Rake 0=20
Seat 1: JJin91 collected (3125)
Seat 2: jbodey52 (button) folded before Flop (didn't bet)
Seat 3: CHIEFKILLER4 (small blind) folded before Flop
Seat 4: DaBirds23 (big blind) folded before Flop
Seat 6: pokernutt420 folded before Flop (didn't bet)


*********** # 222 **************
PokerStars Hand #169427872283: Tournament #1597684008, $13.50+$1.50 USD=
 Hold'em No Limit - Level XV (500/1000) - 2017/05/05 16:11:53 ET
Table '1597684008 10' 6-max Seat #3 is the button
Seat 1: JJin91 (119007 in chips)=20
Seat 2: jbodey52 (33887 in chips)=20
Seat 3: CHIEFKILLER4 (19290 in chips)=20
Seat 4: DaBirds23 (31020 in chips)=20
Seat 5: tess1235 (63405 in chips)=20
Seat 6: pokernutt420 (52170 in chips)=20
JJin91: posts the ante 125
jbodey52: posts the ante 125
CHIEFKILLER4: posts the ante 125
DaBirds23: posts the ante 125
tess1235: posts the ante 125
pokernutt420: posts the ante 125
DaBirds23: posts small blind 500
tess1235: posts big blind 1000
*** HOLE CARDS ***
Dealt to JJin91 [7s Kh]
pokernutt420: folds=20
JJin91: folds=20
jbodey52: folds=20
CHIEFKILLER4: folds=20
DaBirds23: calls 500
tess1235: checks=20
*** FLOP *** [Th Kc 7d]
DaBirds23: bets 1348
tess1235: calls 1348
*** TURN *** [Th Kc 7d] [3d]
DaBirds23: bets 2669
tess1235: folds=20
Uncalled bet (2669) returned to DaBirds23
DaBirds23 collected 5446 from pot
*** SUMMARY ***
Total pot 5446 | Rake 0=20
Board [Th Kc 7d 3d]
Seat 1: JJin91 folded before Flop (didn't bet)
Seat 2: jbodey52 folded before Flop (didn't bet)
Seat 3: CHIEFKILLER4 (button) folded before Flop (didn't bet)
Seat 4: DaBirds23 (small blind) collected (5446)
Seat 5: tess1235 (big blind) folded on the Turn
Seat 6: pokernutt420 folded before Flop (didn't bet)


*********** # 223 **************
PokerStars Hand #169427872404: Tournament #1597684008, $13.50+$1.50 USD=
 Hold'em No Limit - Level XV (500/1000) - 2017/05/05 16:12:35 ET
Table '1597684008 10' 6-max Seat #4 is the button
Seat 1: JJin91 (118882 in chips)=20
Seat 2: jbodey52 (33762 in chips)=20
Seat 3: CHIEFKILLER4 (19165 in chips)=20
Seat 4: DaBirds23 (33993 in chips)=20
Seat 5: tess1235 (60932 in chips)=20
Seat 6: pokernutt420 (52045 in chips)=20
JJin91: posts the ante 125
jbodey52: posts the ante 125
CHIEFKILLER4: posts the ante 125
DaBirds23: posts the ante 125
tess1235: posts the ante 125
pokernutt420: posts the ante 125
tess1235: posts small blind 500
pokernutt420: posts big blind 1000
*** HOLE CARDS ***
Dealt to JJin91 [5c Qd]
JJin91: folds=20
jbodey52: folds=20
CHIEFKILLER4: raises 18040 to 19040 and is all-in
DaBirds23: folds=20
tess1235: folds=20
pokernutt420: folds=20
Uncalled bet (18040) returned to CHIEFKILLER4
CHIEFKILLER4 collected 3250 from pot
*** SUMMARY ***
Total pot 3250 | Rake 0=20
Seat 1: JJin91 folded before Flop (didn't bet)
Seat 2: jbodey52 folded before Flop (didn't bet)
Seat 3: CHIEFKILLER4 collected (3250)
Seat 4: DaBirds23 (button) folded before Flop (didn't bet)
Seat 5: tess1235 (small blind) folded before Flop
Seat 6: pokernutt420 (big blind) folded before Flop


*********** # 224 **************
PokerStars Hand #169427872498: Tournament #1597684008, $13.50+$1.50 USD=
 Hold'em No Limit - Level XV (500/1000) - 2017/05/05 16:13:06 ET
Table '1597684008 10' 6-max Seat #5 is the button
Seat 1: JJin91 (118757 in chips)=20
Seat 2: jbodey52 (33637 in chips)=20
Seat 3: CHIEFKILLER4 (21290 in chips)=20
Seat 4: DaBirds23 (33868 in chips)=20
Seat 5: tess1235 (60307 in chips)=20
Seat 6: pokernutt420 (50920 in chips)=20
JJin91: posts the ante 125
jbodey52: posts the ante 125
CHIEFKILLER4: posts the ante 125
DaBirds23: posts the ante 125
tess1235: posts the ante 125
pokernutt420: posts the ante 125
pokernutt420: posts small blind 500
JJin91: posts big blind 1000
*** HOLE CARDS ***
Dealt to JJin91 [5c Ks]
jbodey52: folds=20
CHIEFKILLER4: raises 1000 to 2000
DaBirds23: folds=20
tess1235: folds=20
pokernutt420: folds=20
JJin91: folds=20
Uncalled bet (1000) returned to CHIEFKILLER4
CHIEFKILLER4 collected 3250 from pot
*** SUMMARY ***
Total pot 3250 | Rake 0=20
Seat 1: JJin91 (big blind) folded before Flop
Seat 2: jbodey52 folded before Flop (didn't bet)
Seat 3: CHIEFKILLER4 collected (3250)
Seat 4: DaBirds23 folded before Flop (didn't bet)
Seat 5: tess1235 (button) folded before Flop (didn't bet)
Seat 6: pokernutt420 (small blind) folded before Flop


*********** # 225 **************
PokerStars Hand #169427872594: Tournament #1597684008, $13.50+$1.50 USD=
 Hold'em No Limit - Level XV (500/1000) - 2017/05/05 16:13:38 ET
Table '1597684008 10' 6-max Seat #6 is the button
Seat 1: JJin91 (117632 in chips)=20
Seat 2: jbodey52 (33512 in chips)=20
Seat 3: CHIEFKILLER4 (23415 in chips)=20
Seat 4: DaBirds23 (33743 in chips)=20
Seat 5: tess1235 (60182 in chips)=20
Seat 6: pokernutt420 (50295 in chips)=20
JJin91: posts the ante 125
jbodey52: posts the ante 125
CHIEFKILLER4: posts the ante 125
DaBirds23: posts the ante 125
tess1235: posts the ante 125
pokernutt420: posts the ante 125
JJin91: posts small blind 500
jbodey52: posts big blind 1000
*** HOLE CARDS ***
Dealt to JJin91 [As 5c]
CHIEFKILLER4: folds=20
DaBirds23: folds=20
tess1235: raises 2000 to 3000
pokernutt420: folds=20
JJin91: folds=20
jbodey52: folds=20
Uncalled bet (2000) returned to tess1235
tess1235 collected 3250 from pot
tess1235: doesn't show hand=20
*** SUMMARY ***
Total pot 3250 | Rake 0=20
Seat 1: JJin91 (small blind) folded before Flop
Seat 2: jbodey52 (big blind) folded before Flop
Seat 3: CHIEFKILLER4 folded before Flop (didn't bet)
Seat 4: DaBirds23 folded before Flop (didn't bet)
Seat 5: tess1235 collected (3250)
Seat 6: pokernutt420 (button) folded before Flop (didn't bet)


*********** # 226 **************
PokerStars Hand #169427872655: Tournament #1597684008, $13.50+$1.50 USD=
 Hold'em No Limit - Level XV (500/1000) - 2017/05/05 16:13:59 ET
Table '1597684008 10' 6-max Seat #1 is the button
Seat 1: JJin91 (117007 in chips)=20
Seat 2: jbodey52 (32387 in chips)=20
Seat 3: CHIEFKILLER4 (23290 in chips)=20
Seat 4: DaBirds23 (33618 in chips)=20
Seat 5: tess1235 (62307 in chips)=20
Seat 6: pokernutt420 (50170 in chips)=20
JJin91: posts the ante 125
jbodey52: posts the ante 125
CHIEFKILLER4: posts the ante 125
DaBirds23: posts the ante 125
tess1235: posts the ante 125
pokernutt420: posts the ante 125
jbodey52: posts small blind 500
CHIEFKILLER4: posts big blind 1000
*** HOLE CARDS ***
Dealt to JJin91 [5h Qs]
DaBirds23: raises 1340 to 2340
tess1235: folds=20
pokernutt420: folds=20
JJin91: folds=20
jbodey52: calls 1840
CHIEFKILLER4: calls 1340
*** FLOP *** [2s 3h 8s]
jbodey52: checks=20
CHIEFKILLER4: checks=20
DaBirds23: bets 2797
jbodey52: raises 5703 to 8500
CHIEFKILLER4: folds=20
DaBirds23: folds=20
Uncalled bet (5703) returned to jbodey52
jbodey52 collected 13364 from pot
jbodey52: doesn't show hand=20
*** SUMMARY ***
Total pot 13364 | Rake 0=20
Board [2s 3h 8s]
Seat 1: JJin91 (button) folded before Flop (didn't bet)
Seat 2: jbodey52 (small blind) collected (13364)
Seat 3: CHIEFKILLER4 (big blind) folded on the Flop
Seat 4: DaBirds23 folded on the Flop
Seat 5: tess1235 folded before Flop (didn't bet)
Seat 6: pokernutt420 folded before Flop (didn't bet)


*********** # 227 **************
PokerStars Hand #169427872868: Tournament #1597684008, $13.50+$1.50 USD=
 Hold'em No Limit - Level XV (500/1000) - 2017/05/05 16:15:09 ET
Table '1597684008 10' 6-max Seat #2 is the button
Seat 1: JJin91 (116882 in chips)=20
Seat 2: jbodey52 (40489 in chips)=20
Seat 3: CHIEFKILLER4 (20825 in chips)=20
Seat 4: DaBirds23 (28356 in chips)=20
Seat 5: tess1235 (62182 in chips)=20
Seat 6: pokernutt420 (50045 in chips)=20
JJin91: posts the ante 125
jbodey52: posts the ante 125
CHIEFKILLER4: posts the ante 125
DaBirds23: posts the ante 125
tess1235: posts the ante 125
pokernutt420: posts the ante 125
CHIEFKILLER4: posts small blind 500
DaBirds23: posts big blind 1000
*** HOLE CARDS ***
Dealt to JJin91 [As 6s]
tess1235: folds=20
pokernutt420: folds=20
JJin91: raises 1211 to 2211
jbodey52: folds=20
CHIEFKILLER4: folds=20
DaBirds23: folds=20
Uncalled bet (1211) returned to JJin91
JJin91 collected 3250 from pot
*** SUMMARY ***
Total pot 3250 | Rake 0=20
Seat 1: JJin91 collected (3250)
Seat 2: jbodey52 (button) folded before Flop (didn't bet)
Seat 3: CHIEFKILLER4 (small blind) folded before Flop
Seat 4: DaBirds23 (big blind) folded before Flop
Seat 5: tess1235 folded before Flop (didn't bet)
Seat 6: pokernutt420 folded before Flop (didn't bet)


*********** # 228 **************
PokerStars Hand #169427872936: Tournament #1597684008, $13.50+$1.50 USD=
 Hold'em No Limit - Level XV (500/1000) - 2017/05/05 16:15:31 ET
Table '1597684008 10' 6-max Seat #3 is the button
Seat 1: JJin91 (119007 in chips)=20
Seat 2: jbodey52 (40364 in chips)=20
Seat 3: CHIEFKILLER4 (20200 in chips)=20
Seat 4: DaBirds23 (27231 in chips)=20
Seat 5: tess1235 (62057 in chips)=20
Seat 6: pokernutt420 (49920 in chips)=20
JJin91: posts the ante 125
jbodey52: posts the ante 125
CHIEFKILLER4: posts the ante 125
DaBirds23: posts the ante 125
tess1235: posts the ante 125
pokernutt420: posts the ante 125
DaBirds23: posts small blind 500
tess1235: posts big blind 1000
*** HOLE CARDS ***
Dealt to JJin91 [Ks 2h]
pokernutt420: folds=20
JJin91: folds=20
jbodey52: raises 1500 to 2500
CHIEFKILLER4: folds=20
DaBirds23: folds=20
tess1235: folds=20
Uncalled bet (1500) returned to jbodey52
jbodey52 collected 3250 from pot
jbodey52: doesn't show hand=20
*** SUMMARY ***
Total pot 3250 | Rake 0=20
Seat 1: JJin91 folded before Flop (didn't bet)
Seat 2: jbodey52 collected (3250)
Seat 3: CHIEFKILLER4 (button) folded before Flop (didn't bet)
Seat 4: DaBirds23 (small blind) folded before Flop
Seat 5: tess1235 (big blind) folded before Flop
Seat 6: pokernutt420 folded before Flop (didn't bet)


*********** # 229 **************
PokerStars Hand #169427873020: Tournament #1597684008, $13.50+$1.50 USD=
 Hold'em No Limit - Level XV (500/1000) - 2017/05/05 16:16:00 ET
Table '1597684008 10' 6-max Seat #4 is the button
Seat 1: JJin91 (118882 in chips)=20
Seat 2: jbodey52 (42489 in chips)=20
Seat 3: CHIEFKILLER4 (20075 in chips)=20
Seat 4: DaBirds23 (26606 in chips)=20
Seat 5: tess1235 (60932 in chips)=20
Seat 6: pokernutt420 (49795 in chips)=20
JJin91: posts the ante 125
jbodey52: posts the ante 125
CHIEFKILLER4: posts the ante 125
DaBirds23: posts the ante 125
tess1235: posts the ante 125
pokernutt420: posts the ante 125
tess1235: posts small blind 500
pokernutt420: posts big blind 1000
*** HOLE CARDS ***
Dealt to JJin91 [Kc Th]
JJin91: folds=20
jbodey52: folds=20
CHIEFKILLER4: folds=20
DaBirds23: raises 1340 to 2340
tess1235: calls 1840
pokernutt420: calls 1340
*** FLOP *** [2h 3d 9s]
tess1235: bets 3885
pokernutt420: folds=20
DaBirds23: folds=20
Uncalled bet (3885) returned to tess1235
tess1235 collected 7770 from pot
tess1235: doesn't show hand=20
*** SUMMARY ***
Total pot 7770 | Rake 0=20
Board [2h 3d 9s]
Seat 1: JJin91 folded before Flop (didn't bet)
Seat 2: jbodey52 folded before Flop (didn't bet)
Seat 3: CHIEFKILLER4 folded before Flop (didn't bet)
Seat 4: DaBirds23 (button) folded on the Flop
Seat 5: tess1235 (small blind) collected (7770)
Seat 6: pokernutt420 (big blind) folded on the Flop


*********** # 230 **************
PokerStars Hand #169427873166: Tournament #1597684008, $13.50+$1.50 USD=
 Hold'em No Limit - Level XV (500/1000) - 2017/05/05 16:16:51 ET
Table '1597684008 10' 6-max Seat #5 is the button
Seat 1: JJin91 (118757 in chips)=20
Seat 2: jbodey52 (42364 in chips)=20
Seat 3: CHIEFKILLER4 (19950 in chips)=20
Seat 4: DaBirds23 (24141 in chips)=20
Seat 5: tess1235 (66237 in chips)=20
Seat 6: pokernutt420 (47330 in chips)=20
JJin91: posts the ante 125
jbodey52: posts the ante 125
CHIEFKILLER4: posts the ante 125
DaBirds23: posts the ante 125
tess1235: posts the ante 125
pokernutt420: posts the ante 125
pokernutt420: posts small blind 500
JJin91: posts big blind 1000
*** HOLE CARDS ***
Dealt to JJin91 [2h 3d]
jbodey52: folds=20
CHIEFKILLER4: folds=20
DaBirds23: folds=20
tess1235: folds=20
pokernutt420: raises 2000 to 3000
JJin91: folds=20
Uncalled bet (2000) returned to pokernutt420
pokernutt420 collected 2750 from pot
pokernutt420: doesn't show hand=20
*** SUMMARY ***
Total pot 2750 | Rake 0=20
Seat 1: JJin91 (big blind) folded before Flop
Seat 2: jbodey52 folded before Flop (didn't bet)
Seat 3: CHIEFKILLER4 folded before Flop (didn't bet)
Seat 4: DaBirds23 folded before Flop (didn't bet)
Seat 5: tess1235 (button) folded before Flop (didn't bet)
Seat 6: pokernutt420 (small blind) collected (2750)


*********** # 231 **************
PokerStars Hand #169427873229: Tournament #1597684008, $13.50+$1.50 USD=
 Hold'em No Limit - Level XV (500/1000) - 2017/05/05 16:17:12 ET
Table '1597684008 10' 6-max Seat #6 is the button
Seat 1: JJin91 (117632 in chips)=20
Seat 2: jbodey52 (42239 in chips)=20
Seat 3: CHIEFKILLER4 (19825 in chips)=20
Seat 4: DaBirds23 (24016 in chips)=20
Seat 5: tess1235 (66112 in chips)=20
Seat 6: pokernutt420 (48955 in chips)=20
JJin91: posts the ante 125
jbodey52: posts the ante 125
CHIEFKILLER4: posts the ante 125
DaBirds23: posts the ante 125
tess1235: posts the ante 125
pokernutt420: posts the ante 125
JJin91: posts small blind 500
jbodey52: posts big blind 1000
*** HOLE CARDS ***
Dealt to JJin91 [Jh 2h]
CHIEFKILLER4: folds=20
DaBirds23: folds=20
tess1235: folds=20
pokernutt420: folds=20
JJin91: raises 2000 to 3000
jbodey52: folds=20
Uncalled bet (2000) returned to JJin91
JJin91 collected 2750 from pot
*** SUMMARY ***
Total pot 2750 | Rake 0=20
Seat 1: JJin91 (small blind) collected (2750)
Seat 2: jbodey52 (big blind) folded before Flop
Seat 3: CHIEFKILLER4 folded before Flop (didn't bet)
Seat 4: DaBirds23 folded before Flop (didn't bet)
Seat 5: tess1235 folded before Flop (didn't bet)
Seat 6: pokernutt420 (button) folded before Flop (didn't bet)


*********** # 232 **************
PokerStars Hand #169427873301: Tournament #1597684008, $13.50+$1.50 USD=
 Hold'em No Limit - Level XV (500/1000) - 2017/05/05 16:17:33 ET
Table '1597684008 10' 6-max Seat #1 is the button
Seat 1: JJin91 (119257 in chips)=20
Seat 2: jbodey52 (41114 in chips)=20
Seat 3: CHIEFKILLER4 (19700 in chips)=20
Seat 4: DaBirds23 (23891 in chips)=20
Seat 5: tess1235 (65987 in chips)=20
Seat 6: pokernutt420 (48830 in chips)=20
JJin91: posts the ante 125
jbodey52: posts the ante 125
CHIEFKILLER4: posts the ante 125
DaBirds23: posts the ante 125
tess1235: posts the ante 125
pokernutt420: posts the ante 125
jbodey52: posts small blind 500
CHIEFKILLER4: posts big blind 1000
*** HOLE CARDS ***
Dealt to JJin91 [Jc Kd]
DaBirds23: folds=20
tess1235: calls 1000
pokernutt420: folds=20
JJin91: raises 2000 to 3000
jbodey52: folds=20
CHIEFKILLER4: folds=20
tess1235: calls 2000
*** FLOP *** [8s 2h As]
tess1235: checks=20
JJin91: bets 3528
tess1235: folds=20
Uncalled bet (3528) returned to JJin91
JJin91 collected 8250 from pot
*** SUMMARY ***
Total pot 8250 | Rake 0=20
Board [8s 2h As]
Seat 1: JJin91 (button) collected (8250)
Seat 2: jbodey52 (small blind) folded before Flop
Seat 3: CHIEFKILLER4 (big blind) folded before Flop
Seat 4: DaBirds23 folded before Flop (didn't bet)
Seat 5: tess1235 folded on the Flop
Seat 6: pokernutt420 folded before Flop (didn't bet)


*********** # 233 **************
PokerStars Hand #169427873460: Tournament #1597684008, $13.50+$1.50 USD=
 Hold'em No Limit - Level XVI (600/1200) - 2017/05/05 16:18:26 ET
Table '1597684008 10' 6-max Seat #2 is the button
Seat 1: JJin91 (124382 in chips)=20
Seat 2: jbodey52 (40489 in chips)=20
Seat 3: CHIEFKILLER4 (18575 in chips)=20
Seat 4: DaBirds23 (23766 in chips)=20
Seat 5: tess1235 (62862 in chips)=20
Seat 6: pokernutt420 (48705 in chips)=20
JJin91: posts the ante 150
jbodey52: posts the ante 150
CHIEFKILLER4: posts the ante 150
DaBirds23: posts the ante 150
tess1235: posts the ante 150
pokernutt420: posts the ante 150
CHIEFKILLER4: posts small blind 600
DaBirds23: posts big blind 1200
*** HOLE CARDS ***
Dealt to JJin91 [5c Kh]
tess1235: calls 1200
pokernutt420: folds=20
JJin91: folds=20
jbodey52: folds=20
CHIEFKILLER4: raises 17225 to 18425 and is all-in
DaBirds23: folds=20
tess1235: calls 17225
*** FLOP *** [3h 3d 4d]
*** TURN *** [3h 3d 4d] [5s]
*** RIVER *** [3h 3d 4d 5s] [Ts]
*** SHOW DOWN ***
CHIEFKILLER4: shows [9d Ks] (a pair of Threes)
tess1235: shows [Ad Th] (two pair, Tens and Threes)
tess1235 collected 38950 from pot
CHIEFKILLER4 finished the tournament in 18th place and received $18.60.
*** SUMMARY ***
Total pot 38950 | Rake 0=20
Board [3h 3d 4d 5s Ts]
Seat 1: JJin91 folded before Flop (didn't bet)
Seat 2: jbodey52 (button) folded before Flop (didn't bet)
Seat 3: CHIEFKILLER4 (small blind) showed [9d Ks] and lost with a pair =
of Threes
Seat 4: DaBirds23 (big blind) folded before Flop
Seat 5: tess1235 showed [Ad Th] and won (38950) with two pair, Tens and=
 Threes
Seat 6: pokernutt420 folded before Flop (didn't bet)


*********** # 234 **************
PokerStars Hand #169427873606: Tournament #1597684008, $13.50+$1.50 USD=
 Hold'em No Limit - Level XVI (600/1200) - 2017/05/05 16:19:11 ET
Table '1597684008 10' 6-max Seat #4 is the button
Seat 1: JJin91 (124232 in chips)=20
Seat 2: jbodey52 (40339 in chips)=20
Seat 4: DaBirds23 (22416 in chips)=20
Seat 5: tess1235 (83237 in chips)=20
Seat 6: pokernutt420 (48555 in chips)=20
JJin91: posts the ante 150
jbodey52: posts the ante 150
DaBirds23: posts the ante 150
tess1235: posts the ante 150
pokernutt420: posts the ante 150
tess1235: posts small blind 600
pokernutt420: posts big blind 1200
*** HOLE CARDS ***
Dealt to JJin91 [6s 9s]
JJin91: folds=20
jbodey52: raises 1800 to 3000
DaBirds23: folds=20
tess1235: folds=20
pokernutt420: folds=20
Uncalled bet (1800) returned to jbodey52
jbodey52 collected 3750 from pot
jbodey52: doesn't show hand=20
*** SUMMARY ***
Total pot 3750 | Rake 0=20
Seat 1: JJin91 folded before Flop (didn't bet)
Seat 2: jbodey52 collected (3750)
Seat 4: DaBirds23 (button) folded before Flop (didn't bet)
Seat 5: tess1235 (small blind) folded before Flop
Seat 6: pokernutt420 (big blind) folded before Flop


*********** # 235 **************
PokerStars Hand #169427873658: Tournament #1597684008, $13.50+$1.50 USD=
 Hold'em No Limit - Level XVI (600/1200) - 2017/05/05 16:19:27 ET
Table '1597684008 10' 6-max Seat #5 is the button
Seat 1: JJin91 (124082 in chips)=20
Seat 2: jbodey52 (42739 in chips)=20
Seat 4: DaBirds23 (22266 in chips)=20
Seat 5: tess1235 (82487 in chips)=20
Seat 6: pokernutt420 (47205 in chips)=20
JJin91: posts the ante 150
jbodey52: posts the ante 150
DaBirds23: posts the ante 150
tess1235: posts the ante 150
pokernutt420: posts the ante 150
pokernutt420: posts small blind 600
JJin91: posts big blind 1200
*** HOLE CARDS ***
Dealt to JJin91 [Ad Qc]
jbodey52: folds=20
DaBirds23: folds=20
tess1235: calls 1200
pokernutt420: calls 600
JJin91: raises 2652 to 3852
tess1235: calls 2652
pokernutt420: calls 2652
*** FLOP *** [9h Ac 9d]
pokernutt420: checks=20
JJin91: checks=20
tess1235: checks=20
*** TURN *** [9h Ac 9d] [2d]
pokernutt420: checks=20
JJin91: bets 7125
tess1235: folds=20
pokernutt420: folds=20
Uncalled bet (7125) returned to JJin91
JJin91 collected 12306 from pot
*** SUMMARY ***
Total pot 12306 | Rake 0=20
Board [9h Ac 9d 2d]
Seat 1: JJin91 (big blind) collected (12306)
Seat 2: jbodey52 folded before Flop (didn't bet)
Seat 4: DaBirds23 folded before Flop (didn't bet)
Seat 5: tess1235 (button) folded on the Turn
Seat 6: pokernutt420 (small blind) folded on the Turn


*********** # 236 **************
PokerStars Hand #169427873845: Tournament #1597684008, $13.50+$1.50 USD=
 Hold'em No Limit - Level XVI (600/1200) - 2017/05/05 16:20:31 ET
Table '1597684008 10' 6-max Seat #6 is the button
Seat 1: JJin91 (132386 in chips)=20
Seat 2: jbodey52 (42589 in chips)=20
Seat 4: DaBirds23 (22116 in chips)=20
Seat 5: tess1235 (78485 in chips)=20
Seat 6: pokernutt420 (43203 in chips)=20
JJin91: posts the ante 150
jbodey52: posts the ante 150
DaBirds23: posts the ante 150
tess1235: posts the ante 150
pokernutt420: posts the ante 150
JJin91: posts small blind 600
jbodey52: posts big blind 1200
*** HOLE CARDS ***
Dealt to JJin91 [9h Js]
DaBirds23: folds=20
tess1235: folds=20
pokernutt420: folds=20
JJin91: raises 1200 to 2400
jbodey52: raises 6000 to 8400
JJin91: folds=20
Uncalled bet (6000) returned to jbodey52
jbodey52 collected 5550 from pot
jbodey52: doesn't show hand=20
*** SUMMARY ***
Total pot 5550 | Rake 0=20
Seat 1: JJin91 (small blind) folded before Flop
Seat 2: jbodey52 (big blind) collected (5550)
Seat 4: DaBirds23 folded before Flop (didn't bet)
Seat 5: tess1235 folded before Flop (didn't bet)
Seat 6: pokernutt420 (button) folded before Flop (didn't bet)


*********** # 237 **************
PokerStars Hand #169427873908: Tournament #1597684008, $13.50+$1.50 USD=
 Hold'em No Limit - Level XVI (600/1200) - 2017/05/05 16:20:54 ET
Table '1597684008 10' 6-max Seat #1 is the button
Seat 1: JJin91 (129836 in chips)=20
Seat 2: jbodey52 (45589 in chips)=20
Seat 4: DaBirds23 (21966 in chips)=20
Seat 5: tess1235 (78335 in chips)=20
Seat 6: pokernutt420 (43053 in chips)=20
JJin91: posts the ante 150
jbodey52: posts the ante 150
DaBirds23: posts the ante 150
tess1235: posts the ante 150
pokernutt420: posts the ante 150
jbodey52: posts small blind 600
DaBirds23: posts big blind 1200
*** HOLE CARDS ***
Dealt to JJin91 [5c 7s]
tess1235: folds=20
pokernutt420: folds=20
JJin91: folds=20
jbodey52: raises 1800 to 3000
DaBirds23: folds=20
Uncalled bet (1800) returned to jbodey52
jbodey52 collected 3150 from pot
jbodey52: doesn't show hand=20
*** SUMMARY ***
Total pot 3150 | Rake 0=20
Seat 1: JJin91 (button) folded before Flop (didn't bet)
Seat 2: jbodey52 (small blind) collected (3150)
Seat 4: DaBirds23 (big blind) folded before Flop
Seat 5: tess1235 folded before Flop (didn't bet)
Seat 6: pokernutt420 folded before Flop (didn't bet)


*********** # 238 **************
PokerStars Hand #169427873978: Tournament #1597684008, $13.50+$1.50 USD=
 Hold'em No Limit - Level XVI (600/1200) - 2017/05/05 16:21:17 ET
Table '1597684008 10' 6-max Seat #2 is the button
Seat 1: JJin91 (129686 in chips)=20
Seat 2: jbodey52 (47389 in chips)=20
Seat 4: DaBirds23 (20616 in chips)=20
Seat 5: tess1235 (78185 in chips)=20
Seat 6: pokernutt420 (42903 in chips)=20
JJin91: posts the ante 150
jbodey52: posts the ante 150
DaBirds23: posts the ante 150
tess1235: posts the ante 150
pokernutt420: posts the ante 150
DaBirds23: posts small blind 600
tess1235: posts big blind 1200
*** HOLE CARDS ***
Dealt to JJin91 [7c Jh]
pokernutt420: folds=20
JJin91: folds=20
jbodey52: calls 1200
DaBirds23: calls 600
tess1235: checks=20
*** FLOP *** [4d 3d 4c]
DaBirds23: checks=20
tess1235: checks=20
jbodey52: bets 1600
DaBirds23: calls 1600
tess1235: folds=20
*** TURN *** [4d 3d 4c] [2h]
DaBirds23: checks=20
jbodey52: checks=20
*** RIVER *** [4d 3d 4c 2h] [6c]
DaBirds23: bets 5512
jbodey52: folds=20
Uncalled bet (5512) returned to DaBirds23
DaBirds23 collected 7550 from pot
*** SUMMARY ***
Total pot 7550 | Rake 0=20
Board [4d 3d 4c 2h 6c]
Seat 1: JJin91 folded before Flop (didn't bet)
Seat 2: jbodey52 (button) folded on the River
Seat 4: DaBirds23 (small blind) collected (7550)
Seat 5: tess1235 (big blind) folded on the Flop
Seat 6: pokernutt420 folded before Flop (didn't bet)


*********** # 239 **************
PokerStars Hand #169427874163: Tournament #1597684008, $13.50+$1.50 USD=
 Hold'em No Limit - Level XVI (600/1200) - 2017/05/05 16:22:29 ET
Table '1597684008 10' 6-max Seat #4 is the button
Seat 1: JJin91 (129536 in chips)=20
Seat 2: jbodey52 (44439 in chips)=20
Seat 4: DaBirds23 (25216 in chips)=20
Seat 5: tess1235 (76835 in chips)=20
Seat 6: pokernutt420 (42753 in chips)=20
JJin91: posts the ante 150
jbodey52: posts the ante 150
DaBirds23: posts the ante 150
tess1235: posts the ante 150
pokernutt420: posts the ante 150
tess1235: posts small blind 600
pokernutt420: posts big blind 1200
*** HOLE CARDS ***
Dealt to JJin91 [7c 9h]
JJin91: folds=20
jbodey52: folds=20
DaBirds23: folds=20
tess1235: calls 600
pokernutt420: checks=20
*** FLOP *** [2h 6d 7h]
tess1235: checks=20
pokernutt420: checks=20
*** TURN *** [2h 6d 7h] [8s]
tess1235: bets 1575
pokernutt420: calls 1575
*** RIVER *** [2h 6d 7h 8s] [Ah]
tess1235: checks=20
pokernutt420: bets 3600
tess1235: folds=20
Uncalled bet (3600) returned to pokernutt420
pokernutt420 collected 6300 from pot
pokernutt420: doesn't show hand=20
*** SUMMARY ***
Total pot 6300 | Rake 0=20
Board [2h 6d 7h 8s Ah]
Seat 1: JJin91 folded before Flop (didn't bet)
Seat 2: jbodey52 folded before Flop (didn't bet)
Seat 4: DaBirds23 (button) folded before Flop (didn't bet)
Seat 5: tess1235 (small blind) folded on the River
Seat 6: pokernutt420 (big blind) collected (6300)


*********** # 240 **************
PokerStars Hand #169427874301: Tournament #1597684008, $13.50+$1.50 USD=
 Hold'em No Limit - Level XVI (600/1200) - 2017/05/05 16:23:11 ET
Table '1597684008 10' 6-max Seat #5 is the button
Seat 1: JJin91 (129386 in chips)=20
Seat 2: jbodey52 (44289 in chips)=20
Seat 4: DaBirds23 (25066 in chips)=20
Seat 5: tess1235 (73910 in chips)=20
Seat 6: pokernutt420 (46128 in chips)=20
JJin91: posts the ante 150
jbodey52: posts the ante 150
DaBirds23: posts the ante 150
tess1235: posts the ante 150
pokernutt420: posts the ante 150
pokernutt420: posts small blind 600
JJin91: posts big blind 1200
*** HOLE CARDS ***
Dealt to JJin91 [5h 5d]
jbodey52: raises 1800 to 3000
DaBirds23: folds=20
tess1235: folds=20
pokernutt420: folds=20
JJin91: calls 1800
*** FLOP *** [9h 2s Ah]
JJin91: checks=20
jbodey52: bets 3500
JJin91: folds=20
Uncalled bet (3500) returned to jbodey52
jbodey52 collected 7350 from pot
jbodey52: doesn't show hand=20
*** SUMMARY ***
Total pot 7350 | Rake 0=20
Board [9h 2s Ah]
Seat 1: JJin91 (big blind) folded on the Flop
Seat 2: jbodey52 collected (7350)
Seat 4: DaBirds23 folded before Flop (didn't bet)
Seat 5: tess1235 (button) folded before Flop (didn't bet)
Seat 6: pokernutt420 (small blind) folded before Flop


*********** # 241 **************
PokerStars Hand #169427874405: Tournament #1597684008, $13.50+$1.50 USD=
 Hold'em No Limit - Level XVI (600/1200) - 2017/05/05 16:23:53 ET
Table '1597684008 10' 6-max Seat #6 is the button
Seat 1: JJin91 (126236 in chips)=20
Seat 2: jbodey52 (48489 in chips)=20
Seat 4: DaBirds23 (24916 in chips)=20
Seat 5: tess1235 (73760 in chips)=20
Seat 6: pokernutt420 (45378 in chips)=20
JJin91: posts the ante 150
jbodey52: posts the ante 150
DaBirds23: posts the ante 150
tess1235: posts the ante 150
pokernutt420: posts the ante 150
JJin91: posts small blind 600
jbodey52: posts big blind 1200
*** HOLE CARDS ***
Dealt to JJin91 [9s 2c]
DaBirds23: folds=20
tess1235: folds=20
pokernutt420: raises 1200 to 2400
JJin91: folds=20
jbodey52: calls 1200
*** FLOP *** [Qh Jh 6d]
jbodey52: checks=20
pokernutt420: checks=20
*** TURN *** [Qh Jh 6d] [7s]
jbodey52: bets 3100
pokernutt420: calls 3100
*** RIVER *** [Qh Jh 6d 7s] [Jc]
jbodey52: bets 4500
pokernutt420: folds=20
Uncalled bet (4500) returned to jbodey52
jbodey52 collected 12350 from pot
jbodey52: doesn't show hand=20
*** SUMMARY ***
Total pot 12350 | Rake 0=20
Board [Qh Jh 6d 7s Jc]
Seat 1: JJin91 (small blind) folded before Flop
Seat 2: jbodey52 (big blind) collected (12350)
Seat 4: DaBirds23 folded before Flop (didn't bet)
Seat 5: tess1235 folded before Flop (didn't bet)
Seat 6: pokernutt420 (button) folded on the River


*********** # 242 **************
PokerStars Hand #169427874542: Tournament #1597684008, $13.50+$1.50 USD=
 Hold'em No Limit - Level XVI (600/1200) - 2017/05/05 16:24:43 ET
Table '1597684008 10' 6-max Seat #1 is the button
Seat 1: JJin91 (125486 in chips)=20
Seat 2: jbodey52 (55189 in chips)=20
Seat 4: DaBirds23 (24766 in chips)=20
Seat 5: tess1235 (73610 in chips)=20
Seat 6: pokernutt420 (39728 in chips)=20
JJin91: posts the ante 150
jbodey52: posts the ante 150
DaBirds23: posts the ante 150
tess1235: posts the ante 150
pokernutt420: posts the ante 150
jbodey52: posts small blind 600
DaBirds23: posts big blind 1200
*** HOLE CARDS ***
Dealt to JJin91 [Ts 9h]
tess1235: folds=20
pokernutt420: folds=20
JJin91: raises 1512 to 2712
jbodey52: folds=20
DaBirds23: calls 1512
*** FLOP *** [Ah Tc Qd]
DaBirds23: checks=20
JJin91: bets 3682
DaBirds23: calls 3682
*** TURN *** [Ah Tc Qd] [3s]
DaBirds23: checks=20
JJin91: checks=20
*** RIVER *** [Ah Tc Qd 3s] [7h]
DaBirds23: checks=20
JJin91: checks=20
*** SHOW DOWN ***
DaBirds23: shows [Jh Qs] (a pair of Queens)
JJin91: mucks hand=20
DaBirds23 collected 14138 from pot
*** SUMMARY ***
Total pot 14138 | Rake 0=20
Board [Ah Tc Qd 3s 7h]
Seat 1: JJin91 (button) mucked [Ts 9h]
Seat 2: jbodey52 (small blind) folded before Flop
Seat 4: DaBirds23 (big blind) showed [Jh Qs] and won (14138) with a pai=
r of Queens
Seat 5: tess1235 folded before Flop (didn't bet)
Seat 6: pokernutt420 folded before Flop (didn't bet)


*********** # 243 **************
PokerStars Hand #169427874713: Tournament #1597684008, $13.50+$1.50 USD=
 Hold'em No Limit - Level XVI (600/1200) - 2017/05/05 16:25:43 ET
Table '1597684008 10' 6-max Seat #2 is the button
Seat 1: JJin91 (118942 in chips)=20
Seat 2: jbodey52 (54439 in chips)=20
Seat 4: DaBirds23 (32360 in chips)=20
Seat 5: tess1235 (73460 in chips)=20
Seat 6: pokernutt420 (39578 in chips)=20
JJin91: posts the ante 150
jbodey52: posts the ante 150
DaBirds23: posts the ante 150
tess1235: posts the ante 150
pokernutt420: posts the ante 150
DaBirds23: posts small blind 600
tess1235: posts big blind 1200
*** HOLE CARDS ***
Dealt to JJin91 [Ac 2h]
pokernutt420: raises 2400 to 3600
JJin91: folds=20
jbodey52: folds=20
DaBirds23: folds=20
tess1235: folds=20
Uncalled bet (2400) returned to pokernutt420
pokernutt420 collected 3750 from pot
pokernutt420: doesn't show hand=20
*** SUMMARY ***
Total pot 3750 | Rake 0=20
Seat 1: JJin91 folded before Flop (didn't bet)
Seat 2: jbodey52 (button) folded before Flop (didn't bet)
Seat 4: DaBirds23 (small blind) folded before Flop
Seat 5: tess1235 (big blind) folded before Flop
Seat 6: pokernutt420 collected (3750)


*********** # 244 **************
PokerStars Hand #169427874767: Tournament #1597684008, $13.50+$1.50 USD=
 Hold'em No Limit - Level XVI (600/1200) - 2017/05/05 16:26:06 ET
Table '1597684008 10' 6-max Seat #4 is the button
Seat 1: JJin91 (118792 in chips)=20
Seat 2: jbodey52 (54289 in chips)=20
Seat 4: DaBirds23 (31610 in chips)=20
Seat 5: tess1235 (72110 in chips)=20
Seat 6: pokernutt420 (41978 in chips)=20
JJin91: posts the ante 150
jbodey52: posts the ante 150
DaBirds23: posts the ante 150
tess1235: posts the ante 150
pokernutt420: posts the ante 150
tess1235: posts small blind 600
pokernutt420: posts big blind 1200
*** HOLE CARDS ***
Dealt to JJin91 [Th 4c]
JJin91: folds=20
jbodey52: folds=20
DaBirds23: raises 1200 to 2400
tess1235: folds=20
pokernutt420: folds=20
Uncalled bet (1200) returned to DaBirds23
DaBirds23 collected 3750 from pot
*** SUMMARY ***
Total pot 3750 | Rake 0=20
Seat 1: JJin91 folded before Flop (didn't bet)
Seat 2: jbodey52 folded before Flop (didn't bet)
Seat 4: DaBirds23 (button) collected (3750)
Seat 5: tess1235 (small blind) folded before Flop
Seat 6: pokernutt420 (big blind) folded before Flop


*********** # 245 **************
PokerStars Hand #169427874828: Tournament #1597684008, $13.50+$1.50 USD=
 Hold'em No Limit - Level XVI (600/1200) - 2017/05/05 16:26:29 ET
Table '1597684008 10' 6-max Seat #5 is the button
Seat 1: JJin91 (118642 in chips)=20
Seat 2: jbodey52 (54139 in chips)=20
Seat 4: DaBirds23 (34010 in chips)=20
Seat 5: tess1235 (71360 in chips)=20
Seat 6: pokernutt420 (40628 in chips)=20
JJin91: posts the ante 150
jbodey52: posts the ante 150
DaBirds23: posts the ante 150
tess1235: posts the ante 150
pokernutt420: posts the ante 150
pokernutt420: posts small blind 600
JJin91: posts big blind 1200
*** HOLE CARDS ***
Dealt to JJin91 [Ts 3s]
jbodey52: folds=20
DaBirds23: folds=20
tess1235: folds=20
pokernutt420: folds=20
Uncalled bet (600) returned to JJin91
JJin91 collected 1950 from pot
*** SUMMARY ***
Total pot 1950 | Rake 0=20
Seat 1: JJin91 (big blind) collected (1950)
Seat 2: jbodey52 folded before Flop (didn't bet)
Seat 4: DaBirds23 folded before Flop (didn't bet)
Seat 5: tess1235 (button) folded before Flop (didn't bet)
Seat 6: pokernutt420 (small blind) folded before Flop


*********** # 246 **************
PokerStars Hand #169427874883: Tournament #1597684008, $13.50+$1.50 USD=
 Hold'em No Limit - Level XVI (600/1200) - 2017/05/05 16:26:50 ET
Table '1597684008 10' 6-max Seat #6 is the button
Seat 1: JJin91 (119842 in chips)=20
Seat 2: jbodey52 (53989 in chips)=20
Seat 4: DaBirds23 (33860 in chips)=20
Seat 5: tess1235 (71210 in chips)=20
Seat 6: pokernutt420 (39878 in chips)=20
JJin91: posts the ante 150
jbodey52: posts the ante 150
DaBirds23: posts the ante 150
tess1235: posts the ante 150
pokernutt420: posts the ante 150
JJin91: posts small blind 600
jbodey52: posts big blind 1200
*** HOLE CARDS ***
Dealt to JJin91 [4c 2d]
DaBirds23: raises 1200 to 2400
tess1235: calls 2400
pokernutt420: folds=20
JJin91: folds=20
jbodey52: folds=20
*** FLOP *** [8d 4h 9h]
DaBirds23: bets 2646
tess1235: calls 2646
*** TURN *** [8d 4h 9h] [Td]
DaBirds23: checks=20
tess1235: checks=20
*** RIVER *** [8d 4h 9h Td] [Ac]
DaBirds23: checks=20
tess1235: bets 6321
DaBirds23: folds=20
Uncalled bet (6321) returned to tess1235
tess1235 collected 12642 from pot
tess1235: doesn't show hand=20
*** SUMMARY ***
Total pot 12642 | Rake 0=20
Board [8d 4h 9h Td Ac]
Seat 1: JJin91 (small blind) folded before Flop
Seat 2: jbodey52 (big blind) folded before Flop
Seat 4: DaBirds23 folded on the River
Seat 5: tess1235 collected (12642)
Seat 6: pokernutt420 (button) folded before Flop (didn't bet)


*********** # 247 **************
PokerStars Hand #169427875046: Tournament #1597684008, $13.50+$1.50 USD=
 Hold'em No Limit - Level XVI (600/1200) - 2017/05/05 16:27:51 ET
Table '1597684008 10' 6-max Seat #1 is the button
Seat 1: JJin91 (119092 in chips)=20
Seat 2: jbodey52 (52639 in chips)=20
Seat 4: DaBirds23 (28664 in chips)=20
Seat 5: tess1235 (78656 in chips)=20
Seat 6: pokernutt420 (39728 in chips)=20
JJin91: posts the ante 150
jbodey52: posts the ante 150
DaBirds23: posts the ante 150
tess1235: posts the ante 150
pokernutt420: posts the ante 150
jbodey52: posts small blind 600
DaBirds23: posts big blind 1200
*** HOLE CARDS ***
Dealt to JJin91 [Jh Tc]
tess1235: folds=20
pokernutt420: calls 1200
JJin91: calls 1200
jbodey52: calls 600
DaBirds23: checks=20
*** FLOP *** [As Jd 9d]
jbodey52: checks=20
DaBirds23: checks=20
pokernutt420: checks=20
JJin91: checks=20
*** TURN *** [As Jd 9d] [Kc]
jbodey52: checks=20
DaBirds23: checks=20
pokernutt420: checks=20
JJin91: bets 2180
jbodey52: raises 4945 to 7125
DaBirds23: folds=20
pokernutt420: folds=20
JJin91: calls 4945
*** RIVER *** [As Jd 9d Kc] [9h]
jbodey52: checks=20
JJin91: checks=20
*** SHOW DOWN ***
jbodey52: shows [Th Js] (two pair, Jacks and Nines)
JJin91: shows [Jh Tc] (two pair, Jacks and Nines)
jbodey52 collected 9900 from pot
JJin91 collected 9900 from pot
*** SUMMARY ***
Total pot 19800 | Rake 0=20
Board [As Jd 9d Kc 9h]
Seat 1: JJin91 (button) showed [Jh Tc] and won (9900) with two pair, Ja=
cks and Nines
Seat 2: jbodey52 (small blind) showed [Th Js] and won (9900) with two p=
air, Jacks and Nines
Seat 4: DaBirds23 (big blind) folded on the Turn
Seat 5: tess1235 folded before Flop (didn't bet)
Seat 6: pokernutt420 folded on the Turn


*********** # 248 **************
PokerStars Hand #169427875245: Tournament #1597684008, $13.50+$1.50 USD=
 Hold'em No Limit - Level XVII (700/1400) - 2017/05/05 16:29:07 ET
Table '1597684008 10' 6-max Seat #2 is the button
Seat 1: JJin91 (120517 in chips)=20
Seat 2: jbodey52 (54064 in chips)=20
Seat 4: DaBirds23 (27314 in chips)=20
Seat 5: tess1235 (78506 in chips)=20
Seat 6: pokernutt420 (38378 in chips)=20
JJin91: posts the ante 175
jbodey52: posts the ante 175
DaBirds23: posts the ante 175
tess1235: posts the ante 175
pokernutt420: posts the ante 175
DaBirds23: posts small blind 700
tess1235: posts big blind 1400
*** HOLE CARDS ***
Dealt to JJin91 [2c Kh]
pokernutt420: folds=20
JJin91: folds=20
jbodey52: raises 2100 to 3500
DaBirds23: raises 23639 to 27139 and is all-in
tess1235: folds=20
jbodey52: folds=20
Uncalled bet (23639) returned to DaBirds23
jbodey52 said, "aq off"
DaBirds23 collected 9275 from pot
*** SUMMARY ***
Total pot 9275 | Rake 0=20
Seat 1: JJin91 folded before Flop (didn't bet)
Seat 2: jbodey52 (button) folded before Flop
Seat 4: DaBirds23 (small blind) collected (9275)
Seat 5: tess1235 (big blind) folded before Flop
Seat 6: pokernutt420 folded before Flop (didn't bet)


*********** # 249 **************
PokerStars Hand #169427875363: Tournament #1597684008, $13.50+$1.50 USD=
 Hold'em No Limit - Level XVII (700/1400) - 2017/05/05 16:30:00 ET
Table '1597684008 10' 6-max Seat #4 is the button
Seat 1: JJin91 (120342 in chips)=20
Seat 2: jbodey52 (50389 in chips)=20
Seat 3: oceangurl2 (63190 in chips)=20
Seat 4: DaBirds23 (32914 in chips)=20
Seat 5: tess1235 (76931 in chips)=20
Seat 6: pokernutt420 (38203 in chips)=20
JJin91: posts the ante 175
jbodey52: posts the ante 175
oceangurl2: posts the ante 175
DaBirds23: posts the ante 175
tess1235: posts the ante 175
pokernutt420: posts the ante 175
tess1235: posts small blind 700
pokernutt420: posts big blind 1400
*** HOLE CARDS ***
Dealt to JJin91 [8d 5h]
JJin91: folds=20
jbodey52: folds=20
oceangurl2: folds=20
DaBirds23: folds=20
jbodey52 said, "only u birds"
tess1235: calls 700
pokernutt420: checks=20
*** FLOP *** [6h 6s 7s]
DaBirds23 said, "lol"
tess1235: bets 1925
jbodey52 said, "didnt wanna race"
pokernutt420: calls 1925
*** TURN *** [6h 6s 7s] [Ac]
tess1235: checks=20
pokernutt420: bets 4200
tess1235: folds=20
Uncalled bet (4200) returned to pokernutt420
pokernutt420 collected 7700 from pot
pokernutt420: doesn't show hand=20
jbodey52 said, "no ak right"
*** SUMMARY ***
Total pot 7700 | Rake 0=20
Board [6h 6s 7s Ac]
Seat 1: JJin91 folded before Flop (didn't bet)
Seat 2: jbodey52 folded before Flop (didn't bet)
Seat 3: oceangurl2 folded before Flop (didn't bet)
Seat 4: DaBirds23 (button) folded before Flop (didn't bet)
Seat 5: tess1235 (small blind) folded on the Turn
Seat 6: pokernutt420 (big blind) collected (7700)


*********** # 250 **************
PokerStars Hand #169427875408: Tournament #1597684008, $13.50+$1.50 USD=
 Hold'em No Limit - Level XVII (700/1400) - 2017/05/05 16:30:26 ET
Table '1597684008 10' 6-max Seat #5 is the button
Seat 1: JJin91 (120167 in chips)=20
Seat 2: jbodey52 (50214 in chips)=20
Seat 3: oceangurl2 (63015 in chips)=20
Seat 4: DaBirds23 (32739 in chips)=20
Seat 5: tess1235 (73431 in chips)=20
Seat 6: pokernutt420 (42403 in chips)=20
JJin91: posts the ante 175
jbodey52: posts the ante 175
oceangurl2: posts the ante 175
DaBirds23: posts the ante 175
tess1235: posts the ante 175
pokernutt420: posts the ante 175
pokernutt420: posts small blind 700
JJin91: posts big blind 1400
*** HOLE CARDS ***
Dealt to JJin91 [Qh 9c]
jbodey52: raises 2100 to 3500
oceangurl2: folds=20
DaBirds23: folds=20
tess1235: folds=20
pokernutt420: folds=20
JJin91: folds=20
Uncalled bet (2100) returned to jbodey52
jbodey52 collected 4550 from pot
jbodey52: doesn't show hand=20
*** SUMMARY ***
Total pot 4550 | Rake 0=20
Seat 1: JJin91 (big blind) folded before Flop
Seat 2: jbodey52 collected (4550)
Seat 3: oceangurl2 folded before Flop (didn't bet)
Seat 4: DaBirds23 folded before Flop (didn't bet)
Seat 5: tess1235 (button) folded before Flop (didn't bet)
Seat 6: pokernutt420 (small blind) folded before Flop


*********** # 251 **************
PokerStars Hand #169427875458: Tournament #1597684008, $13.50+$1.50 USD=
 Hold'em No Limit - Level XVII (700/1400) - 2017/05/05 16:30:45 ET
Table '1597684008 10' 6-max Seat #6 is the button
Seat 1: JJin91 (118592 in chips)=20
Seat 2: jbodey52 (53189 in chips)=20
Seat 3: oceangurl2 (62840 in chips)=20
Seat 4: DaBirds23 (32564 in chips)=20
Seat 5: tess1235 (73256 in chips)=20
Seat 6: pokernutt420 (41528 in chips)=20
JJin91: posts the ante 175
jbodey52: posts the ante 175
oceangurl2: posts the ante 175
DaBirds23: posts the ante 175
tess1235: posts the ante 175
pokernutt420: posts the ante 175
JJin91: posts small blind 700
jbodey52: posts big blind 1400
*** HOLE CARDS ***
Dealt to JJin91 [5d 2d]
oceangurl2: folds=20
DaBirds23: raises 1400 to 2800
tess1235: folds=20
pokernutt420: calls 2800
JJin91: folds=20
jbodey52 said, "gunna play all NJscopp events"
jbodey52 said, "u play omaha ?"
jbodey52: calls 1400
*** FLOP *** [3d Qs Qc]
DaBirds23 said, "i will tell u i didnt have ak"
jbodey52: checks=20
jbodey52 said, "ty"
DaBirds23: bets 3654
pokernutt420: folds=20
jbodey52: folds=20
Uncalled bet (3654) returned to DaBirds23
DaBirds23 collected 10150 from pot
*** SUMMARY ***
Total pot 10150 | Rake 0=20
Board [3d Qs Qc]
Seat 1: JJin91 (small blind) folded before Flop
Seat 2: jbodey52 (big blind) folded on the Flop
Seat 3: oceangurl2 folded before Flop (didn't bet)
Seat 4: DaBirds23 collected (10150)
Seat 5: tess1235 folded before Flop (didn't bet)
Seat 6: pokernutt420 (button) folded on the Flop


*********** # 252 **************
PokerStars Hand #169427875611: Tournament #1597684008, $13.50+$1.50 USD=
 Hold'em No Limit - Level XVII (700/1400) - 2017/05/05 16:31:52 ET
Table '1597684008 10' 6-max Seat #1 is the button
Seat 1: JJin91 (117717 in chips)=20
Seat 2: jbodey52 (50214 in chips)=20
Seat 3: oceangurl2 (62665 in chips)=20
Seat 4: DaBirds23 (39739 in chips)=20
Seat 5: tess1235 (73081 in chips)=20
Seat 6: pokernutt420 (38553 in chips)=20
JJin91: posts the ante 175
jbodey52: posts the ante 175
oceangurl2: posts the ante 175
DaBirds23: posts the ante 175
tess1235: posts the ante 175
pokernutt420: posts the ante 175
jbodey52: posts small blind 700
oceangurl2: posts big blind 1400
*** HOLE CARDS ***
Dealt to JJin91 [7d 2s]
DaBirds23 said, "yeah ill play almost everything"
DaBirds23: folds=20
tess1235: folds=20
jbodey52 said, "nice"
pokernutt420: raises 1400 to 2800
JJin91: folds=20
jbodey52 said, "u are doing well 2016"
jbodey52 said, "how bout 2017"
jbodey52 said, "u killing thus far ?"
jbodey52: raises 46900 to 49700
oceangurl2: folds=20
pokernutt420: folds=20
Uncalled bet (46900) returned to jbodey52
jbodey52 collected 8050 from pot
jbodey52: doesn't show hand=20
*** SUMMARY ***
Total pot 8050 | Rake 0=20
Seat 1: JJin91 (button) folded before Flop (didn't bet)
Seat 2: jbodey52 (small blind) collected (8050)
Seat 3: oceangurl2 (big blind) folded before Flop
Seat 4: DaBirds23 folded before Flop (didn't bet)
Seat 5: tess1235 folded before Flop (didn't bet)
Seat 6: pokernutt420 folded before Flop


*********** # 253 **************
PokerStars Hand #169427875700: Tournament #1597684008, $13.50+$1.50 USD=
 Hold'em No Limit - Level XVII (700/1400) - 2017/05/05 16:32:31 ET
Table '1597684008 10' 6-max Seat #2 is the button
Seat 1: JJin91 (117542 in chips)=20
Seat 2: jbodey52 (55289 in chips)=20
Seat 3: oceangurl2 (61090 in chips)=20
Seat 4: DaBirds23 (39564 in chips)=20
Seat 5: tess1235 (72906 in chips)=20
Seat 6: pokernutt420 (35578 in chips)=20
JJin91: posts the ante 175
jbodey52: posts the ante 175
oceangurl2: posts the ante 175
DaBirds23: posts the ante 175
tess1235: posts the ante 175
pokernutt420: posts the ante 175
oceangurl2: posts small blind 700
DaBirds23: posts big blind 1400
*** HOLE CARDS ***
Dealt to JJin91 [9s 6d]
tess1235: folds=20
pokernutt420: folds=20
JJin91: folds=20
jbodey52: raises 1725 to 3125
oceangurl2: folds=20
DaBirds23: folds=20
Uncalled bet (1725) returned to jbodey52
jbodey52 collected 4550 from pot
jbodey52: doesn't show hand=20
*** SUMMARY ***
Total pot 4550 | Rake 0=20
Seat 1: JJin91 folded before Flop (didn't bet)
Seat 2: jbodey52 (button) collected (4550)
Seat 3: oceangurl2 (small blind) folded before Flop
Seat 4: DaBirds23 (big blind) folded before Flop
Seat 5: tess1235 folded before Flop (didn't bet)
Seat 6: pokernutt420 folded before Flop (didn't bet)


*********** # 254 **************
PokerStars Hand #169427875754: Tournament #1597684008, $13.50+$1.50 USD=
 Hold'em No Limit - Level XVII (700/1400) - 2017/05/05 16:32:55 ET
Table '1597684008 10' 6-max Seat #3 is the button
Seat 1: JJin91 (117367 in chips)=20
Seat 2: jbodey52 (58264 in chips)=20
Seat 3: oceangurl2 (60215 in chips)=20
Seat 4: DaBirds23 (37989 in chips)=20
Seat 5: tess1235 (72731 in chips)=20
Seat 6: pokernutt420 (35403 in chips)=20
JJin91: posts the ante 175
jbodey52: posts the ante 175
oceangurl2: posts the ante 175
DaBirds23: posts the ante 175
tess1235: posts the ante 175
pokernutt420: posts the ante 175
DaBirds23: posts small blind 700
tess1235: posts big blind 1400
*** HOLE CARDS ***
Dealt to JJin91 [Qh 9c]
pokernutt420: folds=20
JJin91: folds=20
jbodey52: folds=20
oceangurl2: folds=20
DaBirds23: raises 1876 to 3276
tess1235: calls 1876
*** FLOP *** [9d 5d Jh]
DaBirds23: checks=20
tess1235: bets 3801
DaBirds23: folds=20
Uncalled bet (3801) returned to tess1235
tess1235 collected 7602 from pot
tess1235: doesn't show hand=20
*** SUMMARY ***
Total pot 7602 | Rake 0=20
Board [9d 5d Jh]
Seat 1: JJin91 folded before Flop (didn't bet)
Seat 2: jbodey52 folded before Flop (didn't bet)
Seat 3: oceangurl2 (button) folded before Flop (didn't bet)
Seat 4: DaBirds23 (small blind) folded on the Flop
Seat 5: tess1235 (big blind) collected (7602)
Seat 6: pokernutt420 folded before Flop (didn't bet)


*********** # 255 **************
PokerStars Hand #169427875830: Tournament #1597684008, $13.50+$1.50 USD=
 Hold'em No Limit - Level XVII (700/1400) - 2017/05/05 16:33:29 ET
Table '1597684008 10' 6-max Seat #4 is the button
Seat 1: JJin91 (117192 in chips)=20
Seat 2: jbodey52 (58089 in chips)=20
Seat 3: oceangurl2 (60040 in chips)=20
Seat 4: DaBirds23 (34538 in chips)=20
Seat 5: tess1235 (76882 in chips)=20
Seat 6: pokernutt420 (35228 in chips)=20
JJin91: posts the ante 175
jbodey52: posts the ante 175
oceangurl2: posts the ante 175
DaBirds23: posts the ante 175
tess1235: posts the ante 175
pokernutt420: posts the ante 175
tess1235: posts small blind 700
pokernutt420: posts big blind 1400
*** HOLE CARDS ***
Dealt to JJin91 [6c 4s]
JJin91: folds=20
jbodey52: raises 1725 to 3125
oceangurl2: folds=20
DaBirds23: folds=20
tess1235: folds=20
pokernutt420: folds=20
Uncalled bet (1725) returned to jbodey52
jbodey52 collected 4550 from pot
jbodey52: doesn't show hand=20
*** SUMMARY ***
Total pot 4550 | Rake 0=20
Seat 1: JJin91 folded before Flop (didn't bet)
Seat 2: jbodey52 collected (4550)
Seat 3: oceangurl2 folded before Flop (didn't bet)
Seat 4: DaBirds23 (button) folded before Flop (didn't bet)
Seat 5: tess1235 (small blind) folded before Flop
Seat 6: pokernutt420 (big blind) folded before Flop


*********** # 256 **************
PokerStars Hand #169427875869: Tournament #1597684008, $13.50+$1.50 USD=
 Hold'em No Limit - Level XVII (700/1400) - 2017/05/05 16:33:48 ET
Table '1597684008 10' 6-max Seat #5 is the button
Seat 1: JJin91 (117017 in chips)=20
Seat 2: jbodey52 (61064 in chips)=20
Seat 3: oceangurl2 (59865 in chips)=20
Seat 4: DaBirds23 (34363 in chips)=20
Seat 5: tess1235 (76007 in chips)=20
Seat 6: pokernutt420 (33653 in chips)=20
JJin91: posts the ante 175
jbodey52: posts the ante 175
oceangurl2: posts the ante 175
DaBirds23: posts the ante 175
tess1235: posts the ante 175
pokernutt420: posts the ante 175
pokernutt420: posts small blind 700
JJin91: posts big blind 1400
*** HOLE CARDS ***
Dealt to JJin91 [6h 8c]
jbodey52: folds=20
oceangurl2: folds=20
DaBirds23: folds=20
tess1235: folds=20
pokernutt420: folds=20
Uncalled bet (700) returned to JJin91
JJin91 collected 2450 from pot
*** SUMMARY ***
Total pot 2450 | Rake 0=20
Seat 1: JJin91 (big blind) collected (2450)
Seat 2: jbodey52 folded before Flop (didn't bet)
Seat 3: oceangurl2 folded before Flop (didn't bet)
Seat 4: DaBirds23 folded before Flop (didn't bet)
Seat 5: tess1235 (button) folded before Flop (didn't bet)
Seat 6: pokernutt420 (small blind) folded before Flop


*********** # 257 **************
PokerStars Hand #169427875918: Tournament #1597684008, $13.50+$1.50 USD=
 Hold'em No Limit - Level XVII (700/1400) - 2017/05/05 16:34:09 ET
Table '1597684008 10' 6-max Seat #6 is the button
Seat 1: JJin91 (118592 in chips)=20
Seat 2: jbodey52 (60889 in chips)=20
Seat 3: oceangurl2 (59690 in chips)=20
Seat 4: DaBirds23 (34188 in chips)=20
Seat 5: tess1235 (75832 in chips)=20
Seat 6: pokernutt420 (32778 in chips)=20
JJin91: posts the ante 175
jbodey52: posts the ante 175
oceangurl2: posts the ante 175
DaBirds23: posts the ante 175
tess1235: posts the ante 175
pokernutt420: posts the ante 175
JJin91: posts small blind 700
jbodey52: posts big blind 1400
*** HOLE CARDS ***
Dealt to JJin91 [Js Ks]
oceangurl2: folds=20
DaBirds23: folds=20
tess1235: calls 1400
pokernutt420: calls 1400
JJin91: raises 2858 to 4258
jbodey52: folds=20
tess1235: folds=20
pokernutt420: calls 2858
*** FLOP *** [Qc Qs Td]
JJin91: checks=20
pokernutt420: checks=20
*** TURN *** [Qc Qs Td] [Jd]
JJin91: checks=20
pokernutt420: checks=20
*** RIVER *** [Qc Qs Td Jd] [7h]
JJin91: checks=20
pokernutt420: checks=20
*** SHOW DOWN ***
JJin91: shows [Js Ks] (two pair, Queens and Jacks)
pokernutt420: shows [Jh Kh] (two pair, Queens and Jacks)
JJin91 collected 6183 from pot
pokernutt420 collected 6183 from pot
*** SUMMARY ***
Total pot 12366 | Rake 0=20
Board [Qc Qs Td Jd 7h]
Seat 1: JJin91 (small blind) showed [Js Ks] and won (6183) with two pai=
r, Queens and Jacks
Seat 2: jbodey52 (big blind) folded before Flop
Seat 3: oceangurl2 folded before Flop (didn't bet)
Seat 4: DaBirds23 folded before Flop (didn't bet)
Seat 5: tess1235 folded before Flop
Seat 6: pokernutt420 (button) showed [Jh Kh] and won (6183) with two pa=
ir, Queens and Jacks


*********** # 258 **************
PokerStars Hand #169427876054: Tournament #1597684008, $13.50+$1.50 USD=
 Hold'em No Limit - Level XVII (700/1400) - 2017/05/05 16:35:08 ET
Table '1597684008 10' 6-max Seat #1 is the button
Seat 1: JJin91 (120342 in chips)=20
Seat 2: jbodey52 (59314 in chips)=20
Seat 3: oceangurl2 (59515 in chips)=20
Seat 4: DaBirds23 (34013 in chips)=20
Seat 5: tess1235 (74257 in chips)=20
Seat 6: pokernutt420 (34528 in chips)=20
JJin91: posts the ante 175
jbodey52: posts the ante 175
oceangurl2: posts the ante 175
DaBirds23: posts the ante 175
tess1235: posts the ante 175
pokernutt420: posts the ante 175
jbodey52: posts small blind 700
oceangurl2: posts big blind 1400
*** HOLE CARDS ***
Dealt to JJin91 [Ts Qd]
DaBirds23: folds=20
tess1235: folds=20
pokernutt420: folds=20
JJin91: calls 1400
jbodey52: calls 700
oceangurl2: checks=20
*** FLOP *** [6d 5c Jd]
jbodey52: checks=20
oceangurl2: checks=20
JJin91: checks=20
*** TURN *** [6d 5c Jd] [Jc]
jbodey52: checks=20
oceangurl2: checks=20
JJin91: bets 2632
jbodey52: folds=20
oceangurl2: folds=20
Uncalled bet (2632) returned to JJin91
JJin91 collected 5250 from pot
*** SUMMARY ***
Total pot 5250 | Rake 0=20
Board [6d 5c Jd Jc]
Seat 1: JJin91 (button) collected (5250)
Seat 2: jbodey52 (small blind) folded on the Turn
Seat 3: oceangurl2 (big blind) folded on the Turn
Seat 4: DaBirds23 folded before Flop (didn't bet)
Seat 5: tess1235 folded before Flop (didn't bet)
Seat 6: pokernutt420 folded before Flop (didn't bet)


*********** # 259 **************
PokerStars Hand #169427876250: Tournament #1597684008, $13.50+$1.50 USD=
 Hold'em No Limit - Level XVII (700/1400) - 2017/05/05 16:36:08 ET
Table '1597684008 10' 6-max Seat #2 is the button
Seat 1: JJin91 (124017 in chips)=20
Seat 2: jbodey52 (57739 in chips)=20
Seat 3: oceangurl2 (57940 in chips)=20
Seat 4: DaBirds23 (33838 in chips)=20
Seat 5: tess1235 (74082 in chips)=20
Seat 6: pokernutt420 (34353 in chips)=20
JJin91: posts the ante 175
jbodey52: posts the ante 175
oceangurl2: posts the ante 175
DaBirds23: posts the ante 175
tess1235: posts the ante 175
pokernutt420: posts the ante 175
oceangurl2: posts small blind 700
DaBirds23: posts big blind 1400
*** HOLE CARDS ***
Dealt to JJin91 [Qh 9h]
tess1235: folds=20
pokernutt420: folds=20
JJin91: raises 1625 to 3025
jbodey52: calls 3025
oceangurl2: folds=20
DaBirds23: calls 1625
*** FLOP *** [Td 4c 2d]
DaBirds23: checks=20
JJin91: checks=20
jbodey52: bets 5400
DaBirds23: folds=20
JJin91: folds=20
Uncalled bet (5400) returned to jbodey52
jbodey52 collected 10825 from pot
jbodey52: doesn't show hand=20
*** SUMMARY ***
Total pot 10825 | Rake 0=20
Board [Td 4c 2d]
Seat 1: JJin91 folded on the Flop
Seat 2: jbodey52 (button) collected (10825)
Seat 3: oceangurl2 (small blind) folded before Flop
Seat 4: DaBirds23 (big blind) folded on the Flop
Seat 5: tess1235 folded before Flop (didn't bet)
Seat 6: pokernutt420 folded before Flop (didn't bet)


*********** # 260 **************
PokerStars Hand #169427876406: Tournament #1597684008, $13.50+$1.50 USD=
 Hold'em No Limit - Level XVII (700/1400) - 2017/05/05 16:37:00 ET
Table '1597684008 10' 6-max Seat #3 is the button
Seat 1: JJin91 (120817 in chips)=20
Seat 2: jbodey52 (65364 in chips)=20
Seat 3: oceangurl2 (57065 in chips)=20
Seat 4: DaBirds23 (30638 in chips)=20
Seat 5: tess1235 (73907 in chips)=20
Seat 6: pokernutt420 (34178 in chips)=20
JJin91: posts the ante 175
jbodey52: posts the ante 175
oceangurl2: posts the ante 175
DaBirds23: posts the ante 175
tess1235: posts the ante 175
pokernutt420: posts the ante 175
DaBirds23: posts small blind 700
tess1235: posts big blind 1400
*** HOLE CARDS ***
Dealt to JJin91 [4d 3h]
pokernutt420: folds=20
JJin91: folds=20
jbodey52: raises 2100 to 3500
oceangurl2: folds=20
DaBirds23: folds=20
tess1235: folds=20
Uncalled bet (2100) returned to jbodey52
jbodey52 collected 4550 from pot
jbodey52: doesn't show hand=20
*** SUMMARY ***
Total pot 4550 | Rake 0=20
Seat 1: JJin91 folded before Flop (didn't bet)
Seat 2: jbodey52 collected (4550)
Seat 3: oceangurl2 (button) folded before Flop (didn't bet)
Seat 4: DaBirds23 (small blind) folded before Flop
Seat 5: tess1235 (big blind) folded before Flop
Seat 6: pokernutt420 folded before Flop (didn't bet)


*********** # 261 **************
PokerStars Hand #169427876490: Tournament #1597684008, $13.50+$1.50 USD=
 Hold'em No Limit - Level XVII (700/1400) - 2017/05/05 16:37:27 ET
Table '1597684008 10' 6-max Seat #4 is the button
Seat 1: JJin91 (120642 in chips)=20
Seat 2: jbodey52 (68339 in chips)=20
Seat 3: oceangurl2 (56890 in chips)=20
Seat 4: DaBirds23 (29763 in chips)=20
Seat 5: tess1235 (72332 in chips)=20
Seat 6: pokernutt420 (34003 in chips)=20
JJin91: posts the ante 175
jbodey52: posts the ante 175
oceangurl2: posts the ante 175
DaBirds23: posts the ante 175
tess1235: posts the ante 175
pokernutt420: posts the ante 175
tess1235: posts small blind 700
pokernutt420: posts big blind 1400
*** HOLE CARDS ***
Dealt to JJin91 [2d Ad]
JJin91: raises 1652 to 3052
jbodey52: folds=20
oceangurl2: folds=20
DaBirds23: folds=20
tess1235: folds=20
pokernutt420: folds=20
Uncalled bet (1652) returned to JJin91
JJin91 collected 4550 from pot
*** SUMMARY ***
Total pot 4550 | Rake 0=20
Seat 1: JJin91 collected (4550)
Seat 2: jbodey52 folded before Flop (didn't bet)
Seat 3: oceangurl2 folded before Flop (didn't bet)
Seat 4: DaBirds23 (button) folded before Flop (didn't bet)
Seat 5: tess1235 (small blind) folded before Flop
Seat 6: pokernutt420 (big blind) folded before Flop


*********** # 262 **************
PokerStars Hand #169427876563: Tournament #1597684008, $13.50+$1.50 USD=
 Hold'em No Limit - Level XVII (700/1400) - 2017/05/05 16:37:51 ET
Table '1597684008 10' 6-max Seat #5 is the button
Seat 1: JJin91 (123617 in chips)=20
Seat 2: jbodey52 (68164 in chips)=20
Seat 3: oceangurl2 (56715 in chips)=20
Seat 4: DaBirds23 (29588 in chips)=20
Seat 5: tess1235 (71457 in chips)=20
Seat 6: pokernutt420 (32428 in chips)=20
JJin91: posts the ante 175
jbodey52: posts the ante 175
oceangurl2: posts the ante 175
DaBirds23: posts the ante 175
tess1235: posts the ante 175
pokernutt420: posts the ante 175
pokernutt420: posts small blind 700
JJin91: posts big blind 1400
*** HOLE CARDS ***
Dealt to JJin91 [9h Ah]
jbodey52: folds=20
oceangurl2: folds=20
DaBirds23: folds=20
tess1235: folds=20
pokernutt420: folds=20
Uncalled bet (700) returned to JJin91
JJin91 collected 2450 from pot
*** SUMMARY ***
Total pot 2450 | Rake 0=20
Seat 1: JJin91 (big blind) collected (2450)
Seat 2: jbodey52 folded before Flop (didn't bet)
Seat 3: oceangurl2 folded before Flop (didn't bet)
Seat 4: DaBirds23 folded before Flop (didn't bet)
Seat 5: tess1235 (button) folded before Flop (didn't bet)
Seat 6: pokernutt420 (small blind) folded before Flop


*********** # 263 **************
PokerStars Hand #169427876598: Tournament #1597684008, $13.50+$1.50 USD=
 Hold'em No Limit - Level XVII (700/1400) - 2017/05/05 16:38:05 ET
Table '1597684008 10' 6-max Seat #6 is the button
Seat 1: JJin91 (125192 in chips)=20
Seat 2: jbodey52 (67989 in chips)=20
Seat 3: oceangurl2 (56540 in chips)=20
Seat 4: DaBirds23 (29413 in chips)=20
Seat 5: tess1235 (71282 in chips)=20
Seat 6: pokernutt420 (31553 in chips)=20
JJin91: posts the ante 175
jbodey52: posts the ante 175
oceangurl2: posts the ante 175
DaBirds23: posts the ante 175
tess1235: posts the ante 175
pokernutt420: posts the ante 175
JJin91: posts small blind 700
jbodey52: posts big blind 1400
*** HOLE CARDS ***
Dealt to JJin91 [Qh 6c]
oceangurl2: folds=20
DaBirds23: folds=20
tess1235: calls 1400
pokernutt420: folds=20
JJin91: folds=20
jbodey52: checks=20
*** FLOP *** [Ah 2c Qc]
jbodey52: checks=20
tess1235: bets 4550
jbodey52: folds [8c 3c]
Uncalled bet (4550) returned to tess1235
tess1235 collected 4550 from pot
tess1235: doesn't show hand=20
*** SUMMARY ***
Total pot 4550 | Rake 0=20
Board [Ah 2c Qc]
Seat 1: JJin91 (small blind) folded before Flop
Seat 2: jbodey52 (big blind) folded on the Flop
Seat 3: oceangurl2 folded before Flop (didn't bet)
Seat 4: DaBirds23 folded before Flop (didn't bet)
Seat 5: tess1235 collected (4550)
Seat 6: pokernutt420 (button) folded before Flop (didn't bet)


*********** # 264 **************
PokerStars Hand #169427876736: Tournament #1597684008, $13.50+$1.50 USD=
 Hold'em No Limit - Level XVIII (800/1600) - 2017/05/05 16:38:49 ET
Table '1597684008 10' 6-max Seat #1 is the button
Seat 1: JJin91 (124317 in chips)=20
Seat 2: jbodey52 (66414 in chips)=20
Seat 3: oceangurl2 (56365 in chips)=20
Seat 4: DaBirds23 (29238 in chips)=20
Seat 5: tess1235 (74257 in chips)=20
Seat 6: pokernutt420 (31378 in chips)=20
JJin91: posts the ante 200
jbodey52: posts the ante 200
oceangurl2: posts the ante 200
DaBirds23: posts the ante 200
tess1235: posts the ante 200
pokernutt420: posts the ante 200
jbodey52: posts small blind 800
oceangurl2: posts big blind 1600
*** HOLE CARDS ***
Dealt to JJin91 [Jc 5c]
DaBirds23: folds=20
tess1235: folds=20
pokernutt420: folds=20
JJin91: folds=20
jbodey52: calls 800
oceangurl2: checks=20
*** FLOP *** [Kh Ac 8c]
jbodey52: bets 2125
oceangurl2: folds=20
Uncalled bet (2125) returned to jbodey52
jbodey52 collected 4400 from pot
jbodey52: doesn't show hand=20
*** SUMMARY ***
Total pot 4400 | Rake 0=20
Board [Kh Ac 8c]
Seat 1: JJin91 (button) folded before Flop (didn't bet)
Seat 2: jbodey52 (small blind) collected (4400)
Seat 3: oceangurl2 (big blind) folded on the Flop
Seat 4: DaBirds23 folded before Flop (didn't bet)
Seat 5: tess1235 folded before Flop (didn't bet)
Seat 6: pokernutt420 folded before Flop (didn't bet)


*********** # 265 **************
PokerStars Hand #169427876842: Tournament #1597684008, $13.50+$1.50 USD=
 Hold'em No Limit - Level XVIII (800/1600) - 2017/05/05 16:39:23 ET
Table '1597684008 10' 6-max Seat #2 is the button
Seat 1: JJin91 (124117 in chips)=20
Seat 2: jbodey52 (69014 in chips)=20
Seat 3: oceangurl2 (54565 in chips)=20
Seat 4: DaBirds23 (29038 in chips)=20
Seat 5: tess1235 (74057 in chips)=20
Seat 6: pokernutt420 (31178 in chips)=20
JJin91: posts the ante 200
jbodey52: posts the ante 200
oceangurl2: posts the ante 200
DaBirds23: posts the ante 200
tess1235: posts the ante 200
pokernutt420: posts the ante 200
oceangurl2: posts small blind 800
DaBirds23: posts big blind 1600
*** HOLE CARDS ***
Dealt to JJin91 [Jd Qh]
tess1235: folds=20
pokernutt420: folds=20
JJin91: raises 1956 to 3556
jbodey52: folds=20
oceangurl2: calls 2756
DaBirds23: folds=20
*** FLOP *** [2d 9d 9s]
oceangurl2: bets 6400
JJin91: calls 6400
*** TURN *** [2d 9d 9s] [3h]
oceangurl2: bets 44409 and is all-in
JJin91: folds=20
Uncalled bet (44409) returned to oceangurl2
oceangurl2 collected 22712 from pot
oceangurl2: doesn't show hand=20
*** SUMMARY ***
Total pot 22712 | Rake 0=20
Board [2d 9d 9s 3h]
Seat 1: JJin91 folded on the Turn
Seat 2: jbodey52 (button) folded before Flop (didn't bet)
Seat 3: oceangurl2 (small blind) collected (22712)
Seat 4: DaBirds23 (big blind) folded before Flop
Seat 5: tess1235 folded before Flop (didn't bet)
Seat 6: pokernutt420 folded before Flop (didn't bet)


*********** # 266 **************
PokerStars Hand #169427876976: Tournament #1597684008, $13.50+$1.50 USD=
 Hold'em No Limit - Level XVIII (800/1600) - 2017/05/05 16:40:15 ET
Table '1597684008 10' 6-max Seat #3 is the button
Seat 1: JJin91 (113961 in chips)=20
Seat 2: jbodey52 (68814 in chips)=20
Seat 3: oceangurl2 (67121 in chips)=20
Seat 4: DaBirds23 (27238 in chips)=20
Seat 5: tess1235 (73857 in chips)=20
Seat 6: pokernutt420 (30978 in chips)=20
JJin91: posts the ante 200
jbodey52: posts the ante 200
oceangurl2: posts the ante 200
DaBirds23: posts the ante 200
tess1235: posts the ante 200
pokernutt420: posts the ante 200
DaBirds23: posts small blind 800
tess1235: posts big blind 1600
*** HOLE CARDS ***
Dealt to JJin91 [6s 4d]
pokernutt420: folds=20
JJin91: folds=20
jbodey52: folds=20
oceangurl2: folds=20
DaBirds23: folds=20
Uncalled bet (800) returned to tess1235
tess1235 collected 2800 from pot
tess1235: doesn't show hand=20
*** SUMMARY ***
Total pot 2800 | Rake 0=20
Seat 1: JJin91 folded before Flop (didn't bet)
Seat 2: jbodey52 folded before Flop (didn't bet)
Seat 3: oceangurl2 (button) folded before Flop (didn't bet)
Seat 4: DaBirds23 (small blind) folded before Flop
Seat 5: tess1235 (big blind) collected (2800)
Seat 6: pokernutt420 folded before Flop (didn't bet)


*********** # 267 **************
PokerStars Hand #169427877051: Tournament #1597684008, $13.50+$1.50 USD=
 Hold'em No Limit - Level XVIII (800/1600) - 2017/05/05 16:40:43 ET
Table '1597684008 10' 6-max Seat #4 is the button
Seat 1: JJin91 (113761 in chips)=20
Seat 2: jbodey52 (68614 in chips)=20
Seat 3: oceangurl2 (66921 in chips)=20
Seat 4: DaBirds23 (26238 in chips)=20
Seat 5: tess1235 (75657 in chips)=20
Seat 6: pokernutt420 (30778 in chips)=20
JJin91: posts the ante 200
jbodey52: posts the ante 200
oceangurl2: posts the ante 200
DaBirds23: posts the ante 200
tess1235: posts the ante 200
pokernutt420: posts the ante 200
tess1235: posts small blind 800
pokernutt420: posts big blind 1600
*** HOLE CARDS ***
Dealt to JJin91 [Js 4s]
JJin91: folds=20
jbodey52: raises 2200 to 3800
oceangurl2: folds=20
DaBirds23: folds=20
tess1235: folds=20
pokernutt420: folds=20
Uncalled bet (2200) returned to jbodey52
jbodey52 collected 5200 from pot
jbodey52: doesn't show hand=20
*** SUMMARY ***
Total pot 5200 | Rake 0=20
Seat 1: JJin91 folded before Flop (didn't bet)
Seat 2: jbodey52 collected (5200)
Seat 3: oceangurl2 folded before Flop (didn't bet)
Seat 4: DaBirds23 (button) folded before Flop (didn't bet)
Seat 5: tess1235 (small blind) folded before Flop
Seat 6: pokernutt420 (big blind) folded before Flop


*********** # 268 **************
PokerStars Hand #169427877142: Tournament #1597684008, $13.50+$1.50 USD=
 Hold'em No Limit - Level XVIII (800/1600) - 2017/05/05 16:41:19 ET
Table '1597684008 10' 6-max Seat #5 is the button
Seat 1: JJin91 (113561 in chips)=20
Seat 2: jbodey52 (72014 in chips)=20
Seat 3: oceangurl2 (66721 in chips)=20
Seat 4: DaBirds23 (26038 in chips)=20
Seat 5: tess1235 (74657 in chips)=20
Seat 6: pokernutt420 (28978 in chips)=20
JJin91: posts the ante 200
jbodey52: posts the ante 200
oceangurl2: posts the ante 200
DaBirds23: posts the ante 200
tess1235: posts the ante 200
pokernutt420: posts the ante 200
pokernutt420: posts small blind 800
JJin91: posts big blind 1600
*** HOLE CARDS ***
Dealt to JJin91 [Ad 6h]
jbodey52: folds=20
oceangurl2: folds=20
DaBirds23: folds=20
tess1235: folds=20
pokernutt420: calls 800
JJin91: checks=20
*** FLOP *** [7c 8d 7d]
pokernutt420: checks=20
JJin91: bets 1985
pokernutt420: calls 1985
*** TURN *** [7c 8d 7d] [9c]
pokernutt420: checks=20
JJin91: bets 4852
pokernutt420: calls 4852
*** RIVER *** [7c 8d 7d 9c] [7s]
pokernutt420: checks=20
JJin91: bets 104924 and is all-in
pokernutt420: folds=20
Uncalled bet (104924) returned to JJin91
JJin91 collected 18074 from pot
*** SUMMARY ***
Total pot 18074 | Rake 0=20
Board [7c 8d 7d 9c 7s]
Seat 1: JJin91 (big blind) collected (18074)
Seat 2: jbodey52 folded before Flop (didn't bet)
Seat 3: oceangurl2 folded before Flop (didn't bet)
Seat 4: DaBirds23 folded before Flop (didn't bet)
Seat 5: tess1235 (button) folded before Flop (didn't bet)
Seat 6: pokernutt420 (small blind) folded on the River


*********** # 269 **************
PokerStars Hand #169427877307: Tournament #1597684008, $13.50+$1.50 USD=
 Hold'em No Limit - Level XVIII (800/1600) - 2017/05/05 16:42:26 ET
Table '1597684008 10' 6-max Seat #6 is the button
Seat 1: JJin91 (122998 in chips)=20
Seat 2: jbodey52 (71814 in chips)=20
Seat 3: oceangurl2 (66521 in chips)=20
Seat 4: DaBirds23 (25838 in chips)=20
Seat 5: tess1235 (74457 in chips)=20
Seat 6: pokernutt420 (20341 in chips)=20
JJin91: posts the ante 200
jbodey52: posts the ante 200
oceangurl2: posts the ante 200
DaBirds23: posts the ante 200
tess1235: posts the ante 200
pokernutt420: posts the ante 200
JJin91: posts small blind 800
jbodey52: posts big blind 1600
*** HOLE CARDS ***
Dealt to JJin91 [7d 7c]
oceangurl2: folds=20
DaBirds23: folds=20
tess1235: folds=20
pokernutt420: folds=20
JJin91: calls 800
jbodey52: checks=20
*** FLOP *** [3h 2c Ac]
JJin91: bets 3528
jbodey52: folds=20
Uncalled bet (3528) returned to JJin91
JJin91 collected 4400 from pot
*** SUMMARY ***
Total pot 4400 | Rake 0=20
Board [3h 2c Ac]
Seat 1: JJin91 (small blind) collected (4400)
Seat 2: jbodey52 (big blind) folded on the Flop
Seat 3: oceangurl2 folded before Flop (didn't bet)
Seat 4: DaBirds23 folded before Flop (didn't bet)
Seat 5: tess1235 folded before Flop (didn't bet)
Seat 6: pokernutt420 (button) folded before Flop (didn't bet)


*********** # 270 **************
PokerStars Hand #169427877407: Tournament #1597684008, $13.50+$1.50 USD=
 Hold'em No Limit - Level XVIII (800/1600) - 2017/05/05 16:43:03 ET
Table '1597684008 10' 6-max Seat #1 is the button
Seat 1: JJin91 (125598 in chips)=20
Seat 2: jbodey52 (70014 in chips)=20
Seat 3: oceangurl2 (66321 in chips)=20
Seat 4: DaBirds23 (25638 in chips)=20
Seat 5: tess1235 (74257 in chips)=20
Seat 6: pokernutt420 (20141 in chips)=20
JJin91: posts the ante 200
jbodey52: posts the ante 200
oceangurl2: posts the ante 200
DaBirds23: posts the ante 200
tess1235: posts the ante 200
pokernutt420: posts the ante 200
jbodey52: posts small blind 800
oceangurl2: posts big blind 1600
*** HOLE CARDS ***
Dealt to JJin91 [5s Kc]
DaBirds23: folds=20
tess1235: calls 1600
pokernutt420: folds=20
JJin91: folds=20
jbodey52: calls 800
oceangurl2: checks=20
*** FLOP *** [Ac 5d Jc]
jbodey52: checks=20
oceangurl2: checks=20
tess1235: bets 6000
jbodey52: folds=20
oceangurl2: folds=20
Uncalled bet (6000) returned to tess1235
tess1235 collected 6000 from pot
tess1235: doesn't show hand=20
*** SUMMARY ***
Total pot 6000 | Rake 0=20
Board [Ac 5d Jc]
Seat 1: JJin91 (button) folded before Flop (didn't bet)
Seat 2: jbodey52 (small blind) folded on the Flop
Seat 3: oceangurl2 (big blind) folded on the Flop
Seat 4: DaBirds23 folded before Flop (didn't bet)
Seat 5: tess1235 collected (6000)
Seat 6: pokernutt420 folded before Flop (didn't bet)


*********** # 271 **************
PokerStars Hand #169427877565: Tournament #1597684008, $13.50+$1.50 USD=
 Hold'em No Limit - Level XVIII (800/1600) - 2017/05/05 16:43:56 ET
Table '1597684008 10' 6-max Seat #2 is the button
Seat 1: JJin91 (125398 in chips)=20
Seat 2: jbodey52 (68214 in chips)=20
Seat 3: oceangurl2 (64521 in chips)=20
Seat 4: DaBirds23 (25438 in chips)=20
Seat 5: tess1235 (78457 in chips)=20
Seat 6: pokernutt420 (19941 in chips)=20
JJin91: posts the ante 200
jbodey52: posts the ante 200
oceangurl2: posts the ante 200
DaBirds23: posts the ante 200
tess1235: posts the ante 200
pokernutt420: posts the ante 200
oceangurl2: posts small blind 800
DaBirds23: posts big blind 1600
*** HOLE CARDS ***
Dealt to JJin91 [4d 9h]
tess1235: folds=20
pokernutt420: folds=20
JJin91: folds=20
jbodey52: raises 2400 to 4000
oceangurl2: folds=20
DaBirds23: folds=20
Uncalled bet (2400) returned to jbodey52
jbodey52 collected 5200 from pot
jbodey52: doesn't show hand=20
*** SUMMARY ***
Total pot 5200 | Rake 0=20
Seat 1: JJin91 folded before Flop (didn't bet)
Seat 2: jbodey52 (button) collected (5200)
Seat 3: oceangurl2 (small blind) folded before Flop
Seat 4: DaBirds23 (big blind) folded before Flop
Seat 5: tess1235 folded before Flop (didn't bet)
Seat 6: pokernutt420 folded before Flop (didn't bet)


*********** # 272 **************
PokerStars Hand #169427877625: Tournament #1597684008, $13.50+$1.50 USD=
 Hold'em No Limit - Level XVIII (800/1600) - 2017/05/05 16:44:17 ET
Table '1597684008 10' 6-max Seat #3 is the button
Seat 1: JJin91 (125198 in chips)=20
Seat 2: jbodey52 (71614 in chips)=20
Seat 3: oceangurl2 (63521 in chips)=20
Seat 4: DaBirds23 (23638 in chips)=20
Seat 5: tess1235 (78257 in chips)=20
Seat 6: pokernutt420 (19741 in chips)=20
JJin91: posts the ante 200
jbodey52: posts the ante 200
oceangurl2: posts the ante 200
DaBirds23: posts the ante 200
tess1235: posts the ante 200
pokernutt420: posts the ante 200
DaBirds23: posts small blind 800
tess1235: posts big blind 1600
*** HOLE CARDS ***
Dealt to JJin91 [7d 8h]
pokernutt420: raises 17941 to 19541 and is all-in
JJin91: folds=20
jbodey52: folds=20
oceangurl2: folds=20
DaBirds23: raises 3897 to 23438 and is all-in
tess1235: folds=20
Uncalled bet (3897) returned to DaBirds23
*** FLOP *** [5h 3h 4d]
*** TURN *** [5h 3h 4d] [3d]
*** RIVER *** [5h 3h 4d 3d] [Kh]
*** SHOW DOWN ***
DaBirds23: shows [Ac Kc] (two pair, Kings and Threes)
pokernutt420: shows [Ks Ts] (two pair, Kings and Threes - lower kicker)
DaBirds23 collected 41882 from pot
pokernutt420 finished the tournament in 12th place and received $30.76.
*** SUMMARY ***
Total pot 41882 | Rake 0=20
Board [5h 3h 4d 3d Kh]
Seat 1: JJin91 folded before Flop (didn't bet)
Seat 2: jbodey52 folded before Flop (didn't bet)
Seat 3: oceangurl2 (button) folded before Flop (didn't bet)
Seat 4: DaBirds23 (small blind) showed [Ac Kc] and won (41882) with two=
 pair, Kings and Threes
Seat 5: tess1235 (big blind) folded before Flop
Seat 6: pokernutt420 showed [Ks Ts] and lost with two pair, Kings and T=
hrees


*********** # 273 **************
PokerStars Hand #169427877701: Tournament #1597684008, $13.50+$1.50 USD=
 Hold'em No Limit - Level XVIII (800/1600) - 2017/05/05 16:44:42 ET
Table '1597684008 10' 6-max Seat #4 is the button
Seat 1: JJin91 (124998 in chips)=20
Seat 2: jbodey52 (71414 in chips)=20
Seat 3: oceangurl2 (63321 in chips)=20
Seat 4: DaBirds23 (45779 in chips)=20
Seat 5: tess1235 (76457 in chips)=20
JJin91: posts the ante 200
jbodey52: posts the ante 200
oceangurl2: posts the ante 200
DaBirds23: posts the ante 200
tess1235: posts the ante 200
tess1235: posts small blind 800
JJin91: posts big blind 1600
*** HOLE CARDS ***
Dealt to JJin91 [3d 6d]
jbodey52: calls 1600
oceangurl2: folds=20
DaBirds23: folds=20
tess1235: folds=20
JJin91: checks=20
*** FLOP *** [8c Ah Ks]
JJin91: checks=20
jbodey52: bets 2500
JJin91: folds=20
Uncalled bet (2500) returned to jbodey52
jbodey52 collected 5000 from pot
jbodey52: doesn't show hand=20
*** SUMMARY ***
Total pot 5000 | Rake 0=20
Board [8c Ah Ks]
Seat 1: JJin91 (big blind) folded on the Flop
Seat 2: jbodey52 collected (5000)
Seat 3: oceangurl2 folded before Flop (didn't bet)
Seat 4: DaBirds23 (button) folded before Flop (didn't bet)
Seat 5: tess1235 (small blind) folded before Flop


*********** # 274 **************
PokerStars Hand #169427877777: Tournament #1597684008, $13.50+$1.50 USD=
 Hold'em No Limit - Level XVIII (800/1600) - 2017/05/05 16:45:09 ET
Table '1597684008 10' 6-max Seat #5 is the button
Seat 1: JJin91 (123198 in chips)=20
Seat 2: jbodey52 (74614 in chips)=20
Seat 3: oceangurl2 (63121 in chips)=20
Seat 4: DaBirds23 (45579 in chips)=20
Seat 5: tess1235 (75457 in chips)=20
JJin91: posts the ante 200
jbodey52: posts the ante 200
oceangurl2: posts the ante 200
DaBirds23: posts the ante 200
tess1235: posts the ante 200
JJin91: posts small blind 800
jbodey52: posts big blind 1600
*** HOLE CARDS ***
Dealt to JJin91 [6d 4d]
oceangurl2: folds=20
DaBirds23: folds=20
tess1235: raises 3200 to 4800
JJin91: folds=20
jbodey52: raises 7200 to 12000
tess1235: calls 7200
*** FLOP *** [3h 3s As]
jbodey52: checks=20
tess1235: checks=20
*** TURN *** [3h 3s As] [Ad]
jbodey52: bets 10000
tess1235: folds=20
Uncalled bet (10000) returned to jbodey52
jbodey52 collected 25800 from pot
jbodey52: doesn't show hand=20
*** SUMMARY ***
Total pot 25800 | Rake 0=20
Board [3h 3s As Ad]
Seat 1: JJin91 (small blind) folded before Flop
Seat 2: jbodey52 (big blind) collected (25800)
Seat 3: oceangurl2 folded before Flop (didn't bet)
Seat 4: DaBirds23 folded before Flop (didn't bet)
Seat 5: tess1235 (button) folded on the Turn


*********** # 275 **************
PokerStars Hand #169427877959: Tournament #1597684008, $13.50+$1.50 USD=
 Hold'em No Limit - Level XVIII (800/1600) - 2017/05/05 16:46:05 ET
Table '1597684008 10' 6-max Seat #1 is the button
Seat 1: JJin91 (122198 in chips)=20
Seat 2: jbodey52 (88214 in chips)=20
Seat 3: oceangurl2 (62921 in chips)=20
Seat 4: DaBirds23 (45379 in chips)=20
Seat 5: tess1235 (63257 in chips)=20
JJin91: posts the ante 200
jbodey52: posts the ante 200
oceangurl2: posts the ante 200
DaBirds23: posts the ante 200
tess1235: posts the ante 200
jbodey52: posts small blind 800
oceangurl2: posts big blind 1600
*** HOLE CARDS ***
Dealt to JJin91 [2h Td]
DaBirds23: raises 1600 to 3200
tess1235: folds=20
JJin91: folds=20
jbodey52: calls 2400
oceangurl2: folds=20
*** FLOP *** [4c 5s Jc]
jbodey52: checks=20
DaBirds23: checks=20
*** TURN *** [4c 5s Jc] [Qh]
jbodey52: bets 3500
DaBirds23: calls 3500
*** RIVER *** [4c 5s Jc Qh] [7s]
jbodey52: checks=20
DaBirds23: bets 7840
jbodey52: calls 7840
*** SHOW DOWN ***
DaBirds23: shows [8d Qd] (a pair of Queens)
jbodey52: mucks hand=20
DaBirds23 collected 31680 from pot
*** SUMMARY ***
Total pot 31680 | Rake 0=20
Board [4c 5s Jc Qh 7s]
Seat 1: JJin91 (button) folded before Flop (didn't bet)
Seat 2: jbodey52 (small blind) mucked [5d 9d]
Seat 3: oceangurl2 (big blind) folded before Flop
Seat 4: DaBirds23 showed [8d Qd] and won (31680) with a pair of Queens
Seat 5: tess1235 folded before Flop (didn't bet)


*********** # 276 **************
PokerStars Hand #169427878126: Tournament #1597684008, $13.50+$1.50 USD=
 Hold'em No Limit - Level XVIII (800/1600) - 2017/05/05 16:47:06 ET
Table '1597684008 10' 6-max Seat #2 is the button
Seat 1: JJin91 (121998 in chips)=20
Seat 2: jbodey52 (73474 in chips)=20
Seat 3: oceangurl2 (61121 in chips)=20
Seat 4: DaBirds23 (62319 in chips)=20
Seat 5: tess1235 (63057 in chips)=20
JJin91: posts the ante 200
jbodey52: posts the ante 200
oceangurl2: posts the ante 200
DaBirds23: posts the ante 200
tess1235: posts the ante 200
oceangurl2: posts small blind 800
DaBirds23: posts big blind 1600
*** HOLE CARDS ***
Dealt to JJin91 [4c 9d]
tess1235: folds=20
JJin91: folds=20
jbodey52: raises 2400 to 4000
oceangurl2: folds=20
DaBirds23: folds=20
Uncalled bet (2400) returned to jbodey52
jbodey52 collected 5000 from pot
jbodey52: doesn't show hand=20
*** SUMMARY ***
Total pot 5000 | Rake 0=20
Seat 1: JJin91 folded before Flop (didn't bet)
Seat 2: jbodey52 (button) collected (5000)
Seat 3: oceangurl2 (small blind) folded before Flop
Seat 4: DaBirds23 (big blind) folded before Flop
Seat 5: tess1235 folded before Flop (didn't bet)


*********** # 277 **************
PokerStars Hand #169427878198: Tournament #1597684008, $13.50+$1.50 USD=
 Hold'em No Limit - Level XVIII (800/1600) - 2017/05/05 16:47:31 ET
Table '1597684008 10' 6-max Seat #3 is the button
Seat 1: JJin91 (121798 in chips)=20
Seat 2: jbodey52 (76674 in chips)=20
Seat 3: oceangurl2 (60121 in chips)=20
Seat 4: DaBirds23 (60519 in chips)=20
Seat 5: tess1235 (62857 in chips)=20
JJin91: posts the ante 200
jbodey52: posts the ante 200
oceangurl2: posts the ante 200
DaBirds23: posts the ante 200
tess1235: posts the ante 200
DaBirds23: posts small blind 800
tess1235: posts big blind 1600
*** HOLE CARDS ***
Dealt to JJin91 [7h 7s]
JJin91: raises 1928 to 3528
jbodey52: calls 3528
oceangurl2: folds=20
DaBirds23: folds=20
tess1235: calls 1928
*** FLOP *** [3s 9d Js]
jbodey52 said, "birds i put u on air lol"
tess1235: checks=20
jbodey52 said, "like ak"
JJin91: checks=20
jbodey52: bets 5200
DaBirds23 said, "lol that was the idea"
tess1235: folds=20
JJin91: folds=20
Uncalled bet (5200) returned to jbodey52
jbodey52 collected 12384 from pot
jbodey52: doesn't show hand=20
*** SUMMARY ***
Total pot 12384 | Rake 0=20
Board [3s 9d Js]
Seat 1: JJin91 folded on the Flop
Seat 2: jbodey52 collected (12384)
Seat 3: oceangurl2 (button) folded before Flop (didn't bet)
Seat 4: DaBirds23 (small blind) folded before Flop
Seat 5: tess1235 (big blind) folded on the Flop


*********** # 278 **************
PokerStars Hand #169427878357: Tournament #1597684008, $13.50+$1.50 USD=
 Hold'em No Limit - Level XIX (1000/2000) - 2017/05/05 16:48:31 ET
Table '1597684008 10' 6-max Seat #4 is the button
Seat 1: JJin91 (118070 in chips)=20
Seat 2: jbodey52 (85330 in chips)=20
Seat 3: oceangurl2 (59921 in chips)=20
Seat 4: DaBirds23 (59519 in chips)=20
Seat 5: tess1235 (59129 in chips)=20
JJin91: posts the ante 250
jbodey52: posts the ante 250
oceangurl2: posts the ante 250
DaBirds23: posts the ante 250
tess1235: posts the ante 250
tess1235: posts small blind 1000
JJin91: posts big blind 2000
*** HOLE CARDS ***
Dealt to JJin91 [Kc 2s]
jbodey52 said, "yirp"
jbodey52 said, "lol"
jbodey52 said, "then flip q8"
jbodey52: folds=20
oceangurl2: folds=20
jbodey52 said, "put i also wante to see"
DaBirds23: raises 2000 to 4000
tess1235: folds=20
JJin91: folds=20
Uncalled bet (2000) returned to DaBirds23
DaBirds23 collected 6250 from pot
*** SUMMARY ***
Total pot 6250 | Rake 0=20
Seat 1: JJin91 (big blind) folded before Flop
Seat 2: jbodey52 folded before Flop (didn't bet)
Seat 3: oceangurl2 folded before Flop (didn't bet)
Seat 4: DaBirds23 (button) collected (6250)
Seat 5: tess1235 (small blind) folded before Flop


*********** # 279 **************
PokerStars Hand #169427878429: Tournament #1597684008, $13.50+$1.50 USD=
 Hold'em No Limit - Level XIX (1000/2000) - 2017/05/05 16:48:58 ET
Table '1597684008 10' 6-max Seat #5 is the button
Seat 1: JJin91 (115820 in chips)=20
Seat 2: jbodey52 (85080 in chips)=20
Seat 3: oceangurl2 (59671 in chips)=20
Seat 4: DaBirds23 (63519 in chips)=20
Seat 5: tess1235 (57879 in chips)=20
JJin91: posts the ante 250
jbodey52: posts the ante 250
oceangurl2: posts the ante 250
DaBirds23: posts the ante 250
tess1235: posts the ante 250
JJin91: posts small blind 1000
jbodey52: posts big blind 2000
*** HOLE CARDS ***
Dealt to JJin91 [4s Ks]
oceangurl2: folds=20
DaBirds23: folds=20
tess1235: calls 2000
JJin91: calls 1000
jbodey52: raises 7999 to 9999
tess1235: folds=20
JJin91: calls 7999
*** FLOP *** [As 6h Tc]
JJin91: checks=20
jbodey52: checks=20
*** TURN *** [As 6h Tc] [Jd]
JJin91: checks=20
jbodey52: checks=20
*** RIVER *** [As 6h Tc Jd] [3c]
JJin91: checks=20
jbodey52: checks=20
*** SHOW DOWN ***
JJin91: shows [4s Ks] (high card Ace)
jbodey52: shows [Td 5s] (a pair of Tens)
jbodey52 collected 23248 from pot
*** SUMMARY ***
Total pot 23248 | Rake 0=20
Board [As 6h Tc Jd 3c]
Seat 1: JJin91 (small blind) showed [4s Ks] and lost with high card Ace
Seat 2: jbodey52 (big blind) showed [Td 5s] and won (23248) with a pair=
 of Tens
Seat 3: oceangurl2 folded before Flop (didn't bet)
Seat 4: DaBirds23 folded before Flop (didn't bet)
Seat 5: tess1235 (button) folded before Flop


*********** # 280 **************
PokerStars Hand #169427878604: Tournament #1597684008, $13.50+$1.50 USD=
 Hold'em No Limit - Level XIX (1000/2000) - 2017/05/05 16:50:07 ET
Table '1597684008 10' 6-max Seat #1 is the button
Seat 1: JJin91 (105571 in chips)=20
Seat 2: jbodey52 (98079 in chips)=20
Seat 3: oceangurl2 (59421 in chips)=20
Seat 4: DaBirds23 (63269 in chips)=20
Seat 5: tess1235 (55629 in chips)=20
JJin91: posts the ante 250
jbodey52: posts the ante 250
oceangurl2: posts the ante 250
DaBirds23: posts the ante 250
tess1235: posts the ante 250
jbodey52: posts small blind 1000
oceangurl2: posts big blind 2000
*** HOLE CARDS ***
Dealt to JJin91 [Ah 4d]
jbodey52 said, "lol take that"
DaBirds23: folds=20
tess1235: calls 2000
JJin91: raises 4000 to 6000
jbodey52: calls 5000
oceangurl2: folds=20
tess1235: calls 4000
*** FLOP *** [Tc Jh 2c]
jbodey52: checks=20
tess1235: checks=20
JJin91: bets 12586
jbodey52: folds=20
tess1235: folds=20
Uncalled bet (12586) returned to JJin91
JJin91 collected 21250 from pot
*** SUMMARY ***
Total pot 21250 | Rake 0=20
Board [Tc Jh 2c]
Seat 1: JJin91 (button) collected (21250)
Seat 2: jbodey52 (small blind) folded on the Flop
Seat 3: oceangurl2 (big blind) folded before Flop
Seat 4: DaBirds23 folded before Flop (didn't bet)
Seat 5: tess1235 folded on the Flop


*********** # 281 **************
PokerStars Hand #169427878759: Tournament #1597684008, $13.50+$1.50 USD=
 Hold'em No Limit - Level XIX (1000/2000) - 2017/05/05 16:51:04 ET
Table '1597684008 10' 6-max Seat #2 is the button
Seat 1: JJin91 (120571 in chips)=20
Seat 2: jbodey52 (91829 in chips)=20
Seat 3: oceangurl2 (57171 in chips)=20
Seat 4: DaBirds23 (63019 in chips)=20
Seat 5: tess1235 (49379 in chips)=20
JJin91: posts the ante 250
jbodey52: posts the ante 250
oceangurl2: posts the ante 250
DaBirds23: posts the ante 250
tess1235: posts the ante 250
oceangurl2: posts small blind 1000
DaBirds23: posts big blind 2000
*** HOLE CARDS ***
Dealt to JJin91 [3s 2h]
tess1235: folds=20
JJin91: folds=20
jbodey52: raises 3000 to 5000
oceangurl2: folds=20
DaBirds23: folds=20
Uncalled bet (3000) returned to jbodey52
jbodey52 collected 6250 from pot
jbodey52: doesn't show hand=20
*** SUMMARY ***
Total pot 6250 | Rake 0=20
Seat 1: JJin91 folded before Flop (didn't bet)
Seat 2: jbodey52 (button) collected (6250)
Seat 3: oceangurl2 (small blind) folded before Flop
Seat 4: DaBirds23 (big blind) folded before Flop
Seat 5: tess1235 folded before Flop (didn't bet)


*********** # 282 **************
PokerStars Hand #169427878815: Tournament #1597684008, $13.50+$1.50 USD=
 Hold'em No Limit - Level XIX (1000/2000) - 2017/05/05 16:51:27 ET
Table '1597684008 10' 6-max Seat #3 is the button
Seat 1: JJin91 (120321 in chips)=20
Seat 2: jbodey52 (95829 in chips)=20
Seat 3: oceangurl2 (55921 in chips)=20
Seat 4: DaBirds23 (60769 in chips)=20
Seat 5: tess1235 (49129 in chips)=20
JJin91: posts the ante 250
jbodey52: posts the ante 250
oceangurl2: posts the ante 250
DaBirds23: posts the ante 250
tess1235: posts the ante 250
DaBirds23: posts small blind 1000
tess1235: posts big blind 2000
*** HOLE CARDS ***
Dealt to JJin91 [5s 3s]
JJin91: folds=20
jbodey52 said, "ak"
jbodey52: folds=20
oceangurl2: calls 2000
DaBirds23: calls 1000
tess1235: checks=20
*** FLOP *** [8h 6c 7c]
DaBirds23: checks=20
tess1235: checks=20
oceangurl2: bets 6000
DaBirds23: calls 6000
tess1235: folds=20
*** TURN *** [8h 6c 7c] [9h]
DaBirds23: checks=20
oceangurl2: checks=20
*** RIVER *** [8h 6c 7c 9h] [Js]
DaBirds23: checks=20
oceangurl2: checks=20
*** SHOW DOWN ***
DaBirds23: shows [8s 6s] (two pair, Eights and Sixes)
oceangurl2: mucks hand=20
DaBirds23 collected 19250 from pot
*** SUMMARY ***
Total pot 19250 | Rake 0=20
Board [8h 6c 7c 9h Js]
Seat 1: JJin91 folded before Flop (didn't bet)
Seat 2: jbodey52 folded before Flop (didn't bet)
Seat 3: oceangurl2 (button) mucked [3c 3d]
Seat 4: DaBirds23 (small blind) showed [8s 6s] and won (19250) with two=
 pair, Eights and Sixes
Seat 5: tess1235 (big blind) folded on the Flop


*********** # 283 **************
PokerStars Hand #169427878943: Tournament #1597684008, $13.50+$1.50 USD=
 Hold'em No Limit - Level XIX (1000/2000) - 2017/05/05 16:52:19 ET
Table '1597684008 10' 6-max Seat #4 is the button
Seat 1: JJin91 (120071 in chips)=20
Seat 2: jbodey52 (95579 in chips)=20
Seat 3: oceangurl2 (47671 in chips)=20
Seat 4: DaBirds23 (71769 in chips)=20
Seat 5: tess1235 (46879 in chips)=20
JJin91: posts the ante 250
jbodey52: posts the ante 250
oceangurl2: posts the ante 250
DaBirds23: posts the ante 250
tess1235: posts the ante 250
tess1235: posts small blind 1000
JJin91: posts big blind 2000
*** HOLE CARDS ***
Dealt to JJin91 [Th 9s]
jbodey52: folds=20
oceangurl2: folds=20
DaBirds23: raises 2000 to 4000
tess1235: folds=20
JJin91: calls 2000
*** FLOP *** [Kd 7d 5h]
JJin91: checks=20
DaBirds23: bets 3690
JJin91: folds=20
Uncalled bet (3690) returned to DaBirds23
DaBirds23 collected 10250 from pot
DaBirds23: doesn't show hand=20
*** SUMMARY ***
Total pot 10250 | Rake 0=20
Board [Kd 7d 5h]
Seat 1: JJin91 (big blind) folded on the Flop
Seat 2: jbodey52 folded before Flop (didn't bet)
Seat 3: oceangurl2 folded before Flop (didn't bet)
Seat 4: DaBirds23 (button) collected (10250)
Seat 5: tess1235 (small blind) folded before Flop


*********** # 284 **************
PokerStars Hand #169427879016: Tournament #1597684008, $13.50+$1.50 USD=
 Hold'em No Limit - Level XIX (1000/2000) - 2017/05/05 16:52:47 ET
Table '1597684008 10' 6-max Seat #5 is the button
Seat 1: JJin91 (115821 in chips)=20
Seat 2: jbodey52 (95329 in chips)=20
Seat 3: oceangurl2 (47421 in chips)=20
Seat 4: DaBirds23 (77769 in chips)=20
Seat 5: tess1235 (45629 in chips)=20
JJin91: posts the ante 250
jbodey52: posts the ante 250
oceangurl2: posts the ante 250
DaBirds23: posts the ante 250
tess1235: posts the ante 250
JJin91: posts small blind 1000
jbodey52: posts big blind 2000
*** HOLE CARDS ***
Dealt to JJin91 [Kd 9d]
oceangurl2: folds=20
DaBirds23: raises 2000 to 4000
tess1235: folds=20
JJin91: calls 3000
jbodey52: folds=20
*** FLOP *** [Qs 3s 8d]
JJin91: bets 4563
DaBirds23: calls 4563
*** TURN *** [Qs 3s 8d] [9c]
JJin91: checks=20
DaBirds23: checks=20
*** RIVER *** [Qs 3s 8d 9c] [Jh]
JJin91: checks=20
DaBirds23: checks=20
*** SHOW DOWN ***
JJin91: shows [Kd 9d] (a pair of Nines)
DaBirds23: mucks hand=20
JJin91 collected 20376 from pot
*** SUMMARY ***
Total pot 20376 | Rake 0=20
Board [Qs 3s 8d 9c Jh]
Seat 1: JJin91 (small blind) showed [Kd 9d] and won (20376) with a pair=
 of Nines
Seat 2: jbodey52 (big blind) folded before Flop
Seat 3: oceangurl2 folded before Flop (didn't bet)
Seat 4: DaBirds23 mucked [7h 8h]
Seat 5: tess1235 (button) folded before Flop (didn't bet)


*********** # 285 **************
PokerStars Hand #169427879154: Tournament #1597684008, $13.50+$1.50 USD=
 Hold'em No Limit - Level XIX (1000/2000) - 2017/05/05 16:53:40 ET
Table '1597684008 10' 6-max Seat #1 is the button
Seat 1: JJin91 (127384 in chips)=20
Seat 2: jbodey52 (93079 in chips)=20
Seat 4: DaBirds23 (68956 in chips)=20
Seat 5: tess1235 (45379 in chips)=20
JJin91: posts the ante 250
jbodey52: posts the ante 250
DaBirds23: posts the ante 250
tess1235: posts the ante 250
jbodey52: posts small blind 1000
DaBirds23: posts big blind 2000
*** HOLE CARDS ***
Dealt to JJin91 [Jh Ts]
tess1235: calls 2000
JJin91: folds=20
jbodey52: calls 1000
DaBirds23: checks=20
*** FLOP *** [2s 4c 6d]
jbodey52: bets 3500
DaBirds23: folds=20
tess1235: folds=20
Uncalled bet (3500) returned to jbodey52
jbodey52 collected 7000 from pot
jbodey52: doesn't show hand=20
*** SUMMARY ***
Total pot 7000 | Rake 0=20
Board [2s 4c 6d]
Seat 1: JJin91 (button) folded before Flop (didn't bet)
Seat 2: jbodey52 (small blind) collected (7000)
Seat 4: DaBirds23 (big blind) folded on the Flop
Seat 5: tess1235 folded on the Flop


*********** # 286 **************
PokerStars Hand #169427879231: Tournament #1597684008, $13.50+$1.50 USD=
 Hold'em No Limit - Level XIX (1000/2000) - 2017/05/05 16:54:06 ET
Table '1597684008 10' 6-max Seat #2 is the button
Seat 1: JJin91 (127134 in chips)=20
Seat 2: jbodey52 (97829 in chips)=20
Seat 4: DaBirds23 (66706 in chips)=20
Seat 5: tess1235 (43129 in chips)=20
JJin91: posts the ante 250
jbodey52: posts the ante 250
DaBirds23: posts the ante 250
tess1235: posts the ante 250
DaBirds23: posts small blind 1000
tess1235: posts big blind 2000
*** HOLE CARDS ***
Dealt to JJin91 [As 2c]
JJin91: folds=20
jbodey52: folds=20
DaBirds23: calls 1000
tess1235: checks=20
*** FLOP *** [9d 6h Jh]
DaBirds23: checks=20
tess1235: checks=20
*** TURN *** [9d 6h Jh] [8s]
DaBirds23: checks=20
tess1235: checks=20
*** RIVER *** [9d 6h Jh 8s] [Js]
DaBirds23: checks=20
tess1235: checks=20
*** SHOW DOWN ***
DaBirds23: shows [Ad 7c] (a pair of Jacks)
tess1235: mucks hand=20
DaBirds23 collected 5000 from pot
*** SUMMARY ***
Total pot 5000 | Rake 0=20
Board [9d 6h Jh 8s Js]
Seat 1: JJin91 folded before Flop (didn't bet)
Seat 2: jbodey52 (button) folded before Flop (didn't bet)
Seat 4: DaBirds23 (small blind) showed [Ad 7c] and won (5000) with a pa=
ir of Jacks
Seat 5: tess1235 (big blind) mucked [Qh 4h]


*********** # 287 **************
PokerStars Hand #169427879331: Tournament #1597684008, $13.50+$1.50 USD=
 Hold'em No Limit - Level XIX (1000/2000) - 2017/05/05 16:54:34 ET
Table '1597684008 10' 6-max Seat #4 is the button
Seat 1: JJin91 (126884 in chips)=20
Seat 2: jbodey52 (97579 in chips)=20
Seat 4: DaBirds23 (69456 in chips)=20
Seat 5: tess1235 (40879 in chips)=20
JJin91: posts the ante 250
jbodey52: posts the ante 250
DaBirds23: posts the ante 250
tess1235: posts the ante 250
tess1235: posts small blind 1000
JJin91: posts big blind 2000
*** HOLE CARDS ***
Dealt to JJin91 [6d Qd]
jbodey52: folds=20
DaBirds23: folds=20
tess1235: folds=20
Uncalled bet (1000) returned to JJin91
JJin91 collected 3000 from pot
*** SUMMARY ***
Total pot 3000 | Rake 0=20
Seat 1: JJin91 (big blind) collected (3000)
Seat 2: jbodey52 folded before Flop (didn't bet)
Seat 4: DaBirds23 (button) folded before Flop (didn't bet)
Seat 5: tess1235 (small blind) folded before Flop


*********** # 288 **************
PokerStars Hand #169427879361: Tournament #1597684008, $13.50+$1.50 USD=
 Hold'em No Limit - Level XIX (1000/2000) - 2017/05/05 16:54:43 ET
Table '1597684008 10' 6-max Seat #5 is the button
Seat 1: JJin91 (128634 in chips)=20
Seat 2: jbodey52 (97329 in chips)=20
Seat 4: DaBirds23 (69206 in chips)=20
Seat 5: tess1235 (39629 in chips)=20
JJin91: posts the ante 250
jbodey52: posts the ante 250
DaBirds23: posts the ante 250
tess1235: posts the ante 250
JJin91: posts small blind 1000
jbodey52: posts big blind 2000
*** HOLE CARDS ***
Dealt to JJin91 [Qs 8h]
DaBirds23: folds=20
tess1235: folds=20
JJin91: folds=20
Uncalled bet (1000) returned to jbodey52
jbodey52 collected 3000 from pot
jbodey52: doesn't show hand=20
*** SUMMARY ***
Total pot 3000 | Rake 0=20
Seat 1: JJin91 (small blind) folded before Flop
Seat 2: jbodey52 (big blind) collected (3000)
Seat 4: DaBirds23 folded before Flop (didn't bet)
Seat 5: tess1235 (button) folded before Flop (didn't bet)


*********** # 289 **************
PokerStars Hand #169428667024: Tournament #1597684008, $13.50+$1.50 USD=
 Hold'em No Limit - Level XIX (1000/2000) - 2017/05/05 17:00:22 ET
Table '1597684008 10' 6-max Seat #1 is the button
Seat 1: JJin91 (127384 in chips)=20
Seat 2: jbodey52 (99079 in chips)=20
Seat 4: DaBirds23 (68956 in chips)=20
Seat 5: tess1235 (39379 in chips)=20
JJin91: posts the ante 250
jbodey52: posts the ante 250
DaBirds23: posts the ante 250
tess1235: posts the ante 250
jbodey52: posts small blind 1000
DaBirds23: posts big blind 2000
*** HOLE CARDS ***
Dealt to JJin91 [8h As]
tess1235: folds=20
JJin91: raises 2369 to 4369
jbodey52: calls 3369
DaBirds23: folds=20
*** FLOP *** [Ah 3d Qd]
jbodey52: checks=20
JJin91: bets 4873
jbodey52: raises 5126 to 9999
JJin91: calls 5126
*** TURN *** [Ah 3d Qd] [Kd]
jbodey52: checks=20
JJin91: bets 13695
jbodey52: raises 60305 to 74000
JJin91: raises 38766 to 112766 and is all-in
jbodey52: calls 10461 and is all-in
Uncalled bet (28305) returned to JJin91
*** RIVER *** [Ah 3d Qd Kd] [4h]
*** SHOW DOWN ***
jbodey52: shows [Ad Th] (a pair of Aces)
JJin91: shows [8h As] (a pair of Aces - lower kicker)
jbodey52 collected 200658 from pot
*** SUMMARY ***
Total pot 200658 | Rake 0=20
Board [Ah 3d Qd Kd 4h]
Seat 1: JJin91 (button) showed [8h As] and lost with a pair of Aces
Seat 2: jbodey52 (small blind) showed [Ad Th] and won (200658) with a p=
air of Aces
Seat 4: DaBirds23 (big blind) folded before Flop
Seat 5: tess1235 folded before Flop (didn't bet)


*********** # 290 **************
PokerStars Hand #169428667407: Tournament #1597684008, $13.50+$1.50 USD=
 Hold'em No Limit - Level XIX (1000/2000) - 2017/05/05 17:02:15 ET
Table '1597684008 10' 6-max Seat #2 is the button
Seat 1: JJin91 (28305 in chips)=20
Seat 2: jbodey52 (200658 in chips)=20
Seat 4: DaBirds23 (66706 in chips)=20
Seat 5: tess1235 (39129 in chips)=20
JJin91: posts the ante 250
jbodey52: posts the ante 250
DaBirds23: posts the ante 250
tess1235: posts the ante 250
DaBirds23: posts small blind 1000
tess1235: posts big blind 2000
*** HOLE CARDS ***
Dealt to JJin91 [5c 8d]
JJin91: folds=20
jbodey52: folds=20
DaBirds23: calls 1000
tess1235: checks=20
*** FLOP *** [As 4d Qc]
DaBirds23: checks=20
tess1235: checks=20
*** TURN *** [As 4d Qc] [Ts]
DaBirds23: bets 2450
tess1235: calls 2450
*** RIVER *** [As 4d Qc Ts] [9c]
DaBirds23: checks=20
tess1235: checks=20
*** SHOW DOWN ***
DaBirds23: shows [Js 3s] (high card Ace)
tess1235: shows [Th 2d] (a pair of Tens)
tess1235 collected 9900 from pot
*** SUMMARY ***
Total pot 9900 | Rake 0=20
Board [As 4d Qc Ts 9c]
Seat 1: JJin91 folded before Flop (didn't bet)
Seat 2: jbodey52 (button) folded before Flop (didn't bet)
Seat 4: DaBirds23 (small blind) showed [Js 3s] and lost with high card =
Ace
Seat 5: tess1235 (big blind) showed [Th 2d] and won (9900) with a pair =
of Tens


*********** # 291 **************
PokerStars Hand #169428667512: Tournament #1597684008, $13.50+$1.50 USD=
 Hold'em No Limit - Level XIX (1000/2000) - 2017/05/05 17:02:51 ET
Table '1597684008 10' 6-max Seat #4 is the button
Seat 1: JJin91 (28055 in chips)=20
Seat 2: jbodey52 (200408 in chips)=20
Seat 4: DaBirds23 (62006 in chips)=20
Seat 5: tess1235 (44329 in chips)=20
JJin91: posts the ante 250
jbodey52: posts the ante 250
DaBirds23: posts the ante 250
tess1235: posts the ante 250
tess1235: posts small blind 1000
JJin91: posts big blind 2000
*** HOLE CARDS ***
Dealt to JJin91 [9c 5s]
jbodey52: raises 3000 to 5000
DaBirds23: folds=20
tess1235: folds=20
JJin91: folds=20
Uncalled bet (3000) returned to jbodey52
jbodey52 collected 6000 from pot
jbodey52: doesn't show hand=20
*** SUMMARY ***
Total pot 6000 | Rake 0=20
Seat 1: JJin91 (big blind) folded before Flop
Seat 2: jbodey52 collected (6000)
Seat 4: DaBirds23 (button) folded before Flop (didn't bet)
Seat 5: tess1235 (small blind) folded before Flop


*********** # 292 **************
PokerStars Hand #169428667574: Tournament #1597684008, $13.50+$1.50 USD=
 Hold'em No Limit - Level XIX (1000/2000) - 2017/05/05 17:03:10 ET
Table '1597684008 10' 6-max Seat #5 is the button
Seat 1: JJin91 (25805 in chips)=20
Seat 2: jbodey52 (204158 in chips)=20
Seat 4: DaBirds23 (61756 in chips)=20
Seat 5: tess1235 (43079 in chips)=20
JJin91: posts the ante 250
jbodey52: posts the ante 250
DaBirds23: posts the ante 250
tess1235: posts the ante 250
JJin91: posts small blind 1000
jbodey52: posts big blind 2000
*** HOLE CARDS ***
Dealt to JJin91 [Ac 4h]
DaBirds23: folds=20
tess1235: folds=20
JJin91: raises 23555 to 25555 and is all-in
jbodey52: calls 23555
*** FLOP *** [3c Ts Kc]
*** TURN *** [3c Ts Kc] [8h]
*** RIVER *** [3c Ts Kc 8h] [Kd]
*** SHOW DOWN ***
JJin91: shows [Ac 4h] (a pair of Kings)
jbodey52: shows [9c Ad] (a pair of Kings - Ace+Ten+Nine kicker)
jbodey52 collected 52110 from pot
JJin91 finished the tournament in 8th place and received $46.50.
*** SUMMARY ***
Total pot 52110 | Rake 0=20
Board [3c Ts Kc 8h Kd]
Seat 1: JJin91 (small blind) showed [Ac 4h] and lost with a pair of Kin=
gs
Seat 2: jbodey52 (big blind) showed [9c Ad] and won (52110) with a pair=
 of Kings
Seat 4: DaBirds23 folded before Flop (didn't bet)
Seat 5: tess1235 (button) folded before Flop (didn't bet)



If you have any questions, please contact us at "PokerStars Support" <s=
upport@pokerstarsnj.com>


