Transcript for tournament #1622573280 requested by JJin91 (jamiejin91@g=
mail.com)

*********** # 1 **************
PokerStars Hand #170370858593: Tournament #1622573280, $9.10+$0.90 USD =
Hold'em No Limit - Level V (60/120) - 2017/05/25 18:45:27 ET
Table '1622573280 1' 9-max Seat #2 is the button
Seat 1: FinesseU22 (7653 in chips)=20
Seat 2: hainesiv2 (12803 in chips)=20
Seat 3: robertg68 (5980 in chips)=20
Seat 5: camp183 (9490 in chips)=20
Seat 6: elimin8tor1 (10895 in chips)=20
Seat 7: JerseyGuy316 (13050 in chips)=20
Seat 8: JJin91 (10000 in chips)=20
Seat 9: oceangurl2 (17605 in chips)=20
FinesseU22: posts the ante 15
hainesiv2: posts the ante 15
robertg68: posts the ante 15
camp183: posts the ante 15
elimin8tor1: posts the ante 15
JerseyGuy316: posts the ante 15
JJin91: posts the ante 15
oceangurl2: posts the ante 15
robertg68: posts small blind 60
camp183: posts big blind 120
*** HOLE CARDS ***
Dealt to JJin91 [Ad 8d]
elimin8tor1: calls 120
JerseyGuy316: folds=20
JJin91: raises 249 to 369
oceangurl2: calls 369
FinesseU22: folds=20
hainesiv2: folds=20
robertg68: calls 309
camp183: calls 249
elimin8tor1: calls 249
*** FLOP *** [4d Kh 3c]
robertg68: checks=20
camp183: checks=20
elimin8tor1: checks=20
JJin91: checks=20
oceangurl2: checks=20
*** TURN *** [4d Kh 3c] [8c]
robertg68: checks=20
camp183: checks=20
elimin8tor1: checks=20
JJin91: bets 727
oceangurl2: folds=20
robertg68: folds=20
camp183: folds=20
elimin8tor1: folds=20
Uncalled bet (727) returned to JJin91
JJin91 collected 1965 from pot
JJin91: doesn't show hand=20
*** SUMMARY ***
Total pot 1965 | Rake 0=20
Board [4d Kh 3c 8c]
Seat 1: FinesseU22 folded before Flop (didn't bet)
Seat 2: hainesiv2 (button) folded before Flop (didn't bet)
Seat 3: robertg68 (small blind) folded on the Turn
Seat 5: camp183 (big blind) folded on the Turn
Seat 6: elimin8tor1 folded on the Turn
Seat 7: JerseyGuy316 folded before Flop (didn't bet)
Seat 8: JJin91 collected (1965)
Seat 9: oceangurl2 folded on the Turn


*********** # 2 **************
PokerStars Hand #170370858899: Tournament #1622573280, $9.10+$0.90 USD =
Hold'em No Limit - Level V (60/120) - 2017/05/25 18:47:00 ET
Table '1622573280 1' 9-max Seat #3 is the button
Seat 1: FinesseU22 (7638 in chips)=20
Seat 2: hainesiv2 (12788 in chips)=20
Seat 3: robertg68 (5596 in chips)=20
Seat 5: camp183 (9106 in chips)=20
Seat 6: elimin8tor1 (10511 in chips)=20
Seat 7: JerseyGuy316 (13035 in chips)=20
Seat 8: JJin91 (11581 in chips)=20
Seat 9: oceangurl2 (17221 in chips)=20
FinesseU22: posts the ante 15
hainesiv2: posts the ante 15
robertg68: posts the ante 15
camp183: posts the ante 15
elimin8tor1: posts the ante 15
JerseyGuy316: posts the ante 15
JJin91: posts the ante 15
oceangurl2: posts the ante 15
camp183: posts small blind 60
elimin8tor1: posts big blind 120
*** HOLE CARDS ***
Dealt to JJin91 [7s Kc]
JerseyGuy316: folds=20
JJin91: folds=20
oceangurl2: folds=20
FinesseU22: calls 120
hainesiv2: folds=20
robertg68: calls 120
camp183: calls 60
elimin8tor1: checks=20
*** FLOP *** [5d Qs 3h]
camp183: checks=20
elimin8tor1: checks=20
FinesseU22: checks=20
robertg68: checks=20
*** TURN *** [5d Qs 3h] [4s]
camp183: checks=20
elimin8tor1: checks=20
FinesseU22: checks=20
robertg68: checks=20
*** RIVER *** [5d Qs 3h 4s] [Td]
camp183: checks=20
elimin8tor1: checks=20
FinesseU22: checks=20
robertg68: checks=20
*** SHOW DOWN ***
camp183: shows [5h Jd] (a pair of Fives)
elimin8tor1: mucks hand=20
FinesseU22: mucks hand=20
robertg68: shows [6c 6s] (a pair of Sixes)
robertg68 collected 600 from pot
*** SUMMARY ***
Total pot 600 | Rake 0=20
Board [5d Qs 3h 4s Td]
Seat 1: FinesseU22 mucked [9s 7c]
Seat 2: hainesiv2 folded before Flop (didn't bet)
Seat 3: robertg68 (button) showed [6c 6s] and won (600) with a pair of =
Sixes
Seat 5: camp183 (small blind) showed [5h Jd] and lost with a pair of Fi=
ves
Seat 6: elimin8tor1 (big blind) mucked [Jh Kd]
Seat 7: JerseyGuy316 folded before Flop (didn't bet)
Seat 8: JJin91 folded before Flop (didn't bet)
Seat 9: oceangurl2 folded before Flop (didn't bet)


*********** # 3 **************
PokerStars Hand #170370859114: Tournament #1622573280, $9.10+$0.90 USD =
Hold'em No Limit - Level V (60/120) - 2017/05/25 18:48:02 ET
Table '1622573280 1' 9-max Seat #5 is the button
Seat 1: FinesseU22 (7503 in chips)=20
Seat 2: hainesiv2 (12773 in chips)=20
Seat 3: robertg68 (6061 in chips)=20
Seat 5: camp183 (8971 in chips)=20
Seat 6: elimin8tor1 (10376 in chips)=20
Seat 7: JerseyGuy316 (13020 in chips)=20
Seat 8: JJin91 (11566 in chips)=20
Seat 9: oceangurl2 (17206 in chips)=20
FinesseU22: posts the ante 15
hainesiv2: posts the ante 15
robertg68: posts the ante 15
camp183: posts the ante 15
elimin8tor1: posts the ante 15
JerseyGuy316: posts the ante 15
JJin91: posts the ante 15
oceangurl2: posts the ante 15
elimin8tor1: posts small blind 60
JerseyGuy316: posts big blind 120
*** HOLE CARDS ***
Dealt to JJin91 [Qs Ac]
JJin91: raises 142 to 262
oceangurl2: folds=20
FinesseU22: calls 262
hainesiv2: folds=20
robertg68: folds=20
camp183: folds=20
elimin8tor1: folds=20
JerseyGuy316: folds=20
*** FLOP *** [Ks Jh Kc]
JJin91: bets 470
FinesseU22: calls 470
*** TURN *** [Ks Jh Kc] [Qc]
JJin91: checks=20
FinesseU22: checks=20
*** RIVER *** [Ks Jh Kc Qc] [4c]
JJin91: checks=20
FinesseU22: checks=20
*** SHOW DOWN ***
JJin91: shows [Qs Ac] (two pair, Kings and Queens)
FinesseU22: mucks hand=20
JJin91 collected 1764 from pot
*** SUMMARY ***
Total pot 1764 | Rake 0=20
Board [Ks Jh Kc Qc 4c]
Seat 1: FinesseU22 mucked [Ad 8d]
Seat 2: hainesiv2 folded before Flop (didn't bet)
Seat 3: robertg68 folded before Flop (didn't bet)
Seat 5: camp183 (button) folded before Flop (didn't bet)
Seat 6: elimin8tor1 (small blind) folded before Flop
Seat 7: JerseyGuy316 (big blind) folded before Flop
Seat 8: JJin91 showed [Qs Ac] and won (1764) with two pair, Kings and Q=
ueens
Seat 9: oceangurl2 folded before Flop (didn't bet)


*********** # 4 **************
PokerStars Hand #170370859284: Tournament #1622573280, $9.10+$0.90 USD =
Hold'em No Limit - Level V (60/120) - 2017/05/25 18:48:54 ET
Table '1622573280 1' 9-max Seat #6 is the button
Seat 1: FinesseU22 (6756 in chips)=20
Seat 2: hainesiv2 (12758 in chips)=20
Seat 3: robertg68 (6046 in chips)=20
Seat 5: camp183 (8956 in chips)=20
Seat 6: elimin8tor1 (10301 in chips)=20
Seat 7: JerseyGuy316 (12885 in chips)=20
Seat 8: JJin91 (12583 in chips)=20
Seat 9: oceangurl2 (17191 in chips)=20
FinesseU22: posts the ante 15
hainesiv2: posts the ante 15
robertg68: posts the ante 15
camp183: posts the ante 15
elimin8tor1: posts the ante 15
JerseyGuy316: posts the ante 15
JJin91: posts the ante 15
oceangurl2: posts the ante 15
JerseyGuy316: posts small blind 60
JJin91: posts big blind 120
*** HOLE CARDS ***
Dealt to JJin91 [Ad Th]
oceangurl2: folds=20
FinesseU22: raises 420 to 540
hainesiv2: folds=20
robertg68: calls 540
camp183: calls 540
elimin8tor1: folds=20
JerseyGuy316: folds=20
JJin91: folds=20
*** FLOP *** [Ks 6h Kd]
FinesseU22: bets 6201 and is all-in
robertg68: calls 5491 and is all-in
camp183: calls 6201
*** TURN *** [Ks 6h Kd] [Ac]
*** RIVER *** [Ks 6h Kd Ac] [Jc]
*** SHOW DOWN ***
FinesseU22: shows [4s 4c] (two pair, Kings and Fours)
camp183: shows [Kc Tc] (three of a kind, Kings)
camp183 collected 1420 from side pot
robertg68: shows [6d 6c] (a full house, Sixes full of Kings)
robertg68 collected 18393 from main pot
FinesseU22 finished the tournament in 154th place
*** SUMMARY ***
Total pot 19813 Main pot 18393. Side pot 1420. | Rake 0=20
Board [Ks 6h Kd Ac Jc]
Seat 1: FinesseU22 showed [4s 4c] and lost with two pair, Kings and Fou=
rs
Seat 2: hainesiv2 folded before Flop (didn't bet)
Seat 3: robertg68 showed [6d 6c] and won (18393) with a full house, Six=
es full of Kings
Seat 5: camp183 showed [Kc Tc] and won (1420) with three of a kind, Kin=
gs
Seat 6: elimin8tor1 (button) folded before Flop (didn't bet)
Seat 7: JerseyGuy316 (small blind) folded before Flop
Seat 8: JJin91 (big blind) folded before Flop
Seat 9: oceangurl2 folded before Flop (didn't bet)


*********** # 5 **************
PokerStars Hand #170370859415: Tournament #1622573280, $9.10+$0.90 USD =
Hold'em No Limit - Level V (60/120) - 2017/05/25 18:49:33 ET
Table '1622573280 1' 9-max Seat #7 is the button
Seat 2: hainesiv2 (12743 in chips)=20
Seat 3: robertg68 (18393 in chips)=20
Seat 5: camp183 (3620 in chips)=20
Seat 6: elimin8tor1 (10286 in chips)=20
Seat 7: JerseyGuy316 (12810 in chips)=20
Seat 8: JJin91 (12448 in chips)=20
Seat 9: oceangurl2 (17176 in chips)=20
hainesiv2: posts the ante 15
robertg68: posts the ante 15
camp183: posts the ante 15
elimin8tor1: posts the ante 15
JerseyGuy316: posts the ante 15
JJin91: posts the ante 15
oceangurl2: posts the ante 15
JJin91: posts small blind 60
oceangurl2: posts big blind 120
*** HOLE CARDS ***
Dealt to JJin91 [Qd 3s]
hainesiv2: folds=20
robertg68: calls 120
camp183: folds=20
elimin8tor1: folds=20
JerseyGuy316: folds=20
JJin91: folds=20
oceangurl2: checks=20
*** FLOP *** [Kd As Ah]
oceangurl2: bets 120
robertg68: calls 120
*** TURN *** [Kd As Ah] [7h]
oceangurl2: checks=20
robertg68: bets 120
oceangurl2: folds=20
Uncalled bet (120) returned to robertg68
robertg68 collected 645 from pot
*** SUMMARY ***
Total pot 645 | Rake 0=20
Board [Kd As Ah 7h]
Seat 2: hainesiv2 folded before Flop (didn't bet)
Seat 3: robertg68 collected (645)
Seat 5: camp183 folded before Flop (didn't bet)
Seat 6: elimin8tor1 folded before Flop (didn't bet)
Seat 7: JerseyGuy316 (button) folded before Flop (didn't bet)
Seat 8: JJin91 (small blind) folded before Flop
Seat 9: oceangurl2 (big blind) folded on the Turn


*********** # 6 **************
PokerStars Hand #170370859538: Tournament #1622573280, $9.10+$0.90 USD =
Hold'em No Limit - Level VI (75/150) - 2017/05/25 18:50:12 ET
Table '1622573280 1' 9-max Seat #8 is the button
Seat 1: FinesseU22 (10000 in chips)=20
Seat 2: hainesiv2 (12728 in chips)=20
Seat 3: robertg68 (18783 in chips)=20
Seat 5: camp183 (3605 in chips)=20
Seat 6: elimin8tor1 (10271 in chips)=20
Seat 7: JerseyGuy316 (12795 in chips)=20
Seat 8: JJin91 (12373 in chips)=20
Seat 9: oceangurl2 (16921 in chips)=20
FinesseU22: posts the ante 20
hainesiv2: posts the ante 20
robertg68: posts the ante 20
camp183: posts the ante 20
elimin8tor1: posts the ante 20
JerseyGuy316: posts the ante 20
JJin91: posts the ante 20
oceangurl2: posts the ante 20
oceangurl2: posts small blind 75
FinesseU22: posts big blind 150
*** HOLE CARDS ***
Dealt to JJin91 [2s 6h]
hainesiv2: folds=20
robertg68: folds=20
camp183: folds=20
elimin8tor1: folds=20
JerseyGuy316: folds=20
JJin91: folds=20
oceangurl2: raises 300 to 450
FinesseU22: calls 300
*** FLOP *** [4s Jc 7h]
oceangurl2: checks=20
FinesseU22: checks=20
*** TURN *** [4s Jc 7h] [Kd]
oceangurl2: bets 450
FinesseU22: calls 450
*** RIVER *** [4s Jc 7h Kd] [Js]
oceangurl2: bets 450
FinesseU22: calls 450
*** SHOW DOWN ***
oceangurl2: shows [Qc Kc] (two pair, Kings and Jacks)
FinesseU22: mucks hand=20
oceangurl2 collected 2860 from pot
*** SUMMARY ***
Total pot 2860 | Rake 0=20
Board [4s Jc 7h Kd Js]
Seat 1: FinesseU22 (big blind) mucked [Qs 7s]
Seat 2: hainesiv2 folded before Flop (didn't bet)
Seat 3: robertg68 folded before Flop (didn't bet)
Seat 5: camp183 folded before Flop (didn't bet)
Seat 6: elimin8tor1 folded before Flop (didn't bet)
Seat 7: JerseyGuy316 folded before Flop (didn't bet)
Seat 8: JJin91 (button) folded before Flop (didn't bet)
Seat 9: oceangurl2 (small blind) showed [Qc Kc] and won (2860) with two=
 pair, Kings and Jacks


*********** # 7 **************
PokerStars Hand #170370859704: Tournament #1622573280, $9.10+$0.90 USD =
Hold'em No Limit - Level VI (75/150) - 2017/05/25 18:50:58 ET
Table '1622573280 1' 9-max Seat #9 is the button
Seat 1: FinesseU22 (8630 in chips)=20
Seat 2: hainesiv2 (12708 in chips)=20
Seat 3: robertg68 (18763 in chips)=20
Seat 5: camp183 (3585 in chips)=20
Seat 6: elimin8tor1 (10251 in chips)=20
Seat 7: JerseyGuy316 (12775 in chips)=20
Seat 8: JJin91 (12353 in chips)=20
Seat 9: oceangurl2 (18411 in chips)=20
FinesseU22: posts the ante 20
hainesiv2: posts the ante 20
robertg68: posts the ante 20
camp183: posts the ante 20
elimin8tor1: posts the ante 20
JerseyGuy316: posts the ante 20
JJin91: posts the ante 20
oceangurl2: posts the ante 20
FinesseU22: posts small blind 75
hainesiv2: posts big blind 150
*** HOLE CARDS ***
Dealt to JJin91 [4c Tc]
robertg68: calls 150
camp183: raises 3415 to 3565 and is all-in
elimin8tor1: folds=20
JerseyGuy316: folds=20
JJin91: folds=20
oceangurl2: folds=20
FinesseU22: folds=20
hainesiv2: calls 3415
robertg68: folds=20
*** FLOP *** [As 4h Qc]
*** TURN *** [As 4h Qc] [8s]
*** RIVER *** [As 4h Qc 8s] [2s]
*** SHOW DOWN ***
hainesiv2: shows [Jc Ad] (a pair of Aces)
camp183: shows [Td Kd] (high card Ace)
hainesiv2 collected 7515 from pot
camp183 finished the tournament in 153rd place
*** SUMMARY ***
Total pot 7515 | Rake 0=20
Board [As 4h Qc 8s 2s]
Seat 1: FinesseU22 (small blind) folded before Flop
Seat 2: hainesiv2 (big blind) showed [Jc Ad] and won (7515) with a pair=
 of Aces
Seat 3: robertg68 folded before Flop
Seat 5: camp183 showed [Td Kd] and lost with high card Ace
Seat 6: elimin8tor1 folded before Flop (didn't bet)
Seat 7: JerseyGuy316 folded before Flop (didn't bet)
Seat 8: JJin91 folded before Flop (didn't bet)
Seat 9: oceangurl2 (button) folded before Flop (didn't bet)


*********** # 8 **************
PokerStars Hand #170370859809: Tournament #1622573280, $9.10+$0.90 USD =
Hold'em No Limit - Level VI (75/150) - 2017/05/25 18:51:29 ET
Table '1622573280 1' 9-max Seat #1 is the button
Seat 1: FinesseU22 (8535 in chips)=20
Seat 2: hainesiv2 (16638 in chips)=20
Seat 3: robertg68 (18593 in chips)=20
Seat 6: elimin8tor1 (10231 in chips)=20
Seat 7: JerseyGuy316 (12755 in chips)=20
Seat 8: JJin91 (12333 in chips)=20
Seat 9: oceangurl2 (18391 in chips)=20
FinesseU22: posts the ante 20
hainesiv2: posts the ante 20
robertg68: posts the ante 20
elimin8tor1: posts the ante 20
JerseyGuy316: posts the ante 20
JJin91: posts the ante 20
oceangurl2: posts the ante 20
hainesiv2: posts small blind 75
robertg68: posts big blind 150
*** HOLE CARDS ***
Dealt to JJin91 [9d 8c]
elimin8tor1: folds=20
JerseyGuy316: folds=20
JJin91: folds=20
oceangurl2: folds=20
FinesseU22: folds=20
hainesiv2: calls 75
robertg68: checks=20
*** FLOP *** [Js Jd Ks]
hainesiv2: checks=20
robertg68: bets 300
hainesiv2: calls 300
*** TURN *** [Js Jd Ks] [Th]
hainesiv2: checks=20
robertg68: bets 300
hainesiv2: calls 300
*** RIVER *** [Js Jd Ks Th] [6s]
hainesiv2: checks=20
robertg68: checks=20
*** SHOW DOWN ***
hainesiv2: shows [7s Kh] (two pair, Kings and Jacks)
robertg68: shows [4h Kc] (two pair, Kings and Jacks)
hainesiv2 collected 820 from pot
robertg68 collected 820 from pot
*** SUMMARY ***
Total pot 1640 | Rake 0=20
Board [Js Jd Ks Th 6s]
Seat 1: FinesseU22 (button) folded before Flop (didn't bet)
Seat 2: hainesiv2 (small blind) showed [7s Kh] and won (820) with two p=
air, Kings and Jacks
Seat 3: robertg68 (big blind) showed [4h Kc] and won (820) with two pai=
r, Kings and Jacks
Seat 6: elimin8tor1 folded before Flop (didn't bet)
Seat 7: JerseyGuy316 folded before Flop (didn't bet)
Seat 8: JJin91 folded before Flop (didn't bet)
Seat 9: oceangurl2 folded before Flop (didn't bet)


*********** # 9 **************
PokerStars Hand #170370859989: Tournament #1622573280, $9.10+$0.90 USD =
Hold'em No Limit - Level VI (75/150) - 2017/05/25 18:52:23 ET
Table '1622573280 1' 9-max Seat #2 is the button
Seat 1: FinesseU22 (8515 in chips)=20
Seat 2: hainesiv2 (16688 in chips)=20
Seat 3: robertg68 (18643 in chips)=20
Seat 4: hof49 (14920 in chips)=20
Seat 6: elimin8tor1 (10211 in chips)=20
Seat 7: JerseyGuy316 (12735 in chips)=20
Seat 8: JJin91 (12313 in chips)=20
Seat 9: oceangurl2 (18371 in chips)=20
FinesseU22: posts the ante 20
hainesiv2: posts the ante 20
robertg68: posts the ante 20
hof49: posts the ante 20
elimin8tor1: posts the ante 20
JerseyGuy316: posts the ante 20
JJin91: posts the ante 20
oceangurl2: posts the ante 20
robertg68: posts small blind 75
hof49: posts big blind 150
*** HOLE CARDS ***
Dealt to JJin91 [7s 7h]
elimin8tor1: folds=20
JerseyGuy316: folds=20
JJin91: raises 178 to 328
oceangurl2: folds=20
FinesseU22: calls 328
hainesiv2: folds=20
robertg68: folds=20
hof49: calls 178
*** FLOP *** [7d Qs Jc]
hof49: checks=20
JJin91: bets 451
FinesseU22: folds=20
hof49: calls 451
*** TURN *** [7d Qs Jc] [Ac]
hof49: checks=20
JJin91: bets 1209
hof49: folds=20
Uncalled bet (1209) returned to JJin91
JJin91 collected 2121 from pot
JJin91: doesn't show hand=20
*** SUMMARY ***
Total pot 2121 | Rake 0=20
Board [7d Qs Jc Ac]
Seat 1: FinesseU22 folded on the Flop
Seat 2: hainesiv2 (button) folded before Flop (didn't bet)
Seat 3: robertg68 (small blind) folded before Flop
Seat 4: hof49 (big blind) folded on the Turn
Seat 6: elimin8tor1 folded before Flop (didn't bet)
Seat 7: JerseyGuy316 folded before Flop (didn't bet)
Seat 8: JJin91 collected (2121)
Seat 9: oceangurl2 folded before Flop (didn't bet)


*********** # 10 **************
PokerStars Hand #170371770224: Tournament #1622573280, $9.10+$0.90 USD =
Hold'em No Limit - Level VI (75/150) - 2017/05/25 18:53:02 ET
Table '1622573280 1' 9-max Seat #3 is the button
Seat 1: FinesseU22 (8167 in chips)=20
Seat 2: hainesiv2 (16668 in chips)=20
Seat 3: robertg68 (18548 in chips)=20
Seat 4: hof49 (14121 in chips)=20
Seat 6: elimin8tor1 (10191 in chips)=20
Seat 7: JerseyGuy316 (12715 in chips)=20
Seat 8: JJin91 (13635 in chips)=20
Seat 9: oceangurl2 (18351 in chips)=20
FinesseU22: posts the ante 20
hainesiv2: posts the ante 20
robertg68: posts the ante 20
hof49: posts the ante 20
elimin8tor1: posts the ante 20
JerseyGuy316: posts the ante 20
JJin91: posts the ante 20
oceangurl2: posts the ante 20
hof49: posts small blind 75
elimin8tor1: posts big blind 150
*** HOLE CARDS ***
Dealt to JJin91 [6c Js]
JerseyGuy316: folds=20
JJin91: folds=20
oceangurl2: folds=20
FinesseU22: calls 150
hainesiv2: folds=20
robertg68: folds=20
hof49: raises 300 to 450
elimin8tor1: folds=20
FinesseU22: calls 300
*** FLOP *** [Qs 3h 3d]
hof49: checks=20
FinesseU22: checks=20
*** TURN *** [Qs 3h 3d] [8d]
hof49: bets 150
FinesseU22: folds=20
Uncalled bet (150) returned to hof49
hof49 collected 1210 from pot
hof49: doesn't show hand=20
*** SUMMARY ***
Total pot 1210 | Rake 0=20
Board [Qs 3h 3d 8d]
Seat 1: FinesseU22 folded on the Turn
Seat 2: hainesiv2 folded before Flop (didn't bet)
Seat 3: robertg68 (button) folded before Flop (didn't bet)
Seat 4: hof49 (small blind) collected (1210)
Seat 6: elimin8tor1 (big blind) folded before Flop
Seat 7: JerseyGuy316 folded before Flop (didn't bet)
Seat 8: JJin91 folded before Flop (didn't bet)
Seat 9: oceangurl2 folded before Flop (didn't bet)


*********** # 11 **************
PokerStars Hand #170371770376: Tournament #1622573280, $9.10+$0.90 USD =
Hold'em No Limit - Level VI (75/150) - 2017/05/25 18:53:47 ET
Table '1622573280 1' 9-max Seat #4 is the button
Seat 1: FinesseU22 (7697 in chips)=20
Seat 2: hainesiv2 (16648 in chips)=20
Seat 3: robertg68 (18528 in chips)=20
Seat 4: hof49 (14861 in chips)=20
Seat 6: elimin8tor1 (10021 in chips)=20
Seat 7: JerseyGuy316 (12695 in chips)=20
Seat 8: JJin91 (13615 in chips)=20
Seat 9: oceangurl2 (18331 in chips)=20
FinesseU22: posts the ante 20
hainesiv2: posts the ante 20
robertg68: posts the ante 20
hof49: posts the ante 20
elimin8tor1: posts the ante 20
JerseyGuy316: posts the ante 20
JJin91: posts the ante 20
oceangurl2: posts the ante 20
elimin8tor1: posts small blind 75
JerseyGuy316: posts big blind 150
*** HOLE CARDS ***
Dealt to JJin91 [9c Kh]
JJin91: folds=20
oceangurl2: calls 150
FinesseU22: folds=20
hainesiv2: calls 150
robertg68: calls 150
hof49: calls 150
elimin8tor1: folds=20
JerseyGuy316: checks=20
*** FLOP *** [8d 6c 7s]
JerseyGuy316: checks=20
oceangurl2: bets 300
hainesiv2: folds=20
robertg68: calls 300
hof49: calls 300
JerseyGuy316: folds=20
*** TURN *** [8d 6c 7s] [5d]
oceangurl2: bets 600
robertg68: folds=20
hof49: raises 1050 to 1650
oceangurl2: calls 1050
*** RIVER *** [8d 6c 7s 5d] [Jd]
oceangurl2: checks=20
hof49: bets 1950
oceangurl2: folds=20
Uncalled bet (1950) returned to hof49
hof49 collected 5185 from pot
hof49: doesn't show hand=20
*** SUMMARY ***
Total pot 5185 | Rake 0=20
Board [8d 6c 7s 5d Jd]
Seat 1: FinesseU22 folded before Flop (didn't bet)
Seat 2: hainesiv2 folded on the Flop
Seat 3: robertg68 folded on the Turn
Seat 4: hof49 (button) collected (5185)
Seat 6: elimin8tor1 (small blind) folded before Flop
Seat 7: JerseyGuy316 (big blind) folded on the Flop
Seat 8: JJin91 folded before Flop (didn't bet)
Seat 9: oceangurl2 folded on the River


*********** # 12 **************
PokerStars Hand #170371772038: Tournament #1622573280, $9.10+$0.90 USD =
Hold'em No Limit - Level VI (75/150) - 2017/05/25 19:02:24 ET
Table '1622573280 1' 9-max Seat #6 is the button
Seat 1: FinesseU22 (7677 in chips)=20
Seat 2: hainesiv2 (16478 in chips)=20
Seat 3: robertg68 (18058 in chips)=20
Seat 4: hof49 (17926 in chips)=20
Seat 6: elimin8tor1 (9926 in chips)=20
Seat 7: JerseyGuy316 (12525 in chips)=20
Seat 8: JJin91 (13595 in chips)=20
Seat 9: oceangurl2 (16211 in chips)=20
FinesseU22: posts the ante 20
hainesiv2: posts the ante 20
robertg68: posts the ante 20
hof49: posts the ante 20
elimin8tor1: posts the ante 20
JerseyGuy316: posts the ante 20
JJin91: posts the ante 20
oceangurl2: posts the ante 20
JerseyGuy316: posts small blind 75
JJin91: posts big blind 150
*** HOLE CARDS ***
Dealt to JJin91 [8d 4c]
oceangurl2: folds=20
FinesseU22: calls 150
hainesiv2: folds=20
robertg68: folds=20
hof49: calls 150
elimin8tor1: folds=20
JerseyGuy316: calls 75
JJin91: checks=20
*** FLOP *** [9c 8s 6s]
JerseyGuy316: bets 760
JJin91: folds=20
FinesseU22: folds=20
hof49: calls 760
*** TURN *** [9c 8s 6s] [7d]
JerseyGuy316: checks=20
hof49: bets 1800
JerseyGuy316: calls 1800
*** RIVER *** [9c 8s 6s 7d] [Tc]
JerseyGuy316: checks=20
hof49: checks=20
*** SHOW DOWN ***
JerseyGuy316: shows [6c 8h] (a straight, Six to Ten)
hof49: shows [9h Kc] (a straight, Six to Ten)
JerseyGuy316 collected 2940 from pot
hof49 collected 2940 from pot
*** SUMMARY ***
Total pot 5880 | Rake 0=20
Board [9c 8s 6s 7d Tc]
Seat 1: FinesseU22 folded on the Flop
Seat 2: hainesiv2 folded before Flop (didn't bet)
Seat 3: robertg68 folded before Flop (didn't bet)
Seat 4: hof49 showed [9h Kc] and won (2940) with a straight, Six to Ten
Seat 6: elimin8tor1 (button) folded before Flop (didn't bet)
Seat 7: JerseyGuy316 (small blind) showed [6c 8h] and won (2940) with a=
 straight, Six to Ten
Seat 8: JJin91 (big blind) folded on the Flop
Seat 9: oceangurl2 folded before Flop (didn't bet)


*********** # 13 **************
PokerStars Hand #170371772331: Tournament #1622573280, $9.10+$0.90 USD =
Hold'em No Limit - Level VI (75/150) - 2017/05/25 19:03:41 ET
Table '1622573280 1' 9-max Seat #7 is the button
Seat 1: FinesseU22 (7507 in chips)=20
Seat 2: hainesiv2 (16458 in chips)=20
Seat 3: robertg68 (18038 in chips)=20
Seat 4: hof49 (18136 in chips)=20
Seat 6: elimin8tor1 (9906 in chips)=20
Seat 7: JerseyGuy316 (12735 in chips)=20
Seat 8: JJin91 (13425 in chips)=20
Seat 9: oceangurl2 (16191 in chips)=20
FinesseU22: posts the ante 20
hainesiv2: posts the ante 20
robertg68: posts the ante 20
hof49: posts the ante 20
elimin8tor1: posts the ante 20
JerseyGuy316: posts the ante 20
JJin91: posts the ante 20
oceangurl2: posts the ante 20
JJin91: posts small blind 75
oceangurl2: posts big blind 150
*** HOLE CARDS ***
Dealt to JJin91 [9c 4s]
FinesseU22: raises 7337 to 7487 and is all-in
hainesiv2: folds=20
robertg68: folds=20
hof49: folds=20
elimin8tor1: folds=20
JerseyGuy316: folds=20
JJin91: folds=20
oceangurl2: folds=20
Uncalled bet (7337) returned to FinesseU22
FinesseU22 collected 535 from pot
*** SUMMARY ***
Total pot 535 | Rake 0=20
Seat 1: FinesseU22 collected (535)
Seat 2: hainesiv2 folded before Flop (didn't bet)
Seat 3: robertg68 folded before Flop (didn't bet)
Seat 4: hof49 folded before Flop (didn't bet)
Seat 6: elimin8tor1 folded before Flop (didn't bet)
Seat 7: JerseyGuy316 (button) folded before Flop (didn't bet)
Seat 8: JJin91 (small blind) folded before Flop
Seat 9: oceangurl2 (big blind) folded before Flop


*********** # 14 **************
PokerStars Hand #170371772415: Tournament #1622573280, $9.10+$0.90 USD =
Hold'em No Limit - Level VI (75/150) - 2017/05/25 19:04:07 ET
Table '1622573280 1' 9-max Seat #8 is the button
Seat 1: FinesseU22 (7872 in chips)=20
Seat 2: hainesiv2 (16438 in chips)=20
Seat 3: robertg68 (18018 in chips)=20
Seat 4: hof49 (18116 in chips)=20
Seat 6: elimin8tor1 (9886 in chips)=20
Seat 7: JerseyGuy316 (12715 in chips)=20
Seat 8: JJin91 (13330 in chips)=20
Seat 9: oceangurl2 (16021 in chips)=20
FinesseU22: posts the ante 20
hainesiv2: posts the ante 20
robertg68: posts the ante 20
hof49: posts the ante 20
elimin8tor1: posts the ante 20
JerseyGuy316: posts the ante 20
JJin91: posts the ante 20
oceangurl2: posts the ante 20
oceangurl2: posts small blind 75
FinesseU22: posts big blind 150
*** HOLE CARDS ***
Dealt to JJin91 [4s 5c]
hainesiv2: folds=20
robertg68: folds=20
hof49: calls 150
elimin8tor1: folds=20
JerseyGuy316: calls 150
JJin91: folds=20
oceangurl2: folds=20
FinesseU22: checks=20
*** FLOP *** [3c Qd 6h]
FinesseU22: checks=20
hof49: checks=20
JerseyGuy316: bets 343
FinesseU22: folds=20
hof49: folds=20
Uncalled bet (343) returned to JerseyGuy316
JerseyGuy316 collected 685 from pot
JerseyGuy316: doesn't show hand=20
*** SUMMARY ***
Total pot 685 | Rake 0=20
Board [3c Qd 6h]
Seat 1: FinesseU22 (big blind) folded on the Flop
Seat 2: hainesiv2 folded before Flop (didn't bet)
Seat 3: robertg68 folded before Flop (didn't bet)
Seat 4: hof49 folded on the Flop
Seat 6: elimin8tor1 folded before Flop (didn't bet)
Seat 7: JerseyGuy316 collected (685)
Seat 8: JJin91 (button) folded before Flop (didn't bet)
Seat 9: oceangurl2 (small blind) folded before Flop


*********** # 15 **************
PokerStars Hand #170371772566: Tournament #1622573280, $9.10+$0.90 USD =
Hold'em No Limit - Level VI (75/150) - 2017/05/25 19:04:47 ET
Table '1622573280 1' 9-max Seat #9 is the button
Seat 1: FinesseU22 (7702 in chips)=20
Seat 2: hainesiv2 (16418 in chips)=20
Seat 3: robertg68 (17998 in chips)=20
Seat 4: hof49 (17946 in chips)=20
Seat 6: elimin8tor1 (9866 in chips)=20
Seat 7: JerseyGuy316 (13230 in chips)=20
Seat 8: JJin91 (13310 in chips)=20
Seat 9: oceangurl2 (15926 in chips)=20
FinesseU22: posts the ante 20
hainesiv2: posts the ante 20
robertg68: posts the ante 20
hof49: posts the ante 20
elimin8tor1: posts the ante 20
JerseyGuy316: posts the ante 20
JJin91: posts the ante 20
oceangurl2: posts the ante 20
FinesseU22: posts small blind 75
hainesiv2: posts big blind 150
*** HOLE CARDS ***
Dealt to JJin91 [6s 8d]
robertg68: folds=20
hof49: folds=20
elimin8tor1: raises 225 to 375
JerseyGuy316: folds=20
JJin91: folds=20
oceangurl2: folds=20
FinesseU22: folds=20
hainesiv2: calls 225
*** FLOP *** [8h 6d 5h]
hainesiv2: checks=20
elimin8tor1: bets 739
hainesiv2: folds=20
Uncalled bet (739) returned to elimin8tor1
elimin8tor1 collected 985 from pot
elimin8tor1: doesn't show hand=20
*** SUMMARY ***
Total pot 985 | Rake 0=20
Board [8h 6d 5h]
Seat 1: FinesseU22 (small blind) folded before Flop
Seat 2: hainesiv2 (big blind) folded on the Flop
Seat 3: robertg68 folded before Flop (didn't bet)
Seat 4: hof49 folded before Flop (didn't bet)
Seat 6: elimin8tor1 collected (985)
Seat 7: JerseyGuy316 folded before Flop (didn't bet)
Seat 8: JJin91 folded before Flop (didn't bet)
Seat 9: oceangurl2 (button) folded before Flop (didn't bet)


*********** # 16 **************
PokerStars Hand #170371772752: Tournament #1622573280, $9.10+$0.90 USD =
Hold'em No Limit - Level VI (75/150) - 2017/05/25 19:05:41 ET
Table '1622573280 1' 9-max Seat #1 is the button
Seat 1: FinesseU22 (7607 in chips)=20
Seat 2: hainesiv2 (16023 in chips)=20
Seat 3: robertg68 (17978 in chips)=20
Seat 4: hof49 (17926 in chips)=20
Seat 6: elimin8tor1 (10456 in chips)=20
Seat 7: JerseyGuy316 (13210 in chips)=20
Seat 8: JJin91 (13290 in chips)=20
Seat 9: oceangurl2 (15906 in chips)=20
FinesseU22: posts the ante 20
hainesiv2: posts the ante 20
robertg68: posts the ante 20
hof49: posts the ante 20
elimin8tor1: posts the ante 20
JerseyGuy316: posts the ante 20
JJin91: posts the ante 20
oceangurl2: posts the ante 20
hainesiv2: posts small blind 75
robertg68: posts big blind 150
*** HOLE CARDS ***
Dealt to JJin91 [9c 7d]
hof49: folds=20
elimin8tor1: folds=20
JerseyGuy316: folds=20
JJin91: folds=20
oceangurl2: calls 150
FinesseU22: folds=20
hainesiv2: folds=20
robertg68: checks=20
*** FLOP *** [6d 8d 7h]
robertg68: checks=20
oceangurl2: checks=20
*** TURN *** [6d 8d 7h] [4d]
robertg68: checks=20
oceangurl2: checks=20
*** RIVER *** [6d 8d 7h 4d] [2h]
robertg68: checks=20
oceangurl2: checks=20
*** SHOW DOWN ***
robertg68: shows [Js 6c] (a pair of Sixes)
oceangurl2: mucks hand=20
robertg68 collected 535 from pot
*** SUMMARY ***
Total pot 535 | Rake 0=20
Board [6d 8d 7h 4d 2h]
Seat 1: FinesseU22 (button) folded before Flop (didn't bet)
Seat 2: hainesiv2 (small blind) folded before Flop
Seat 3: robertg68 (big blind) showed [Js 6c] and won (535) with a pair =
of Sixes
Seat 4: hof49 folded before Flop (didn't bet)
Seat 6: elimin8tor1 folded before Flop (didn't bet)
Seat 7: JerseyGuy316 folded before Flop (didn't bet)
Seat 8: JJin91 folded before Flop (didn't bet)
Seat 9: oceangurl2 mucked [Jc Qh]


*********** # 17 **************
PokerStars Hand #170371772917: Tournament #1622573280, $9.10+$0.90 USD =
Hold'em No Limit - Level VI (75/150) - 2017/05/25 19:06:31 ET
Table '1622573280 1' 9-max Seat #2 is the button
Seat 1: FinesseU22 (7587 in chips)=20
Seat 2: hainesiv2 (15928 in chips)=20
Seat 3: robertg68 (18343 in chips)=20
Seat 4: hof49 (17906 in chips)=20
Seat 6: elimin8tor1 (10436 in chips)=20
Seat 7: JerseyGuy316 (13190 in chips)=20
Seat 8: JJin91 (13270 in chips)=20
Seat 9: oceangurl2 (15736 in chips)=20
FinesseU22: posts the ante 20
hainesiv2: posts the ante 20
robertg68: posts the ante 20
hof49: posts the ante 20
elimin8tor1: posts the ante 20
JerseyGuy316: posts the ante 20
JJin91: posts the ante 20
oceangurl2: posts the ante 20
robertg68: posts small blind 75
hof49: posts big blind 150
*** HOLE CARDS ***
Dealt to JJin91 [7c Qs]
elimin8tor1: raises 150 to 300
JerseyGuy316: folds=20
JJin91: folds=20
oceangurl2: folds=20
FinesseU22: calls 300
hainesiv2: calls 300
robertg68: calls 225
hof49: calls 150
*** FLOP *** [9h 9s 3d]
robertg68: checks=20
hof49: bets 150
elimin8tor1: calls 150
FinesseU22: folds=20
hainesiv2: folds=20
robertg68: calls 150
*** TURN *** [9h 9s 3d] [2h]
robertg68: checks=20
hof49: bets 150
elimin8tor1: calls 150
robertg68: calls 150
*** RIVER *** [9h 9s 3d 2h] [5s]
robertg68: checks=20
hof49: checks=20
elimin8tor1: bets 1280
robertg68: folds=20
hof49: folds=20
Uncalled bet (1280) returned to elimin8tor1
elimin8tor1 collected 2560 from pot
elimin8tor1: doesn't show hand=20
*** SUMMARY ***
Total pot 2560 | Rake 0=20
Board [9h 9s 3d 2h 5s]
Seat 1: FinesseU22 folded on the Flop
Seat 2: hainesiv2 (button) folded on the Flop
Seat 3: robertg68 (small blind) folded on the River
Seat 4: hof49 (big blind) folded on the River
Seat 6: elimin8tor1 collected (2560)
Seat 7: JerseyGuy316 folded before Flop (didn't bet)
Seat 8: JJin91 folded before Flop (didn't bet)
Seat 9: oceangurl2 folded before Flop (didn't bet)


*********** # 18 **************
PokerStars Hand #170371773208: Tournament #1622573280, $9.10+$0.90 USD =
Hold'em No Limit - Level VII (100/200) - 2017/05/25 19:08:02 ET
Table '1622573280 1' 9-max Seat #3 is the button
Seat 1: FinesseU22 (7267 in chips)=20
Seat 2: hainesiv2 (15608 in chips)=20
Seat 3: robertg68 (17723 in chips)=20
Seat 4: hof49 (17286 in chips)=20
Seat 5: toodope4you (10000 in chips)=20
Seat 6: elimin8tor1 (12376 in chips)=20
Seat 7: JerseyGuy316 (13170 in chips)=20
Seat 8: JJin91 (13250 in chips)=20
Seat 9: oceangurl2 (15716 in chips)=20
FinesseU22: posts the ante 25
hainesiv2: posts the ante 25
robertg68: posts the ante 25
hof49: posts the ante 25
toodope4you: posts the ante 25
elimin8tor1: posts the ante 25
JerseyGuy316: posts the ante 25
JJin91: posts the ante 25
oceangurl2: posts the ante 25
hof49: posts small blind 100
toodope4you: posts big blind 200
*** HOLE CARDS ***
Dealt to JJin91 [8s 4d]
elimin8tor1: folds=20
JerseyGuy316: folds=20
JJin91: folds=20
oceangurl2: calls 200
FinesseU22: calls 200
hainesiv2: calls 200
robertg68: folds=20
hof49: calls 100
toodope4you: checks=20
*** FLOP *** [Qh Kh 9s]
hof49: checks=20
toodope4you: checks=20
oceangurl2: checks=20
FinesseU22: checks=20
hainesiv2: checks=20
*** TURN *** [Qh Kh 9s] [Ad]
hof49: checks=20
toodope4you: bets 817
oceangurl2: folds=20
FinesseU22: calls 817
hainesiv2: calls 817
hof49: folds=20
*** RIVER *** [Qh Kh 9s Ad] [Qc]
toodope4you: bets 2451
FinesseU22: calls 2451
hainesiv2: calls 2451
*** SHOW DOWN ***
toodope4you: shows [Ts Ah] (two pair, Aces and Queens)
FinesseU22: shows [2d As] (two pair, Aces and Queens)
hainesiv2: shows [Tc Qs] (three of a kind, Queens)
hainesiv2 collected 11029 from pot
*** SUMMARY ***
Total pot 11029 | Rake 0=20
Board [Qh Kh 9s Ad Qc]
Seat 1: FinesseU22 showed [2d As] and lost with two pair, Aces and Quee=
ns
Seat 2: hainesiv2 showed [Tc Qs] and won (11029) with three of a kind, =
Queens
Seat 3: robertg68 (button) folded before Flop (didn't bet)
Seat 4: hof49 (small blind) folded on the Turn
Seat 5: toodope4you (big blind) showed [Ts Ah] and lost with two pair, =
Aces and Queens
Seat 6: elimin8tor1 folded before Flop (didn't bet)
Seat 7: JerseyGuy316 folded before Flop (didn't bet)
Seat 8: JJin91 folded before Flop (didn't bet)
Seat 9: oceangurl2 folded on the Turn


*********** # 19 **************
PokerStars Hand #170371773462: Tournament #1622573280, $9.10+$0.90 USD =
Hold'em No Limit - Level VII (100/200) - 2017/05/25 19:09:23 ET
Table '1622573280 1' 9-max Seat #4 is the button
Seat 1: FinesseU22 (3774 in chips)=20
Seat 2: hainesiv2 (23144 in chips)=20
Seat 3: robertg68 (17698 in chips)=20
Seat 4: hof49 (17061 in chips)=20
Seat 5: toodope4you (6507 in chips)=20
Seat 6: elimin8tor1 (12351 in chips)=20
Seat 7: JerseyGuy316 (13145 in chips)=20
Seat 8: JJin91 (13225 in chips)=20
Seat 9: oceangurl2 (15491 in chips)=20
FinesseU22: posts the ante 25
hainesiv2: posts the ante 25
robertg68: posts the ante 25
hof49: posts the ante 25
toodope4you: posts the ante 25
elimin8tor1: posts the ante 25
JerseyGuy316: posts the ante 25
JJin91: posts the ante 25
oceangurl2: posts the ante 25
toodope4you: posts small blind 100
elimin8tor1: posts big blind 200
*** HOLE CARDS ***
Dealt to JJin91 [7s 9d]
JerseyGuy316: calls 200
JJin91: folds=20
oceangurl2: calls 200
FinesseU22: folds=20
hainesiv2: folds=20
robertg68: folds=20
hof49: folds=20
toodope4you: folds=20
elimin8tor1: checks=20
*** FLOP *** [Ah Jc 2d]
elimin8tor1: checks=20
JerseyGuy316: checks=20
oceangurl2: checks=20
*** TURN *** [Ah Jc 2d] [9s]
elimin8tor1: checks=20
JerseyGuy316: checks=20
oceangurl2: checks=20
*** RIVER *** [Ah Jc 2d 9s] [Td]
elimin8tor1: checks=20
JerseyGuy316: checks=20
oceangurl2: checks=20
*** SHOW DOWN ***
elimin8tor1: shows [7d 9h] (a pair of Nines)
JerseyGuy316: mucks hand=20
oceangurl2: shows [Ts Kh] (a pair of Tens)
oceangurl2 collected 925 from pot
*** SUMMARY ***
Total pot 925 | Rake 0=20
Board [Ah Jc 2d 9s Td]
Seat 1: FinesseU22 folded before Flop (didn't bet)
Seat 2: hainesiv2 folded before Flop (didn't bet)
Seat 3: robertg68 folded before Flop (didn't bet)
Seat 4: hof49 (button) folded before Flop (didn't bet)
Seat 5: toodope4you (small blind) folded before Flop
Seat 6: elimin8tor1 (big blind) showed [7d 9h] and lost with a pair of =
Nines
Seat 7: JerseyGuy316 mucked [3d Kd]
Seat 8: JJin91 folded before Flop (didn't bet)
Seat 9: oceangurl2 showed [Ts Kh] and won (925) with a pair of Tens


*********** # 20 **************
PokerStars Hand #170371773624: Tournament #1622573280, $9.10+$0.90 USD =
Hold'em No Limit - Level VII (100/200) - 2017/05/25 19:10:24 ET
Table '1622573280 1' 9-max Seat #5 is the button
Seat 1: FinesseU22 (3749 in chips)=20
Seat 2: hainesiv2 (23119 in chips)=20
Seat 3: robertg68 (17673 in chips)=20
Seat 4: hof49 (17036 in chips)=20
Seat 5: toodope4you (6382 in chips)=20
Seat 6: elimin8tor1 (12126 in chips)=20
Seat 7: JerseyGuy316 (12920 in chips)=20
Seat 8: JJin91 (13200 in chips)=20
Seat 9: oceangurl2 (16191 in chips)=20
FinesseU22: posts the ante 25
hainesiv2: posts the ante 25
robertg68: posts the ante 25
hof49: posts the ante 25
toodope4you: posts the ante 25
elimin8tor1: posts the ante 25
JerseyGuy316: posts the ante 25
JJin91: posts the ante 25
oceangurl2: posts the ante 25
elimin8tor1: posts small blind 100
JerseyGuy316: posts big blind 200
*** HOLE CARDS ***
Dealt to JJin91 [Kh Qs]
JJin91: raises 238 to 438
oceangurl2: folds=20
FinesseU22: calls 438
hainesiv2: folds=20
robertg68: folds=20
hof49: calls 438
toodope4you: folds=20
elimin8tor1: folds=20
JerseyGuy316: folds=20
*** FLOP *** [9c 4d 6h]
JJin91: checks=20
FinesseU22: checks=20
hof49: checks=20
*** TURN *** [9c 4d 6h] [Ks]
JJin91: checks=20
FinesseU22: checks=20
hof49: checks=20
*** RIVER *** [9c 4d 6h Ks] [3d]
JJin91: bets 1839
FinesseU22: folds=20
hof49: folds=20
Uncalled bet (1839) returned to JJin91
JJin91 collected 1839 from pot
JJin91: doesn't show hand=20
*** SUMMARY ***
Total pot 1839 | Rake 0=20
Board [9c 4d 6h Ks 3d]
Seat 1: FinesseU22 folded on the River
Seat 2: hainesiv2 folded before Flop (didn't bet)
Seat 3: robertg68 folded before Flop (didn't bet)
Seat 4: hof49 folded on the River
Seat 5: toodope4you (button) folded before Flop (didn't bet)
Seat 6: elimin8tor1 (small blind) folded before Flop
Seat 7: JerseyGuy316 (big blind) folded before Flop
Seat 8: JJin91 collected (1839)
Seat 9: oceangurl2 folded before Flop (didn't bet)


*********** # 21 **************
PokerStars Hand #170371773860: Tournament #1622573280, $9.10+$0.90 USD =
Hold'em No Limit - Level VII (100/200) - 2017/05/25 19:11:37 ET
Table '1622573280 1' 9-max Seat #6 is the button
Seat 1: FinesseU22 (3286 in chips)=20
Seat 2: hainesiv2 (23094 in chips)=20
Seat 3: robertg68 (17648 in chips)=20
Seat 4: hof49 (16573 in chips)=20
Seat 5: toodope4you (6357 in chips)=20
Seat 6: elimin8tor1 (12001 in chips)=20
Seat 7: JerseyGuy316 (12695 in chips)=20
Seat 8: JJin91 (14576 in chips)=20
Seat 9: oceangurl2 (16166 in chips)=20
FinesseU22: posts the ante 25
hainesiv2: posts the ante 25
robertg68: posts the ante 25
hof49: posts the ante 25
toodope4you: posts the ante 25
elimin8tor1: posts the ante 25
JerseyGuy316: posts the ante 25
JJin91: posts the ante 25
oceangurl2: posts the ante 25
JerseyGuy316: posts small blind 100
JJin91: posts big blind 200
*** HOLE CARDS ***
Dealt to JJin91 [Jc Qh]
oceangurl2: folds=20
FinesseU22: calls 200
hainesiv2: folds=20
robertg68: folds=20
hof49: calls 200
toodope4you: raises 440 to 640
elimin8tor1: folds=20
JerseyGuy316: calls 540
JJin91: folds=20
FinesseU22: calls 440
hof49: calls 440
*** FLOP *** [Th Ks 7c]
JerseyGuy316: checks=20
FinesseU22: bets 2621 and is all-in
hof49: calls 2621
toodope4you: folds=20
JerseyGuy316: folds=20
*** TURN *** [Th Ks 7c] [4d]
*** RIVER *** [Th Ks 7c 4d] [Kd]
*** SHOW DOWN ***
FinesseU22: shows [Ac Tc] (two pair, Kings and Tens)
hof49: shows [Qd 9c] (a pair of Kings)
FinesseU22 collected 8227 from pot
*** SUMMARY ***
Total pot 8227 | Rake 0=20
Board [Th Ks 7c 4d Kd]
Seat 1: FinesseU22 showed [Ac Tc] and won (8227) with two pair, Kings a=
nd Tens
Seat 2: hainesiv2 folded before Flop (didn't bet)
Seat 3: robertg68 folded before Flop (didn't bet)
Seat 4: hof49 showed [Qd 9c] and lost with a pair of Kings
Seat 5: toodope4you folded on the Flop
Seat 6: elimin8tor1 (button) folded before Flop (didn't bet)
Seat 7: JerseyGuy316 (small blind) folded on the Flop
Seat 8: JJin91 (big blind) folded before Flop
Seat 9: oceangurl2 folded before Flop (didn't bet)


*********** # 22 **************
PokerStars Hand #170371774132: Tournament #1622573280, $9.10+$0.90 USD =
Hold'em No Limit - Level VII (100/200) - 2017/05/25 19:13:03 ET
Table '1622573280 1' 9-max Seat #7 is the button
Seat 1: FinesseU22 (8227 in chips)=20
Seat 2: hainesiv2 (23069 in chips)=20
Seat 3: robertg68 (17623 in chips)=20
Seat 4: hof49 (13287 in chips)=20
Seat 5: toodope4you (5692 in chips)=20
Seat 6: elimin8tor1 (11976 in chips)=20
Seat 7: JerseyGuy316 (12030 in chips)=20
Seat 8: JJin91 (14351 in chips)=20
FinesseU22: posts the ante 25
hainesiv2: posts the ante 25
robertg68: posts the ante 25
hof49: posts the ante 25
toodope4you: posts the ante 25
elimin8tor1: posts the ante 25
JerseyGuy316: posts the ante 25
JJin91: posts the ante 25
JJin91: posts small blind 100
FinesseU22: posts big blind 200
*** HOLE CARDS ***
Dealt to JJin91 [Qh Ad]
hainesiv2: folds=20
robertg68: calls 200
hof49: folds=20
toodope4you: folds=20
elimin8tor1: calls 200
JerseyGuy316: calls 200
JJin91: raises 1012 to 1212
FinesseU22: calls 1012
robertg68: folds=20
elimin8tor1: folds=20
JerseyGuy316: folds=20
*** FLOP *** [4c 5h Jh]
JJin91: checks=20
FinesseU22: bets 200
JJin91: calls 200
*** TURN *** [4c 5h Jh] [Js]
JJin91: checks=20
FinesseU22: bets 200
JJin91: calls 200
*** RIVER *** [4c 5h Jh Js] [2d]
JJin91: checks=20
FinesseU22: checks=20
*** SHOW DOWN ***
JJin91: shows [Qh Ad] (a pair of Jacks)
FinesseU22: mucks hand=20
JJin91 collected 4024 from pot
*** SUMMARY ***
Total pot 4024 | Rake 0=20
Board [4c 5h Jh Js 2d]
Seat 1: FinesseU22 (big blind) mucked [7h 6h]
Seat 2: hainesiv2 folded before Flop (didn't bet)
Seat 3: robertg68 folded before Flop
Seat 4: hof49 folded before Flop (didn't bet)
Seat 5: toodope4you folded before Flop (didn't bet)
Seat 6: elimin8tor1 folded before Flop
Seat 7: JerseyGuy316 (button) folded before Flop
Seat 8: JJin91 (small blind) showed [Qh Ad] and won (4024) with a pair =
of Jacks


*********** # 23 **************
PokerStars Hand #170371774434: Tournament #1622573280, $9.10+$0.90 USD =
Hold'em No Limit - Level VII (100/200) - 2017/05/25 19:14:30 ET
Table '1622573280 1' 9-max Seat #8 is the button
Seat 1: FinesseU22 (6590 in chips)=20
Seat 2: hainesiv2 (23044 in chips)=20
Seat 3: robertg68 (17398 in chips)=20
Seat 4: hof49 (13262 in chips)=20
Seat 5: toodope4you (5667 in chips)=20
Seat 6: elimin8tor1 (11751 in chips)=20
Seat 7: JerseyGuy316 (11805 in chips)=20
Seat 8: JJin91 (16738 in chips)=20
Seat 9: xJaehaerysx (10000 in chips) out of hand (moved from another ta=
ble into small blind)
FinesseU22: posts the ante 25
hainesiv2: posts the ante 25
robertg68: posts the ante 25
hof49: posts the ante 25
toodope4you: posts the ante 25
elimin8tor1: posts the ante 25
JerseyGuy316: posts the ante 25
JJin91: posts the ante 25
FinesseU22: posts small blind 100
hainesiv2: posts big blind 200
*** HOLE CARDS ***
Dealt to JJin91 [Ad Kc]
robertg68: folds=20
hof49: raises 200 to 400
toodope4you: folds=20
elimin8tor1: calls 400
JerseyGuy316: folds=20
JJin91: raises 1394 to 1794
FinesseU22: folds=20
hainesiv2: folds=20
hof49: calls 1394
elimin8tor1: folds=20
*** FLOP *** [6h 7c 9c]
hof49: checks=20
JJin91: checks=20
*** TURN *** [6h 7c 9c] [5c]
hof49: bets 400
JJin91: calls 400
*** RIVER *** [6h 7c 9c 5c] [8c]
hof49: bets 800
JJin91: calls 800
*** SHOW DOWN ***
hof49: shows [4s As] (a straight, Five to Nine)
JJin91: shows [Ad Kc] (a flush, King high)
JJin91 collected 6888 from pot
*** SUMMARY ***
Total pot 6888 | Rake 0=20
Board [6h 7c 9c 5c 8c]
Seat 1: FinesseU22 (small blind) folded before Flop
Seat 2: hainesiv2 (big blind) folded before Flop
Seat 3: robertg68 folded before Flop (didn't bet)
Seat 4: hof49 showed [4s As] and lost with a straight, Five to Nine
Seat 5: toodope4you folded before Flop (didn't bet)
Seat 6: elimin8tor1 folded before Flop
Seat 7: JerseyGuy316 folded before Flop (didn't bet)
Seat 8: JJin91 (button) showed [Ad Kc] and won (6888) with a flush, Kin=
g high


*********** # 24 **************
PokerStars Hand #170371774716: Tournament #1622573280, $9.10+$0.90 USD =
Hold'em No Limit - Level VII (100/200) - 2017/05/25 19:15:58 ET
Table '1622573280 1' 9-max Seat #1 is the button
Seat 1: FinesseU22 (6465 in chips)=20
Seat 2: hainesiv2 (22819 in chips)=20
Seat 3: robertg68 (17373 in chips)=20
Seat 4: hof49 (10243 in chips)=20
Seat 5: toodope4you (5642 in chips)=20
Seat 6: elimin8tor1 (11326 in chips)=20
Seat 7: JerseyGuy316 (11780 in chips)=20
Seat 8: JJin91 (20607 in chips)=20
Seat 9: xJaehaerysx (10000 in chips)=20
FinesseU22: posts the ante 25
hainesiv2: posts the ante 25
robertg68: posts the ante 25
hof49: posts the ante 25
toodope4you: posts the ante 25
elimin8tor1: posts the ante 25
JerseyGuy316: posts the ante 25
JJin91: posts the ante 25
xJaehaerysx: posts the ante 25
hainesiv2: posts small blind 100
robertg68: posts big blind 200
*** HOLE CARDS ***
Dealt to JJin91 [4h Ah]
hof49: raises 1800 to 2000
toodope4you: folds=20
elimin8tor1: folds=20
JerseyGuy316: calls 2000
JJin91: folds=20
xJaehaerysx: folds=20
FinesseU22: folds=20
hainesiv2: folds=20
robertg68: folds=20
*** FLOP *** [Kh 5d 8c]
hof49: checks=20
JerseyGuy316: checks=20
*** TURN *** [Kh 5d 8c] [5h]
hof49: bets 800
JerseyGuy316: calls 800
*** RIVER *** [Kh 5d 8c 5h] [6h]
hof49: bets 1800
JerseyGuy316: calls 1800
*** SHOW DOWN ***
hof49: shows [Kc As] (two pair, Kings and Fives)
JerseyGuy316: mucks hand=20
hof49 collected 9725 from pot
*** SUMMARY ***
Total pot 9725 | Rake 0=20
Board [Kh 5d 8c 5h 6h]
Seat 1: FinesseU22 (button) folded before Flop (didn't bet)
Seat 2: hainesiv2 (small blind) folded before Flop
Seat 3: robertg68 (big blind) folded before Flop
Seat 4: hof49 showed [Kc As] and won (9725) with two pair, Kings and Fi=
ves
Seat 5: toodope4you folded before Flop (didn't bet)
Seat 6: elimin8tor1 folded before Flop (didn't bet)
Seat 7: JerseyGuy316 mucked [9h 9s]
Seat 8: JJin91 folded before Flop (didn't bet)
Seat 9: xJaehaerysx folded before Flop (didn't bet)


*********** # 25 **************
PokerStars Hand #170371774937: Tournament #1622573280, $9.10+$0.90 USD =
Hold'em No Limit - Level VII (100/200) - 2017/05/25 19:17:06 ET
Table '1622573280 1' 9-max Seat #2 is the button
Seat 1: FinesseU22 (6440 in chips)=20
Seat 2: hainesiv2 (22694 in chips)=20
Seat 3: robertg68 (17148 in chips)=20
Seat 4: hof49 (15343 in chips)=20
Seat 5: toodope4you (5617 in chips)=20
Seat 6: elimin8tor1 (11301 in chips)=20
Seat 7: JerseyGuy316 (7155 in chips)=20
Seat 8: JJin91 (20582 in chips)=20
Seat 9: xJaehaerysx (9975 in chips)=20
FinesseU22: posts the ante 25
hainesiv2: posts the ante 25
robertg68: posts the ante 25
hof49: posts the ante 25
toodope4you: posts the ante 25
elimin8tor1: posts the ante 25
JerseyGuy316: posts the ante 25
JJin91: posts the ante 25
xJaehaerysx: posts the ante 25
robertg68: posts small blind 100
hof49: posts big blind 200
*** HOLE CARDS ***
Dealt to JJin91 [9c Qs]
toodope4you: folds=20
elimin8tor1: folds=20
JerseyGuy316: calls 200
JJin91: folds=20
xJaehaerysx: folds=20
FinesseU22: calls 200
hainesiv2: folds=20
robertg68: calls 100
hof49: checks=20
*** FLOP *** [2c 4h 3d]
robertg68: checks=20
hof49: bets 600
JerseyGuy316: folds=20
FinesseU22: calls 600
robertg68: calls 600
*** TURN *** [2c 4h 3d] [8h]
robertg68: checks=20
hof49: bets 400
FinesseU22: calls 400
robertg68: calls 400
*** RIVER *** [2c 4h 3d 8h] [3h]
robertg68: checks=20
hof49: checks=20
FinesseU22: checks=20
*** SHOW DOWN ***
robertg68: shows [Jd 3s] (three of a kind, Threes)
hof49: mucks hand=20
FinesseU22: mucks hand=20
robertg68 collected 4025 from pot
*** SUMMARY ***
Total pot 4025 | Rake 0=20
Board [2c 4h 3d 8h 3h]
Seat 1: FinesseU22 mucked [Ks 6d]
Seat 2: hainesiv2 (button) folded before Flop (didn't bet)
Seat 3: robertg68 (small blind) showed [Jd 3s] and won (4025) with thre=
e of a kind, Threes
Seat 4: hof49 (big blind) mucked [9s 4d]
Seat 5: toodope4you folded before Flop (didn't bet)
Seat 6: elimin8tor1 folded before Flop (didn't bet)
Seat 7: JerseyGuy316 folded on the Flop
Seat 8: JJin91 folded before Flop (didn't bet)
Seat 9: xJaehaerysx folded before Flop (didn't bet)


*********** # 26 **************
PokerStars Hand #170371775209: Tournament #1622573280, $9.10+$0.90 USD =
Hold'em No Limit - Level VIII (125/250) - 2017/05/25 19:18:32 ET
Table '1622573280 1' 9-max Seat #3 is the button
Seat 1: FinesseU22 (5215 in chips)=20
Seat 2: hainesiv2 (22669 in chips)=20
Seat 3: robertg68 (19948 in chips)=20
Seat 4: hof49 (14118 in chips)=20
Seat 5: toodope4you (5592 in chips)=20
Seat 6: elimin8tor1 (11276 in chips)=20
Seat 7: JerseyGuy316 (6930 in chips)=20
Seat 8: JJin91 (20557 in chips)=20
Seat 9: xJaehaerysx (9950 in chips)=20
FinesseU22: posts the ante 30
hainesiv2: posts the ante 30
robertg68: posts the ante 30
hof49: posts the ante 30
toodope4you: posts the ante 30
elimin8tor1: posts the ante 30
JerseyGuy316: posts the ante 30
JJin91: posts the ante 30
xJaehaerysx: posts the ante 30
hof49: posts small blind 125
toodope4you: posts big blind 250
*** HOLE CARDS ***
Dealt to JJin91 [2d 2h]
elimin8tor1: folds=20
JerseyGuy316: calls 250
JJin91: calls 250
xJaehaerysx: folds=20
FinesseU22: calls 250
hainesiv2: calls 250
robertg68: folds=20
hof49: calls 125
toodope4you: checks=20
*** FLOP *** [6s Qs Kd]
hof49: checks=20
toodope4you: checks=20
JerseyGuy316: checks=20
JJin91: checks=20
FinesseU22: checks=20
hainesiv2: checks=20
*** TURN *** [6s Qs Kd] [4c]
hof49: bets 250
toodope4you: folds=20
JerseyGuy316: folds=20
JJin91: folds=20
FinesseU22: calls 250
hainesiv2: raises 2268 to 2518
hof49: folds=20
FinesseU22: calls 2268
*** RIVER *** [6s Qs Kd 4c] [As]
FinesseU22: checks=20
hainesiv2: checks=20
*** SHOW DOWN ***
FinesseU22: shows [Qd 2s] (a pair of Queens)
hainesiv2: shows [9s Kh] (a pair of Kings)
hainesiv2 collected 7056 from pot
*** SUMMARY ***
Total pot 7056 | Rake 0=20
Board [6s Qs Kd 4c As]
Seat 1: FinesseU22 showed [Qd 2s] and lost with a pair of Queens
Seat 2: hainesiv2 showed [9s Kh] and won (7056) with a pair of Kings
Seat 3: robertg68 (button) folded before Flop (didn't bet)
Seat 4: hof49 (small blind) folded on the Turn
Seat 5: toodope4you (big blind) folded on the Turn
Seat 6: elimin8tor1 folded before Flop (didn't bet)
Seat 7: JerseyGuy316 folded on the Turn
Seat 8: JJin91 folded on the Turn
Seat 9: xJaehaerysx folded before Flop (didn't bet)


*********** # 27 **************
PokerStars Hand #170371775600: Tournament #1622573280, $9.10+$0.90 USD =
Hold'em No Limit - Level VIII (125/250) - 2017/05/25 19:20:24 ET
Table '1622573280 1' 9-max Seat #4 is the button
Seat 1: FinesseU22 (2417 in chips)=20
Seat 2: hainesiv2 (26927 in chips)=20
Seat 3: robertg68 (19918 in chips)=20
Seat 4: hof49 (13588 in chips)=20
Seat 5: toodope4you (5312 in chips)=20
Seat 6: elimin8tor1 (11246 in chips)=20
Seat 7: JerseyGuy316 (6650 in chips)=20
Seat 8: JJin91 (20277 in chips)=20
Seat 9: xJaehaerysx (9920 in chips)=20
FinesseU22: posts the ante 30
hainesiv2: posts the ante 30
robertg68: posts the ante 30
hof49: posts the ante 30
toodope4you: posts the ante 30
elimin8tor1: posts the ante 30
JerseyGuy316: posts the ante 30
JJin91: posts the ante 30
xJaehaerysx: posts the ante 30
toodope4you: posts small blind 125
elimin8tor1: posts big blind 250
*** HOLE CARDS ***
Dealt to JJin91 [4h Ks]
JerseyGuy316: folds=20
JJin91: folds=20
xJaehaerysx: calls 250
FinesseU22: calls 250
hainesiv2: folds=20
robertg68: calls 250
hof49: folds=20
toodope4you: folds=20
elimin8tor1: checks=20
*** FLOP *** [Qd Qh Qc]
elimin8tor1: checks=20
xJaehaerysx: checks=20
FinesseU22: checks=20
robertg68: checks=20
*** TURN *** [Qd Qh Qc] [6d]
elimin8tor1: checks=20
xJaehaerysx: checks=20
FinesseU22: bets 2137 and is all-in
robertg68: folds=20
elimin8tor1: folds=20
xJaehaerysx: folds=20
Uncalled bet (2137) returned to FinesseU22
FinesseU22 collected 1395 from pot
*** SUMMARY ***
Total pot 1395 | Rake 0=20
Board [Qd Qh Qc 6d]
Seat 1: FinesseU22 collected (1395)
Seat 2: hainesiv2 folded before Flop (didn't bet)
Seat 3: robertg68 folded on the Turn
Seat 4: hof49 (button) folded before Flop (didn't bet)
Seat 5: toodope4you (small blind) folded before Flop
Seat 6: elimin8tor1 (big blind) folded on the Turn
Seat 7: JerseyGuy316 folded before Flop (didn't bet)
Seat 8: JJin91 folded before Flop (didn't bet)
Seat 9: xJaehaerysx folded on the Turn


*********** # 28 **************
PokerStars Hand #170371775928: Tournament #1622573280, $9.10+$0.90 USD =
Hold'em No Limit - Level VIII (125/250) - 2017/05/25 19:21:55 ET
Table '1622573280 1' 9-max Seat #5 is the button
Seat 1: FinesseU22 (3532 in chips)=20
Seat 2: hainesiv2 (26897 in chips)=20
Seat 3: robertg68 (19638 in chips)=20
Seat 4: hof49 (13558 in chips)=20
Seat 5: toodope4you (5157 in chips)=20
Seat 6: elimin8tor1 (10966 in chips)=20
Seat 7: JerseyGuy316 (6620 in chips)=20
Seat 8: JJin91 (20247 in chips)=20
Seat 9: xJaehaerysx (9640 in chips)=20
FinesseU22: posts the ante 30
hainesiv2: posts the ante 30
robertg68: posts the ante 30
hof49: posts the ante 30
toodope4you: posts the ante 30
elimin8tor1: posts the ante 30
JerseyGuy316: posts the ante 30
JJin91: posts the ante 30
xJaehaerysx: posts the ante 30
elimin8tor1: posts small blind 125
JerseyGuy316: posts big blind 250
*** HOLE CARDS ***
Dealt to JJin91 [6c 3s]
JJin91: folds=20
xJaehaerysx: folds=20
FinesseU22: folds=20
hainesiv2: folds=20
robertg68: folds=20
hof49: folds=20
toodope4you: folds=20
elimin8tor1: calls 125
JerseyGuy316: checks=20
*** FLOP *** [Qd Tc Qh]
elimin8tor1: bets 250
JerseyGuy316: folds=20
Uncalled bet (250) returned to elimin8tor1
elimin8tor1 collected 770 from pot
elimin8tor1: doesn't show hand=20
*** SUMMARY ***
Total pot 770 | Rake 0=20
Board [Qd Tc Qh]
Seat 1: FinesseU22 folded before Flop (didn't bet)
Seat 2: hainesiv2 folded before Flop (didn't bet)
Seat 3: robertg68 folded before Flop (didn't bet)
Seat 4: hof49 folded before Flop (didn't bet)
Seat 5: toodope4you (button) folded before Flop (didn't bet)
Seat 6: elimin8tor1 (small blind) collected (770)
Seat 7: JerseyGuy316 (big blind) folded on the Flop
Seat 8: JJin91 folded before Flop (didn't bet)
Seat 9: xJaehaerysx folded before Flop (didn't bet)


*********** # 29 **************
PokerStars Hand #170371776057: Tournament #1622573280, $9.10+$0.90 USD =
Hold'em No Limit - Level VIII (125/250) - 2017/05/25 19:22:34 ET
Table '1622573280 1' 9-max Seat #6 is the button
Seat 1: FinesseU22 (3502 in chips)=20
Seat 2: hainesiv2 (26867 in chips)=20
Seat 3: robertg68 (19608 in chips)=20
Seat 4: hof49 (13528 in chips)=20
Seat 5: toodope4you (5127 in chips)=20
Seat 6: elimin8tor1 (11456 in chips)=20
Seat 7: JerseyGuy316 (6340 in chips)=20
Seat 8: JJin91 (20217 in chips)=20
Seat 9: xJaehaerysx (9610 in chips)=20
FinesseU22: posts the ante 30
hainesiv2: posts the ante 30
robertg68: posts the ante 30
hof49: posts the ante 30
toodope4you: posts the ante 30
elimin8tor1: posts the ante 30
JerseyGuy316: posts the ante 30
JJin91: posts the ante 30
xJaehaerysx: posts the ante 30
JerseyGuy316: posts small blind 125
JJin91: posts big blind 250
*** HOLE CARDS ***
Dealt to JJin91 [Td 6h]
xJaehaerysx: folds=20
FinesseU22: calls 250
hainesiv2: folds=20
robertg68: calls 250
hof49: folds=20
toodope4you: folds=20
elimin8tor1: folds=20
JerseyGuy316: raises 500 to 750
JJin91: folds=20
FinesseU22: calls 500
robertg68: calls 500
*** FLOP *** [Jc 9c 6c]
JerseyGuy316: checks=20
FinesseU22: bets 2722 and is all-in
robertg68: folds=20
JerseyGuy316: folds=20
Uncalled bet (2722) returned to FinesseU22
FinesseU22 collected 2770 from pot
*** SUMMARY ***
Total pot 2770 | Rake 0=20
Board [Jc 9c 6c]
Seat 1: FinesseU22 collected (2770)
Seat 2: hainesiv2 folded before Flop (didn't bet)
Seat 3: robertg68 folded on the Flop
Seat 4: hof49 folded before Flop (didn't bet)
Seat 5: toodope4you folded before Flop (didn't bet)
Seat 6: elimin8tor1 (button) folded before Flop (didn't bet)
Seat 7: JerseyGuy316 (small blind) folded on the Flop
Seat 8: JJin91 (big blind) folded before Flop
Seat 9: xJaehaerysx folded before Flop (didn't bet)


*********** # 30 **************
PokerStars Hand #170371776322: Tournament #1622573280, $9.10+$0.90 USD =
Hold'em No Limit - Level VIII (125/250) - 2017/05/25 19:23:53 ET
Table '1622573280 1' 9-max Seat #7 is the button
Seat 1: FinesseU22 (5492 in chips)=20
Seat 2: hainesiv2 (26837 in chips)=20
Seat 3: robertg68 (18828 in chips)=20
Seat 4: hof49 (13498 in chips)=20
Seat 5: toodope4you (5097 in chips)=20
Seat 6: elimin8tor1 (11426 in chips)=20
Seat 7: JerseyGuy316 (5560 in chips)=20
Seat 8: JJin91 (19937 in chips)=20
Seat 9: xJaehaerysx (9580 in chips)=20
FinesseU22: posts the ante 30
hainesiv2: posts the ante 30
robertg68: posts the ante 30
hof49: posts the ante 30
toodope4you: posts the ante 30
elimin8tor1: posts the ante 30
JerseyGuy316: posts the ante 30
JJin91: posts the ante 30
xJaehaerysx: posts the ante 30
JJin91: posts small blind 125
xJaehaerysx: posts big blind 250
*** HOLE CARDS ***
Dealt to JJin91 [Ts 6s]
FinesseU22: folds=20
hainesiv2: folds=20
robertg68: folds=20
hof49: calls 250
toodope4you: folds=20
elimin8tor1: calls 250
JerseyGuy316: folds=20
JJin91: calls 125
xJaehaerysx: checks=20
*** FLOP *** [Jh 8s 2s]
JJin91: checks=20
xJaehaerysx: bets 953
hof49: folds=20
elimin8tor1: folds=20
JJin91: calls 953
*** TURN *** [Jh 8s 2s] [Ks]
JJin91: checks=20
xJaehaerysx: checks=20
*** RIVER *** [Jh 8s 2s Ks] [8h]
JJin91: bets 2291
xJaehaerysx: folds=20
Uncalled bet (2291) returned to JJin91
JJin91 collected 3176 from pot
JJin91: doesn't show hand=20
*** SUMMARY ***
Total pot 3176 | Rake 0=20
Board [Jh 8s 2s Ks 8h]
Seat 1: FinesseU22 folded before Flop (didn't bet)
Seat 2: hainesiv2 folded before Flop (didn't bet)
Seat 3: robertg68 folded before Flop (didn't bet)
Seat 4: hof49 folded on the Flop
Seat 5: toodope4you folded before Flop (didn't bet)
Seat 6: elimin8tor1 folded on the Flop
Seat 7: JerseyGuy316 (button) folded before Flop (didn't bet)
Seat 8: JJin91 (small blind) collected (3176)
Seat 9: xJaehaerysx (big blind) folded on the River


*********** # 31 **************
PokerStars Hand #170371776688: Tournament #1622573280, $9.10+$0.90 USD =
Hold'em No Limit - Level VIII (125/250) - 2017/05/25 19:25:40 ET
Table '1622573280 1' 9-max Seat #8 is the button
Seat 2: hainesiv2 (26807 in chips)=20
Seat 3: robertg68 (18798 in chips)=20
Seat 4: hof49 (13218 in chips)=20
Seat 5: toodope4you (5067 in chips)=20
Seat 6: elimin8tor1 (11146 in chips)=20
Seat 7: JerseyGuy316 (5530 in chips)=20
Seat 8: JJin91 (21880 in chips)=20
Seat 9: xJaehaerysx (8347 in chips)=20
hainesiv2: posts the ante 30
robertg68: posts the ante 30
hof49: posts the ante 30
toodope4you: posts the ante 30
elimin8tor1: posts the ante 30
JerseyGuy316: posts the ante 30
JJin91: posts the ante 30
xJaehaerysx: posts the ante 30
xJaehaerysx: posts small blind 125
hainesiv2: posts big blind 250
*** HOLE CARDS ***
Dealt to JJin91 [4d 6h]
hof49 said, "No waitress for the last half hour. I need a coffee!"
robertg68: folds=20
hof49: raises 250 to 500
toodope4you: folds=20
elimin8tor1: calls 500
JerseyGuy316: folds=20
JJin91: folds=20
xJaehaerysx: folds=20
hainesiv2: calls 250
*** FLOP *** [3d 7s 7d]
hainesiv2: checks=20
hof49: checks=20
elimin8tor1: checks=20
*** TURN *** [3d 7s 7d] [Jh]
hainesiv2: checks=20
hof49: bets 500
elimin8tor1: calls 500
hainesiv2: folds=20
*** RIVER *** [3d 7s 7d Jh] [As]
hof49: bets 3500
elimin8tor1: folds=20
Uncalled bet (3500) returned to hof49
hof49 collected 2865 from pot
hof49: doesn't show hand=20
*** SUMMARY ***
Total pot 2865 | Rake 0=20
Board [3d 7s 7d Jh As]
Seat 2: hainesiv2 (big blind) folded on the Turn
Seat 3: robertg68 folded before Flop (didn't bet)
Seat 4: hof49 collected (2865)
Seat 5: toodope4you folded before Flop (didn't bet)
Seat 6: elimin8tor1 folded on the River
Seat 7: JerseyGuy316 folded before Flop (didn't bet)
Seat 8: JJin91 (button) folded before Flop (didn't bet)
Seat 9: xJaehaerysx (small blind) folded before Flop


*********** # 32 **************
PokerStars Hand #170371776933: Tournament #1622573280, $9.10+$0.90 USD =
Hold'em No Limit - Level VIII (125/250) - 2017/05/25 19:27:00 ET
Table '1622573280 1' 9-max Seat #9 is the button
Seat 1: mrbobsnj (10000 in chips) out of hand (moved from another table=
 into small blind)
Seat 2: hainesiv2 (26277 in chips)=20
Seat 3: robertg68 (18768 in chips)=20
Seat 4: hof49 (15053 in chips)=20
Seat 5: toodope4you (5037 in chips)=20
Seat 6: elimin8tor1 (10116 in chips)=20
Seat 7: JerseyGuy316 (5500 in chips)=20
Seat 8: JJin91 (21850 in chips)=20
Seat 9: xJaehaerysx (8192 in chips)=20
hainesiv2: posts the ante 30
robertg68: posts the ante 30
hof49: posts the ante 30
toodope4you: posts the ante 30
elimin8tor1: posts the ante 30
JerseyGuy316: posts the ante 30
JJin91: posts the ante 30
xJaehaerysx: posts the ante 30
hainesiv2: posts small blind 125
robertg68: posts big blind 250
*** HOLE CARDS ***
Dealt to JJin91 [Jh 8d]
hof49: folds=20
toodope4you: folds=20
elimin8tor1: raises 250 to 500
JerseyGuy316: folds=20
JJin91: folds=20
xJaehaerysx: calls 500
hainesiv2: folds=20
robertg68: calls 250
*** FLOP *** [Jd 9d 5s]
robertg68: checks=20
elimin8tor1: checks=20
xJaehaerysx: checks=20
*** TURN *** [Jd 9d 5s] [7c]
robertg68: bets 250
elimin8tor1: calls 250
xJaehaerysx: folds=20
*** RIVER *** [Jd 9d 5s 7c] [Qc]
robertg68: bets 250
elimin8tor1: folds=20
Uncalled bet (250) returned to robertg68
robertg68 collected 2365 from pot
*** SUMMARY ***
Total pot 2365 | Rake 0=20
Board [Jd 9d 5s 7c Qc]
Seat 2: hainesiv2 (small blind) folded before Flop
Seat 3: robertg68 (big blind) collected (2365)
Seat 4: hof49 folded before Flop (didn't bet)
Seat 5: toodope4you folded before Flop (didn't bet)
Seat 6: elimin8tor1 folded on the River
Seat 7: JerseyGuy316 folded before Flop (didn't bet)
Seat 8: JJin91 folded before Flop (didn't bet)
Seat 9: xJaehaerysx (button) folded on the Turn


*********** # 33 **************
PokerStars Hand #170371777221: Tournament #1622573280, $9.10+$0.90 USD =
Hold'em No Limit - Level IX (150/300) - 2017/05/25 19:28:29 ET
Table '1622573280 1' 9-max Seat #2 is the button
Seat 1: mrbobsnj (10000 in chips)=20
Seat 2: hainesiv2 (26122 in chips)=20
Seat 3: robertg68 (20353 in chips)=20
Seat 4: hof49 (15023 in chips)=20
Seat 5: toodope4you (5007 in chips)=20
Seat 6: elimin8tor1 (9336 in chips)=20
Seat 7: JerseyGuy316 (5470 in chips)=20
Seat 8: JJin91 (21820 in chips)=20
Seat 9: xJaehaerysx (7662 in chips)=20
mrbobsnj: posts the ante 40
hainesiv2: posts the ante 40
robertg68: posts the ante 40
hof49: posts the ante 40
toodope4you: posts the ante 40
elimin8tor1: posts the ante 40
JerseyGuy316: posts the ante 40
JJin91: posts the ante 40
xJaehaerysx: posts the ante 40
robertg68: posts small blind 150
hof49: posts big blind 300
*** HOLE CARDS ***
Dealt to JJin91 [Qs Qh]
toodope4you: folds=20
elimin8tor1: folds=20
JerseyGuy316: raises 600 to 900
JJin91: raises 1587 to 2487
xJaehaerysx: folds=20
mrbobsnj: folds=20
hainesiv2: folds=20
robertg68: folds=20
hof49: folds=20
JerseyGuy316: calls 1587
*** FLOP *** [Th Td 3d]
JerseyGuy316: checks=20
JJin91: bets 19293 and is all-in
JerseyGuy316: calls 2943 and is all-in
Uncalled bet (16350) returned to JJin91
*** TURN *** [Th Td 3d] [As]
JerseyGuy316 said, "nh"
*** RIVER *** [Th Td 3d As] [5d]
*** SHOW DOWN ***
JerseyGuy316: shows [4c 4s] (two pair, Tens and Fours)
JJin91: shows [Qs Qh] (two pair, Queens and Tens)
JJin91 collected 11670 from pot
JerseyGuy316 finished the tournament in 131st place
*** SUMMARY ***
Total pot 11670 | Rake 0=20
Board [Th Td 3d As 5d]
Seat 1: mrbobsnj folded before Flop (didn't bet)
Seat 2: hainesiv2 (button) folded before Flop (didn't bet)
Seat 3: robertg68 (small blind) folded before Flop
Seat 4: hof49 (big blind) folded before Flop
Seat 5: toodope4you folded before Flop (didn't bet)
Seat 6: elimin8tor1 folded before Flop (didn't bet)
Seat 7: JerseyGuy316 showed [4c 4s] and lost with two pair, Tens and Fo=
urs
Seat 8: JJin91 showed [Qs Qh] and won (11670) with two pair, Queens and=
 Tens
Seat 9: xJaehaerysx folded before Flop (didn't bet)


*********** # 34 **************
PokerStars Hand #170371777415: Tournament #1622573280, $9.10+$0.90 USD =
Hold'em No Limit - Level IX (150/300) - 2017/05/25 19:29:19 ET
Table '1622573280 1' 9-max Seat #3 is the button
Seat 1: mrbobsnj (9960 in chips)=20
Seat 2: hainesiv2 (26082 in chips)=20
Seat 3: robertg68 (20163 in chips)=20
Seat 4: hof49 (14683 in chips)=20
Seat 5: toodope4you (4967 in chips)=20
Seat 6: elimin8tor1 (9296 in chips)=20
Seat 8: JJin91 (28020 in chips)=20
Seat 9: xJaehaerysx (7622 in chips)=20
mrbobsnj: posts the ante 40
hainesiv2: posts the ante 40
robertg68: posts the ante 40
hof49: posts the ante 40
toodope4you: posts the ante 40
elimin8tor1: posts the ante 40
JJin91: posts the ante 40
xJaehaerysx: posts the ante 40
hof49: posts small blind 150
toodope4you: posts big blind 300
*** HOLE CARDS ***
Dealt to JJin91 [Ac 6s]
elimin8tor1: folds=20
JJin91: folds=20
xJaehaerysx: folds=20
mrbobsnj: calls 300
hainesiv2: folds=20
robertg68: calls 300
hof49: folds=20
toodope4you: raises 900 to 1200
mrbobsnj: folds=20
robertg68: folds=20
Uncalled bet (900) returned to toodope4you
toodope4you collected 1370 from pot
toodope4you: doesn't show hand=20
*** SUMMARY ***
Total pot 1370 | Rake 0=20
Seat 1: mrbobsnj folded before Flop
Seat 2: hainesiv2 folded before Flop (didn't bet)
Seat 3: robertg68 (button) folded before Flop
Seat 4: hof49 (small blind) folded before Flop
Seat 5: toodope4you (big blind) collected (1370)
Seat 6: elimin8tor1 folded before Flop (didn't bet)
Seat 8: JJin91 folded before Flop (didn't bet)
Seat 9: xJaehaerysx folded before Flop (didn't bet)


*********** # 35 **************
PokerStars Hand #170371777590: Tournament #1622573280, $9.10+$0.90 USD =
Hold'em No Limit - Level IX (150/300) - 2017/05/25 19:30:06 ET
Table '1622573280 1' 9-max Seat #4 is the button
Seat 1: mrbobsnj (9620 in chips)=20
Seat 2: hainesiv2 (26042 in chips)=20
Seat 3: robertg68 (19823 in chips)=20
Seat 4: hof49 (14493 in chips)=20
Seat 5: toodope4you (5997 in chips)=20
Seat 6: elimin8tor1 (9256 in chips)=20
Seat 8: JJin91 (27980 in chips)=20
Seat 9: xJaehaerysx (7582 in chips)=20
mrbobsnj: posts the ante 40
hainesiv2: posts the ante 40
robertg68: posts the ante 40
hof49: posts the ante 40
toodope4you: posts the ante 40
elimin8tor1: posts the ante 40
JJin91: posts the ante 40
xJaehaerysx: posts the ante 40
toodope4you: posts small blind 150
elimin8tor1: posts big blind 300
*** HOLE CARDS ***
Dealt to JJin91 [4d 8s]
JJin91: folds=20
xJaehaerysx: folds=20
mrbobsnj: folds=20
hainesiv2: folds=20
robertg68: folds=20
hof49: folds=20
toodope4you: folds=20
Uncalled bet (150) returned to elimin8tor1
elimin8tor1 collected 620 from pot
elimin8tor1: doesn't show hand=20
*** SUMMARY ***
Total pot 620 | Rake 0=20
Seat 1: mrbobsnj folded before Flop (didn't bet)
Seat 2: hainesiv2 folded before Flop (didn't bet)
Seat 3: robertg68 folded before Flop (didn't bet)
Seat 4: hof49 (button) folded before Flop (didn't bet)
Seat 5: toodope4you (small blind) folded before Flop
Seat 6: elimin8tor1 (big blind) collected (620)
Seat 8: JJin91 folded before Flop (didn't bet)
Seat 9: xJaehaerysx folded before Flop (didn't bet)


*********** # 36 **************
PokerStars Hand #170371777767: Tournament #1622573280, $9.10+$0.90 USD =
Hold'em No Limit - Level IX (150/300) - 2017/05/25 19:30:58 ET
Table '1622573280 1' 9-max Seat #5 is the button
Seat 1: mrbobsnj (9580 in chips)=20
Seat 2: hainesiv2 (26002 in chips)=20
Seat 3: robertg68 (19783 in chips)=20
Seat 4: hof49 (14453 in chips)=20
Seat 5: toodope4you (5807 in chips)=20
Seat 6: elimin8tor1 (9686 in chips)=20
Seat 7: zootsuit101 (10000 in chips)=20
Seat 8: JJin91 (27940 in chips)=20
Seat 9: xJaehaerysx (7542 in chips)=20
mrbobsnj: posts the ante 40
hainesiv2: posts the ante 40
robertg68: posts the ante 40
hof49: posts the ante 40
toodope4you: posts the ante 40
elimin8tor1: posts the ante 40
zootsuit101: posts the ante 40
JJin91: posts the ante 40
xJaehaerysx: posts the ante 40
elimin8tor1: posts small blind 150
zootsuit101: posts big blind 300
*** HOLE CARDS ***
Dealt to JJin91 [6h 9c]
JJin91: folds=20
xJaehaerysx: raises 300 to 600
mrbobsnj: calls 600
hainesiv2: folds=20
robertg68: folds=20
hof49: folds=20
toodope4you: calls 600
elimin8tor1: folds=20
zootsuit101: folds=20
*** FLOP *** [3c 8h Ks]
xJaehaerysx: checks=20
mrbobsnj: bets 1200
toodope4you: folds=20
xJaehaerysx: folds=20
Uncalled bet (1200) returned to mrbobsnj
mrbobsnj collected 2610 from pot
mrbobsnj: doesn't show hand=20
*** SUMMARY ***
Total pot 2610 | Rake 0=20
Board [3c 8h Ks]
Seat 1: mrbobsnj collected (2610)
Seat 2: hainesiv2 folded before Flop (didn't bet)
Seat 3: robertg68 folded before Flop (didn't bet)
Seat 4: hof49 folded before Flop (didn't bet)
Seat 5: toodope4you (button) folded on the Flop
Seat 6: elimin8tor1 (small blind) folded before Flop
Seat 7: zootsuit101 (big blind) folded before Flop
Seat 8: JJin91 folded before Flop (didn't bet)
Seat 9: xJaehaerysx folded on the Flop


*********** # 37 **************
PokerStars Hand #170371778015: Tournament #1622573280, $9.10+$0.90 USD =
Hold'em No Limit - Level IX (150/300) - 2017/05/25 19:32:06 ET
Table '1622573280 1' 9-max Seat #6 is the button
Seat 1: mrbobsnj (11550 in chips)=20
Seat 2: hainesiv2 (25962 in chips)=20
Seat 3: robertg68 (19743 in chips)=20
Seat 4: hof49 (14413 in chips)=20
Seat 5: toodope4you (5167 in chips)=20
Seat 6: elimin8tor1 (9496 in chips)=20
Seat 7: zootsuit101 (9660 in chips)=20
Seat 8: JJin91 (27900 in chips)=20
Seat 9: xJaehaerysx (6902 in chips)=20
mrbobsnj: posts the ante 40
hainesiv2: posts the ante 40
robertg68: posts the ante 40
hof49: posts the ante 40
toodope4you: posts the ante 40
elimin8tor1: posts the ante 40
zootsuit101: posts the ante 40
JJin91: posts the ante 40
xJaehaerysx: posts the ante 40
zootsuit101: posts small blind 150
JJin91: posts big blind 300
*** HOLE CARDS ***
Dealt to JJin91 [6d Kd]
xJaehaerysx: folds=20
mrbobsnj: folds=20
hainesiv2: folds=20
robertg68: folds=20
hof49: folds=20
toodope4you: raises 425 to 725
elimin8tor1: folds=20
zootsuit101: folds=20
JJin91: calls 425
*** FLOP *** [4c Tc Ts]
JJin91: checks=20
toodope4you: bets 1200
JJin91: folds=20
Uncalled bet (1200) returned to toodope4you
toodope4you collected 1960 from pot
toodope4you: doesn't show hand=20
*** SUMMARY ***
Total pot 1960 | Rake 0=20
Board [4c Tc Ts]
Seat 1: mrbobsnj folded before Flop (didn't bet)
Seat 2: hainesiv2 folded before Flop (didn't bet)
Seat 3: robertg68 folded before Flop (didn't bet)
Seat 4: hof49 folded before Flop (didn't bet)
Seat 5: toodope4you collected (1960)
Seat 6: elimin8tor1 (button) folded before Flop (didn't bet)
Seat 7: zootsuit101 (small blind) folded before Flop
Seat 8: JJin91 (big blind) folded on the Flop
Seat 9: xJaehaerysx folded before Flop (didn't bet)


*********** # 38 **************
PokerStars Hand #170371778239: Tournament #1622573280, $9.10+$0.90 USD =
Hold'em No Limit - Level IX (150/300) - 2017/05/25 19:33:05 ET
Table '1622573280 1' 9-max Seat #7 is the button
Seat 1: mrbobsnj (11510 in chips)=20
Seat 2: hainesiv2 (25922 in chips)=20
Seat 3: robertg68 (19703 in chips)=20
Seat 4: hof49 (14373 in chips)=20
Seat 5: toodope4you (6362 in chips)=20
Seat 6: elimin8tor1 (9456 in chips)=20
Seat 7: zootsuit101 (9470 in chips)=20
Seat 8: JJin91 (27135 in chips)=20
Seat 9: xJaehaerysx (6862 in chips)=20
mrbobsnj: posts the ante 40
hainesiv2: posts the ante 40
robertg68: posts the ante 40
hof49: posts the ante 40
toodope4you: posts the ante 40
elimin8tor1: posts the ante 40
zootsuit101: posts the ante 40
JJin91: posts the ante 40
xJaehaerysx: posts the ante 40
JJin91: posts small blind 150
xJaehaerysx: posts big blind 300
*** HOLE CARDS ***
Dealt to JJin91 [2s 2c]
mrbobsnj: folds=20
hainesiv2: folds=20
robertg68: calls 300
hof49: folds=20
toodope4you: folds=20
elimin8tor1: folds=20
zootsuit101: folds=20
JJin91: calls 150
xJaehaerysx: checks=20
*** FLOP *** [8d 9h 7s]
JJin91: checks=20
xJaehaerysx: checks=20
robertg68: checks=20
*** TURN *** [8d 9h 7s] [Qs]
JJin91: checks=20
xJaehaerysx: bets 630
robertg68: folds=20
JJin91: folds=20
Uncalled bet (630) returned to xJaehaerysx
xJaehaerysx collected 1260 from pot
xJaehaerysx: doesn't show hand=20
*** SUMMARY ***
Total pot 1260 | Rake 0=20
Board [8d 9h 7s Qs]
Seat 1: mrbobsnj folded before Flop (didn't bet)
Seat 2: hainesiv2 folded before Flop (didn't bet)
Seat 3: robertg68 folded on the Turn
Seat 4: hof49 folded before Flop (didn't bet)
Seat 5: toodope4you folded before Flop (didn't bet)
Seat 6: elimin8tor1 folded before Flop (didn't bet)
Seat 7: zootsuit101 (button) folded before Flop (didn't bet)
Seat 8: JJin91 (small blind) folded on the Turn
Seat 9: xJaehaerysx (big blind) collected (1260)


*********** # 39 **************
PokerStars Hand #170371778546: Tournament #1622573280, $9.10+$0.90 USD =
Hold'em No Limit - Level IX (150/300) - 2017/05/25 19:34:33 ET
Table '1622573280 1' 9-max Seat #8 is the button
Seat 1: mrbobsnj (11470 in chips)=20
Seat 2: hainesiv2 (25882 in chips)=20
Seat 3: robertg68 (19363 in chips)=20
Seat 4: hof49 (14333 in chips)=20
Seat 5: toodope4you (6322 in chips)=20
Seat 6: elimin8tor1 (9416 in chips)=20
Seat 7: zootsuit101 (9430 in chips)=20
Seat 8: JJin91 (26795 in chips)=20
Seat 9: xJaehaerysx (7782 in chips)=20
mrbobsnj: posts the ante 40
hainesiv2: posts the ante 40
robertg68: posts the ante 40
hof49: posts the ante 40
toodope4you: posts the ante 40
elimin8tor1: posts the ante 40
zootsuit101: posts the ante 40
JJin91: posts the ante 40
xJaehaerysx: posts the ante 40
xJaehaerysx: posts small blind 150
mrbobsnj: posts big blind 300
*** HOLE CARDS ***
Dealt to JJin91 [Qc 5s]
hainesiv2: folds=20
robertg68: folds=20
hof49: folds=20
toodope4you: folds=20
elimin8tor1: raises 300 to 600
zootsuit101: folds=20
JJin91: folds=20
xJaehaerysx: folds=20
mrbobsnj: calls 300
*** FLOP *** [Td 4c 8d]
mrbobsnj: checks=20
elimin8tor1: bets 1550
mrbobsnj: folds=20
Uncalled bet (1550) returned to elimin8tor1
elimin8tor1 collected 1710 from pot
*** SUMMARY ***
Total pot 1710 | Rake 0=20
Board [Td 4c 8d]
Seat 1: mrbobsnj (big blind) folded on the Flop
Seat 2: hainesiv2 folded before Flop (didn't bet)
Seat 3: robertg68 folded before Flop (didn't bet)
Seat 4: hof49 folded before Flop (didn't bet)
Seat 5: toodope4you folded before Flop (didn't bet)
Seat 6: elimin8tor1 collected (1710)
Seat 7: zootsuit101 folded before Flop (didn't bet)
Seat 8: JJin91 (button) folded before Flop (didn't bet)
Seat 9: xJaehaerysx (small blind) folded before Flop


*********** # 40 **************
PokerStars Hand #170371778763: Tournament #1622573280, $9.10+$0.90 USD =
Hold'em No Limit - Level IX (150/300) - 2017/05/25 19:35:32 ET
Table '1622573280 1' 9-max Seat #9 is the button
Seat 1: mrbobsnj (10830 in chips)=20
Seat 2: hainesiv2 (25842 in chips)=20
Seat 3: robertg68 (19323 in chips)=20
Seat 4: hof49 (14293 in chips)=20
Seat 5: toodope4you (6282 in chips)=20
Seat 7: zootsuit101 (9390 in chips)=20
Seat 8: JJin91 (26755 in chips)=20
Seat 9: xJaehaerysx (7592 in chips)=20
mrbobsnj: posts the ante 40
hainesiv2: posts the ante 40
robertg68: posts the ante 40
hof49: posts the ante 40
toodope4you: posts the ante 40
zootsuit101: posts the ante 40
JJin91: posts the ante 40
xJaehaerysx: posts the ante 40
mrbobsnj: posts small blind 150
hainesiv2: posts big blind 300
*** HOLE CARDS ***
Dealt to JJin91 [3c As]
robertg68: folds=20
hof49: raises 300 to 600
toodope4you: folds=20
zootsuit101: folds=20
JJin91: folds=20
xJaehaerysx: folds=20
mrbobsnj: folds=20
hainesiv2: calls 300
*** FLOP *** [Jd Ad 2s]
hainesiv2: bets 1002
hof49: calls 1002
*** TURN *** [Jd Ad 2s] [Qs]
hainesiv2: checks=20
hof49: checks=20
*** RIVER *** [Jd Ad 2s Qs] [Js]
hainesiv2: checks=20
hof49: checks=20
*** SHOW DOWN ***
hainesiv2: shows [7s Kc] (a pair of Jacks)
hof49: shows [8c Ac] (two pair, Aces and Jacks)
hof49 collected 3674 from pot
*** SUMMARY ***
Total pot 3674 | Rake 0=20
Board [Jd Ad 2s Qs Js]
Seat 1: mrbobsnj (small blind) folded before Flop
Seat 2: hainesiv2 (big blind) showed [7s Kc] and lost with a pair of Ja=
cks
Seat 3: robertg68 folded before Flop (didn't bet)
Seat 4: hof49 showed [8c Ac] and won (3674) with two pair, Aces and Jac=
ks
Seat 5: toodope4you folded before Flop (didn't bet)
Seat 7: zootsuit101 folded before Flop (didn't bet)
Seat 8: JJin91 folded before Flop (didn't bet)
Seat 9: xJaehaerysx (button) folded before Flop (didn't bet)


*********** # 41 **************
PokerStars Hand #170371778962: Tournament #1622573280, $9.10+$0.90 USD =
Hold'em No Limit - Level IX (150/300) - 2017/05/25 19:36:27 ET
Table '1622573280 1' 9-max Seat #1 is the button
Seat 1: mrbobsnj (10640 in chips)=20
Seat 2: hainesiv2 (24200 in chips)=20
Seat 3: robertg68 (19283 in chips)=20
Seat 4: hof49 (16325 in chips)=20
Seat 5: toodope4you (6242 in chips)=20
Seat 7: zootsuit101 (9350 in chips)=20
Seat 8: JJin91 (26715 in chips)=20
Seat 9: xJaehaerysx (7552 in chips)=20
mrbobsnj: posts the ante 40
hainesiv2: posts the ante 40
robertg68: posts the ante 40
hof49: posts the ante 40
toodope4you: posts the ante 40
zootsuit101: posts the ante 40
JJin91: posts the ante 40
xJaehaerysx: posts the ante 40
hainesiv2: posts small blind 150
robertg68: posts big blind 300
*** HOLE CARDS ***
Dealt to JJin91 [7c 7h]
hof49: raises 300 to 600
toodope4you: folds=20
zootsuit101: folds=20
JJin91: calls 600
xJaehaerysx: calls 600
mrbobsnj: folds=20
hainesiv2: calls 450
robertg68: calls 300
*** FLOP *** [5c Kd 4s]
hainesiv2: bets 1992
robertg68: folds=20
hof49: folds=20
JJin91: calls 1992
xJaehaerysx: folds=20
*** TURN *** [5c Kd 4s] [9c]
hainesiv2: checks=20
JJin91: bets 2702
hainesiv2: calls 2702
*** RIVER *** [5c Kd 4s 9c] [Jc]
hainesiv2: checks=20
JJin91: checks=20
*** SHOW DOWN ***
hainesiv2: shows [Js Ks] (two pair, Kings and Jacks)
JJin91: mucks hand=20
hainesiv2 collected 12708 from pot
*** SUMMARY ***
Total pot 12708 | Rake 0=20
Board [5c Kd 4s 9c Jc]
Seat 1: mrbobsnj (button) folded before Flop (didn't bet)
Seat 2: hainesiv2 (small blind) showed [Js Ks] and won (12708) with two=
 pair, Kings and Jacks
Seat 3: robertg68 (big blind) folded on the Flop
Seat 4: hof49 folded on the Flop
Seat 5: toodope4you folded before Flop (didn't bet)
Seat 7: zootsuit101 folded before Flop (didn't bet)
Seat 8: JJin91 mucked [7c 7h]
Seat 9: xJaehaerysx folded on the Flop


*********** # 42 **************
PokerStars Hand #170371779357: Tournament #1622573280, $9.10+$0.90 USD =
Hold'em No Limit - Level X (200/400) - 2017/05/25 19:38:25 ET
Table '1622573280 1' 9-max Seat #2 is the button
Seat 1: mrbobsnj (10600 in chips)=20
Seat 2: hainesiv2 (31574 in chips)=20
Seat 3: robertg68 (18643 in chips)=20
Seat 4: hof49 (15685 in chips)=20
Seat 5: toodope4you (6202 in chips)=20
Seat 6: MJG0 (4865 in chips)=20
Seat 7: zootsuit101 (9310 in chips)=20
Seat 8: JJin91 (21381 in chips)=20
Seat 9: xJaehaerysx (6912 in chips)=20
mrbobsnj: posts the ante 50
hainesiv2: posts the ante 50
robertg68: posts the ante 50
hof49: posts the ante 50
toodope4you: posts the ante 50
MJG0: posts the ante 50
zootsuit101: posts the ante 50
JJin91: posts the ante 50
xJaehaerysx: posts the ante 50
robertg68: posts small blind 200
hof49: posts big blind 400
*** HOLE CARDS ***
Dealt to JJin91 [Jh 8d]
toodope4you: folds=20
MJG0: folds=20
zootsuit101: folds=20
JJin91: folds=20
xJaehaerysx: raises 400 to 800
mrbobsnj: calls 800
hainesiv2: calls 800
robertg68: folds=20
hof49: raises 1200 to 2000
xJaehaerysx: calls 1200
mrbobsnj: calls 1200
hainesiv2: calls 1200
*** FLOP *** [3c Kd Th]
hof49: bets 1200
xJaehaerysx: raises 3662 to 4862 and is all-in
mrbobsnj: folds=20
hainesiv2: folds=20
hof49: folds=20
Uncalled bet (3662) returned to xJaehaerysx
xJaehaerysx collected 11050 from pot
xJaehaerysx: doesn't show hand=20
*** SUMMARY ***
Total pot 11050 | Rake 0=20
Board [3c Kd Th]
Seat 1: mrbobsnj folded on the Flop
Seat 2: hainesiv2 (button) folded on the Flop
Seat 3: robertg68 (small blind) folded before Flop
Seat 4: hof49 (big blind) folded on the Flop
Seat 5: toodope4you folded before Flop (didn't bet)
Seat 6: MJG0 folded before Flop (didn't bet)
Seat 7: zootsuit101 folded before Flop (didn't bet)
Seat 8: JJin91 folded before Flop (didn't bet)
Seat 9: xJaehaerysx collected (11050)


*********** # 43 **************
PokerStars Hand #170371779595: Tournament #1622573280, $9.10+$0.90 USD =
Hold'em No Limit - Level X (200/400) - 2017/05/25 19:39:40 ET
Table '1622573280 1' 9-max Seat #3 is the button
Seat 1: mrbobsnj (8550 in chips)=20
Seat 2: hainesiv2 (29524 in chips)=20
Seat 3: robertg68 (18393 in chips)=20
Seat 4: hof49 (12435 in chips)=20
Seat 5: toodope4you (6152 in chips)=20
Seat 6: MJG0 (4815 in chips)=20
Seat 7: zootsuit101 (9260 in chips)=20
Seat 8: JJin91 (21331 in chips)=20
Seat 9: xJaehaerysx (14712 in chips)=20
mrbobsnj: posts the ante 50
hainesiv2: posts the ante 50
robertg68: posts the ante 50
hof49: posts the ante 50
toodope4you: posts the ante 50
MJG0: posts the ante 50
zootsuit101: posts the ante 50
JJin91: posts the ante 50
xJaehaerysx: posts the ante 50
hof49: posts small blind 200
toodope4you: posts big blind 400
*** HOLE CARDS ***
Dealt to JJin91 [5h 6s]
MJG0: folds=20
zootsuit101: folds=20
JJin91: folds=20
xJaehaerysx: folds=20
mrbobsnj: folds=20
hainesiv2: folds=20
robertg68: folds=20
hof49: folds=20
Uncalled bet (200) returned to toodope4you
toodope4you collected 850 from pot
toodope4you: doesn't show hand=20
*** SUMMARY ***
Total pot 850 | Rake 0=20
Seat 1: mrbobsnj folded before Flop (didn't bet)
Seat 2: hainesiv2 folded before Flop (didn't bet)
Seat 3: robertg68 (button) folded before Flop (didn't bet)
Seat 4: hof49 (small blind) folded before Flop
Seat 5: toodope4you (big blind) collected (850)
Seat 6: MJG0 folded before Flop (didn't bet)
Seat 7: zootsuit101 folded before Flop (didn't bet)
Seat 8: JJin91 folded before Flop (didn't bet)
Seat 9: xJaehaerysx folded before Flop (didn't bet)


*********** # 44 **************
PokerStars Hand #170371779675: Tournament #1622573280, $9.10+$0.90 USD =
Hold'em No Limit - Level X (200/400) - 2017/05/25 19:40:03 ET
Table '1622573280 1' 9-max Seat #4 is the button
Seat 1: mrbobsnj (8500 in chips)=20
Seat 2: hainesiv2 (29474 in chips)=20
Seat 3: robertg68 (18343 in chips)=20
Seat 4: hof49 (12185 in chips)=20
Seat 5: toodope4you (6752 in chips)=20
Seat 6: MJG0 (4765 in chips)=20
Seat 7: zootsuit101 (9210 in chips)=20
Seat 8: JJin91 (21281 in chips)=20
Seat 9: xJaehaerysx (14662 in chips)=20
mrbobsnj: posts the ante 50
hainesiv2: posts the ante 50
robertg68: posts the ante 50
hof49: posts the ante 50
toodope4you: posts the ante 50
MJG0: posts the ante 50
zootsuit101: posts the ante 50
JJin91: posts the ante 50
xJaehaerysx: posts the ante 50
toodope4you: posts small blind 200
MJG0: posts big blind 400
*** HOLE CARDS ***
Dealt to JJin91 [9c 5c]
zootsuit101: folds=20
JJin91: folds=20
xJaehaerysx: folds=20
mrbobsnj: folds=20
hainesiv2: folds=20
robertg68: calls 400
hof49: calls 400
toodope4you: folds=20
MJG0: raises 4315 to 4715 and is all-in
robertg68: folds=20
hof49: folds=20
Uncalled bet (4315) returned to MJG0
MJG0 collected 1850 from pot
MJG0: doesn't show hand=20
*** SUMMARY ***
Total pot 1850 | Rake 0=20
Seat 1: mrbobsnj folded before Flop (didn't bet)
Seat 2: hainesiv2 folded before Flop (didn't bet)
Seat 3: robertg68 folded before Flop
Seat 4: hof49 (button) folded before Flop
Seat 5: toodope4you (small blind) folded before Flop
Seat 6: MJG0 (big blind) collected (1850)
Seat 7: zootsuit101 folded before Flop (didn't bet)
Seat 8: JJin91 folded before Flop (didn't bet)
Seat 9: xJaehaerysx folded before Flop (didn't bet)


*********** # 45 **************
PokerStars Hand #170371779817: Tournament #1622573280, $9.10+$0.90 USD =
Hold'em No Limit - Level X (200/400) - 2017/05/25 19:40:48 ET
Table '1622573280 1' 9-max Seat #5 is the button
Seat 1: mrbobsnj (8450 in chips)=20
Seat 2: hainesiv2 (29424 in chips)=20
Seat 3: robertg68 (17893 in chips)=20
Seat 4: hof49 (11735 in chips)=20
Seat 5: toodope4you (6502 in chips)=20
Seat 6: MJG0 (6165 in chips)=20
Seat 8: JJin91 (21231 in chips)=20
Seat 9: xJaehaerysx (14612 in chips)=20
mrbobsnj: posts the ante 50
hainesiv2: posts the ante 50
robertg68: posts the ante 50
hof49: posts the ante 50
toodope4you: posts the ante 50
MJG0: posts the ante 50
JJin91: posts the ante 50
xJaehaerysx: posts the ante 50
MJG0: posts small blind 200
JJin91: posts big blind 400
*** HOLE CARDS ***
Dealt to JJin91 [2d 3s]
xJaehaerysx: folds=20
mrbobsnj: folds=20
hainesiv2: folds=20
robertg68: folds=20
hof49: raises 800 to 1200
toodope4you: folds=20
MJG0: folds=20
JJin91: folds=20
Uncalled bet (800) returned to hof49
hof49 collected 1400 from pot
hof49: doesn't show hand=20
*** SUMMARY ***
Total pot 1400 | Rake 0=20
Seat 1: mrbobsnj folded before Flop (didn't bet)
Seat 2: hainesiv2 folded before Flop (didn't bet)
Seat 3: robertg68 folded before Flop (didn't bet)
Seat 4: hof49 collected (1400)
Seat 5: toodope4you (button) folded before Flop (didn't bet)
Seat 6: MJG0 (small blind) folded before Flop
Seat 8: JJin91 (big blind) folded before Flop
Seat 9: xJaehaerysx folded before Flop (didn't bet)


*********** # 46 **************
PokerStars Hand #170371779936: Tournament #1622573280, $9.10+$0.90 USD =
Hold'em No Limit - Level X (200/400) - 2017/05/25 19:41:21 ET
Table '1622573280 1' 9-max Seat #6 is the button
Seat 1: mrbobsnj (8400 in chips)=20
Seat 2: hainesiv2 (29374 in chips)=20
Seat 3: robertg68 (17843 in chips)=20
Seat 4: hof49 (12685 in chips)=20
Seat 5: toodope4you (6452 in chips)=20
Seat 6: MJG0 (5915 in chips)=20
Seat 8: JJin91 (20781 in chips)=20
Seat 9: xJaehaerysx (14562 in chips)=20
mrbobsnj: posts the ante 50
hainesiv2: posts the ante 50
robertg68: posts the ante 50
hof49: posts the ante 50
toodope4you: posts the ante 50
MJG0: posts the ante 50
JJin91: posts the ante 50
xJaehaerysx: posts the ante 50
JJin91: posts small blind 200
xJaehaerysx: posts big blind 400
*** HOLE CARDS ***
Dealt to JJin91 [Jd 9s]
mrbobsnj: raises 400 to 800
hainesiv2: folds=20
robertg68: folds=20
hof49: folds=20
toodope4you: folds=20
MJG0: folds=20
JJin91: folds=20
xJaehaerysx: folds=20
Uncalled bet (400) returned to mrbobsnj
mrbobsnj collected 1400 from pot
mrbobsnj: doesn't show hand=20
*** SUMMARY ***
Total pot 1400 | Rake 0=20
Seat 1: mrbobsnj collected (1400)
Seat 2: hainesiv2 folded before Flop (didn't bet)
Seat 3: robertg68 folded before Flop (didn't bet)
Seat 4: hof49 folded before Flop (didn't bet)
Seat 5: toodope4you folded before Flop (didn't bet)
Seat 6: MJG0 (button) folded before Flop (didn't bet)
Seat 8: JJin91 (small blind) folded before Flop
Seat 9: xJaehaerysx (big blind) folded before Flop


*********** # 47 **************
PokerStars Hand #170373986344: Tournament #1622573280, $9.10+$0.90 USD =
Hold'em No Limit - Level X (200/400) - 2017/05/25 19:41:52 ET
Table '1622573280 1' 9-max Seat #8 is the button
Seat 1: mrbobsnj (9350 in chips)=20
Seat 2: hainesiv2 (29324 in chips)=20
Seat 3: robertg68 (17793 in chips)=20
Seat 4: hof49 (12635 in chips)=20
Seat 5: toodope4you (6402 in chips)=20
Seat 6: MJG0 (5865 in chips)=20
Seat 8: JJin91 (20531 in chips)=20
Seat 9: xJaehaerysx (14112 in chips)=20
mrbobsnj: posts the ante 50
hainesiv2: posts the ante 50
robertg68: posts the ante 50
hof49: posts the ante 50
toodope4you: posts the ante 50
MJG0: posts the ante 50
JJin91: posts the ante 50
xJaehaerysx: posts the ante 50
xJaehaerysx: posts small blind 200
mrbobsnj: posts big blind 400
*** HOLE CARDS ***
Dealt to JJin91 [2h Th]
hainesiv2: folds=20
robertg68: calls 400
hof49: folds=20
toodope4you: raises 520 to 920
MJG0: folds=20
JJin91: folds=20
xJaehaerysx: folds=20
mrbobsnj: calls 520
robertg68: calls 520
*** FLOP *** [Kh 3h Jh]
mrbobsnj: checks=20
robertg68: bets 800
toodope4you: raises 3720 to 4520
mrbobsnj: folds=20
robertg68: raises 3720 to 8240
toodope4you: calls 912 and is all-in
Uncalled bet (2808) returned to robertg68
*** TURN *** [Kh 3h Jh] [8c]
*** RIVER *** [Kh 3h Jh 8c] [7d]
*** SHOW DOWN ***
robertg68: shows [Tc Ks] (a pair of Kings)
toodope4you: shows [6c 6s] (a pair of Sixes)
robertg68 collected 14224 from pot
toodope4you finished the tournament in 108th place
*** SUMMARY ***
Total pot 14224 | Rake 0=20
Board [Kh 3h Jh 8c 7d]
Seat 1: mrbobsnj (big blind) folded on the Flop
Seat 2: hainesiv2 folded before Flop (didn't bet)
Seat 3: robertg68 showed [Tc Ks] and won (14224) with a pair of Kings
Seat 4: hof49 folded before Flop (didn't bet)
Seat 5: toodope4you showed [6c 6s] and lost with a pair of Sixes
Seat 6: MJG0 folded before Flop (didn't bet)
Seat 8: JJin91 (button) folded before Flop (didn't bet)
Seat 9: xJaehaerysx (small blind) folded before Flop


*********** # 48 **************
PokerStars Hand #170373986579: Tournament #1622573280, $9.10+$0.90 USD =
Hold'em No Limit - Level X (200/400) - 2017/05/25 19:43:01 ET
Table '1622573280 1' 9-max Seat #9 is the button
Seat 1: mrbobsnj (8380 in chips)=20
Seat 2: hainesiv2 (29274 in chips)=20
Seat 3: robertg68 (25615 in chips)=20
Seat 4: hof49 (12585 in chips)=20
Seat 6: MJG0 (5815 in chips)=20
Seat 8: JJin91 (20481 in chips)=20
Seat 9: xJaehaerysx (13862 in chips)=20
mrbobsnj: posts the ante 50
hainesiv2: posts the ante 50
robertg68: posts the ante 50
hof49: posts the ante 50
MJG0: posts the ante 50
JJin91: posts the ante 50
xJaehaerysx: posts the ante 50
mrbobsnj: posts small blind 200
hainesiv2: posts big blind 400
*** HOLE CARDS ***
Dealt to JJin91 [Kh 5d]
robertg68: folds=20
hof49: folds=20
MJG0: calls 400
JJin91: folds=20
xJaehaerysx: raises 480 to 880
mrbobsnj: folds=20
hainesiv2: raises 480 to 1360
MJG0: folds=20
xJaehaerysx: folds=20
Uncalled bet (480) returned to hainesiv2
hainesiv2 collected 2710 from pot
hainesiv2: doesn't show hand=20
*** SUMMARY ***
Total pot 2710 | Rake 0=20
Seat 1: mrbobsnj (small blind) folded before Flop
Seat 2: hainesiv2 (big blind) collected (2710)
Seat 3: robertg68 folded before Flop (didn't bet)
Seat 4: hof49 folded before Flop (didn't bet)
Seat 6: MJG0 folded before Flop
Seat 8: JJin91 folded before Flop (didn't bet)
Seat 9: xJaehaerysx (button) folded before Flop


*********** # 49 **************
PokerStars Hand #170373986762: Tournament #1622573280, $9.10+$0.90 USD =
Hold'em No Limit - Level X (200/400) - 2017/05/25 19:43:51 ET
Table '1622573280 1' 9-max Seat #1 is the button
Seat 1: mrbobsnj (8130 in chips)=20
Seat 2: hainesiv2 (31054 in chips)=20
Seat 3: robertg68 (25565 in chips)=20
Seat 4: hof49 (12535 in chips)=20
Seat 6: MJG0 (5365 in chips)=20
Seat 7: toodope4you (10000 in chips)=20
Seat 8: JJin91 (20431 in chips)=20
Seat 9: xJaehaerysx (12932 in chips)=20
mrbobsnj: posts the ante 50
hainesiv2: posts the ante 50
robertg68: posts the ante 50
hof49: posts the ante 50
MJG0: posts the ante 50
toodope4you: posts the ante 50
JJin91: posts the ante 50
xJaehaerysx: posts the ante 50
hainesiv2: posts small blind 200
robertg68: posts big blind 400
*** HOLE CARDS ***
Dealt to JJin91 [2s Kh]
hof49: calls 400
MJG0: calls 400
toodope4you: folds=20
JJin91: folds=20
xJaehaerysx: folds=20
mrbobsnj: calls 400
hainesiv2: folds=20
robertg68: checks=20
*** FLOP *** [Qd Tc Qh]
robertg68: checks=20
hof49: checks=20
MJG0: checks=20
mrbobsnj: checks=20
*** TURN *** [Qd Tc Qh] [8d]
robertg68: checks=20
hof49: bets 400
MJG0: raises 800 to 1200
mrbobsnj: calls 1200
robertg68: folds=20
hof49: folds=20
*** RIVER *** [Qd Tc Qh 8d] [As]
MJG0: checks=20
mrbobsnj: bets 1200
MJG0: calls 1200
*** SHOW DOWN ***
mrbobsnj: shows [8h Qs] (a full house, Queens full of Eights)
MJG0: mucks hand=20
mrbobsnj collected 7400 from pot
*** SUMMARY ***
Total pot 7400 | Rake 0=20
Board [Qd Tc Qh 8d As]
Seat 1: mrbobsnj (button) showed [8h Qs] and won (7400) with a full hou=
se, Queens full of Eights
Seat 2: hainesiv2 (small blind) folded before Flop
Seat 3: robertg68 (big blind) folded on the Turn
Seat 4: hof49 folded on the Turn
Seat 6: MJG0 mucked [Jh Th]
Seat 7: toodope4you folded before Flop (didn't bet)
Seat 8: JJin91 folded before Flop (didn't bet)
Seat 9: xJaehaerysx folded before Flop (didn't bet)


*********** # 50 **************
PokerStars Hand #170373987050: Tournament #1622573280, $9.10+$0.90 USD =
Hold'em No Limit - Level X (200/400) - 2017/05/25 19:45:13 ET
Table '1622573280 1' 9-max Seat #2 is the button
Seat 1: mrbobsnj (12680 in chips)=20
Seat 2: hainesiv2 (30804 in chips)=20
Seat 3: robertg68 (25115 in chips)=20
Seat 4: hof49 (11685 in chips)=20
Seat 6: MJG0 (2515 in chips)=20
Seat 7: toodope4you (9950 in chips)=20
Seat 8: JJin91 (20381 in chips)=20
Seat 9: xJaehaerysx (12882 in chips)=20
mrbobsnj: posts the ante 50
hainesiv2: posts the ante 50
robertg68: posts the ante 50
hof49: posts the ante 50
MJG0: posts the ante 50
toodope4you: posts the ante 50
JJin91: posts the ante 50
xJaehaerysx: posts the ante 50
robertg68: posts small blind 200
hof49: posts big blind 400
*** HOLE CARDS ***
Dealt to JJin91 [8h Js]
MJG0: raises 2065 to 2465 and is all-in
toodope4you: folds=20
JJin91: folds=20
xJaehaerysx: folds=20
mrbobsnj: folds=20
hainesiv2: folds=20
robertg68: folds=20
hof49: folds=20
Uncalled bet (2065) returned to MJG0
MJG0 collected 1400 from pot
MJG0: doesn't show hand=20
*** SUMMARY ***
Total pot 1400 | Rake 0=20
Seat 1: mrbobsnj folded before Flop (didn't bet)
Seat 2: hainesiv2 (button) folded before Flop (didn't bet)
Seat 3: robertg68 (small blind) folded before Flop
Seat 4: hof49 (big blind) folded before Flop
Seat 6: MJG0 collected (1400)
Seat 7: toodope4you folded before Flop (didn't bet)
Seat 8: JJin91 folded before Flop (didn't bet)
Seat 9: xJaehaerysx folded before Flop (didn't bet)


*********** # 51 **************
PokerStars Hand #170373987165: Tournament #1622573280, $9.10+$0.90 USD =
Hold'em No Limit - Level X (200/400) - 2017/05/25 19:45:45 ET
Table '1622573280 1' 9-max Seat #3 is the button
Seat 1: mrbobsnj (12630 in chips)=20
Seat 2: hainesiv2 (30754 in chips)=20
Seat 3: robertg68 (24865 in chips)=20
Seat 4: hof49 (11235 in chips)=20
Seat 6: MJG0 (3465 in chips)=20
Seat 7: toodope4you (9900 in chips)=20
Seat 8: JJin91 (20331 in chips)=20
Seat 9: xJaehaerysx (12832 in chips)=20
mrbobsnj: posts the ante 50
hainesiv2: posts the ante 50
robertg68: posts the ante 50
hof49: posts the ante 50
MJG0: posts the ante 50
toodope4you: posts the ante 50
JJin91: posts the ante 50
xJaehaerysx: posts the ante 50
hof49: posts small blind 200
MJG0: posts big blind 400
*** HOLE CARDS ***
Dealt to JJin91 [2s Ad]
toodope4you: folds=20
JJin91: folds=20
xJaehaerysx: folds=20
mrbobsnj: calls 400
hainesiv2: folds=20
robertg68: folds=20
hof49: calls 200
MJG0: checks=20
*** FLOP *** [Ah 5s Jc]
hof49: bets 800
MJG0: folds=20
mrbobsnj: folds=20
Uncalled bet (800) returned to hof49
hof49 collected 1600 from pot
hof49: doesn't show hand=20
*** SUMMARY ***
Total pot 1600 | Rake 0=20
Board [Ah 5s Jc]
Seat 1: mrbobsnj folded on the Flop
Seat 2: hainesiv2 folded before Flop (didn't bet)
Seat 3: robertg68 (button) folded before Flop (didn't bet)
Seat 4: hof49 (small blind) collected (1600)
Seat 6: MJG0 (big blind) folded on the Flop
Seat 7: toodope4you folded before Flop (didn't bet)
Seat 8: JJin91 folded before Flop (didn't bet)
Seat 9: xJaehaerysx folded before Flop (didn't bet)


*********** # 52 **************
PokerStars Hand #170373987311: Tournament #1622573280, $9.10+$0.90 USD =
Hold'em No Limit - Level X (200/400) - 2017/05/25 19:46:25 ET
Table '1622573280 1' 9-max Seat #4 is the button
Seat 1: mrbobsnj (12180 in chips)=20
Seat 2: hainesiv2 (30704 in chips)=20
Seat 3: robertg68 (24815 in chips)=20
Seat 4: hof49 (12385 in chips)=20
Seat 6: MJG0 (3015 in chips)=20
Seat 7: toodope4you (9850 in chips)=20
Seat 8: JJin91 (20281 in chips)=20
Seat 9: xJaehaerysx (12782 in chips)=20
mrbobsnj: posts the ante 50
hainesiv2: posts the ante 50
robertg68: posts the ante 50
hof49: posts the ante 50
MJG0: posts the ante 50
toodope4you: posts the ante 50
JJin91: posts the ante 50
xJaehaerysx: posts the ante 50
MJG0: posts small blind 200
toodope4you: posts big blind 400
*** HOLE CARDS ***
Dealt to JJin91 [2s 3c]
JJin91: folds=20
xJaehaerysx: calls 400
mrbobsnj: calls 400
hainesiv2: calls 400
robertg68: calls 400
hof49: raises 800 to 1200
MJG0: folds=20
toodope4you: folds=20
xJaehaerysx: calls 800
mrbobsnj: calls 800
hainesiv2: calls 800
robertg68: calls 800
*** FLOP *** [6s Ts 5d]
xJaehaerysx: checks=20
mrbobsnj: bets 7000
hainesiv2: folds=20
robertg68: folds=20
hof49: folds=20
xJaehaerysx: folds=20
Uncalled bet (7000) returned to mrbobsnj
mrbobsnj collected 7000 from pot
mrbobsnj: doesn't show hand=20
*** SUMMARY ***
Total pot 7000 | Rake 0=20
Board [6s Ts 5d]
Seat 1: mrbobsnj collected (7000)
Seat 2: hainesiv2 folded on the Flop
Seat 3: robertg68 folded on the Flop
Seat 4: hof49 (button) folded on the Flop
Seat 6: MJG0 (small blind) folded before Flop
Seat 7: toodope4you (big blind) folded before Flop
Seat 8: JJin91 folded before Flop (didn't bet)
Seat 9: xJaehaerysx folded on the Flop


*********** # 53 **************
PokerStars Hand #170373987676: Tournament #1622573280, $9.10+$0.90 USD =
Hold'em No Limit - Level XI (250/500) - 2017/05/25 19:48:11 ET
Table '1622573280 1' 9-max Seat #6 is the button
Seat 1: mrbobsnj (17930 in chips)=20
Seat 2: hainesiv2 (29454 in chips)=20
Seat 3: robertg68 (23565 in chips)=20
Seat 4: hof49 (11135 in chips)=20
Seat 6: MJG0 (2765 in chips)=20
Seat 7: toodope4you (9400 in chips)=20
Seat 8: JJin91 (20231 in chips)=20
Seat 9: xJaehaerysx (11532 in chips)=20
mrbobsnj: posts the ante 60
hainesiv2: posts the ante 60
robertg68: posts the ante 60
hof49: posts the ante 60
MJG0: posts the ante 60
toodope4you: posts the ante 60
JJin91: posts the ante 60
xJaehaerysx: posts the ante 60
toodope4you: posts small blind 250
JJin91: posts big blind 500
*** HOLE CARDS ***
Dealt to JJin91 [Ts 4c]
xJaehaerysx: folds=20
mrbobsnj: folds=20
hainesiv2: folds=20
robertg68: folds=20
hof49: raises 500 to 1000
MJG0: folds=20
toodope4you: folds=20
JJin91: folds=20
Uncalled bet (500) returned to hof49
hof49 collected 1730 from pot
hof49: doesn't show hand=20
*** SUMMARY ***
Total pot 1730 | Rake 0=20
Seat 1: mrbobsnj folded before Flop (didn't bet)
Seat 2: hainesiv2 folded before Flop (didn't bet)
Seat 3: robertg68 folded before Flop (didn't bet)
Seat 4: hof49 collected (1730)
Seat 6: MJG0 (button) folded before Flop (didn't bet)
Seat 7: toodope4you (small blind) folded before Flop
Seat 8: JJin91 (big blind) folded before Flop
Seat 9: xJaehaerysx folded before Flop (didn't bet)


*********** # 54 **************
PokerStars Hand #170373987759: Tournament #1622573280, $9.10+$0.90 USD =
Hold'em No Limit - Level XI (250/500) - 2017/05/25 19:48:36 ET
Table '1622573280 1' 9-max Seat #7 is the button
Seat 1: mrbobsnj (17870 in chips)=20
Seat 2: hainesiv2 (29394 in chips)=20
Seat 3: robertg68 (23505 in chips)=20
Seat 4: hof49 (12305 in chips)=20
Seat 6: MJG0 (2705 in chips)=20
Seat 7: toodope4you (9090 in chips)=20
Seat 8: JJin91 (19671 in chips)=20
Seat 9: xJaehaerysx (11472 in chips)=20
mrbobsnj: posts the ante 60
hainesiv2: posts the ante 60
robertg68: posts the ante 60
hof49: posts the ante 60
MJG0: posts the ante 60
toodope4you: posts the ante 60
JJin91: posts the ante 60
xJaehaerysx: posts the ante 60
JJin91: posts small blind 250
xJaehaerysx: posts big blind 500
*** HOLE CARDS ***
Dealt to JJin91 [7d 6h]
mrbobsnj: folds=20
hainesiv2: folds=20
robertg68: folds=20
hof49: calls 500
MJG0: raises 2145 to 2645 and is all-in
toodope4you: folds=20
JJin91: folds=20
xJaehaerysx: folds=20
hof49: calls 2145
*** FLOP *** [Ts Jc Jh]
*** TURN *** [Ts Jc Jh] [3d]
*** RIVER *** [Ts Jc Jh 3d] [Ad]
*** SHOW DOWN ***
hof49: shows [4d 3c] (two pair, Jacks and Threes)
MJG0: shows [Jd Ac] (a full house, Jacks full of Aces)
MJG0 collected 6520 from pot
*** SUMMARY ***
Total pot 6520 | Rake 0=20
Board [Ts Jc Jh 3d Ad]
Seat 1: mrbobsnj folded before Flop (didn't bet)
Seat 2: hainesiv2 folded before Flop (didn't bet)
Seat 3: robertg68 folded before Flop (didn't bet)
Seat 4: hof49 showed [4d 3c] and lost with two pair, Jacks and Threes
Seat 6: MJG0 showed [Jd Ac] and won (6520) with a full house, Jacks ful=
l of Aces
Seat 7: toodope4you (button) folded before Flop (didn't bet)
Seat 8: JJin91 (small blind) folded before Flop
Seat 9: xJaehaerysx (big blind) folded before Flop


*********** # 55 **************
PokerStars Hand #170373987928: Tournament #1622573280, $9.10+$0.90 USD =
Hold'em No Limit - Level XI (250/500) - 2017/05/25 19:49:27 ET
Table '1622573280 1' 9-max Seat #8 is the button
Seat 1: mrbobsnj (17810 in chips)=20
Seat 2: hainesiv2 (29334 in chips)=20
Seat 3: robertg68 (23445 in chips)=20
Seat 4: hof49 (9600 in chips)=20
Seat 6: MJG0 (6520 in chips)=20
Seat 7: toodope4you (9030 in chips)=20
Seat 8: JJin91 (19361 in chips)=20
Seat 9: xJaehaerysx (10912 in chips)=20
mrbobsnj: posts the ante 60
hainesiv2: posts the ante 60
robertg68: posts the ante 60
hof49: posts the ante 60
MJG0: posts the ante 60
toodope4you: posts the ante 60
JJin91: posts the ante 60
xJaehaerysx: posts the ante 60
xJaehaerysx: posts small blind 250
mrbobsnj: posts big blind 500
*** HOLE CARDS ***
Dealt to JJin91 [3h 3d]
hainesiv2: folds=20
robertg68: folds=20
hof49: raises 500 to 1000
MJG0: folds=20
toodope4you: folds=20
JJin91: calls 1000
xJaehaerysx: folds=20
mrbobsnj: calls 500
*** FLOP *** [3s 6h Qd]
mrbobsnj: bets 500
hof49: calls 500
JJin91: calls 500
*** TURN *** [3s 6h Qd] [4s]
mrbobsnj: checks=20
hof49: checks=20
JJin91: bets 2981
mrbobsnj: folds=20
hof49: calls 2981
*** RIVER *** [3s 6h Qd 4s] [6s]
hof49: bets 5059 and is all-in
JJin91: calls 5059
*** SHOW DOWN ***
hof49: shows [Ts Ks] (a flush, King high)
JJin91: shows [3h 3d] (a full house, Threes full of Sixes)
JJin91 collected 21310 from pot
hof49 finished the tournament in 99th place
*** SUMMARY ***
Total pot 21310 | Rake 0=20
Board [3s 6h Qd 4s 6s]
Seat 1: mrbobsnj (big blind) folded on the Turn
Seat 2: hainesiv2 folded before Flop (didn't bet)
Seat 3: robertg68 folded before Flop (didn't bet)
Seat 4: hof49 showed [Ts Ks] and lost with a flush, King high
Seat 6: MJG0 folded before Flop (didn't bet)
Seat 7: toodope4you folded before Flop (didn't bet)
Seat 8: JJin91 (button) showed [3h 3d] and won (21310) with a full hous=
e, Threes full of Sixes
Seat 9: xJaehaerysx (small blind) folded before Flop


*********** # 56 **************
PokerStars Hand #170373988303: Tournament #1622573280, $9.10+$0.90 USD =
Hold'em No Limit - Level XI (250/500) - 2017/05/25 19:51:12 ET
Table '1622573280 1' 9-max Seat #9 is the button
Seat 1: mrbobsnj (16250 in chips)=20
Seat 2: hainesiv2 (29274 in chips)=20
Seat 3: robertg68 (23385 in chips)=20
Seat 6: MJG0 (6460 in chips)=20
Seat 7: toodope4you (8970 in chips)=20
Seat 8: JJin91 (31071 in chips)=20
Seat 9: xJaehaerysx (10602 in chips)=20
mrbobsnj: posts the ante 60
hainesiv2: posts the ante 60
robertg68: posts the ante 60
MJG0: posts the ante 60
toodope4you: posts the ante 60
JJin91: posts the ante 60
xJaehaerysx: posts the ante 60
mrbobsnj: posts small blind 250
hainesiv2: posts big blind 500
*** HOLE CARDS ***
Dealt to JJin91 [6d 3s]
robertg68: folds=20
MJG0: folds=20
toodope4you: folds=20
JJin91: folds=20
xJaehaerysx: folds=20
mrbobsnj: calls 250
hainesiv2: checks=20
*** FLOP *** [9h 4c Jh]
mrbobsnj: checks=20
hainesiv2: bets 1562
mrbobsnj: folds=20
Uncalled bet (1562) returned to hainesiv2
hainesiv2 collected 1420 from pot
hainesiv2: doesn't show hand=20
*** SUMMARY ***
Total pot 1420 | Rake 0=20
Board [9h 4c Jh]
Seat 1: mrbobsnj (small blind) folded on the Flop
Seat 2: hainesiv2 (big blind) collected (1420)
Seat 3: robertg68 folded before Flop (didn't bet)
Seat 6: MJG0 folded before Flop (didn't bet)
Seat 7: toodope4you folded before Flop (didn't bet)
Seat 8: JJin91 folded before Flop (didn't bet)
Seat 9: xJaehaerysx (button) folded before Flop (didn't bet)


*********** # 57 **************
PokerStars Hand #170373988474: Tournament #1622573280, $9.10+$0.90 USD =
Hold'em No Limit - Level XI (250/500) - 2017/05/25 19:51:58 ET
Table '1622573280 1' 9-max Seat #1 is the button
Seat 1: mrbobsnj (15690 in chips)=20
Seat 2: hainesiv2 (30134 in chips)=20
Seat 3: robertg68 (23325 in chips)=20
Seat 4: JerseyGuy316 (9970 in chips)=20
Seat 6: MJG0 (6400 in chips)=20
Seat 7: toodope4you (8910 in chips)=20
Seat 8: JJin91 (31011 in chips)=20
Seat 9: xJaehaerysx (10542 in chips)=20
mrbobsnj: posts the ante 60
hainesiv2: posts the ante 60
robertg68: posts the ante 60
JerseyGuy316: posts the ante 60
MJG0: posts the ante 60
toodope4you: posts the ante 60
JJin91: posts the ante 60
xJaehaerysx: posts the ante 60
hainesiv2: posts small blind 250
robertg68: posts big blind 500
*** HOLE CARDS ***
Dealt to JJin91 [Qh 8d]
JerseyGuy316: folds=20
MJG0: folds=20
toodope4you: folds=20
JJin91: folds=20
xJaehaerysx: folds=20
mrbobsnj: folds=20
hainesiv2: calls 250
robertg68: checks=20
*** FLOP *** [9d 4s 3s]
hainesiv2: checks=20
robertg68: checks=20
*** TURN *** [9d 4s 3s] [2d]
hainesiv2: checks=20
robertg68: checks=20
*** RIVER *** [9d 4s 3s 2d] [9h]
hainesiv2: checks=20
robertg68: checks=20
*** SHOW DOWN ***
hainesiv2: shows [Jh 5h] (a pair of Nines)
robertg68: shows [Js Tc] (a pair of Nines - Jack+Ten kicker)
robertg68 collected 1480 from pot
*** SUMMARY ***
Total pot 1480 | Rake 0=20
Board [9d 4s 3s 2d 9h]
Seat 1: mrbobsnj (button) folded before Flop (didn't bet)
Seat 2: hainesiv2 (small blind) showed [Jh 5h] and lost with a pair of =
Nines
Seat 3: robertg68 (big blind) showed [Js Tc] and won (1480) with a pair=
 of Nines
Seat 4: JerseyGuy316 folded before Flop (didn't bet)
Seat 6: MJG0 folded before Flop (didn't bet)
Seat 7: toodope4you folded before Flop (didn't bet)
Seat 8: JJin91 folded before Flop (didn't bet)
Seat 9: xJaehaerysx folded before Flop (didn't bet)


*********** # 58 **************
PokerStars Hand #170373988661: Tournament #1622573280, $9.10+$0.90 USD =
Hold'em No Limit - Level XI (250/500) - 2017/05/25 19:52:45 ET
Table '1622573280 1' 9-max Seat #2 is the button
Seat 1: mrbobsnj (15630 in chips)=20
Seat 2: hainesiv2 (29574 in chips)=20
Seat 3: robertg68 (24245 in chips)=20
Seat 4: JerseyGuy316 (9910 in chips)=20
Seat 6: MJG0 (6340 in chips)=20
Seat 7: toodope4you (8850 in chips)=20
Seat 8: JJin91 (30951 in chips)=20
Seat 9: xJaehaerysx (10482 in chips)=20
mrbobsnj: posts the ante 60
hainesiv2: posts the ante 60
robertg68: posts the ante 60
JerseyGuy316: posts the ante 60
MJG0: posts the ante 60
toodope4you: posts the ante 60
JJin91: posts the ante 60
xJaehaerysx: posts the ante 60
robertg68: posts small blind 250
JerseyGuy316: posts big blind 500
*** HOLE CARDS ***
Dealt to JJin91 [3h 3d]
MJG0: folds=20
toodope4you: folds=20
JJin91: raises 595 to 1095
xJaehaerysx: calls 1095
mrbobsnj: folds=20
hainesiv2: folds=20
robertg68: folds=20
JerseyGuy316: folds=20
*** FLOP *** [2h As Qc]
JJin91: bets 1949
xJaehaerysx: folds=20
Uncalled bet (1949) returned to JJin91
JJin91 collected 3420 from pot
JJin91: doesn't show hand=20
*** SUMMARY ***
Total pot 3420 | Rake 0=20
Board [2h As Qc]
Seat 1: mrbobsnj folded before Flop (didn't bet)
Seat 2: hainesiv2 (button) folded before Flop (didn't bet)
Seat 3: robertg68 (small blind) folded before Flop
Seat 4: JerseyGuy316 (big blind) folded before Flop
Seat 6: MJG0 folded before Flop (didn't bet)
Seat 7: toodope4you folded before Flop (didn't bet)
Seat 8: JJin91 collected (3420)
Seat 9: xJaehaerysx folded on the Flop


*********** # 59 **************
PokerStars Hand #170373988883: Tournament #1622573280, $9.10+$0.90 USD =
Hold'em No Limit - Level XI (250/500) - 2017/05/25 19:53:40 ET
Table '1622573280 1' 9-max Seat #3 is the button
Seat 1: mrbobsnj (15570 in chips)=20
Seat 2: hainesiv2 (29514 in chips)=20
Seat 3: robertg68 (23935 in chips)=20
Seat 4: JerseyGuy316 (9350 in chips)=20
Seat 6: MJG0 (6280 in chips)=20
Seat 7: toodope4you (8790 in chips)=20
Seat 8: JJin91 (33216 in chips)=20
Seat 9: xJaehaerysx (9327 in chips)=20
mrbobsnj: posts the ante 60
hainesiv2: posts the ante 60
robertg68: posts the ante 60
JerseyGuy316: posts the ante 60
MJG0: posts the ante 60
toodope4you: posts the ante 60
JJin91: posts the ante 60
xJaehaerysx: posts the ante 60
JerseyGuy316: posts small blind 250
MJG0: posts big blind 500
*** HOLE CARDS ***
Dealt to JJin91 [Qd 5s]
toodope4you: folds=20
JJin91: folds=20
xJaehaerysx: raises 500 to 1000
mrbobsnj: folds=20
hainesiv2: folds=20
robertg68: calls 1000
JerseyGuy316: folds=20
MJG0: calls 500
*** FLOP *** [Kc 8c 2c]
MJG0: checks=20
xJaehaerysx: bets 1865
robertg68: folds=20
MJG0: folds=20
Uncalled bet (1865) returned to xJaehaerysx
xJaehaerysx collected 3730 from pot
xJaehaerysx: doesn't show hand=20
*** SUMMARY ***
Total pot 3730 | Rake 0=20
Board [Kc 8c 2c]
Seat 1: mrbobsnj folded before Flop (didn't bet)
Seat 2: hainesiv2 folded before Flop (didn't bet)
Seat 3: robertg68 (button) folded on the Flop
Seat 4: JerseyGuy316 (small blind) folded before Flop
Seat 6: MJG0 (big blind) folded on the Flop
Seat 7: toodope4you folded before Flop (didn't bet)
Seat 8: JJin91 folded before Flop (didn't bet)
Seat 9: xJaehaerysx collected (3730)


*********** # 60 **************
PokerStars Hand #170373989033: Tournament #1622573280, $9.10+$0.90 USD =
Hold'em No Limit - Level XI (250/500) - 2017/05/25 19:54:17 ET
Table '1622573280 1' 9-max Seat #4 is the button
Seat 1: mrbobsnj (15510 in chips)=20
Seat 2: hainesiv2 (29454 in chips)=20
Seat 3: robertg68 (22875 in chips)=20
Seat 4: JerseyGuy316 (9040 in chips)=20
Seat 6: MJG0 (5220 in chips)=20
Seat 7: toodope4you (8730 in chips)=20
Seat 8: JJin91 (33156 in chips)=20
Seat 9: xJaehaerysx (11997 in chips)=20
mrbobsnj: posts the ante 60
hainesiv2: posts the ante 60
robertg68: posts the ante 60
JerseyGuy316: posts the ante 60
MJG0: posts the ante 60
toodope4you: posts the ante 60
JJin91: posts the ante 60
xJaehaerysx: posts the ante 60
MJG0: posts small blind 250
toodope4you: posts big blind 500
*** HOLE CARDS ***
Dealt to JJin91 [2h Jc]
JJin91: folds=20
xJaehaerysx: folds=20
mrbobsnj: calls 500
hainesiv2: folds=20
robertg68: folds=20
JerseyGuy316: calls 500
MJG0: raises 4660 to 5160 and is all-in
toodope4you: folds=20
mrbobsnj: folds=20
JerseyGuy316: folds=20
Uncalled bet (4660) returned to MJG0
MJG0 collected 2480 from pot
MJG0: doesn't show hand=20
*** SUMMARY ***
Total pot 2480 | Rake 0=20
Seat 1: mrbobsnj folded before Flop
Seat 2: hainesiv2 folded before Flop (didn't bet)
Seat 3: robertg68 folded before Flop (didn't bet)
Seat 4: JerseyGuy316 (button) folded before Flop
Seat 6: MJG0 (small blind) collected (2480)
Seat 7: toodope4you (big blind) folded before Flop
Seat 8: JJin91 folded before Flop (didn't bet)
Seat 9: xJaehaerysx folded before Flop (didn't bet)


*********** # 61 **************
PokerStars Hand #170374812370: Tournament #1622573280, $9.10+$0.90 USD =
Hold'em No Limit - Level XI (250/500) - 2017/05/25 20:01:17 ET
Table '1622573280 1' 9-max Seat #6 is the button
Seat 1: mrbobsnj (14950 in chips)=20
Seat 2: hainesiv2 (29394 in chips)=20
Seat 4: JerseyGuy316 (8480 in chips)=20
Seat 5: ks1112 (10000 in chips)=20
Seat 6: MJG0 (7140 in chips)=20
Seat 7: toodope4you (8170 in chips)=20
Seat 8: JJin91 (33096 in chips)=20
Seat 9: xJaehaerysx (11937 in chips)=20
mrbobsnj: posts the ante 60
hainesiv2: posts the ante 60
JerseyGuy316: posts the ante 60
ks1112: posts the ante 60
MJG0: posts the ante 60
toodope4you: posts the ante 60
JJin91: posts the ante 60
xJaehaerysx: posts the ante 60
toodope4you: posts small blind 250
JJin91: posts big blind 500
*** HOLE CARDS ***
Dealt to JJin91 [Ts 4h]
xJaehaerysx: folds=20
mrbobsnj: folds=20
hainesiv2: calls 500
JerseyGuy316: folds=20
ks1112: folds=20
MJG0: folds=20
toodope4you: folds=20
JJin91: checks=20
*** FLOP *** [3h 5d 6h]
JJin91: checks=20
hainesiv2: bets 1038
JJin91: calls 1038
*** TURN *** [3h 5d 6h] [7h]
JJin91: checks=20
hainesiv2: bets 2284
JJin91: calls 2284
*** RIVER *** [3h 5d 6h 7h] [Qd]
JJin91: checks=20
hainesiv2: checks=20
*** SHOW DOWN ***
JJin91: shows [Ts 4h] (a straight, Three to Seven)
hainesiv2: mucks hand=20
JJin91 collected 8374 from pot
*** SUMMARY ***
Total pot 8374 | Rake 0=20
Board [3h 5d 6h 7h Qd]
Seat 1: mrbobsnj folded before Flop (didn't bet)
Seat 2: hainesiv2 mucked [Tc As]
Seat 4: JerseyGuy316 folded before Flop (didn't bet)
Seat 5: ks1112 folded before Flop (didn't bet)
Seat 6: MJG0 (button) folded before Flop (didn't bet)
Seat 7: toodope4you (small blind) folded before Flop
Seat 8: JJin91 (big blind) showed [Ts 4h] and won (8374) with a straigh=
t, Three to Seven
Seat 9: xJaehaerysx folded before Flop (didn't bet)


*********** # 62 **************
PokerStars Hand #170374812730: Tournament #1622573280, $9.10+$0.90 USD =
Hold'em No Limit - Level XI (250/500) - 2017/05/25 20:02:39 ET
Table '1622573280 1' 9-max Seat #7 is the button
Seat 1: mrbobsnj (14890 in chips)=20
Seat 2: hainesiv2 (25512 in chips)=20
Seat 3: SneakyPete85 (15700 in chips)=20
Seat 4: JerseyGuy316 (8420 in chips)=20
Seat 5: ks1112 (9940 in chips)=20
Seat 6: MJG0 (7080 in chips)=20
Seat 7: toodope4you (7860 in chips)=20
Seat 8: JJin91 (37588 in chips)=20
Seat 9: xJaehaerysx (11877 in chips)=20
mrbobsnj: posts the ante 60
hainesiv2: posts the ante 60
SneakyPete85: posts the ante 60
JerseyGuy316: posts the ante 60
ks1112: posts the ante 60
MJG0: posts the ante 60
toodope4you: posts the ante 60
JJin91: posts the ante 60
xJaehaerysx: posts the ante 60
JJin91: posts small blind 250
xJaehaerysx: posts big blind 500
*** HOLE CARDS ***
Dealt to JJin91 [6c Kh]
mrbobsnj: folds=20
hainesiv2: folds=20
SneakyPete85: folds=20
JerseyGuy316: folds=20
ks1112: folds=20
MJG0: folds=20
toodope4you: folds=20
JJin91: folds=20
Uncalled bet (250) returned to xJaehaerysx
xJaehaerysx collected 1040 from pot
xJaehaerysx: doesn't show hand=20
*** SUMMARY ***
Total pot 1040 | Rake 0=20
Seat 1: mrbobsnj folded before Flop (didn't bet)
Seat 2: hainesiv2 folded before Flop (didn't bet)
Seat 3: SneakyPete85 folded before Flop (didn't bet)
Seat 4: JerseyGuy316 folded before Flop (didn't bet)
Seat 5: ks1112 folded before Flop (didn't bet)
Seat 6: MJG0 folded before Flop (didn't bet)
Seat 7: toodope4you (button) folded before Flop (didn't bet)
Seat 8: JJin91 (small blind) folded before Flop
Seat 9: xJaehaerysx (big blind) collected (1040)


*********** # 63 **************
PokerStars Hand #170374812847: Tournament #1622573280, $9.10+$0.90 USD =
Hold'em No Limit - Level XI (250/500) - 2017/05/25 20:03:06 ET
Table '1622573280 1' 9-max Seat #8 is the button
Seat 1: mrbobsnj (14830 in chips)=20
Seat 2: hainesiv2 (25452 in chips)=20
Seat 3: SneakyPete85 (15640 in chips)=20
Seat 4: JerseyGuy316 (8360 in chips)=20
Seat 5: ks1112 (9880 in chips)=20
Seat 6: MJG0 (7020 in chips)=20
Seat 7: toodope4you (7800 in chips)=20
Seat 8: JJin91 (37278 in chips)=20
Seat 9: xJaehaerysx (12607 in chips)=20
mrbobsnj: posts the ante 60
hainesiv2: posts the ante 60
SneakyPete85: posts the ante 60
JerseyGuy316: posts the ante 60
ks1112: posts the ante 60
MJG0: posts the ante 60
toodope4you: posts the ante 60
JJin91: posts the ante 60
xJaehaerysx: posts the ante 60
xJaehaerysx: posts small blind 250
mrbobsnj: posts big blind 500
*** HOLE CARDS ***
Dealt to JJin91 [Ts 8c]
hainesiv2: folds=20
SneakyPete85: raises 500 to 1000
JerseyGuy316: calls 1000
ks1112: folds=20
MJG0: calls 1000
toodope4you: folds=20
JJin91: folds=20
xJaehaerysx: folds=20
mrbobsnj: calls 500
*** FLOP *** [9h Qh 4s]
mrbobsnj: bets 500
SneakyPete85: calls 500
JerseyGuy316 said, "ill probally lose here lmao"
JerseyGuy316: raises 6800 to 7300 and is all-in
MJG0: calls 5960 and is all-in
mrbobsnj: folds=20
SneakyPete85: calls 6800
*** TURN *** [9h Qh 4s] [9c]
*** RIVER *** [9h Qh 4s 9c] [6d]
*** SHOW DOWN ***
SneakyPete85: shows [Ah 2h] (a pair of Nines)
JerseyGuy316: shows [Qs As] (two pair, Queens and Nines)
JerseyGuy316 collected 2680 from side pot
MJG0: shows [Kh Th] (a pair of Nines)
JerseyGuy316 collected 23170 from main pot
MJG0 finished the tournament in 90th place
mrbobsnj said, "jj or aa ?"
*** SUMMARY ***
Total pot 25850 Main pot 23170. Side pot 2680. | Rake 0=20
Board [9h Qh 4s 9c 6d]
Seat 1: mrbobsnj (big blind) folded on the Flop
Seat 2: hainesiv2 folded before Flop (didn't bet)
Seat 3: SneakyPete85 showed [Ah 2h] and lost with a pair of Nines
Seat 4: JerseyGuy316 showed [Qs As] and won (25850) with two pair, Quee=
ns and Nines
Seat 5: ks1112 folded before Flop (didn't bet)
Seat 6: MJG0 showed [Kh Th] and lost with a pair of Nines
Seat 7: toodope4you folded before Flop (didn't bet)
Seat 8: JJin91 (button) folded before Flop (didn't bet)
Seat 9: xJaehaerysx (small blind) folded before Flop


*********** # 64 **************
PokerStars Hand #170374813216: Tournament #1622573280, $9.10+$0.90 USD =
Hold'em No Limit - Level XII (300/600) - 2017/05/25 20:04:34 ET
Table '1622573280 1' 9-max Seat #9 is the button
Seat 1: mrbobsnj (13270 in chips)=20
Seat 2: hainesiv2 (25392 in chips)=20
Seat 3: SneakyPete85 (7280 in chips)=20
Seat 4: JerseyGuy316 (25850 in chips)=20
Seat 5: ks1112 (9820 in chips)=20
Seat 7: toodope4you (7740 in chips)=20
Seat 8: JJin91 (37218 in chips)=20
Seat 9: xJaehaerysx (12297 in chips)=20
mrbobsnj: posts the ante 70
hainesiv2: posts the ante 70
SneakyPete85: posts the ante 70
JerseyGuy316: posts the ante 70
ks1112: posts the ante 70
toodope4you: posts the ante 70
JJin91: posts the ante 70
xJaehaerysx: posts the ante 70
mrbobsnj: posts small blind 300
hainesiv2: posts big blind 600
*** HOLE CARDS ***
Dealt to JJin91 [9d 6c]
JerseyGuy316 said, "lol nice you bot h had hearts"
SneakyPete85: folds=20
mrbobsnj said, "mmmmmmm"
JerseyGuy316: folds=20
MJG0 [observer] said, "nh"
JerseyGuy316 said, "bot of em chasing"
mrbobsnj said, "n/h"
ks1112: folds=20
JerseyGuy316 said, "thank you sir"
mrbobsnj said, " it held"
JerseyGuy316 said, "ty gg"
toodope4you: folds=20
JJin91: folds=20
xJaehaerysx: raises 600 to 1200
mrbobsnj: calls 900
hainesiv2: folds=20
*** FLOP *** [4d Jc 8s]
mrbobsnj: checks=20
xJaehaerysx: bets 2400
mrbobsnj: folds=20
Uncalled bet (2400) returned to xJaehaerysx
xJaehaerysx collected 3560 from pot
xJaehaerysx: doesn't show hand=20
*** SUMMARY ***
Total pot 3560 | Rake 0=20
Board [4d Jc 8s]
Seat 1: mrbobsnj (small blind) folded on the Flop
Seat 2: hainesiv2 (big blind) folded before Flop
Seat 3: SneakyPete85 folded before Flop (didn't bet)
Seat 4: JerseyGuy316 folded before Flop (didn't bet)
Seat 5: ks1112 folded before Flop (didn't bet)
Seat 7: toodope4you folded before Flop (didn't bet)
Seat 8: JJin91 folded before Flop (didn't bet)
Seat 9: xJaehaerysx (button) collected (3560)


*********** # 65 **************
PokerStars Hand #170374813473: Tournament #1622573280, $9.10+$0.90 USD =
Hold'em No Limit - Level XII (300/600) - 2017/05/25 20:05:35 ET
Table '1622573280 1' 9-max Seat #1 is the button
Seat 1: mrbobsnj (12000 in chips)=20
Seat 2: hainesiv2 (24722 in chips)=20
Seat 3: SneakyPete85 (7210 in chips)=20
Seat 4: JerseyGuy316 (25780 in chips)=20
Seat 5: ks1112 (9750 in chips)=20
Seat 7: toodope4you (7670 in chips)=20
Seat 8: JJin91 (37148 in chips)=20
Seat 9: xJaehaerysx (14587 in chips)=20
mrbobsnj: posts the ante 70
hainesiv2: posts the ante 70
SneakyPete85: posts the ante 70
JerseyGuy316: posts the ante 70
ks1112: posts the ante 70
toodope4you: posts the ante 70
JJin91: posts the ante 70
xJaehaerysx: posts the ante 70
hainesiv2: posts small blind 300
SneakyPete85: posts big blind 600
*** HOLE CARDS ***
Dealt to JJin91 [3s 3c]
JerseyGuy316: folds=20
ks1112: folds=20
toodope4you: folds=20
JJin91: raises 714 to 1314
xJaehaerysx: folds=20
mrbobsnj: folds=20
hainesiv2: folds=20
SneakyPete85: folds=20
Uncalled bet (714) returned to JJin91
JJin91 collected 2060 from pot
JJin91: doesn't show hand=20
*** SUMMARY ***
Total pot 2060 | Rake 0=20
Seat 1: mrbobsnj (button) folded before Flop (didn't bet)
Seat 2: hainesiv2 (small blind) folded before Flop
Seat 3: SneakyPete85 (big blind) folded before Flop
Seat 4: JerseyGuy316 folded before Flop (didn't bet)
Seat 5: ks1112 folded before Flop (didn't bet)
Seat 7: toodope4you folded before Flop (didn't bet)
Seat 8: JJin91 collected (2060)
Seat 9: xJaehaerysx folded before Flop (didn't bet)


*********** # 66 **************
PokerStars Hand #170374813785: Tournament #1622573280, $9.10+$0.90 USD =
Hold'em No Limit - Level XII (300/600) - 2017/05/25 20:06:51 ET
Table '1622573280 1' 9-max Seat #2 is the button
Seat 1: mrbobsnj (11930 in chips)=20
Seat 2: hainesiv2 (24352 in chips)=20
Seat 3: SneakyPete85 (6540 in chips)=20
Seat 4: JerseyGuy316 (25710 in chips)=20
Seat 5: ks1112 (9680 in chips)=20
Seat 7: toodope4you (7600 in chips)=20
Seat 8: JJin91 (38538 in chips)=20
Seat 9: xJaehaerysx (14517 in chips)=20
mrbobsnj: posts the ante 70
hainesiv2: posts the ante 70
SneakyPete85: posts the ante 70
JerseyGuy316: posts the ante 70
ks1112: posts the ante 70
toodope4you: posts the ante 70
JJin91: posts the ante 70
xJaehaerysx: posts the ante 70
SneakyPete85: posts small blind 300
JerseyGuy316: posts big blind 600
*** HOLE CARDS ***
Dealt to JJin91 [7c Ks]
ks1112: folds=20
toodope4you: raises 600 to 1200
JJin91: folds=20
xJaehaerysx: folds=20
mrbobsnj: folds=20
hainesiv2: folds=20
SneakyPete85: folds=20
JerseyGuy316: folds=20
Uncalled bet (600) returned to toodope4you
toodope4you collected 2060 from pot
toodope4you: doesn't show hand=20
*** SUMMARY ***
Total pot 2060 | Rake 0=20
Seat 1: mrbobsnj folded before Flop (didn't bet)
Seat 2: hainesiv2 (button) folded before Flop (didn't bet)
Seat 3: SneakyPete85 (small blind) folded before Flop
Seat 4: JerseyGuy316 (big blind) folded before Flop
Seat 5: ks1112 folded before Flop (didn't bet)
Seat 7: toodope4you collected (2060)
Seat 8: JJin91 folded before Flop (didn't bet)
Seat 9: xJaehaerysx folded before Flop (didn't bet)


*********** # 67 **************
PokerStars Hand #170374813905: Tournament #1622573280, $9.10+$0.90 USD =
Hold'em No Limit - Level XII (300/600) - 2017/05/25 20:07:18 ET
Table '1622573280 1' 9-max Seat #3 is the button
Seat 1: mrbobsnj (11860 in chips)=20
Seat 2: hainesiv2 (24282 in chips)=20
Seat 3: SneakyPete85 (6170 in chips)=20
Seat 4: JerseyGuy316 (25040 in chips)=20
Seat 5: ks1112 (9610 in chips)=20
Seat 7: toodope4you (8990 in chips)=20
Seat 8: JJin91 (38468 in chips)=20
Seat 9: xJaehaerysx (14447 in chips)=20
mrbobsnj: posts the ante 70
hainesiv2: posts the ante 70
SneakyPete85: posts the ante 70
JerseyGuy316: posts the ante 70
ks1112: posts the ante 70
toodope4you: posts the ante 70
JJin91: posts the ante 70
xJaehaerysx: posts the ante 70
JerseyGuy316: posts small blind 300
ks1112: posts big blind 600
*** HOLE CARDS ***
Dealt to JJin91 [6d 3d]
toodope4you: folds=20
JJin91: folds=20
xJaehaerysx: raises 600 to 1200
mrbobsnj: calls 1200
hainesiv2: folds=20
SneakyPete85: folds=20
JerseyGuy316: folds=20
ks1112: folds=20
*** FLOP *** [8d Jc 8h]
xJaehaerysx: bets 1930
mrbobsnj: calls 1930
*** TURN *** [8d Jc 8h] [7c]
xJaehaerysx: checks=20
mrbobsnj: bets 1200
xJaehaerysx: folds=20
Uncalled bet (1200) returned to mrbobsnj
mrbobsnj collected 7720 from pot
mrbobsnj: doesn't show hand=20
*** SUMMARY ***
Total pot 7720 | Rake 0=20
Board [8d Jc 8h 7c]
Seat 1: mrbobsnj collected (7720)
Seat 2: hainesiv2 folded before Flop (didn't bet)
Seat 3: SneakyPete85 (button) folded before Flop (didn't bet)
Seat 4: JerseyGuy316 (small blind) folded before Flop
Seat 5: ks1112 (big blind) folded before Flop
Seat 7: toodope4you folded before Flop (didn't bet)
Seat 8: JJin91 folded before Flop (didn't bet)
Seat 9: xJaehaerysx folded on the Turn


*********** # 68 **************
PokerStars Hand #170374814279: Tournament #1622573280, $9.10+$0.90 USD =
Hold'em No Limit - Level XII (300/600) - 2017/05/25 20:08:43 ET
Table '1622573280 1' 9-max Seat #4 is the button
Seat 1: mrbobsnj (16380 in chips)=20
Seat 2: hainesiv2 (24212 in chips)=20
Seat 3: SneakyPete85 (6100 in chips)=20
Seat 4: JerseyGuy316 (24670 in chips)=20
Seat 5: ks1112 (8940 in chips)=20
Seat 7: toodope4you (8920 in chips)=20
Seat 8: JJin91 (38398 in chips)=20
Seat 9: xJaehaerysx (11247 in chips)=20
mrbobsnj: posts the ante 70
hainesiv2: posts the ante 70
SneakyPete85: posts the ante 70
JerseyGuy316: posts the ante 70
ks1112: posts the ante 70
toodope4you: posts the ante 70
JJin91: posts the ante 70
xJaehaerysx: posts the ante 70
ks1112: posts small blind 300
toodope4you: posts big blind 600
*** HOLE CARDS ***
Dealt to JJin91 [Kd Qs]
JJin91: folds=20
xJaehaerysx: folds=20
mrbobsnj: folds=20
hainesiv2: folds=20
SneakyPete85: folds=20
JerseyGuy316: calls 600
ks1112: calls 300
toodope4you: checks=20
*** FLOP *** [Qd Td Kh]
ks1112: checks=20
toodope4you: bets 1770
JerseyGuy316: folds=20
ks1112: folds=20
Uncalled bet (1770) returned to toodope4you
toodope4you collected 2360 from pot
toodope4you: doesn't show hand=20
*** SUMMARY ***
Total pot 2360 | Rake 0=20
Board [Qd Td Kh]
Seat 1: mrbobsnj folded before Flop (didn't bet)
Seat 2: hainesiv2 folded before Flop (didn't bet)
Seat 3: SneakyPete85 folded before Flop (didn't bet)
Seat 4: JerseyGuy316 (button) folded on the Flop
Seat 5: ks1112 (small blind) folded on the Flop
Seat 7: toodope4you (big blind) collected (2360)
Seat 8: JJin91 folded before Flop (didn't bet)
Seat 9: xJaehaerysx folded before Flop (didn't bet)


*********** # 69 **************
PokerStars Hand #170374814462: Tournament #1622573280, $9.10+$0.90 USD =
Hold'em No Limit - Level XII (300/600) - 2017/05/25 20:09:29 ET
Table '1622573280 1' 9-max Seat #5 is the button
Seat 1: mrbobsnj (16310 in chips)=20
Seat 2: hainesiv2 (24142 in chips)=20
Seat 3: SneakyPete85 (6030 in chips)=20
Seat 4: JerseyGuy316 (24000 in chips)=20
Seat 5: ks1112 (8270 in chips)=20
Seat 7: toodope4you (10610 in chips)=20
Seat 8: JJin91 (38328 in chips)=20
Seat 9: xJaehaerysx (11177 in chips)=20
mrbobsnj: posts the ante 70
hainesiv2: posts the ante 70
SneakyPete85: posts the ante 70
JerseyGuy316: posts the ante 70
ks1112: posts the ante 70
toodope4you: posts the ante 70
JJin91: posts the ante 70
xJaehaerysx: posts the ante 70
toodope4you: posts small blind 300
JJin91: posts big blind 600
*** HOLE CARDS ***
Dealt to JJin91 [4s Kd]
xJaehaerysx: folds=20
mrbobsnj: folds=20
hainesiv2: folds=20
SneakyPete85: folds=20
JerseyGuy316: calls 600
ks1112: calls 600
toodope4you: folds=20
JJin91: checks=20
*** FLOP *** [Th Jh 4d]
JJin91: checks=20
JerseyGuy316: checks=20
ks1112: bets 2660
JJin91: folds=20
JerseyGuy316: folds=20
Uncalled bet (2660) returned to ks1112
ks1112 collected 2660 from pot
*** SUMMARY ***
Total pot 2660 | Rake 0=20
Board [Th Jh 4d]
Seat 1: mrbobsnj folded before Flop (didn't bet)
Seat 2: hainesiv2 folded before Flop (didn't bet)
Seat 3: SneakyPete85 folded before Flop (didn't bet)
Seat 4: JerseyGuy316 folded on the Flop
Seat 5: ks1112 (button) collected (2660)
Seat 7: toodope4you (small blind) folded before Flop
Seat 8: JJin91 (big blind) folded on the Flop
Seat 9: xJaehaerysx folded before Flop (didn't bet)


*********** # 70 **************
PokerStars Hand #170374814639: Tournament #1622573280, $9.10+$0.90 USD =
Hold'em No Limit - Level XII (300/600) - 2017/05/25 20:10:15 ET
Table '1622573280 1' 9-max Seat #7 is the button
Seat 1: mrbobsnj (16240 in chips)=20
Seat 2: hainesiv2 (24072 in chips)=20
Seat 3: SneakyPete85 (5960 in chips)=20
Seat 4: JerseyGuy316 (23330 in chips)=20
Seat 5: ks1112 (10260 in chips)=20
Seat 7: toodope4you (10240 in chips)=20
Seat 8: JJin91 (37658 in chips)=20
Seat 9: xJaehaerysx (11107 in chips)=20
mrbobsnj: posts the ante 70
hainesiv2: posts the ante 70
SneakyPete85: posts the ante 70
JerseyGuy316: posts the ante 70
ks1112: posts the ante 70
toodope4you: posts the ante 70
JJin91: posts the ante 70
xJaehaerysx: posts the ante 70
JJin91: posts small blind 300
xJaehaerysx: posts big blind 600
*** HOLE CARDS ***
Dealt to JJin91 [Qc 5h]
mrbobsnj: raises 600 to 1200
hainesiv2: folds=20
SneakyPete85: folds=20
JerseyGuy316: folds=20
ks1112: folds=20
toodope4you: folds=20
JJin91: folds=20
xJaehaerysx: calls 600
*** FLOP *** [Qh Qd 8h]
xJaehaerysx: bets 2445
mrbobsnj: folds=20
Uncalled bet (2445) returned to xJaehaerysx
xJaehaerysx collected 3260 from pot
xJaehaerysx: doesn't show hand=20
*** SUMMARY ***
Total pot 3260 | Rake 0=20
Board [Qh Qd 8h]
Seat 1: mrbobsnj folded on the Flop
Seat 2: hainesiv2 folded before Flop (didn't bet)
Seat 3: SneakyPete85 folded before Flop (didn't bet)
Seat 4: JerseyGuy316 folded before Flop (didn't bet)
Seat 5: ks1112 folded before Flop (didn't bet)
Seat 7: toodope4you (button) folded before Flop (didn't bet)
Seat 8: JJin91 (small blind) folded before Flop
Seat 9: xJaehaerysx (big blind) collected (3260)


*********** # 71 **************
PokerStars Hand #170374814800: Tournament #1622573280, $9.10+$0.90 USD =
Hold'em No Limit - Level XII (300/600) - 2017/05/25 20:10:58 ET
Table '1622573280 1' 9-max Seat #8 is the button
Seat 1: mrbobsnj (14970 in chips)=20
Seat 2: hainesiv2 (24002 in chips)=20
Seat 3: SneakyPete85 (5890 in chips)=20
Seat 4: JerseyGuy316 (23260 in chips)=20
Seat 5: ks1112 (10190 in chips)=20
Seat 7: toodope4you (10170 in chips)=20
Seat 8: JJin91 (37288 in chips)=20
Seat 9: xJaehaerysx (13097 in chips)=20
mrbobsnj: posts the ante 70
hainesiv2: posts the ante 70
SneakyPete85: posts the ante 70
JerseyGuy316: posts the ante 70
ks1112: posts the ante 70
toodope4you: posts the ante 70
JJin91: posts the ante 70
xJaehaerysx: posts the ante 70
xJaehaerysx: posts small blind 300
mrbobsnj: posts big blind 600
*** HOLE CARDS ***
Dealt to JJin91 [Jc 5d]
hainesiv2: raises 1200 to 1800
SneakyPete85: folds=20
JerseyGuy316: folds=20
ks1112: folds=20
toodope4you: folds=20
JJin91: folds=20
xJaehaerysx: folds=20
mrbobsnj: folds=20
Uncalled bet (1200) returned to hainesiv2
hainesiv2 collected 2060 from pot
hainesiv2: doesn't show hand=20
*** SUMMARY ***
Total pot 2060 | Rake 0=20
Seat 1: mrbobsnj (big blind) folded before Flop
Seat 2: hainesiv2 collected (2060)
Seat 3: SneakyPete85 folded before Flop (didn't bet)
Seat 4: JerseyGuy316 folded before Flop (didn't bet)
Seat 5: ks1112 folded before Flop (didn't bet)
Seat 7: toodope4you folded before Flop (didn't bet)
Seat 8: JJin91 (button) folded before Flop (didn't bet)
Seat 9: xJaehaerysx (small blind) folded before Flop


*********** # 72 **************
PokerStars Hand #170374814925: Tournament #1622573280, $9.10+$0.90 USD =
Hold'em No Limit - Level XII (300/600) - 2017/05/25 20:11:29 ET
Table '1622573280 1' 9-max Seat #9 is the button
Seat 1: mrbobsnj (14300 in chips)=20
Seat 2: hainesiv2 (25392 in chips)=20
Seat 3: SneakyPete85 (5820 in chips)=20
Seat 4: JerseyGuy316 (23190 in chips)=20
Seat 5: ks1112 (10120 in chips)=20
Seat 7: toodope4you (10100 in chips)=20
Seat 8: JJin91 (37218 in chips)=20
Seat 9: xJaehaerysx (12727 in chips)=20
mrbobsnj: posts the ante 70
hainesiv2: posts the ante 70
SneakyPete85: posts the ante 70
JerseyGuy316: posts the ante 70
ks1112: posts the ante 70
toodope4you: posts the ante 70
JJin91: posts the ante 70
xJaehaerysx: posts the ante 70
mrbobsnj: posts small blind 300
hainesiv2: posts big blind 600
*** HOLE CARDS ***
Dealt to JJin91 [6s 9s]
SneakyPete85: raises 5150 to 5750 and is all-in
JerseyGuy316: folds=20
ks1112: folds=20
toodope4you: folds=20
JJin91: folds=20
xJaehaerysx: folds=20
mrbobsnj: folds=20
hainesiv2: folds=20
Uncalled bet (5150) returned to SneakyPete85
SneakyPete85 collected 2060 from pot
SneakyPete85: doesn't show hand=20
*** SUMMARY ***
Total pot 2060 | Rake 0=20
Seat 1: mrbobsnj (small blind) folded before Flop
Seat 2: hainesiv2 (big blind) folded before Flop
Seat 3: SneakyPete85 collected (2060)
Seat 4: JerseyGuy316 folded before Flop (didn't bet)
Seat 5: ks1112 folded before Flop (didn't bet)
Seat 7: toodope4you folded before Flop (didn't bet)
Seat 8: JJin91 folded before Flop (didn't bet)
Seat 9: xJaehaerysx (button) folded before Flop (didn't bet)


*********** # 73 **************
PokerStars Hand #170374815050: Tournament #1622573280, $9.10+$0.90 USD =
Hold'em No Limit - Level XII (300/600) - 2017/05/25 20:12:03 ET
Table '1622573280 1' 9-max Seat #1 is the button
Seat 1: mrbobsnj (13930 in chips)=20
Seat 2: hainesiv2 (24722 in chips)=20
Seat 3: SneakyPete85 (7210 in chips)=20
Seat 4: JerseyGuy316 (23120 in chips)=20
Seat 5: ks1112 (10050 in chips)=20
Seat 7: toodope4you (10030 in chips)=20
Seat 8: JJin91 (37148 in chips)=20
Seat 9: xJaehaerysx (12657 in chips)=20
mrbobsnj: posts the ante 70
hainesiv2: posts the ante 70
SneakyPete85: posts the ante 70
JerseyGuy316: posts the ante 70
ks1112: posts the ante 70
toodope4you: posts the ante 70
JJin91: posts the ante 70
xJaehaerysx: posts the ante 70
hainesiv2: posts small blind 300
SneakyPete85: posts big blind 600
*** HOLE CARDS ***
Dealt to JJin91 [Td 3d]
JerseyGuy316: folds=20
ks1112: folds=20
toodope4you: folds=20
JJin91: folds=20
xJaehaerysx: raises 720 to 1320
mrbobsnj: calls 1320
hainesiv2: folds=20
SneakyPete85: folds=20
*** FLOP *** [8d Ad Jh]
xJaehaerysx: bets 2050
mrbobsnj: calls 2050
*** TURN *** [8d Ad Jh] [Kh]
xJaehaerysx: bets 4100
mrbobsnj said, "bad kicker"
mrbobsnj: folds [3c]
Uncalled bet (4100) returned to xJaehaerysx
xJaehaerysx collected 8200 from pot
xJaehaerysx: doesn't show hand=20
*** SUMMARY ***
Total pot 8200 | Rake 0=20
Board [8d Ad Jh Kh]
Seat 1: mrbobsnj (button) folded on the Turn
Seat 2: hainesiv2 (small blind) folded before Flop
Seat 3: SneakyPete85 (big blind) folded before Flop
Seat 4: JerseyGuy316 folded before Flop (didn't bet)
Seat 5: ks1112 folded before Flop (didn't bet)
Seat 7: toodope4you folded before Flop (didn't bet)
Seat 8: JJin91 folded before Flop (didn't bet)
Seat 9: xJaehaerysx collected (8200)


*********** # 74 **************
PokerStars Hand #170374815362: Tournament #1622573280, $9.10+$0.90 USD =
Hold'em No Limit - Level XII (300/600) - 2017/05/25 20:13:29 ET
Table '1622573280 1' 9-max Seat #2 is the button
Seat 1: mrbobsnj (10490 in chips)=20
Seat 2: hainesiv2 (24352 in chips)=20
Seat 3: SneakyPete85 (6540 in chips)=20
Seat 4: JerseyGuy316 (23050 in chips)=20
Seat 5: ks1112 (9980 in chips)=20
Seat 6: nwmdnj (11480 in chips)=20
Seat 7: toodope4you (9960 in chips)=20
Seat 8: JJin91 (37078 in chips)=20
Seat 9: xJaehaerysx (17417 in chips)=20
mrbobsnj: posts the ante 70
hainesiv2: posts the ante 70
SneakyPete85: posts the ante 70
JerseyGuy316: posts the ante 70
ks1112: posts the ante 70
nwmdnj: posts the ante 70
toodope4you: posts the ante 70
JJin91: posts the ante 70
xJaehaerysx: posts the ante 70
SneakyPete85: posts small blind 300
JerseyGuy316: posts big blind 600
*** HOLE CARDS ***
Dealt to JJin91 [Ad Qd]
ks1112: folds=20
nwmdnj: folds=20
toodope4you: folds=20
JJin91: raises 714 to 1314
xJaehaerysx: folds=20
mrbobsnj: calls 1314
hainesiv2: folds=20
SneakyPete85: raises 5156 to 6470 and is all-in
JerseyGuy316: folds=20
JJin91: raises 30538 to 37008 and is all-in
mrbobsnj: folds=20
Uncalled bet (30538) returned to JJin91
*** FLOP *** [Js 5s Jc]
*** TURN *** [Js 5s Jc] [Qs]
*** RIVER *** [Js 5s Jc Qs] [9h]
*** SHOW DOWN ***
SneakyPete85: shows [Jd Qc] (a full house, Jacks full of Queens)
JJin91: shows [Ad Qd] (two pair, Queens and Jacks)
SneakyPete85 collected 15484 from pot
*** SUMMARY ***
Total pot 15484 | Rake 0=20
Board [Js 5s Jc Qs 9h]
Seat 1: mrbobsnj folded before Flop
Seat 2: hainesiv2 (button) folded before Flop (didn't bet)
Seat 3: SneakyPete85 (small blind) showed [Jd Qc] and won (15484) with =
a full house, Jacks full of Queens
Seat 4: JerseyGuy316 (big blind) folded before Flop
Seat 5: ks1112 folded before Flop (didn't bet)
Seat 6: nwmdnj folded before Flop (didn't bet)
Seat 7: toodope4you folded before Flop (didn't bet)
Seat 8: JJin91 showed [Ad Qd] and lost with two pair, Queens and Jacks
Seat 9: xJaehaerysx folded before Flop (didn't bet)


*********** # 75 **************
PokerStars Hand #170374815654: Tournament #1622573280, $9.10+$0.90 USD =
Hold'em No Limit - Level XIII (350/700) - 2017/05/25 20:14:45 ET
Table '1622573280 1' 9-max Seat #3 is the button
Seat 1: mrbobsnj (9106 in chips)=20
Seat 2: hainesiv2 (24282 in chips)=20
Seat 3: SneakyPete85 (15484 in chips)=20
Seat 4: JerseyGuy316 (22380 in chips)=20
Seat 5: ks1112 (9910 in chips)=20
Seat 6: nwmdnj (11410 in chips)=20
Seat 7: toodope4you (9890 in chips)=20
Seat 8: JJin91 (30538 in chips)=20
Seat 9: xJaehaerysx (17347 in chips)=20
mrbobsnj: posts the ante 85
hainesiv2: posts the ante 85
SneakyPete85: posts the ante 85
JerseyGuy316: posts the ante 85
ks1112: posts the ante 85
nwmdnj: posts the ante 85
toodope4you: posts the ante 85
JJin91: posts the ante 85
xJaehaerysx: posts the ante 85
JerseyGuy316: posts small blind 350
ks1112: posts big blind 700
*** HOLE CARDS ***
Dealt to JJin91 [Ts Tc]
nwmdnj: folds=20
toodope4you: folds=20
JJin91: raises 833 to 1533
xJaehaerysx: folds=20
mrbobsnj: folds=20
hainesiv2: folds=20
SneakyPete85: folds=20
JerseyGuy316: folds=20
ks1112: folds=20
Uncalled bet (833) returned to JJin91
JJin91 collected 2515 from pot
JJin91: doesn't show hand=20
*** SUMMARY ***
Total pot 2515 | Rake 0=20
Seat 1: mrbobsnj folded before Flop (didn't bet)
Seat 2: hainesiv2 folded before Flop (didn't bet)
Seat 3: SneakyPete85 (button) folded before Flop (didn't bet)
Seat 4: JerseyGuy316 (small blind) folded before Flop
Seat 5: ks1112 (big blind) folded before Flop
Seat 6: nwmdnj folded before Flop (didn't bet)
Seat 7: toodope4you folded before Flop (didn't bet)
Seat 8: JJin91 collected (2515)
Seat 9: xJaehaerysx folded before Flop (didn't bet)


*********** # 76 **************
PokerStars Hand #170374815885: Tournament #1622573280, $9.10+$0.90 USD =
Hold'em No Limit - Level XIII (350/700) - 2017/05/25 20:15:42 ET
Table '1622573280 1' 9-max Seat #4 is the button
Seat 1: mrbobsnj (9021 in chips)=20
Seat 2: hainesiv2 (24197 in chips)=20
Seat 3: SneakyPete85 (15399 in chips)=20
Seat 4: JerseyGuy316 (21945 in chips)=20
Seat 5: ks1112 (9125 in chips)=20
Seat 6: nwmdnj (11325 in chips)=20
Seat 7: toodope4you (9805 in chips)=20
Seat 8: JJin91 (32268 in chips)=20
Seat 9: xJaehaerysx (17262 in chips)=20
mrbobsnj: posts the ante 85
hainesiv2: posts the ante 85
SneakyPete85: posts the ante 85
JerseyGuy316: posts the ante 85
ks1112: posts the ante 85
nwmdnj: posts the ante 85
toodope4you: posts the ante 85
JJin91: posts the ante 85
xJaehaerysx: posts the ante 85
ks1112: posts small blind 350
nwmdnj: posts big blind 700
*** HOLE CARDS ***
Dealt to JJin91 [9h Qh]
toodope4you: raises 1540 to 2240
JJin91: folds=20
xJaehaerysx: folds=20
mrbobsnj: folds=20
hainesiv2: folds=20
SneakyPete85: folds=20
JerseyGuy316: calls 2240
ks1112: folds=20
nwmdnj: folds=20
*** FLOP *** [Js Jc 4c]
toodope4you: bets 7480 and is all-in
JerseyGuy316: calls 7480
*** TURN *** [Js Jc 4c] [Ac]
*** RIVER *** [Js Jc 4c Ac] [6d]
*** SHOW DOWN ***
toodope4you: shows [8h 8c] (two pair, Jacks and Eights)
JerseyGuy316: shows [Kd Jd] (three of a kind, Jacks)
JerseyGuy316 collected 21255 from pot
toodope4you finished the tournament in 79th place
*** SUMMARY ***
Total pot 21255 | Rake 0=20
Board [Js Jc 4c Ac 6d]
Seat 1: mrbobsnj folded before Flop (didn't bet)
Seat 2: hainesiv2 folded before Flop (didn't bet)
Seat 3: SneakyPete85 folded before Flop (didn't bet)
Seat 4: JerseyGuy316 (button) showed [Kd Jd] and won (21255) with three=
 of a kind, Jacks
Seat 5: ks1112 (small blind) folded before Flop
Seat 6: nwmdnj (big blind) folded before Flop
Seat 7: toodope4you showed [8h 8c] and lost with two pair, Jacks and Ei=
ghts
Seat 8: JJin91 folded before Flop (didn't bet)
Seat 9: xJaehaerysx folded before Flop (didn't bet)


*********** # 77 **************
PokerStars Hand #170374816151: Tournament #1622573280, $9.10+$0.90 USD =
Hold'em No Limit - Level XIII (350/700) - 2017/05/25 20:16:48 ET
Table '1622573280 1' 9-max Seat #5 is the button
Seat 1: mrbobsnj (8936 in chips)=20
Seat 2: hainesiv2 (24112 in chips)=20
Seat 3: SneakyPete85 (15314 in chips)=20
Seat 4: JerseyGuy316 (33395 in chips)=20
Seat 5: ks1112 (8690 in chips)=20
Seat 6: nwmdnj (10540 in chips)=20
Seat 8: JJin91 (32183 in chips)=20
Seat 9: xJaehaerysx (17177 in chips)=20
mrbobsnj: posts the ante 85
hainesiv2: posts the ante 85
SneakyPete85: posts the ante 85
JerseyGuy316: posts the ante 85
ks1112: posts the ante 85
nwmdnj: posts the ante 85
JJin91: posts the ante 85
xJaehaerysx: posts the ante 85
nwmdnj: posts small blind 350
JJin91: posts big blind 700
*** HOLE CARDS ***
Dealt to JJin91 [7h Kd]
xJaehaerysx: folds=20
mrbobsnj: folds=20
hainesiv2: folds=20
SneakyPete85: folds=20
JerseyGuy316: folds=20
ks1112: folds=20
nwmdnj: folds=20
Uncalled bet (350) returned to JJin91
JJin91 collected 1380 from pot
JJin91: doesn't show hand=20
*** SUMMARY ***
Total pot 1380 | Rake 0=20
Seat 1: mrbobsnj folded before Flop (didn't bet)
Seat 2: hainesiv2 folded before Flop (didn't bet)
Seat 3: SneakyPete85 folded before Flop (didn't bet)
Seat 4: JerseyGuy316 folded before Flop (didn't bet)
Seat 5: ks1112 (button) folded before Flop (didn't bet)
Seat 6: nwmdnj (small blind) folded before Flop
Seat 8: JJin91 (big blind) collected (1380)
Seat 9: xJaehaerysx folded before Flop (didn't bet)


*********** # 78 **************
PokerStars Hand #170374816271: Tournament #1622573280, $9.10+$0.90 USD =
Hold'em No Limit - Level XIII (350/700) - 2017/05/25 20:17:16 ET
Table '1622573280 1' 9-max Seat #6 is the button
Seat 1: mrbobsnj (8851 in chips)=20
Seat 2: hainesiv2 (24027 in chips)=20
Seat 3: SneakyPete85 (15229 in chips)=20
Seat 4: JerseyGuy316 (33310 in chips)=20
Seat 5: ks1112 (8605 in chips)=20
Seat 6: nwmdnj (10105 in chips)=20
Seat 8: JJin91 (33128 in chips)=20
Seat 9: xJaehaerysx (17092 in chips)=20
mrbobsnj: posts the ante 85
hainesiv2: posts the ante 85
SneakyPete85: posts the ante 85
JerseyGuy316: posts the ante 85
ks1112: posts the ante 85
nwmdnj: posts the ante 85
JJin91: posts the ante 85
xJaehaerysx: posts the ante 85
JJin91: posts small blind 350
xJaehaerysx: posts big blind 700
*** HOLE CARDS ***
Dealt to JJin91 [7s 8s]
mrbobsnj: folds=20
hainesiv2: folds=20
SneakyPete85: folds=20
JerseyGuy316: calls 700
ks1112: folds=20
nwmdnj: raises 9320 to 10020 and is all-in
JJin91: folds=20
xJaehaerysx: folds=20
JerseyGuy316: folds=20
Uncalled bet (9320) returned to nwmdnj
nwmdnj collected 3130 from pot
nwmdnj: doesn't show hand=20
*** SUMMARY ***
Total pot 3130 | Rake 0=20
Seat 1: mrbobsnj folded before Flop (didn't bet)
Seat 2: hainesiv2 folded before Flop (didn't bet)
Seat 3: SneakyPete85 folded before Flop (didn't bet)
Seat 4: JerseyGuy316 folded before Flop
Seat 5: ks1112 folded before Flop (didn't bet)
Seat 6: nwmdnj (button) collected (3130)
Seat 8: JJin91 (small blind) folded before Flop
Seat 9: xJaehaerysx (big blind) folded before Flop


*********** # 79 **************
PokerStars Hand #170374816527: Tournament #1622573280, $9.10+$0.90 USD =
Hold'em No Limit - Level XIII (350/700) - 2017/05/25 20:18:12 ET
Table '1622573280 1' 9-max Seat #8 is the button
Seat 1: mrbobsnj (8766 in chips)=20
Seat 2: hainesiv2 (23942 in chips)=20
Seat 3: SneakyPete85 (15144 in chips)=20
Seat 4: JerseyGuy316 (32525 in chips)=20
Seat 5: ks1112 (8520 in chips)=20
Seat 6: nwmdnj (12450 in chips)=20
Seat 8: JJin91 (32693 in chips)=20
Seat 9: xJaehaerysx (16307 in chips)=20
mrbobsnj: posts the ante 85
hainesiv2: posts the ante 85
SneakyPete85: posts the ante 85
JerseyGuy316: posts the ante 85
ks1112: posts the ante 85
nwmdnj: posts the ante 85
JJin91: posts the ante 85
xJaehaerysx: posts the ante 85
xJaehaerysx: posts small blind 350
mrbobsnj: posts big blind 700
*** HOLE CARDS ***
Dealt to JJin91 [Js Jh]
hainesiv2: folds=20
SneakyPete85: folds=20
JerseyGuy316 said, "welcome to the lottery portion of our show lol"
JerseyGuy316: folds=20
ks1112: folds=20
nwmdnj: folds=20
JJin91: raises 31908 to 32608 and is all-in
xJaehaerysx: calls 15872 and is all-in
mrbobsnj: calls 7981 and is all-in
Uncalled bet (16386) returned to JJin91
*** FLOP *** [Ts 7h 5h]
*** TURN *** [Ts 7h 5h] [9h]
*** RIVER *** [Ts 7h 5h 9h] [8d]
*** SHOW DOWN ***
xJaehaerysx: shows [Kd Ks] (a pair of Kings)
JJin91: shows [Js Jh] (a straight, Seven to Jack)
JJin91 collected 15082 from side pot
mrbobsnj: shows [As 6s] (a straight, Six to Ten)
JJin91 collected 26723 from main pot
xJaehaerysx finished the tournament in 71st place
mrbobsnj finished the tournament in 72nd place
*** SUMMARY ***
Total pot 41805 Main pot 26723. Side pot 15082. | Rake 0=20
Board [Ts 7h 5h 9h 8d]
Seat 1: mrbobsnj (big blind) showed [As 6s] and lost with a straight, S=
ix to Ten
Seat 2: hainesiv2 folded before Flop (didn't bet)
Seat 3: SneakyPete85 folded before Flop (didn't bet)
Seat 4: JerseyGuy316 folded before Flop (didn't bet)
Seat 5: ks1112 folded before Flop (didn't bet)
Seat 6: nwmdnj folded before Flop (didn't bet)
Seat 8: JJin91 (button) showed [Js Jh] and won (41805) with a straight,=
 Seven to Jack
Seat 9: xJaehaerysx (small blind) showed [Kd Ks] and lost with a pair o=
f Kings


*********** # 80 **************
PokerStars Hand #170374816735: Tournament #1622573280, $9.10+$0.90 USD =
Hold'em No Limit - Level XIII (350/700) - 2017/05/25 20:18:52 ET
Table '1622573280 1' 9-max Seat #2 is the button
Seat 2: hainesiv2 (23857 in chips)=20
Seat 3: SneakyPete85 (15059 in chips)=20
Seat 4: JerseyGuy316 (32440 in chips)=20
Seat 5: ks1112 (8435 in chips)=20
Seat 6: nwmdnj (12365 in chips)=20
Seat 7: TheNewMonkey (20395 in chips)=20
Seat 8: JJin91 (58191 in chips)=20
hainesiv2: posts the ante 85
SneakyPete85: posts the ante 85
JerseyGuy316: posts the ante 85
ks1112: posts the ante 85
nwmdnj: posts the ante 85
TheNewMonkey: posts the ante 85
JJin91: posts the ante 85
SneakyPete85: posts small blind 350
JerseyGuy316: posts big blind 700
*** HOLE CARDS ***
Dealt to JJin91 [Kc 5c]
ks1112: folds=20
nwmdnj: folds=20
TheNewMonkey: folds=20
JJin91: folds=20
hainesiv2: folds=20
SneakyPete85: folds=20
Uncalled bet (350) returned to JerseyGuy316
JerseyGuy316 collected 1295 from pot
*** SUMMARY ***
Total pot 1295 | Rake 0=20
Seat 2: hainesiv2 (button) folded before Flop (didn't bet)
Seat 3: SneakyPete85 (small blind) folded before Flop
Seat 4: JerseyGuy316 (big blind) collected (1295)
Seat 5: ks1112 folded before Flop (didn't bet)
Seat 6: nwmdnj folded before Flop (didn't bet)
Seat 7: TheNewMonkey folded before Flop (didn't bet)
Seat 8: JJin91 folded before Flop (didn't bet)


*********** # 81 **************
PokerStars Hand #170374816932: Tournament #1622573280, $9.10+$0.90 USD =
Hold'em No Limit - Level XIII (350/700) - 2017/05/25 20:19:33 ET
Table '1622573280 1' 9-max Seat #3 is the button
Seat 1: robertg68 (15989 in chips)=20
Seat 2: hainesiv2 (23772 in chips)=20
Seat 3: SneakyPete85 (14624 in chips)=20
Seat 4: JerseyGuy316 (33300 in chips)=20
Seat 5: ks1112 (8350 in chips)=20
Seat 6: nwmdnj (12280 in chips)=20
Seat 7: TheNewMonkey (20310 in chips)=20
Seat 8: JJin91 (58106 in chips)=20
robertg68: posts the ante 85
hainesiv2: posts the ante 85
SneakyPete85: posts the ante 85
JerseyGuy316: posts the ante 85
ks1112: posts the ante 85
nwmdnj: posts the ante 85
TheNewMonkey: posts the ante 85
JJin91: posts the ante 85
JerseyGuy316: posts small blind 350
ks1112: posts big blind 700
*** HOLE CARDS ***
Dealt to JJin91 [Th 8c]
nwmdnj: folds=20
TheNewMonkey: folds=20
JJin91: folds=20
robertg68: folds=20
hainesiv2: folds=20
SneakyPete85: raises 700 to 1400
JerseyGuy316: folds=20
ks1112: calls 700
*** FLOP *** [Qd 9c 2d]
ks1112: checks=20
SneakyPete85: bets 1915
ks1112: folds=20
Uncalled bet (1915) returned to SneakyPete85
SneakyPete85 collected 3830 from pot
SneakyPete85: doesn't show hand=20
*** SUMMARY ***
Total pot 3830 | Rake 0=20
Board [Qd 9c 2d]
Seat 1: robertg68 folded before Flop (didn't bet)
Seat 2: hainesiv2 folded before Flop (didn't bet)
Seat 3: SneakyPete85 (button) collected (3830)
Seat 4: JerseyGuy316 (small blind) folded before Flop
Seat 5: ks1112 (big blind) folded on the Flop
Seat 6: nwmdnj folded before Flop (didn't bet)
Seat 7: TheNewMonkey folded before Flop (didn't bet)
Seat 8: JJin91 folded before Flop (didn't bet)


*********** # 82 **************
PokerStars Hand #170374817223: Tournament #1622573280, $9.10+$0.90 USD =
Hold'em No Limit - Level XIII (350/700) - 2017/05/25 20:20:37 ET
Table '1622573280 1' 9-max Seat #4 is the button
Seat 1: robertg68 (15904 in chips)=20
Seat 2: hainesiv2 (23687 in chips)=20
Seat 3: SneakyPete85 (16969 in chips)=20
Seat 4: JerseyGuy316 (32865 in chips)=20
Seat 5: ks1112 (6865 in chips)=20
Seat 6: nwmdnj (12195 in chips)=20
Seat 7: TheNewMonkey (20225 in chips)=20
Seat 8: JJin91 (58021 in chips)=20
robertg68: posts the ante 85
hainesiv2: posts the ante 85
SneakyPete85: posts the ante 85
JerseyGuy316: posts the ante 85
ks1112: posts the ante 85
nwmdnj: posts the ante 85
TheNewMonkey: posts the ante 85
JJin91: posts the ante 85
ks1112: posts small blind 350
nwmdnj: posts big blind 700
*** HOLE CARDS ***
Dealt to JJin91 [2h 9c]
TheNewMonkey: raises 700 to 1400
JJin91: folds=20
robertg68: folds=20
hainesiv2: folds=20
SneakyPete85: folds=20
JerseyGuy316: folds=20
ks1112: folds=20
nwmdnj: folds=20
Uncalled bet (700) returned to TheNewMonkey
TheNewMonkey collected 2430 from pot
TheNewMonkey: doesn't show hand=20
*** SUMMARY ***
Total pot 2430 | Rake 0=20
Seat 1: robertg68 folded before Flop (didn't bet)
Seat 2: hainesiv2 folded before Flop (didn't bet)
Seat 3: SneakyPete85 folded before Flop (didn't bet)
Seat 4: JerseyGuy316 (button) folded before Flop (didn't bet)
Seat 5: ks1112 (small blind) folded before Flop
Seat 6: nwmdnj (big blind) folded before Flop
Seat 7: TheNewMonkey collected (2430)
Seat 8: JJin91 folded before Flop (didn't bet)


*********** # 83 **************
PokerStars Hand #170374817447: Tournament #1622573280, $9.10+$0.90 USD =
Hold'em No Limit - Level XIII (350/700) - 2017/05/25 20:21:25 ET
Table '1622573280 1' 9-max Seat #5 is the button
Seat 1: robertg68 (15819 in chips)=20
Seat 2: hainesiv2 (23602 in chips)=20
Seat 3: SneakyPete85 (16884 in chips)=20
Seat 4: JerseyGuy316 (32780 in chips)=20
Seat 5: ks1112 (6430 in chips)=20
Seat 6: nwmdnj (11410 in chips)=20
Seat 7: TheNewMonkey (21870 in chips)=20
Seat 8: JJin91 (57936 in chips)=20
robertg68: posts the ante 85
hainesiv2: posts the ante 85
SneakyPete85: posts the ante 85
JerseyGuy316: posts the ante 85
ks1112: posts the ante 85
nwmdnj: posts the ante 85
TheNewMonkey: posts the ante 85
JJin91: posts the ante 85
nwmdnj: posts small blind 350
TheNewMonkey: posts big blind 700
*** HOLE CARDS ***
Dealt to JJin91 [6c Tc]
JJin91: folds=20
robertg68: folds=20
hainesiv2: folds=20
SneakyPete85: folds=20
JerseyGuy316: folds=20
ks1112: folds=20
nwmdnj: folds=20
Uncalled bet (350) returned to TheNewMonkey
TheNewMonkey collected 1380 from pot
TheNewMonkey: doesn't show hand=20
*** SUMMARY ***
Total pot 1380 | Rake 0=20
Seat 1: robertg68 folded before Flop (didn't bet)
Seat 2: hainesiv2 folded before Flop (didn't bet)
Seat 3: SneakyPete85 folded before Flop (didn't bet)
Seat 4: JerseyGuy316 folded before Flop (didn't bet)
Seat 5: ks1112 (button) folded before Flop (didn't bet)
Seat 6: nwmdnj (small blind) folded before Flop
Seat 7: TheNewMonkey (big blind) collected (1380)
Seat 8: JJin91 folded before Flop (didn't bet)


*********** # 84 **************
PokerStars Hand #170374817611: Tournament #1622573280, $9.10+$0.90 USD =
Hold'em No Limit - Level XIII (350/700) - 2017/05/25 20:21:58 ET
Table '1622573280 1' 9-max Seat #6 is the button
Seat 1: robertg68 (15734 in chips)=20
Seat 2: hainesiv2 (23517 in chips)=20
Seat 3: SneakyPete85 (16799 in chips)=20
Seat 4: JerseyGuy316 (32695 in chips)=20
Seat 5: ks1112 (6345 in chips)=20
Seat 6: nwmdnj (10975 in chips)=20
Seat 7: TheNewMonkey (22815 in chips)=20
Seat 8: JJin91 (57851 in chips)=20
robertg68: posts the ante 85
hainesiv2: posts the ante 85
SneakyPete85: posts the ante 85
JerseyGuy316: posts the ante 85
ks1112: posts the ante 85
nwmdnj: posts the ante 85
TheNewMonkey: posts the ante 85
JJin91: posts the ante 85
TheNewMonkey: posts small blind 350
JJin91: posts big blind 700
*** HOLE CARDS ***
Dealt to JJin91 [Js Kd]
robertg68: folds=20
hainesiv2: folds=20
SneakyPete85: folds=20
JerseyGuy316: calls 700
ks1112: folds=20
nwmdnj: folds=20
TheNewMonkey: folds=20
JJin91: raises 1614 to 2314
JerseyGuy316: calls 1614
*** FLOP *** [3h As Jd]
JJin91: bets 3225
JerseyGuy316: calls 3225
*** TURN *** [3h As Jd] [Ac]
JJin91: checks=20
JerseyGuy316: bets 6054
JJin91: folds=20
Uncalled bet (6054) returned to JerseyGuy316
JerseyGuy316 collected 12108 from pot
JerseyGuy316: doesn't show hand=20
*** SUMMARY ***
Total pot 12108 | Rake 0=20
Board [3h As Jd Ac]
Seat 1: robertg68 folded before Flop (didn't bet)
Seat 2: hainesiv2 folded before Flop (didn't bet)
Seat 3: SneakyPete85 folded before Flop (didn't bet)
Seat 4: JerseyGuy316 collected (12108)
Seat 5: ks1112 folded before Flop (didn't bet)
Seat 6: nwmdnj (button) folded before Flop (didn't bet)
Seat 7: TheNewMonkey (small blind) folded before Flop
Seat 8: JJin91 (big blind) folded on the Turn


*********** # 85 **************
PokerStars Hand #170374817907: Tournament #1622573280, $9.10+$0.90 USD =
Hold'em No Limit - Level XIII (350/700) - 2017/05/25 20:23:01 ET
Table '1622573280 1' 9-max Seat #7 is the button
Seat 1: robertg68 (15649 in chips)=20
Seat 2: hainesiv2 (23432 in chips)=20
Seat 3: SneakyPete85 (16714 in chips)=20
Seat 4: JerseyGuy316 (39179 in chips)=20
Seat 5: ks1112 (6260 in chips)=20
Seat 6: nwmdnj (10890 in chips)=20
Seat 7: TheNewMonkey (22380 in chips)=20
Seat 8: JJin91 (52227 in chips)=20
robertg68: posts the ante 85
hainesiv2: posts the ante 85
SneakyPete85: posts the ante 85
JerseyGuy316: posts the ante 85
ks1112: posts the ante 85
nwmdnj: posts the ante 85
TheNewMonkey: posts the ante 85
JJin91: posts the ante 85
JJin91: posts small blind 350
robertg68: posts big blind 700
*** HOLE CARDS ***
Dealt to JJin91 [5d Jc]
hainesiv2: folds=20
SneakyPete85: folds=20
JerseyGuy316: folds=20
ks1112: folds=20
nwmdnj: folds=20
TheNewMonkey: raises 700 to 1400
JJin91: folds=20
robertg68: raises 700 to 2100
TheNewMonkey: calls 700
*** FLOP *** [3c As 5s]
robertg68: bets 1400
TheNewMonkey: calls 1400
*** TURN *** [3c As 5s] [7d]
robertg68: bets 1400
TheNewMonkey: raises 2100 to 3500
robertg68: calls 2100
*** RIVER *** [3c As 5s 7d] [Ad]
robertg68: checks=20
TheNewMonkey: bets 7700
robertg68: folds=20
Uncalled bet (7700) returned to TheNewMonkey
TheNewMonkey collected 15030 from pot
TheNewMonkey: doesn't show hand=20
*** SUMMARY ***
Total pot 15030 | Rake 0=20
Board [3c As 5s 7d Ad]
Seat 1: robertg68 (big blind) folded on the River
Seat 2: hainesiv2 folded before Flop (didn't bet)
Seat 3: SneakyPete85 folded before Flop (didn't bet)
Seat 4: JerseyGuy316 folded before Flop (didn't bet)
Seat 5: ks1112 folded before Flop (didn't bet)
Seat 6: nwmdnj folded before Flop (didn't bet)
Seat 7: TheNewMonkey (button) collected (15030)
Seat 8: JJin91 (small blind) folded before Flop


*********** # 86 **************
PokerStars Hand #170374818239: Tournament #1622573280, $9.10+$0.90 USD =
Hold'em No Limit - Level XIV (400/800) - 2017/05/25 20:24:08 ET
Table '1622573280 1' 9-max Seat #8 is the button
Seat 1: robertg68 (8564 in chips)=20
Seat 2: hainesiv2 (23347 in chips)=20
Seat 3: SneakyPete85 (16629 in chips)=20
Seat 4: JerseyGuy316 (39094 in chips)=20
Seat 5: ks1112 (6175 in chips)=20
Seat 6: nwmdnj (10805 in chips)=20
Seat 7: TheNewMonkey (30325 in chips)=20
Seat 8: JJin91 (51792 in chips)=20
robertg68: posts the ante 100
hainesiv2: posts the ante 100
SneakyPete85: posts the ante 100
JerseyGuy316: posts the ante 100
ks1112: posts the ante 100
nwmdnj: posts the ante 100
TheNewMonkey: posts the ante 100
JJin91: posts the ante 100
robertg68: posts small blind 400
hainesiv2: posts big blind 800
*** HOLE CARDS ***
Dealt to JJin91 [5h Td]
SneakyPete85: folds=20
JerseyGuy316: folds=20
ks1112: raises 5275 to 6075 and is all-in
nwmdnj: folds=20
TheNewMonkey: folds=20
JJin91: folds=20
robertg68: folds=20
hainesiv2: folds=20
Uncalled bet (5275) returned to ks1112
ks1112 collected 2800 from pot
ks1112: doesn't show hand=20
*** SUMMARY ***
Total pot 2800 | Rake 0=20
Seat 1: robertg68 (small blind) folded before Flop
Seat 2: hainesiv2 (big blind) folded before Flop
Seat 3: SneakyPete85 folded before Flop (didn't bet)
Seat 4: JerseyGuy316 folded before Flop (didn't bet)
Seat 5: ks1112 collected (2800)
Seat 6: nwmdnj folded before Flop (didn't bet)
Seat 7: TheNewMonkey folded before Flop (didn't bet)
Seat 8: JJin91 (button) folded before Flop (didn't bet)


*********** # 87 **************
PokerStars Hand #170374818362: Tournament #1622573280, $9.10+$0.90 USD =
Hold'em No Limit - Level XIV (400/800) - 2017/05/25 20:24:38 ET
Table '1622573280 1' 9-max Seat #1 is the button
Seat 1: robertg68 (8064 in chips)=20
Seat 2: hainesiv2 (22447 in chips)=20
Seat 3: SneakyPete85 (16529 in chips)=20
Seat 4: JerseyGuy316 (38994 in chips)=20
Seat 5: ks1112 (8075 in chips)=20
Seat 6: nwmdnj (10705 in chips)=20
Seat 7: TheNewMonkey (30225 in chips)=20
Seat 8: JJin91 (51692 in chips)=20
robertg68: posts the ante 100
hainesiv2: posts the ante 100
SneakyPete85: posts the ante 100
JerseyGuy316: posts the ante 100
ks1112: posts the ante 100
nwmdnj: posts the ante 100
TheNewMonkey: posts the ante 100
JJin91: posts the ante 100
hainesiv2: posts small blind 400
SneakyPete85: posts big blind 800
*** HOLE CARDS ***
Dealt to JJin91 [Qh 5c]
JerseyGuy316: raises 1600 to 2400
ks1112: folds=20
nwmdnj: folds=20
TheNewMonkey: folds=20
JJin91: folds=20
robertg68: folds=20
hainesiv2: folds=20
SneakyPete85: folds=20
Uncalled bet (1600) returned to JerseyGuy316
JerseyGuy316 collected 2800 from pot
*** SUMMARY ***
Total pot 2800 | Rake 0=20
Seat 1: robertg68 (button) folded before Flop (didn't bet)
Seat 2: hainesiv2 (small blind) folded before Flop
Seat 3: SneakyPete85 (big blind) folded before Flop
Seat 4: JerseyGuy316 collected (2800)
Seat 5: ks1112 folded before Flop (didn't bet)
Seat 6: nwmdnj folded before Flop (didn't bet)
Seat 7: TheNewMonkey folded before Flop (didn't bet)
Seat 8: JJin91 folded before Flop (didn't bet)


*********** # 88 **************
PokerStars Hand #170374818469: Tournament #1622573280, $9.10+$0.90 USD =
Hold'em No Limit - Level XIV (400/800) - 2017/05/25 20:25:03 ET
Table '1622573280 1' 9-max Seat #2 is the button
Seat 1: robertg68 (7964 in chips)=20
Seat 2: hainesiv2 (21947 in chips)=20
Seat 3: SneakyPete85 (15629 in chips)=20
Seat 4: JerseyGuy316 (40894 in chips)=20
Seat 5: ks1112 (7975 in chips)=20
Seat 6: nwmdnj (10605 in chips)=20
Seat 7: TheNewMonkey (30125 in chips)=20
Seat 8: JJin91 (51592 in chips)=20
robertg68: posts the ante 100
hainesiv2: posts the ante 100
SneakyPete85: posts the ante 100
JerseyGuy316: posts the ante 100
ks1112: posts the ante 100
nwmdnj: posts the ante 100
TheNewMonkey: posts the ante 100
JJin91: posts the ante 100
SneakyPete85: posts small blind 400
JerseyGuy316: posts big blind 800
*** HOLE CARDS ***
Dealt to JJin91 [7c Jd]
ks1112: folds=20
nwmdnj: folds=20
TheNewMonkey: folds=20
JJin91: folds=20
robertg68: calls 800
hainesiv2: raises 2400 to 3200
SneakyPete85: folds=20
JerseyGuy316: folds=20
robertg68: calls 2400
*** FLOP *** [2d 2h 6d]
robertg68: checks=20
hainesiv2: bets 9240
robertg68: calls 4664 and is all-in
Uncalled bet (4576) returned to hainesiv2
*** TURN *** [2d 2h 6d] [3s]
*** RIVER *** [2d 2h 6d 3s] [6c]
*** SHOW DOWN ***
robertg68: shows [Tc Ac] (two pair, Sixes and Deuces)
hainesiv2: shows [8s 8c] (two pair, Eights and Sixes)
hainesiv2 collected 17728 from pot
robertg68 finished the tournament in 63rd place
*** SUMMARY ***
Total pot 17728 | Rake 0=20
Board [2d 2h 6d 3s 6c]
Seat 1: robertg68 showed [Tc Ac] and lost with two pair, Sixes and Deuc=
es
Seat 2: hainesiv2 (button) showed [8s 8c] and won (17728) with two pair=
, Eights and Sixes
Seat 3: SneakyPete85 (small blind) folded before Flop
Seat 4: JerseyGuy316 (big blind) folded before Flop
Seat 5: ks1112 folded before Flop (didn't bet)
Seat 6: nwmdnj folded before Flop (didn't bet)
Seat 7: TheNewMonkey folded before Flop (didn't bet)
Seat 8: JJin91 folded before Flop (didn't bet)


*********** # 89 **************
PokerStars Hand #170374818699: Tournament #1622573280, $9.10+$0.90 USD =
Hold'em No Limit - Level XIV (400/800) - 2017/05/25 20:25:53 ET
Table '1622573280 1' 9-max Seat #3 is the button
Seat 2: hainesiv2 (31711 in chips)=20
Seat 3: SneakyPete85 (15129 in chips)=20
Seat 4: JerseyGuy316 (39994 in chips)=20
Seat 5: ks1112 (7875 in chips)=20
Seat 6: nwmdnj (10505 in chips)=20
Seat 7: TheNewMonkey (30025 in chips)=20
Seat 8: JJin91 (51492 in chips)=20
Seat 9: Ch1no354 (33690 in chips)=20
hainesiv2: posts the ante 100
SneakyPete85: posts the ante 100
JerseyGuy316: posts the ante 100
ks1112: posts the ante 100
nwmdnj: posts the ante 100
TheNewMonkey: posts the ante 100
JJin91: posts the ante 100
Ch1no354: posts the ante 100
JerseyGuy316: posts small blind 400
ks1112: posts big blind 800
*** HOLE CARDS ***
Dealt to JJin91 [6d Tc]
nwmdnj: folds=20
TheNewMonkey: raises 800 to 1600
JJin91: folds=20
Ch1no354: folds=20
hainesiv2: folds=20
SneakyPete85: folds=20
JerseyGuy316: raises 4800 to 6400
ks1112: folds=20
TheNewMonkey: calls 4800
*** FLOP *** [As 3c Ah]
JerseyGuy316: checks=20
TheNewMonkey: checks=20
*** TURN *** [As 3c Ah] [5h]
JerseyGuy316: bets 7200
TheNewMonkey: calls 7200
*** RIVER *** [As 3c Ah 5h] [Ac]
JerseyGuy316: bets 6294
TheNewMonkey: calls 6294
*** SHOW DOWN ***
JerseyGuy316: shows [Qc Qs] (a full house, Aces full of Queens)
TheNewMonkey: shows [Ks Kc] (a full house, Aces full of Kings)
TheNewMonkey collected 41388 from pot
*** SUMMARY ***
Total pot 41388 | Rake 0=20
Board [As 3c Ah 5h Ac]
Seat 2: hainesiv2 folded before Flop (didn't bet)
Seat 3: SneakyPete85 (button) folded before Flop (didn't bet)
Seat 4: JerseyGuy316 (small blind) showed [Qc Qs] and lost with a full =
house, Aces full of Queens
Seat 5: ks1112 (big blind) folded before Flop
Seat 6: nwmdnj folded before Flop (didn't bet)
Seat 7: TheNewMonkey showed [Ks Kc] and won (41388) with a full house, =
Aces full of Kings
Seat 8: JJin91 folded before Flop (didn't bet)
Seat 9: Ch1no354 folded before Flop (didn't bet)


*********** # 90 **************
PokerStars Hand #170374818958: Tournament #1622573280, $9.10+$0.90 USD =
Hold'em No Limit - Level XIV (400/800) - 2017/05/25 20:26:57 ET
Table '1622573280 1' 9-max Seat #4 is the button
Seat 2: hainesiv2 (31611 in chips)=20
Seat 3: SneakyPete85 (15029 in chips)=20
Seat 4: JerseyGuy316 (20000 in chips)=20
Seat 5: ks1112 (6975 in chips)=20
Seat 6: nwmdnj (10405 in chips)=20
Seat 7: TheNewMonkey (51419 in chips)=20
Seat 8: JJin91 (51392 in chips)=20
Seat 9: Ch1no354 (33590 in chips)=20
hainesiv2: posts the ante 100
SneakyPete85: posts the ante 100
JerseyGuy316: posts the ante 100
ks1112: posts the ante 100
nwmdnj: posts the ante 100
TheNewMonkey: posts the ante 100
JJin91: posts the ante 100
Ch1no354: posts the ante 100
ks1112: posts small blind 400
nwmdnj: posts big blind 800
*** HOLE CARDS ***
Dealt to JJin91 [3h 2c]
JerseyGuy316 said, "lol"
JerseyGuy316 said, "what a cooler"
TheNewMonkey: folds=20
JerseyGuy316 said, "only me"
JJin91: folds=20
Ch1no354: raises 1600 to 2400
hainesiv2: folds=20
SneakyPete85: folds=20
JerseyGuy316: folds=20
ks1112: folds=20
JerseyGuy316 said, "its such a screwed up thing they got going against =
me"
nwmdnj: folds=20
Uncalled bet (1600) returned to Ch1no354
JerseyGuy316 said, "i never harmed anyone lol"
Ch1no354 collected 2800 from pot
Ch1no354: doesn't show hand=20
*** SUMMARY ***
Total pot 2800 | Rake 0=20
Seat 2: hainesiv2 folded before Flop (didn't bet)
Seat 3: SneakyPete85 folded before Flop (didn't bet)
Seat 4: JerseyGuy316 (button) folded before Flop (didn't bet)
Seat 5: ks1112 (small blind) folded before Flop
Seat 6: nwmdnj (big blind) folded before Flop
Seat 7: TheNewMonkey folded before Flop (didn't bet)
Seat 8: JJin91 folded before Flop (didn't bet)
Seat 9: Ch1no354 collected (2800)


*********** # 91 **************
PokerStars Hand #170374819162: Tournament #1622573280, $9.10+$0.90 USD =
Hold'em No Limit - Level XIV (400/800) - 2017/05/25 20:27:47 ET
Table '1622573280 1' 9-max Seat #5 is the button
Seat 2: hainesiv2 (31511 in chips)=20
Seat 3: SneakyPete85 (14929 in chips)=20
Seat 4: JerseyGuy316 (19900 in chips)=20
Seat 5: ks1112 (6475 in chips)=20
Seat 6: nwmdnj (9505 in chips)=20
Seat 7: TheNewMonkey (51319 in chips)=20
Seat 8: JJin91 (51292 in chips)=20
Seat 9: Ch1no354 (35490 in chips)=20
hainesiv2: posts the ante 100
SneakyPete85: posts the ante 100
JerseyGuy316: posts the ante 100
ks1112: posts the ante 100
nwmdnj: posts the ante 100
TheNewMonkey: posts the ante 100
JJin91: posts the ante 100
Ch1no354: posts the ante 100
nwmdnj: posts small blind 400
TheNewMonkey: posts big blind 800
*** HOLE CARDS ***
Dealt to JJin91 [4s Kc]
JerseyGuy316 said, "but punish me lol"
JJin91: folds=20
JerseyGuy316 said, "nh"
Ch1no354: folds=20
hainesiv2: folds=20
SneakyPete85: raises 800 to 1600
JerseyGuy316: folds=20
ks1112: folds=20
nwmdnj: raises 7805 to 9405 and is all-in
TheNewMonkey: folds=20
SneakyPete85: folds=20
Uncalled bet (7805) returned to nwmdnj
nwmdnj collected 4800 from pot
nwmdnj: doesn't show hand=20
*** SUMMARY ***
Total pot 4800 | Rake 0=20
Seat 2: hainesiv2 folded before Flop (didn't bet)
Seat 3: SneakyPete85 folded before Flop
Seat 4: JerseyGuy316 folded before Flop (didn't bet)
Seat 5: ks1112 (button) folded before Flop (didn't bet)
Seat 6: nwmdnj (small blind) collected (4800)
Seat 7: TheNewMonkey (big blind) folded before Flop
Seat 8: JJin91 folded before Flop (didn't bet)
Seat 9: Ch1no354 folded before Flop (didn't bet)


*********** # 92 **************
PokerStars Hand #170374819306: Tournament #1622573280, $9.10+$0.90 USD =
Hold'em No Limit - Level XIV (400/800) - 2017/05/25 20:28:24 ET
Table '1622573280 1' 9-max Seat #6 is the button
Seat 2: hainesiv2 (31411 in chips)=20
Seat 3: SneakyPete85 (13229 in chips)=20
Seat 4: JerseyGuy316 (19800 in chips)=20
Seat 5: ks1112 (6375 in chips)=20
Seat 6: nwmdnj (12605 in chips)=20
Seat 7: TheNewMonkey (50419 in chips)=20
Seat 8: JJin91 (51192 in chips)=20
Seat 9: Ch1no354 (35390 in chips)=20
hainesiv2: posts the ante 100
SneakyPete85: posts the ante 100
JerseyGuy316: posts the ante 100
ks1112: posts the ante 100
nwmdnj: posts the ante 100
TheNewMonkey: posts the ante 100
JJin91: posts the ante 100
Ch1no354: posts the ante 100
TheNewMonkey: posts small blind 400
JJin91: posts big blind 800
*** HOLE CARDS ***
Dealt to JJin91 [3s 2s]
Ch1no354: folds=20
hainesiv2: folds=20
SneakyPete85: folds=20
JerseyGuy316: folds=20
ks1112: folds=20
nwmdnj: raises 11705 to 12505 and is all-in
TheNewMonkey: folds=20
JJin91: folds=20
Uncalled bet (11705) returned to nwmdnj
nwmdnj collected 2800 from pot
nwmdnj: doesn't show hand=20
*** SUMMARY ***
Total pot 2800 | Rake 0=20
Seat 2: hainesiv2 folded before Flop (didn't bet)
Seat 3: SneakyPete85 folded before Flop (didn't bet)
Seat 4: JerseyGuy316 folded before Flop (didn't bet)
Seat 5: ks1112 folded before Flop (didn't bet)
Seat 6: nwmdnj (button) collected (2800)
Seat 7: TheNewMonkey (small blind) folded before Flop
Seat 8: JJin91 (big blind) folded before Flop
Seat 9: Ch1no354 folded before Flop (didn't bet)


*********** # 93 **************
PokerStars Hand #170374819431: Tournament #1622573280, $9.10+$0.90 USD =
Hold'em No Limit - Level XIV (400/800) - 2017/05/25 20:28:55 ET
Table '1622573280 1' 9-max Seat #7 is the button
Seat 2: hainesiv2 (31311 in chips)=20
Seat 3: SneakyPete85 (13129 in chips)=20
Seat 4: JerseyGuy316 (19700 in chips)=20
Seat 5: ks1112 (6275 in chips)=20
Seat 6: nwmdnj (14505 in chips)=20
Seat 7: TheNewMonkey (49919 in chips)=20
Seat 8: JJin91 (50292 in chips)=20
Seat 9: Ch1no354 (35290 in chips)=20
hainesiv2: posts the ante 100
SneakyPete85: posts the ante 100
JerseyGuy316: posts the ante 100
ks1112: posts the ante 100
nwmdnj: posts the ante 100
TheNewMonkey: posts the ante 100
JJin91: posts the ante 100
Ch1no354: posts the ante 100
JJin91: posts small blind 400
Ch1no354: posts big blind 800
*** HOLE CARDS ***
Dealt to JJin91 [5d Ad]
hainesiv2: folds=20
SneakyPete85: raises 800 to 1600
JerseyGuy316: folds=20
ks1112: folds=20
nwmdnj: folds=20
TheNewMonkey: folds=20
JJin91: calls 1200
Ch1no354: folds=20
*** FLOP *** [9c Qs Jc]
JJin91: bets 3236
SneakyPete85: calls 3236
*** TURN *** [9c Qs Jc] [2d]
JJin91: checks=20
SneakyPete85: bets 8193 and is all-in
JJin91: folds=20
Uncalled bet (8193) returned to SneakyPete85
SneakyPete85 collected 11272 from pot
SneakyPete85: doesn't show hand=20
*** SUMMARY ***
Total pot 11272 | Rake 0=20
Board [9c Qs Jc 2d]
Seat 2: hainesiv2 folded before Flop (didn't bet)
Seat 3: SneakyPete85 collected (11272)
Seat 4: JerseyGuy316 folded before Flop (didn't bet)
Seat 5: ks1112 folded before Flop (didn't bet)
Seat 6: nwmdnj folded before Flop (didn't bet)
Seat 7: TheNewMonkey (button) folded before Flop (didn't bet)
Seat 8: JJin91 (small blind) folded on the Turn
Seat 9: Ch1no354 (big blind) folded before Flop


*********** # 94 **************
PokerStars Hand #170374819762: Tournament #1622573280, $9.10+$0.90 USD =
Hold'em No Limit - Level XIV (400/800) - 2017/05/25 20:30:14 ET
Table '1622573280 1' 9-max Seat #8 is the button
Seat 2: hainesiv2 (31211 in chips)=20
Seat 3: SneakyPete85 (19465 in chips)=20
Seat 4: JerseyGuy316 (19600 in chips)=20
Seat 5: ks1112 (6175 in chips)=20
Seat 6: nwmdnj (14405 in chips)=20
Seat 7: TheNewMonkey (49819 in chips)=20
Seat 8: JJin91 (45356 in chips)=20
Seat 9: Ch1no354 (34390 in chips)=20
hainesiv2: posts the ante 100
SneakyPete85: posts the ante 100
JerseyGuy316: posts the ante 100
ks1112: posts the ante 100
nwmdnj: posts the ante 100
TheNewMonkey: posts the ante 100
JJin91: posts the ante 100
Ch1no354: posts the ante 100
Ch1no354: posts small blind 400
hainesiv2: posts big blind 800
*** HOLE CARDS ***
Dealt to JJin91 [As 6d]
SneakyPete85: folds=20
JerseyGuy316: folds=20
ks1112: folds=20
nwmdnj: folds=20
TheNewMonkey: folds=20
JJin91: raises 952 to 1752
Ch1no354: calls 1352
hainesiv2: calls 952
*** FLOP *** [Jd Qd 2s]
Ch1no354: bets 3200
hainesiv2: folds=20
JJin91: folds=20
Uncalled bet (3200) returned to Ch1no354
Ch1no354 collected 6056 from pot
Ch1no354: doesn't show hand=20
*** SUMMARY ***
Total pot 6056 | Rake 0=20
Board [Jd Qd 2s]
Seat 2: hainesiv2 (big blind) folded on the Flop
Seat 3: SneakyPete85 folded before Flop (didn't bet)
Seat 4: JerseyGuy316 folded before Flop (didn't bet)
Seat 5: ks1112 folded before Flop (didn't bet)
Seat 6: nwmdnj folded before Flop (didn't bet)
Seat 7: TheNewMonkey folded before Flop (didn't bet)
Seat 8: JJin91 (button) folded on the Flop
Seat 9: Ch1no354 (small blind) collected (6056)


*********** # 95 **************
PokerStars Hand #170374819961: Tournament #1622573280, $9.10+$0.90 USD =
Hold'em No Limit - Level XIV (400/800) - 2017/05/25 20:30:58 ET
Table '1622573280 1' 9-max Seat #9 is the button
Seat 2: hainesiv2 (29359 in chips)=20
Seat 3: SneakyPete85 (19365 in chips)=20
Seat 4: JerseyGuy316 (19500 in chips)=20
Seat 5: ks1112 (6075 in chips)=20
Seat 6: nwmdnj (14305 in chips)=20
Seat 7: TheNewMonkey (49719 in chips)=20
Seat 8: JJin91 (43504 in chips)=20
Seat 9: Ch1no354 (38594 in chips)=20
hainesiv2: posts the ante 100
SneakyPete85: posts the ante 100
JerseyGuy316: posts the ante 100
ks1112: posts the ante 100
nwmdnj: posts the ante 100
TheNewMonkey: posts the ante 100
JJin91: posts the ante 100
Ch1no354: posts the ante 100
hainesiv2: posts small blind 400
SneakyPete85: posts big blind 800
*** HOLE CARDS ***
Dealt to JJin91 [5d 5s]
JerseyGuy316: folds=20
ks1112: folds=20
nwmdnj: raises 800 to 1600
TheNewMonkey: folds=20
JJin91: folds=20
Ch1no354: calls 1600
hainesiv2: folds=20
SneakyPete85: calls 800
*** FLOP *** [Ks Js Th]
SneakyPete85: checks=20
nwmdnj: checks=20
Ch1no354: bets 3000
SneakyPete85: folds=20
nwmdnj: folds=20
Uncalled bet (3000) returned to Ch1no354
Ch1no354 collected 6000 from pot
Ch1no354: doesn't show hand=20
*** SUMMARY ***
Total pot 6000 | Rake 0=20
Board [Ks Js Th]
Seat 2: hainesiv2 (small blind) folded before Flop
Seat 3: SneakyPete85 (big blind) folded on the Flop
Seat 4: JerseyGuy316 folded before Flop (didn't bet)
Seat 5: ks1112 folded before Flop (didn't bet)
Seat 6: nwmdnj folded on the Flop
Seat 7: TheNewMonkey folded before Flop (didn't bet)
Seat 8: JJin91 folded before Flop (didn't bet)
Seat 9: Ch1no354 (button) collected (6000)


*********** # 96 **************
PokerStars Hand #170376657001: Tournament #1622573280, $9.10+$0.90 USD =
Hold'em No Limit - Level XIV (400/800) - 2017/05/25 20:32:20 ET
Table '1622573280 1' 9-max Seat #2 is the button
Seat 1: jfargz3 (9157 in chips)=20
Seat 2: hainesiv2 (28859 in chips)=20
Seat 3: SneakyPete85 (17665 in chips)=20
Seat 4: JerseyGuy316 (19400 in chips)=20
Seat 5: ks1112 (5975 in chips)=20
Seat 6: nwmdnj (12605 in chips)=20
Seat 7: TheNewMonkey (49619 in chips)=20
Seat 8: JJin91 (43404 in chips)=20
Seat 9: Ch1no354 (42894 in chips)=20
jfargz3: posts the ante 100
hainesiv2: posts the ante 100
SneakyPete85: posts the ante 100
JerseyGuy316: posts the ante 100
ks1112: posts the ante 100
nwmdnj: posts the ante 100
TheNewMonkey: posts the ante 100
JJin91: posts the ante 100
Ch1no354: posts the ante 100
SneakyPete85: posts small blind 400
JerseyGuy316: posts big blind 800
*** HOLE CARDS ***
Dealt to JJin91 [Kc 3h]
ks1112: folds=20
nwmdnj: folds=20
TheNewMonkey: folds=20
JJin91: folds=20
Ch1no354: folds=20
jfargz3: folds=20
hainesiv2: raises 2000 to 2800
SneakyPete85: folds=20
JerseyGuy316: folds=20
Uncalled bet (2000) returned to hainesiv2
hainesiv2 collected 2900 from pot
hainesiv2: doesn't show hand=20
*** SUMMARY ***
Total pot 2900 | Rake 0=20
Seat 1: jfargz3 folded before Flop (didn't bet)
Seat 2: hainesiv2 (button) collected (2900)
Seat 3: SneakyPete85 (small blind) folded before Flop
Seat 4: JerseyGuy316 (big blind) folded before Flop
Seat 5: ks1112 folded before Flop (didn't bet)
Seat 6: nwmdnj folded before Flop (didn't bet)
Seat 7: TheNewMonkey folded before Flop (didn't bet)
Seat 8: JJin91 folded before Flop (didn't bet)
Seat 9: Ch1no354 folded before Flop (didn't bet)


*********** # 97 **************
PokerStars Hand #170376657205: Tournament #1622573280, $9.10+$0.90 USD =
Hold'em No Limit - Level XIV (400/800) - 2017/05/25 20:33:02 ET
Table '1622573280 1' 9-max Seat #3 is the button
Seat 1: jfargz3 (9057 in chips)=20
Seat 2: hainesiv2 (30859 in chips)=20
Seat 3: SneakyPete85 (17165 in chips)=20
Seat 4: JerseyGuy316 (18500 in chips)=20
Seat 5: ks1112 (5875 in chips)=20
Seat 6: nwmdnj (12505 in chips)=20
Seat 7: TheNewMonkey (49519 in chips)=20
Seat 8: JJin91 (43304 in chips)=20
Seat 9: Ch1no354 (42794 in chips)=20
jfargz3: posts the ante 100
hainesiv2: posts the ante 100
SneakyPete85: posts the ante 100
JerseyGuy316: posts the ante 100
ks1112: posts the ante 100
nwmdnj: posts the ante 100
TheNewMonkey: posts the ante 100
JJin91: posts the ante 100
Ch1no354: posts the ante 100
JerseyGuy316: posts small blind 400
ks1112: posts big blind 800
*** HOLE CARDS ***
Dealt to JJin91 [5s Tc]
nwmdnj: raises 1200 to 2000
TheNewMonkey: calls 2000
JJin91: folds=20
Ch1no354: folds=20
jfargz3: folds=20
hainesiv2: folds=20
SneakyPete85: folds=20
JerseyGuy316: folds=20
ks1112: calls 1200
*** FLOP *** [8s 3c 7s]
ks1112: checks=20
nwmdnj: checks=20
TheNewMonkey: checks=20
*** TURN *** [8s 3c 7s] [Td]
ks1112: bets 3775 and is all-in
nwmdnj: folds=20
TheNewMonkey: calls 3775
*** RIVER *** [8s 3c 7s Td] [Ah]
*** SHOW DOWN ***
ks1112: shows [7h 7d] (three of a kind, Sevens)
TheNewMonkey: shows [Jc Ac] (a pair of Aces)
ks1112 collected 14850 from pot
*** SUMMARY ***
Total pot 14850 | Rake 0=20
Board [8s 3c 7s Td Ah]
Seat 1: jfargz3 folded before Flop (didn't bet)
Seat 2: hainesiv2 folded before Flop (didn't bet)
Seat 3: SneakyPete85 (button) folded before Flop (didn't bet)
Seat 4: JerseyGuy316 (small blind) folded before Flop
Seat 5: ks1112 (big blind) showed [7h 7d] and won (14850) with three of=
 a kind, Sevens
Seat 6: nwmdnj folded on the Turn
Seat 7: TheNewMonkey showed [Jc Ac] and lost with a pair of Aces
Seat 8: JJin91 folded before Flop (didn't bet)
Seat 9: Ch1no354 folded before Flop (didn't bet)


*********** # 98 **************
PokerStars Hand #170376657559: Tournament #1622573280, $9.10+$0.90 USD =
Hold'em No Limit - Level XV (500/1000) - 2017/05/25 20:34:13 ET
Table '1622573280 1' 9-max Seat #4 is the button
Seat 1: jfargz3 (8957 in chips)=20
Seat 2: hainesiv2 (30759 in chips)=20
Seat 3: SneakyPete85 (17065 in chips)=20
Seat 4: JerseyGuy316 (18000 in chips)=20
Seat 5: ks1112 (14850 in chips)=20
Seat 6: nwmdnj (10405 in chips)=20
Seat 7: TheNewMonkey (43644 in chips)=20
Seat 8: JJin91 (43204 in chips)=20
Seat 9: Ch1no354 (42694 in chips)=20
jfargz3: posts the ante 125
hainesiv2: posts the ante 125
SneakyPete85: posts the ante 125
JerseyGuy316: posts the ante 125
ks1112: posts the ante 125
nwmdnj: posts the ante 125
TheNewMonkey: posts the ante 125
JJin91: posts the ante 125
Ch1no354: posts the ante 125
ks1112: posts small blind 500
nwmdnj: posts big blind 1000
*** HOLE CARDS ***
Dealt to JJin91 [4s 3s]
TheNewMonkey: folds=20
JJin91: folds=20
Ch1no354: folds=20
jfargz3: folds=20
hainesiv2: folds=20
SneakyPete85: raises 15940 to 16940 and is all-in
JerseyGuy316: folds=20
ks1112: folds=20
nwmdnj: folds=20
Uncalled bet (15940) returned to SneakyPete85
SneakyPete85 collected 3625 from pot
SneakyPete85: doesn't show hand=20
*** SUMMARY ***
Total pot 3625 | Rake 0=20
Seat 1: jfargz3 folded before Flop (didn't bet)
Seat 2: hainesiv2 folded before Flop (didn't bet)
Seat 3: SneakyPete85 collected (3625)
Seat 4: JerseyGuy316 (button) folded before Flop (didn't bet)
Seat 5: ks1112 (small blind) folded before Flop
Seat 6: nwmdnj (big blind) folded before Flop
Seat 7: TheNewMonkey folded before Flop (didn't bet)
Seat 8: JJin91 folded before Flop (didn't bet)
Seat 9: Ch1no354 folded before Flop (didn't bet)


*********** # 99 **************
PokerStars Hand #170376657727: Tournament #1622573280, $9.10+$0.90 USD =
Hold'em No Limit - Level XV (500/1000) - 2017/05/25 20:34:53 ET
Table '1622573280 1' 9-max Seat #5 is the button
Seat 1: jfargz3 (8832 in chips)=20
Seat 2: hainesiv2 (30634 in chips)=20
Seat 3: SneakyPete85 (19565 in chips)=20
Seat 4: JerseyGuy316 (17875 in chips)=20
Seat 5: ks1112 (14225 in chips)=20
Seat 6: nwmdnj (9280 in chips)=20
Seat 7: TheNewMonkey (43519 in chips)=20
Seat 8: JJin91 (43079 in chips)=20
Seat 9: Ch1no354 (42569 in chips)=20
jfargz3: posts the ante 125
hainesiv2: posts the ante 125
SneakyPete85: posts the ante 125
JerseyGuy316: posts the ante 125
ks1112: posts the ante 125
nwmdnj: posts the ante 125
TheNewMonkey: posts the ante 125
JJin91: posts the ante 125
Ch1no354: posts the ante 125
nwmdnj: posts small blind 500
TheNewMonkey: posts big blind 1000
*** HOLE CARDS ***
Dealt to JJin91 [5d 7c]
JJin91: folds=20
Ch1no354: folds=20
jfargz3: raises 7707 to 8707 and is all-in
hainesiv2: folds=20
SneakyPete85: folds=20
JerseyGuy316: folds=20
ks1112: folds=20
nwmdnj: folds=20
TheNewMonkey: folds=20
Uncalled bet (7707) returned to jfargz3
jfargz3 collected 3625 from pot
jfargz3: doesn't show hand=20
*** SUMMARY ***
Total pot 3625 | Rake 0=20
Seat 1: jfargz3 collected (3625)
Seat 2: hainesiv2 folded before Flop (didn't bet)
Seat 3: SneakyPete85 folded before Flop (didn't bet)
Seat 4: JerseyGuy316 folded before Flop (didn't bet)
Seat 5: ks1112 (button) folded before Flop (didn't bet)
Seat 6: nwmdnj (small blind) folded before Flop
Seat 7: TheNewMonkey (big blind) folded before Flop
Seat 8: JJin91 folded before Flop (didn't bet)
Seat 9: Ch1no354 folded before Flop (didn't bet)


*********** # 100 **************
PokerStars Hand #170376657884: Tournament #1622573280, $9.10+$0.90 USD =
Hold'em No Limit - Level XV (500/1000) - 2017/05/25 20:35:29 ET
Table '1622573280 1' 9-max Seat #6 is the button
Seat 1: jfargz3 (11332 in chips)=20
Seat 2: hainesiv2 (30509 in chips)=20
Seat 3: SneakyPete85 (19440 in chips)=20
Seat 4: JerseyGuy316 (17750 in chips)=20
Seat 5: ks1112 (14100 in chips)=20
Seat 6: nwmdnj (8655 in chips)=20
Seat 7: TheNewMonkey (42394 in chips)=20
Seat 8: JJin91 (42954 in chips)=20
Seat 9: Ch1no354 (42444 in chips)=20
jfargz3: posts the ante 125
hainesiv2: posts the ante 125
SneakyPete85: posts the ante 125
JerseyGuy316: posts the ante 125
ks1112: posts the ante 125
nwmdnj: posts the ante 125
TheNewMonkey: posts the ante 125
JJin91: posts the ante 125
Ch1no354: posts the ante 125
TheNewMonkey: posts small blind 500
JJin91: posts big blind 1000
*** HOLE CARDS ***
Dealt to JJin91 [6d Qh]
Ch1no354: folds=20
jfargz3: calls 1000
hainesiv2: folds=20
SneakyPete85: folds=20
JerseyGuy316 said, "watch me lose this one too lol. either way gg to al=
l"
JerseyGuy316: raises 16625 to 17625 and is all-in
ks1112: folds=20
nwmdnj: folds=20
TheNewMonkey: folds=20
JJin91: folds=20
jfargz3: folds=20
Uncalled bet (16625) returned to JerseyGuy316
JerseyGuy316 collected 4625 from pot
JerseyGuy316: doesn't show hand=20
*** SUMMARY ***
Total pot 4625 | Rake 0=20
Seat 1: jfargz3 folded before Flop
Seat 2: hainesiv2 folded before Flop (didn't bet)
Seat 3: SneakyPete85 folded before Flop (didn't bet)
Seat 4: JerseyGuy316 collected (4625)
Seat 5: ks1112 folded before Flop (didn't bet)
Seat 6: nwmdnj (button) folded before Flop (didn't bet)
Seat 7: TheNewMonkey (small blind) folded before Flop
Seat 8: JJin91 (big blind) folded before Flop
Seat 9: Ch1no354 folded before Flop (didn't bet)


*********** # 101 **************
PokerStars Hand #170376658102: Tournament #1622573280, $9.10+$0.90 USD =
Hold'em No Limit - Level XV (500/1000) - 2017/05/25 20:36:22 ET
Table '1622573280 1' 9-max Seat #7 is the button
Seat 1: jfargz3 (10207 in chips)=20
Seat 2: hainesiv2 (30384 in chips)=20
Seat 3: SneakyPete85 (19315 in chips)=20
Seat 4: JerseyGuy316 (21250 in chips)=20
Seat 5: ks1112 (13975 in chips)=20
Seat 6: nwmdnj (8530 in chips)=20
Seat 7: TheNewMonkey (41769 in chips)=20
Seat 8: JJin91 (41829 in chips)=20
Seat 9: Ch1no354 (42319 in chips)=20
jfargz3: posts the ante 125
hainesiv2: posts the ante 125
SneakyPete85: posts the ante 125
JerseyGuy316: posts the ante 125
ks1112: posts the ante 125
nwmdnj: posts the ante 125
TheNewMonkey: posts the ante 125
JJin91: posts the ante 125
Ch1no354: posts the ante 125
JJin91: posts small blind 500
Ch1no354: posts big blind 1000
*** HOLE CARDS ***
Dealt to JJin91 [3d Js]
JerseyGuy316 said, "sweet haha"
jfargz3: folds=20
hainesiv2: folds=20
SneakyPete85: folds=20
JerseyGuy316: calls 1000
ks1112: calls 1000
nwmdnj: folds=20
TheNewMonkey: folds=20
JJin91: folds=20
Ch1no354: checks=20
*** FLOP *** [7h 5c 8d]
Ch1no354: bets 2313
JerseyGuy316: folds=20
ks1112: raises 10537 to 12850 and is all-in
Ch1no354: calls 10537
*** TURN *** [7h 5c 8d] [2c]
*** RIVER *** [7h 5c 8d 2c] [5s]
*** SHOW DOWN ***
Ch1no354: shows [6h 4c] (a straight, Four to Eight)
ks1112: shows [Qd Qc] (two pair, Queens and Fives)
Ch1no354 collected 30325 from pot
ks1112 finished the tournament in 50th place
*** SUMMARY ***
Total pot 30325 | Rake 0=20
Board [7h 5c 8d 2c 5s]
Seat 1: jfargz3 folded before Flop (didn't bet)
Seat 2: hainesiv2 folded before Flop (didn't bet)
Seat 3: SneakyPete85 folded before Flop (didn't bet)
Seat 4: JerseyGuy316 folded on the Flop
Seat 5: ks1112 showed [Qd Qc] and lost with two pair, Queens and Fives
Seat 6: nwmdnj folded before Flop (didn't bet)
Seat 7: TheNewMonkey (button) folded before Flop (didn't bet)
Seat 8: JJin91 (small blind) folded before Flop
Seat 9: Ch1no354 (big blind) showed [6h 4c] and won (30325) with a stra=
ight, Four to Eight


*********** # 102 **************
PokerStars Hand #170376658464: Tournament #1622573280, $9.10+$0.90 USD =
Hold'em No Limit - Level XV (500/1000) - 2017/05/25 20:37:39 ET
Table '1622573280 1' 9-max Seat #8 is the button
Seat 1: jfargz3 (10082 in chips)=20
Seat 2: hainesiv2 (30259 in chips)=20
Seat 3: SneakyPete85 (19190 in chips)=20
Seat 4: JerseyGuy316 (20125 in chips)=20
Seat 6: nwmdnj (8405 in chips)=20
Seat 7: TheNewMonkey (41644 in chips)=20
Seat 8: JJin91 (41204 in chips)=20
Seat 9: Ch1no354 (58669 in chips)=20
jfargz3: posts the ante 125
hainesiv2: posts the ante 125
SneakyPete85: posts the ante 125
JerseyGuy316: posts the ante 125
nwmdnj: posts the ante 125
TheNewMonkey: posts the ante 125
JJin91: posts the ante 125
Ch1no354: posts the ante 125
Ch1no354: posts small blind 500
jfargz3: posts big blind 1000
*** HOLE CARDS ***
Dealt to JJin91 [Ad 5h]
hainesiv2: folds=20
SneakyPete85: folds=20
JerseyGuy316: calls 1000
nwmdnj: folds=20
TheNewMonkey: calls 1000
JJin91: folds=20
Ch1no354: calls 500
jfargz3: checks=20
*** FLOP *** [2c Tc Qc]
Ch1no354: checks=20
jfargz3: checks=20
JerseyGuy316: bets 1000
TheNewMonkey: calls 1000
Ch1no354: folds=20
jfargz3: folds=20
*** TURN *** [2c Tc Qc] [3c]
JerseyGuy316: checks=20
TheNewMonkey: checks=20
*** RIVER *** [2c Tc Qc 3c] [Jd]
JerseyGuy316: bets 3500
TheNewMonkey: calls 3500
*** SHOW DOWN ***
JerseyGuy316: shows [8s Ts] (a pair of Tens)
TheNewMonkey: shows [Kc 7c] (a flush, King high)
TheNewMonkey collected 14000 from pot
*** SUMMARY ***
Total pot 14000 | Rake 0=20
Board [2c Tc Qc 3c Jd]
Seat 1: jfargz3 (big blind) folded on the Flop
Seat 2: hainesiv2 folded before Flop (didn't bet)
Seat 3: SneakyPete85 folded before Flop (didn't bet)
Seat 4: JerseyGuy316 showed [8s Ts] and lost with a pair of Tens
Seat 6: nwmdnj folded before Flop (didn't bet)
Seat 7: TheNewMonkey showed [Kc 7c] and won (14000) with a flush, King =
high
Seat 8: JJin91 (button) folded before Flop (didn't bet)
Seat 9: Ch1no354 (small blind) folded on the Flop


*********** # 103 **************
PokerStars Hand #170376658819: Tournament #1622573280, $9.10+$0.90 USD =
Hold'em No Limit - Level XV (500/1000) - 2017/05/25 20:38:57 ET
Table '1622573280 1' 9-max Seat #9 is the button
Seat 1: jfargz3 (8957 in chips)=20
Seat 2: hainesiv2 (30134 in chips)=20
Seat 3: SneakyPete85 (19065 in chips)=20
Seat 4: JerseyGuy316 (14500 in chips)=20
Seat 6: nwmdnj (8280 in chips)=20
Seat 7: TheNewMonkey (50019 in chips)=20
Seat 8: JJin91 (41079 in chips)=20
Seat 9: Ch1no354 (57544 in chips)=20
jfargz3: posts the ante 125
hainesiv2: posts the ante 125
SneakyPete85: posts the ante 125
JerseyGuy316: posts the ante 125
nwmdnj: posts the ante 125
TheNewMonkey: posts the ante 125
JJin91: posts the ante 125
Ch1no354: posts the ante 125
jfargz3: posts small blind 500
hainesiv2: posts big blind 1000
*** HOLE CARDS ***
Dealt to JJin91 [3c 9d]
SneakyPete85: folds=20
JerseyGuy316: folds=20
nwmdnj: folds=20
TheNewMonkey: raises 1000 to 2000
JJin91: folds=20
Ch1no354: folds=20
jfargz3: raises 6832 to 8832 and is all-in
hainesiv2: folds=20
TheNewMonkey: calls 6832
*** FLOP *** [2s Ac Ad]
*** TURN *** [2s Ac Ad] [Jd]
*** RIVER *** [2s Ac Ad Jd] [9s]
*** SHOW DOWN ***
jfargz3: shows [Qd Ks] (a pair of Aces)
TheNewMonkey: shows [8h 8d] (two pair, Aces and Eights)
TheNewMonkey collected 19664 from pot
jfargz3 finished the tournament in 47th place
*** SUMMARY ***
Total pot 19664 | Rake 0=20
Board [2s Ac Ad Jd 9s]
Seat 1: jfargz3 (small blind) showed [Qd Ks] and lost with a pair of Ac=
es
Seat 2: hainesiv2 (big blind) folded before Flop
Seat 3: SneakyPete85 folded before Flop (didn't bet)
Seat 4: JerseyGuy316 folded before Flop (didn't bet)
Seat 6: nwmdnj folded before Flop (didn't bet)
Seat 7: TheNewMonkey showed [8h 8d] and won (19664) with two pair, Aces=
 and Eights
Seat 8: JJin91 folded before Flop (didn't bet)
Seat 9: Ch1no354 (button) folded before Flop (didn't bet)


*********** # 104 **************
PokerStars Hand #170376658973: Tournament #1622573280, $9.10+$0.90 USD =
Hold'em No Limit - Level XV (500/1000) - 2017/05/25 20:39:29 ET
Table '1622573280 1' 9-max Seat #2 is the button
Seat 2: hainesiv2 (29009 in chips)=20
Seat 3: SneakyPete85 (18940 in chips)=20
Seat 4: JerseyGuy316 (14375 in chips)=20
Seat 6: nwmdnj (8155 in chips)=20
Seat 7: TheNewMonkey (60726 in chips)=20
Seat 8: JJin91 (40954 in chips)=20
Seat 9: Ch1no354 (57419 in chips)=20
hainesiv2: posts the ante 125
SneakyPete85: posts the ante 125
JerseyGuy316: posts the ante 125
nwmdnj: posts the ante 125
TheNewMonkey: posts the ante 125
JJin91: posts the ante 125
Ch1no354: posts the ante 125
SneakyPete85: posts small blind 500
JerseyGuy316: posts big blind 1000
*** HOLE CARDS ***
Dealt to JJin91 [Kd 9d]
nwmdnj: folds=20
TheNewMonkey: folds=20
JJin91: raises 1190 to 2190
Ch1no354: folds=20
hainesiv2: folds=20
SneakyPete85: folds=20
JerseyGuy316: folds=20
Uncalled bet (1190) returned to JJin91
JJin91 collected 3375 from pot
JJin91: doesn't show hand=20
*** SUMMARY ***
Total pot 3375 | Rake 0=20
Seat 2: hainesiv2 (button) folded before Flop (didn't bet)
Seat 3: SneakyPete85 (small blind) folded before Flop
Seat 4: JerseyGuy316 (big blind) folded before Flop
Seat 6: nwmdnj folded before Flop (didn't bet)
Seat 7: TheNewMonkey folded before Flop (didn't bet)
Seat 8: JJin91 collected (3375)
Seat 9: Ch1no354 folded before Flop (didn't bet)


*********** # 105 **************
PokerStars Hand #170376659101: Tournament #1622573280, $9.10+$0.90 USD =
Hold'em No Limit - Level XV (500/1000) - 2017/05/25 20:40:00 ET
Table '1622573280 1' 9-max Seat #3 is the button
Seat 1: smitheea (38366 in chips)=20
Seat 2: hainesiv2 (28884 in chips)=20
Seat 3: SneakyPete85 (18315 in chips)=20
Seat 4: JerseyGuy316 (13250 in chips)=20
Seat 5: AngeloP04 (43585 in chips)=20
Seat 6: nwmdnj (8030 in chips)=20
Seat 7: TheNewMonkey (60601 in chips)=20
Seat 8: JJin91 (43204 in chips)=20
Seat 9: Ch1no354 (57294 in chips)=20
smitheea: posts the ante 125
hainesiv2: posts the ante 125
SneakyPete85: posts the ante 125
JerseyGuy316: posts the ante 125
AngeloP04: posts the ante 125
nwmdnj: posts the ante 125
TheNewMonkey: posts the ante 125
JJin91: posts the ante 125
Ch1no354: posts the ante 125
JerseyGuy316: posts small blind 500
AngeloP04: posts big blind 1000
*** HOLE CARDS ***
Dealt to JJin91 [Qd Td]
nwmdnj: folds=20
TheNewMonkey: folds=20
JJin91: folds=20
Ch1no354: folds=20
smitheea: raises 2000 to 3000
hainesiv2: folds=20
SneakyPete85: folds=20
JerseyGuy316: folds=20
AngeloP04: folds=20
Uncalled bet (2000) returned to smitheea
smitheea collected 3625 from pot
smitheea: doesn't show hand=20
*** SUMMARY ***
Total pot 3625 | Rake 0=20
Seat 1: smitheea collected (3625)
Seat 2: hainesiv2 folded before Flop (didn't bet)
Seat 3: SneakyPete85 (button) folded before Flop (didn't bet)
Seat 4: JerseyGuy316 (small blind) folded before Flop
Seat 5: AngeloP04 (big blind) folded before Flop
Seat 6: nwmdnj folded before Flop (didn't bet)
Seat 7: TheNewMonkey folded before Flop (didn't bet)
Seat 8: JJin91 folded before Flop (didn't bet)
Seat 9: Ch1no354 folded before Flop (didn't bet)


*********** # 106 **************
PokerStars Hand #170376659264: Tournament #1622573280, $9.10+$0.90 USD =
Hold'em No Limit - Level XV (500/1000) - 2017/05/25 20:40:33 ET
Table '1622573280 1' 9-max Seat #4 is the button
Seat 1: smitheea (40866 in chips)=20
Seat 2: hainesiv2 (28759 in chips)=20
Seat 3: SneakyPete85 (18190 in chips)=20
Seat 4: JerseyGuy316 (12625 in chips)=20
Seat 5: AngeloP04 (42460 in chips)=20
Seat 6: nwmdnj (7905 in chips)=20
Seat 7: TheNewMonkey (60476 in chips)=20
Seat 8: JJin91 (43079 in chips)=20
Seat 9: Ch1no354 (57169 in chips)=20
smitheea: posts the ante 125
hainesiv2: posts the ante 125
SneakyPete85: posts the ante 125
JerseyGuy316: posts the ante 125
AngeloP04: posts the ante 125
nwmdnj: posts the ante 125
TheNewMonkey: posts the ante 125
JJin91: posts the ante 125
Ch1no354: posts the ante 125
AngeloP04: posts small blind 500
nwmdnj: posts big blind 1000
*** HOLE CARDS ***
Dealt to JJin91 [Td 8c]
TheNewMonkey: folds=20
JJin91: folds=20
Ch1no354: raises 1000 to 2000
smitheea: calls 2000
hainesiv2: calls 2000
SneakyPete85: raises 16065 to 18065 and is all-in
JerseyGuy316: folds=20
AngeloP04: folds=20
nwmdnj: folds=20
Ch1no354: folds=20
smitheea: folds=20
hainesiv2: folds=20
Uncalled bet (16065) returned to SneakyPete85
SneakyPete85 collected 10625 from pot
SneakyPete85: doesn't show hand=20
*** SUMMARY ***
Total pot 10625 | Rake 0=20
Seat 1: smitheea folded before Flop
Seat 2: hainesiv2 folded before Flop
Seat 3: SneakyPete85 collected (10625)
Seat 4: JerseyGuy316 (button) folded before Flop (didn't bet)
Seat 5: AngeloP04 (small blind) folded before Flop
Seat 6: nwmdnj (big blind) folded before Flop
Seat 7: TheNewMonkey folded before Flop (didn't bet)
Seat 8: JJin91 folded before Flop (didn't bet)
Seat 9: Ch1no354 folded before Flop


*********** # 107 **************
PokerStars Hand #170376659570: Tournament #1622573280, $9.10+$0.90 USD =
Hold'em No Limit - Level XV (500/1000) - 2017/05/25 20:41:39 ET
Table '1622573280 1' 9-max Seat #5 is the button
Seat 1: smitheea (38741 in chips)=20
Seat 2: hainesiv2 (26634 in chips)=20
Seat 3: SneakyPete85 (26690 in chips)=20
Seat 4: JerseyGuy316 (12500 in chips)=20
Seat 5: AngeloP04 (41835 in chips)=20
Seat 6: nwmdnj (6780 in chips)=20
Seat 7: TheNewMonkey (60351 in chips)=20
Seat 8: JJin91 (42954 in chips)=20
Seat 9: Ch1no354 (55044 in chips)=20
smitheea: posts the ante 125
hainesiv2: posts the ante 125
SneakyPete85: posts the ante 125
JerseyGuy316: posts the ante 125
AngeloP04: posts the ante 125
nwmdnj: posts the ante 125
TheNewMonkey: posts the ante 125
JJin91: posts the ante 125
Ch1no354: posts the ante 125
nwmdnj: posts small blind 500
TheNewMonkey: posts big blind 1000
*** HOLE CARDS ***
Dealt to JJin91 [3s Ts]
JJin91: folds=20
Ch1no354: folds=20
smitheea: folds=20
hainesiv2: folds=20
SneakyPete85: folds=20
JerseyGuy316: folds=20
AngeloP04: folds=20
nwmdnj: folds=20
Uncalled bet (500) returned to TheNewMonkey
TheNewMonkey collected 2125 from pot
TheNewMonkey: doesn't show hand=20
*** SUMMARY ***
Total pot 2125 | Rake 0=20
Seat 1: smitheea folded before Flop (didn't bet)
Seat 2: hainesiv2 folded before Flop (didn't bet)
Seat 3: SneakyPete85 folded before Flop (didn't bet)
Seat 4: JerseyGuy316 folded before Flop (didn't bet)
Seat 5: AngeloP04 (button) folded before Flop (didn't bet)
Seat 6: nwmdnj (small blind) folded before Flop
Seat 7: TheNewMonkey (big blind) collected (2125)
Seat 8: JJin91 folded before Flop (didn't bet)
Seat 9: Ch1no354 folded before Flop (didn't bet)


*********** # 108 **************
PokerStars Hand #170376659684: Tournament #1622573280, $9.10+$0.90 USD =
Hold'em No Limit - Level XV (500/1000) - 2017/05/25 20:41:56 ET
Table '1622573280 1' 9-max Seat #6 is the button
Seat 1: smitheea (38616 in chips)=20
Seat 2: hainesiv2 (26509 in chips)=20
Seat 3: SneakyPete85 (26565 in chips)=20
Seat 4: JerseyGuy316 (12375 in chips)=20
Seat 5: AngeloP04 (41710 in chips)=20
Seat 6: nwmdnj (6155 in chips)=20
Seat 7: TheNewMonkey (61851 in chips)=20
Seat 8: JJin91 (42829 in chips)=20
Seat 9: Ch1no354 (54919 in chips)=20
smitheea: posts the ante 125
hainesiv2: posts the ante 125
SneakyPete85: posts the ante 125
JerseyGuy316: posts the ante 125
AngeloP04: posts the ante 125
nwmdnj: posts the ante 125
TheNewMonkey: posts the ante 125
JJin91: posts the ante 125
Ch1no354: posts the ante 125
TheNewMonkey: posts small blind 500
JJin91: posts big blind 1000
*** HOLE CARDS ***
Dealt to JJin91 [3s Jh]
Ch1no354: raises 2000 to 3000
smitheea: folds=20
hainesiv2: folds=20
SneakyPete85: folds=20
JerseyGuy316: folds=20
AngeloP04: folds=20
nwmdnj: folds=20
TheNewMonkey: calls 2500
JJin91: folds=20
*** FLOP *** [Ad 5c 6h]
TheNewMonkey: checks=20
Ch1no354: bets 4063
TheNewMonkey: calls 4063
*** TURN *** [Ad 5c 6h] [2c]
TheNewMonkey: checks=20
Ch1no354: checks=20
*** RIVER *** [Ad 5c 6h 2c] [6s]
TheNewMonkey: bets 4000
Ch1no354: calls 4000
*** SHOW DOWN ***
TheNewMonkey: shows [9h 9c] (two pair, Nines and Sixes)
Ch1no354: shows [As Ts] (two pair, Aces and Sixes)
Ch1no354 collected 24251 from pot
*** SUMMARY ***
Total pot 24251 | Rake 0=20
Board [Ad 5c 6h 2c 6s]
Seat 1: smitheea folded before Flop (didn't bet)
Seat 2: hainesiv2 folded before Flop (didn't bet)
Seat 3: SneakyPete85 folded before Flop (didn't bet)
Seat 4: JerseyGuy316 folded before Flop (didn't bet)
Seat 5: AngeloP04 folded before Flop (didn't bet)
Seat 6: nwmdnj (button) folded before Flop (didn't bet)
Seat 7: TheNewMonkey (small blind) showed [9h 9c] and lost with two pai=
r, Nines and Sixes
Seat 8: JJin91 (big blind) folded before Flop
Seat 9: Ch1no354 showed [As Ts] and won (24251) with two pair, Aces and=
 Sixes


*********** # 109 **************
PokerStars Hand #170377408517: Tournament #1622573280, $9.10+$0.90 USD =
Hold'em No Limit - Level XV (500/1000) - 2017/05/25 20:43:04 ET
Table '1622573280 1' 9-max Seat #7 is the button
Seat 1: smitheea (38491 in chips)=20
Seat 2: hainesiv2 (26384 in chips)=20
Seat 3: SneakyPete85 (26440 in chips)=20
Seat 4: JerseyGuy316 (12250 in chips)=20
Seat 5: AngeloP04 (41585 in chips)=20
Seat 6: nwmdnj (6030 in chips)=20
Seat 7: TheNewMonkey (50663 in chips)=20
Seat 8: JJin91 (41704 in chips)=20
Seat 9: Ch1no354 (67982 in chips)=20
smitheea: posts the ante 125
hainesiv2: posts the ante 125
SneakyPete85: posts the ante 125
JerseyGuy316: posts the ante 125
AngeloP04: posts the ante 125
nwmdnj: posts the ante 125
TheNewMonkey: posts the ante 125
JJin91: posts the ante 125
Ch1no354: posts the ante 125
JJin91: posts small blind 500
Ch1no354: posts big blind 1000
*** HOLE CARDS ***
Dealt to JJin91 [3h Ad]
smitheea: folds=20
hainesiv2: folds=20
SneakyPete85: folds=20
JerseyGuy316: folds=20
AngeloP04: folds=20
nwmdnj: folds=20
TheNewMonkey: folds=20
JJin91: calls 500
Ch1no354: checks=20
*** FLOP *** [6d 4s Ah]
JJin91: checks=20
Ch1no354: bets 2000
JJin91: calls 2000
*** TURN *** [6d 4s Ah] [3d]
JJin91: checks=20
Ch1no354: checks=20
*** RIVER *** [6d 4s Ah 3d] [9h]
JJin91: bets 4061
Ch1no354: folds=20
Uncalled bet (4061) returned to JJin91
JJin91 collected 7125 from pot
JJin91: doesn't show hand=20
*** SUMMARY ***
Total pot 7125 | Rake 0=20
Board [6d 4s Ah 3d 9h]
Seat 1: smitheea folded before Flop (didn't bet)
Seat 2: hainesiv2 folded before Flop (didn't bet)
Seat 3: SneakyPete85 folded before Flop (didn't bet)
Seat 4: JerseyGuy316 folded before Flop (didn't bet)
Seat 5: AngeloP04 folded before Flop (didn't bet)
Seat 6: nwmdnj folded before Flop (didn't bet)
Seat 7: TheNewMonkey (button) folded before Flop (didn't bet)
Seat 8: JJin91 (small blind) collected (7125)
Seat 9: Ch1no354 (big blind) folded on the River


*********** # 110 **************
PokerStars Hand #170377408884: Tournament #1622573280, $9.10+$0.90 USD =
Hold'em No Limit - Level XVI (600/1200) - 2017/05/25 20:44:29 ET
Table '1622573280 1' 9-max Seat #8 is the button
Seat 1: smitheea (38366 in chips)=20
Seat 2: hainesiv2 (26259 in chips)=20
Seat 3: SneakyPete85 (26315 in chips)=20
Seat 4: JerseyGuy316 (12125 in chips)=20
Seat 5: AngeloP04 (41460 in chips)=20
Seat 6: nwmdnj (5905 in chips)=20
Seat 7: TheNewMonkey (50538 in chips)=20
Seat 8: JJin91 (45704 in chips)=20
Seat 9: Ch1no354 (64857 in chips)=20
smitheea: posts the ante 150
hainesiv2: posts the ante 150
SneakyPete85: posts the ante 150
JerseyGuy316: posts the ante 150
AngeloP04: posts the ante 150
nwmdnj: posts the ante 150
TheNewMonkey: posts the ante 150
JJin91: posts the ante 150
Ch1no354: posts the ante 150
Ch1no354: posts small blind 600
smitheea: posts big blind 1200
*** HOLE CARDS ***
Dealt to JJin91 [Qh Th]
hainesiv2: folds=20
SneakyPete85: folds=20
JerseyGuy316: folds=20
AngeloP04: raises 2400 to 3600
nwmdnj: folds=20
TheNewMonkey: folds=20
JJin91: calls 3600
Ch1no354: folds=20
smitheea: calls 2400
*** FLOP *** [Kd 9h Qd]
smitheea: checks=20
AngeloP04: bets 12750
JJin91: folds=20
smitheea: calls 12750
*** TURN *** [Kd 9h Qd] [As]
smitheea: checks=20
AngeloP04: bets 24960 and is all-in
smitheea: folds=20
Uncalled bet (24960) returned to AngeloP04
AngeloP04 collected 38250 from pot
AngeloP04: doesn't show hand=20
*** SUMMARY ***
Total pot 38250 | Rake 0=20
Board [Kd 9h Qd As]
Seat 1: smitheea (big blind) folded on the Turn
Seat 2: hainesiv2 folded before Flop (didn't bet)
Seat 3: SneakyPete85 folded before Flop (didn't bet)
Seat 4: JerseyGuy316 folded before Flop (didn't bet)
Seat 5: AngeloP04 collected (38250)
Seat 6: nwmdnj folded before Flop (didn't bet)
Seat 7: TheNewMonkey folded before Flop (didn't bet)
Seat 8: JJin91 (button) folded on the Flop
Seat 9: Ch1no354 (small blind) folded before Flop


*********** # 111 **************
PokerStars Hand #170377409240: Tournament #1622573280, $9.10+$0.90 USD =
Hold'em No Limit - Level XVI (600/1200) - 2017/05/25 20:45:44 ET
Table '1622573280 1' 9-max Seat #9 is the button
Seat 1: smitheea (21866 in chips)=20
Seat 2: hainesiv2 (26109 in chips)=20
Seat 3: SneakyPete85 (26165 in chips)=20
Seat 4: JerseyGuy316 (11975 in chips)=20
Seat 5: AngeloP04 (63210 in chips)=20
Seat 6: nwmdnj (5755 in chips)=20
Seat 7: TheNewMonkey (50388 in chips)=20
Seat 8: JJin91 (41954 in chips)=20
Seat 9: Ch1no354 (64107 in chips)=20
smitheea: posts the ante 150
hainesiv2: posts the ante 150
SneakyPete85: posts the ante 150
JerseyGuy316: posts the ante 150
AngeloP04: posts the ante 150
nwmdnj: posts the ante 150
TheNewMonkey: posts the ante 150
JJin91: posts the ante 150
Ch1no354: posts the ante 150
smitheea: posts small blind 600
hainesiv2: posts big blind 1200
*** HOLE CARDS ***
Dealt to JJin91 [2s 4s]
SneakyPete85: folds=20
JerseyGuy316: folds=20
AngeloP04: folds=20
nwmdnj: folds=20
TheNewMonkey: raises 1200 to 2400
JJin91: folds=20
Ch1no354: folds=20
smitheea: calls 1800
hainesiv2: folds=20
*** FLOP *** [Jh Jc 5d]
smitheea: checks=20
TheNewMonkey: bets 7200
smitheea: calls 7200
*** TURN *** [Jh Jc 5d] [As]
smitheea: checks=20
TheNewMonkey: checks=20
*** RIVER *** [Jh Jc 5d As] [5c]
smitheea: bets 11963
TheNewMonkey: folds=20
Uncalled bet (11963) returned to smitheea
smitheea collected 21750 from pot
smitheea: doesn't show hand=20
*** SUMMARY ***
Total pot 21750 | Rake 0=20
Board [Jh Jc 5d As 5c]
Seat 1: smitheea (small blind) collected (21750)
Seat 2: hainesiv2 (big blind) folded before Flop
Seat 3: SneakyPete85 folded before Flop (didn't bet)
Seat 4: JerseyGuy316 folded before Flop (didn't bet)
Seat 5: AngeloP04 folded before Flop (didn't bet)
Seat 6: nwmdnj folded before Flop (didn't bet)
Seat 7: TheNewMonkey folded on the River
Seat 8: JJin91 folded before Flop (didn't bet)
Seat 9: Ch1no354 (button) folded before Flop (didn't bet)


*********** # 112 **************
PokerStars Hand #170377409474: Tournament #1622573280, $9.10+$0.90 USD =
Hold'em No Limit - Level XVI (600/1200) - 2017/05/25 20:46:33 ET
Table '1622573280 1' 9-max Seat #1 is the button
Seat 1: smitheea (33866 in chips)=20
Seat 2: hainesiv2 (24759 in chips)=20
Seat 3: SneakyPete85 (26015 in chips)=20
Seat 4: JerseyGuy316 (11825 in chips)=20
Seat 5: AngeloP04 (63060 in chips)=20
Seat 6: nwmdnj (5605 in chips)=20
Seat 7: TheNewMonkey (40638 in chips)=20
Seat 8: JJin91 (41804 in chips)=20
Seat 9: Ch1no354 (63957 in chips)=20
smitheea: posts the ante 150
hainesiv2: posts the ante 150
SneakyPete85: posts the ante 150
JerseyGuy316: posts the ante 150
AngeloP04: posts the ante 150
nwmdnj: posts the ante 150
TheNewMonkey: posts the ante 150
JJin91: posts the ante 150
Ch1no354: posts the ante 150
hainesiv2: posts small blind 600
SneakyPete85: posts big blind 1200
*** HOLE CARDS ***
Dealt to JJin91 [Ad 2c]
JerseyGuy316: folds=20
AngeloP04: folds=20
nwmdnj: folds=20
TheNewMonkey: folds=20
JJin91: folds=20
Ch1no354: raises 1200 to 2400
smitheea: folds=20
hainesiv2: calls 1800
SneakyPete85: calls 1200
*** FLOP *** [7d Qc 5d]
hainesiv2: checks=20
SneakyPete85: checks=20
Ch1no354: bets 2400
hainesiv2: folds=20
SneakyPete85: folds=20
Uncalled bet (2400) returned to Ch1no354
Ch1no354 collected 8550 from pot
Ch1no354: doesn't show hand=20
*** SUMMARY ***
Total pot 8550 | Rake 0=20
Board [7d Qc 5d]
Seat 1: smitheea (button) folded before Flop (didn't bet)
Seat 2: hainesiv2 (small blind) folded on the Flop
Seat 3: SneakyPete85 (big blind) folded on the Flop
Seat 4: JerseyGuy316 folded before Flop (didn't bet)
Seat 5: AngeloP04 folded before Flop (didn't bet)
Seat 6: nwmdnj folded before Flop (didn't bet)
Seat 7: TheNewMonkey folded before Flop (didn't bet)
Seat 8: JJin91 folded before Flop (didn't bet)
Seat 9: Ch1no354 collected (8550)


*********** # 113 **************
PokerStars Hand #170377409764: Tournament #1622573280, $9.10+$0.90 USD =
Hold'em No Limit - Level XVI (600/1200) - 2017/05/25 20:47:35 ET
Table '1622573280 1' 9-max Seat #2 is the button
Seat 1: smitheea (33716 in chips)=20
Seat 2: hainesiv2 (22209 in chips)=20
Seat 3: SneakyPete85 (23465 in chips)=20
Seat 4: JerseyGuy316 (11675 in chips)=20
Seat 5: AngeloP04 (62910 in chips)=20
Seat 6: nwmdnj (5455 in chips)=20
Seat 7: TheNewMonkey (40488 in chips)=20
Seat 8: JJin91 (41654 in chips)=20
Seat 9: Ch1no354 (69957 in chips)=20
smitheea: posts the ante 150
hainesiv2: posts the ante 150
SneakyPete85: posts the ante 150
JerseyGuy316: posts the ante 150
AngeloP04: posts the ante 150
nwmdnj: posts the ante 150
TheNewMonkey: posts the ante 150
JJin91: posts the ante 150
Ch1no354: posts the ante 150
SneakyPete85: posts small blind 600
JerseyGuy316: posts big blind 1200
*** HOLE CARDS ***
Dealt to JJin91 [Kh As]
AngeloP04: folds=20
nwmdnj: folds=20
TheNewMonkey: folds=20
JJin91: raises 1428 to 2628
Ch1no354: calls 2628
smitheea: folds=20
hainesiv2: folds=20
SneakyPete85: folds=20
JerseyGuy316: folds=20
*** FLOP *** [3c 8c 7h]
JJin91: checks=20
Ch1no354: checks=20
*** TURN *** [3c 8c 7h] [8h]
JJin91: checks=20
Ch1no354: bets 3600
JJin91: calls 3600
*** RIVER *** [3c 8c 7h 8h] [4h]
JJin91: checks=20
Ch1no354: bets 19200
JJin91: folds=20
Uncalled bet (19200) returned to Ch1no354
Ch1no354 collected 15606 from pot
Ch1no354: doesn't show hand=20
*** SUMMARY ***
Total pot 15606 | Rake 0=20
Board [3c 8c 7h 8h 4h]
Seat 1: smitheea folded before Flop (didn't bet)
Seat 2: hainesiv2 (button) folded before Flop (didn't bet)
Seat 3: SneakyPete85 (small blind) folded before Flop
Seat 4: JerseyGuy316 (big blind) folded before Flop
Seat 5: AngeloP04 folded before Flop (didn't bet)
Seat 6: nwmdnj folded before Flop (didn't bet)
Seat 7: TheNewMonkey folded before Flop (didn't bet)
Seat 8: JJin91 folded on the River
Seat 9: Ch1no354 collected (15606)


*********** # 114 **************
PokerStars Hand #170377722397: Tournament #1622573280, $9.10+$0.90 USD =
Hold'em No Limit - Level XVI (600/1200) - 2017/05/25 20:49:10 ET
Table '1622573280 1' 9-max Seat #3 is the button
Seat 1: smitheea (33566 in chips)=20
Seat 2: hainesiv2 (22059 in chips)=20
Seat 3: SneakyPete85 (22715 in chips)=20
Seat 4: JerseyGuy316 (10325 in chips)=20
Seat 5: AngeloP04 (62760 in chips)=20
Seat 6: nwmdnj (5305 in chips)=20
Seat 7: TheNewMonkey (40338 in chips)=20
Seat 8: JJin91 (35276 in chips)=20
Seat 9: Ch1no354 (79185 in chips)=20
smitheea: posts the ante 150
hainesiv2: posts the ante 150
SneakyPete85: posts the ante 150
JerseyGuy316: posts the ante 150
AngeloP04: posts the ante 150
nwmdnj: posts the ante 150
TheNewMonkey: posts the ante 150
JJin91: posts the ante 150
Ch1no354: posts the ante 150
JerseyGuy316: posts small blind 600
AngeloP04: posts big blind 1200
*** HOLE CARDS ***
Dealt to JJin91 [7s 9c]
nwmdnj: raises 3955 to 5155 and is all-in
TheNewMonkey: folds=20
JJin91: folds=20
Ch1no354: folds=20
smitheea: folds=20
hainesiv2: folds=20
SneakyPete85: folds=20
JerseyGuy316: folds=20
AngeloP04: calls 3955
*** FLOP *** [Kd 9s Qh]
*** TURN *** [Kd 9s Qh] [2s]
*** RIVER *** [Kd 9s Qh 2s] [7c]
*** SHOW DOWN ***
AngeloP04: shows [4s 4c] (a pair of Fours)
nwmdnj: shows [Ad Qc] (a pair of Queens)
nwmdnj collected 12260 from pot
*** SUMMARY ***
Total pot 12260 | Rake 0=20
Board [Kd 9s Qh 2s 7c]
Seat 1: smitheea folded before Flop (didn't bet)
Seat 2: hainesiv2 folded before Flop (didn't bet)
Seat 3: SneakyPete85 (button) folded before Flop (didn't bet)
Seat 4: JerseyGuy316 (small blind) folded before Flop
Seat 5: AngeloP04 (big blind) showed [4s 4c] and lost with a pair of Fo=
urs
Seat 6: nwmdnj showed [Ad Qc] and won (12260) with a pair of Queens
Seat 7: TheNewMonkey folded before Flop (didn't bet)
Seat 8: JJin91 folded before Flop (didn't bet)
Seat 9: Ch1no354 folded before Flop (didn't bet)


*********** # 115 **************
PokerStars Hand #170377722548: Tournament #1622573280, $9.10+$0.90 USD =
Hold'em No Limit - Level XVI (600/1200) - 2017/05/25 20:49:44 ET
Table '1622573280 1' 9-max Seat #4 is the button
Seat 1: smitheea (33416 in chips)=20
Seat 2: hainesiv2 (21909 in chips)=20
Seat 3: SneakyPete85 (22565 in chips)=20
Seat 4: JerseyGuy316 (9575 in chips)=20
Seat 5: AngeloP04 (57455 in chips)=20
Seat 6: nwmdnj (12260 in chips)=20
Seat 7: TheNewMonkey (40188 in chips)=20
Seat 8: JJin91 (35126 in chips)=20
Seat 9: Ch1no354 (79035 in chips)=20
smitheea: posts the ante 150
hainesiv2: posts the ante 150
SneakyPete85: posts the ante 150
JerseyGuy316: posts the ante 150
AngeloP04: posts the ante 150
nwmdnj: posts the ante 150
TheNewMonkey: posts the ante 150
JJin91: posts the ante 150
Ch1no354: posts the ante 150
AngeloP04: posts small blind 600
nwmdnj: posts big blind 1200
*** HOLE CARDS ***
Dealt to JJin91 [Th 7s]
TheNewMonkey: folds=20
JJin91: folds=20
Ch1no354: folds=20
smitheea: folds=20
hainesiv2: calls 1200
SneakyPete85: raises 2400 to 3600
JerseyGuy316: folds=20
AngeloP04: folds=20
nwmdnj: folds=20
hainesiv2: calls 2400
*** FLOP *** [As 2c 7c]
hainesiv2: bets 11385
SneakyPete85: folds=20
Uncalled bet (11385) returned to hainesiv2
hainesiv2 collected 10350 from pot
hainesiv2: doesn't show hand=20
*** SUMMARY ***
Total pot 10350 | Rake 0=20
Board [As 2c 7c]
Seat 1: smitheea folded before Flop (didn't bet)
Seat 2: hainesiv2 collected (10350)
Seat 3: SneakyPete85 folded on the Flop
Seat 4: JerseyGuy316 (button) folded before Flop (didn't bet)
Seat 5: AngeloP04 (small blind) folded before Flop
Seat 6: nwmdnj (big blind) folded before Flop
Seat 7: TheNewMonkey folded before Flop (didn't bet)
Seat 8: JJin91 folded before Flop (didn't bet)
Seat 9: Ch1no354 folded before Flop (didn't bet)


*********** # 116 **************
PokerStars Hand #170377722797: Tournament #1622573280, $9.10+$0.90 USD =
Hold'em No Limit - Level XVI (600/1200) - 2017/05/25 20:50:41 ET
Table '1622573280 1' 9-max Seat #5 is the button
Seat 1: smitheea (33266 in chips)=20
Seat 2: hainesiv2 (28509 in chips)=20
Seat 3: SneakyPete85 (18815 in chips)=20
Seat 4: JerseyGuy316 (9425 in chips)=20
Seat 5: AngeloP04 (56705 in chips)=20
Seat 6: nwmdnj (10910 in chips)=20
Seat 7: TheNewMonkey (40038 in chips)=20
Seat 8: JJin91 (34976 in chips)=20
Seat 9: Ch1no354 (78885 in chips)=20
smitheea: posts the ante 150
hainesiv2: posts the ante 150
SneakyPete85: posts the ante 150
JerseyGuy316: posts the ante 150
AngeloP04: posts the ante 150
nwmdnj: posts the ante 150
TheNewMonkey: posts the ante 150
JJin91: posts the ante 150
Ch1no354: posts the ante 150
nwmdnj: posts small blind 600
TheNewMonkey: posts big blind 1200
*** HOLE CARDS ***
Dealt to JJin91 [Ad Kh]
JJin91: raises 1428 to 2628
Ch1no354: calls 2628
smitheea: folds=20
hainesiv2: folds=20
SneakyPete85: folds=20
JerseyGuy316: folds=20
AngeloP04: folds=20
nwmdnj: folds=20
TheNewMonkey: folds=20
*** FLOP *** [5c Kd 2c]
JJin91: checks=20
Ch1no354: bets 4203
JJin91: calls 4203
*** TURN *** [5c Kd 2c] [2d]
JJin91: checks=20
Ch1no354: checks=20
*** RIVER *** [5c Kd 2c 2d] [6d]
JJin91: bets 6220
Ch1no354: calls 6220
*** SHOW DOWN ***
JJin91: shows [Ad Kh] (two pair, Kings and Deuces)
Ch1no354: mucks hand=20
JJin91 collected 29252 from pot
*** SUMMARY ***
Total pot 29252 | Rake 0=20
Board [5c Kd 2c 2d 6d]
Seat 1: smitheea folded before Flop (didn't bet)
Seat 2: hainesiv2 folded before Flop (didn't bet)
Seat 3: SneakyPete85 folded before Flop (didn't bet)
Seat 4: JerseyGuy316 folded before Flop (didn't bet)
Seat 5: AngeloP04 (button) folded before Flop (didn't bet)
Seat 6: nwmdnj (small blind) folded before Flop
Seat 7: TheNewMonkey (big blind) folded before Flop
Seat 8: JJin91 showed [Ad Kh] and won (29252) with two pair, Kings and =
Deuces
Seat 9: Ch1no354 mucked [8d 8s]


*********** # 117 **************
PokerStars Hand #170377723473: Tournament #1622573280, $9.10+$0.90 USD =
Hold'em No Limit - Level XVI (600/1200) - 2017/05/25 20:53:06 ET
Table '1622573280 1' 9-max Seat #6 is the button
Seat 1: smitheea (33116 in chips)=20
Seat 2: hainesiv2 (28359 in chips)=20
Seat 3: SneakyPete85 (18665 in chips)=20
Seat 4: JerseyGuy316 (9275 in chips)=20
Seat 5: AngeloP04 (56555 in chips)=20
Seat 6: nwmdnj (10160 in chips)=20
Seat 7: TheNewMonkey (38688 in chips)=20
Seat 8: JJin91 (51027 in chips)=20
smitheea: posts the ante 150
hainesiv2: posts the ante 150
SneakyPete85: posts the ante 150
JerseyGuy316: posts the ante 150
AngeloP04: posts the ante 150
nwmdnj: posts the ante 150
TheNewMonkey: posts the ante 150
JJin91: posts the ante 150
TheNewMonkey: posts small blind 600
JJin91: posts big blind 1200
*** HOLE CARDS ***
Dealt to JJin91 [Qh 5s]
smitheea: folds=20
hainesiv2: folds=20
SneakyPete85: folds=20
JerseyGuy316: folds=20
AngeloP04: folds=20
nwmdnj: raises 1200 to 2400
TheNewMonkey: folds=20
JJin91: calls 1200
*** FLOP *** [5h 3s Qs]
JJin91: checks=20
nwmdnj: bets 2178
JJin91: calls 2178
*** TURN *** [5h 3s Qs] [4h]
JJin91: bets 46299 and is all-in
nwmdnj: folds=20
Uncalled bet (46299) returned to JJin91
JJin91 collected 10956 from pot
JJin91: doesn't show hand=20
*** SUMMARY ***
Total pot 10956 | Rake 0=20
Board [5h 3s Qs 4h]
Seat 1: smitheea folded before Flop (didn't bet)
Seat 2: hainesiv2 folded before Flop (didn't bet)
Seat 3: SneakyPete85 folded before Flop (didn't bet)
Seat 4: JerseyGuy316 folded before Flop (didn't bet)
Seat 5: AngeloP04 folded before Flop (didn't bet)
Seat 6: nwmdnj (button) folded on the Turn
Seat 7: TheNewMonkey (small blind) folded before Flop
Seat 8: JJin91 (big blind) collected (10956)


*********** # 118 **************
PokerStars Hand #170377723747: Tournament #1622573280, $9.10+$0.90 USD =
Hold'em No Limit - Level XVII (700/1400) - 2017/05/25 20:54:07 ET
Table '1622573280 1' 9-max Seat #7 is the button
Seat 1: smitheea (32966 in chips)=20
Seat 2: hainesiv2 (28209 in chips)=20
Seat 3: SneakyPete85 (18515 in chips)=20
Seat 4: JerseyGuy316 (9125 in chips)=20
Seat 5: AngeloP04 (56405 in chips)=20
Seat 6: nwmdnj (5432 in chips)=20
Seat 7: TheNewMonkey (37938 in chips)=20
Seat 8: JJin91 (57255 in chips)=20
smitheea: posts the ante 175
hainesiv2: posts the ante 175
SneakyPete85: posts the ante 175
JerseyGuy316: posts the ante 175
AngeloP04: posts the ante 175
nwmdnj: posts the ante 175
TheNewMonkey: posts the ante 175
JJin91: posts the ante 175
JJin91: posts small blind 700
smitheea: posts big blind 1400
*** HOLE CARDS ***
Dealt to JJin91 [6s Qs]
hainesiv2: folds=20
SneakyPete85: folds=20
JerseyGuy316: folds=20
AngeloP04: raises 2800 to 4200
nwmdnj: folds=20
TheNewMonkey: folds=20
JJin91: folds=20
smitheea: folds=20
Uncalled bet (2800) returned to AngeloP04
AngeloP04 collected 4900 from pot
AngeloP04: doesn't show hand=20
*** SUMMARY ***
Total pot 4900 | Rake 0=20
Seat 1: smitheea (big blind) folded before Flop
Seat 2: hainesiv2 folded before Flop (didn't bet)
Seat 3: SneakyPete85 folded before Flop (didn't bet)
Seat 4: JerseyGuy316 folded before Flop (didn't bet)
Seat 5: AngeloP04 collected (4900)
Seat 6: nwmdnj folded before Flop (didn't bet)
Seat 7: TheNewMonkey (button) folded before Flop (didn't bet)
Seat 8: JJin91 (small blind) folded before Flop


*********** # 119 **************
PokerStars Hand #170377723881: Tournament #1622573280, $9.10+$0.90 USD =
Hold'em No Limit - Level XVII (700/1400) - 2017/05/25 20:54:35 ET
Table '1622573280 1' 9-max Seat #8 is the button
Seat 1: smitheea (31391 in chips)=20
Seat 2: hainesiv2 (28034 in chips)=20
Seat 3: SneakyPete85 (18340 in chips)=20
Seat 4: JerseyGuy316 (8950 in chips)=20
Seat 5: AngeloP04 (59730 in chips)=20
Seat 6: nwmdnj (5257 in chips)=20
Seat 7: TheNewMonkey (37763 in chips)=20
Seat 8: JJin91 (56380 in chips)=20
smitheea: posts the ante 175
hainesiv2: posts the ante 175
SneakyPete85: posts the ante 175
JerseyGuy316: posts the ante 175
AngeloP04: posts the ante 175
nwmdnj: posts the ante 175
TheNewMonkey: posts the ante 175
JJin91: posts the ante 175
smitheea: posts small blind 700
hainesiv2: posts big blind 1400
*** HOLE CARDS ***
Dealt to JJin91 [9d 2s]
SneakyPete85: folds=20
JerseyGuy316: folds=20
AngeloP04: folds=20
nwmdnj: folds=20
TheNewMonkey: folds=20
JJin91: folds=20
smitheea: raises 2800 to 4200
hainesiv2: folds=20
Uncalled bet (2800) returned to smitheea
smitheea collected 4200 from pot
smitheea: doesn't show hand=20
*** SUMMARY ***
Total pot 4200 | Rake 0=20
Seat 1: smitheea (small blind) collected (4200)
Seat 2: hainesiv2 (big blind) folded before Flop
Seat 3: SneakyPete85 folded before Flop (didn't bet)
Seat 4: JerseyGuy316 folded before Flop (didn't bet)
Seat 5: AngeloP04 folded before Flop (didn't bet)
Seat 6: nwmdnj folded before Flop (didn't bet)
Seat 7: TheNewMonkey folded before Flop (didn't bet)
Seat 8: JJin91 (button) folded before Flop (didn't bet)


*********** # 120 **************
PokerStars Hand #170377725390: Tournament #1622573280, $9.10+$0.90 USD =
Hold'em No Limit - Level XVII (700/1400) - 2017/05/25 21:01:03 ET
Table '1622573280 1' 9-max Seat #1 is the button
Seat 1: smitheea (34016 in chips)=20
Seat 2: hainesiv2 (26459 in chips)=20
Seat 3: SneakyPete85 (18165 in chips)=20
Seat 4: JerseyGuy316 (8775 in chips)=20
Seat 5: AngeloP04 (59555 in chips)=20
Seat 6: nwmdnj (5082 in chips)=20
Seat 7: TheNewMonkey (37588 in chips)=20
Seat 8: JJin91 (56205 in chips)=20
smitheea: posts the ante 175
hainesiv2: posts the ante 175
SneakyPete85: posts the ante 175
JerseyGuy316: posts the ante 175
AngeloP04: posts the ante 175
nwmdnj: posts the ante 175
TheNewMonkey: posts the ante 175
JJin91: posts the ante 175
hainesiv2: posts small blind 700
SneakyPete85: posts big blind 1400
*** HOLE CARDS ***
Dealt to JJin91 [Jd Kh]
JerseyGuy316: folds=20
AngeloP04: folds=20
nwmdnj: raises 3507 to 4907 and is all-in
TheNewMonkey: raises 4893 to 9800
JJin91: folds=20
smitheea: folds=20
hainesiv2: folds=20
SneakyPete85: raises 8190 to 17990 and is all-in
TheNewMonkey: calls 8190
*** FLOP *** [Kc 8s 4d]
*** TURN *** [Kc 8s 4d] [Js]
*** RIVER *** [Kc 8s 4d Js] [Tc]
*** SHOW DOWN ***
SneakyPete85: shows [Qh Qd] (a pair of Queens)
TheNewMonkey: shows [Jc Ah] (a pair of Jacks)
SneakyPete85 collected 26166 from side pot
nwmdnj: shows [Ks 5s] (a pair of Kings)
nwmdnj collected 16821 from main pot
*** SUMMARY ***
Total pot 42987 Main pot 16821. Side pot 26166. | Rake 0=20
Board [Kc 8s 4d Js Tc]
Seat 1: smitheea (button) folded before Flop (didn't bet)
Seat 2: hainesiv2 (small blind) folded before Flop
Seat 3: SneakyPete85 (big blind) showed [Qh Qd] and won (26166) with a =
pair of Queens
Seat 4: JerseyGuy316 folded before Flop (didn't bet)
Seat 5: AngeloP04 folded before Flop (didn't bet)
Seat 6: nwmdnj showed [Ks 5s] and won (16821) with a pair of Kings
Seat 7: TheNewMonkey showed [Jc Ah] and lost with a pair of Jacks
Seat 8: JJin91 folded before Flop (didn't bet)


*********** # 121 **************
PokerStars Hand #170377725824: Tournament #1622573280, $9.10+$0.90 USD =
Hold'em No Limit - Level XVII (700/1400) - 2017/05/25 21:02:25 ET
Table '1622573280 1' 9-max Seat #2 is the button
Seat 1: smitheea (33841 in chips)=20
Seat 2: hainesiv2 (25584 in chips)=20
Seat 3: SneakyPete85 (26166 in chips)=20
Seat 4: JerseyGuy316 (8600 in chips)=20
Seat 5: AngeloP04 (59380 in chips)=20
Seat 6: nwmdnj (16821 in chips)=20
Seat 7: TheNewMonkey (19423 in chips)=20
Seat 8: JJin91 (56030 in chips)=20
smitheea: posts the ante 175
hainesiv2: posts the ante 175
SneakyPete85: posts the ante 175
JerseyGuy316: posts the ante 175
AngeloP04: posts the ante 175
nwmdnj: posts the ante 175
TheNewMonkey: posts the ante 175
JJin91: posts the ante 175
SneakyPete85: posts small blind 700
JerseyGuy316: posts big blind 1400
*** HOLE CARDS ***
Dealt to JJin91 [Js 8d]
AngeloP04: folds=20
nwmdnj: folds=20
TheNewMonkey: folds=20
JJin91: folds=20
smitheea: folds=20
hainesiv2: raises 24009 to 25409 and is all-in
SneakyPete85: folds=20
JerseyGuy316: folds=20
Uncalled bet (24009) returned to hainesiv2
hainesiv2 collected 4900 from pot
hainesiv2: doesn't show hand=20
*** SUMMARY ***
Total pot 4900 | Rake 0=20
Seat 1: smitheea folded before Flop (didn't bet)
Seat 2: hainesiv2 (button) collected (4900)
Seat 3: SneakyPete85 (small blind) folded before Flop
Seat 4: JerseyGuy316 (big blind) folded before Flop
Seat 5: AngeloP04 folded before Flop (didn't bet)
Seat 6: nwmdnj folded before Flop (didn't bet)
Seat 7: TheNewMonkey folded before Flop (didn't bet)
Seat 8: JJin91 folded before Flop (didn't bet)


*********** # 122 **************
PokerStars Hand #170377725917: Tournament #1622573280, $9.10+$0.90 USD =
Hold'em No Limit - Level XVII (700/1400) - 2017/05/25 21:02:43 ET
Table '1622573280 1' 9-max Seat #3 is the button
Seat 1: smitheea (33666 in chips)=20
Seat 2: hainesiv2 (28909 in chips)=20
Seat 3: SneakyPete85 (25291 in chips)=20
Seat 4: JerseyGuy316 (7025 in chips)=20
Seat 5: AngeloP04 (59205 in chips)=20
Seat 6: nwmdnj (16646 in chips)=20
Seat 7: TheNewMonkey (19248 in chips)=20
Seat 8: JJin91 (55855 in chips)=20
smitheea: posts the ante 175
hainesiv2: posts the ante 175
SneakyPete85: posts the ante 175
JerseyGuy316: posts the ante 175
AngeloP04: posts the ante 175
nwmdnj: posts the ante 175
TheNewMonkey: posts the ante 175
JJin91: posts the ante 175
JerseyGuy316: posts small blind 700
AngeloP04: posts big blind 1400
*** HOLE CARDS ***
Dealt to JJin91 [5h Kd]
JerseyGuy316 said, "well this tourney sucked lol"
nwmdnj: folds=20
TheNewMonkey: folds=20
JJin91: folds=20
smitheea: raises 2800 to 4200
hainesiv2: calls 4200
SneakyPete85: folds=20
JerseyGuy316: folds=20
AngeloP04: folds=20
*** FLOP *** [2h Ah 9c]
smitheea: bets 6545
hainesiv2: raises 17989 to 24534 and is all-in
smitheea: calls 17989
*** TURN *** [2h Ah 9c] [Qs]
*** RIVER *** [2h Ah 9c Qs] [5s]
*** SHOW DOWN ***
smitheea: shows [Qh Ad] (two pair, Aces and Queens)
hainesiv2: shows [8s 8c] (a pair of Eights)
smitheea collected 60968 from pot
hainesiv2 finished the tournament in 37th place
*** SUMMARY ***
Total pot 60968 | Rake 0=20
Board [2h Ah 9c Qs 5s]
Seat 1: smitheea showed [Qh Ad] and won (60968) with two pair, Aces and=
 Queens
Seat 2: hainesiv2 showed [8s 8c] and lost with a pair of Eights
Seat 3: SneakyPete85 (button) folded before Flop (didn't bet)
Seat 4: JerseyGuy316 (small blind) folded before Flop
Seat 5: AngeloP04 (big blind) folded before Flop
Seat 6: nwmdnj folded before Flop (didn't bet)
Seat 7: TheNewMonkey folded before Flop (didn't bet)
Seat 8: JJin91 folded before Flop (didn't bet)


*********** # 123 **************
PokerStars Hand #170377726391: Tournament #1622573280, $9.10+$0.90 USD =
Hold'em No Limit - Level XVII (700/1400) - 2017/05/25 21:04:09 ET
Table '1622573280 4' 9-max Seat #4 is the button
Seat 1: AmTheCaptain (54212 in chips)=20
Seat 2: Ch1no354 (101562 in chips) is sitting out
Seat 3: JerseyGuy316 (6150 in chips)=20
Seat 4: Bsgwolfpack4 (61816 in chips)=20
Seat 5: timmay4fn (51363 in chips)=20
Seat 6: JJin91 (55680 in chips)=20
Seat 7: oceangurl2 (58949 in chips)=20
Seat 8: Eowperson (37966 in chips)=20
Seat 9: 18LivEviL81 (52071 in chips)=20
AmTheCaptain: posts the ante 175
Ch1no354: posts the ante 175
JerseyGuy316: posts the ante 175
Bsgwolfpack4: posts the ante 175
timmay4fn: posts the ante 175
JJin91: posts the ante 175
oceangurl2: posts the ante 175
Eowperson: posts the ante 175
18LivEviL81: posts the ante 175
timmay4fn: posts small blind 700
JJin91: posts big blind 1400
*** HOLE CARDS ***
Dealt to JJin91 [Ts Qs]
oceangurl2: folds=20
Eowperson: folds=20
18LivEviL81: folds=20
AmTheCaptain: calls 1400
Ch1no354: folds=20
JerseyGuy316: folds=20
Bsgwolfpack4: calls 1400
timmay4fn: folds=20
JJin91: checks=20
*** FLOP *** [Jh Qd Kd]
JJin91: checks=20
AmTheCaptain: bets 7000
Bsgwolfpack4: folds=20
oceangurl2 said, "hey jersey guy has things gotten better?"
JJin91: folds=20
Uncalled bet (7000) returned to AmTheCaptain
AmTheCaptain collected 6475 from pot
AmTheCaptain: shows [9s Tc] (a straight, Nine to King)
*** SUMMARY ***
Total pot 6475 | Rake 0=20
Board [Jh Qd Kd]
Seat 1: AmTheCaptain collected (6475)
Seat 2: Ch1no354 folded before Flop (didn't bet)
Seat 3: JerseyGuy316 folded before Flop (didn't bet)
Seat 4: Bsgwolfpack4 (button) folded on the Flop
Seat 5: timmay4fn (small blind) folded before Flop
Seat 6: JJin91 (big blind) folded on the Flop
Seat 7: oceangurl2 folded before Flop (didn't bet)
Seat 8: Eowperson folded before Flop (didn't bet)
Seat 9: 18LivEviL81 folded before Flop (didn't bet)


*********** # 124 **************
PokerStars Hand #170377726623: Tournament #1622573280, $9.10+$0.90 USD =
Hold'em No Limit - Level XVII (700/1400) - 2017/05/25 21:04:49 ET
Table '1622573280 4' 9-max Seat #5 is the button
Seat 1: AmTheCaptain (59112 in chips)=20
Seat 2: Ch1no354 (101387 in chips) is sitting out
Seat 3: JerseyGuy316 (5975 in chips)=20
Seat 4: Bsgwolfpack4 (60241 in chips)=20
Seat 5: timmay4fn (50488 in chips)=20
Seat 6: JJin91 (54105 in chips)=20
Seat 7: oceangurl2 (58774 in chips)=20
Seat 8: Eowperson (37791 in chips)=20
Seat 9: 18LivEviL81 (51896 in chips)=20
AmTheCaptain: posts the ante 175
Ch1no354: posts the ante 175
JerseyGuy316: posts the ante 175
Bsgwolfpack4: posts the ante 175
timmay4fn: posts the ante 175
JJin91: posts the ante 175
oceangurl2: posts the ante 175
Eowperson: posts the ante 175
18LivEviL81: posts the ante 175
JJin91: posts small blind 700
oceangurl2: posts big blind 1400
*** HOLE CARDS ***
Dealt to JJin91 [5s 9s]
Eowperson: folds=20
18LivEviL81: folds=20
AmTheCaptain: calls 1400
Ch1no354: folds=20
JerseyGuy316: folds=20
Bsgwolfpack4: calls 1400
Ch1no354 has returned
timmay4fn: folds=20
JJin91: folds=20
oceangurl2: checks=20
*** FLOP *** [Qd Qh Jd]
oceangurl2: checks=20
AmTheCaptain: checks=20
Bsgwolfpack4: bets 3238
oceangurl2: folds=20
AmTheCaptain: folds=20
Uncalled bet (3238) returned to Bsgwolfpack4
Bsgwolfpack4 collected 6475 from pot
Bsgwolfpack4: doesn't show hand=20
*** SUMMARY ***
Total pot 6475 | Rake 0=20
Board [Qd Qh Jd]
Seat 1: AmTheCaptain folded on the Flop
Seat 2: Ch1no354 folded before Flop (didn't bet)
Seat 3: JerseyGuy316 folded before Flop (didn't bet)
Seat 4: Bsgwolfpack4 collected (6475)
Seat 5: timmay4fn (button) folded before Flop (didn't bet)
Seat 6: JJin91 (small blind) folded before Flop
Seat 7: oceangurl2 (big blind) folded on the Flop
Seat 8: Eowperson folded before Flop (didn't bet)
Seat 9: 18LivEviL81 folded before Flop (didn't bet)


*********** # 125 **************
PokerStars Hand #170377726990: Tournament #1622573280, $9.10+$0.90 USD =
Hold'em No Limit - Level XVII (700/1400) - 2017/05/25 21:05:54 ET
Table '1622573280 4' 9-max Seat #6 is the button
Seat 1: AmTheCaptain (57537 in chips)=20
Seat 2: Ch1no354 (101212 in chips)=20
Seat 3: JerseyGuy316 (5800 in chips)=20
Seat 4: Bsgwolfpack4 (65141 in chips)=20
Seat 5: timmay4fn (50313 in chips)=20
Seat 6: JJin91 (53230 in chips)=20
Seat 7: oceangurl2 (57199 in chips)=20
Seat 8: Eowperson (37616 in chips)=20
Seat 9: 18LivEviL81 (51721 in chips)=20
AmTheCaptain: posts the ante 175
Ch1no354: posts the ante 175
JerseyGuy316: posts the ante 175
Bsgwolfpack4: posts the ante 175
timmay4fn: posts the ante 175
JJin91: posts the ante 175
oceangurl2: posts the ante 175
Eowperson: posts the ante 175
18LivEviL81: posts the ante 175
oceangurl2: posts small blind 700
Eowperson: posts big blind 1400
*** HOLE CARDS ***
Dealt to JJin91 [Td Ts]
18LivEviL81: folds=20
AmTheCaptain: folds=20
Ch1no354: folds=20
JerseyGuy316: folds=20
Bsgwolfpack4: folds=20
timmay4fn: raises 1400 to 2800
JJin91: raises 5059 to 7859
oceangurl2: folds=20
Eowperson: folds=20
timmay4fn: folds=20
Uncalled bet (5059) returned to JJin91
JJin91 collected 9275 from pot
JJin91: doesn't show hand=20
*** SUMMARY ***
Total pot 9275 | Rake 0=20
Seat 1: AmTheCaptain folded before Flop (didn't bet)
Seat 2: Ch1no354 folded before Flop (didn't bet)
Seat 3: JerseyGuy316 folded before Flop (didn't bet)
Seat 4: Bsgwolfpack4 folded before Flop (didn't bet)
Seat 5: timmay4fn folded before Flop
Seat 6: JJin91 (button) collected (9275)
Seat 7: oceangurl2 (small blind) folded before Flop
Seat 8: Eowperson (big blind) folded before Flop
Seat 9: 18LivEviL81 folded before Flop (didn't bet)


*********** # 126 **************
PokerStars Hand #170377727287: Tournament #1622573280, $9.10+$0.90 USD =
Hold'em No Limit - Level XVII (700/1400) - 2017/05/25 21:06:41 ET
Table '1622573280 4' 9-max Seat #7 is the button
Seat 1: AmTheCaptain (57362 in chips)=20
Seat 2: Ch1no354 (101037 in chips)=20
Seat 3: JerseyGuy316 (5625 in chips)=20
Seat 4: Bsgwolfpack4 (64966 in chips)=20
Seat 5: timmay4fn (47338 in chips)=20
Seat 6: JJin91 (59530 in chips)=20
Seat 7: oceangurl2 (56324 in chips)=20
Seat 8: Eowperson (36041 in chips)=20
Seat 9: 18LivEviL81 (51546 in chips)=20
AmTheCaptain: posts the ante 175
Ch1no354: posts the ante 175
JerseyGuy316: posts the ante 175
Bsgwolfpack4: posts the ante 175
timmay4fn: posts the ante 175
JJin91: posts the ante 175
oceangurl2: posts the ante 175
Eowperson: posts the ante 175
18LivEviL81: posts the ante 175
Eowperson: posts small blind 700
18LivEviL81: posts big blind 1400
*** HOLE CARDS ***
Dealt to JJin91 [Td Ts]
AmTheCaptain: folds=20
Ch1no354: folds=20
JerseyGuy316: folds=20
Bsgwolfpack4: raises 2925 to 4325
timmay4fn: folds=20
JJin91: calls 4325
oceangurl2: folds=20
Eowperson: calls 3625
18LivEviL81: calls 2925
*** FLOP *** [7c 7d Jc]
Eowperson: checks=20
18LivEviL81: checks=20
Bsgwolfpack4: checks=20
JJin91: bets 10759
Eowperson: folds=20
18LivEviL81: folds=20
Bsgwolfpack4: folds=20
Uncalled bet (10759) returned to JJin91
JJin91 collected 18875 from pot
JJin91: doesn't show hand=20
*** SUMMARY ***
Total pot 18875 | Rake 0=20
Board [7c 7d Jc]
Seat 1: AmTheCaptain folded before Flop (didn't bet)
Seat 2: Ch1no354 folded before Flop (didn't bet)
Seat 3: JerseyGuy316 folded before Flop (didn't bet)
Seat 4: Bsgwolfpack4 folded on the Flop
Seat 5: timmay4fn folded before Flop (didn't bet)
Seat 6: JJin91 collected (18875)
Seat 7: oceangurl2 (button) folded before Flop (didn't bet)
Seat 8: Eowperson (small blind) folded on the Flop
Seat 9: 18LivEviL81 (big blind) folded on the Flop


*********** # 127 **************
PokerStars Hand #170377727756: Tournament #1622573280, $9.10+$0.90 USD =
Hold'em No Limit - Level XVII (700/1400) - 2017/05/25 21:08:02 ET
Table '1622573280 4' 9-max Seat #8 is the button
Seat 1: AmTheCaptain (57187 in chips)=20
Seat 2: Ch1no354 (100862 in chips)=20
Seat 3: JerseyGuy316 (5450 in chips)=20
Seat 4: Bsgwolfpack4 (60466 in chips)=20
Seat 5: timmay4fn (47163 in chips)=20
Seat 6: JJin91 (73905 in chips)=20
Seat 7: oceangurl2 (56149 in chips)=20
Seat 8: Eowperson (31541 in chips)=20
Seat 9: 18LivEviL81 (47046 in chips)=20
AmTheCaptain: posts the ante 175
Ch1no354: posts the ante 175
JerseyGuy316: posts the ante 175
Bsgwolfpack4: posts the ante 175
timmay4fn: posts the ante 175
JJin91: posts the ante 175
oceangurl2: posts the ante 175
Eowperson: posts the ante 175
18LivEviL81: posts the ante 175
18LivEviL81: posts small blind 700
AmTheCaptain: posts big blind 1400
*** HOLE CARDS ***
Dealt to JJin91 [7d 6c]
Ch1no354: folds=20
JerseyGuy316: folds=20
Bsgwolfpack4: raises 2925 to 4325
timmay4fn: folds=20
JJin91: folds=20
oceangurl2: folds=20
Eowperson: folds=20
18LivEviL81: folds=20
AmTheCaptain: folds=20
Uncalled bet (2925) returned to Bsgwolfpack4
Bsgwolfpack4 collected 5075 from pot
Bsgwolfpack4: doesn't show hand=20
*** SUMMARY ***
Total pot 5075 | Rake 0=20
Seat 1: AmTheCaptain (big blind) folded before Flop
Seat 2: Ch1no354 folded before Flop (didn't bet)
Seat 3: JerseyGuy316 folded before Flop (didn't bet)
Seat 4: Bsgwolfpack4 collected (5075)
Seat 5: timmay4fn folded before Flop (didn't bet)
Seat 6: JJin91 folded before Flop (didn't bet)
Seat 7: oceangurl2 folded before Flop (didn't bet)
Seat 8: Eowperson (button) folded before Flop (didn't bet)
Seat 9: 18LivEviL81 (small blind) folded before Flop


*********** # 128 **************
PokerStars Hand #170377727890: Tournament #1622573280, $9.10+$0.90 USD =
Hold'em No Limit - Level XVII (700/1400) - 2017/05/25 21:08:30 ET
Table '1622573280 4' 9-max Seat #9 is the button
Seat 1: AmTheCaptain (55612 in chips)=20
Seat 2: Ch1no354 (100687 in chips)=20
Seat 3: JerseyGuy316 (5275 in chips)=20
Seat 4: Bsgwolfpack4 (63966 in chips)=20
Seat 5: timmay4fn (46988 in chips)=20
Seat 6: JJin91 (73730 in chips)=20
Seat 7: oceangurl2 (55974 in chips)=20
Seat 8: Eowperson (31366 in chips)=20
Seat 9: 18LivEviL81 (46171 in chips)=20
AmTheCaptain: posts the ante 175
Ch1no354: posts the ante 175
JerseyGuy316: posts the ante 175
Bsgwolfpack4: posts the ante 175
timmay4fn: posts the ante 175
JJin91: posts the ante 175
oceangurl2: posts the ante 175
Eowperson: posts the ante 175
18LivEviL81: posts the ante 175
AmTheCaptain: posts small blind 700
Ch1no354: posts big blind 1400
*** HOLE CARDS ***
Dealt to JJin91 [2s 7d]
JerseyGuy316: raises 3700 to 5100 and is all-in
Bsgwolfpack4: folds=20
timmay4fn: folds=20
JJin91: folds=20
oceangurl2: raises 50699 to 55799 and is all-in
Eowperson: folds=20
18LivEviL81: folds=20
AmTheCaptain: folds=20
Ch1no354: folds=20
Uncalled bet (50699) returned to oceangurl2
*** FLOP *** [7s Js Kh]
*** TURN *** [7s Js Kh] [8d]
*** RIVER *** [7s Js Kh 8d] [7c]
*** SHOW DOWN ***
JerseyGuy316: shows [As Jc] (two pair, Jacks and Sevens)
oceangurl2: shows [Jh Jd] (a full house, Jacks full of Sevens)
oceangurl2 collected 13875 from pot
JerseyGuy316 finished the tournament in 34th place
*** SUMMARY ***
Total pot 13875 | Rake 0=20
Board [7s Js Kh 8d 7c]
Seat 1: AmTheCaptain (small blind) folded before Flop
Seat 2: Ch1no354 (big blind) folded before Flop
Seat 3: JerseyGuy316 showed [As Jc] and lost with two pair, Jacks and S=
evens
Seat 4: Bsgwolfpack4 folded before Flop (didn't bet)
Seat 5: timmay4fn folded before Flop (didn't bet)
Seat 6: JJin91 folded before Flop (didn't bet)
Seat 7: oceangurl2 showed [Jh Jd] and won (13875) with a full house, Ja=
cks full of Sevens
Seat 8: Eowperson folded before Flop (didn't bet)
Seat 9: 18LivEviL81 (button) folded before Flop (didn't bet)


*********** # 129 **************
PokerStars Hand #170377728080: Tournament #1622573280, $9.10+$0.90 USD =
Hold'em No Limit - Level XVII (700/1400) - 2017/05/25 21:09:09 ET
Table '1622573280 4' 9-max Seat #1 is the button
Seat 1: AmTheCaptain (54737 in chips)=20
Seat 2: Ch1no354 (99112 in chips)=20
Seat 4: Bsgwolfpack4 (63791 in chips)=20
Seat 5: timmay4fn (46813 in chips)=20
Seat 6: JJin91 (73555 in chips)=20
Seat 7: oceangurl2 (64574 in chips)=20
Seat 8: Eowperson (31191 in chips)=20
Seat 9: 18LivEviL81 (45996 in chips)=20
AmTheCaptain: posts the ante 175
Ch1no354: posts the ante 175
Bsgwolfpack4: posts the ante 175
timmay4fn: posts the ante 175
JJin91: posts the ante 175
oceangurl2: posts the ante 175
Eowperson: posts the ante 175
18LivEviL81: posts the ante 175
Ch1no354: posts small blind 700
Bsgwolfpack4: posts big blind 1400
*** HOLE CARDS ***
Dealt to JJin91 [Ac 6d]
timmay4fn: folds=20
JJin91: folds=20
oceangurl2: folds=20
Ch1no354 said, "nj"
Ch1no354 said, "nh**"
Eowperson: folds=20
18LivEviL81: folds=20
AmTheCaptain: calls 1400
oceangurl2 said, "ty"
Ch1no354: calls 700
Bsgwolfpack4: checks=20
*** FLOP *** [8d 6c 5s]
Ch1no354: bets 2800
Bsgwolfpack4: calls 2800
AmTheCaptain: calls 2800
*** TURN *** [8d 6c 5s] [3d]
Ch1no354: checks=20
Bsgwolfpack4: checks=20
AmTheCaptain: checks=20
*** RIVER *** [8d 6c 5s 3d] [Jh]
Ch1no354: checks=20
Bsgwolfpack4: checks=20
AmTheCaptain: checks=20
*** SHOW DOWN ***
Ch1no354: shows [6h Ad] (a pair of Sixes)
Bsgwolfpack4: mucks hand=20
AmTheCaptain: shows [8c Tc] (a pair of Eights)
AmTheCaptain collected 14000 from pot
*** SUMMARY ***
Total pot 14000 | Rake 0=20
Board [8d 6c 5s 3d Jh]
Seat 1: AmTheCaptain (button) showed [8c Tc] and won (14000) with a pai=
r of Eights
Seat 2: Ch1no354 (small blind) showed [6h Ad] and lost with a pair of S=
ixes
Seat 4: Bsgwolfpack4 (big blind) mucked [5h 7c]
Seat 5: timmay4fn folded before Flop (didn't bet)
Seat 6: JJin91 folded before Flop (didn't bet)
Seat 7: oceangurl2 folded before Flop (didn't bet)
Seat 8: Eowperson folded before Flop (didn't bet)
Seat 9: 18LivEviL81 folded before Flop (didn't bet)


*********** # 130 **************
PokerStars Hand #170377728492: Tournament #1622573280, $9.10+$0.90 USD =
Hold'em No Limit - Level XVIII (800/1600) - 2017/05/25 21:10:26 ET
Table '1622573280 4' 9-max Seat #2 is the button
Seat 1: AmTheCaptain (64362 in chips)=20
Seat 2: Ch1no354 (94737 in chips)=20
Seat 4: Bsgwolfpack4 (59416 in chips)=20
Seat 5: timmay4fn (46638 in chips)=20
Seat 6: JJin91 (73380 in chips)=20
Seat 7: oceangurl2 (64399 in chips)=20
Seat 8: Eowperson (31016 in chips)=20
Seat 9: 18LivEviL81 (45821 in chips)=20
AmTheCaptain: posts the ante 200
Ch1no354: posts the ante 200
Bsgwolfpack4: posts the ante 200
timmay4fn: posts the ante 200
JJin91: posts the ante 200
oceangurl2: posts the ante 200
Eowperson: posts the ante 200
18LivEviL81: posts the ante 200
Bsgwolfpack4: posts small blind 800
timmay4fn: posts big blind 1600
*** HOLE CARDS ***
Dealt to JJin91 [8d 4d]
JJin91: folds=20
oceangurl2: folds=20
Eowperson: folds=20
18LivEviL81: raises 3200 to 4800
AmTheCaptain: folds=20
Ch1no354: folds=20
Bsgwolfpack4: folds=20
timmay4fn: folds=20
Uncalled bet (3200) returned to 18LivEviL81
18LivEviL81 collected 5600 from pot
18LivEviL81: doesn't show hand=20
*** SUMMARY ***
Total pot 5600 | Rake 0=20
Seat 1: AmTheCaptain folded before Flop (didn't bet)
Seat 2: Ch1no354 (button) folded before Flop (didn't bet)
Seat 4: Bsgwolfpack4 (small blind) folded before Flop
Seat 5: timmay4fn (big blind) folded before Flop
Seat 6: JJin91 folded before Flop (didn't bet)
Seat 7: oceangurl2 folded before Flop (didn't bet)
Seat 8: Eowperson folded before Flop (didn't bet)
Seat 9: 18LivEviL81 collected (5600)


*********** # 131 **************
PokerStars Hand #170377728654: Tournament #1622573280, $9.10+$0.90 USD =
Hold'em No Limit - Level XVIII (800/1600) - 2017/05/25 21:10:59 ET
Table '1622573280 4' 9-max Seat #4 is the button
Seat 1: AmTheCaptain (64162 in chips)=20
Seat 2: Ch1no354 (94537 in chips)=20
Seat 4: Bsgwolfpack4 (58416 in chips)=20
Seat 5: timmay4fn (44838 in chips)=20
Seat 6: JJin91 (73180 in chips)=20
Seat 7: oceangurl2 (64199 in chips)=20
Seat 8: Eowperson (30816 in chips)=20
Seat 9: 18LivEviL81 (49621 in chips)=20
AmTheCaptain: posts the ante 200
Ch1no354: posts the ante 200
Bsgwolfpack4: posts the ante 200
timmay4fn: posts the ante 200
JJin91: posts the ante 200
oceangurl2: posts the ante 200
Eowperson: posts the ante 200
18LivEviL81: posts the ante 200
timmay4fn: posts small blind 800
JJin91: posts big blind 1600
*** HOLE CARDS ***
Dealt to JJin91 [Ac 5d]
oceangurl2: folds=20
Eowperson: folds=20
18LivEviL81: raises 1600 to 3200
AmTheCaptain: folds=20
Ch1no354: folds=20
Bsgwolfpack4: folds=20
timmay4fn: folds=20
JJin91: calls 1600
*** FLOP *** [7h 8h Td]
JJin91: checks=20
18LivEviL81: bets 8800
JJin91: folds=20
Uncalled bet (8800) returned to 18LivEviL81
18LivEviL81 collected 8800 from pot
18LivEviL81: doesn't show hand=20
*** SUMMARY ***
Total pot 8800 | Rake 0=20
Board [7h 8h Td]
Seat 1: AmTheCaptain folded before Flop (didn't bet)
Seat 2: Ch1no354 folded before Flop (didn't bet)
Seat 4: Bsgwolfpack4 (button) folded before Flop (didn't bet)
Seat 5: timmay4fn (small blind) folded before Flop
Seat 6: JJin91 (big blind) folded on the Flop
Seat 7: oceangurl2 folded before Flop (didn't bet)
Seat 8: Eowperson folded before Flop (didn't bet)
Seat 9: 18LivEviL81 collected (8800)


*********** # 132 **************
PokerStars Hand #170377728835: Tournament #1622573280, $9.10+$0.90 USD =
Hold'em No Limit - Level XVIII (800/1600) - 2017/05/25 21:11:33 ET
Table '1622573280 4' 9-max Seat #5 is the button
Seat 1: AmTheCaptain (63962 in chips)=20
Seat 2: Ch1no354 (94337 in chips)=20
Seat 4: Bsgwolfpack4 (58216 in chips)=20
Seat 5: timmay4fn (43838 in chips)=20
Seat 6: JJin91 (69780 in chips)=20
Seat 7: oceangurl2 (63999 in chips)=20
Seat 8: Eowperson (30616 in chips)=20
Seat 9: 18LivEviL81 (55021 in chips)=20
AmTheCaptain: posts the ante 200
Ch1no354: posts the ante 200
Bsgwolfpack4: posts the ante 200
timmay4fn: posts the ante 200
JJin91: posts the ante 200
oceangurl2: posts the ante 200
Eowperson: posts the ante 200
18LivEviL81: posts the ante 200
JJin91: posts small blind 800
oceangurl2: posts big blind 1600
*** HOLE CARDS ***
Dealt to JJin91 [Js 4c]
Eowperson: folds=20
18LivEviL81: folds=20
AmTheCaptain: calls 1600
Ch1no354: folds=20
Bsgwolfpack4: folds=20
timmay4fn: folds=20
JJin91: folds=20
oceangurl2: checks=20
*** FLOP *** [Ad 6d 2s]
oceangurl2: checks=20
AmTheCaptain: bets 3200
oceangurl2: folds=20
Uncalled bet (3200) returned to AmTheCaptain
AmTheCaptain collected 5600 from pot
*** SUMMARY ***
Total pot 5600 | Rake 0=20
Board [Ad 6d 2s]
Seat 1: AmTheCaptain collected (5600)
Seat 2: Ch1no354 folded before Flop (didn't bet)
Seat 4: Bsgwolfpack4 folded before Flop (didn't bet)
Seat 5: timmay4fn (button) folded before Flop (didn't bet)
Seat 6: JJin91 (small blind) folded before Flop
Seat 7: oceangurl2 (big blind) folded on the Flop
Seat 8: Eowperson folded before Flop (didn't bet)
Seat 9: 18LivEviL81 folded before Flop (didn't bet)


*********** # 133 **************
PokerStars Hand #170377729028: Tournament #1622573280, $9.10+$0.90 USD =
Hold'em No Limit - Level XVIII (800/1600) - 2017/05/25 21:12:13 ET
Table '1622573280 4' 9-max Seat #6 is the button
Seat 1: AmTheCaptain (67762 in chips)=20
Seat 2: Ch1no354 (94137 in chips)=20
Seat 4: Bsgwolfpack4 (58016 in chips)=20
Seat 5: timmay4fn (43638 in chips)=20
Seat 6: JJin91 (68780 in chips)=20
Seat 7: oceangurl2 (62199 in chips)=20
Seat 8: Eowperson (30416 in chips)=20
Seat 9: 18LivEviL81 (54821 in chips)=20
AmTheCaptain: posts the ante 200
Ch1no354: posts the ante 200
Bsgwolfpack4: posts the ante 200
timmay4fn: posts the ante 200
JJin91: posts the ante 200
oceangurl2: posts the ante 200
Eowperson: posts the ante 200
18LivEviL81: posts the ante 200
oceangurl2: posts small blind 800
Eowperson: posts big blind 1600
*** HOLE CARDS ***
Dealt to JJin91 [Js 4h]
18LivEviL81: folds=20
AmTheCaptain: folds=20
Ch1no354: folds=20
Bsgwolfpack4: folds=20
timmay4fn: calls 1600
JJin91: folds=20
oceangurl2: folds=20
Eowperson: raises 1600 to 3200
timmay4fn: calls 1600
*** FLOP *** [3d Qh 7c]
Eowperson: checks=20
timmay4fn: checks=20
*** TURN *** [3d Qh 7c] [2c]
Eowperson: bets 3200
timmay4fn: calls 3200
*** RIVER *** [3d Qh 7c 2c] [Ad]
Eowperson: bets 15200
timmay4fn: folds=20
Uncalled bet (15200) returned to Eowperson
Eowperson collected 15200 from pot
Eowperson: doesn't show hand=20
*** SUMMARY ***
Total pot 15200 | Rake 0=20
Board [3d Qh 7c 2c Ad]
Seat 1: AmTheCaptain folded before Flop (didn't bet)
Seat 2: Ch1no354 folded before Flop (didn't bet)
Seat 4: Bsgwolfpack4 folded before Flop (didn't bet)
Seat 5: timmay4fn folded on the River
Seat 6: JJin91 (button) folded before Flop (didn't bet)
Seat 7: oceangurl2 (small blind) folded before Flop
Seat 8: Eowperson (big blind) collected (15200)
Seat 9: 18LivEviL81 folded before Flop (didn't bet)


*********** # 134 **************
PokerStars Hand #170377729397: Tournament #1622573280, $9.10+$0.90 USD =
Hold'em No Limit - Level XVIII (800/1600) - 2017/05/25 21:13:18 ET
Table '1622573280 4' 9-max Seat #7 is the button
Seat 1: AmTheCaptain (67562 in chips)=20
Seat 2: Ch1no354 (93937 in chips)=20
Seat 4: Bsgwolfpack4 (57816 in chips)=20
Seat 5: timmay4fn (37038 in chips)=20
Seat 6: JJin91 (68580 in chips)=20
Seat 7: oceangurl2 (61199 in chips)=20
Seat 8: Eowperson (39016 in chips)=20
Seat 9: 18LivEviL81 (54621 in chips)=20
AmTheCaptain: posts the ante 200
Ch1no354: posts the ante 200
Bsgwolfpack4: posts the ante 200
timmay4fn: posts the ante 200
JJin91: posts the ante 200
oceangurl2: posts the ante 200
Eowperson: posts the ante 200
18LivEviL81: posts the ante 200
Eowperson: posts small blind 800
18LivEviL81: posts big blind 1600
*** HOLE CARDS ***
Dealt to JJin91 [5s 3h]
AmTheCaptain: folds=20
Ch1no354: folds=20
Bsgwolfpack4: folds=20
timmay4fn: folds=20
JJin91: folds=20
oceangurl2: folds=20
Eowperson: calls 800
18LivEviL81: checks=20
*** FLOP *** [7c 6s Td]
Eowperson: checks=20
18LivEviL81: bets 1600
Eowperson: calls 1600
*** TURN *** [7c 6s Td] [4h]
Eowperson: checks=20
18LivEviL81: checks=20
*** RIVER *** [7c 6s Td 4h] [5h]
Eowperson: bets 4800
18LivEviL81: folds=20
Uncalled bet (4800) returned to Eowperson
Eowperson collected 8000 from pot
Eowperson: doesn't show hand=20
*** SUMMARY ***
Total pot 8000 | Rake 0=20
Board [7c 6s Td 4h 5h]
Seat 1: AmTheCaptain folded before Flop (didn't bet)
Seat 2: Ch1no354 folded before Flop (didn't bet)
Seat 4: Bsgwolfpack4 folded before Flop (didn't bet)
Seat 5: timmay4fn folded before Flop (didn't bet)
Seat 6: JJin91 folded before Flop (didn't bet)
Seat 7: oceangurl2 (button) folded before Flop (didn't bet)
Seat 8: Eowperson (small blind) collected (8000)
Seat 9: 18LivEviL81 (big blind) folded on the River


*********** # 135 **************
PokerStars Hand #170377729661: Tournament #1622573280, $9.10+$0.90 USD =
Hold'em No Limit - Level XVIII (800/1600) - 2017/05/25 21:14:05 ET
Table '1622573280 4' 9-max Seat #8 is the button
Seat 1: AmTheCaptain (67362 in chips)=20
Seat 2: Ch1no354 (93737 in chips)=20
Seat 4: Bsgwolfpack4 (57616 in chips)=20
Seat 5: timmay4fn (36838 in chips)=20
Seat 6: JJin91 (68380 in chips)=20
Seat 7: oceangurl2 (60999 in chips)=20
Seat 8: Eowperson (43616 in chips)=20
Seat 9: 18LivEviL81 (51221 in chips)=20
AmTheCaptain: posts the ante 200
Ch1no354: posts the ante 200
Bsgwolfpack4: posts the ante 200
timmay4fn: posts the ante 200
JJin91: posts the ante 200
oceangurl2: posts the ante 200
Eowperson: posts the ante 200
18LivEviL81: posts the ante 200
18LivEviL81: posts small blind 800
AmTheCaptain: posts big blind 1600
*** HOLE CARDS ***
Dealt to JJin91 [5h Td]
Ch1no354: folds=20
Bsgwolfpack4: raises 3200 to 4800
timmay4fn: folds=20
JJin91: folds=20
oceangurl2: folds=20
Eowperson: folds=20
18LivEviL81: folds=20
AmTheCaptain: folds=20
Uncalled bet (3200) returned to Bsgwolfpack4
Bsgwolfpack4 collected 5600 from pot
Bsgwolfpack4: doesn't show hand=20
*** SUMMARY ***
Total pot 5600 | Rake 0=20
Seat 1: AmTheCaptain (big blind) folded before Flop
Seat 2: Ch1no354 folded before Flop (didn't bet)
Seat 4: Bsgwolfpack4 collected (5600)
Seat 5: timmay4fn folded before Flop (didn't bet)
Seat 6: JJin91 folded before Flop (didn't bet)
Seat 7: oceangurl2 folded before Flop (didn't bet)
Seat 8: Eowperson (button) folded before Flop (didn't bet)
Seat 9: 18LivEviL81 (small blind) folded before Flop


*********** # 136 **************
PokerStars Hand #170377729835: Tournament #1622573280, $9.10+$0.90 USD =
Hold'em No Limit - Level XVIII (800/1600) - 2017/05/25 21:14:37 ET
Table '1622573280 4' 9-max Seat #9 is the button
Seat 1: AmTheCaptain (65562 in chips)=20
Seat 2: Ch1no354 (93537 in chips)=20
Seat 4: Bsgwolfpack4 (61416 in chips)=20
Seat 5: timmay4fn (36638 in chips)=20
Seat 6: JJin91 (68180 in chips)=20
Seat 7: oceangurl2 (60799 in chips)=20
Seat 8: Eowperson (43416 in chips)=20
Seat 9: 18LivEviL81 (50221 in chips)=20
AmTheCaptain: posts the ante 200
Ch1no354: posts the ante 200
Bsgwolfpack4: posts the ante 200
timmay4fn: posts the ante 200
JJin91: posts the ante 200
oceangurl2: posts the ante 200
Eowperson: posts the ante 200
18LivEviL81: posts the ante 200
AmTheCaptain: posts small blind 800
Ch1no354: posts big blind 1600
*** HOLE CARDS ***
Dealt to JJin91 [7h 9h]
Bsgwolfpack4: folds=20
timmay4fn: folds=20
JJin91: folds=20
oceangurl2: folds=20
Eowperson: folds=20
18LivEviL81: folds=20
AmTheCaptain: folds=20
Uncalled bet (800) returned to Ch1no354
Ch1no354 collected 3200 from pot
Ch1no354: doesn't show hand=20
*** SUMMARY ***
Total pot 3200 | Rake 0=20
Seat 1: AmTheCaptain (small blind) folded before Flop
Seat 2: Ch1no354 (big blind) collected (3200)
Seat 4: Bsgwolfpack4 folded before Flop (didn't bet)
Seat 5: timmay4fn folded before Flop (didn't bet)
Seat 6: JJin91 folded before Flop (didn't bet)
Seat 7: oceangurl2 folded before Flop (didn't bet)
Seat 8: Eowperson folded before Flop (didn't bet)
Seat 9: 18LivEviL81 (button) folded before Flop (didn't bet)


*********** # 137 **************
PokerStars Hand #170379344957: Tournament #1622573280, $9.10+$0.90 USD =
Hold'em No Limit - Level XVIII (800/1600) - 2017/05/25 21:15:18 ET
Table '1622573280 4' 9-max Seat #1 is the button
Seat 1: AmTheCaptain (64562 in chips)=20
Seat 2: Ch1no354 (95737 in chips)=20
Seat 4: Bsgwolfpack4 (61216 in chips)=20
Seat 5: timmay4fn (36438 in chips)=20
Seat 6: JJin91 (67980 in chips)=20
Seat 7: oceangurl2 (60599 in chips)=20
Seat 8: Eowperson (43216 in chips)=20
Seat 9: 18LivEviL81 (50021 in chips)=20
AmTheCaptain: posts the ante 200
Ch1no354: posts the ante 200
Bsgwolfpack4: posts the ante 200
timmay4fn: posts the ante 200
JJin91: posts the ante 200
oceangurl2: posts the ante 200
Eowperson: posts the ante 200
18LivEviL81: posts the ante 200
Ch1no354: posts small blind 800
Bsgwolfpack4: posts big blind 1600
*** HOLE CARDS ***
Dealt to JJin91 [Td Tc]
timmay4fn: folds=20
JJin91: raises 1904 to 3504
oceangurl2: folds=20
Eowperson: raises 4496 to 8000
18LivEviL81: folds=20
AmTheCaptain: folds=20
Ch1no354: folds=20
Bsgwolfpack4: folds=20
JJin91: raises 11872 to 19872
Eowperson: raises 23144 to 43016 and is all-in
JJin91: folds=20
Uncalled bet (23144) returned to Eowperson
Eowperson collected 43744 from pot
*** SUMMARY ***
Total pot 43744 | Rake 0=20
Seat 1: AmTheCaptain (button) folded before Flop (didn't bet)
Seat 2: Ch1no354 (small blind) folded before Flop
Seat 4: Bsgwolfpack4 (big blind) folded before Flop
Seat 5: timmay4fn folded before Flop (didn't bet)
Seat 6: JJin91 folded before Flop
Seat 7: oceangurl2 folded before Flop (didn't bet)
Seat 8: Eowperson collected (43744)
Seat 9: 18LivEviL81 folded before Flop (didn't bet)


*********** # 138 **************
PokerStars Hand #170379345340: Tournament #1622573280, $9.10+$0.90 USD =
Hold'em No Limit - Level XVIII (800/1600) - 2017/05/25 21:16:30 ET
Table '1622573280 4' 9-max Seat #2 is the button
Seat 1: AmTheCaptain (64362 in chips)=20
Seat 2: Ch1no354 (94737 in chips)=20
Seat 4: Bsgwolfpack4 (59416 in chips)=20
Seat 5: timmay4fn (36238 in chips)=20
Seat 6: JJin91 (47908 in chips)=20
Seat 7: oceangurl2 (60399 in chips)=20
Seat 8: Eowperson (66888 in chips)=20
Seat 9: 18LivEviL81 (49821 in chips)=20
AmTheCaptain: posts the ante 200
Ch1no354: posts the ante 200
Bsgwolfpack4: posts the ante 200
timmay4fn: posts the ante 200
JJin91: posts the ante 200
oceangurl2: posts the ante 200
Eowperson: posts the ante 200
18LivEviL81: posts the ante 200
Bsgwolfpack4: posts small blind 800
timmay4fn: posts big blind 1600
*** HOLE CARDS ***
Dealt to JJin91 [Qh 5s]
JJin91: folds=20
oceangurl2: folds=20
Eowperson: folds=20
18LivEviL81: raises 1600 to 3200
AmTheCaptain: folds=20
Ch1no354: calls 3200
Bsgwolfpack4: folds=20
timmay4fn: calls 1600
*** FLOP *** [Jd 7c 8c]
timmay4fn: checks=20
18LivEviL81: bets 6400
Ch1no354: calls 6400
timmay4fn: folds=20
*** TURN *** [Jd 7c 8c] [6s]
18LivEviL81: bets 24800
Ch1no354 has timed out
Ch1no354: folds=20
Uncalled bet (24800) returned to 18LivEviL81
Ch1no354 is sitting out
Ch1no354 has returned
18LivEviL81 collected 24800 from pot
18LivEviL81: doesn't show hand=20
*** SUMMARY ***
Total pot 24800 | Rake 0=20
Board [Jd 7c 8c 6s]
Seat 1: AmTheCaptain folded before Flop (didn't bet)
Seat 2: Ch1no354 (button) folded on the Turn
Seat 4: Bsgwolfpack4 (small blind) folded before Flop
Seat 5: timmay4fn (big blind) folded on the Flop
Seat 6: JJin91 folded before Flop (didn't bet)
Seat 7: oceangurl2 folded before Flop (didn't bet)
Seat 8: Eowperson folded before Flop (didn't bet)
Seat 9: 18LivEviL81 collected (24800)


*********** # 139 **************
PokerStars Hand #170379345694: Tournament #1622573280, $9.10+$0.90 USD =
Hold'em No Limit - Level XVIII (800/1600) - 2017/05/25 21:17:40 ET
Table '1622573280 4' 9-max Seat #4 is the button
Seat 1: AmTheCaptain (64162 in chips)=20
Seat 2: Ch1no354 (84937 in chips)=20
Seat 4: Bsgwolfpack4 (58416 in chips)=20
Seat 5: timmay4fn (32838 in chips)=20
Seat 6: JJin91 (47708 in chips)=20
Seat 7: oceangurl2 (60199 in chips)=20
Seat 8: Eowperson (66688 in chips)=20
Seat 9: 18LivEviL81 (64821 in chips)=20
AmTheCaptain: posts the ante 200
Ch1no354: posts the ante 200
Bsgwolfpack4: posts the ante 200
timmay4fn: posts the ante 200
JJin91: posts the ante 200
oceangurl2: posts the ante 200
Eowperson: posts the ante 200
18LivEviL81: posts the ante 200
timmay4fn: posts small blind 800
JJin91: posts big blind 1600
*** HOLE CARDS ***
Dealt to JJin91 [2d 5d]
oceangurl2: folds=20
Eowperson: calls 1600
18LivEviL81: folds=20
AmTheCaptain: folds=20
Ch1no354: raises 1600 to 3200
Bsgwolfpack4: folds=20
timmay4fn: calls 2400
JJin91: folds=20
Eowperson: calls 1600
*** FLOP *** [9h 5s Jh]
timmay4fn: bets 29438 and is all-in
Eowperson: folds=20
Ch1no354: folds=20
Uncalled bet (29438) returned to timmay4fn
timmay4fn collected 12800 from pot
timmay4fn: doesn't show hand=20
*** SUMMARY ***
Total pot 12800 | Rake 0=20
Board [9h 5s Jh]
Seat 1: AmTheCaptain folded before Flop (didn't bet)
Seat 2: Ch1no354 folded on the Flop
Seat 4: Bsgwolfpack4 (button) folded before Flop (didn't bet)
Seat 5: timmay4fn (small blind) collected (12800)
Seat 6: JJin91 (big blind) folded before Flop
Seat 7: oceangurl2 folded before Flop (didn't bet)
Seat 8: Eowperson folded on the Flop
Seat 9: 18LivEviL81 folded before Flop (didn't bet)


*********** # 140 **************
PokerStars Hand #170379345917: Tournament #1622573280, $9.10+$0.90 USD =
Hold'em No Limit - Level XVIII (800/1600) - 2017/05/25 21:18:26 ET
Table '1622573280 4' 9-max Seat #5 is the button
Seat 1: AmTheCaptain (63962 in chips)=20
Seat 2: Ch1no354 (81537 in chips)=20
Seat 4: Bsgwolfpack4 (58216 in chips)=20
Seat 5: timmay4fn (42238 in chips)=20
Seat 6: JJin91 (45908 in chips)=20
Seat 7: oceangurl2 (59999 in chips)=20
Seat 8: Eowperson (63288 in chips)=20
Seat 9: 18LivEviL81 (64621 in chips)=20
AmTheCaptain: posts the ante 200
Ch1no354: posts the ante 200
Bsgwolfpack4: posts the ante 200
timmay4fn: posts the ante 200
JJin91: posts the ante 200
oceangurl2: posts the ante 200
Eowperson: posts the ante 200
18LivEviL81: posts the ante 200
JJin91: posts small blind 800
oceangurl2: posts big blind 1600
*** HOLE CARDS ***
Dealt to JJin91 [3c Jc]
Eowperson: folds=20
18LivEviL81: folds=20
AmTheCaptain: raises 3200 to 4800
Ch1no354: folds=20
Bsgwolfpack4: folds=20
timmay4fn: folds=20
JJin91: folds=20
oceangurl2: folds=20
Uncalled bet (3200) returned to AmTheCaptain
AmTheCaptain collected 5600 from pot
*** SUMMARY ***
Total pot 5600 | Rake 0=20
Seat 1: AmTheCaptain collected (5600)
Seat 2: Ch1no354 folded before Flop (didn't bet)
Seat 4: Bsgwolfpack4 folded before Flop (didn't bet)
Seat 5: timmay4fn (button) folded before Flop (didn't bet)
Seat 6: JJin91 (small blind) folded before Flop
Seat 7: oceangurl2 (big blind) folded before Flop
Seat 8: Eowperson folded before Flop (didn't bet)
Seat 9: 18LivEviL81 folded before Flop (didn't bet)


*********** # 141 **************
PokerStars Hand #170379346003: Tournament #1622573280, $9.10+$0.90 USD =
Hold'em No Limit - Level XVIII (800/1600) - 2017/05/25 21:18:45 ET
Table '1622573280 4' 9-max Seat #6 is the button
Seat 1: AmTheCaptain (67762 in chips)=20
Seat 2: Ch1no354 (81337 in chips)=20
Seat 4: Bsgwolfpack4 (58016 in chips)=20
Seat 5: timmay4fn (42038 in chips)=20
Seat 6: JJin91 (44908 in chips)=20
Seat 7: oceangurl2 (58199 in chips)=20
Seat 8: Eowperson (63088 in chips)=20
Seat 9: 18LivEviL81 (64421 in chips)=20
AmTheCaptain: posts the ante 200
Ch1no354: posts the ante 200
Bsgwolfpack4: posts the ante 200
timmay4fn: posts the ante 200
JJin91: posts the ante 200
oceangurl2: posts the ante 200
Eowperson: posts the ante 200
18LivEviL81: posts the ante 200
oceangurl2: posts small blind 800
Eowperson: posts big blind 1600
*** HOLE CARDS ***
Dealt to JJin91 [5c Jc]
18LivEviL81: folds=20
AmTheCaptain: folds=20
Ch1no354: folds=20
Bsgwolfpack4: raises 3200 to 4800
timmay4fn: folds=20
JJin91: folds=20
oceangurl2: folds=20
Eowperson: folds=20
Uncalled bet (3200) returned to Bsgwolfpack4
Bsgwolfpack4 collected 5600 from pot
Bsgwolfpack4: doesn't show hand=20
*** SUMMARY ***
Total pot 5600 | Rake 0=20
Seat 1: AmTheCaptain folded before Flop (didn't bet)
Seat 2: Ch1no354 folded before Flop (didn't bet)
Seat 4: Bsgwolfpack4 collected (5600)
Seat 5: timmay4fn folded before Flop (didn't bet)
Seat 6: JJin91 (button) folded before Flop (didn't bet)
Seat 7: oceangurl2 (small blind) folded before Flop
Seat 8: Eowperson (big blind) folded before Flop
Seat 9: 18LivEviL81 folded before Flop (didn't bet)


*********** # 142 **************
PokerStars Hand #170379346120: Tournament #1622573280, $9.10+$0.90 USD =
Hold'em No Limit - Level XVIII (800/1600) - 2017/05/25 21:19:10 ET
Table '1622573280 4' 9-max Seat #7 is the button
Seat 1: AmTheCaptain (67562 in chips)=20
Seat 2: Ch1no354 (81137 in chips)=20
Seat 4: Bsgwolfpack4 (61816 in chips)=20
Seat 5: timmay4fn (41838 in chips)=20
Seat 6: JJin91 (44708 in chips)=20
Seat 7: oceangurl2 (57199 in chips)=20
Seat 8: Eowperson (61288 in chips)=20
Seat 9: 18LivEviL81 (64221 in chips)=20
AmTheCaptain: posts the ante 200
Ch1no354: posts the ante 200
Bsgwolfpack4: posts the ante 200
timmay4fn: posts the ante 200
JJin91: posts the ante 200
oceangurl2: posts the ante 200
Eowperson: posts the ante 200
18LivEviL81: posts the ante 200
Eowperson: posts small blind 800
18LivEviL81: posts big blind 1600
*** HOLE CARDS ***
Dealt to JJin91 [6h 7c]
AmTheCaptain: folds=20
Ch1no354: folds=20
Bsgwolfpack4: folds=20
timmay4fn: folds=20
JJin91: folds=20
oceangurl2: folds=20
Eowperson: calls 800
18LivEviL81: raises 1600 to 3200
Eowperson: calls 1600
*** FLOP *** [Js 9c Ad]
Eowperson: checks=20
18LivEviL81: bets 1600
Eowperson: calls 1600
*** TURN *** [Js 9c Ad] [3d]
Eowperson: checks=20
18LivEviL81: checks=20
*** RIVER *** [Js 9c Ad 3d] [Ts]
Eowperson: bets 4800
18LivEviL81: folds=20
Uncalled bet (4800) returned to Eowperson
Eowperson collected 11200 from pot
Eowperson: shows [7d]
*** SUMMARY ***
Total pot 11200 | Rake 0=20
Board [Js 9c Ad 3d Ts]
Seat 1: AmTheCaptain folded before Flop (didn't bet)
Seat 2: Ch1no354 folded before Flop (didn't bet)
Seat 4: Bsgwolfpack4 folded before Flop (didn't bet)
Seat 5: timmay4fn folded before Flop (didn't bet)
Seat 6: JJin91 folded before Flop (didn't bet)
Seat 7: oceangurl2 (button) folded before Flop (didn't bet)
Seat 8: Eowperson (small blind) collected (11200)
Seat 9: 18LivEviL81 (big blind) folded on the River


*********** # 143 **************
PokerStars Hand #170379346294: Tournament #1622573280, $9.10+$0.90 USD =
Hold'em No Limit - Level XVIII (800/1600) - 2017/05/25 21:19:49 ET
Table '1622573280 4' 9-max Seat #8 is the button
Seat 1: AmTheCaptain (67362 in chips)=20
Seat 2: Ch1no354 (80937 in chips)=20
Seat 4: Bsgwolfpack4 (61616 in chips)=20
Seat 5: timmay4fn (41638 in chips)=20
Seat 6: JJin91 (44508 in chips)=20
Seat 7: oceangurl2 (56999 in chips)=20
Seat 8: Eowperson (67488 in chips)=20
Seat 9: 18LivEviL81 (59221 in chips)=20
AmTheCaptain: posts the ante 200
Ch1no354: posts the ante 200
Bsgwolfpack4: posts the ante 200
timmay4fn: posts the ante 200
JJin91: posts the ante 200
oceangurl2: posts the ante 200
Eowperson: posts the ante 200
18LivEviL81: posts the ante 200
18LivEviL81: posts small blind 800
AmTheCaptain: posts big blind 1600
*** HOLE CARDS ***
Dealt to JJin91 [9c Ts]
Ch1no354: folds=20
Bsgwolfpack4: folds=20
timmay4fn: raises 1600 to 3200
JJin91: folds=20
oceangurl2: folds=20
Eowperson: folds=20
18LivEviL81: folds=20
AmTheCaptain: calls 1600
*** FLOP *** [7s 8c 9s]
AmTheCaptain: checks=20
timmay4fn: bets 3855
AmTheCaptain: calls 3855
*** TURN *** [7s 8c 9s] [5s]
AmTheCaptain: checks=20
timmay4fn: checks=20
*** RIVER *** [7s 8c 9s 5s] [8s]
AmTheCaptain: checks=20
timmay4fn: bets 4555
AmTheCaptain: folds=20
Uncalled bet (4555) returned to timmay4fn
timmay4fn collected 16510 from pot
timmay4fn: doesn't show hand=20
*** SUMMARY ***
Total pot 16510 | Rake 0=20
Board [7s 8c 9s 5s 8s]
Seat 1: AmTheCaptain (big blind) folded on the River
Seat 2: Ch1no354 folded before Flop (didn't bet)
Seat 4: Bsgwolfpack4 folded before Flop (didn't bet)
Seat 5: timmay4fn collected (16510)
Seat 6: JJin91 folded before Flop (didn't bet)
Seat 7: oceangurl2 folded before Flop (didn't bet)
Seat 8: Eowperson (button) folded before Flop (didn't bet)
Seat 9: 18LivEviL81 (small blind) folded before Flop


*********** # 144 **************
PokerStars Hand #170379346573: Tournament #1622573280, $9.10+$0.90 USD =
Hold'em No Limit - Level XIX (1000/2000) - 2017/05/25 21:20:50 ET
Table '1622573280 4' 9-max Seat #9 is the button
Seat 1: AmTheCaptain (60107 in chips)=20
Seat 2: Ch1no354 (80737 in chips)=20
Seat 4: Bsgwolfpack4 (61416 in chips)=20
Seat 5: timmay4fn (50893 in chips)=20
Seat 6: JJin91 (44308 in chips)=20
Seat 7: oceangurl2 (56799 in chips)=20
Seat 8: Eowperson (67288 in chips)=20
Seat 9: 18LivEviL81 (58221 in chips)=20
AmTheCaptain: posts the ante 250
Ch1no354: posts the ante 250
Bsgwolfpack4: posts the ante 250
timmay4fn: posts the ante 250
JJin91: posts the ante 250
oceangurl2: posts the ante 250
Eowperson: posts the ante 250
18LivEviL81: posts the ante 250
AmTheCaptain: posts small blind 1000
Ch1no354: posts big blind 2000
*** HOLE CARDS ***
Dealt to JJin91 [Qs 3h]
Bsgwolfpack4: folds=20
timmay4fn: folds=20
JJin91: folds=20
oceangurl2: folds=20
Eowperson: folds=20
18LivEviL81: raises 2000 to 4000
AmTheCaptain: folds=20
Ch1no354: folds [3d 4h]
Uncalled bet (2000) returned to 18LivEviL81
18LivEviL81 collected 7000 from pot
18LivEviL81: doesn't show hand=20
*** SUMMARY ***
Total pot 7000 | Rake 0=20
Seat 1: AmTheCaptain (small blind) folded before Flop
Seat 2: Ch1no354 (big blind) folded before Flop
Seat 4: Bsgwolfpack4 folded before Flop (didn't bet)
Seat 5: timmay4fn folded before Flop (didn't bet)
Seat 6: JJin91 folded before Flop (didn't bet)
Seat 7: oceangurl2 folded before Flop (didn't bet)
Seat 8: Eowperson folded before Flop (didn't bet)
Seat 9: 18LivEviL81 (button) collected (7000)


*********** # 145 **************
PokerStars Hand #170379346741: Tournament #1622573280, $9.10+$0.90 USD =
Hold'em No Limit - Level XIX (1000/2000) - 2017/05/25 21:21:25 ET
Table '1622573280 4' 9-max Seat #1 is the button
Seat 1: AmTheCaptain (58857 in chips)=20
Seat 2: Ch1no354 (78487 in chips)=20
Seat 4: Bsgwolfpack4 (61166 in chips)=20
Seat 5: timmay4fn (50643 in chips)=20
Seat 6: JJin91 (44058 in chips)=20
Seat 7: oceangurl2 (56549 in chips)=20
Seat 8: Eowperson (67038 in chips)=20
Seat 9: 18LivEviL81 (62971 in chips)=20
AmTheCaptain: posts the ante 250
Ch1no354: posts the ante 250
Bsgwolfpack4: posts the ante 250
timmay4fn: posts the ante 250
JJin91: posts the ante 250
oceangurl2: posts the ante 250
Eowperson: posts the ante 250
18LivEviL81: posts the ante 250
Ch1no354: posts small blind 1000
Bsgwolfpack4: posts big blind 2000
*** HOLE CARDS ***
Dealt to JJin91 [Ts As]
timmay4fn: calls 2000
JJin91: raises 2380 to 4380
oceangurl2: folds=20
Eowperson: folds=20
18LivEviL81: folds=20
AmTheCaptain: folds=20
Ch1no354: folds=20
Bsgwolfpack4: folds=20
timmay4fn: calls 2380
*** FLOP *** [3c 2d Qs]
timmay4fn: checks=20
JJin91: bets 7843
timmay4fn: folds=20
Uncalled bet (7843) returned to JJin91
JJin91 collected 13760 from pot
JJin91: doesn't show hand=20
*** SUMMARY ***
Total pot 13760 | Rake 0=20
Board [3c 2d Qs]
Seat 1: AmTheCaptain (button) folded before Flop (didn't bet)
Seat 2: Ch1no354 (small blind) folded before Flop
Seat 4: Bsgwolfpack4 (big blind) folded before Flop
Seat 5: timmay4fn folded on the Flop
Seat 6: JJin91 collected (13760)
Seat 7: oceangurl2 folded before Flop (didn't bet)
Seat 8: Eowperson folded before Flop (didn't bet)
Seat 9: 18LivEviL81 folded before Flop (didn't bet)


*********** # 146 **************
PokerStars Hand #170379346948: Tournament #1622573280, $9.10+$0.90 USD =
Hold'em No Limit - Level XIX (1000/2000) - 2017/05/25 21:22:10 ET
Table '1622573280 4' 9-max Seat #2 is the button
Seat 1: AmTheCaptain (58607 in chips)=20
Seat 2: Ch1no354 (77237 in chips)=20
Seat 4: Bsgwolfpack4 (58916 in chips)=20
Seat 5: timmay4fn (46013 in chips)=20
Seat 6: JJin91 (53188 in chips)=20
Seat 7: oceangurl2 (56299 in chips)=20
Seat 8: Eowperson (66788 in chips)=20
Seat 9: 18LivEviL81 (62721 in chips)=20
AmTheCaptain: posts the ante 250
Ch1no354: posts the ante 250
Bsgwolfpack4: posts the ante 250
timmay4fn: posts the ante 250
JJin91: posts the ante 250
oceangurl2: posts the ante 250
Eowperson: posts the ante 250
18LivEviL81: posts the ante 250
Bsgwolfpack4: posts small blind 1000
timmay4fn: posts big blind 2000
*** HOLE CARDS ***
Dealt to JJin91 [9d Js]
JJin91: folds=20
oceangurl2: folds=20
Eowperson: folds=20
18LivEviL81: folds=20
AmTheCaptain: raises 4000 to 6000
Ch1no354: raises 4000 to 10000
Bsgwolfpack4: folds=20
timmay4fn: folds=20
AmTheCaptain: calls 4000
*** FLOP *** [Qs 6s 7h]
AmTheCaptain: bets 48357 and is all-in
Ch1no354: folds=20
Uncalled bet (48357) returned to AmTheCaptain
AmTheCaptain collected 25000 from pot
AmTheCaptain: shows [7s 6c]
Ch1no354 said, "yea rihgt"
*** SUMMARY ***
Total pot 25000 | Rake 0=20
Board [Qs 6s 7h]
Seat 1: AmTheCaptain collected (25000)
Seat 2: Ch1no354 (button) folded on the Flop
Seat 4: Bsgwolfpack4 (small blind) folded before Flop
Seat 5: timmay4fn (big blind) folded before Flop
Seat 6: JJin91 folded before Flop (didn't bet)
Seat 7: oceangurl2 folded before Flop (didn't bet)
Seat 8: Eowperson folded before Flop (didn't bet)
Seat 9: 18LivEviL81 folded before Flop (didn't bet)


*********** # 147 **************
PokerStars Hand #170379347208: Tournament #1622573280, $9.10+$0.90 USD =
Hold'em No Limit - Level XIX (1000/2000) - 2017/05/25 21:23:07 ET
Table '1622573280 4' 9-max Seat #4 is the button
Seat 1: AmTheCaptain (73357 in chips)=20
Seat 2: Ch1no354 (66987 in chips)=20
Seat 4: Bsgwolfpack4 (57666 in chips)=20
Seat 5: timmay4fn (43763 in chips)=20
Seat 6: JJin91 (52938 in chips)=20
Seat 7: oceangurl2 (56049 in chips)=20
Seat 8: Eowperson (66538 in chips)=20
Seat 9: 18LivEviL81 (62471 in chips)=20
AmTheCaptain: posts the ante 250
Ch1no354: posts the ante 250
Bsgwolfpack4: posts the ante 250
timmay4fn: posts the ante 250
JJin91: posts the ante 250
oceangurl2: posts the ante 250
Eowperson: posts the ante 250
18LivEviL81: posts the ante 250
timmay4fn: posts small blind 1000
JJin91: posts big blind 2000
*** HOLE CARDS ***
Dealt to JJin91 [Ah 9h]
Ch1no354 said, "call a 10k pot with thst bull shit"
oceangurl2: calls 2000
Eowperson: folds=20
18LivEviL81: folds=20
AmTheCaptain: folds=20
Ch1no354 said, "fkn donkey"
Ch1no354: folds=20
Bsgwolfpack4: folds=20
timmay4fn: calls 1000
AmTheCaptain said, "I raised it first"
Ch1no354 said, "with ass"
Ch1no354 said, "exactly"
JJin91: raises 4281 to 6281
AmTheCaptain said, "I have the right to call it"
oceangurl2: folds=20
timmay4fn: folds=20
Uncalled bet (4281) returned to JJin91
JJin91 collected 8000 from pot
JJin91: doesn't show hand=20
Ch1no354 said, "i guess lmao"
*** SUMMARY ***
Total pot 8000 | Rake 0=20
Seat 1: AmTheCaptain folded before Flop (didn't bet)
Seat 2: Ch1no354 folded before Flop (didn't bet)
Seat 4: Bsgwolfpack4 (button) folded before Flop (didn't bet)
Seat 5: timmay4fn (small blind) folded before Flop
Seat 6: JJin91 (big blind) collected (8000)
Seat 7: oceangurl2 folded before Flop
Seat 8: Eowperson folded before Flop (didn't bet)
Seat 9: 18LivEviL81 folded before Flop (didn't bet)


*********** # 148 **************
PokerStars Hand #170379347454: Tournament #1622573280, $9.10+$0.90 USD =
Hold'em No Limit - Level XIX (1000/2000) - 2017/05/25 21:23:55 ET
Table '1622573280 4' 9-max Seat #5 is the button
Seat 1: AmTheCaptain (73107 in chips)=20
Seat 2: Ch1no354 (66737 in chips)=20
Seat 4: Bsgwolfpack4 (57416 in chips)=20
Seat 5: timmay4fn (41513 in chips)=20
Seat 6: JJin91 (58688 in chips)=20
Seat 7: oceangurl2 (53799 in chips)=20
Seat 8: Eowperson (66288 in chips)=20
Seat 9: 18LivEviL81 (62221 in chips)=20
AmTheCaptain: posts the ante 250
Ch1no354: posts the ante 250
Bsgwolfpack4: posts the ante 250
timmay4fn: posts the ante 250
JJin91: posts the ante 250
oceangurl2: posts the ante 250
Eowperson: posts the ante 250
18LivEviL81: posts the ante 250
JJin91: posts small blind 1000
oceangurl2: posts big blind 2000
*** HOLE CARDS ***
Dealt to JJin91 [7d 9s]
AmTheCaptain said, "u stupid"
Ch1no354 said, "shoudlve shoved on  ur bum ass"
Eowperson: folds=20
18LivEviL81: folds=20
AmTheCaptain: raises 8000 to 10000
Ch1no354: folds=20
Bsgwolfpack4: folds=20
timmay4fn: folds=20
JJin91: folds=20
oceangurl2: folds=20
Uncalled bet (8000) returned to AmTheCaptain
AmTheCaptain collected 7000 from pot
*** SUMMARY ***
Total pot 7000 | Rake 0=20
Seat 1: AmTheCaptain collected (7000)
Seat 2: Ch1no354 folded before Flop (didn't bet)
Seat 4: Bsgwolfpack4 folded before Flop (didn't bet)
Seat 5: timmay4fn (button) folded before Flop (didn't bet)
Seat 6: JJin91 (small blind) folded before Flop
Seat 7: oceangurl2 (big blind) folded before Flop
Seat 8: Eowperson folded before Flop (didn't bet)
Seat 9: 18LivEviL81 folded before Flop (didn't bet)


*********** # 149 **************
PokerStars Hand #170379347635: Tournament #1622573280, $9.10+$0.90 USD =
Hold'em No Limit - Level XIX (1000/2000) - 2017/05/25 21:24:27 ET
Table '1622573280 4' 9-max Seat #6 is the button
Seat 1: AmTheCaptain (77857 in chips)=20
Seat 2: Ch1no354 (66487 in chips)=20
Seat 4: Bsgwolfpack4 (57166 in chips)=20
Seat 5: timmay4fn (41263 in chips)=20
Seat 6: JJin91 (57438 in chips)=20
Seat 7: oceangurl2 (51549 in chips)=20
Seat 8: Eowperson (66038 in chips)=20
Seat 9: 18LivEviL81 (61971 in chips)=20
AmTheCaptain: posts the ante 250
Ch1no354: posts the ante 250
Bsgwolfpack4: posts the ante 250
timmay4fn: posts the ante 250
JJin91: posts the ante 250
oceangurl2: posts the ante 250
Eowperson: posts the ante 250
18LivEviL81: posts the ante 250
oceangurl2: posts small blind 1000
Eowperson: posts big blind 2000
*** HOLE CARDS ***
Dealt to JJin91 [4d 8c]
18LivEviL81: raises 4000 to 6000
AmTheCaptain: folds=20
Ch1no354: folds=20
Bsgwolfpack4: folds=20
timmay4fn: folds=20
JJin91: folds=20
AmTheCaptain said, "if u shoved pre flop would have folded"
oceangurl2: folds=20
Eowperson: calls 4000
*** FLOP *** [5c As 3s]
Eowperson: checks=20
18LivEviL81: bets 10000
Eowperson: folds=20
Uncalled bet (10000) returned to 18LivEviL81
18LivEviL81 collected 15000 from pot
18LivEviL81: doesn't show hand=20
*** SUMMARY ***
Total pot 15000 | Rake 0=20
Board [5c As 3s]
Seat 1: AmTheCaptain folded before Flop (didn't bet)
Seat 2: Ch1no354 folded before Flop (didn't bet)
Seat 4: Bsgwolfpack4 folded before Flop (didn't bet)
Seat 5: timmay4fn folded before Flop (didn't bet)
Seat 6: JJin91 (button) folded before Flop (didn't bet)
Seat 7: oceangurl2 (small blind) folded before Flop
Seat 8: Eowperson (big blind) folded on the Flop
Seat 9: 18LivEviL81 collected (15000)


*********** # 150 **************
PokerStars Hand #170379347898: Tournament #1622573280, $9.10+$0.90 USD =
Hold'em No Limit - Level XIX (1000/2000) - 2017/05/25 21:25:20 ET
Table '1622573280 4' 9-max Seat #7 is the button
Seat 1: AmTheCaptain (77607 in chips)=20
Seat 2: Ch1no354 (66237 in chips)=20
Seat 4: Bsgwolfpack4 (56916 in chips)=20
Seat 5: timmay4fn (41013 in chips)=20
Seat 6: JJin91 (57188 in chips)=20
Seat 7: oceangurl2 (50299 in chips)=20
Seat 8: Eowperson (59788 in chips)=20
Seat 9: 18LivEviL81 (70721 in chips)=20
AmTheCaptain: posts the ante 250
Ch1no354: posts the ante 250
Bsgwolfpack4: posts the ante 250
timmay4fn: posts the ante 250
JJin91: posts the ante 250
oceangurl2: posts the ante 250
Eowperson: posts the ante 250
18LivEviL81: posts the ante 250
Eowperson: posts small blind 1000
18LivEviL81: posts big blind 2000
*** HOLE CARDS ***
Dealt to JJin91 [Js 6c]
AmTheCaptain said, "I am not gonna fold after putting 6k"
AmTheCaptain: folds=20
Ch1no354: folds=20
Bsgwolfpack4: folds=20
timmay4fn: raises 3889 to 5889
JJin91: folds=20
AmTheCaptain said, "only 4 more to call"
oceangurl2: folds=20
Eowperson: calls 4889
18LivEviL81: folds=20
*** FLOP *** [8c Th 5h]
Eowperson: checks=20
Ch1no354 said, "ok bro stop tryin to expkain ur donkyniess i get it 76 =
off raise"
Ch1no354 said, "got u"
timmay4fn: bets 34874 and is all-in
Eowperson: folds=20
Uncalled bet (34874) returned to timmay4fn
timmay4fn collected 15778 from pot
timmay4fn: doesn't show hand=20
*** SUMMARY ***
Total pot 15778 | Rake 0=20
Board [8c Th 5h]
Seat 1: AmTheCaptain folded before Flop (didn't bet)
Seat 2: Ch1no354 folded before Flop (didn't bet)
Seat 4: Bsgwolfpack4 folded before Flop (didn't bet)
Seat 5: timmay4fn collected (15778)
Seat 6: JJin91 folded before Flop (didn't bet)
Seat 7: oceangurl2 (button) folded before Flop (didn't bet)
Seat 8: Eowperson (small blind) folded on the Flop
Seat 9: 18LivEviL81 (big blind) folded before Flop


*********** # 151 **************
PokerStars Hand #170379348097: Tournament #1622573280, $9.10+$0.90 USD =
Hold'em No Limit - Level XIX (1000/2000) - 2017/05/25 21:26:03 ET
Table '1622573280 4' 9-max Seat #8 is the button
Seat 1: AmTheCaptain (77357 in chips)=20
Seat 2: Ch1no354 (65987 in chips)=20
Seat 4: Bsgwolfpack4 (56666 in chips)=20
Seat 5: timmay4fn (50652 in chips)=20
Seat 6: JJin91 (56938 in chips)=20
Seat 7: oceangurl2 (50049 in chips)=20
Seat 8: Eowperson (53649 in chips)=20
Seat 9: 18LivEviL81 (68471 in chips)=20
AmTheCaptain: posts the ante 250
Ch1no354: posts the ante 250
Bsgwolfpack4: posts the ante 250
timmay4fn: posts the ante 250
JJin91: posts the ante 250
oceangurl2: posts the ante 250
Eowperson: posts the ante 250
18LivEviL81: posts the ante 250
18LivEviL81: posts small blind 1000
AmTheCaptain: posts big blind 2000
*** HOLE CARDS ***
Dealt to JJin91 [6c Jh]
Ch1no354: folds=20
Bsgwolfpack4: raises 4000 to 6000
timmay4fn: folds=20
JJin91: folds=20
AmTheCaptain said, "it happens bro. get over it"
oceangurl2: folds=20
Eowperson: folds=20
18LivEviL81: folds=20
AmTheCaptain: calls 4000
*** FLOP *** [3c 6h Qh]
AmTheCaptain: checks=20
Bsgwolfpack4: checks=20
*** TURN *** [3c 6h Qh] [9c]
AmTheCaptain: checks=20
timmay4fn said, "two more until the money, be happy guys!"
Bsgwolfpack4: checks=20
*** RIVER *** [3c 6h Qh 9c] [2c]
AmTheCaptain: checks=20
Bsgwolfpack4: checks=20
*** SHOW DOWN ***
AmTheCaptain: shows [Js Kh] (high card King)
Bsgwolfpack4: shows [Kc Ad] (high card Ace)
Bsgwolfpack4 collected 15000 from pot
AmTheCaptain said, "lol"
*** SUMMARY ***
Total pot 15000 | Rake 0=20
Board [3c 6h Qh 9c 2c]
Seat 1: AmTheCaptain (big blind) showed [Js Kh] and lost with high card=
 King
Seat 2: Ch1no354 folded before Flop (didn't bet)
Seat 4: Bsgwolfpack4 showed [Kc Ad] and won (15000) with high card Ace
Seat 5: timmay4fn folded before Flop (didn't bet)
Seat 6: JJin91 folded before Flop (didn't bet)
Seat 7: oceangurl2 folded before Flop (didn't bet)
Seat 8: Eowperson (button) folded before Flop (didn't bet)
Seat 9: 18LivEviL81 (small blind) folded before Flop


*********** # 152 **************
PokerStars Hand #170379348296: Tournament #1622573280, $9.10+$0.90 USD =
Hold'em No Limit - Level XIX (1000/2000) - 2017/05/25 21:26:46 ET
Table '1622573280 4' 9-max Seat #9 is the button
Seat 1: AmTheCaptain (71107 in chips)=20
Seat 2: Ch1no354 (65737 in chips)=20
Seat 4: Bsgwolfpack4 (65416 in chips)=20
Seat 5: timmay4fn (50402 in chips)=20
Seat 6: JJin91 (56688 in chips)=20
Seat 7: oceangurl2 (49799 in chips)=20
Seat 8: Eowperson (53399 in chips)=20
Seat 9: 18LivEviL81 (67221 in chips)=20
AmTheCaptain: posts the ante 250
Ch1no354: posts the ante 250
Bsgwolfpack4: posts the ante 250
timmay4fn: posts the ante 250
JJin91: posts the ante 250
oceangurl2: posts the ante 250
Eowperson: posts the ante 250
18LivEviL81: posts the ante 250
AmTheCaptain: posts small blind 1000
Ch1no354: posts big blind 2000
*** HOLE CARDS ***
Dealt to JJin91 [5s 8d]
Bsgwolfpack4: folds=20
timmay4fn: folds=20
JJin91: folds=20
AmTheCaptain said, "true"
oceangurl2: folds=20
Eowperson: folds=20
18LivEviL81: raises 2000 to 4000
AmTheCaptain: folds=20
Ch1no354: calls 2000
*** FLOP *** [Qh 3h Qd]
Ch1no354: bets 4000
18LivEviL81: folds=20
Uncalled bet (4000) returned to Ch1no354
Ch1no354 collected 11000 from pot
Ch1no354: doesn't show hand=20
*** SUMMARY ***
Total pot 11000 | Rake 0=20
Board [Qh 3h Qd]
Seat 1: AmTheCaptain (small blind) folded before Flop
Seat 2: Ch1no354 (big blind) collected (11000)
Seat 4: Bsgwolfpack4 folded before Flop (didn't bet)
Seat 5: timmay4fn folded before Flop (didn't bet)
Seat 6: JJin91 folded before Flop (didn't bet)
Seat 7: oceangurl2 folded before Flop (didn't bet)
Seat 8: Eowperson folded before Flop (didn't bet)
Seat 9: 18LivEviL81 (button) folded on the Flop


*********** # 153 **************
PokerStars Hand #170379348505: Tournament #1622573280, $9.10+$0.90 USD =
Hold'em No Limit - Level XIX (1000/2000) - 2017/05/25 21:27:28 ET
Table '1622573280 4' 9-max Seat #1 is the button
Seat 1: AmTheCaptain (69857 in chips)=20
Seat 2: Ch1no354 (72487 in chips)=20
Seat 4: Bsgwolfpack4 (65166 in chips)=20
Seat 5: timmay4fn (50152 in chips)=20
Seat 6: JJin91 (56438 in chips)=20
Seat 7: oceangurl2 (49549 in chips)=20
Seat 8: Eowperson (53149 in chips)=20
Seat 9: 18LivEviL81 (62971 in chips)=20
AmTheCaptain: posts the ante 250
Ch1no354: posts the ante 250
Bsgwolfpack4: posts the ante 250
timmay4fn: posts the ante 250
JJin91: posts the ante 250
oceangurl2: posts the ante 250
Eowperson: posts the ante 250
18LivEviL81: posts the ante 250
Ch1no354: posts small blind 1000
Bsgwolfpack4: posts big blind 2000
*** HOLE CARDS ***
Dealt to JJin91 [4s 6c]
timmay4fn: calls 2000
JJin91: folds=20
oceangurl2: folds=20
Eowperson: folds=20
18LivEviL81: folds=20
AmTheCaptain: calls 2000
Ch1no354: calls 1000
Bsgwolfpack4: checks=20
*** FLOP *** [Kd Jc Ac]
Ch1no354: checks=20
Bsgwolfpack4: checks=20
timmay4fn: bets 8000
Bsgwolfpack4 said, "TIMMAY TIMMAY"
Bsgwolfpack4 said, "LOL"
AmTheCaptain: folds=20
Ch1no354: folds=20
Bsgwolfpack4 said, "LORDS OF THE UNDERWORLD, DARKNESS FILLS MY HEAT WIT=
H PAIN"
AmTheCaptain said, "laid down weak Ace lol"
Bsgwolfpack4: calls 8000
*** TURN *** [Kd Jc Ac] [Ts]
Bsgwolfpack4: checks=20
timmay4fn: bets 8000
AmTheCaptain said, "sorry"
Bsgwolfpack4: calls 8000
*** RIVER *** [Kd Jc Ac Ts] [5c]
Bsgwolfpack4: checks=20
timmay4fn: checks=20
*** SHOW DOWN ***
Bsgwolfpack4: shows [Jd Ks] (two pair, Kings and Jacks)
timmay4fn: shows [Kc Js] (two pair, Kings and Jacks)
Bsgwolfpack4 collected 21000 from pot
timmay4fn collected 21000 from pot
*** SUMMARY ***
Total pot 42000 | Rake 0=20
Board [Kd Jc Ac Ts 5c]
Seat 1: AmTheCaptain (button) folded on the Flop
Seat 2: Ch1no354 (small blind) folded on the Flop
Seat 4: Bsgwolfpack4 (big blind) showed [Jd Ks] and won (21000) with tw=
o pair, Kings and Jacks
Seat 5: timmay4fn showed [Kc Js] and won (21000) with two pair, Kings a=
nd Jacks
Seat 6: JJin91 folded before Flop (didn't bet)
Seat 7: oceangurl2 folded before Flop (didn't bet)
Seat 8: Eowperson folded before Flop (didn't bet)
Seat 9: 18LivEviL81 folded before Flop (didn't bet)


*********** # 154 **************
PokerStars Hand #170379349119: Tournament #1622573280, $9.10+$0.90 USD =
Hold'em No Limit - Level XIX (1000/2000) - 2017/05/25 21:29:26 ET
Table '1622573280 4' 9-max Seat #2 is the button
Seat 1: AmTheCaptain (67607 in chips)=20
Seat 2: Ch1no354 (70237 in chips)=20
Seat 4: Bsgwolfpack4 (67916 in chips)=20
Seat 5: timmay4fn (52902 in chips)=20
Seat 6: JJin91 (56188 in chips)=20
Seat 7: oceangurl2 (49299 in chips)=20
Seat 9: 18LivEviL81 (62721 in chips)=20
AmTheCaptain: posts the ante 250
Ch1no354: posts the ante 250
Bsgwolfpack4: posts the ante 250
timmay4fn: posts the ante 250
JJin91: posts the ante 250
oceangurl2: posts the ante 250
18LivEviL81: posts the ante 250
Bsgwolfpack4: posts small blind 1000
timmay4fn: posts big blind 2000
*** HOLE CARDS ***
Dealt to JJin91 [7h Ah]
timmay4fn said, "ha"
JJin91: raises 2380 to 4380
oceangurl2: folds=20
18LivEviL81: calls 4380
AmTheCaptain: folds=20
Ch1no354: folds=20
Bsgwolfpack4: calls 3380
timmay4fn: calls 2380
*** FLOP *** [4d 2h 9s]
Bsgwolfpack4: checks=20
timmay4fn: checks=20
JJin91: checks=20
18LivEviL81: bets 58091 and is all-in
Bsgwolfpack4: folds=20
timmay4fn: folds=20
JJin91: folds=20
Uncalled bet (58091) returned to 18LivEviL81
18LivEviL81 collected 19270 from pot
18LivEviL81: doesn't show hand=20
*** SUMMARY ***
Total pot 19270 | Rake 0=20
Board [4d 2h 9s]
Seat 1: AmTheCaptain folded before Flop (didn't bet)
Seat 2: Ch1no354 (button) folded before Flop (didn't bet)
Seat 4: Bsgwolfpack4 (small blind) folded on the Flop
Seat 5: timmay4fn (big blind) folded on the Flop
Seat 6: JJin91 folded on the Flop
Seat 7: oceangurl2 folded before Flop (didn't bet)
Seat 9: 18LivEviL81 collected (19270)


*********** # 155 **************
PokerStars Hand #170379349582: Tournament #1622573280, $9.10+$0.90 USD =
Hold'em No Limit - Level XX (1250/2500) - 2017/05/25 21:30:58 ET
Table '1622573280 4' 9-max Seat #4 is the button
Seat 1: AmTheCaptain (67357 in chips)=20
Seat 2: Ch1no354 (69987 in chips)=20
Seat 4: Bsgwolfpack4 (63286 in chips)=20
Seat 5: timmay4fn (48272 in chips)=20
Seat 6: JJin91 (51558 in chips)=20
Seat 7: oceangurl2 (49049 in chips)=20
Seat 9: 18LivEviL81 (77361 in chips)=20
AmTheCaptain: posts the ante 325
Ch1no354: posts the ante 325
Bsgwolfpack4: posts the ante 325
timmay4fn: posts the ante 325
JJin91: posts the ante 325
oceangurl2: posts the ante 325
18LivEviL81: posts the ante 325
timmay4fn: posts small blind 1250
JJin91: posts big blind 2500
*** HOLE CARDS ***
Dealt to JJin91 [9c Ac]
oceangurl2: folds=20
18LivEviL81: folds=20
AmTheCaptain: folds=20
Ch1no354: folds=20
Bsgwolfpack4: folds=20
timmay4fn: folds=20
Uncalled bet (1250) returned to JJin91
JJin91 collected 4775 from pot
JJin91: doesn't show hand=20
*** SUMMARY ***
Total pot 4775 | Rake 0=20
Seat 1: AmTheCaptain folded before Flop (didn't bet)
Seat 2: Ch1no354 folded before Flop (didn't bet)
Seat 4: Bsgwolfpack4 (button) folded before Flop (didn't bet)
Seat 5: timmay4fn (small blind) folded before Flop
Seat 6: JJin91 (big blind) collected (4775)
Seat 7: oceangurl2 folded before Flop (didn't bet)
Seat 9: 18LivEviL81 folded before Flop (didn't bet)


*********** # 156 **************
PokerStars Hand #170379349877: Tournament #1622573280, $9.10+$0.90 USD =
Hold'em No Limit - Level XX (1250/2500) - 2017/05/25 21:31:59 ET
Table '1622573280 4' 9-max Seat #5 is the button
Seat 1: AmTheCaptain (67032 in chips)=20
Seat 2: Ch1no354 (69662 in chips)=20
Seat 4: Bsgwolfpack4 (62961 in chips)=20
Seat 5: timmay4fn (46697 in chips)=20
Seat 6: JJin91 (54758 in chips)=20
Seat 7: oceangurl2 (48724 in chips)=20
Seat 9: 18LivEviL81 (77036 in chips)=20
AmTheCaptain: posts the ante 325
Ch1no354: posts the ante 325
Bsgwolfpack4: posts the ante 325
timmay4fn: posts the ante 325
JJin91: posts the ante 325
oceangurl2: posts the ante 325
18LivEviL81: posts the ante 325
JJin91: posts small blind 1250
oceangurl2: posts big blind 2500
*** HOLE CARDS ***
Dealt to JJin91 [5h 6d]
18LivEviL81: folds=20
AmTheCaptain: raises 10000 to 12500
Ch1no354: folds=20
Bsgwolfpack4: calls 12500
timmay4fn: folds=20
JJin91: folds=20
oceangurl2: folds=20
*** FLOP *** [Jh 8s 4h]
AmTheCaptain: bets 30000
Bsgwolfpack4 said, "FOR REAL ?"
Bsgwolfpack4 said, "guess im bubbling"
Bsgwolfpack4: raises 20136 to 50136 and is all-in
AmTheCaptain: calls 20136
*** TURN *** [Jh 8s 4h] [5c]
*** RIVER *** [Jh 8s 4h 5c] [Td]
*** SHOW DOWN ***
AmTheCaptain: shows [Ad As] (a pair of Aces)
Bsgwolfpack4: shows [Qc Qd] (a pair of Queens)
AmTheCaptain collected 131297 from pot
Bsgwolfpack4 finished the tournament in 28th place
*** SUMMARY ***
Total pot 131297 | Rake 0=20
Board [Jh 8s 4h 5c Td]
Seat 1: AmTheCaptain showed [Ad As] and won (131297) with a pair of Aces
Seat 2: Ch1no354 folded before Flop (didn't bet)
Seat 4: Bsgwolfpack4 showed [Qc Qd] and lost with a pair of Queens
Seat 5: timmay4fn (button) folded before Flop (didn't bet)
Seat 6: JJin91 (small blind) folded before Flop
Seat 7: oceangurl2 (big blind) folded before Flop
Seat 9: 18LivEviL81 folded before Flop (didn't bet)


*********** # 157 **************
PokerStars Hand #170380251269: Tournament #1622573280, $9.10+$0.90 USD =
Hold'em No Limit - Level XX (1250/2500) - 2017/05/25 21:33:02 ET
Table '1622573280 3' 9-max Seat #8 is the button
Seat 1: se3dog (34346 in chips)=20
Seat 2: SapofPine (57937 in chips)=20
Seat 3: mrbfmrbf (107035 in chips)=20
Seat 4: AngeloP04 (83785 in chips)=20
Seat 5: y3nk_ (67858 in chips)=20
Seat 6: oceangurl2 (45899 in chips)=20
Seat 7: JJin91 (53183 in chips)=20
Seat 8: VagColeSlaw (69980 in chips)=20
Seat 9: daisy316 (58488 in chips)=20
se3dog: posts the ante 325
SapofPine: posts the ante 325
mrbfmrbf: posts the ante 325
AngeloP04: posts the ante 325
y3nk_: posts the ante 325
oceangurl2: posts the ante 325
JJin91: posts the ante 325
VagColeSlaw: posts the ante 325
daisy316: posts the ante 325
daisy316: posts small blind 1250
se3dog: posts big blind 2500
*** HOLE CARDS ***
Dealt to JJin91 [5c 4c]
SapofPine: raises 3725 to 6225
mrbfmrbf: folds=20
AngeloP04: calls 6225
y3nk_: folds=20
oceangurl2: raises 39349 to 45574 and is all-in
JJin91: folds=20
VagColeSlaw: folds=20
daisy316: folds=20
se3dog: folds=20
SapofPine: folds=20
AngeloP04: folds=20
Uncalled bet (39349) returned to oceangurl2
oceangurl2 collected 25350 from pot
oceangurl2: doesn't show hand=20
*** SUMMARY ***
Total pot 25350 | Rake 0=20
Seat 1: se3dog (big blind) folded before Flop
Seat 2: SapofPine folded before Flop
Seat 3: mrbfmrbf folded before Flop (didn't bet)
Seat 4: AngeloP04 folded before Flop
Seat 5: y3nk_ folded before Flop (didn't bet)
Seat 6: oceangurl2 collected (25350)
Seat 7: JJin91 folded before Flop (didn't bet)
Seat 8: VagColeSlaw (button) folded before Flop (didn't bet)
Seat 9: daisy316 (small blind) folded before Flop


*********** # 158 **************
PokerStars Hand #170380251506: Tournament #1622573280, $9.10+$0.90 USD =
Hold'em No Limit - Level XX (1250/2500) - 2017/05/25 21:33:47 ET
Table '1622573280 3' 9-max Seat #9 is the button
Seat 1: se3dog (31521 in chips)=20
Seat 2: SapofPine (51387 in chips)=20
Seat 3: mrbfmrbf (106710 in chips)=20
Seat 4: AngeloP04 (77235 in chips)=20
Seat 5: y3nk_ (67533 in chips)=20
Seat 6: oceangurl2 (64699 in chips)=20
Seat 7: JJin91 (52858 in chips)=20
Seat 8: VagColeSlaw (69655 in chips)=20
Seat 9: daisy316 (56913 in chips)=20
se3dog: posts the ante 325
SapofPine: posts the ante 325
mrbfmrbf: posts the ante 325
AngeloP04: posts the ante 325
y3nk_: posts the ante 325
oceangurl2: posts the ante 325
JJin91: posts the ante 325
VagColeSlaw: posts the ante 325
daisy316: posts the ante 325
se3dog: posts small blind 1250
SapofPine: posts big blind 2500
*** HOLE CARDS ***
Dealt to JJin91 [Qd Js]
mrbfmrbf: folds=20
AngeloP04: folds=20
y3nk_: raises 3500 to 6000
oceangurl2: folds=20
JJin91: folds=20
VagColeSlaw: folds=20
daisy316: folds=20
se3dog: folds=20
SapofPine: folds=20
Uncalled bet (3500) returned to y3nk_
y3nk_ collected 9175 from pot
*** SUMMARY ***
Total pot 9175 | Rake 0=20
Seat 1: se3dog (small blind) folded before Flop
Seat 2: SapofPine (big blind) folded before Flop
Seat 3: mrbfmrbf folded before Flop (didn't bet)
Seat 4: AngeloP04 folded before Flop (didn't bet)
Seat 5: y3nk_ collected (9175)
Seat 6: oceangurl2 folded before Flop (didn't bet)
Seat 7: JJin91 folded before Flop (didn't bet)
Seat 8: VagColeSlaw folded before Flop (didn't bet)
Seat 9: daisy316 (button) folded before Flop (didn't bet)


*********** # 159 **************
PokerStars Hand #170380251644: Tournament #1622573280, $9.10+$0.90 USD =
Hold'em No Limit - Level XX (1250/2500) - 2017/05/25 21:34:16 ET
Table '1622573280 3' 9-max Seat #1 is the button
Seat 1: se3dog (29946 in chips)=20
Seat 2: SapofPine (48562 in chips)=20
Seat 3: mrbfmrbf (106385 in chips)=20
Seat 4: AngeloP04 (76910 in chips)=20
Seat 5: y3nk_ (73883 in chips)=20
Seat 6: oceangurl2 (64374 in chips)=20
Seat 7: JJin91 (52533 in chips)=20
Seat 8: VagColeSlaw (69330 in chips)=20
Seat 9: daisy316 (56588 in chips)=20
se3dog: posts the ante 325
SapofPine: posts the ante 325
mrbfmrbf: posts the ante 325
AngeloP04: posts the ante 325
y3nk_: posts the ante 325
oceangurl2: posts the ante 325
JJin91: posts the ante 325
VagColeSlaw: posts the ante 325
daisy316: posts the ante 325
SapofPine: posts small blind 1250
mrbfmrbf: posts big blind 2500
*** HOLE CARDS ***
Dealt to JJin91 [3d 6d]
AngeloP04: folds=20
y3nk_: raises 2875 to 5375
oceangurl2: folds=20
JJin91: folds=20
VagColeSlaw: folds=20
daisy316: folds=20
se3dog: folds=20
SapofPine: folds=20
mrbfmrbf: calls 2875
*** FLOP *** [Qs Td 4h]
mrbfmrbf: bets 7463
y3nk_: calls 7463
*** TURN *** [Qs Td 4h] [7c]
mrbfmrbf: bets 14926
y3nk_: folds=20
Uncalled bet (14926) returned to mrbfmrbf
mrbfmrbf collected 29851 from pot
mrbfmrbf: doesn't show hand=20
*** SUMMARY ***
Total pot 29851 | Rake 0=20
Board [Qs Td 4h 7c]
Seat 1: se3dog (button) folded before Flop (didn't bet)
Seat 2: SapofPine (small blind) folded before Flop
Seat 3: mrbfmrbf (big blind) collected (29851)
Seat 4: AngeloP04 folded before Flop (didn't bet)
Seat 5: y3nk_ folded on the Turn
Seat 6: oceangurl2 folded before Flop (didn't bet)
Seat 7: JJin91 folded before Flop (didn't bet)
Seat 8: VagColeSlaw folded before Flop (didn't bet)
Seat 9: daisy316 folded before Flop (didn't bet)


*********** # 160 **************
PokerStars Hand #170380251831: Tournament #1622573280, $9.10+$0.90 USD =
Hold'em No Limit - Level XX (1250/2500) - 2017/05/25 21:34:53 ET
Table '1622573280 3' 9-max Seat #2 is the button
Seat 1: se3dog (29621 in chips)=20
Seat 2: SapofPine (46987 in chips)=20
Seat 3: mrbfmrbf (123073 in chips)=20
Seat 4: AngeloP04 (76585 in chips)=20
Seat 5: y3nk_ (60720 in chips)=20
Seat 6: oceangurl2 (64049 in chips)=20
Seat 7: JJin91 (52208 in chips)=20
Seat 8: VagColeSlaw (69005 in chips)=20
Seat 9: daisy316 (56263 in chips)=20
se3dog: posts the ante 325
SapofPine: posts the ante 325
mrbfmrbf: posts the ante 325
AngeloP04: posts the ante 325
y3nk_: posts the ante 325
oceangurl2: posts the ante 325
JJin91: posts the ante 325
VagColeSlaw: posts the ante 325
daisy316: posts the ante 325
mrbfmrbf: posts small blind 1250
AngeloP04: posts big blind 2500
*** HOLE CARDS ***
Dealt to JJin91 [3d 8s]
y3nk_: folds=20
oceangurl2: folds=20
JJin91: folds=20
VagColeSlaw: folds=20
daisy316: folds=20
se3dog: folds=20
SapofPine: folds=20
mrbfmrbf: calls 1250
AngeloP04: raises 5000 to 7500
mrbfmrbf: folds=20
Uncalled bet (5000) returned to AngeloP04
AngeloP04 collected 7925 from pot
AngeloP04: doesn't show hand=20
*** SUMMARY ***
Total pot 7925 | Rake 0=20
Seat 1: se3dog folded before Flop (didn't bet)
Seat 2: SapofPine (button) folded before Flop (didn't bet)
Seat 3: mrbfmrbf (small blind) folded before Flop
Seat 4: AngeloP04 (big blind) collected (7925)
Seat 5: y3nk_ folded before Flop (didn't bet)
Seat 6: oceangurl2 folded before Flop (didn't bet)
Seat 7: JJin91 folded before Flop (didn't bet)
Seat 8: VagColeSlaw folded before Flop (didn't bet)
Seat 9: daisy316 folded before Flop (didn't bet)


*********** # 161 **************
PokerStars Hand #170380252022: Tournament #1622573280, $9.10+$0.90 USD =
Hold'em No Limit - Level XX (1250/2500) - 2017/05/25 21:35:29 ET
Table '1622573280 3' 9-max Seat #3 is the button
Seat 1: se3dog (29296 in chips)=20
Seat 2: SapofPine (46662 in chips)=20
Seat 3: mrbfmrbf (120248 in chips)=20
Seat 4: AngeloP04 (81685 in chips)=20
Seat 5: y3nk_ (60395 in chips)=20
Seat 6: oceangurl2 (63724 in chips)=20
Seat 7: JJin91 (51883 in chips)=20
Seat 8: VagColeSlaw (68680 in chips)=20
Seat 9: daisy316 (55938 in chips)=20
se3dog: posts the ante 325
SapofPine: posts the ante 325
mrbfmrbf: posts the ante 325
AngeloP04: posts the ante 325
y3nk_: posts the ante 325
oceangurl2: posts the ante 325
JJin91: posts the ante 325
VagColeSlaw: posts the ante 325
daisy316: posts the ante 325
AngeloP04: posts small blind 1250
y3nk_: posts big blind 2500
*** HOLE CARDS ***
Dealt to JJin91 [9h 8c]
oceangurl2: folds=20
JJin91: folds=20
VagColeSlaw: folds=20
daisy316: folds=20
se3dog: calls 2500
SapofPine: folds=20
mrbfmrbf: calls 2500
AngeloP04: calls 1250
y3nk_: checks=20
*** FLOP *** [Qs 7c 7s]
AngeloP04: checks=20
y3nk_: checks=20
se3dog: checks=20
mrbfmrbf: checks=20
*** TURN *** [Qs 7c 7s] [2c]
AngeloP04: checks=20
y3nk_: bets 5429
se3dog: calls 5429
mrbfmrbf: folds=20
AngeloP04: folds=20
*** RIVER *** [Qs 7c 7s 2c] [8s]
y3nk_: bets 8750
se3dog: calls 8750
*** SHOW DOWN ***
y3nk_: shows [Jh 7d] (three of a kind, Sevens)
se3dog: mucks hand=20
y3nk_ collected 41283 from pot
*** SUMMARY ***
Total pot 41283 | Rake 0=20
Board [Qs 7c 7s 2c 8s]
Seat 1: se3dog mucked [9d 9s]
Seat 2: SapofPine folded before Flop (didn't bet)
Seat 3: mrbfmrbf (button) folded on the Turn
Seat 4: AngeloP04 (small blind) folded on the Turn
Seat 5: y3nk_ (big blind) showed [Jh 7d] and won (41283) with three of =
a kind, Sevens
Seat 6: oceangurl2 folded before Flop (didn't bet)
Seat 7: JJin91 folded before Flop (didn't bet)
Seat 8: VagColeSlaw folded before Flop (didn't bet)
Seat 9: daisy316 folded before Flop (didn't bet)


*********** # 162 **************
PokerStars Hand #170380252339: Tournament #1622573280, $9.10+$0.90 USD =
Hold'em No Limit - Level XX (1250/2500) - 2017/05/25 21:36:36 ET
Table '1622573280 3' 9-max Seat #4 is the button
Seat 1: se3dog (12292 in chips)=20
Seat 2: SapofPine (46337 in chips)=20
Seat 3: mrbfmrbf (117423 in chips)=20
Seat 4: AngeloP04 (78860 in chips)=20
Seat 5: y3nk_ (84674 in chips)=20
Seat 6: oceangurl2 (63399 in chips)=20
Seat 7: JJin91 (51558 in chips)=20
Seat 8: VagColeSlaw (68355 in chips)=20
Seat 9: daisy316 (55613 in chips)=20
se3dog: posts the ante 325
SapofPine: posts the ante 325
mrbfmrbf: posts the ante 325
AngeloP04: posts the ante 325
y3nk_: posts the ante 325
oceangurl2: posts the ante 325
JJin91: posts the ante 325
VagColeSlaw: posts the ante 325
daisy316: posts the ante 325
y3nk_: posts small blind 1250
oceangurl2: posts big blind 2500
*** HOLE CARDS ***
Dealt to JJin91 [9s 7c]
JJin91: folds=20
VagColeSlaw: folds=20
daisy316: folds=20
se3dog: folds=20
SapofPine: folds=20
mrbfmrbf: folds=20
AngeloP04: raises 5000 to 7500
y3nk_: calls 6250
oceangurl2: folds=20
*** FLOP *** [6s 8s 5d]
y3nk_: checks=20
AngeloP04: bets 10213
y3nk_: raises 12287 to 22500
AngeloP04: folds=20
Uncalled bet (12287) returned to y3nk_
y3nk_ collected 40851 from pot
y3nk_: doesn't show hand=20
*** SUMMARY ***
Total pot 40851 | Rake 0=20
Board [6s 8s 5d]
Seat 1: se3dog folded before Flop (didn't bet)
Seat 2: SapofPine folded before Flop (didn't bet)
Seat 3: mrbfmrbf folded before Flop (didn't bet)
Seat 4: AngeloP04 (button) folded on the Flop
Seat 5: y3nk_ (small blind) collected (40851)
Seat 6: oceangurl2 (big blind) folded before Flop
Seat 7: JJin91 folded before Flop (didn't bet)
Seat 8: VagColeSlaw folded before Flop (didn't bet)
Seat 9: daisy316 folded before Flop (didn't bet)


*********** # 163 **************
PokerStars Hand #170380252559: Tournament #1622573280, $9.10+$0.90 USD =
Hold'em No Limit - Level XX (1250/2500) - 2017/05/25 21:37:21 ET
Table '1622573280 3' 9-max Seat #5 is the button
Seat 1: se3dog (11967 in chips)=20
Seat 2: SapofPine (46012 in chips)=20
Seat 3: mrbfmrbf (117098 in chips)=20
Seat 4: AngeloP04 (60822 in chips)=20
Seat 5: y3nk_ (107487 in chips)=20
Seat 6: oceangurl2 (60574 in chips)=20
Seat 7: JJin91 (51233 in chips)=20
Seat 8: VagColeSlaw (68030 in chips)=20
Seat 9: daisy316 (55288 in chips)=20
se3dog: posts the ante 325
SapofPine: posts the ante 325
mrbfmrbf: posts the ante 325
AngeloP04: posts the ante 325
y3nk_: posts the ante 325
oceangurl2: posts the ante 325
JJin91: posts the ante 325
VagColeSlaw: posts the ante 325
daisy316: posts the ante 325
oceangurl2: posts small blind 1250
JJin91: posts big blind 2500
*** HOLE CARDS ***
Dealt to JJin91 [2d 3d]
VagColeSlaw: folds=20
daisy316: folds=20
se3dog: folds=20
SapofPine: folds=20
mrbfmrbf: folds=20
AngeloP04: raises 5000 to 7500
y3nk_: folds=20
oceangurl2: folds=20
JJin91: folds=20
Uncalled bet (5000) returned to AngeloP04
AngeloP04 collected 9175 from pot
AngeloP04: doesn't show hand=20
*** SUMMARY ***
Total pot 9175 | Rake 0=20
Seat 1: se3dog folded before Flop (didn't bet)
Seat 2: SapofPine folded before Flop (didn't bet)
Seat 3: mrbfmrbf folded before Flop (didn't bet)
Seat 4: AngeloP04 collected (9175)
Seat 5: y3nk_ (button) folded before Flop (didn't bet)
Seat 6: oceangurl2 (small blind) folded before Flop
Seat 7: JJin91 (big blind) folded before Flop
Seat 8: VagColeSlaw folded before Flop (didn't bet)
Seat 9: daisy316 folded before Flop (didn't bet)


*********** # 164 **************
PokerStars Hand #170380252656: Tournament #1622573280, $9.10+$0.90 USD =
Hold'em No Limit - Level XX (1250/2500) - 2017/05/25 21:37:39 ET
Table '1622573280 3' 9-max Seat #6 is the button
Seat 1: se3dog (11642 in chips)=20
Seat 2: SapofPine (45687 in chips)=20
Seat 3: mrbfmrbf (116773 in chips)=20
Seat 4: AngeloP04 (67172 in chips)=20
Seat 5: y3nk_ (107162 in chips)=20
Seat 6: oceangurl2 (58999 in chips)=20
Seat 7: JJin91 (48408 in chips)=20
Seat 8: VagColeSlaw (67705 in chips)=20
Seat 9: daisy316 (54963 in chips)=20
se3dog: posts the ante 325
SapofPine: posts the ante 325
mrbfmrbf: posts the ante 325
AngeloP04: posts the ante 325
y3nk_: posts the ante 325
oceangurl2: posts the ante 325
JJin91: posts the ante 325
VagColeSlaw: posts the ante 325
daisy316: posts the ante 325
JJin91: posts small blind 1250
VagColeSlaw: posts big blind 2500
*** HOLE CARDS ***
Dealt to JJin91 [5d Jc]
daisy316: folds=20
se3dog has timed out
se3dog: folds=20
se3dog is sitting out
SapofPine: raises 3725 to 6225
mrbfmrbf: folds=20
AngeloP04: calls 6225
y3nk_: folds=20
oceangurl2: folds=20
JJin91: folds=20
VagColeSlaw: folds=20
*** FLOP *** [Ks Td Qd]
SapofPine: checks=20
se3dog has returned
AngeloP04: checks=20
*** TURN *** [Ks Td Qd] [Ah]
SapofPine: checks=20
AngeloP04: bets 9563
SapofPine: folds=20
Uncalled bet (9563) returned to AngeloP04
AngeloP04 collected 19125 from pot
AngeloP04: doesn't show hand=20
*** SUMMARY ***
Total pot 19125 | Rake 0=20
Board [Ks Td Qd Ah]
Seat 1: se3dog folded before Flop (didn't bet)
Seat 2: SapofPine folded on the Turn
Seat 3: mrbfmrbf folded before Flop (didn't bet)
Seat 4: AngeloP04 collected (19125)
Seat 5: y3nk_ folded before Flop (didn't bet)
Seat 6: oceangurl2 (button) folded before Flop (didn't bet)
Seat 7: JJin91 (small blind) folded before Flop
Seat 8: VagColeSlaw (big blind) folded before Flop
Seat 9: daisy316 folded before Flop (didn't bet)


*********** # 165 **************
PokerStars Hand #170380252997: Tournament #1622573280, $9.10+$0.90 USD =
Hold'em No Limit - Level XX (1250/2500) - 2017/05/25 21:38:42 ET
Table '1622573280 3' 9-max Seat #7 is the button
Seat 1: se3dog (11317 in chips)=20
Seat 2: SapofPine (39137 in chips)=20
Seat 3: mrbfmrbf (116448 in chips)=20
Seat 4: AngeloP04 (79747 in chips)=20
Seat 5: y3nk_ (106837 in chips)=20
Seat 6: oceangurl2 (58674 in chips)=20
Seat 7: JJin91 (46833 in chips)=20
Seat 8: VagColeSlaw (64880 in chips)=20
Seat 9: daisy316 (54638 in chips)=20
se3dog: posts the ante 325
SapofPine: posts the ante 325
mrbfmrbf: posts the ante 325
AngeloP04: posts the ante 325
y3nk_: posts the ante 325
oceangurl2: posts the ante 325
JJin91: posts the ante 325
VagColeSlaw: posts the ante 325
daisy316: posts the ante 325
VagColeSlaw: posts small blind 1250
daisy316: posts big blind 2500
*** HOLE CARDS ***
Dealt to JJin91 [Qd 7s]
se3dog: folds=20
SapofPine: folds=20
mrbfmrbf: folds=20
AngeloP04: folds=20
y3nk_: folds=20
oceangurl2: folds=20
JJin91: raises 2975 to 5475
VagColeSlaw: folds=20
daisy316: folds=20
Uncalled bet (2975) returned to JJin91
JJin91 collected 9175 from pot
JJin91: doesn't show hand=20
*** SUMMARY ***
Total pot 9175 | Rake 0=20
Seat 1: se3dog folded before Flop (didn't bet)
Seat 2: SapofPine folded before Flop (didn't bet)
Seat 3: mrbfmrbf folded before Flop (didn't bet)
Seat 4: AngeloP04 folded before Flop (didn't bet)
Seat 5: y3nk_ folded before Flop (didn't bet)
Seat 6: oceangurl2 folded before Flop (didn't bet)
Seat 7: JJin91 (button) collected (9175)
Seat 8: VagColeSlaw (small blind) folded before Flop
Seat 9: daisy316 (big blind) folded before Flop


*********** # 166 **************
PokerStars Hand #170380253206: Tournament #1622573280, $9.10+$0.90 USD =
Hold'em No Limit - Level XX (1250/2500) - 2017/05/25 21:39:25 ET
Table '1622573280 3' 9-max Seat #8 is the button
Seat 1: se3dog (10992 in chips)=20
Seat 2: SapofPine (38812 in chips)=20
Seat 3: mrbfmrbf (116123 in chips)=20
Seat 4: AngeloP04 (79422 in chips)=20
Seat 5: y3nk_ (106512 in chips)=20
Seat 6: oceangurl2 (58349 in chips)=20
Seat 7: JJin91 (53183 in chips)=20
Seat 8: VagColeSlaw (63305 in chips)=20
Seat 9: daisy316 (51813 in chips)=20
se3dog: posts the ante 325
SapofPine: posts the ante 325
mrbfmrbf: posts the ante 325
AngeloP04: posts the ante 325
y3nk_: posts the ante 325
oceangurl2: posts the ante 325
JJin91: posts the ante 325
VagColeSlaw: posts the ante 325
daisy316: posts the ante 325
daisy316: posts small blind 1250
se3dog: posts big blind 2500
*** HOLE CARDS ***
Dealt to JJin91 [8c Jd]
SapofPine: folds=20
mrbfmrbf: raises 5000 to 7500
AngeloP04: folds=20
y3nk_: folds=20
oceangurl2: folds=20
JJin91: folds=20
VagColeSlaw: folds=20
daisy316: raises 20425 to 27925
se3dog: folds=20
mrbfmrbf said, "aq sutied in muck"
mrbfmrbf: folds=20
Uncalled bet (20425) returned to daisy316
daisy316 collected 20425 from pot
daisy316: doesn't show hand=20
*** SUMMARY ***
Total pot 20425 | Rake 0=20
Seat 1: se3dog (big blind) folded before Flop
Seat 2: SapofPine folded before Flop (didn't bet)
Seat 3: mrbfmrbf folded before Flop
Seat 4: AngeloP04 folded before Flop (didn't bet)
Seat 5: y3nk_ folded before Flop (didn't bet)
Seat 6: oceangurl2 folded before Flop (didn't bet)
Seat 7: JJin91 folded before Flop (didn't bet)
Seat 8: VagColeSlaw (button) folded before Flop (didn't bet)
Seat 9: daisy316 (small blind) collected (20425)


*********** # 167 **************
PokerStars Hand #170380253526: Tournament #1622573280, $9.10+$0.90 USD =
Hold'em No Limit - Level XXI (1500/3000) - 2017/05/25 21:40:26 ET
Table '1622573280 3' 9-max Seat #9 is the button
Seat 1: se3dog (8167 in chips)=20
Seat 2: SapofPine (38487 in chips)=20
Seat 3: mrbfmrbf (108298 in chips)=20
Seat 4: AngeloP04 (79097 in chips)=20
Seat 6: oceangurl2 (58024 in chips)=20
Seat 7: JJin91 (52858 in chips)=20
Seat 8: VagColeSlaw (62980 in chips)=20
Seat 9: daisy316 (64413 in chips)=20
se3dog: posts the ante 375
SapofPine: posts the ante 375
mrbfmrbf: posts the ante 375
AngeloP04: posts the ante 375
oceangurl2: posts the ante 375
JJin91: posts the ante 375
VagColeSlaw: posts the ante 375
daisy316: posts the ante 375
se3dog: posts small blind 1500
SapofPine: posts big blind 3000
*** HOLE CARDS ***
Dealt to JJin91 [7s 5s]
mrbfmrbf: folds=20
AngeloP04: folds=20
oceangurl2: folds=20
JJin91: folds=20
VagColeSlaw: raises 3000 to 6000
daisy316: folds=20
se3dog: folds=20
SapofPine: folds=20
Uncalled bet (3000) returned to VagColeSlaw
VagColeSlaw collected 10500 from pot
VagColeSlaw: doesn't show hand=20
*** SUMMARY ***
Total pot 10500 | Rake 0=20
Seat 1: se3dog (small blind) folded before Flop
Seat 2: SapofPine (big blind) folded before Flop
Seat 3: mrbfmrbf folded before Flop (didn't bet)
Seat 4: AngeloP04 folded before Flop (didn't bet)
Seat 6: oceangurl2 folded before Flop (didn't bet)
Seat 7: JJin91 folded before Flop (didn't bet)
Seat 8: VagColeSlaw collected (10500)
Seat 9: daisy316 (button) folded before Flop (didn't bet)


*********** # 168 **************
PokerStars Hand #170380253638: Tournament #1622573280, $9.10+$0.90 USD =
Hold'em No Limit - Level XXI (1500/3000) - 2017/05/25 21:40:50 ET
Table '1622573280 3' 9-max Seat #1 is the button
Seat 1: se3dog (6292 in chips)=20
Seat 2: SapofPine (35112 in chips)=20
Seat 3: mrbfmrbf (107923 in chips)=20
Seat 4: AngeloP04 (78722 in chips)=20
Seat 6: oceangurl2 (57649 in chips)=20
Seat 7: JJin91 (52483 in chips)=20
Seat 8: VagColeSlaw (70105 in chips)=20
Seat 9: daisy316 (64038 in chips)=20
se3dog: posts the ante 375
SapofPine: posts the ante 375
mrbfmrbf: posts the ante 375
AngeloP04: posts the ante 375
oceangurl2: posts the ante 375
JJin91: posts the ante 375
VagColeSlaw: posts the ante 375
daisy316: posts the ante 375
SapofPine: posts small blind 1500
mrbfmrbf: posts big blind 3000
*** HOLE CARDS ***
Dealt to JJin91 [Ah Ts]
AngeloP04: folds=20
oceangurl2: folds=20
JJin91: raises 3570 to 6570
VagColeSlaw: folds=20
daisy316: folds=20
se3dog: folds=20
SapofPine: calls 5070
mrbfmrbf: folds=20
*** FLOP *** [7c Js 5d]
SapofPine: checks=20
JJin91: bets 7082
SapofPine: folds=20
Uncalled bet (7082) returned to JJin91
JJin91 collected 19140 from pot
JJin91: doesn't show hand=20
*** SUMMARY ***
Total pot 19140 | Rake 0=20
Board [7c Js 5d]
Seat 1: se3dog (button) folded before Flop (didn't bet)
Seat 2: SapofPine (small blind) folded on the Flop
Seat 3: mrbfmrbf (big blind) folded before Flop
Seat 4: AngeloP04 folded before Flop (didn't bet)
Seat 6: oceangurl2 folded before Flop (didn't bet)
Seat 7: JJin91 collected (19140)
Seat 8: VagColeSlaw folded before Flop (didn't bet)
Seat 9: daisy316 folded before Flop (didn't bet)


*********** # 169 **************
PokerStars Hand #170380253820: Tournament #1622573280, $9.10+$0.90 USD =
Hold'em No Limit - Level XXI (1500/3000) - 2017/05/25 21:41:27 ET
Table '1622573280 3' 9-max Seat #2 is the button
Seat 1: se3dog (5917 in chips)=20
Seat 2: SapofPine (28167 in chips)=20
Seat 3: mrbfmrbf (104548 in chips)=20
Seat 4: AngeloP04 (78347 in chips)=20
Seat 6: oceangurl2 (57274 in chips)=20
Seat 7: JJin91 (64678 in chips)=20
Seat 8: VagColeSlaw (69730 in chips)=20
Seat 9: daisy316 (63663 in chips)=20
se3dog: posts the ante 375
SapofPine: posts the ante 375
mrbfmrbf: posts the ante 375
AngeloP04: posts the ante 375
oceangurl2: posts the ante 375
JJin91: posts the ante 375
VagColeSlaw: posts the ante 375
daisy316: posts the ante 375
mrbfmrbf: posts small blind 1500
AngeloP04: posts big blind 3000
*** HOLE CARDS ***
Dealt to JJin91 [8h 5h]
oceangurl2: folds=20
JJin91: folds=20
VagColeSlaw: folds=20
daisy316: folds=20
se3dog: folds=20
SapofPine: folds=20
mrbfmrbf: raises 3000 to 6000
AngeloP04: calls 3000
*** FLOP *** [Jd 4d 7s]
mrbfmrbf: bets 7500
AngeloP04: folds=20
Uncalled bet (7500) returned to mrbfmrbf
mrbfmrbf collected 15000 from pot
mrbfmrbf: doesn't show hand=20
*** SUMMARY ***
Total pot 15000 | Rake 0=20
Board [Jd 4d 7s]
Seat 1: se3dog folded before Flop (didn't bet)
Seat 2: SapofPine (button) folded before Flop (didn't bet)
Seat 3: mrbfmrbf (small blind) collected (15000)
Seat 4: AngeloP04 (big blind) folded on the Flop
Seat 6: oceangurl2 folded before Flop (didn't bet)
Seat 7: JJin91 folded before Flop (didn't bet)
Seat 8: VagColeSlaw folded before Flop (didn't bet)
Seat 9: daisy316 folded before Flop (didn't bet)


*********** # 170 **************
PokerStars Hand #170380253930: Tournament #1622573280, $9.10+$0.90 USD =
Hold'em No Limit - Level XXI (1500/3000) - 2017/05/25 21:41:50 ET
Table '1622573280 3' 9-max Seat #3 is the button
Seat 1: se3dog (5542 in chips)=20
Seat 2: SapofPine (27792 in chips)=20
Seat 3: mrbfmrbf (113173 in chips)=20
Seat 4: AngeloP04 (71972 in chips)=20
Seat 6: oceangurl2 (56899 in chips)=20
Seat 7: JJin91 (64303 in chips)=20
Seat 8: VagColeSlaw (69355 in chips)=20
Seat 9: daisy316 (63288 in chips)=20
se3dog: posts the ante 375
SapofPine: posts the ante 375
mrbfmrbf: posts the ante 375
AngeloP04: posts the ante 375
oceangurl2: posts the ante 375
JJin91: posts the ante 375
VagColeSlaw: posts the ante 375
daisy316: posts the ante 375
AngeloP04: posts small blind 1500
oceangurl2: posts big blind 3000
*** HOLE CARDS ***
Dealt to JJin91 [8h 3d]
JJin91: folds=20
VagColeSlaw: folds=20
daisy316: folds=20
se3dog: folds=20
SapofPine: raises 24417 to 27417 and is all-in
mrbfmrbf: folds=20
AngeloP04: folds=20
oceangurl2: folds=20
Uncalled bet (24417) returned to SapofPine
SapofPine collected 10500 from pot
*** SUMMARY ***
Total pot 10500 | Rake 0=20
Seat 1: se3dog folded before Flop (didn't bet)
Seat 2: SapofPine collected (10500)
Seat 3: mrbfmrbf (button) folded before Flop (didn't bet)
Seat 4: AngeloP04 (small blind) folded before Flop
Seat 6: oceangurl2 (big blind) folded before Flop
Seat 7: JJin91 folded before Flop (didn't bet)
Seat 8: VagColeSlaw folded before Flop (didn't bet)
Seat 9: daisy316 folded before Flop (didn't bet)


*********** # 171 **************
PokerStars Hand #170380254094: Tournament #1622573280, $9.10+$0.90 USD =
Hold'em No Limit - Level XXI (1500/3000) - 2017/05/25 21:42:20 ET
Table '1622573280 3' 9-max Seat #4 is the button
Seat 1: se3dog (5167 in chips)=20
Seat 2: SapofPine (34917 in chips)=20
Seat 3: mrbfmrbf (112798 in chips)=20
Seat 4: AngeloP04 (70097 in chips)=20
Seat 6: oceangurl2 (53524 in chips)=20
Seat 7: JJin91 (63928 in chips)=20
Seat 8: VagColeSlaw (68980 in chips)=20
Seat 9: daisy316 (62913 in chips)=20
se3dog: posts the ante 375
SapofPine: posts the ante 375
mrbfmrbf: posts the ante 375
AngeloP04: posts the ante 375
oceangurl2: posts the ante 375
JJin91: posts the ante 375
VagColeSlaw: posts the ante 375
daisy316: posts the ante 375
oceangurl2: posts small blind 1500
JJin91: posts big blind 3000
*** HOLE CARDS ***
Dealt to JJin91 [Qd 6c]
VagColeSlaw: folds=20
daisy316: raises 6000 to 9000
se3dog: calls 4792 and is all-in
SapofPine: folds=20
mrbfmrbf: folds=20
AngeloP04: folds=20
oceangurl2: folds=20
JJin91: folds=20
Uncalled bet (4208) returned to daisy316
*** FLOP *** [3c 9s Js]
*** TURN *** [3c 9s Js] [Ks]
*** RIVER *** [3c 9s Js Ks] [6h]
*** SHOW DOWN ***
daisy316: shows [Ac 5s] (high card Ace)
se3dog: shows [Tc Ad] (high card Ace - King+Jack+Ten kicker)
se3dog collected 17084 from pot
*** SUMMARY ***
Total pot 17084 | Rake 0=20
Board [3c 9s Js Ks 6h]
Seat 1: se3dog showed [Tc Ad] and won (17084) with high card Ace
Seat 2: SapofPine folded before Flop (didn't bet)
Seat 3: mrbfmrbf folded before Flop (didn't bet)
Seat 4: AngeloP04 (button) folded before Flop (didn't bet)
Seat 6: oceangurl2 (small blind) folded before Flop
Seat 7: JJin91 (big blind) folded before Flop
Seat 8: VagColeSlaw folded before Flop (didn't bet)
Seat 9: daisy316 showed [Ac 5s] and lost with high card Ace


*********** # 172 **************
PokerStars Hand #170380254241: Tournament #1622573280, $9.10+$0.90 USD =
Hold'em No Limit - Level XXI (1500/3000) - 2017/05/25 21:42:52 ET
Table '1622573280 3' 9-max Seat #6 is the button
Seat 1: se3dog (17084 in chips)=20
Seat 2: SapofPine (34542 in chips)=20
Seat 3: mrbfmrbf (112423 in chips)=20
Seat 4: AngeloP04 (69722 in chips)=20
Seat 6: oceangurl2 (51649 in chips)=20
Seat 7: JJin91 (60553 in chips)=20
Seat 8: VagColeSlaw (68605 in chips)=20
Seat 9: daisy316 (57746 in chips)=20
se3dog: posts the ante 375
SapofPine: posts the ante 375
mrbfmrbf: posts the ante 375
AngeloP04: posts the ante 375
oceangurl2: posts the ante 375
JJin91: posts the ante 375
VagColeSlaw: posts the ante 375
daisy316: posts the ante 375
JJin91: posts small blind 1500
VagColeSlaw: posts big blind 3000
*** HOLE CARDS ***
Dealt to JJin91 [9s 3h]
daisy316: calls 3000
se3dog: folds=20
SapofPine: calls 3000
mrbfmrbf: calls 3000
AngeloP04: calls 3000
oceangurl2: folds=20
JJin91: folds=20
VagColeSlaw: checks=20
*** FLOP *** [4d Kc 6d]
VagColeSlaw: checks=20
daisy316: checks=20
SapofPine: checks=20
mrbfmrbf: checks=20
AngeloP04: checks=20
*** TURN *** [4d Kc 6d] [8d]
VagColeSlaw: checks=20
daisy316: checks=20
SapofPine: checks=20
mrbfmrbf: bets 19500
AngeloP04: calls 19500
VagColeSlaw: folds=20
daisy316: folds=20
SapofPine: folds=20
*** RIVER *** [4d Kc 6d 8d] [7c]
mrbfmrbf: bets 29250
AngeloP04: folds=20
Uncalled bet (29250) returned to mrbfmrbf
mrbfmrbf collected 58500 from pot
mrbfmrbf: doesn't show hand=20
*** SUMMARY ***
Total pot 58500 | Rake 0=20
Board [4d Kc 6d 8d 7c]
Seat 1: se3dog folded before Flop (didn't bet)
Seat 2: SapofPine folded on the Turn
Seat 3: mrbfmrbf collected (58500)
Seat 4: AngeloP04 folded on the River
Seat 6: oceangurl2 (button) folded before Flop (didn't bet)
Seat 7: JJin91 (small blind) folded before Flop
Seat 8: VagColeSlaw (big blind) folded on the Turn
Seat 9: daisy316 folded on the Turn


*********** # 173 **************
PokerStars Hand #170380254562: Tournament #1622573280, $9.10+$0.90 USD =
Hold'em No Limit - Level XXI (1500/3000) - 2017/05/25 21:43:57 ET
Table '1622573280 3' 9-max Seat #7 is the button
Seat 1: se3dog (16709 in chips)=20
Seat 2: SapofPine (31167 in chips)=20
Seat 3: mrbfmrbf (148048 in chips)=20
Seat 4: AngeloP04 (46847 in chips)=20
Seat 6: oceangurl2 (51274 in chips)=20
Seat 7: JJin91 (58678 in chips)=20
Seat 8: VagColeSlaw (65230 in chips)=20
Seat 9: daisy316 (54371 in chips)=20
se3dog: posts the ante 375
SapofPine: posts the ante 375
mrbfmrbf: posts the ante 375
AngeloP04: posts the ante 375
oceangurl2: posts the ante 375
JJin91: posts the ante 375
VagColeSlaw: posts the ante 375
daisy316: posts the ante 375
VagColeSlaw: posts small blind 1500
daisy316: posts big blind 3000
*** HOLE CARDS ***
Dealt to JJin91 [7h Kh]
se3dog: folds=20
SapofPine: folds=20
mrbfmrbf: folds=20
AngeloP04: folds=20
oceangurl2: folds=20
JJin91: raises 3570 to 6570
VagColeSlaw: folds=20
daisy316: raises 17640 to 24210
JJin91: folds=20
Uncalled bet (17640) returned to daisy316
daisy316 collected 17640 from pot
daisy316: doesn't show hand=20
*** SUMMARY ***
Total pot 17640 | Rake 0=20
Seat 1: se3dog folded before Flop (didn't bet)
Seat 2: SapofPine folded before Flop (didn't bet)
Seat 3: mrbfmrbf folded before Flop (didn't bet)
Seat 4: AngeloP04 folded before Flop (didn't bet)
Seat 6: oceangurl2 folded before Flop (didn't bet)
Seat 7: JJin91 (button) folded before Flop
Seat 8: VagColeSlaw (small blind) folded before Flop
Seat 9: daisy316 (big blind) collected (17640)


*********** # 174 **************
PokerStars Hand #170380254737: Tournament #1622573280, $9.10+$0.90 USD =
Hold'em No Limit - Level XXI (1500/3000) - 2017/05/25 21:44:30 ET
Table '1622573280 3' 9-max Seat #8 is the button
Seat 1: se3dog (16334 in chips)=20
Seat 2: SapofPine (30792 in chips)=20
Seat 3: mrbfmrbf (147673 in chips)=20
Seat 4: AngeloP04 (46472 in chips)=20
Seat 6: oceangurl2 (50899 in chips)=20
Seat 7: JJin91 (51733 in chips)=20
Seat 8: VagColeSlaw (63355 in chips)=20
Seat 9: daisy316 (65066 in chips)=20
se3dog: posts the ante 375
SapofPine: posts the ante 375
mrbfmrbf: posts the ante 375
AngeloP04: posts the ante 375
oceangurl2: posts the ante 375
JJin91: posts the ante 375
VagColeSlaw: posts the ante 375
daisy316: posts the ante 375
daisy316: posts small blind 1500
se3dog: posts big blind 3000
*** HOLE CARDS ***
Dealt to JJin91 [Ks 9c]
SapofPine: folds=20
mrbfmrbf: folds=20
AngeloP04: folds=20
oceangurl2: folds=20
JJin91: folds=20
VagColeSlaw: folds=20
daisy316: raises 6000 to 9000
se3dog: folds=20
Uncalled bet (6000) returned to daisy316
daisy316 collected 9000 from pot
daisy316: doesn't show hand=20
*** SUMMARY ***
Total pot 9000 | Rake 0=20
Seat 1: se3dog (big blind) folded before Flop
Seat 2: SapofPine folded before Flop (didn't bet)
Seat 3: mrbfmrbf folded before Flop (didn't bet)
Seat 4: AngeloP04 folded before Flop (didn't bet)
Seat 6: oceangurl2 folded before Flop (didn't bet)
Seat 7: JJin91 folded before Flop (didn't bet)
Seat 8: VagColeSlaw (button) folded before Flop (didn't bet)
Seat 9: daisy316 (small blind) collected (9000)


*********** # 175 **************
PokerStars Hand #170380254821: Tournament #1622573280, $9.10+$0.90 USD =
Hold'em No Limit - Level XXI (1500/3000) - 2017/05/25 21:44:47 ET
Table '1622573280 3' 9-max Seat #9 is the button
Seat 1: se3dog (12959 in chips)=20
Seat 2: SapofPine (30417 in chips)=20
Seat 3: mrbfmrbf (147298 in chips)=20
Seat 4: AngeloP04 (46097 in chips)=20
Seat 6: oceangurl2 (50524 in chips)=20
Seat 7: JJin91 (51358 in chips)=20
Seat 8: VagColeSlaw (62980 in chips)=20
Seat 9: daisy316 (70691 in chips)=20
se3dog: posts the ante 375
SapofPine: posts the ante 375
mrbfmrbf: posts the ante 375
AngeloP04: posts the ante 375
oceangurl2: posts the ante 375
JJin91: posts the ante 375
VagColeSlaw: posts the ante 375
daisy316: posts the ante 375
se3dog: posts small blind 1500
SapofPine: posts big blind 3000
*** HOLE CARDS ***
Dealt to JJin91 [7s 4d]
mrbfmrbf: folds=20
AngeloP04: folds=20
oceangurl2: folds=20
JJin91: folds=20
VagColeSlaw: folds=20
daisy316: raises 3000 to 6000
se3dog: raises 6584 to 12584 and is all-in
SapofPine: folds=20
daisy316: calls 6584
*** FLOP *** [Qd Qs 8s]
*** TURN *** [Qd Qs 8s] [3h]
*** RIVER *** [Qd Qs 8s 3h] [Kc]
*** SHOW DOWN ***
se3dog: shows [Js Qc] (three of a kind, Queens)
daisy316: shows [Ah 7d] (a pair of Queens)
se3dog collected 31168 from pot
*** SUMMARY ***
Total pot 31168 | Rake 0=20
Board [Qd Qs 8s 3h Kc]
Seat 1: se3dog (small blind) showed [Js Qc] and won (31168) with three =
of a kind, Queens
Seat 2: SapofPine (big blind) folded before Flop
Seat 3: mrbfmrbf folded before Flop (didn't bet)
Seat 4: AngeloP04 folded before Flop (didn't bet)
Seat 6: oceangurl2 folded before Flop (didn't bet)
Seat 7: JJin91 folded before Flop (didn't bet)
Seat 8: VagColeSlaw folded before Flop (didn't bet)
Seat 9: daisy316 (button) showed [Ah 7d] and lost with a pair of Queens


*********** # 176 **************
PokerStars Hand #170380255006: Tournament #1622573280, $9.10+$0.90 USD =
Hold'em No Limit - Level XXI (1500/3000) - 2017/05/25 21:45:25 ET
Table '1622573280 3' 9-max Seat #1 is the button
Seat 1: se3dog (31168 in chips)=20
Seat 2: SapofPine (27042 in chips)=20
Seat 3: mrbfmrbf (146923 in chips)=20
Seat 4: AngeloP04 (45722 in chips)=20
Seat 6: oceangurl2 (50149 in chips)=20
Seat 7: JJin91 (50983 in chips)=20
Seat 8: VagColeSlaw (62605 in chips)=20
Seat 9: daisy316 (57732 in chips)=20
se3dog: posts the ante 375
SapofPine: posts the ante 375
mrbfmrbf: posts the ante 375
AngeloP04: posts the ante 375
oceangurl2: posts the ante 375
JJin91: posts the ante 375
VagColeSlaw: posts the ante 375
daisy316: posts the ante 375
SapofPine: posts small blind 1500
mrbfmrbf: posts big blind 3000
*** HOLE CARDS ***
Dealt to JJin91 [Jd Qc]
AngeloP04: folds=20
oceangurl2: folds=20
JJin91: raises 3570 to 6570
VagColeSlaw: folds=20
daisy316: folds=20
se3dog: folds=20
SapofPine: folds=20
mrbfmrbf: folds=20
Uncalled bet (3570) returned to JJin91
JJin91 collected 10500 from pot
JJin91: doesn't show hand=20
*** SUMMARY ***
Total pot 10500 | Rake 0=20
Seat 1: se3dog (button) folded before Flop (didn't bet)
Seat 2: SapofPine (small blind) folded before Flop
Seat 3: mrbfmrbf (big blind) folded before Flop
Seat 4: AngeloP04 folded before Flop (didn't bet)
Seat 6: oceangurl2 folded before Flop (didn't bet)
Seat 7: JJin91 collected (10500)
Seat 8: VagColeSlaw folded before Flop (didn't bet)
Seat 9: daisy316 folded before Flop (didn't bet)


*********** # 177 **************
PokerStars Hand #170380255084: Tournament #1622573280, $9.10+$0.90 USD =
Hold'em No Limit - Level XXI (1500/3000) - 2017/05/25 21:45:42 ET
Table '1622573280 3' 9-max Seat #2 is the button
Seat 1: se3dog (30793 in chips)=20
Seat 2: SapofPine (25167 in chips)=20
Seat 3: mrbfmrbf (143548 in chips)=20
Seat 4: AngeloP04 (45347 in chips)=20
Seat 6: oceangurl2 (49774 in chips)=20
Seat 7: JJin91 (58108 in chips)=20
Seat 8: VagColeSlaw (62230 in chips)=20
Seat 9: daisy316 (57357 in chips)=20
se3dog: posts the ante 375
SapofPine: posts the ante 375
mrbfmrbf: posts the ante 375
AngeloP04: posts the ante 375
oceangurl2: posts the ante 375
JJin91: posts the ante 375
VagColeSlaw: posts the ante 375
daisy316: posts the ante 375
mrbfmrbf: posts small blind 1500
AngeloP04: posts big blind 3000
*** HOLE CARDS ***
Dealt to JJin91 [3d 8d]
oceangurl2: folds=20
JJin91: folds=20
VagColeSlaw: folds=20
daisy316: folds=20
se3dog: folds=20
SapofPine: folds=20
mrbfmrbf: raises 6000 to 9000
AngeloP04: folds=20
Uncalled bet (6000) returned to mrbfmrbf
mrbfmrbf collected 9000 from pot
mrbfmrbf: doesn't show hand=20
*** SUMMARY ***
Total pot 9000 | Rake 0=20
Seat 1: se3dog folded before Flop (didn't bet)
Seat 2: SapofPine (button) folded before Flop (didn't bet)
Seat 3: mrbfmrbf (small blind) collected (9000)
Seat 4: AngeloP04 (big blind) folded before Flop
Seat 6: oceangurl2 folded before Flop (didn't bet)
Seat 7: JJin91 folded before Flop (didn't bet)
Seat 8: VagColeSlaw folded before Flop (didn't bet)
Seat 9: daisy316 folded before Flop (didn't bet)


*********** # 178 **************
PokerStars Hand #170380255198: Tournament #1622573280, $9.10+$0.90 USD =
Hold'em No Limit - Level XXI (1500/3000) - 2017/05/25 21:46:09 ET
Table '1622573280 3' 9-max Seat #3 is the button
Seat 1: se3dog (30418 in chips)=20
Seat 2: SapofPine (24792 in chips)=20
Seat 3: mrbfmrbf (149173 in chips)=20
Seat 4: AngeloP04 (41972 in chips)=20
Seat 6: oceangurl2 (49399 in chips)=20
Seat 7: JJin91 (57733 in chips)=20
Seat 8: VagColeSlaw (61855 in chips)=20
Seat 9: daisy316 (56982 in chips)=20
se3dog: posts the ante 375
SapofPine: posts the ante 375
mrbfmrbf: posts the ante 375
AngeloP04: posts the ante 375
oceangurl2: posts the ante 375
JJin91: posts the ante 375
VagColeSlaw: posts the ante 375
daisy316: posts the ante 375
AngeloP04: posts small blind 1500
oceangurl2: posts big blind 3000
*** HOLE CARDS ***
Dealt to JJin91 [8d 8h]
JJin91: raises 3570 to 6570
VagColeSlaw: folds=20
daisy316: folds=20
se3dog: folds=20
SapofPine: folds=20
mrbfmrbf: folds=20
AngeloP04: folds=20
oceangurl2: calls 3570
*** FLOP *** [5c Tc 6h]
oceangurl2: checks=20
JJin91: bets 10055
oceangurl2: folds=20
Uncalled bet (10055) returned to JJin91
JJin91 collected 17640 from pot
JJin91: doesn't show hand=20
*** SUMMARY ***
Total pot 17640 | Rake 0=20
Board [5c Tc 6h]
Seat 1: se3dog folded before Flop (didn't bet)
Seat 2: SapofPine folded before Flop (didn't bet)
Seat 3: mrbfmrbf (button) folded before Flop (didn't bet)
Seat 4: AngeloP04 (small blind) folded before Flop
Seat 6: oceangurl2 (big blind) folded on the Flop
Seat 7: JJin91 collected (17640)
Seat 8: VagColeSlaw folded before Flop (didn't bet)
Seat 9: daisy316 folded before Flop (didn't bet)


*********** # 179 **************
PokerStars Hand #170380255313: Tournament #1622573280, $9.10+$0.90 USD =
Hold'em No Limit - Level XXI (1500/3000) - 2017/05/25 21:46:36 ET
Table '1622573280 3' 9-max Seat #4 is the button
Seat 1: se3dog (30043 in chips)=20
Seat 2: SapofPine (24417 in chips)=20
Seat 3: mrbfmrbf (148798 in chips)=20
Seat 4: AngeloP04 (40097 in chips)=20
Seat 6: oceangurl2 (42454 in chips)=20
Seat 7: JJin91 (68428 in chips)=20
Seat 8: VagColeSlaw (61480 in chips)=20
Seat 9: daisy316 (56607 in chips)=20
se3dog: posts the ante 375
SapofPine: posts the ante 375
mrbfmrbf: posts the ante 375
AngeloP04: posts the ante 375
oceangurl2: posts the ante 375
JJin91: posts the ante 375
VagColeSlaw: posts the ante 375
daisy316: posts the ante 375
oceangurl2: posts small blind 1500
JJin91: posts big blind 3000
*** HOLE CARDS ***
Dealt to JJin91 [8s Ad]
VagColeSlaw: folds=20
daisy316: folds=20
se3dog: folds=20
SapofPine: folds=20
mrbfmrbf: folds=20
AngeloP04: raises 6000 to 9000
oceangurl2: folds=20
JJin91: calls 6000
*** FLOP *** [2d 4d 7s]
JJin91: checks=20
AngeloP04: bets 11250
JJin91: raises 47803 to 59053 and is all-in
AngeloP04: folds=20
Uncalled bet (47803) returned to JJin91
JJin91 collected 45000 from pot
JJin91: doesn't show hand=20
*** SUMMARY ***
Total pot 45000 | Rake 0=20
Board [2d 4d 7s]
Seat 1: se3dog folded before Flop (didn't bet)
Seat 2: SapofPine folded before Flop (didn't bet)
Seat 3: mrbfmrbf folded before Flop (didn't bet)
Seat 4: AngeloP04 (button) folded on the Flop
Seat 6: oceangurl2 (small blind) folded before Flop
Seat 7: JJin91 (big blind) collected (45000)
Seat 8: VagColeSlaw folded before Flop (didn't bet)
Seat 9: daisy316 folded before Flop (didn't bet)


*********** # 180 **************
PokerStars Hand #170380255507: Tournament #1622573280, $9.10+$0.90 USD =
Hold'em No Limit - Level XXI (1500/3000) - 2017/05/25 21:47:20 ET
Table '1622573280 3' 9-max Seat #6 is the button
Seat 1: se3dog (29668 in chips)=20
Seat 2: SapofPine (24042 in chips)=20
Seat 3: mrbfmrbf (148423 in chips)=20
Seat 4: AngeloP04 (19472 in chips)=20
Seat 6: oceangurl2 (40579 in chips)=20
Seat 7: JJin91 (92803 in chips)=20
Seat 8: VagColeSlaw (61105 in chips)=20
Seat 9: daisy316 (56232 in chips)=20
se3dog: posts the ante 375
SapofPine: posts the ante 375
mrbfmrbf: posts the ante 375
AngeloP04: posts the ante 375
oceangurl2: posts the ante 375
JJin91: posts the ante 375
VagColeSlaw: posts the ante 375
daisy316: posts the ante 375
JJin91: posts small blind 1500
VagColeSlaw: posts big blind 3000
*** HOLE CARDS ***
Dealt to JJin91 [2d 8c]
daisy316: folds=20
se3dog: folds=20
SapofPine: folds=20
mrbfmrbf: raises 3000 to 6000
AngeloP04: folds=20
oceangurl2: raises 34204 to 40204 and is all-in
JJin91: folds=20
VagColeSlaw: folds=20
mrbfmrbf: folds=20
Uncalled bet (34204) returned to oceangurl2
oceangurl2 collected 19500 from pot
oceangurl2: doesn't show hand=20
*** SUMMARY ***
Total pot 19500 | Rake 0=20
Seat 1: se3dog folded before Flop (didn't bet)
Seat 2: SapofPine folded before Flop (didn't bet)
Seat 3: mrbfmrbf folded before Flop
Seat 4: AngeloP04 folded before Flop (didn't bet)
Seat 6: oceangurl2 (button) collected (19500)
Seat 7: JJin91 (small blind) folded before Flop
Seat 8: VagColeSlaw (big blind) folded before Flop
Seat 9: daisy316 folded before Flop (didn't bet)


*********** # 181 **************
PokerStars Hand #170380255676: Tournament #1622573280, $9.10+$0.90 USD =
Hold'em No Limit - Level XXI (1500/3000) - 2017/05/25 21:47:58 ET
Table '1622573280 3' 9-max Seat #7 is the button
Seat 1: se3dog (29293 in chips)=20
Seat 2: SapofPine (23667 in chips)=20
Seat 3: mrbfmrbf (142048 in chips)=20
Seat 4: AngeloP04 (19097 in chips)=20
Seat 6: oceangurl2 (53704 in chips)=20
Seat 7: JJin91 (90928 in chips)=20
Seat 8: VagColeSlaw (57730 in chips)=20
Seat 9: daisy316 (55857 in chips)=20
se3dog: posts the ante 375
SapofPine: posts the ante 375
mrbfmrbf: posts the ante 375
AngeloP04: posts the ante 375
oceangurl2: posts the ante 375
JJin91: posts the ante 375
VagColeSlaw: posts the ante 375
daisy316: posts the ante 375
VagColeSlaw: posts small blind 1500
daisy316: posts big blind 3000
*** HOLE CARDS ***
Dealt to JJin91 [6d Js]
se3dog: folds=20
SapofPine: folds=20
mrbfmrbf: folds=20
AngeloP04: raises 15722 to 18722 and is all-in
oceangurl2: folds=20
JJin91: folds=20
VagColeSlaw: raises 38633 to 57355 and is all-in
daisy316: folds=20
Uncalled bet (38633) returned to VagColeSlaw
*** FLOP *** [7d 2s 5s]
*** TURN *** [7d 2s 5s] [5h]
*** RIVER *** [7d 2s 5s 5h] [Ac]
*** SHOW DOWN ***
VagColeSlaw: shows [Ts Td] (two pair, Tens and Fives)
AngeloP04: shows [6c As] (two pair, Aces and Fives)
AngeloP04 collected 43444 from pot
*** SUMMARY ***
Total pot 43444 | Rake 0=20
Board [7d 2s 5s 5h Ac]
Seat 1: se3dog folded before Flop (didn't bet)
Seat 2: SapofPine folded before Flop (didn't bet)
Seat 3: mrbfmrbf folded before Flop (didn't bet)
Seat 4: AngeloP04 showed [6c As] and won (43444) with two pair, Aces an=
d Fives
Seat 6: oceangurl2 folded before Flop (didn't bet)
Seat 7: JJin91 (button) folded before Flop (didn't bet)
Seat 8: VagColeSlaw (small blind) showed [Ts Td] and lost with two pair=
, Tens and Fives
Seat 9: daisy316 (big blind) folded before Flop


*********** # 182 **************
PokerStars Hand #170380255781: Tournament #1622573280, $9.10+$0.90 USD =
Hold'em No Limit - Level XXI (1500/3000) - 2017/05/25 21:48:22 ET
Table '1622573280 3' 9-max Seat #8 is the button
Seat 1: se3dog (28918 in chips)=20
Seat 2: SapofPine (23292 in chips)=20
Seat 3: mrbfmrbf (141673 in chips)=20
Seat 4: AngeloP04 (43444 in chips)=20
Seat 6: oceangurl2 (53329 in chips)=20
Seat 7: JJin91 (90553 in chips)=20
Seat 8: VagColeSlaw (38633 in chips)=20
Seat 9: daisy316 (52482 in chips)=20
se3dog: posts the ante 375
SapofPine: posts the ante 375
mrbfmrbf: posts the ante 375
AngeloP04: posts the ante 375
oceangurl2: posts the ante 375
JJin91: posts the ante 375
VagColeSlaw: posts the ante 375
daisy316: posts the ante 375
daisy316: posts small blind 1500
se3dog: posts big blind 3000
*** HOLE CARDS ***
Dealt to JJin91 [2c As]
SapofPine: folds=20
mrbfmrbf: folds=20
AngeloP04: folds=20
oceangurl2: folds=20
JJin91: folds=20
VagColeSlaw: folds=20
daisy316: folds=20
Uncalled bet (1500) returned to se3dog
se3dog collected 6000 from pot
se3dog: doesn't show hand=20
*** SUMMARY ***
Total pot 6000 | Rake 0=20
Seat 1: se3dog (big blind) collected (6000)
Seat 2: SapofPine folded before Flop (didn't bet)
Seat 3: mrbfmrbf folded before Flop (didn't bet)
Seat 4: AngeloP04 folded before Flop (didn't bet)
Seat 6: oceangurl2 folded before Flop (didn't bet)
Seat 7: JJin91 folded before Flop (didn't bet)
Seat 8: VagColeSlaw (button) folded before Flop (didn't bet)
Seat 9: daisy316 (small blind) folded before Flop


*********** # 183 **************
PokerStars Hand #170380255873: Tournament #1622573280, $9.10+$0.90 USD =
Hold'em No Limit - Level XXI (1500/3000) - 2017/05/25 21:48:39 ET
Table '1622573280 3' 9-max Seat #9 is the button
Seat 1: se3dog (33043 in chips)=20
Seat 2: SapofPine (22917 in chips)=20
Seat 3: mrbfmrbf (141298 in chips)=20
Seat 4: AngeloP04 (43069 in chips)=20
Seat 6: oceangurl2 (52954 in chips)=20
Seat 7: JJin91 (90178 in chips)=20
Seat 8: VagColeSlaw (38258 in chips)=20
Seat 9: daisy316 (50607 in chips)=20
se3dog: posts the ante 375
SapofPine: posts the ante 375
mrbfmrbf: posts the ante 375
AngeloP04: posts the ante 375
oceangurl2: posts the ante 375
JJin91: posts the ante 375
VagColeSlaw: posts the ante 375
daisy316: posts the ante 375
se3dog: posts small blind 1500
SapofPine: posts big blind 3000
*** HOLE CARDS ***
Dealt to JJin91 [9h 3s]
mrbfmrbf: folds=20
AngeloP04: folds=20
oceangurl2: folds=20
JJin91: folds=20
VagColeSlaw: folds=20
daisy316: folds=20
se3dog: raises 29668 to 32668 and is all-in
SapofPine: calls 19542 and is all-in
Uncalled bet (10126) returned to se3dog
*** FLOP *** [2s 7h 7c]
*** TURN *** [2s 7h 7c] [Kd]
*** RIVER *** [2s 7h 7c Kd] [5s]
*** SHOW DOWN ***
se3dog: shows [Qh As] (a pair of Sevens)
SapofPine: shows [Th 8h] (a pair of Sevens - lower kicker)
se3dog collected 48084 from pot
SapofPine finished the tournament in 22nd place and received $15.28.
*** SUMMARY ***
Total pot 48084 | Rake 0=20
Board [2s 7h 7c Kd 5s]
Seat 1: se3dog (small blind) showed [Qh As] and won (48084) with a pair=
 of Sevens
Seat 2: SapofPine (big blind) showed [Th 8h] and lost with a pair of Se=
vens
Seat 3: mrbfmrbf folded before Flop (didn't bet)
Seat 4: AngeloP04 folded before Flop (didn't bet)
Seat 6: oceangurl2 folded before Flop (didn't bet)
Seat 7: JJin91 folded before Flop (didn't bet)
Seat 8: VagColeSlaw folded before Flop (didn't bet)
Seat 9: daisy316 (button) folded before Flop (didn't bet)


*********** # 184 **************
PokerStars Hand #170380256018: Tournament #1622573280, $9.10+$0.90 USD =
Hold'em No Limit - Level XXI (1500/3000) - 2017/05/25 21:49:11 ET
Table '1622573280 3' 9-max Seat #1 is the button
Seat 1: se3dog (58210 in chips)=20
Seat 3: mrbfmrbf (140923 in chips)=20
Seat 4: AngeloP04 (42694 in chips)=20
Seat 6: oceangurl2 (52579 in chips)=20
Seat 7: JJin91 (89803 in chips)=20
Seat 8: VagColeSlaw (37883 in chips)=20
Seat 9: daisy316 (50232 in chips)=20
se3dog: posts the ante 375
mrbfmrbf: posts the ante 375
AngeloP04: posts the ante 375
oceangurl2: posts the ante 375
JJin91: posts the ante 375
VagColeSlaw: posts the ante 375
daisy316: posts the ante 375
mrbfmrbf: posts small blind 1500
AngeloP04: posts big blind 3000
*** HOLE CARDS ***
Dealt to JJin91 [4c 9h]
oceangurl2: raises 6000 to 9000
JJin91: folds=20
VagColeSlaw: folds=20
daisy316: folds=20
se3dog: folds=20
mrbfmrbf: folds=20
AngeloP04: folds=20
Uncalled bet (6000) returned to oceangurl2
oceangurl2 collected 10125 from pot
oceangurl2: doesn't show hand=20
*** SUMMARY ***
Total pot 10125 | Rake 0=20
Seat 1: se3dog (button) folded before Flop (didn't bet)
Seat 3: mrbfmrbf (small blind) folded before Flop
Seat 4: AngeloP04 (big blind) folded before Flop
Seat 6: oceangurl2 collected (10125)
Seat 7: JJin91 folded before Flop (didn't bet)
Seat 8: VagColeSlaw folded before Flop (didn't bet)
Seat 9: daisy316 folded before Flop (didn't bet)


*********** # 185 **************
PokerStars Hand #170380256095: Tournament #1622573280, $9.10+$0.90 USD =
Hold'em No Limit - Level XXI (1500/3000) - 2017/05/25 21:49:30 ET
Table '1622573280 3' 9-max Seat #3 is the button
Seat 1: se3dog (57835 in chips)=20
Seat 3: mrbfmrbf (139048 in chips)=20
Seat 4: AngeloP04 (39319 in chips)=20
Seat 6: oceangurl2 (59329 in chips)=20
Seat 7: JJin91 (89428 in chips)=20
Seat 8: VagColeSlaw (37508 in chips)=20
Seat 9: daisy316 (49857 in chips)=20
se3dog: posts the ante 375
mrbfmrbf: posts the ante 375
AngeloP04: posts the ante 375
oceangurl2: posts the ante 375
JJin91: posts the ante 375
VagColeSlaw: posts the ante 375
daisy316: posts the ante 375
AngeloP04: posts small blind 1500
oceangurl2: posts big blind 3000
*** HOLE CARDS ***
Dealt to JJin91 [Kh Jd]
JJin91: raises 3570 to 6570
VagColeSlaw: folds=20
daisy316: folds=20
se3dog: folds=20
mrbfmrbf: folds=20
AngeloP04: folds=20
oceangurl2: folds=20
Uncalled bet (3570) returned to JJin91
JJin91 collected 10125 from pot
JJin91: doesn't show hand=20
*** SUMMARY ***
Total pot 10125 | Rake 0=20
Seat 1: se3dog folded before Flop (didn't bet)
Seat 3: mrbfmrbf (button) folded before Flop (didn't bet)
Seat 4: AngeloP04 (small blind) folded before Flop
Seat 6: oceangurl2 (big blind) folded before Flop
Seat 7: JJin91 collected (10125)
Seat 8: VagColeSlaw folded before Flop (didn't bet)
Seat 9: daisy316 folded before Flop (didn't bet)


*********** # 186 **************
PokerStars Hand #170380256252: Tournament #1622573280, $9.10+$0.90 USD =
Hold'em No Limit - Level XXII (2000/4000) - 2017/05/25 21:50:04 ET
Table '1622573280 3' 9-max Seat #4 is the button
Seat 1: se3dog (57460 in chips)=20
Seat 3: mrbfmrbf (138673 in chips)=20
Seat 4: AngeloP04 (37444 in chips)=20
Seat 6: oceangurl2 (55954 in chips)=20
Seat 7: JJin91 (96178 in chips)=20
Seat 8: VagColeSlaw (37133 in chips)=20
Seat 9: daisy316 (49482 in chips)=20
se3dog: posts the ante 500
mrbfmrbf: posts the ante 500
AngeloP04: posts the ante 500
oceangurl2: posts the ante 500
JJin91: posts the ante 500
VagColeSlaw: posts the ante 500
daisy316: posts the ante 500
oceangurl2: posts small blind 2000
JJin91: posts big blind 4000
*** HOLE CARDS ***
Dealt to JJin91 [Qd Kc]
VagColeSlaw: folds=20
daisy316: raises 4000 to 8000
se3dog: folds=20
mrbfmrbf: folds=20
AngeloP04: folds=20
oceangurl2: folds=20
JJin91: raises 87678 to 95678 and is all-in
daisy316: folds=20
Uncalled bet (87678) returned to JJin91
JJin91 collected 21500 from pot
JJin91: doesn't show hand=20
*** SUMMARY ***
Total pot 21500 | Rake 0=20
Seat 1: se3dog folded before Flop (didn't bet)
Seat 3: mrbfmrbf folded before Flop (didn't bet)
Seat 4: AngeloP04 (button) folded before Flop (didn't bet)
Seat 6: oceangurl2 (small blind) folded before Flop
Seat 7: JJin91 (big blind) collected (21500)
Seat 8: VagColeSlaw folded before Flop (didn't bet)
Seat 9: daisy316 folded before Flop


*********** # 187 **************
PokerStars Hand #170380256366: Tournament #1622573280, $9.10+$0.90 USD =
Hold'em No Limit - Level XXII (2000/4000) - 2017/05/25 21:50:28 ET
Table '1622573280 3' 9-max Seat #6 is the button
Seat 1: se3dog (56960 in chips)=20
Seat 3: mrbfmrbf (138173 in chips)=20
Seat 4: AngeloP04 (36944 in chips)=20
Seat 6: oceangurl2 (53454 in chips)=20
Seat 7: JJin91 (109178 in chips)=20
Seat 8: VagColeSlaw (36633 in chips)=20
Seat 9: daisy316 (40982 in chips)=20
se3dog: posts the ante 500
mrbfmrbf: posts the ante 500
AngeloP04: posts the ante 500
oceangurl2: posts the ante 500
JJin91: posts the ante 500
VagColeSlaw: posts the ante 500
daisy316: posts the ante 500
JJin91: posts small blind 2000
VagColeSlaw: posts big blind 4000
*** HOLE CARDS ***
Dealt to JJin91 [2h 8d]
daisy316: folds=20
se3dog: folds=20
mrbfmrbf: folds=20
AngeloP04: raises 32444 to 36444 and is all-in
oceangurl2: folds=20
JJin91: folds=20
VagColeSlaw: folds=20
Uncalled bet (32444) returned to AngeloP04
AngeloP04 collected 13500 from pot
AngeloP04: doesn't show hand=20
*** SUMMARY ***
Total pot 13500 | Rake 0=20
Seat 1: se3dog folded before Flop (didn't bet)
Seat 3: mrbfmrbf folded before Flop (didn't bet)
Seat 4: AngeloP04 collected (13500)
Seat 6: oceangurl2 (button) folded before Flop (didn't bet)
Seat 7: JJin91 (small blind) folded before Flop
Seat 8: VagColeSlaw (big blind) folded before Flop
Seat 9: daisy316 folded before Flop (didn't bet)


*********** # 188 **************
PokerStars Hand #170380256465: Tournament #1622573280, $9.10+$0.90 USD =
Hold'em No Limit - Level XXII (2000/4000) - 2017/05/25 21:50:48 ET
Table '1622573280 3' 9-max Seat #7 is the button
Seat 1: se3dog (56460 in chips)=20
Seat 3: mrbfmrbf (137673 in chips)=20
Seat 4: AngeloP04 (45944 in chips)=20
Seat 6: oceangurl2 (52954 in chips)=20
Seat 7: JJin91 (106678 in chips)=20
Seat 8: VagColeSlaw (32133 in chips)=20
Seat 9: daisy316 (40482 in chips)=20
se3dog: posts the ante 500
mrbfmrbf: posts the ante 500
AngeloP04: posts the ante 500
oceangurl2: posts the ante 500
JJin91: posts the ante 500
VagColeSlaw: posts the ante 500
daisy316: posts the ante 500
VagColeSlaw: posts small blind 2000
daisy316: posts big blind 4000
*** HOLE CARDS ***
Dealt to JJin91 [Kh Ah]
se3dog: folds=20
mrbfmrbf: folds=20
AngeloP04: raises 41444 to 45444 and is all-in
oceangurl2: folds=20
JJin91: calls 45444
VagColeSlaw: calls 29633 and is all-in
daisy316: folds=20
*** FLOP *** [5s 7d 7c]
*** TURN *** [5s 7d 7c] [7s]
*** RIVER *** [5s 7d 7c 7s] [2c]
*** SHOW DOWN ***
AngeloP04: shows [2d 2h] (a full house, Sevens full of Deuces)
JJin91: shows [Kh Ah] (three of a kind, Sevens)
AngeloP04 collected 27622 from side pot
VagColeSlaw: shows [Kc Ad] (three of a kind, Sevens)
AngeloP04 collected 102399 from main pot
VagColeSlaw finished the tournament in 21st place and received $15.28.
*** SUMMARY ***
Total pot 130021 Main pot 102399. Side pot 27622. | Rake 0=20
Board [5s 7d 7c 7s 2c]
Seat 1: se3dog folded before Flop (didn't bet)
Seat 3: mrbfmrbf folded before Flop (didn't bet)
Seat 4: AngeloP04 showed [2d 2h] and won (130021) with a full house, Se=
vens full of Deuces
Seat 6: oceangurl2 folded before Flop (didn't bet)
Seat 7: JJin91 (button) showed [Kh Ah] and lost with three of a kind, S=
evens
Seat 8: VagColeSlaw (small blind) showed [Kc Ad] and lost with three of=
 a kind, Sevens
Seat 9: daisy316 (big blind) folded before Flop


*********** # 189 **************
PokerStars Hand #170380256602: Tournament #1622573280, $9.10+$0.90 USD =
Hold'em No Limit - Level XXII (2000/4000) - 2017/05/25 21:51:16 ET
Table '1622573280 3' 9-max Seat #9 is the button
Seat 1: se3dog (55960 in chips)=20
Seat 3: mrbfmrbf (137173 in chips)=20
Seat 4: AngeloP04 (130021 in chips)=20
Seat 6: oceangurl2 (52454 in chips)=20
Seat 7: JJin91 (60734 in chips)=20
Seat 9: daisy316 (35982 in chips)=20
se3dog: posts the ante 500
mrbfmrbf: posts the ante 500
AngeloP04: posts the ante 500
oceangurl2: posts the ante 500
JJin91: posts the ante 500
daisy316: posts the ante 500
se3dog: posts small blind 2000
mrbfmrbf: posts big blind 4000
*** HOLE CARDS ***
Dealt to JJin91 [9s Jh]
AngeloP04: folds=20
oceangurl2: folds=20
mrbfmrbf said, "nh"
JJin91: folds=20
daisy316: raises 13000 to 17000
oceangurl2 said, "vnh"
JJin91 said, "nh"
se3dog: raises 38460 to 55460 and is all-in
mrbfmrbf: folds=20
daisy316: calls 18482 and is all-in
Uncalled bet (19978) returned to se3dog
*** FLOP *** [3c Qs Qh]
AngeloP04 said, "lucky"
*** TURN *** [3c Qs Qh] [2s]
*** RIVER *** [3c Qs Qh 2s] [6c]
*** SHOW DOWN ***
se3dog: shows [Kc Ks] (two pair, Kings and Queens)
daisy316: shows [5d Ah] (a pair of Queens)
se3dog collected 77964 from pot
daisy316 finished the tournament in 20th place and received $15.28.
*** SUMMARY ***
Total pot 77964 | Rake 0=20
Board [3c Qs Qh 2s 6c]
Seat 1: se3dog (small blind) showed [Kc Ks] and won (77964) with two pa=
ir, Kings and Queens
Seat 3: mrbfmrbf (big blind) folded before Flop
Seat 4: AngeloP04 folded before Flop (didn't bet)
Seat 6: oceangurl2 folded before Flop (didn't bet)
Seat 7: JJin91 folded before Flop (didn't bet)
Seat 9: daisy316 (button) showed [5d Ah] and lost with a pair of Queens


*********** # 190 **************
PokerStars Hand #170380256718: Tournament #1622573280, $9.10+$0.90 USD =
Hold'em No Limit - Level XXII (2000/4000) - 2017/05/25 21:51:43 ET
Table '1622573280 3' 9-max Seat #1 is the button
Seat 1: se3dog (97942 in chips)=20
Seat 3: mrbfmrbf (132673 in chips)=20
Seat 4: AngeloP04 (129521 in chips)=20
Seat 6: oceangurl2 (51954 in chips)=20
Seat 7: JJin91 (60234 in chips)=20
se3dog: posts the ante 500
mrbfmrbf: posts the ante 500
AngeloP04: posts the ante 500
oceangurl2: posts the ante 500
JJin91: posts the ante 500
mrbfmrbf: posts small blind 2000
AngeloP04: posts big blind 4000
*** HOLE CARDS ***
Dealt to JJin91 [3h 5d]
oceangurl2: folds=20
JJin91: folds=20
se3dog: folds=20
mrbfmrbf: raises 4000 to 8000
AngeloP04: folds=20
Uncalled bet (4000) returned to mrbfmrbf
mrbfmrbf collected 10500 from pot
*** SUMMARY ***
Total pot 10500 | Rake 0=20
Seat 1: se3dog (button) folded before Flop (didn't bet)
Seat 3: mrbfmrbf (small blind) collected (10500)
Seat 4: AngeloP04 (big blind) folded before Flop
Seat 6: oceangurl2 folded before Flop (didn't bet)
Seat 7: JJin91 folded before Flop (didn't bet)


*********** # 191 **************
PokerStars Hand #170380256780: Tournament #1622573280, $9.10+$0.90 USD =
Hold'em No Limit - Level XXII (2000/4000) - 2017/05/25 21:51:56 ET
Table '1622573280 3' 9-max Seat #3 is the button
Seat 1: se3dog (97442 in chips)=20
Seat 2: zootsuit101 (61916 in chips)=20
Seat 3: mrbfmrbf (138673 in chips)=20
Seat 4: AngeloP04 (125021 in chips)=20
Seat 6: oceangurl2 (51454 in chips)=20
Seat 7: JJin91 (59734 in chips)=20
se3dog: posts the ante 500
zootsuit101: posts the ante 500
mrbfmrbf: posts the ante 500
AngeloP04: posts the ante 500
oceangurl2: posts the ante 500
JJin91: posts the ante 500
AngeloP04: posts small blind 2000
oceangurl2: posts big blind 4000
*** HOLE CARDS ***
Dealt to JJin91 [As Js]
JJin91: raises 55234 to 59234 and is all-in
se3dog: folds=20
zootsuit101: folds=20
mrbfmrbf: folds=20
AngeloP04: folds=20
oceangurl2: folds=20
Uncalled bet (55234) returned to JJin91
JJin91 collected 13000 from pot
JJin91: doesn't show hand=20
*** SUMMARY ***
Total pot 13000 | Rake 0=20
Seat 1: se3dog folded before Flop (didn't bet)
Seat 2: zootsuit101 folded before Flop (didn't bet)
Seat 3: mrbfmrbf (button) folded before Flop (didn't bet)
Seat 4: AngeloP04 (small blind) folded before Flop
Seat 6: oceangurl2 (big blind) folded before Flop
Seat 7: JJin91 collected (13000)


*********** # 192 **************
PokerStars Hand #170380256831: Tournament #1622573280, $9.10+$0.90 USD =
Hold'em No Limit - Level XXII (2000/4000) - 2017/05/25 21:52:07 ET
Table '1622573280 3' 9-max Seat #4 is the button
Seat 1: se3dog (96942 in chips)=20
Seat 2: zootsuit101 (61416 in chips)=20
Seat 3: mrbfmrbf (138173 in chips)=20
Seat 4: AngeloP04 (122521 in chips)=20
Seat 5: abidumar (188674 in chips) out of hand (moved from another tabl=
e into small blind)
Seat 6: oceangurl2 (46954 in chips)=20
Seat 7: JJin91 (68234 in chips)=20
Seat 8: mlavadre1708 (90966 in chips)=20
Seat 9: IknowHow2pla (93738 in chips)=20
se3dog: posts the ante 500
zootsuit101: posts the ante 500
mrbfmrbf: posts the ante 500
AngeloP04: posts the ante 500
oceangurl2: posts the ante 500
JJin91: posts the ante 500
mlavadre1708: posts the ante 500
IknowHow2pla: posts the ante 500
oceangurl2: posts small blind 2000
JJin91: posts big blind 4000
*** HOLE CARDS ***
Dealt to JJin91 [6h 3d]
mlavadre1708: raises 4000 to 8000
IknowHow2pla: folds=20
se3dog: folds=20
zootsuit101: folds=20
mrbfmrbf: folds=20
AngeloP04: folds=20
oceangurl2: folds=20
JJin91: folds=20
Uncalled bet (4000) returned to mlavadre1708
mlavadre1708 collected 14000 from pot
mlavadre1708: doesn't show hand=20
*** SUMMARY ***
Total pot 14000 | Rake 0=20
Seat 1: se3dog folded before Flop (didn't bet)
Seat 2: zootsuit101 folded before Flop (didn't bet)
Seat 3: mrbfmrbf folded before Flop (didn't bet)
Seat 4: AngeloP04 (button) folded before Flop (didn't bet)
Seat 6: oceangurl2 (small blind) folded before Flop
Seat 7: JJin91 (big blind) folded before Flop
Seat 8: mlavadre1708 collected (14000)
Seat 9: IknowHow2pla folded before Flop (didn't bet)


*********** # 193 **************
PokerStars Hand #170380256939: Tournament #1622573280, $9.10+$0.90 USD =
Hold'em No Limit - Level XXII (2000/4000) - 2017/05/25 21:52:27 ET
Table '1622573280 3' 9-max Seat #6 is the button
Seat 1: se3dog (96442 in chips)=20
Seat 2: zootsuit101 (60916 in chips)=20
Seat 3: mrbfmrbf (137673 in chips)=20
Seat 4: AngeloP04 (122021 in chips)=20
Seat 5: abidumar (188674 in chips)=20
Seat 6: oceangurl2 (44454 in chips)=20
Seat 7: JJin91 (63734 in chips)=20
Seat 8: mlavadre1708 (100466 in chips)=20
Seat 9: IknowHow2pla (93238 in chips)=20
se3dog: posts the ante 500
zootsuit101: posts the ante 500
mrbfmrbf: posts the ante 500
AngeloP04: posts the ante 500
abidumar: posts the ante 500
oceangurl2: posts the ante 500
JJin91: posts the ante 500
mlavadre1708: posts the ante 500
IknowHow2pla: posts the ante 500
JJin91: posts small blind 2000
mlavadre1708: posts big blind 4000
*** HOLE CARDS ***
Dealt to JJin91 [9d 9h]
IknowHow2pla: folds=20
se3dog: folds=20
zootsuit101: raises 6000 to 10000
mrbfmrbf: folds=20
AngeloP04: folds=20
abidumar: folds=20
oceangurl2: folds=20
JJin91: raises 53234 to 63234 and is all-in
mlavadre1708: folds=20
zootsuit101: folds=20
Uncalled bet (53234) returned to JJin91
JJin91 collected 28500 from pot
JJin91: doesn't show hand=20
*** SUMMARY ***
Total pot 28500 | Rake 0=20
Seat 1: se3dog folded before Flop (didn't bet)
Seat 2: zootsuit101 folded before Flop
Seat 3: mrbfmrbf folded before Flop (didn't bet)
Seat 4: AngeloP04 folded before Flop (didn't bet)
Seat 5: abidumar folded before Flop (didn't bet)
Seat 6: oceangurl2 (button) folded before Flop (didn't bet)
Seat 7: JJin91 (small blind) collected (28500)
Seat 8: mlavadre1708 (big blind) folded before Flop
Seat 9: IknowHow2pla folded before Flop (didn't bet)


*********** # 194 **************
PokerStars Hand #170380257047: Tournament #1622573280, $9.10+$0.90 USD =
Hold'em No Limit - Level XXII (2000/4000) - 2017/05/25 21:52:48 ET
Table '1622573280 3' 9-max Seat #7 is the button
Seat 1: se3dog (95942 in chips)=20
Seat 2: zootsuit101 (50416 in chips)=20
Seat 3: mrbfmrbf (137173 in chips)=20
Seat 4: AngeloP04 (121521 in chips)=20
Seat 5: abidumar (188174 in chips)=20
Seat 6: oceangurl2 (43954 in chips)=20
Seat 7: JJin91 (81734 in chips)=20
Seat 8: mlavadre1708 (95966 in chips)=20
Seat 9: IknowHow2pla (92738 in chips)=20
se3dog: posts the ante 500
zootsuit101: posts the ante 500
mrbfmrbf: posts the ante 500
AngeloP04: posts the ante 500
abidumar: posts the ante 500
oceangurl2: posts the ante 500
JJin91: posts the ante 500
mlavadre1708: posts the ante 500
IknowHow2pla: posts the ante 500
mlavadre1708: posts small blind 2000
IknowHow2pla: posts big blind 4000
*** HOLE CARDS ***
Dealt to JJin91 [9s 7c]
se3dog: folds=20
zootsuit101: folds=20
mrbfmrbf: folds=20
AngeloP04: folds=20
abidumar: folds=20
oceangurl2: folds=20
JJin91: folds=20
mlavadre1708: raises 4000 to 8000
IknowHow2pla: calls 4000
*** FLOP *** [Jh Kc 9c]
mlavadre1708: checks=20
IknowHow2pla: bets 8000
mlavadre1708: calls 8000
*** TURN *** [Jh Kc 9c] [6c]
mlavadre1708: checks=20
IknowHow2pla: checks=20
*** RIVER *** [Jh Kc 9c 6c] [7d]
mlavadre1708: bets 17000
IknowHow2pla: calls 17000
*** SHOW DOWN ***
mlavadre1708: shows [Td 8c] (a straight, Seven to Jack)
IknowHow2pla: shows [Qs Ts] (a straight, Nine to King)
IknowHow2pla collected 70500 from pot
*** SUMMARY ***
Total pot 70500 | Rake 0=20
Board [Jh Kc 9c 6c 7d]
Seat 1: se3dog folded before Flop (didn't bet)
Seat 2: zootsuit101 folded before Flop (didn't bet)
Seat 3: mrbfmrbf folded before Flop (didn't bet)
Seat 4: AngeloP04 folded before Flop (didn't bet)
Seat 5: abidumar folded before Flop (didn't bet)
Seat 6: oceangurl2 folded before Flop (didn't bet)
Seat 7: JJin91 (button) folded before Flop (didn't bet)
Seat 8: mlavadre1708 (small blind) showed [Td 8c] and lost with a strai=
ght, Seven to Jack
Seat 9: IknowHow2pla (big blind) showed [Qs Ts] and won (70500) with a =
straight, Nine to King


*********** # 195 **************
PokerStars Hand #170380257410: Tournament #1622573280, $9.10+$0.90 USD =
Hold'em No Limit - Level XXII (2000/4000) - 2017/05/25 21:54:01 ET
Table '1622573280 3' 9-max Seat #8 is the button
Seat 1: se3dog (95442 in chips)=20
Seat 2: zootsuit101 (49916 in chips)=20
Seat 3: mrbfmrbf (136673 in chips)=20
Seat 4: AngeloP04 (121021 in chips)=20
Seat 5: abidumar (187674 in chips)=20
Seat 6: oceangurl2 (43454 in chips)=20
Seat 7: JJin91 (81234 in chips)=20
Seat 8: mlavadre1708 (62466 in chips)=20
Seat 9: IknowHow2pla (129738 in chips)=20
se3dog: posts the ante 500
zootsuit101: posts the ante 500
mrbfmrbf: posts the ante 500
AngeloP04: posts the ante 500
abidumar: posts the ante 500
oceangurl2: posts the ante 500
JJin91: posts the ante 500
mlavadre1708: posts the ante 500
IknowHow2pla: posts the ante 500
IknowHow2pla: posts small blind 2000
se3dog: posts big blind 4000
*** HOLE CARDS ***
Dealt to JJin91 [Ah Tc]
zootsuit101: folds=20
mrbfmrbf: raises 8000 to 12000
AngeloP04: folds=20
abidumar: folds=20
oceangurl2: folds=20
JJin91: calls 12000
mlavadre1708: folds=20
IknowHow2pla: calls 10000
se3dog: folds=20
*** FLOP *** [Th 6c Jc]
IknowHow2pla: checks=20
mrbfmrbf: checks=20
JJin91: bets 18465
IknowHow2pla: calls 18465
mrbfmrbf: folds=20
*** TURN *** [Th 6c Jc] [Kc]
IknowHow2pla: checks=20
JJin91: bets 50269 and is all-in
IknowHow2pla: folds=20
Uncalled bet (50269) returned to JJin91
JJin91 collected 81430 from pot
JJin91: doesn't show hand=20
*** SUMMARY ***
Total pot 81430 | Rake 0=20
Board [Th 6c Jc Kc]
Seat 1: se3dog (big blind) folded before Flop
Seat 2: zootsuit101 folded before Flop (didn't bet)
Seat 3: mrbfmrbf folded on the Flop
Seat 4: AngeloP04 folded before Flop (didn't bet)
Seat 5: abidumar folded before Flop (didn't bet)
Seat 6: oceangurl2 folded before Flop (didn't bet)
Seat 7: JJin91 collected (81430)
Seat 8: mlavadre1708 (button) folded before Flop (didn't bet)
Seat 9: IknowHow2pla (small blind) folded on the Turn


*********** # 196 **************
PokerStars Hand #170380259277: Tournament #1622573280, $9.10+$0.90 USD =
Hold'em No Limit - Level XXII (2000/4000) - 2017/05/25 22:01:13 ET
Table '1622573280 3' 9-max Seat #9 is the button
Seat 1: se3dog (90942 in chips)=20
Seat 2: zootsuit101 (49416 in chips)=20
Seat 3: mrbfmrbf (124173 in chips)=20
Seat 4: AngeloP04 (120521 in chips)=20
Seat 5: abidumar (187174 in chips)=20
Seat 6: oceangurl2 (42954 in chips)=20
Seat 7: JJin91 (131699 in chips)=20
Seat 8: mlavadre1708 (61966 in chips)=20
Seat 9: IknowHow2pla (98773 in chips)=20
se3dog: posts the ante 500
zootsuit101: posts the ante 500
mrbfmrbf: posts the ante 500
AngeloP04: posts the ante 500
abidumar: posts the ante 500
oceangurl2: posts the ante 500
JJin91: posts the ante 500
mlavadre1708: posts the ante 500
IknowHow2pla: posts the ante 500
se3dog: posts small blind 2000
zootsuit101: posts big blind 4000
*** HOLE CARDS ***
Dealt to JJin91 [4s 5h]
mrbfmrbf: folds=20
AngeloP04: folds=20
abidumar: folds=20
oceangurl2: folds=20
JJin91: folds=20
mlavadre1708: raises 8000 to 12000
IknowHow2pla: folds=20
se3dog: folds=20
zootsuit101: raises 36916 to 48916 and is all-in
mlavadre1708: calls 36916
*** FLOP *** [Jd Qs 9h]
*** TURN *** [Jd Qs 9h] [2d]
*** RIVER *** [Jd Qs 9h 2d] [Jh]
*** SHOW DOWN ***
zootsuit101: shows [Ac Ad] (two pair, Aces and Jacks)
mlavadre1708: shows [As Kc] (a pair of Jacks)
zootsuit101 collected 104332 from pot
*** SUMMARY ***
Total pot 104332 | Rake 0=20
Board [Jd Qs 9h 2d Jh]
Seat 1: se3dog (small blind) folded before Flop
Seat 2: zootsuit101 (big blind) showed [Ac Ad] and won (104332) with tw=
o pair, Aces and Jacks
Seat 3: mrbfmrbf folded before Flop (didn't bet)
Seat 4: AngeloP04 folded before Flop (didn't bet)
Seat 5: abidumar folded before Flop (didn't bet)
Seat 6: oceangurl2 folded before Flop (didn't bet)
Seat 7: JJin91 folded before Flop (didn't bet)
Seat 8: mlavadre1708 showed [As Kc] and lost with a pair of Jacks
Seat 9: IknowHow2pla (button) folded before Flop (didn't bet)


*********** # 197 **************
PokerStars Hand #170380259524: Tournament #1622573280, $9.10+$0.90 USD =
Hold'em No Limit - Level XXII (2000/4000) - 2017/05/25 22:01:59 ET
Table '1622573280 3' 9-max Seat #1 is the button
Seat 1: se3dog (88442 in chips)=20
Seat 2: zootsuit101 (104332 in chips)=20
Seat 3: mrbfmrbf (123673 in chips)=20
Seat 4: AngeloP04 (120021 in chips)=20
Seat 5: abidumar (186674 in chips)=20
Seat 6: oceangurl2 (42454 in chips)=20
Seat 7: JJin91 (131199 in chips)=20
Seat 8: mlavadre1708 (12550 in chips)=20
Seat 9: IknowHow2pla (98273 in chips)=20
se3dog: posts the ante 500
zootsuit101: posts the ante 500
mrbfmrbf: posts the ante 500
AngeloP04: posts the ante 500
abidumar: posts the ante 500
oceangurl2: posts the ante 500
JJin91: posts the ante 500
mlavadre1708: posts the ante 500
IknowHow2pla: posts the ante 500
zootsuit101: posts small blind 2000
mrbfmrbf: posts big blind 4000
*** HOLE CARDS ***
Dealt to JJin91 [Jd 2d]
AngeloP04: folds=20
abidumar: folds=20
oceangurl2: folds=20
mlavadre1708 said, "auch"
JJin91: folds=20
mlavadre1708: raises 8050 to 12050 and is all-in
IknowHow2pla: folds=20
se3dog: folds=20
zootsuit101: folds=20
mrbfmrbf: folds=20
Uncalled bet (8050) returned to mlavadre1708
mlavadre1708 collected 14500 from pot
mlavadre1708: doesn't show hand=20
*** SUMMARY ***
Total pot 14500 | Rake 0=20
Seat 1: se3dog (button) folded before Flop (didn't bet)
Seat 2: zootsuit101 (small blind) folded before Flop
Seat 3: mrbfmrbf (big blind) folded before Flop
Seat 4: AngeloP04 folded before Flop (didn't bet)
Seat 5: abidumar folded before Flop (didn't bet)
Seat 6: oceangurl2 folded before Flop (didn't bet)
Seat 7: JJin91 folded before Flop (didn't bet)
Seat 8: mlavadre1708 collected (14500)
Seat 9: IknowHow2pla folded before Flop (didn't bet)


*********** # 198 **************
PokerStars Hand #170380259641: Tournament #1622573280, $9.10+$0.90 USD =
Hold'em No Limit - Level XXII (2000/4000) - 2017/05/25 22:02:21 ET
Table '1622573280 3' 9-max Seat #2 is the button
Seat 1: se3dog (87942 in chips)=20
Seat 2: zootsuit101 (101832 in chips)=20
Seat 3: mrbfmrbf (119173 in chips)=20
Seat 4: AngeloP04 (119521 in chips)=20
Seat 5: abidumar (186174 in chips)=20
Seat 6: oceangurl2 (41954 in chips)=20
Seat 7: JJin91 (130699 in chips)=20
Seat 8: mlavadre1708 (22550 in chips)=20
Seat 9: IknowHow2pla (97773 in chips)=20
se3dog: posts the ante 500
zootsuit101: posts the ante 500
mrbfmrbf: posts the ante 500
AngeloP04: posts the ante 500
abidumar: posts the ante 500
oceangurl2: posts the ante 500
JJin91: posts the ante 500
mlavadre1708: posts the ante 500
IknowHow2pla: posts the ante 500
mrbfmrbf: posts small blind 2000
AngeloP04: posts big blind 4000
*** HOLE CARDS ***
Dealt to JJin91 [2c 9s]
abidumar: folds=20
oceangurl2: folds=20
JJin91: folds=20
mlavadre1708: folds=20
IknowHow2pla: folds=20
se3dog: folds=20
zootsuit101: folds=20
mrbfmrbf: raises 4000 to 8000
AngeloP04: folds=20
Uncalled bet (4000) returned to mrbfmrbf
mrbfmrbf collected 12500 from pot
mrbfmrbf: doesn't show hand=20
*** SUMMARY ***
Total pot 12500 | Rake 0=20
Seat 1: se3dog folded before Flop (didn't bet)
Seat 2: zootsuit101 (button) folded before Flop (didn't bet)
Seat 3: mrbfmrbf (small blind) collected (12500)
Seat 4: AngeloP04 (big blind) folded before Flop
Seat 5: abidumar folded before Flop (didn't bet)
Seat 6: oceangurl2 folded before Flop (didn't bet)
Seat 7: JJin91 folded before Flop (didn't bet)
Seat 8: mlavadre1708 folded before Flop (didn't bet)
Seat 9: IknowHow2pla folded before Flop (didn't bet)


*********** # 199 **************
PokerStars Hand #170380259754: Tournament #1622573280, $9.10+$0.90 USD =
Hold'em No Limit - Level XXII (2000/4000) - 2017/05/25 22:02:44 ET
Table '1622573280 3' 9-max Seat #3 is the button
Seat 2: zootsuit101 (101332 in chips)=20
Seat 3: mrbfmrbf (127173 in chips)=20
Seat 4: AngeloP04 (115021 in chips)=20
Seat 5: abidumar (185674 in chips)=20
Seat 6: oceangurl2 (41454 in chips)=20
Seat 7: JJin91 (130199 in chips)=20
Seat 8: mlavadre1708 (22050 in chips)=20
Seat 9: IknowHow2pla (97273 in chips)=20
zootsuit101: posts the ante 500
mrbfmrbf: posts the ante 500
AngeloP04: posts the ante 500
abidumar: posts the ante 500
oceangurl2: posts the ante 500
JJin91: posts the ante 500
mlavadre1708: posts the ante 500
IknowHow2pla: posts the ante 500
AngeloP04: posts small blind 2000
abidumar: posts big blind 4000
*** HOLE CARDS ***
Dealt to JJin91 [2d 4s]
oceangurl2: folds=20
JJin91: folds=20
mlavadre1708: folds=20
IknowHow2pla: raises 4000 to 8000
zootsuit101: folds=20
mrbfmrbf: folds=20
AngeloP04: folds=20
abidumar: calls 4000
*** FLOP *** [Kd Ts Kh]
abidumar: checks=20
IknowHow2pla: checks=20
*** TURN *** [Kd Ts Kh] [2c]
abidumar: checks=20
IknowHow2pla: bets 4000
abidumar: calls 4000
*** RIVER *** [Kd Ts Kh 2c] [5h]
abidumar: checks=20
IknowHow2pla: checks=20
*** SHOW DOWN ***
abidumar: shows [Th Qs] (two pair, Kings and Tens)
IknowHow2pla: mucks hand=20
abidumar collected 30000 from pot
*** SUMMARY ***
Total pot 30000 | Rake 0=20
Board [Kd Ts Kh 2c 5h]
Seat 2: zootsuit101 folded before Flop (didn't bet)
Seat 3: mrbfmrbf (button) folded before Flop (didn't bet)
Seat 4: AngeloP04 (small blind) folded before Flop
Seat 5: abidumar (big blind) showed [Th Qs] and won (30000) with two pa=
ir, Kings and Tens
Seat 6: oceangurl2 folded before Flop (didn't bet)
Seat 7: JJin91 folded before Flop (didn't bet)
Seat 8: mlavadre1708 folded before Flop (didn't bet)
Seat 9: IknowHow2pla mucked [7h 7s]


*********** # 200 **************
PokerStars Hand #170380259993: Tournament #1622573280, $9.10+$0.90 USD =
Hold'em No Limit - Level XXII (2000/4000) - 2017/05/25 22:03:35 ET
Table '1622573280 3' 9-max Seat #4 is the button
Seat 2: zootsuit101 (100832 in chips)=20
Seat 3: mrbfmrbf (126673 in chips)=20
Seat 4: AngeloP04 (112521 in chips)=20
Seat 5: abidumar (203174 in chips)=20
Seat 6: oceangurl2 (40954 in chips)=20
Seat 7: JJin91 (129699 in chips)=20
Seat 8: mlavadre1708 (21550 in chips)=20
Seat 9: IknowHow2pla (84773 in chips)=20
zootsuit101: posts the ante 500
mrbfmrbf: posts the ante 500
AngeloP04: posts the ante 500
abidumar: posts the ante 500
oceangurl2: posts the ante 500
JJin91: posts the ante 500
mlavadre1708: posts the ante 500
IknowHow2pla: posts the ante 500
abidumar: posts small blind 2000
oceangurl2: posts big blind 4000
*** HOLE CARDS ***
Dealt to JJin91 [Jc 5s]
JJin91: folds=20
mlavadre1708: raises 17050 to 21050 and is all-in
IknowHow2pla: folds=20
zootsuit101: folds=20
mrbfmrbf: calls 21050
AngeloP04: folds=20
abidumar: calls 19050
oceangurl2: folds=20
*** FLOP *** [5h 9s Qh]
abidumar: checks=20
mrbfmrbf: checks=20
*** TURN *** [5h 9s Qh] [Th]
abidumar: checks=20
mrbfmrbf: checks=20
*** RIVER *** [5h 9s Qh Th] [7s]
abidumar: bets 4000
mrbfmrbf: folds=20
Uncalled bet (4000) returned to abidumar
*** SHOW DOWN ***
abidumar: shows [Kh Qd] (a pair of Queens)
mlavadre1708: shows [8d 8s] (a pair of Eights)
abidumar collected 71150 from pot
mlavadre1708 finished the tournament in 16th place and received $19.11.
*** SUMMARY ***
Total pot 71150 | Rake 0=20
Board [5h 9s Qh Th 7s]
Seat 2: zootsuit101 folded before Flop (didn't bet)
Seat 3: mrbfmrbf folded on the River
Seat 4: AngeloP04 (button) folded before Flop (didn't bet)
Seat 5: abidumar (small blind) showed [Kh Qd] and won (71150) with a pa=
ir of Queens
Seat 6: oceangurl2 (big blind) folded before Flop
Seat 7: JJin91 folded before Flop (didn't bet)
Seat 8: mlavadre1708 showed [8d 8s] and lost with a pair of Eights
Seat 9: IknowHow2pla folded before Flop (didn't bet)


*********** # 201 **************
PokerStars Hand #170381714652: Tournament #1622573280, $9.10+$0.90 USD =
Hold'em No Limit - Level XXII (2000/4000) - 2017/05/25 22:04:23 ET
Table '1622573280 3' 9-max Seat #5 is the button
Seat 2: zootsuit101 (100332 in chips)=20
Seat 3: mrbfmrbf (105123 in chips)=20
Seat 4: AngeloP04 (112021 in chips)=20
Seat 5: abidumar (252774 in chips)=20
Seat 6: oceangurl2 (36454 in chips)=20
Seat 7: JJin91 (129199 in chips)=20
Seat 9: IknowHow2pla (84273 in chips)=20
zootsuit101: posts the ante 500
mrbfmrbf: posts the ante 500
AngeloP04: posts the ante 500
abidumar: posts the ante 500
oceangurl2: posts the ante 500
JJin91: posts the ante 500
IknowHow2pla: posts the ante 500
oceangurl2: posts small blind 2000
JJin91: posts big blind 4000
*** HOLE CARDS ***
Dealt to JJin91 [9d Ks]
IknowHow2pla: folds=20
zootsuit101: folds=20
mrbfmrbf: folds=20
AngeloP04: folds=20
abidumar: calls 4000
oceangurl2: calls 2000
JJin91: checks=20
*** FLOP *** [Qh 6h Td]
oceangurl2: bets 31954 and is all-in
JJin91: folds=20
abidumar: calls 31954
*** TURN *** [Qh 6h Td] [2h]
*** RIVER *** [Qh 6h Td 2h] [6s]
*** SHOW DOWN ***
oceangurl2: shows [8h 7h] (a flush, Queen high)
abidumar: shows [Th Kd] (two pair, Tens and Sixes)
oceangurl2 collected 79408 from pot
*** SUMMARY ***
Total pot 79408 | Rake 0=20
Board [Qh 6h Td 2h 6s]
Seat 2: zootsuit101 folded before Flop (didn't bet)
Seat 3: mrbfmrbf folded before Flop (didn't bet)
Seat 4: AngeloP04 folded before Flop (didn't bet)
Seat 5: abidumar (button) showed [Th Kd] and lost with two pair, Tens a=
nd Sixes
Seat 6: oceangurl2 (small blind) showed [8h 7h] and won (79408) with a =
flush, Queen high
Seat 7: JJin91 (big blind) folded on the Flop
Seat 9: IknowHow2pla folded before Flop (didn't bet)


*********** # 202 **************
PokerStars Hand #170381714854: Tournament #1622573280, $9.10+$0.90 USD =
Hold'em No Limit - Level XXII (2000/4000) - 2017/05/25 22:05:01 ET
Table '1622573280 3' 9-max Seat #6 is the button
Seat 2: zootsuit101 (99832 in chips)=20
Seat 3: mrbfmrbf (104623 in chips)=20
Seat 4: AngeloP04 (111521 in chips)=20
Seat 5: abidumar (216320 in chips)=20
Seat 6: oceangurl2 (79408 in chips)=20
Seat 7: JJin91 (124699 in chips)=20
Seat 9: IknowHow2pla (83773 in chips)=20
zootsuit101: posts the ante 500
mrbfmrbf: posts the ante 500
AngeloP04: posts the ante 500
abidumar: posts the ante 500
oceangurl2: posts the ante 500
JJin91: posts the ante 500
IknowHow2pla: posts the ante 500
JJin91: posts small blind 2000
IknowHow2pla: posts big blind 4000
*** HOLE CARDS ***
Dealt to JJin91 [Ac 2s]
zootsuit101: folds=20
mrbfmrbf: raises 4000 to 8000
AngeloP04: folds=20
abidumar: folds=20
oceangurl2: folds=20
JJin91: folds=20
IknowHow2pla: calls 4000
*** FLOP *** [4c 3c 5c]
IknowHow2pla: checks=20
mrbfmrbf: checks=20
*** TURN *** [4c 3c 5c] [9h]
IknowHow2pla: checks=20
mrbfmrbf: checks=20
*** RIVER *** [4c 3c 5c 9h] [Jc]
IknowHow2pla: checks=20
mrbfmrbf: checks=20
*** SHOW DOWN ***
IknowHow2pla: shows [Td 4d] (a pair of Fours)
mrbfmrbf: shows [Th Js] (a pair of Jacks)
mrbfmrbf collected 21500 from pot
*** SUMMARY ***
Total pot 21500 | Rake 0=20
Board [4c 3c 5c 9h Jc]
Seat 2: zootsuit101 folded before Flop (didn't bet)
Seat 3: mrbfmrbf showed [Th Js] and won (21500) with a pair of Jacks
Seat 4: AngeloP04 folded before Flop (didn't bet)
Seat 5: abidumar folded before Flop (didn't bet)
Seat 6: oceangurl2 (button) folded before Flop (didn't bet)
Seat 7: JJin91 (small blind) folded before Flop
Seat 9: IknowHow2pla (big blind) showed [Td 4d] and lost with a pair of=
 Fours


*********** # 203 **************
PokerStars Hand #170381715074: Tournament #1622573280, $9.10+$0.90 USD =
Hold'em No Limit - Level XXII (2000/4000) - 2017/05/25 22:05:44 ET
Table '1622573280 3' 9-max Seat #7 is the button
Seat 2: zootsuit101 (99332 in chips)=20
Seat 3: mrbfmrbf (117623 in chips)=20
Seat 4: AngeloP04 (111021 in chips)=20
Seat 5: abidumar (215820 in chips)=20
Seat 6: oceangurl2 (78908 in chips)=20
Seat 7: JJin91 (122199 in chips)=20
Seat 9: IknowHow2pla (75273 in chips)=20
zootsuit101: posts the ante 500
mrbfmrbf: posts the ante 500
AngeloP04: posts the ante 500
abidumar: posts the ante 500
oceangurl2: posts the ante 500
JJin91: posts the ante 500
IknowHow2pla: posts the ante 500
IknowHow2pla: posts small blind 2000
zootsuit101: posts big blind 4000
*** HOLE CARDS ***
Dealt to JJin91 [3d Qs]
mrbfmrbf: folds=20
AngeloP04: folds=20
abidumar: calls 4000
oceangurl2: folds=20
JJin91: folds=20
IknowHow2pla: folds=20
zootsuit101: checks=20
*** FLOP *** [3c 6c Jd]
zootsuit101: checks=20
abidumar: checks=20
*** TURN *** [3c 6c Jd] [7s]
zootsuit101: checks=20
abidumar: checks=20
*** RIVER *** [3c 6c Jd 7s] [6d]
zootsuit101: bets 6750
abidumar: raises 6750 to 13500
zootsuit101: calls 6750
*** SHOW DOWN ***
abidumar: shows [Td Ah] (a pair of Sixes)
zootsuit101: shows [Qc 6s] (three of a kind, Sixes)
zootsuit101 collected 40500 from pot
*** SUMMARY ***
Total pot 40500 | Rake 0=20
Board [3c 6c Jd 7s 6d]
Seat 2: zootsuit101 (big blind) showed [Qc 6s] and won (40500) with thr=
ee of a kind, Sixes
Seat 3: mrbfmrbf folded before Flop (didn't bet)
Seat 4: AngeloP04 folded before Flop (didn't bet)
Seat 5: abidumar showed [Td Ah] and lost with a pair of Sixes
Seat 6: oceangurl2 folded before Flop (didn't bet)
Seat 7: JJin91 (button) folded before Flop (didn't bet)
Seat 9: IknowHow2pla (small blind) folded before Flop


*********** # 204 **************
PokerStars Hand #170381715275: Tournament #1622573280, $9.10+$0.90 USD =
Hold'em No Limit - Level XXIII (2500/5000) - 2017/05/25 22:06:24 ET
Table '1622573280 3' 9-max Seat #9 is the button
Seat 2: zootsuit101 (121832 in chips)=20
Seat 3: mrbfmrbf (117123 in chips)=20
Seat 4: AngeloP04 (110521 in chips)=20
Seat 5: abidumar (197820 in chips)=20
Seat 6: oceangurl2 (78408 in chips)=20
Seat 7: JJin91 (121699 in chips)=20
Seat 9: IknowHow2pla (72773 in chips)=20
zootsuit101: posts the ante 625
mrbfmrbf: posts the ante 625
AngeloP04: posts the ante 625
abidumar: posts the ante 625
oceangurl2: posts the ante 625
JJin91: posts the ante 625
IknowHow2pla: posts the ante 625
zootsuit101: posts small blind 2500
mrbfmrbf: posts big blind 5000
*** HOLE CARDS ***
Dealt to JJin91 [6s 6d]
AngeloP04: folds=20
abidumar: calls 5000
oceangurl2: folds=20
JJin91: calls 5000
IknowHow2pla: calls 5000
zootsuit101: calls 2500
mrbfmrbf: checks=20
*** FLOP *** [Kh Js Ks]
zootsuit101: checks=20
mrbfmrbf: checks=20
abidumar: bets 5000
JJin91: calls 5000
IknowHow2pla: folds=20
zootsuit101: calls 5000
mrbfmrbf: folds=20
*** TURN *** [Kh Js Ks] [Td]
zootsuit101: checks=20
abidumar: bets 5000
JJin91: folds=20
zootsuit101: calls 5000
*** RIVER *** [Kh Js Ks Td] [Jh]
zootsuit101: checks=20
abidumar: checks=20
*** SHOW DOWN ***
zootsuit101: shows [Jd 9s] (a full house, Jacks full of Kings)
abidumar: mucks hand=20
zootsuit101 collected 54375 from pot
*** SUMMARY ***
Total pot 54375 | Rake 0=20
Board [Kh Js Ks Td Jh]
Seat 2: zootsuit101 (small blind) showed [Jd 9s] and won (54375) with a=
 full house, Jacks full of Kings
Seat 3: mrbfmrbf (big blind) folded on the Flop
Seat 4: AngeloP04 folded before Flop (didn't bet)
Seat 5: abidumar mucked [Qd Tc]
Seat 6: oceangurl2 folded before Flop (didn't bet)
Seat 7: JJin91 folded on the Turn
Seat 9: IknowHow2pla (button) folded on the Flop


*********** # 205 **************
PokerStars Hand #170381715684: Tournament #1622573280, $9.10+$0.90 USD =
Hold'em No Limit - Level XXIII (2500/5000) - 2017/05/25 22:07:42 ET
Table '1622573280 3' 9-max Seat #2 is the button
Seat 2: zootsuit101 (160582 in chips)=20
Seat 3: mrbfmrbf (111498 in chips)=20
Seat 4: AngeloP04 (109896 in chips)=20
Seat 5: abidumar (182195 in chips)=20
Seat 6: oceangurl2 (77783 in chips)=20
Seat 7: JJin91 (111074 in chips)=20
Seat 9: IknowHow2pla (67148 in chips)=20
zootsuit101: posts the ante 625
mrbfmrbf: posts the ante 625
AngeloP04: posts the ante 625
abidumar: posts the ante 625
oceangurl2: posts the ante 625
JJin91: posts the ante 625
IknowHow2pla: posts the ante 625
mrbfmrbf: posts small blind 2500
AngeloP04: posts big blind 5000
*** HOLE CARDS ***
Dealt to JJin91 [7d 2d]
abidumar: folds=20
oceangurl2: folds=20
JJin91: folds=20
IknowHow2pla: folds=20
zootsuit101: raises 7500 to 12500
mrbfmrbf: folds=20
AngeloP04: folds=20
Uncalled bet (7500) returned to zootsuit101
zootsuit101 collected 16875 from pot
zootsuit101: doesn't show hand=20
*** SUMMARY ***
Total pot 16875 | Rake 0=20
Seat 2: zootsuit101 (button) collected (16875)
Seat 3: mrbfmrbf (small blind) folded before Flop
Seat 4: AngeloP04 (big blind) folded before Flop
Seat 5: abidumar folded before Flop (didn't bet)
Seat 6: oceangurl2 folded before Flop (didn't bet)
Seat 7: JJin91 folded before Flop (didn't bet)
Seat 9: IknowHow2pla folded before Flop (didn't bet)


*********** # 206 **************
PokerStars Hand #170381715775: Tournament #1622573280, $9.10+$0.90 USD =
Hold'em No Limit - Level XXIII (2500/5000) - 2017/05/25 22:08:00 ET
Table '1622573280 3' 9-max Seat #3 is the button
Seat 2: zootsuit101 (171832 in chips)=20
Seat 3: mrbfmrbf (108373 in chips)=20
Seat 4: AngeloP04 (104271 in chips)=20
Seat 5: abidumar (181570 in chips)=20
Seat 6: oceangurl2 (77158 in chips)=20
Seat 7: JJin91 (110449 in chips)=20
Seat 9: IknowHow2pla (66523 in chips)=20
zootsuit101: posts the ante 625
mrbfmrbf: posts the ante 625
AngeloP04: posts the ante 625
abidumar: posts the ante 625
oceangurl2: posts the ante 625
JJin91: posts the ante 625
IknowHow2pla: posts the ante 625
AngeloP04: posts small blind 2500
abidumar: posts big blind 5000
*** HOLE CARDS ***
Dealt to JJin91 [8d 3s]
oceangurl2: folds=20
JJin91: folds=20
IknowHow2pla: folds=20
zootsuit101: raises 7500 to 12500
mrbfmrbf: calls 12500
AngeloP04: folds=20
abidumar: calls 7500
*** FLOP *** [9c 8h Kd]
abidumar: checks=20
zootsuit101: checks=20
mrbfmrbf: checks=20
*** TURN *** [9c 8h Kd] [5s]
abidumar: bets 5000
zootsuit101: calls 5000
mrbfmrbf: calls 5000
*** RIVER *** [9c 8h Kd 5s] [3d]
abidumar: bets 5000
zootsuit101: calls 5000
mrbfmrbf is disconnected=20
mrbfmrbf has timed out while disconnected
mrbfmrbf: folds=20
mrbfmrbf is sitting out
*** SHOW DOWN ***
abidumar: shows [Th Kc] (a pair of Kings)
zootsuit101: mucks hand=20
abidumar collected 69375 from pot
*** SUMMARY ***
Total pot 69375 | Rake 0=20
Board [9c 8h Kd 5s 3d]
Seat 2: zootsuit101 mucked [6d As]
Seat 3: mrbfmrbf (button) folded on the River
Seat 4: AngeloP04 (small blind) folded before Flop
Seat 5: abidumar (big blind) showed [Th Kc] and won (69375) with a pair=
 of Kings
Seat 6: oceangurl2 folded before Flop (didn't bet)
Seat 7: JJin91 folded before Flop (didn't bet)
Seat 9: IknowHow2pla folded before Flop (didn't bet)


*********** # 207 **************
PokerStars Hand #170381716216: Tournament #1622573280, $9.10+$0.90 USD =
Hold'em No Limit - Level XXIII (2500/5000) - 2017/05/25 22:09:26 ET
Table '1622573280 3' 9-max Seat #4 is the button
Seat 2: zootsuit101 (148707 in chips)=20
Seat 3: mrbfmrbf (90248 in chips) is sitting out
Seat 4: AngeloP04 (101146 in chips)=20
Seat 5: abidumar (227820 in chips)=20
Seat 6: oceangurl2 (76533 in chips)=20
Seat 7: JJin91 (109824 in chips)=20
Seat 9: IknowHow2pla (65898 in chips)=20
zootsuit101: posts the ante 625
mrbfmrbf: posts the ante 625
AngeloP04: posts the ante 625
abidumar: posts the ante 625
oceangurl2: posts the ante 625
JJin91: posts the ante 625
IknowHow2pla: posts the ante 625
abidumar: posts small blind 2500
oceangurl2: posts big blind 5000
*** HOLE CARDS ***
Dealt to JJin91 [8h Ts]
mrbfmrbf has returned
JJin91: folds=20
IknowHow2pla: folds=20
zootsuit101: folds=20
mrbfmrbf: folds=20
AngeloP04: raises 10000 to 15000
abidumar: calls 12500
oceangurl2: folds=20
*** FLOP *** [Qc 4d 2s]
abidumar: checks=20
AngeloP04: bets 19688
abidumar: folds=20
Uncalled bet (19688) returned to AngeloP04
AngeloP04 collected 39375 from pot
AngeloP04: doesn't show hand=20
*** SUMMARY ***
Total pot 39375 | Rake 0=20
Board [Qc 4d 2s]
Seat 2: zootsuit101 folded before Flop (didn't bet)
Seat 3: mrbfmrbf folded before Flop (didn't bet)
Seat 4: AngeloP04 (button) collected (39375)
Seat 5: abidumar (small blind) folded on the Flop
Seat 6: oceangurl2 (big blind) folded before Flop
Seat 7: JJin91 folded before Flop (didn't bet)
Seat 9: IknowHow2pla folded before Flop (didn't bet)


*********** # 208 **************
PokerStars Hand #170381716429: Tournament #1622573280, $9.10+$0.90 USD =
Hold'em No Limit - Level XXIII (2500/5000) - 2017/05/25 22:10:09 ET
Table '1622573280 3' 9-max Seat #5 is the button
Seat 2: zootsuit101 (148082 in chips)=20
Seat 3: mrbfmrbf (89623 in chips)=20
Seat 4: AngeloP04 (124896 in chips)=20
Seat 5: abidumar (212195 in chips)=20
Seat 6: oceangurl2 (70908 in chips)=20
Seat 7: JJin91 (109199 in chips)=20
Seat 9: IknowHow2pla (65273 in chips)=20
zootsuit101: posts the ante 625
mrbfmrbf: posts the ante 625
AngeloP04: posts the ante 625
abidumar: posts the ante 625
oceangurl2: posts the ante 625
JJin91: posts the ante 625
IknowHow2pla: posts the ante 625
oceangurl2: posts small blind 2500
JJin91: posts big blind 5000
*** HOLE CARDS ***
Dealt to JJin91 [Jc 5h]
IknowHow2pla: folds=20
zootsuit101: raises 7500 to 12500
mrbfmrbf: folds=20
AngeloP04: folds=20
abidumar: calls 12500
oceangurl2: folds=20
JJin91: calls 7500
*** FLOP *** [2h Kd 3h]
JJin91: checks=20
zootsuit101: checks=20
abidumar: checks=20
*** TURN *** [2h Kd 3h] [3d]
JJin91: checks=20
zootsuit101: bets 22188
abidumar: calls 22188
JJin91: folds=20
*** RIVER *** [2h Kd 3h 3d] [8s]
zootsuit101: bets 30000
abidumar: calls 30000
*** SHOW DOWN ***
zootsuit101: shows [Jd Ad] (a pair of Threes)
abidumar: shows [9h 8h] (two pair, Eights and Threes)
abidumar collected 148751 from pot
*** SUMMARY ***
Total pot 148751 | Rake 0=20
Board [2h Kd 3h 3d 8s]
Seat 2: zootsuit101 showed [Jd Ad] and lost with a pair of Threes
Seat 3: mrbfmrbf folded before Flop (didn't bet)
Seat 4: AngeloP04 folded before Flop (didn't bet)
Seat 5: abidumar (button) showed [9h 8h] and won (148751) with two pair=
, Eights and Threes
Seat 6: oceangurl2 (small blind) folded before Flop
Seat 7: JJin91 (big blind) folded on the Turn
Seat 9: IknowHow2pla folded before Flop (didn't bet)


*********** # 209 **************
PokerStars Hand #170381716713: Tournament #1622573280, $9.10+$0.90 USD =
Hold'em No Limit - Level XXIII (2500/5000) - 2017/05/25 22:11:11 ET
Table '1622573280 3' 9-max Seat #6 is the button
Seat 2: zootsuit101 (82769 in chips)=20
Seat 3: mrbfmrbf (88998 in chips)=20
Seat 4: AngeloP04 (124271 in chips)=20
Seat 5: abidumar (295633 in chips)=20
Seat 6: oceangurl2 (67783 in chips)=20
Seat 7: JJin91 (96074 in chips)=20
Seat 9: IknowHow2pla (64648 in chips)=20
zootsuit101: posts the ante 625
mrbfmrbf: posts the ante 625
AngeloP04: posts the ante 625
abidumar: posts the ante 625
oceangurl2: posts the ante 625
JJin91: posts the ante 625
IknowHow2pla: posts the ante 625
JJin91: posts small blind 2500
IknowHow2pla: posts big blind 5000
*** HOLE CARDS ***
Dealt to JJin91 [3d 6d]
zootsuit101: folds=20
mrbfmrbf: folds=20
AngeloP04: folds=20
abidumar: calls 5000
oceangurl2: folds=20
JJin91: folds=20
IknowHow2pla: checks=20
*** FLOP *** [Kc 2h 3c]
IknowHow2pla: checks=20
abidumar: checks=20
*** TURN *** [Kc 2h 3c] [Kd]
IknowHow2pla: checks=20
abidumar: checks=20
*** RIVER *** [Kc 2h 3c Kd] [Ks]
IknowHow2pla: checks=20
abidumar: bets 5000
IknowHow2pla: calls 5000
*** SHOW DOWN ***
abidumar: shows [6h 5h] (three of a kind, Kings)
IknowHow2pla: shows [Qh 9s] (three of a kind, Kings - Queen kicker)
IknowHow2pla collected 26875 from pot
*** SUMMARY ***
Total pot 26875 | Rake 0=20
Board [Kc 2h 3c Kd Ks]
Seat 2: zootsuit101 folded before Flop (didn't bet)
Seat 3: mrbfmrbf folded before Flop (didn't bet)
Seat 4: AngeloP04 folded before Flop (didn't bet)
Seat 5: abidumar showed [6h 5h] and lost with three of a kind, Kings
Seat 6: oceangurl2 (button) folded before Flop (didn't bet)
Seat 7: JJin91 (small blind) folded before Flop
Seat 9: IknowHow2pla (big blind) showed [Qh 9s] and won (26875) with th=
ree of a kind, Kings


*********** # 210 **************
PokerStars Hand #170381716966: Tournament #1622573280, $9.10+$0.90 USD =
Hold'em No Limit - Level XXIII (2500/5000) - 2017/05/25 22:11:59 ET
Table '1622573280 3' 9-max Seat #7 is the button
Seat 2: zootsuit101 (82144 in chips)=20
Seat 3: mrbfmrbf (88373 in chips)=20
Seat 4: AngeloP04 (123646 in chips)=20
Seat 5: abidumar (285008 in chips)=20
Seat 6: oceangurl2 (67158 in chips)=20
Seat 7: JJin91 (92949 in chips)=20
Seat 9: IknowHow2pla (80898 in chips)=20
zootsuit101: posts the ante 625
mrbfmrbf: posts the ante 625
AngeloP04: posts the ante 625
abidumar: posts the ante 625
oceangurl2: posts the ante 625
JJin91: posts the ante 625
IknowHow2pla: posts the ante 625
IknowHow2pla: posts small blind 2500
zootsuit101: posts big blind 5000
*** HOLE CARDS ***
Dealt to JJin91 [5h 3d]
mrbfmrbf: folds=20
AngeloP04: folds=20
abidumar: folds=20
oceangurl2: raises 61533 to 66533 and is all-in
JJin91: folds=20
IknowHow2pla: folds=20
zootsuit101: folds=20
Uncalled bet (61533) returned to oceangurl2
oceangurl2 collected 16875 from pot
oceangurl2: doesn't show hand=20
*** SUMMARY ***
Total pot 16875 | Rake 0=20
Seat 2: zootsuit101 (big blind) folded before Flop
Seat 3: mrbfmrbf folded before Flop (didn't bet)
Seat 4: AngeloP04 folded before Flop (didn't bet)
Seat 5: abidumar folded before Flop (didn't bet)
Seat 6: oceangurl2 collected (16875)
Seat 7: JJin91 (button) folded before Flop (didn't bet)
Seat 9: IknowHow2pla (small blind) folded before Flop


*********** # 211 **************
PokerStars Hand #170381717035: Tournament #1622573280, $9.10+$0.90 USD =
Hold'em No Limit - Level XXIII (2500/5000) - 2017/05/25 22:12:16 ET
Table '1622573280 3' 9-max Seat #9 is the button
Seat 2: zootsuit101 (76519 in chips)=20
Seat 3: mrbfmrbf (87748 in chips)=20
Seat 4: AngeloP04 (123021 in chips)=20
Seat 5: abidumar (284383 in chips)=20
Seat 6: oceangurl2 (78408 in chips)=20
Seat 7: JJin91 (92324 in chips)=20
Seat 9: IknowHow2pla (77773 in chips)=20
zootsuit101: posts the ante 625
mrbfmrbf: posts the ante 625
AngeloP04: posts the ante 625
abidumar: posts the ante 625
oceangurl2: posts the ante 625
JJin91: posts the ante 625
IknowHow2pla: posts the ante 625
zootsuit101: posts small blind 2500
mrbfmrbf: posts big blind 5000
*** HOLE CARDS ***
Dealt to JJin91 [2s Qc]
AngeloP04: folds=20
abidumar: folds=20
oceangurl2: folds=20
JJin91: folds=20
IknowHow2pla: raises 5000 to 10000
zootsuit101: folds=20
mrbfmrbf: folds=20
Uncalled bet (5000) returned to IknowHow2pla
IknowHow2pla collected 16875 from pot
IknowHow2pla: doesn't show hand=20
*** SUMMARY ***
Total pot 16875 | Rake 0=20
Seat 2: zootsuit101 (small blind) folded before Flop
Seat 3: mrbfmrbf (big blind) folded before Flop
Seat 4: AngeloP04 folded before Flop (didn't bet)
Seat 5: abidumar folded before Flop (didn't bet)
Seat 6: oceangurl2 folded before Flop (didn't bet)
Seat 7: JJin91 folded before Flop (didn't bet)
Seat 9: IknowHow2pla (button) collected (16875)


*********** # 212 **************
PokerStars Hand #170381717138: Tournament #1622573280, $9.10+$0.90 USD =
Hold'em No Limit - Level XXIII (2500/5000) - 2017/05/25 22:12:37 ET
Table '1622573280 3' 9-max Seat #2 is the button
Seat 2: zootsuit101 (73394 in chips)=20
Seat 3: mrbfmrbf (82123 in chips)=20
Seat 4: AngeloP04 (122396 in chips)=20
Seat 5: abidumar (283758 in chips)=20
Seat 6: oceangurl2 (77783 in chips)=20
Seat 7: JJin91 (91699 in chips)=20
Seat 9: IknowHow2pla (89023 in chips)=20
zootsuit101: posts the ante 625
mrbfmrbf: posts the ante 625
AngeloP04: posts the ante 625
abidumar: posts the ante 625
oceangurl2: posts the ante 625
JJin91: posts the ante 625
IknowHow2pla: posts the ante 625
mrbfmrbf: posts small blind 2500
AngeloP04: posts big blind 5000
*** HOLE CARDS ***
Dealt to JJin91 [Ad 4d]
abidumar: calls 5000
oceangurl2: folds=20
JJin91: raises 19156 to 24156
IknowHow2pla: folds=20
zootsuit101: folds=20
mrbfmrbf: folds=20
AngeloP04: folds=20
abidumar: calls 19156
*** FLOP *** [Jh Qh Qs]
abidumar: checks=20
JJin91: checks=20
*** TURN *** [Jh Qh Qs] [Qc]
abidumar: checks=20
JJin91: checks=20
*** RIVER *** [Jh Qh Qs Qc] [9h]
abidumar: checks=20
JJin91: checks=20
*** SHOW DOWN ***
abidumar: shows [7s Js] (a full house, Queens full of Jacks)
JJin91: mucks hand=20
abidumar collected 60187 from pot
*** SUMMARY ***
Total pot 60187 | Rake 0=20
Board [Jh Qh Qs Qc 9h]
Seat 2: zootsuit101 (button) folded before Flop (didn't bet)
Seat 3: mrbfmrbf (small blind) folded before Flop
Seat 4: AngeloP04 (big blind) folded before Flop
Seat 5: abidumar showed [7s Js] and won (60187) with a full house, Quee=
ns full of Jacks
Seat 6: oceangurl2 folded before Flop (didn't bet)
Seat 7: JJin91 mucked [Ad 4d]
Seat 9: IknowHow2pla folded before Flop (didn't bet)


*********** # 213 **************
PokerStars Hand #170381717444: Tournament #1622573280, $9.10+$0.90 USD =
Hold'em No Limit - Level XXIII (2500/5000) - 2017/05/25 22:13:40 ET
Table '1622573280 3' 9-max Seat #3 is the button
Seat 2: zootsuit101 (72769 in chips)=20
Seat 3: mrbfmrbf (78998 in chips)=20
Seat 4: AngeloP04 (116771 in chips)=20
Seat 5: abidumar (319164 in chips)=20
Seat 6: oceangurl2 (77158 in chips)=20
Seat 7: JJin91 (66918 in chips)=20
Seat 9: IknowHow2pla (88398 in chips)=20
zootsuit101: posts the ante 625
mrbfmrbf: posts the ante 625
AngeloP04: posts the ante 625
abidumar: posts the ante 625
oceangurl2: posts the ante 625
JJin91: posts the ante 625
IknowHow2pla: posts the ante 625
AngeloP04: posts small blind 2500
abidumar: posts big blind 5000
*** HOLE CARDS ***
Dealt to JJin91 [Jc 8h]
oceangurl2: folds=20
JJin91: folds=20
IknowHow2pla: raises 5000 to 10000
zootsuit101: folds=20
mrbfmrbf: folds=20
AngeloP04: folds=20
abidumar: calls 5000
*** FLOP *** [4d 7d 9d]
abidumar: checks=20
IknowHow2pla: checks=20
*** TURN *** [4d 7d 9d] [Ts]
abidumar: checks=20
IknowHow2pla: checks=20
*** RIVER *** [4d 7d 9d Ts] [5d]
abidumar: bets 5000
IknowHow2pla: folds=20
Uncalled bet (5000) returned to abidumar
abidumar collected 26875 from pot
*** SUMMARY ***
Total pot 26875 | Rake 0=20
Board [4d 7d 9d Ts 5d]
Seat 2: zootsuit101 folded before Flop (didn't bet)
Seat 3: mrbfmrbf (button) folded before Flop (didn't bet)
Seat 4: AngeloP04 (small blind) folded before Flop
Seat 5: abidumar (big blind) collected (26875)
Seat 6: oceangurl2 folded before Flop (didn't bet)
Seat 7: JJin91 folded before Flop (didn't bet)
Seat 9: IknowHow2pla folded on the River


*********** # 214 **************
PokerStars Hand #170381717665: Tournament #1622573280, $9.10+$0.90 USD =
Hold'em No Limit - Level XXIII (2500/5000) - 2017/05/25 22:14:21 ET
Table '1622573280 3' 9-max Seat #4 is the button
Seat 2: zootsuit101 (72144 in chips)=20
Seat 3: mrbfmrbf (78373 in chips)=20
Seat 4: AngeloP04 (113646 in chips)=20
Seat 5: abidumar (335414 in chips)=20
Seat 6: oceangurl2 (76533 in chips)=20
Seat 7: JJin91 (66293 in chips)=20
Seat 9: IknowHow2pla (77773 in chips)=20
zootsuit101: posts the ante 625
mrbfmrbf: posts the ante 625
AngeloP04: posts the ante 625
abidumar: posts the ante 625
oceangurl2: posts the ante 625
JJin91: posts the ante 625
IknowHow2pla: posts the ante 625
abidumar: posts small blind 2500
oceangurl2: posts big blind 5000
*** HOLE CARDS ***
Dealt to JJin91 [4c Kc]
JJin91: folds=20
IknowHow2pla: folds=20
zootsuit101: folds=20
mrbfmrbf: raises 5000 to 10000
AngeloP04: raises 15000 to 25000
abidumar: folds=20
oceangurl2: folds=20
mrbfmrbf: folds=20
Uncalled bet (15000) returned to AngeloP04
AngeloP04 collected 31875 from pot
AngeloP04: doesn't show hand=20
*** SUMMARY ***
Total pot 31875 | Rake 0=20
Seat 2: zootsuit101 folded before Flop (didn't bet)
Seat 3: mrbfmrbf folded before Flop
Seat 4: AngeloP04 (button) collected (31875)
Seat 5: abidumar (small blind) folded before Flop
Seat 6: oceangurl2 (big blind) folded before Flop
Seat 7: JJin91 folded before Flop (didn't bet)
Seat 9: IknowHow2pla folded before Flop (didn't bet)


*********** # 215 **************
PokerStars Hand #170381717829: Tournament #1622573280, $9.10+$0.90 USD =
Hold'em No Limit - Level XXIII (2500/5000) - 2017/05/25 22:14:52 ET
Table '1622573280 3' 9-max Seat #5 is the button
Seat 2: zootsuit101 (71519 in chips)=20
Seat 3: mrbfmrbf (67748 in chips)=20
Seat 4: AngeloP04 (134896 in chips)=20
Seat 5: abidumar (332289 in chips)=20
Seat 6: oceangurl2 (70908 in chips)=20
Seat 7: JJin91 (65668 in chips)=20
Seat 9: IknowHow2pla (77148 in chips)=20
zootsuit101: posts the ante 625
mrbfmrbf: posts the ante 625
AngeloP04: posts the ante 625
abidumar: posts the ante 625
oceangurl2: posts the ante 625
JJin91: posts the ante 625
IknowHow2pla: posts the ante 625
oceangurl2: posts small blind 2500
JJin91: posts big blind 5000
*** HOLE CARDS ***
Dealt to JJin91 [2d 4d]
IknowHow2pla: folds=20
zootsuit101: folds=20
mrbfmrbf: raises 10000 to 15000
AngeloP04: folds=20
abidumar: folds=20
oceangurl2: folds=20
JJin91: folds=20
Uncalled bet (10000) returned to mrbfmrbf
mrbfmrbf collected 16875 from pot
mrbfmrbf: doesn't show hand=20
*** SUMMARY ***
Total pot 16875 | Rake 0=20
Seat 2: zootsuit101 folded before Flop (didn't bet)
Seat 3: mrbfmrbf collected (16875)
Seat 4: AngeloP04 folded before Flop (didn't bet)
Seat 5: abidumar (button) folded before Flop (didn't bet)
Seat 6: oceangurl2 (small blind) folded before Flop
Seat 7: JJin91 (big blind) folded before Flop
Seat 9: IknowHow2pla folded before Flop (didn't bet)


*********** # 216 **************
PokerStars Hand #170381717906: Tournament #1622573280, $9.10+$0.90 USD =
Hold'em No Limit - Level XXIII (2500/5000) - 2017/05/25 22:15:08 ET
Table '1622573280 3' 9-max Seat #6 is the button
Seat 2: zootsuit101 (70894 in chips)=20
Seat 3: mrbfmrbf (78998 in chips)=20
Seat 4: AngeloP04 (134271 in chips)=20
Seat 5: abidumar (331664 in chips)=20
Seat 6: oceangurl2 (67783 in chips)=20
Seat 7: JJin91 (60043 in chips)=20
Seat 9: IknowHow2pla (76523 in chips)=20
zootsuit101: posts the ante 625
mrbfmrbf: posts the ante 625
AngeloP04: posts the ante 625
abidumar: posts the ante 625
oceangurl2: posts the ante 625
JJin91: posts the ante 625
IknowHow2pla: posts the ante 625
JJin91: posts small blind 2500
IknowHow2pla: posts big blind 5000
*** HOLE CARDS ***
Dealt to JJin91 [Jd As]
zootsuit101: raises 7500 to 12500
mrbfmrbf: folds=20
AngeloP04: folds=20
abidumar: folds=20
oceangurl2: folds=20
JJin91: raises 46918 to 59418 and is all-in
IknowHow2pla: folds=20
zootsuit101: calls 46918
*** FLOP *** [5d 3d 3h]
*** TURN *** [5d 3d 3h] [Qc]
*** RIVER *** [5d 3d 3h Qc] [2h]
*** SHOW DOWN ***
JJin91: shows [Jd As] (a pair of Threes)
zootsuit101: shows [Ts Td] (two pair, Tens and Threes)
zootsuit101 collected 128211 from pot
JJin91 finished the tournament in 13th place and received $22.93.
*** SUMMARY ***
Total pot 128211 | Rake 0=20
Board [5d 3d 3h Qc 2h]
Seat 2: zootsuit101 showed [Ts Td] and won (128211) with two pair, Tens=
 and Threes
Seat 3: mrbfmrbf folded before Flop (didn't bet)
Seat 4: AngeloP04 folded before Flop (didn't bet)
Seat 5: abidumar folded before Flop (didn't bet)
Seat 6: oceangurl2 (button) folded before Flop (didn't bet)
Seat 7: JJin91 (small blind) showed [Jd As] and lost with a pair of Thr=
ees
Seat 9: IknowHow2pla (big blind) folded before Flop



If you have any questions, please contact us at "PokerStars Support" <s=
upport@pokerstarsnj.com>


