Transcript for tournament #1648990476 requested by JJin91 (jamiejin91@g=
mail.com)

*********** # 1 **************
PokerStars Hand #172136508290: Tournament #1648990476, $18.20+$1.80 USD=
 Hold'em No Limit - Level II (30/60) - 2017/07/06 19:16:43 ET
Table '1648990476 2' 9-max Seat #4 is the button
Seat 3: JJ2MG72 (22822 in chips)=20
Seat 4: miketherake (7329 in chips)=20
Seat 5: lrb1024 (12523 in chips)=20
Seat 6: alcode422 (14300 in chips)=20
Seat 7: JJin91 (10000 in chips)=20
Seat 8: CrittyJJones (6354 in chips)=20
Seat 9: senor stinks (11140 in chips)=20
lrb1024: posts small blind 30
alcode422: posts big blind 60
*** HOLE CARDS ***
Dealt to JJin91 [5d Kd]
JJin91: folds=20
CrittyJJones: folds=20
senor stinks: folds=20
JJ2MG72: folds=20
miketherake: folds=20
lrb1024: raises 60 to 120
alcode422: folds=20
Uncalled bet (60) returned to lrb1024
lrb1024 collected 120 from pot
lrb1024: doesn't show hand=20
*** SUMMARY ***
Total pot 120 | Rake 0=20
Seat 3: JJ2MG72 folded before Flop (didn't bet)
Seat 4: miketherake (button) folded before Flop (didn't bet)
Seat 5: lrb1024 (small blind) collected (120)
Seat 6: alcode422 (big blind) folded before Flop
Seat 7: JJin91 folded before Flop (didn't bet)
Seat 8: CrittyJJones folded before Flop (didn't bet)
Seat 9: senor stinks folded before Flop (didn't bet)


*********** # 2 **************
PokerStars Hand #172136508350: Tournament #1648990476, $18.20+$1.80 USD=
 Hold'em No Limit - Level II (30/60) - 2017/07/06 19:17:02 ET
Table '1648990476 2' 9-max Seat #5 is the button
Seat 3: JJ2MG72 (22822 in chips)=20
Seat 4: miketherake (7329 in chips)=20
Seat 5: lrb1024 (12583 in chips)=20
Seat 6: alcode422 (14240 in chips)=20
Seat 7: JJin91 (10000 in chips)=20
Seat 8: CrittyJJones (6354 in chips)=20
Seat 9: senor stinks (11140 in chips)=20
alcode422: posts small blind 30
JJin91: posts big blind 60
*** HOLE CARDS ***
Dealt to JJin91 [7d 2h]
CrittyJJones: folds=20
senor stinks: folds=20
JJ2MG72: folds=20
miketherake: folds=20
lrb1024: calls 60
alcode422: folds=20
JJin91: checks=20
*** FLOP *** [Kc 5s Kh]
JJin91: checks=20
lrb1024: checks=20
*** TURN *** [Kc 5s Kh] [8h]
JJin91: checks=20
lrb1024: checks=20
*** RIVER *** [Kc 5s Kh 8h] [8s]
JJin91: checks=20
lrb1024: checks=20
*** SHOW DOWN ***
JJin91: shows [7d 2h] (two pair, Kings and Eights)
lrb1024: shows [Ac 7s] (two pair, Kings and Eights - Ace kicker)
lrb1024 collected 150 from pot
*** SUMMARY ***
Total pot 150 | Rake 0=20
Board [Kc 5s Kh 8h 8s]
Seat 3: JJ2MG72 folded before Flop (didn't bet)
Seat 4: miketherake folded before Flop (didn't bet)
Seat 5: lrb1024 (button) showed [Ac 7s] and won (150) with two pair, Ki=
ngs and Eights
Seat 6: alcode422 (small blind) folded before Flop
Seat 7: JJin91 (big blind) showed [7d 2h] and lost with two pair, Kings=
 and Eights
Seat 8: CrittyJJones folded before Flop (didn't bet)
Seat 9: senor stinks folded before Flop (didn't bet)


*********** # 3 **************
PokerStars Hand #172136508510: Tournament #1648990476, $18.20+$1.80 USD=
 Hold'em No Limit - Level II (30/60) - 2017/07/06 19:17:53 ET
Table '1648990476 2' 9-max Seat #6 is the button
Seat 3: JJ2MG72 (22822 in chips)=20
Seat 4: miketherake (7329 in chips)=20
Seat 5: lrb1024 (12673 in chips)=20
Seat 6: alcode422 (14210 in chips)=20
Seat 7: JJin91 (9940 in chips)=20
Seat 8: CrittyJJones (6354 in chips)=20
Seat 9: senor stinks (11140 in chips)=20
JJin91: posts small blind 30
CrittyJJones: posts big blind 60
*** HOLE CARDS ***
Dealt to JJin91 [Qc Jd]
senor stinks: folds=20
JJ2MG72: folds=20
miketherake: raises 120 to 180
lrb1024: folds=20
alcode422: folds=20
JJin91: folds=20
CrittyJJones: calls 120
*** FLOP *** [3h 7s 2d]
CrittyJJones: checks=20
miketherake: bets 390
CrittyJJones: calls 390
*** TURN *** [3h 7s 2d] [Ks]
CrittyJJones: checks=20
miketherake: bets 1170
CrittyJJones: calls 1170
*** RIVER *** [3h 7s 2d Ks] [8s]
CrittyJJones: checks=20
miketherake: checks=20
*** SHOW DOWN ***
CrittyJJones: shows [7c Ah] (a pair of Sevens)
miketherake: shows [Kc 3c] (two pair, Kings and Threes)
miketherake collected 3510 from pot
*** SUMMARY ***
Total pot 3510 | Rake 0=20
Board [3h 7s 2d Ks 8s]
Seat 3: JJ2MG72 folded before Flop (didn't bet)
Seat 4: miketherake showed [Kc 3c] and won (3510) with two pair, Kings =
and Threes
Seat 5: lrb1024 folded before Flop (didn't bet)
Seat 6: alcode422 (button) folded before Flop (didn't bet)
Seat 7: JJin91 (small blind) folded before Flop
Seat 8: CrittyJJones (big blind) showed [7c Ah] and lost with a pair of=
 Sevens
Seat 9: senor stinks folded before Flop (didn't bet)


*********** # 4 **************
PokerStars Hand #172136508637: Tournament #1648990476, $18.20+$1.80 USD=
 Hold'em No Limit - Level II (30/60) - 2017/07/06 19:18:38 ET
Table '1648990476 2' 9-max Seat #7 is the button
Seat 1: Scooby-D0O (10000 in chips)=20
Seat 3: JJ2MG72 (22822 in chips)=20
Seat 4: miketherake (9099 in chips)=20
Seat 5: lrb1024 (12673 in chips)=20
Seat 6: alcode422 (14210 in chips)=20
Seat 7: JJin91 (9910 in chips)=20
Seat 8: CrittyJJones (4614 in chips)=20
Seat 9: senor stinks (11140 in chips)=20
CrittyJJones: posts small blind 30
senor stinks: posts big blind 60
*** HOLE CARDS ***
Dealt to JJin91 [5c 5s]
Scooby-D0O: folds=20
JJ2MG72: folds=20
miketherake: folds=20
lrb1024: calls 60
alcode422: folds=20
JJin91: raises 136 to 196
CrittyJJones: calls 166
senor stinks: folds=20
lrb1024: calls 136
*** FLOP *** [As Ts Qd]
CrittyJJones: checks=20
lrb1024: bets 60
JJin91: raises 607 to 667
CrittyJJones: folds=20
lrb1024: calls 607
*** TURN *** [As Ts Qd] [6s]
lrb1024: checks=20
JJin91: bets 1256
lrb1024: calls 1256
*** RIVER *** [As Ts Qd 6s] [4d]
lrb1024: checks=20
JJin91: bets 1352
lrb1024: folds=20
Uncalled bet (1352) returned to JJin91
JJin91 collected 4494 from pot
JJin91: doesn't show hand=20
*** SUMMARY ***
Total pot 4494 | Rake 0=20
Board [As Ts Qd 6s 4d]
Seat 1: Scooby-D0O folded before Flop (didn't bet)
Seat 3: JJ2MG72 folded before Flop (didn't bet)
Seat 4: miketherake folded before Flop (didn't bet)
Seat 5: lrb1024 folded on the River
Seat 6: alcode422 folded before Flop (didn't bet)
Seat 7: JJin91 (button) collected (4494)
Seat 8: CrittyJJones (small blind) folded on the Flop
Seat 9: senor stinks (big blind) folded before Flop


*********** # 5 **************
PokerStars Hand #172136508954: Tournament #1648990476, $18.20+$1.80 USD=
 Hold'em No Limit - Level III (40/80) - 2017/07/06 19:20:33 ET
Table '1648990476 2' 9-max Seat #8 is the button
Seat 1: Scooby-D0O (10000 in chips)=20
Seat 3: JJ2MG72 (22822 in chips)=20
Seat 4: miketherake (9099 in chips)=20
Seat 5: lrb1024 (10554 in chips)=20
Seat 6: alcode422 (14210 in chips)=20
Seat 7: JJin91 (12285 in chips)=20
Seat 8: CrittyJJones (4418 in chips)=20
Seat 9: senor stinks (11080 in chips)=20
senor stinks: posts small blind 40
Scooby-D0O: posts big blind 80
*** HOLE CARDS ***
Dealt to JJin91 [Kh 6h]
JJ2MG72: calls 80
miketherake: folds=20
lrb1024: folds=20
alcode422: calls 80
JJin91: folds=20
CrittyJJones: folds=20
senor stinks: calls 40
Scooby-D0O: checks=20
*** FLOP *** [4c 3c 9s]
senor stinks: checks=20
Scooby-D0O: bets 240
JJ2MG72: folds=20
alcode422: calls 240
senor stinks: folds=20
*** TURN *** [4c 3c 9s] [Ts]
Scooby-D0O: bets 600
alcode422: calls 600
*** RIVER *** [4c 3c 9s Ts] [7d]
Scooby-D0O: bets 1500
alcode422: calls 1500
*** SHOW DOWN ***
Scooby-D0O: shows [5s 2c] (high card Ten)
alcode422: shows [4s 7s] (two pair, Sevens and Fours)
alcode422 collected 5000 from pot
*** SUMMARY ***
Total pot 5000 | Rake 0=20
Board [4c 3c 9s Ts 7d]
Seat 1: Scooby-D0O (big blind) showed [5s 2c] and lost with high card T=
en
Seat 3: JJ2MG72 folded on the Flop
Seat 4: miketherake folded before Flop (didn't bet)
Seat 5: lrb1024 folded before Flop (didn't bet)
Seat 6: alcode422 showed [4s 7s] and won (5000) with two pair, Sevens a=
nd Fours
Seat 7: JJin91 folded before Flop (didn't bet)
Seat 8: CrittyJJones (button) folded before Flop (didn't bet)
Seat 9: senor stinks (small blind) folded on the Flop


*********** # 6 **************
PokerStars Hand #172136509222: Tournament #1648990476, $18.20+$1.80 USD=
 Hold'em No Limit - Level III (40/80) - 2017/07/06 19:21:59 ET
Table '1648990476 2' 9-max Seat #9 is the button
Seat 1: Scooby-D0O (7580 in chips)=20
Seat 3: JJ2MG72 (22742 in chips)=20
Seat 4: miketherake (9099 in chips)=20
Seat 5: lrb1024 (10554 in chips)=20
Seat 6: alcode422 (16790 in chips)=20
Seat 7: JJin91 (12285 in chips)=20
Seat 8: CrittyJJones (4418 in chips)=20
Seat 9: senor stinks (11000 in chips)=20
Scooby-D0O: posts small blind 40
JJ2MG72: posts big blind 80
*** HOLE CARDS ***
Dealt to JJin91 [2h 9h]
miketherake: folds=20
lrb1024: calls 80
alcode422: folds=20
JJin91: folds=20
CrittyJJones: folds=20
senor stinks: folds=20
Scooby-D0O: calls 40
JJ2MG72: checks=20
*** FLOP *** [9d Ah 5h]
Scooby-D0O: bets 180
JJ2MG72: raises 220 to 400
lrb1024: folds=20
Scooby-D0O: calls 220
*** TURN *** [9d Ah 5h] [2c]
Scooby-D0O: checks=20
JJ2MG72: bets 520
Scooby-D0O: calls 520
*** RIVER *** [9d Ah 5h 2c] [Td]
Scooby-D0O: checks=20
JJ2MG72: bets 2080
Scooby-D0O: calls 2080
*** SHOW DOWN ***
JJ2MG72: shows [4h 8h] (high card Ace)
Scooby-D0O: shows [Ac 3h] (a pair of Aces)
Scooby-D0O collected 6240 from pot
*** SUMMARY ***
Total pot 6240 | Rake 0=20
Board [9d Ah 5h 2c Td]
Seat 1: Scooby-D0O (small blind) showed [Ac 3h] and won (6240) with a p=
air of Aces
Seat 3: JJ2MG72 (big blind) showed [4h 8h] and lost with high card Ace
Seat 4: miketherake folded before Flop (didn't bet)
Seat 5: lrb1024 folded on the Flop
Seat 6: alcode422 folded before Flop (didn't bet)
Seat 7: JJin91 folded before Flop (didn't bet)
Seat 8: CrittyJJones folded before Flop (didn't bet)
Seat 9: senor stinks (button) folded before Flop (didn't bet)


*********** # 7 **************
PokerStars Hand #172136509417: Tournament #1648990476, $18.20+$1.80 USD=
 Hold'em No Limit - Level III (40/80) - 2017/07/06 19:23:06 ET
Table '1648990476 2' 9-max Seat #1 is the button
Seat 1: Scooby-D0O (10740 in chips)=20
Seat 3: JJ2MG72 (19662 in chips)=20
Seat 5: lrb1024 (10474 in chips)=20
Seat 6: alcode422 (16790 in chips)=20
Seat 7: JJin91 (12285 in chips)=20
Seat 8: CrittyJJones (4418 in chips)=20
Seat 9: senor stinks (11000 in chips)=20
JJ2MG72: posts small blind 40
lrb1024: posts big blind 80
*** HOLE CARDS ***
Dealt to JJin91 [5s 3h]
alcode422: folds=20
JJin91: folds=20
CrittyJJones: folds=20
senor stinks: folds=20
Scooby-D0O: raises 120 to 200
JJ2MG72: folds=20
lrb1024: calls 120
*** FLOP *** [8h 4c 8c]
lrb1024: checks=20
Scooby-D0O: bets 194
lrb1024: calls 194
*** TURN *** [8h 4c 8c] [Ks]
lrb1024: checks=20
Scooby-D0O: bets 364
lrb1024: calls 364
*** RIVER *** [8h 4c 8c Ks] [Qd]
lrb1024: checks=20
Scooby-D0O: bets 1360
lrb1024: folds=20
Uncalled bet (1360) returned to Scooby-D0O
Scooby-D0O collected 1556 from pot
*** SUMMARY ***
Total pot 1556 | Rake 0=20
Board [8h 4c 8c Ks Qd]
Seat 1: Scooby-D0O (button) collected (1556)
Seat 3: JJ2MG72 (small blind) folded before Flop
Seat 5: lrb1024 (big blind) folded on the River
Seat 6: alcode422 folded before Flop (didn't bet)
Seat 7: JJin91 folded before Flop (didn't bet)
Seat 8: CrittyJJones folded before Flop (didn't bet)
Seat 9: senor stinks folded before Flop (didn't bet)


*********** # 8 **************
PokerStars Hand #172136509575: Tournament #1648990476, $18.20+$1.80 USD=
 Hold'em No Limit - Level III (40/80) - 2017/07/06 19:23:55 ET
Table '1648990476 2' 9-max Seat #3 is the button
Seat 1: Scooby-D0O (11538 in chips)=20
Seat 3: JJ2MG72 (19622 in chips)=20
Seat 5: lrb1024 (9716 in chips)=20
Seat 6: alcode422 (16790 in chips)=20
Seat 7: JJin91 (12285 in chips)=20
Seat 8: CrittyJJones (4418 in chips)=20
Seat 9: senor stinks (11000 in chips)=20
lrb1024: posts small blind 40
alcode422: posts big blind 80
*** HOLE CARDS ***
Dealt to JJin91 [8h Th]
JJin91: folds=20
CrittyJJones: folds=20
senor stinks: folds=20
Scooby-D0O: folds=20
JJ2MG72: calls 80
lrb1024: calls 40
alcode422: raises 400 to 480
JJ2MG72: calls 400
lrb1024: folds=20
*** FLOP *** [3h 9d 7d]
alcode422: bets 480
JJ2MG72: calls 480
*** TURN *** [3h 9d 7d] [5h]
alcode422: bets 960
JJ2MG72: calls 960
*** RIVER *** [3h 9d 7d 5h] [2c]
alcode422: bets 3920
JJ2MG72: raises 13782 to 17702 and is all-in
alcode422: folds=20
Uncalled bet (13782) returned to JJ2MG72
JJ2MG72 collected 11760 from pot
JJ2MG72: doesn't show hand=20
*** SUMMARY ***
Total pot 11760 | Rake 0=20
Board [3h 9d 7d 5h 2c]
Seat 1: Scooby-D0O folded before Flop (didn't bet)
Seat 3: JJ2MG72 (button) collected (11760)
Seat 5: lrb1024 (small blind) folded before Flop
Seat 6: alcode422 (big blind) folded on the River
Seat 7: JJin91 folded before Flop (didn't bet)
Seat 8: CrittyJJones folded before Flop (didn't bet)
Seat 9: senor stinks folded before Flop (didn't bet)


*********** # 9 **************
PokerStars Hand #172136509787: Tournament #1648990476, $18.20+$1.80 USD=
 Hold'em No Limit - Level III (40/80) - 2017/07/06 19:25:05 ET
Table '1648990476 2' 9-max Seat #5 is the button
Seat 1: Scooby-D0O (11538 in chips)=20
Seat 3: JJ2MG72 (25542 in chips)=20
Seat 5: lrb1024 (9636 in chips)=20
Seat 6: alcode422 (10950 in chips)=20
Seat 7: JJin91 (12285 in chips)=20
Seat 8: CrittyJJones (4418 in chips)=20
Seat 9: senor stinks (11000 in chips)=20
alcode422: posts small blind 40
JJin91: posts big blind 80
*** HOLE CARDS ***
Dealt to JJin91 [Ad 6d]
CrittyJJones: folds=20
senor stinks: folds=20
Scooby-D0O: raises 120 to 200
JJ2MG72: folds=20
lrb1024: folds=20
alcode422: calls 160
JJin91: calls 120
*** FLOP *** [3h 3s Td]
alcode422: checks=20
JJin91: checks=20
Scooby-D0O: bets 180
alcode422: folds=20
JJin91: calls 180
*** TURN *** [3h 3s Td] [Kc]
JJin91: checks=20
Scooby-D0O: bets 720
JJin91: folds=20
Uncalled bet (720) returned to Scooby-D0O
Scooby-D0O collected 960 from pot
*** SUMMARY ***
Total pot 960 | Rake 0=20
Board [3h 3s Td Kc]
Seat 1: Scooby-D0O collected (960)
Seat 3: JJ2MG72 folded before Flop (didn't bet)
Seat 5: lrb1024 (button) folded before Flop (didn't bet)
Seat 6: alcode422 (small blind) folded on the Flop
Seat 7: JJin91 (big blind) folded on the Turn
Seat 8: CrittyJJones folded before Flop (didn't bet)
Seat 9: senor stinks folded before Flop (didn't bet)


*********** # 10 **************
PokerStars Hand #172136509997: Tournament #1648990476, $18.20+$1.80 USD=
 Hold'em No Limit - Level III (40/80) - 2017/07/06 19:26:05 ET
Table '1648990476 2' 9-max Seat #6 is the button
Seat 1: Scooby-D0O (12118 in chips)=20
Seat 3: JJ2MG72 (25542 in chips)=20
Seat 5: lrb1024 (9636 in chips)=20
Seat 6: alcode422 (10750 in chips)=20
Seat 7: JJin91 (11905 in chips)=20
Seat 8: CrittyJJones (4418 in chips)=20
Seat 9: senor stinks (11000 in chips)=20
JJin91: posts small blind 40
CrittyJJones: posts big blind 80
*** HOLE CARDS ***
Dealt to JJin91 [2c 9d]
senor stinks: folds=20
Scooby-D0O: raises 120 to 200
JJ2MG72: raises 360 to 560
lrb1024: folds=20
alcode422: calls 560
JJin91: folds=20
CrittyJJones: folds=20
Scooby-D0O: calls 360
*** FLOP *** [Jh 2s Jc]
Scooby-D0O: checks=20
JJ2MG72: checks=20
alcode422: checks=20
*** TURN *** [Jh 2s Jc] [Ah]
Scooby-D0O: checks=20
JJ2MG72: checks=20
alcode422: checks=20
*** RIVER *** [Jh 2s Jc Ah] [Kh]
Scooby-D0O: bets 1350
JJ2MG72: calls 1350
alcode422: folds=20
*** SHOW DOWN ***
Scooby-D0O: shows [6s As] (two pair, Aces and Jacks)
JJ2MG72: shows [Ac Qh] (two pair, Aces and Jacks)
Scooby-D0O collected 2250 from pot
JJ2MG72 collected 2250 from pot
*** SUMMARY ***
Total pot 4500 | Rake 0=20
Board [Jh 2s Jc Ah Kh]
Seat 1: Scooby-D0O showed [6s As] and won (2250) with two pair, Aces an=
d Jacks
Seat 3: JJ2MG72 showed [Ac Qh] and won (2250) with two pair, Aces and J=
acks
Seat 5: lrb1024 folded before Flop (didn't bet)
Seat 6: alcode422 (button) folded on the River
Seat 7: JJin91 (small blind) folded before Flop
Seat 8: CrittyJJones (big blind) folded before Flop
Seat 9: senor stinks folded before Flop (didn't bet)


*********** # 11 **************
PokerStars Hand #172138030798: Tournament #1648990476, $18.20+$1.80 USD=
 Hold'em No Limit - Level III (40/80) - 2017/07/06 19:27:05 ET
Table '1648990476 2' 9-max Seat #7 is the button
Seat 1: Scooby-D0O (12458 in chips)=20
Seat 2: donkeynutz44 (10000 in chips)=20
Seat 3: JJ2MG72 (25882 in chips)=20
Seat 6: alcode422 (10190 in chips)=20
Seat 7: JJin91 (11865 in chips)=20
Seat 8: CrittyJJones (4338 in chips)=20
Seat 9: senor stinks (11000 in chips)=20
CrittyJJones: posts small blind 40
senor stinks: posts big blind 80
*** HOLE CARDS ***
Dealt to JJin91 [As 7h]
Scooby-D0O: folds=20
donkeynutz44: folds=20
JJ2MG72: calls 80
alcode422: calls 80
JJin91: calls 80
CrittyJJones: calls 40
senor stinks: checks=20
*** FLOP *** [Qc 4d 8h]
CrittyJJones: bets 289
senor stinks: folds=20
JJ2MG72: folds=20
alcode422: calls 289
JJin91: folds=20
*** TURN *** [Qc 4d 8h] [8c]
CrittyJJones: checks=20
alcode422: checks=20
*** RIVER *** [Qc 4d 8h 8c] [9c]
CrittyJJones: checks=20
alcode422: checks=20
*** SHOW DOWN ***
CrittyJJones: shows [2c Qs] (two pair, Queens and Eights)
alcode422: mucks hand=20
CrittyJJones collected 978 from pot
*** SUMMARY ***
Total pot 978 | Rake 0=20
Board [Qc 4d 8h 8c 9c]
Seat 1: Scooby-D0O folded before Flop (didn't bet)
Seat 2: donkeynutz44 folded before Flop (didn't bet)
Seat 3: JJ2MG72 folded on the Flop
Seat 6: alcode422 mucked [9s 4s]
Seat 7: JJin91 (button) folded on the Flop
Seat 8: CrittyJJones (small blind) showed [2c Qs] and won (978) with tw=
o pair, Queens and Eights
Seat 9: senor stinks (big blind) folded on the Flop


*********** # 12 **************
PokerStars Hand #172138030988: Tournament #1648990476, $18.20+$1.80 USD=
 Hold'em No Limit - Level III (40/80) - 2017/07/06 19:28:01 ET
Table '1648990476 2' 9-max Seat #8 is the button
Seat 1: Scooby-D0O (12458 in chips)=20
Seat 2: donkeynutz44 (10000 in chips)=20
Seat 3: JJ2MG72 (25802 in chips)=20
Seat 4: BUGG136 (10000 in chips)=20
Seat 6: alcode422 (9821 in chips)=20
Seat 7: JJin91 (11785 in chips)=20
Seat 8: CrittyJJones (4947 in chips)=20
Seat 9: senor stinks (10920 in chips)=20
senor stinks: posts small blind 40
Scooby-D0O: posts big blind 80
*** HOLE CARDS ***
Dealt to JJin91 [3h 5d]
donkeynutz44: folds=20
JJ2MG72 has timed out
JJ2MG72: folds=20
JJ2MG72 is sitting out
BUGG136: folds=20
alcode422: calls 80
JJin91: folds=20
CrittyJJones: raises 200 to 280
senor stinks: folds=20
Scooby-D0O: folds=20
alcode422: calls 200
*** FLOP *** [Ah 9h 6c]
alcode422: checks=20
CrittyJJones: bets 447
alcode422: folds=20
Uncalled bet (447) returned to CrittyJJones
CrittyJJones collected 680 from pot
CrittyJJones: doesn't show hand=20
*** SUMMARY ***
Total pot 680 | Rake 0=20
Board [Ah 9h 6c]
Seat 1: Scooby-D0O (big blind) folded before Flop
Seat 2: donkeynutz44 folded before Flop (didn't bet)
Seat 3: JJ2MG72 folded before Flop (didn't bet)
Seat 4: BUGG136 folded before Flop (didn't bet)
Seat 6: alcode422 folded on the Flop
Seat 7: JJin91 folded before Flop (didn't bet)
Seat 8: CrittyJJones (button) collected (680)
Seat 9: senor stinks (small blind) folded before Flop


*********** # 13 **************
PokerStars Hand #172138031207: Tournament #1648990476, $18.20+$1.80 USD=
 Hold'em No Limit - Level III (40/80) - 2017/07/06 19:29:11 ET
Table '1648990476 2' 9-max Seat #9 is the button
Seat 1: Scooby-D0O (12378 in chips)=20
Seat 2: donkeynutz44 (10000 in chips)=20
Seat 3: JJ2MG72 (25802 in chips) is sitting out
Seat 4: BUGG136 (10000 in chips)=20
Seat 6: alcode422 (9541 in chips)=20
Seat 7: JJin91 (11785 in chips)=20
Seat 8: CrittyJJones (5347 in chips)=20
Seat 9: senor stinks (10880 in chips)=20
Scooby-D0O: posts small blind 40
donkeynutz44: posts big blind 80
*** HOLE CARDS ***
Dealt to JJin91 [6d 7d]
JJ2MG72: folds=20
BUGG136: folds=20
alcode422: folds=20
JJin91: raises 88 to 168
JJ2MG72 has returned
CrittyJJones: folds=20
senor stinks: folds=20
Scooby-D0O: folds=20
donkeynutz44: folds=20
Uncalled bet (88) returned to JJin91
JJin91 collected 200 from pot
JJin91: doesn't show hand=20
*** SUMMARY ***
Total pot 200 | Rake 0=20
Seat 1: Scooby-D0O (small blind) folded before Flop
Seat 2: donkeynutz44 (big blind) folded before Flop
Seat 3: JJ2MG72 folded before Flop (didn't bet)
Seat 4: BUGG136 folded before Flop (didn't bet)
Seat 6: alcode422 folded before Flop (didn't bet)
Seat 7: JJin91 collected (200)
Seat 8: CrittyJJones folded before Flop (didn't bet)
Seat 9: senor stinks (button) folded before Flop (didn't bet)


*********** # 14 **************
PokerStars Hand #172138031294: Tournament #1648990476, $18.20+$1.80 USD=
 Hold'em No Limit - Level III (40/80) - 2017/07/06 19:29:39 ET
Table '1648990476 2' 9-max Seat #1 is the button
Seat 1: Scooby-D0O (12338 in chips)=20
Seat 2: donkeynutz44 (9920 in chips)=20
Seat 3: JJ2MG72 (25802 in chips)=20
Seat 4: BUGG136 (10000 in chips)=20
Seat 6: alcode422 (9541 in chips)=20
Seat 7: JJin91 (11905 in chips)=20
Seat 8: CrittyJJones (5347 in chips)=20
Seat 9: senor stinks (10880 in chips)=20
donkeynutz44: posts small blind 40
JJ2MG72: posts big blind 80
*** HOLE CARDS ***
Dealt to JJin91 [4d 5h]
BUGG136: folds=20
alcode422: calls 80
JJin91: folds=20
CrittyJJones: folds=20
senor stinks: folds=20
Scooby-D0O: folds=20
donkeynutz44: folds=20
JJ2MG72: checks=20
*** FLOP *** [3h 9s 9h]
JJ2MG72: bets 80
alcode422: folds=20
Uncalled bet (80) returned to JJ2MG72
JJ2MG72 collected 200 from pot
JJ2MG72: doesn't show hand=20
*** SUMMARY ***
Total pot 200 | Rake 0=20
Board [3h 9s 9h]
Seat 1: Scooby-D0O (button) folded before Flop (didn't bet)
Seat 2: donkeynutz44 (small blind) folded before Flop
Seat 3: JJ2MG72 (big blind) collected (200)
Seat 4: BUGG136 folded before Flop (didn't bet)
Seat 6: alcode422 folded on the Flop
Seat 7: JJin91 folded before Flop (didn't bet)
Seat 8: CrittyJJones folded before Flop (didn't bet)
Seat 9: senor stinks folded before Flop (didn't bet)


*********** # 15 **************
PokerStars Hand #172138031447: Tournament #1648990476, $18.20+$1.80 USD=
 Hold'em No Limit - Level IV (50/100) - 2017/07/06 19:30:27 ET
Table '1648990476 2' 9-max Seat #2 is the button
Seat 1: Scooby-D0O (12338 in chips)=20
Seat 2: donkeynutz44 (9880 in chips)=20
Seat 3: JJ2MG72 (25922 in chips)=20
Seat 4: BUGG136 (10000 in chips)=20
Seat 6: alcode422 (9461 in chips)=20
Seat 7: JJin91 (11905 in chips)=20
Seat 8: CrittyJJones (5347 in chips)=20
Seat 9: senor stinks (10880 in chips)=20
Scooby-D0O: posts the ante 10
donkeynutz44: posts the ante 10
JJ2MG72: posts the ante 10
BUGG136: posts the ante 10
alcode422: posts the ante 10
JJin91: posts the ante 10
CrittyJJones: posts the ante 10
senor stinks: posts the ante 10
JJ2MG72: posts small blind 50
BUGG136: posts big blind 100
*** HOLE CARDS ***
Dealt to JJin91 [3s Kc]
alcode422: folds=20
JJin91: folds=20
CrittyJJones: folds=20
senor stinks: folds=20
Scooby-D0O: raises 150 to 250
donkeynutz44: folds=20
JJ2MG72: calls 200
BUGG136: calls 150
*** FLOP *** [Tc Ah As]
JJ2MG72: checks=20
BUGG136: checks=20
Scooby-D0O: bets 365
JJ2MG72: folds=20
BUGG136: folds=20
Uncalled bet (365) returned to Scooby-D0O
Scooby-D0O collected 830 from pot
Scooby-D0O: doesn't show hand=20
*** SUMMARY ***
Total pot 830 | Rake 0=20
Board [Tc Ah As]
Seat 1: Scooby-D0O collected (830)
Seat 2: donkeynutz44 (button) folded before Flop (didn't bet)
Seat 3: JJ2MG72 (small blind) folded on the Flop
Seat 4: BUGG136 (big blind) folded on the Flop
Seat 6: alcode422 folded before Flop (didn't bet)
Seat 7: JJin91 folded before Flop (didn't bet)
Seat 8: CrittyJJones folded before Flop (didn't bet)
Seat 9: senor stinks folded before Flop (didn't bet)


*********** # 16 **************
PokerStars Hand #172138031676: Tournament #1648990476, $18.20+$1.80 USD=
 Hold'em No Limit - Level IV (50/100) - 2017/07/06 19:31:40 ET
Table '1648990476 2' 9-max Seat #3 is the button
Seat 1: Scooby-D0O (12908 in chips)=20
Seat 2: donkeynutz44 (9870 in chips)=20
Seat 3: JJ2MG72 (25662 in chips)=20
Seat 4: BUGG136 (9740 in chips)=20
Seat 6: alcode422 (9451 in chips)=20
Seat 7: JJin91 (11895 in chips)=20
Seat 8: CrittyJJones (5337 in chips)=20
Seat 9: senor stinks (10870 in chips)=20
Scooby-D0O: posts the ante 10
donkeynutz44: posts the ante 10
JJ2MG72: posts the ante 10
BUGG136: posts the ante 10
alcode422: posts the ante 10
JJin91: posts the ante 10
CrittyJJones: posts the ante 10
senor stinks: posts the ante 10
BUGG136: posts small blind 50
alcode422: posts big blind 100
*** HOLE CARDS ***
Dealt to JJin91 [Kc 4h]
JJin91: folds=20
CrittyJJones: folds=20
senor stinks: folds=20
Scooby-D0O: folds=20
donkeynutz44: calls 100
JJ2MG72: folds=20
BUGG136: calls 50
alcode422: checks=20
*** FLOP *** [Ks Tc 2c]
BUGG136: checks=20
alcode422: checks=20
donkeynutz44: checks=20
*** TURN *** [Ks Tc 2c] [5c]
BUGG136: checks=20
alcode422: checks=20
donkeynutz44: checks=20
*** RIVER *** [Ks Tc 2c 5c] [2d]
BUGG136: checks=20
alcode422: checks=20
donkeynutz44: checks=20
*** SHOW DOWN ***
BUGG136: shows [8s Jc] (a pair of Deuces)
alcode422: shows [6c Qh] (a pair of Deuces - King+Queen kicker)
donkeynutz44: mucks hand=20
alcode422 collected 380 from pot
*** SUMMARY ***
Total pot 380 | Rake 0=20
Board [Ks Tc 2c 5c 2d]
Seat 1: Scooby-D0O folded before Flop (didn't bet)
Seat 2: donkeynutz44 mucked [9h 7h]
Seat 3: JJ2MG72 (button) folded before Flop (didn't bet)
Seat 4: BUGG136 (small blind) showed [8s Jc] and lost with a pair of De=
uces
Seat 6: alcode422 (big blind) showed [6c Qh] and won (380) with a pair =
of Deuces
Seat 7: JJin91 folded before Flop (didn't bet)
Seat 8: CrittyJJones folded before Flop (didn't bet)
Seat 9: senor stinks folded before Flop (didn't bet)


*********** # 17 **************
PokerStars Hand #172138031889: Tournament #1648990476, $18.20+$1.80 USD=
 Hold'em No Limit - Level IV (50/100) - 2017/07/06 19:32:41 ET
Table '1648990476 2' 9-max Seat #4 is the button
Seat 1: Scooby-D0O (12898 in chips)=20
Seat 2: donkeynutz44 (9760 in chips)=20
Seat 3: JJ2MG72 (25652 in chips)=20
Seat 4: BUGG136 (9630 in chips)=20
Seat 6: alcode422 (9721 in chips)=20
Seat 7: JJin91 (11885 in chips)=20
Seat 8: CrittyJJones (5327 in chips)=20
Seat 9: senor stinks (10860 in chips)=20
Scooby-D0O: posts the ante 10
donkeynutz44: posts the ante 10
JJ2MG72: posts the ante 10
BUGG136: posts the ante 10
alcode422: posts the ante 10
JJin91: posts the ante 10
CrittyJJones: posts the ante 10
senor stinks: posts the ante 10
alcode422: posts small blind 50
JJin91: posts big blind 100
*** HOLE CARDS ***
Dealt to JJin91 [8d Td]
CrittyJJones: folds=20
senor stinks: raises 150 to 250
Scooby-D0O: folds=20
donkeynutz44: raises 730 to 980
JJ2MG72 has timed out
JJ2MG72: folds=20
JJ2MG72 is sitting out
BUGG136: folds=20
alcode422: calls 930
JJin91: folds=20
senor stinks: folds=20
*** FLOP *** [As Qs Jc]
alcode422: checks=20
donkeynutz44: bets 1195
alcode422: calls 1195
*** TURN *** [As Qs Jc] [Jh]
alcode422: checks=20
donkeynutz44: bets 2390
alcode422: calls 2390
*** RIVER *** [As Qs Jc Jh] [Kc]
alcode422: bets 5146 and is all-in
donkeynutz44: folds=20
Uncalled bet (5146) returned to alcode422
alcode422 collected 9560 from pot
alcode422: doesn't show hand=20
*** SUMMARY ***
Total pot 9560 | Rake 0=20
Board [As Qs Jc Jh Kc]
Seat 1: Scooby-D0O folded before Flop (didn't bet)
Seat 2: donkeynutz44 folded on the River
Seat 3: JJ2MG72 folded before Flop (didn't bet)
Seat 4: BUGG136 (button) folded before Flop (didn't bet)
Seat 6: alcode422 (small blind) collected (9560)
Seat 7: JJin91 (big blind) folded before Flop
Seat 8: CrittyJJones folded before Flop (didn't bet)
Seat 9: senor stinks folded before Flop


*********** # 18 **************
PokerStars Hand #172138032206: Tournament #1648990476, $18.20+$1.80 USD=
 Hold'em No Limit - Level IV (50/100) - 2017/07/06 19:34:16 ET
Table '1648990476 2' 9-max Seat #6 is the button
Seat 1: Scooby-D0O (12888 in chips)=20
Seat 2: donkeynutz44 (5185 in chips)=20
Seat 3: JJ2MG72 (25642 in chips) is sitting out
Seat 4: BUGG136 (9620 in chips)=20
Seat 6: alcode422 (14706 in chips)=20
Seat 7: JJin91 (11775 in chips)=20
Seat 8: CrittyJJones (5317 in chips)=20
Seat 9: senor stinks (10600 in chips)=20
Scooby-D0O: posts the ante 10
donkeynutz44: posts the ante 10
JJ2MG72: posts the ante 10
BUGG136: posts the ante 10
alcode422: posts the ante 10
JJin91: posts the ante 10
CrittyJJones: posts the ante 10
senor stinks: posts the ante 10
JJin91: posts small blind 50
CrittyJJones: posts big blind 100
*** HOLE CARDS ***
Dealt to JJin91 [7c 4c]
senor stinks: folds=20
Scooby-D0O: raises 150 to 250
donkeynutz44: raises 730 to 980
JJ2MG72: folds=20
BUGG136: folds=20
alcode422: folds=20
JJin91: folds=20
CrittyJJones: folds=20
Scooby-D0O: calls 730
*** FLOP *** [Jc 2c Jh]
Scooby-D0O: checks=20
donkeynutz44: checks=20
*** TURN *** [Jc 2c Jh] [6h]
Scooby-D0O: checks=20
donkeynutz44: bets 1095
Scooby-D0O: calls 1095
*** RIVER *** [Jc 2c Jh 6h] [Kd]
Scooby-D0O: bets 3285
donkeynutz44: calls 3100 and is all-in
Uncalled bet (185) returned to Scooby-D0O
*** SHOW DOWN ***
Scooby-D0O: shows [Ah 4h] (a pair of Jacks)
donkeynutz44: shows [Jd As] (three of a kind, Jacks)
donkeynutz44 collected 10580 from pot
*** SUMMARY ***
Total pot 10580 | Rake 0=20
Board [Jc 2c Jh 6h Kd]
Seat 1: Scooby-D0O showed [Ah 4h] and lost with a pair of Jacks
Seat 2: donkeynutz44 showed [Jd As] and won (10580) with three of a kin=
d, Jacks
Seat 3: JJ2MG72 folded before Flop (didn't bet)
Seat 4: BUGG136 folded before Flop (didn't bet)
Seat 6: alcode422 (button) folded before Flop (didn't bet)
Seat 7: JJin91 (small blind) folded before Flop
Seat 8: CrittyJJones (big blind) folded before Flop
Seat 9: senor stinks folded before Flop (didn't bet)


*********** # 19 **************
PokerStars Hand #172138032469: Tournament #1648990476, $18.20+$1.80 USD=
 Hold'em No Limit - Level IV (50/100) - 2017/07/06 19:35:30 ET
Table '1648990476 2' 9-max Seat #7 is the button
Seat 1: Scooby-D0O (7703 in chips)=20
Seat 2: donkeynutz44 (10580 in chips)=20
Seat 3: JJ2MG72 (25632 in chips) is sitting out
Seat 4: BUGG136 (9610 in chips)=20
Seat 6: alcode422 (14696 in chips)=20
Seat 7: JJin91 (11715 in chips)=20
Seat 8: CrittyJJones (5207 in chips)=20
Seat 9: senor stinks (10590 in chips)=20
Scooby-D0O: posts the ante 10
donkeynutz44: posts the ante 10
JJ2MG72: posts the ante 10
BUGG136: posts the ante 10
alcode422: posts the ante 10
JJin91: posts the ante 10
CrittyJJones: posts the ante 10
senor stinks: posts the ante 10
CrittyJJones: posts small blind 50
senor stinks: posts big blind 100
*** HOLE CARDS ***
Dealt to JJin91 [3c 5s]
Scooby-D0O: folds=20
donkeynutz44: calls 100
JJ2MG72: folds=20
BUGG136: folds=20
alcode422: calls 100
JJin91: folds=20
CrittyJJones: calls 50
senor stinks: checks=20
*** FLOP *** [Qc Kh Tc]
CrittyJJones: bets 347
senor stinks: folds=20
donkeynutz44: calls 347
alcode422: raises 1553 to 1900
CrittyJJones: folds=20
donkeynutz44: folds=20
Uncalled bet (1553) returned to alcode422
alcode422 collected 1521 from pot
alcode422: doesn't show hand=20
*** SUMMARY ***
Total pot 1521 | Rake 0=20
Board [Qc Kh Tc]
Seat 1: Scooby-D0O folded before Flop (didn't bet)
Seat 2: donkeynutz44 folded on the Flop
Seat 3: JJ2MG72 folded before Flop (didn't bet)
Seat 4: BUGG136 folded before Flop (didn't bet)
Seat 6: alcode422 collected (1521)
Seat 7: JJin91 (button) folded before Flop (didn't bet)
Seat 8: CrittyJJones (small blind) folded on the Flop
Seat 9: senor stinks (big blind) folded on the Flop


*********** # 20 **************
PokerStars Hand #172138032651: Tournament #1648990476, $18.20+$1.80 USD=
 Hold'em No Limit - Level IV (50/100) - 2017/07/06 19:36:24 ET
Table '1648990476 2' 9-max Seat #8 is the button
Seat 1: Scooby-D0O (7693 in chips)=20
Seat 2: donkeynutz44 (10123 in chips)=20
Seat 3: JJ2MG72 (25622 in chips) is sitting out
Seat 4: BUGG136 (9600 in chips)=20
Seat 6: alcode422 (15760 in chips)=20
Seat 7: JJin91 (11705 in chips)=20
Seat 8: CrittyJJones (4750 in chips)=20
Seat 9: senor stinks (10480 in chips)=20
Scooby-D0O: posts the ante 10
donkeynutz44: posts the ante 10
JJ2MG72: posts the ante 10
BUGG136: posts the ante 10
alcode422: posts the ante 10
JJin91: posts the ante 10
CrittyJJones: posts the ante 10
senor stinks: posts the ante 10
senor stinks: posts small blind 50
Scooby-D0O: posts big blind 100
*** HOLE CARDS ***
Dealt to JJin91 [6s Jc]
donkeynutz44: raises 200 to 300
JJ2MG72: folds=20
BUGG136: folds=20
alcode422: calls 300
JJin91: folds=20
CrittyJJones: folds=20
senor stinks: folds=20
Scooby-D0O: folds=20
*** FLOP *** [8c 4h 7h]
donkeynutz44: bets 415
alcode422: calls 415
*** TURN *** [8c 4h 7h] [Tc]
donkeynutz44: checks=20
alcode422: bets 800
donkeynutz44: folds=20
Uncalled bet (800) returned to alcode422
alcode422 collected 1660 from pot
alcode422: doesn't show hand=20
*** SUMMARY ***
Total pot 1660 | Rake 0=20
Board [8c 4h 7h Tc]
Seat 1: Scooby-D0O (big blind) folded before Flop
Seat 2: donkeynutz44 folded on the Turn
Seat 3: JJ2MG72 folded before Flop (didn't bet)
Seat 4: BUGG136 folded before Flop (didn't bet)
Seat 6: alcode422 collected (1660)
Seat 7: JJin91 folded before Flop (didn't bet)
Seat 8: CrittyJJones (button) folded before Flop (didn't bet)
Seat 9: senor stinks (small blind) folded before Flop


*********** # 21 **************
PokerStars Hand #172138032896: Tournament #1648990476, $18.20+$1.80 USD=
 Hold'em No Limit - Level IV (50/100) - 2017/07/06 19:37:37 ET
Table '1648990476 2' 9-max Seat #9 is the button
Seat 1: Scooby-D0O (7583 in chips)=20
Seat 2: donkeynutz44 (9398 in chips)=20
Seat 3: JJ2MG72 (25612 in chips) is sitting out
Seat 4: BUGG136 (9590 in chips)=20
Seat 6: alcode422 (16695 in chips)=20
Seat 7: JJin91 (11695 in chips)=20
Seat 8: CrittyJJones (4740 in chips)=20
Seat 9: senor stinks (10420 in chips)=20
Scooby-D0O: posts the ante 10
donkeynutz44: posts the ante 10
JJ2MG72: posts the ante 10
BUGG136: posts the ante 10
alcode422: posts the ante 10
JJin91: posts the ante 10
CrittyJJones: posts the ante 10
senor stinks: posts the ante 10
Scooby-D0O: posts small blind 50
donkeynutz44: posts big blind 100
*** HOLE CARDS ***
Dealt to JJin91 [Qd Qh]
JJ2MG72: folds=20
BUGG136: folds=20
alcode422: folds=20
JJin91: raises 111 to 211
CrittyJJones: calls 211
senor stinks: folds=20
Scooby-D0O: calls 161
donkeynutz44: raises 924 to 1135
JJin91: raises 3078 to 4213
CrittyJJones: raises 517 to 4730 and is all-in
Scooby-D0O: folds=20
donkeynutz44: raises 4658 to 9388 and is all-in
JJin91: calls 5175
*** FLOP *** [2d Th 5c]
*** TURN *** [2d Th 5c] [4s]
*** RIVER *** [2d Th 5c 4s] [8d]
*** SHOW DOWN ***
donkeynutz44: shows [9h 9c] (a pair of Nines)
JJin91: shows [Qd Qh] (a pair of Queens)
JJin91 collected 9316 from side pot
CrittyJJones: shows [Ah Kh] (high card Ace)
JJin91 collected 14481 from main pot
donkeynutz44 finished the tournament in 128th place
CrittyJJones finished the tournament in 129th place
*** SUMMARY ***
Total pot 23797 Main pot 14481. Side pot 9316. | Rake 0=20
Board [2d Th 5c 4s 8d]
Seat 1: Scooby-D0O (small blind) folded before Flop
Seat 2: donkeynutz44 (big blind) showed [9h 9c] and lost with a pair of=
 Nines
Seat 3: JJ2MG72 folded before Flop (didn't bet)
Seat 4: BUGG136 folded before Flop (didn't bet)
Seat 6: alcode422 folded before Flop (didn't bet)
Seat 7: JJin91 showed [Qd Qh] and won (23797) with a pair of Queens
Seat 8: CrittyJJones showed [Ah Kh] and lost with high card Ace
Seat 9: senor stinks (button) folded before Flop (didn't bet)


*********** # 22 **************
PokerStars Hand #172138033098: Tournament #1648990476, $18.20+$1.80 USD=
 Hold'em No Limit - Level IV (50/100) - 2017/07/06 19:38:33 ET
Table '1648990476 2' 9-max Seat #1 is the button
Seat 1: Scooby-D0O (7362 in chips)=20
Seat 3: JJ2MG72 (25602 in chips) is sitting out
Seat 4: BUGG136 (9580 in chips)=20
Seat 6: alcode422 (16685 in chips)=20
Seat 7: JJin91 (26094 in chips)=20
Seat 9: senor stinks (10410 in chips)=20
Scooby-D0O: posts the ante 10
JJ2MG72: posts the ante 10
BUGG136: posts the ante 10
alcode422: posts the ante 10
JJin91: posts the ante 10
senor stinks: posts the ante 10
JJ2MG72: posts small blind 50
BUGG136: posts big blind 100
*** HOLE CARDS ***
Dealt to JJin91 [Jc 6c]
alcode422: folds=20
JJin91: folds=20
senor stinks: raises 150 to 250
Scooby-D0O: raises 450 to 700
JJ2MG72: folds=20
BUGG136: folds=20
JJ2MG72 has returned
senor stinks: raises 1000 to 1700
Scooby-D0O: folds=20
Uncalled bet (1000) returned to senor stinks
senor stinks collected 1610 from pot
senor stinks: doesn't show hand=20
*** SUMMARY ***
Total pot 1610 | Rake 0=20
Seat 1: Scooby-D0O (button) folded before Flop
Seat 3: JJ2MG72 (small blind) folded before Flop
Seat 4: BUGG136 (big blind) folded before Flop
Seat 6: alcode422 folded before Flop (didn't bet)
Seat 7: JJin91 folded before Flop (didn't bet)
Seat 9: senor stinks collected (1610)


*********** # 23 **************
PokerStars Hand #172138033242: Tournament #1648990476, $18.20+$1.80 USD=
 Hold'em No Limit - Level IV (50/100) - 2017/07/06 19:39:16 ET
Table '1648990476 2' 9-max Seat #3 is the button
Seat 1: Scooby-D0O (6652 in chips)=20
Seat 3: JJ2MG72 (25542 in chips)=20
Seat 4: BUGG136 (9470 in chips)=20
Seat 5: SapofPine (11368 in chips)=20
Seat 6: alcode422 (16675 in chips)=20
Seat 7: JJin91 (26084 in chips)=20
Seat 8: CrittyJJones (10000 in chips)=20
Seat 9: senor stinks (11310 in chips)=20
Scooby-D0O: posts the ante 10
JJ2MG72: posts the ante 10
BUGG136: posts the ante 10
SapofPine: posts the ante 10
alcode422: posts the ante 10
JJin91: posts the ante 10
CrittyJJones: posts the ante 10
senor stinks: posts the ante 10
BUGG136: posts small blind 50
SapofPine: posts big blind 100
*** HOLE CARDS ***
Dealt to JJin91 [2d Qh]
alcode422: folds=20
JJin91: folds=20
CrittyJJones: folds=20
senor stinks: raises 150 to 250
Scooby-D0O: folds=20
JJ2MG72: folds=20
BUGG136: folds=20
SapofPine: folds=20
Uncalled bet (150) returned to senor stinks
senor stinks collected 330 from pot
senor stinks: doesn't show hand=20
*** SUMMARY ***
Total pot 330 | Rake 0=20
Seat 1: Scooby-D0O folded before Flop (didn't bet)
Seat 3: JJ2MG72 (button) folded before Flop (didn't bet)
Seat 4: BUGG136 (small blind) folded before Flop
Seat 5: SapofPine (big blind) folded before Flop
Seat 6: alcode422 folded before Flop (didn't bet)
Seat 7: JJin91 folded before Flop (didn't bet)
Seat 8: CrittyJJones folded before Flop (didn't bet)
Seat 9: senor stinks collected (330)


*********** # 24 **************
PokerStars Hand #172138033348: Tournament #1648990476, $18.20+$1.80 USD=
 Hold'em No Limit - Level IV (50/100) - 2017/07/06 19:39:50 ET
Table '1648990476 2' 9-max Seat #4 is the button
Seat 1: Scooby-D0O (6642 in chips)=20
Seat 3: JJ2MG72 (25532 in chips)=20
Seat 4: BUGG136 (9410 in chips)=20
Seat 5: SapofPine (11258 in chips)=20
Seat 6: alcode422 (16665 in chips)=20
Seat 7: JJin91 (26074 in chips)=20
Seat 8: CrittyJJones (9990 in chips)=20
Seat 9: senor stinks (11530 in chips)=20
Scooby-D0O: posts the ante 10
JJ2MG72: posts the ante 10
BUGG136: posts the ante 10
SapofPine: posts the ante 10
alcode422: posts the ante 10
JJin91: posts the ante 10
CrittyJJones: posts the ante 10
senor stinks: posts the ante 10
SapofPine: posts small blind 50
alcode422: posts big blind 100
*** HOLE CARDS ***
Dealt to JJin91 [4d 6d]
JJin91: folds=20
CrittyJJones: folds=20
senor stinks: folds=20
Scooby-D0O: folds=20
JJ2MG72: folds=20
BUGG136: calls 100
SapofPine: folds=20
alcode422: checks=20
*** FLOP *** [4h 5c Th]
alcode422: checks=20
BUGG136: bets 100
alcode422: raises 500 to 600
BUGG136: folds=20
Uncalled bet (500) returned to alcode422
alcode422 collected 530 from pot
alcode422: doesn't show hand=20
*** SUMMARY ***
Total pot 530 | Rake 0=20
Board [4h 5c Th]
Seat 1: Scooby-D0O folded before Flop (didn't bet)
Seat 3: JJ2MG72 folded before Flop (didn't bet)
Seat 4: BUGG136 (button) folded on the Flop
Seat 5: SapofPine (small blind) folded before Flop
Seat 6: alcode422 (big blind) collected (530)
Seat 7: JJin91 folded before Flop (didn't bet)
Seat 8: CrittyJJones folded before Flop (didn't bet)
Seat 9: senor stinks folded before Flop (didn't bet)


*********** # 25 **************
PokerStars Hand #172138033575: Tournament #1648990476, $18.20+$1.80 USD=
 Hold'em No Limit - Level V (60/120) - 2017/07/06 19:40:50 ET
Table '1648990476 2' 9-max Seat #5 is the button
Seat 1: Scooby-D0O (6632 in chips)=20
Seat 2: EdgyEddie (10000 in chips)=20
Seat 3: JJ2MG72 (25522 in chips)=20
Seat 4: BUGG136 (9200 in chips)=20
Seat 5: SapofPine (11198 in chips)=20
Seat 6: alcode422 (16985 in chips)=20
Seat 7: JJin91 (26064 in chips)=20
Seat 8: CrittyJJones (9980 in chips)=20
Seat 9: senor stinks (11520 in chips)=20
Scooby-D0O: posts the ante 15
EdgyEddie: posts the ante 15
JJ2MG72: posts the ante 15
BUGG136: posts the ante 15
SapofPine: posts the ante 15
alcode422: posts the ante 15
JJin91: posts the ante 15
CrittyJJones: posts the ante 15
senor stinks: posts the ante 15
alcode422: posts small blind 60
JJin91: posts big blind 120
*** HOLE CARDS ***
Dealt to JJin91 [7d Ah]
CrittyJJones: folds=20
senor stinks: folds=20
Scooby-D0O: raises 180 to 300
EdgyEddie: folds=20
JJ2MG72: calls 300
BUGG136: folds=20
SapofPine: folds=20
alcode422: folds=20
JJin91: calls 180
*** FLOP *** [9s Qh Tc]
JJin91: checks=20
Scooby-D0O: checks=20
JJ2MG72: bets 480
JJin91: folds=20
Scooby-D0O: calls 480
*** TURN *** [9s Qh Tc] [Qc]
Scooby-D0O: checks=20
JJ2MG72: checks=20
*** RIVER *** [9s Qh Tc Qc] [Qd]
Scooby-D0O: checks=20
JJ2MG72: checks=20
*** SHOW DOWN ***
Scooby-D0O: shows [Ac 9h] (a full house, Queens full of Nines)
JJ2MG72: mucks hand=20
Scooby-D0O collected 2055 from pot
*** SUMMARY ***
Total pot 2055 | Rake 0=20
Board [9s Qh Tc Qc Qd]
Seat 1: Scooby-D0O showed [Ac 9h] and won (2055) with a full house, Que=
ens full of Nines
Seat 2: EdgyEddie folded before Flop (didn't bet)
Seat 3: JJ2MG72 mucked [Kh Jc]
Seat 4: BUGG136 folded before Flop (didn't bet)
Seat 5: SapofPine (button) folded before Flop (didn't bet)
Seat 6: alcode422 (small blind) folded before Flop
Seat 7: JJin91 (big blind) folded on the Flop
Seat 8: CrittyJJones folded before Flop (didn't bet)
Seat 9: senor stinks folded before Flop (didn't bet)


*********** # 26 **************
PokerStars Hand #172138033878: Tournament #1648990476, $18.20+$1.80 USD=
 Hold'em No Limit - Level V (60/120) - 2017/07/06 19:42:11 ET
Table '1648990476 2' 9-max Seat #6 is the button
Seat 1: Scooby-D0O (7892 in chips)=20
Seat 2: EdgyEddie (9985 in chips)=20
Seat 3: JJ2MG72 (24727 in chips)=20
Seat 4: BUGG136 (9185 in chips)=20
Seat 5: SapofPine (11183 in chips)=20
Seat 6: alcode422 (16910 in chips)=20
Seat 7: JJin91 (25749 in chips)=20
Seat 9: senor stinks (11505 in chips)=20
Scooby-D0O: posts the ante 15
EdgyEddie: posts the ante 15
JJ2MG72: posts the ante 15
BUGG136: posts the ante 15
SapofPine: posts the ante 15
alcode422: posts the ante 15
JJin91: posts the ante 15
senor stinks: posts the ante 15
JJin91: posts small blind 60
senor stinks: posts big blind 120
*** HOLE CARDS ***
Dealt to JJin91 [2d Kc]
Scooby-D0O: raises 180 to 300
EdgyEddie: folds=20
JJ2MG72: calls 300
BUGG136: folds=20
SapofPine: folds=20
alcode422: folds=20
JJin91: folds=20
senor stinks: folds=20
*** FLOP *** [4h Ad 5d]
Scooby-D0O: bets 396
JJ2MG72: folds=20
Uncalled bet (396) returned to Scooby-D0O
Scooby-D0O collected 900 from pot
*** SUMMARY ***
Total pot 900 | Rake 0=20
Board [4h Ad 5d]
Seat 1: Scooby-D0O collected (900)
Seat 2: EdgyEddie folded before Flop (didn't bet)
Seat 3: JJ2MG72 folded on the Flop
Seat 4: BUGG136 folded before Flop (didn't bet)
Seat 5: SapofPine folded before Flop (didn't bet)
Seat 6: alcode422 (button) folded before Flop (didn't bet)
Seat 7: JJin91 (small blind) folded before Flop
Seat 9: senor stinks (big blind) folded before Flop


*********** # 27 **************
PokerStars Hand #172138034023: Tournament #1648990476, $18.20+$1.80 USD=
 Hold'em No Limit - Level V (60/120) - 2017/07/06 19:42:48 ET
Table '1648990476 2' 9-max Seat #7 is the button
Seat 1: Scooby-D0O (8477 in chips)=20
Seat 2: EdgyEddie (9970 in chips)=20
Seat 4: BUGG136 (9170 in chips)=20
Seat 5: SapofPine (11168 in chips)=20
Seat 6: alcode422 (16895 in chips)=20
Seat 7: JJin91 (25674 in chips)=20
Seat 9: senor stinks (11370 in chips)=20
Scooby-D0O: posts the ante 15
EdgyEddie: posts the ante 15
BUGG136: posts the ante 15
SapofPine: posts the ante 15
alcode422: posts the ante 15
JJin91: posts the ante 15
senor stinks: posts the ante 15
senor stinks: posts small blind 60
Scooby-D0O: posts big blind 120
*** HOLE CARDS ***
Dealt to JJin91 [Th 8d]
EdgyEddie: folds=20
BUGG136: calls 120
SapofPine: folds=20
alcode422: folds=20
JJin91: folds=20
senor stinks: calls 60
Scooby-D0O: checks=20
*** FLOP *** [4h 4s 3c]
senor stinks: checks=20
Scooby-D0O: checks=20
BUGG136: checks=20
*** TURN *** [4h 4s 3c] [Qd]
senor stinks: checks=20
Scooby-D0O: checks=20
BUGG136: checks=20
*** RIVER *** [4h 4s 3c Qd] [Qs]
senor stinks: checks=20
Scooby-D0O: checks=20
BUGG136: checks=20
*** SHOW DOWN ***
senor stinks: shows [2h Kc] (two pair, Queens and Fours)
Scooby-D0O: mucks hand=20
BUGG136: mucks hand=20
senor stinks collected 465 from pot
*** SUMMARY ***
Total pot 465 | Rake 0=20
Board [4h 4s 3c Qd Qs]
Seat 1: Scooby-D0O (big blind) mucked [7d 6h]
Seat 2: EdgyEddie folded before Flop (didn't bet)
Seat 4: BUGG136 mucked [8c 9s]
Seat 5: SapofPine folded before Flop (didn't bet)
Seat 6: alcode422 folded before Flop (didn't bet)
Seat 7: JJin91 (button) folded before Flop (didn't bet)
Seat 9: senor stinks (small blind) showed [2h Kc] and won (465) with tw=
o pair, Queens and Fours


*********** # 28 **************
PokerStars Hand #172138034298: Tournament #1648990476, $18.20+$1.80 USD=
 Hold'em No Limit - Level V (60/120) - 2017/07/06 19:44:06 ET
Table '1648990476 2' 9-max Seat #9 is the button
Seat 1: Scooby-D0O (8342 in chips)=20
Seat 2: EdgyEddie (9955 in chips)=20
Seat 4: BUGG136 (9035 in chips)=20
Seat 5: SapofPine (11153 in chips)=20
Seat 6: alcode422 (16880 in chips)=20
Seat 7: JJin91 (25659 in chips)=20
Seat 9: senor stinks (11700 in chips)=20
Scooby-D0O: posts the ante 15
EdgyEddie: posts the ante 15
BUGG136: posts the ante 15
SapofPine: posts the ante 15
alcode422: posts the ante 15
JJin91: posts the ante 15
senor stinks: posts the ante 15
Scooby-D0O: posts small blind 60
EdgyEddie: posts big blind 120
*** HOLE CARDS ***
Dealt to JJin91 [8h Kd]
BUGG136: raises 120 to 240
SapofPine: folds=20
alcode422: folds=20
JJin91: folds=20
senor stinks: raises 480 to 720
Scooby-D0O: folds=20
EdgyEddie: calls 600
BUGG136: calls 480
*** FLOP *** [6s 7h 7s]
EdgyEddie: checks=20
BUGG136: checks=20
senor stinks: bets 720
EdgyEddie: calls 720
BUGG136: folds=20
*** TURN *** [6s 7h 7s] [Td]
EdgyEddie: checks=20
senor stinks: checks=20
*** RIVER *** [6s 7h 7s Td] [Kc]
EdgyEddie: checks=20
senor stinks: bets 1200
EdgyEddie: folds=20
Uncalled bet (1200) returned to senor stinks
senor stinks collected 3765 from pot
senor stinks: doesn't show hand=20
*** SUMMARY ***
Total pot 3765 | Rake 0=20
Board [6s 7h 7s Td Kc]
Seat 1: Scooby-D0O (small blind) folded before Flop
Seat 2: EdgyEddie (big blind) folded on the River
Seat 4: BUGG136 folded on the Flop
Seat 5: SapofPine folded before Flop (didn't bet)
Seat 6: alcode422 folded before Flop (didn't bet)
Seat 7: JJin91 folded before Flop (didn't bet)
Seat 9: senor stinks (button) collected (3765)


*********** # 29 **************
PokerStars Hand #172138034548: Tournament #1648990476, $18.20+$1.80 USD=
 Hold'em No Limit - Level V (60/120) - 2017/07/06 19:45:15 ET
Table '1648990476 2' 9-max Seat #1 is the button
Seat 1: Scooby-D0O (8267 in chips)=20
Seat 2: EdgyEddie (8500 in chips)=20
Seat 3: OceansO7 (10000 in chips)=20
Seat 4: BUGG136 (8300 in chips)=20
Seat 5: SapofPine (11138 in chips)=20
Seat 6: alcode422 (16865 in chips)=20
Seat 7: JJin91 (25644 in chips)=20
Seat 9: senor stinks (14010 in chips)=20
Scooby-D0O: posts the ante 15
EdgyEddie: posts the ante 15
OceansO7: posts the ante 15
BUGG136: posts the ante 15
SapofPine: posts the ante 15
alcode422: posts the ante 15
JJin91: posts the ante 15
senor stinks: posts the ante 15
EdgyEddie: posts small blind 60
OceansO7: posts big blind 120
*** HOLE CARDS ***
Dealt to JJin91 [9d 3c]
BUGG136: folds=20
SapofPine: folds=20
alcode422: folds=20
JJin91: folds=20
senor stinks: raises 180 to 300
Scooby-D0O: folds=20
EdgyEddie: calls 240
OceansO7: calls 180
*** FLOP *** [8h Qc Td]
EdgyEddie: checks=20
OceansO7: checks=20
senor stinks: checks=20
*** TURN *** [8h Qc Td] [7h]
EdgyEddie: checks=20
OceansO7: bets 420
senor stinks: calls 420
EdgyEddie: folds=20
*** RIVER *** [8h Qc Td 7h] [7s]
OceansO7: checks=20
senor stinks: bets 600
OceansO7: calls 600
*** SHOW DOWN ***
senor stinks: shows [Tc Ad] (two pair, Tens and Sevens)
OceansO7: shows [Js Qh] (two pair, Queens and Sevens)
OceansO7 collected 3060 from pot
*** SUMMARY ***
Total pot 3060 | Rake 0=20
Board [8h Qc Td 7h 7s]
Seat 1: Scooby-D0O (button) folded before Flop (didn't bet)
Seat 2: EdgyEddie (small blind) folded on the Turn
Seat 3: OceansO7 (big blind) showed [Js Qh] and won (3060) with two pai=
r, Queens and Sevens
Seat 4: BUGG136 folded before Flop (didn't bet)
Seat 5: SapofPine folded before Flop (didn't bet)
Seat 6: alcode422 folded before Flop (didn't bet)
Seat 7: JJin91 folded before Flop (didn't bet)
Seat 9: senor stinks showed [Tc Ad] and lost with two pair, Tens and Se=
vens


*********** # 30 **************
PokerStars Hand #172138034745: Tournament #1648990476, $18.20+$1.80 USD=
 Hold'em No Limit - Level V (60/120) - 2017/07/06 19:46:13 ET
Table '1648990476 2' 9-max Seat #2 is the button
Seat 1: Scooby-D0O (8252 in chips)=20
Seat 2: EdgyEddie (8185 in chips)=20
Seat 3: OceansO7 (11725 in chips)=20
Seat 4: BUGG136 (8285 in chips)=20
Seat 5: SapofPine (11123 in chips)=20
Seat 6: alcode422 (16850 in chips)=20
Seat 7: JJin91 (25629 in chips)=20
Seat 9: senor stinks (12675 in chips)=20
Scooby-D0O: posts the ante 15
EdgyEddie: posts the ante 15
OceansO7: posts the ante 15
BUGG136: posts the ante 15
SapofPine: posts the ante 15
alcode422: posts the ante 15
JJin91: posts the ante 15
senor stinks: posts the ante 15
OceansO7: posts small blind 60
BUGG136: posts big blind 120
*** HOLE CARDS ***
Dealt to JJin91 [2h 6c]
SapofPine: folds=20
alcode422: raises 480 to 600
JJin91: folds=20
senor stinks: folds=20
Scooby-D0O: raises 1320 to 1920
EdgyEddie: folds=20
OceansO7: folds=20
BUGG136: folds=20
alcode422: calls 1320
*** FLOP *** [5c 6d Kc]
alcode422: checks=20
Scooby-D0O: bets 1822
alcode422: raises 7778 to 9600
Scooby-D0O: calls 4495 and is all-in
Uncalled bet (3283) returned to alcode422
*** TURN *** [5c 6d Kc] [2s]
*** RIVER *** [5c 6d Kc 2s] [7h]
*** SHOW DOWN ***
alcode422: shows [7d 7s] (three of a kind, Sevens)
Scooby-D0O: shows [Ac Ks] (a pair of Kings)
alcode422 collected 16774 from pot
Scooby-D0O finished the tournament in 127th place
*** SUMMARY ***
Total pot 16774 | Rake 0=20
Board [5c 6d Kc 2s 7h]
Seat 1: Scooby-D0O showed [Ac Ks] and lost with a pair of Kings
Seat 2: EdgyEddie (button) folded before Flop (didn't bet)
Seat 3: OceansO7 (small blind) folded before Flop
Seat 4: BUGG136 (big blind) folded before Flop
Seat 5: SapofPine folded before Flop (didn't bet)
Seat 6: alcode422 showed [7d 7s] and won (16774) with three of a kind, =
Sevens
Seat 7: JJin91 folded before Flop (didn't bet)
Seat 9: senor stinks folded before Flop (didn't bet)


*********** # 31 **************
PokerStars Hand #172138034892: Tournament #1648990476, $18.20+$1.80 USD=
 Hold'em No Limit - Level V (60/120) - 2017/07/06 19:46:58 ET
Table '1648990476 2' 9-max Seat #3 is the button
Seat 1: Scooby-D0O (10000 in chips)=20
Seat 2: EdgyEddie (8170 in chips)=20
Seat 3: OceansO7 (11650 in chips)=20
Seat 4: BUGG136 (8150 in chips)=20
Seat 5: SapofPine (11108 in chips)=20
Seat 6: alcode422 (25372 in chips)=20
Seat 7: JJin91 (25614 in chips)=20
Seat 9: senor stinks (12660 in chips)=20
Scooby-D0O: posts the ante 15
EdgyEddie: posts the ante 15
OceansO7: posts the ante 15
BUGG136: posts the ante 15
SapofPine: posts the ante 15
alcode422: posts the ante 15
JJin91: posts the ante 15
senor stinks: posts the ante 15
BUGG136: posts small blind 60
SapofPine: posts big blind 120
*** HOLE CARDS ***
Dealt to JJin91 [5s Ah]
BUGG136 said, "smfh"
alcode422: folds=20
JJin91: folds=20
alcode422 said, "rip"
senor stinks: folds=20
Scooby-D0O: folds=20
BUGG136 said, "lol"
EdgyEddie: raises 120 to 240
OceansO7: folds=20
BUGG136: folds=20
SapofPine: folds=20
Uncalled bet (120) returned to EdgyEddie
EdgyEddie collected 420 from pot
EdgyEddie: doesn't show hand=20
*** SUMMARY ***
Total pot 420 | Rake 0=20
Seat 1: Scooby-D0O folded before Flop (didn't bet)
Seat 2: EdgyEddie collected (420)
Seat 3: OceansO7 (button) folded before Flop (didn't bet)
Seat 4: BUGG136 (small blind) folded before Flop
Seat 5: SapofPine (big blind) folded before Flop
Seat 6: alcode422 folded before Flop (didn't bet)
Seat 7: JJin91 folded before Flop (didn't bet)
Seat 9: senor stinks folded before Flop (didn't bet)


*********** # 32 **************
PokerStars Hand #172138034987: Tournament #1648990476, $18.20+$1.80 USD=
 Hold'em No Limit - Level V (60/120) - 2017/07/06 19:47:27 ET
Table '1648990476 2' 9-max Seat #4 is the button
Seat 1: Scooby-D0O (9985 in chips)=20
Seat 2: EdgyEddie (8455 in chips)=20
Seat 3: OceansO7 (11635 in chips)=20
Seat 4: BUGG136 (8075 in chips)=20
Seat 5: SapofPine (10973 in chips)=20
Seat 6: alcode422 (25357 in chips)=20
Seat 7: JJin91 (25599 in chips)=20
Seat 9: senor stinks (12645 in chips)=20
Scooby-D0O: posts the ante 15
EdgyEddie: posts the ante 15
OceansO7: posts the ante 15
BUGG136: posts the ante 15
SapofPine: posts the ante 15
alcode422: posts the ante 15
JJin91: posts the ante 15
senor stinks: posts the ante 15
SapofPine: posts small blind 60
alcode422: posts big blind 120
*** HOLE CARDS ***
Dealt to JJin91 [7h 4c]
JJin91: folds=20
senor stinks: folds=20
Scooby-D0O: folds=20
EdgyEddie: calls 120
OceansO7: folds=20
BUGG136: folds=20
SapofPine: folds=20
alcode422: checks=20
*** FLOP *** [4s Ac Th]
alcode422: checks=20
EdgyEddie: checks=20
*** TURN *** [4s Ac Th] [9d]
alcode422: checks=20
EdgyEddie: bets 360
alcode422: folds=20
Uncalled bet (360) returned to EdgyEddie
EdgyEddie collected 420 from pot
EdgyEddie: doesn't show hand=20
*** SUMMARY ***
Total pot 420 | Rake 0=20
Board [4s Ac Th 9d]
Seat 1: Scooby-D0O folded before Flop (didn't bet)
Seat 2: EdgyEddie collected (420)
Seat 3: OceansO7 folded before Flop (didn't bet)
Seat 4: BUGG136 (button) folded before Flop (didn't bet)
Seat 5: SapofPine (small blind) folded before Flop
Seat 6: alcode422 (big blind) folded on the Turn
Seat 7: JJin91 folded before Flop (didn't bet)
Seat 9: senor stinks folded before Flop (didn't bet)


*********** # 33 **************
PokerStars Hand #172138035129: Tournament #1648990476, $18.20+$1.80 USD=
 Hold'em No Limit - Level V (60/120) - 2017/07/06 19:48:04 ET
Table '1648990476 2' 9-max Seat #5 is the button
Seat 1: Scooby-D0O (9970 in chips)=20
Seat 2: EdgyEddie (8740 in chips)=20
Seat 3: OceansO7 (11620 in chips)=20
Seat 4: BUGG136 (8060 in chips)=20
Seat 5: SapofPine (10898 in chips)=20
Seat 6: alcode422 (25222 in chips)=20
Seat 7: JJin91 (25584 in chips)=20
Seat 9: senor stinks (12630 in chips)=20
Scooby-D0O: posts the ante 15
EdgyEddie: posts the ante 15
OceansO7: posts the ante 15
BUGG136: posts the ante 15
SapofPine: posts the ante 15
alcode422: posts the ante 15
JJin91: posts the ante 15
senor stinks: posts the ante 15
alcode422: posts small blind 60
JJin91: posts big blind 120
*** HOLE CARDS ***
Dealt to JJin91 [7s 3d]
senor stinks: folds=20
Scooby-D0O: folds=20
EdgyEddie: folds=20
OceansO7: folds=20
BUGG136: folds=20
SapofPine: folds=20
alcode422: raises 360 to 480
JJin91: folds=20
Uncalled bet (360) returned to alcode422
alcode422 collected 360 from pot
alcode422: doesn't show hand=20
*** SUMMARY ***
Total pot 360 | Rake 0=20
Seat 1: Scooby-D0O folded before Flop (didn't bet)
Seat 2: EdgyEddie folded before Flop (didn't bet)
Seat 3: OceansO7 folded before Flop (didn't bet)
Seat 4: BUGG136 folded before Flop (didn't bet)
Seat 5: SapofPine (button) folded before Flop (didn't bet)
Seat 6: alcode422 (small blind) collected (360)
Seat 7: JJin91 (big blind) folded before Flop
Seat 9: senor stinks folded before Flop (didn't bet)


*********** # 34 **************
PokerStars Hand #172138035219: Tournament #1648990476, $18.20+$1.80 USD=
 Hold'em No Limit - Level V (60/120) - 2017/07/06 19:48:26 ET
Table '1648990476 2' 9-max Seat #6 is the button
Seat 1: Scooby-D0O (9955 in chips)=20
Seat 2: EdgyEddie (8725 in chips)=20
Seat 3: OceansO7 (11605 in chips)=20
Seat 4: BUGG136 (8045 in chips)=20
Seat 5: SapofPine (10883 in chips)=20
Seat 6: alcode422 (25447 in chips)=20
Seat 7: JJin91 (25449 in chips)=20
Seat 9: senor stinks (12615 in chips)=20
Scooby-D0O: posts the ante 15
EdgyEddie: posts the ante 15
OceansO7: posts the ante 15
BUGG136: posts the ante 15
SapofPine: posts the ante 15
alcode422: posts the ante 15
JJin91: posts the ante 15
senor stinks: posts the ante 15
JJin91: posts small blind 60
senor stinks: posts big blind 120
*** HOLE CARDS ***
Dealt to JJin91 [5c 6s]
Scooby-D0O: folds=20
EdgyEddie: folds=20
OceansO7: folds=20
BUGG136: folds=20
SapofPine: folds=20
alcode422: folds=20
JJin91: folds=20
Uncalled bet (60) returned to senor stinks
senor stinks collected 240 from pot
senor stinks: doesn't show hand=20
*** SUMMARY ***
Total pot 240 | Rake 0=20
Seat 1: Scooby-D0O folded before Flop (didn't bet)
Seat 2: EdgyEddie folded before Flop (didn't bet)
Seat 3: OceansO7 folded before Flop (didn't bet)
Seat 4: BUGG136 folded before Flop (didn't bet)
Seat 5: SapofPine folded before Flop (didn't bet)
Seat 6: alcode422 (button) folded before Flop (didn't bet)
Seat 7: JJin91 (small blind) folded before Flop
Seat 9: senor stinks (big blind) collected (240)


*********** # 35 **************
PokerStars Hand #172138035332: Tournament #1648990476, $18.20+$1.80 USD=
 Hold'em No Limit - Level V (60/120) - 2017/07/06 19:48:56 ET
Table '1648990476 2' 9-max Seat #7 is the button
Seat 1: Scooby-D0O (9940 in chips)=20
Seat 2: EdgyEddie (8710 in chips)=20
Seat 3: OceansO7 (11590 in chips)=20
Seat 4: BUGG136 (8030 in chips)=20
Seat 5: SapofPine (10868 in chips)=20
Seat 6: alcode422 (25432 in chips)=20
Seat 7: JJin91 (25374 in chips)=20
Seat 9: senor stinks (12780 in chips)=20
Scooby-D0O: posts the ante 15
EdgyEddie: posts the ante 15
OceansO7: posts the ante 15
BUGG136: posts the ante 15
SapofPine: posts the ante 15
alcode422: posts the ante 15
JJin91: posts the ante 15
senor stinks: posts the ante 15
senor stinks: posts small blind 60
Scooby-D0O: posts big blind 120
*** HOLE CARDS ***
Dealt to JJin91 [2s 9c]
EdgyEddie: folds=20
OceansO7: folds=20
BUGG136: folds=20
SapofPine: folds=20
alcode422: raises 420 to 540
JJin91: folds=20
senor stinks: folds=20
Scooby-D0O: folds=20
Uncalled bet (420) returned to alcode422
alcode422 collected 420 from pot
alcode422: doesn't show hand=20
*** SUMMARY ***
Total pot 420 | Rake 0=20
Seat 1: Scooby-D0O (big blind) folded before Flop
Seat 2: EdgyEddie folded before Flop (didn't bet)
Seat 3: OceansO7 folded before Flop (didn't bet)
Seat 4: BUGG136 folded before Flop (didn't bet)
Seat 5: SapofPine folded before Flop (didn't bet)
Seat 6: alcode422 collected (420)
Seat 7: JJin91 (button) folded before Flop (didn't bet)
Seat 9: senor stinks (small blind) folded before Flop


*********** # 36 **************
PokerStars Hand #172138035444: Tournament #1648990476, $18.20+$1.80 USD=
 Hold'em No Limit - Level V (60/120) - 2017/07/06 19:49:27 ET
Table '1648990476 2' 9-max Seat #9 is the button
Seat 1: Scooby-D0O (9805 in chips)=20
Seat 2: EdgyEddie (8695 in chips)=20
Seat 3: OceansO7 (11575 in chips)=20
Seat 4: BUGG136 (8015 in chips)=20
Seat 5: SapofPine (10853 in chips)=20
Seat 6: alcode422 (25717 in chips)=20
Seat 7: JJin91 (25359 in chips)=20
Seat 9: senor stinks (12705 in chips)=20
Scooby-D0O: posts the ante 15
EdgyEddie: posts the ante 15
OceansO7: posts the ante 15
BUGG136: posts the ante 15
SapofPine: posts the ante 15
alcode422: posts the ante 15
JJin91: posts the ante 15
senor stinks: posts the ante 15
Scooby-D0O: posts small blind 60
EdgyEddie: posts big blind 120
*** HOLE CARDS ***
Dealt to JJin91 [Ac 6s]
OceansO7: folds=20
BUGG136: folds=20
SapofPine: folds=20
alcode422: folds=20
JJin91: raises 133 to 253
senor stinks: folds=20
Scooby-D0O: folds=20
EdgyEddie: calls 133
*** FLOP *** [Ts Kh As]
EdgyEddie: checks=20
JJin91: bets 226
EdgyEddie: calls 226
*** TURN *** [Ts Kh As] [2s]
EdgyEddie: checks=20
JJin91: bets 733
EdgyEddie: folds=20
Uncalled bet (733) returned to JJin91
JJin91 collected 1138 from pot
JJin91: doesn't show hand=20
*** SUMMARY ***
Total pot 1138 | Rake 0=20
Board [Ts Kh As 2s]
Seat 1: Scooby-D0O (small blind) folded before Flop
Seat 2: EdgyEddie (big blind) folded on the Turn
Seat 3: OceansO7 folded before Flop (didn't bet)
Seat 4: BUGG136 folded before Flop (didn't bet)
Seat 5: SapofPine folded before Flop (didn't bet)
Seat 6: alcode422 folded before Flop (didn't bet)
Seat 7: JJin91 collected (1138)
Seat 9: senor stinks (button) folded before Flop (didn't bet)


*********** # 37 **************
PokerStars Hand #172138035692: Tournament #1648990476, $18.20+$1.80 USD=
 Hold'em No Limit - Level VI (75/150) - 2017/07/06 19:50:44 ET
Table '1648990476 2' 9-max Seat #1 is the button
Seat 1: Scooby-D0O (9730 in chips)=20
Seat 2: EdgyEddie (8201 in chips)=20
Seat 3: OceansO7 (11560 in chips)=20
Seat 4: BUGG136 (8000 in chips)=20
Seat 5: SapofPine (10838 in chips)=20
Seat 6: alcode422 (25702 in chips)=20
Seat 7: JJin91 (26003 in chips)=20
Seat 9: senor stinks (12690 in chips)=20
Scooby-D0O: posts the ante 20
EdgyEddie: posts the ante 20
OceansO7: posts the ante 20
BUGG136: posts the ante 20
SapofPine: posts the ante 20
alcode422: posts the ante 20
JJin91: posts the ante 20
senor stinks: posts the ante 20
EdgyEddie: posts small blind 75
OceansO7: posts big blind 150
*** HOLE CARDS ***
Dealt to JJin91 [Js Qs]
BUGG136: folds=20
SapofPine: folds=20
alcode422: folds=20
JJin91: raises 166 to 316
senor stinks: folds=20
Scooby-D0O: raises 734 to 1050
EdgyEddie: folds=20
OceansO7: folds=20
JJin91: folds=20
Uncalled bet (734) returned to Scooby-D0O
Scooby-D0O collected 1017 from pot
*** SUMMARY ***
Total pot 1017 | Rake 0=20
Seat 1: Scooby-D0O (button) collected (1017)
Seat 2: EdgyEddie (small blind) folded before Flop
Seat 3: OceansO7 (big blind) folded before Flop
Seat 4: BUGG136 folded before Flop (didn't bet)
Seat 5: SapofPine folded before Flop (didn't bet)
Seat 6: alcode422 folded before Flop (didn't bet)
Seat 7: JJin91 folded before Flop
Seat 9: senor stinks folded before Flop (didn't bet)


*********** # 38 **************
PokerStars Hand #172138035852: Tournament #1648990476, $18.20+$1.80 USD=
 Hold'em No Limit - Level VI (75/150) - 2017/07/06 19:51:35 ET
Table '1648990476 2' 9-max Seat #2 is the button
Seat 1: Scooby-D0O (10411 in chips)=20
Seat 2: EdgyEddie (8106 in chips)=20
Seat 3: OceansO7 (11390 in chips)=20
Seat 4: BUGG136 (7980 in chips)=20
Seat 5: SapofPine (10818 in chips)=20
Seat 6: alcode422 (25682 in chips)=20
Seat 7: JJin91 (25667 in chips)=20
Seat 9: senor stinks (12670 in chips)=20
Scooby-D0O: posts the ante 20
EdgyEddie: posts the ante 20
OceansO7: posts the ante 20
BUGG136: posts the ante 20
SapofPine: posts the ante 20
alcode422: posts the ante 20
JJin91: posts the ante 20
senor stinks: posts the ante 20
OceansO7: posts small blind 75
BUGG136: posts big blind 150
*** HOLE CARDS ***
Dealt to JJin91 [Ad 3d]
SapofPine: folds=20
alcode422: folds=20
JJin91: folds=20
senor stinks: raises 225 to 375
Scooby-D0O: raises 675 to 1050
EdgyEddie: folds=20
OceansO7: folds=20
BUGG136: folds=20
senor stinks: calls 675
*** FLOP *** [7c 7d 6h]
senor stinks: checks=20
Scooby-D0O: bets 746
senor stinks: folds=20
Uncalled bet (746) returned to Scooby-D0O
Scooby-D0O collected 2485 from pot
*** SUMMARY ***
Total pot 2485 | Rake 0=20
Board [7c 7d 6h]
Seat 1: Scooby-D0O collected (2485)
Seat 2: EdgyEddie (button) folded before Flop (didn't bet)
Seat 3: OceansO7 (small blind) folded before Flop
Seat 4: BUGG136 (big blind) folded before Flop
Seat 5: SapofPine folded before Flop (didn't bet)
Seat 6: alcode422 folded before Flop (didn't bet)
Seat 7: JJin91 folded before Flop (didn't bet)
Seat 9: senor stinks folded on the Flop


*********** # 39 **************
PokerStars Hand #172138035931: Tournament #1648990476, $18.20+$1.80 USD=
 Hold'em No Limit - Level VI (75/150) - 2017/07/06 19:51:58 ET
Table '1648990476 2' 9-max Seat #3 is the button
Seat 1: Scooby-D0O (11826 in chips)=20
Seat 2: EdgyEddie (8086 in chips)=20
Seat 3: OceansO7 (11295 in chips)=20
Seat 4: BUGG136 (7810 in chips)=20
Seat 5: SapofPine (10798 in chips)=20
Seat 6: alcode422 (25662 in chips)=20
Seat 7: JJin91 (25647 in chips)=20
Seat 8: Booson11 (10000 in chips)=20
Seat 9: senor stinks (11600 in chips)=20
Scooby-D0O: posts the ante 20
EdgyEddie: posts the ante 20
OceansO7: posts the ante 20
BUGG136: posts the ante 20
SapofPine: posts the ante 20
alcode422: posts the ante 20
JJin91: posts the ante 20
Booson11: posts the ante 20
senor stinks: posts the ante 20
BUGG136: posts small blind 75
SapofPine: posts big blind 150
*** HOLE CARDS ***
Dealt to JJin91 [2h 9s]
alcode422: folds=20
JJin91: folds=20
Booson11: folds=20
senor stinks: folds=20
Scooby-D0O: folds=20
EdgyEddie: folds=20
OceansO7: raises 225 to 375
BUGG136: folds=20
SapofPine: raises 1275 to 1650
OceansO7: raises 9625 to 11275 and is all-in
SapofPine: folds=20
Uncalled bet (9625) returned to OceansO7
OceansO7 collected 3555 from pot
OceansO7: doesn't show hand=20
*** SUMMARY ***
Total pot 3555 | Rake 0=20
Seat 1: Scooby-D0O folded before Flop (didn't bet)
Seat 2: EdgyEddie folded before Flop (didn't bet)
Seat 3: OceansO7 (button) collected (3555)
Seat 4: BUGG136 (small blind) folded before Flop
Seat 5: SapofPine (big blind) folded before Flop
Seat 6: alcode422 folded before Flop (didn't bet)
Seat 7: JJin91 folded before Flop (didn't bet)
Seat 8: Booson11 folded before Flop (didn't bet)
Seat 9: senor stinks folded before Flop (didn't bet)


*********** # 40 **************
PokerStars Hand #172138036118: Tournament #1648990476, $18.20+$1.80 USD=
 Hold'em No Limit - Level VI (75/150) - 2017/07/06 19:52:52 ET
Table '1648990476 2' 9-max Seat #4 is the button
Seat 1: Scooby-D0O (11806 in chips)=20
Seat 2: EdgyEddie (8066 in chips)=20
Seat 3: OceansO7 (13180 in chips)=20
Seat 4: BUGG136 (7715 in chips)=20
Seat 5: SapofPine (9128 in chips)=20
Seat 6: alcode422 (25642 in chips)=20
Seat 7: JJin91 (25627 in chips)=20
Seat 8: Booson11 (9980 in chips)=20
Seat 9: senor stinks (11580 in chips)=20
Scooby-D0O: posts the ante 20
EdgyEddie: posts the ante 20
OceansO7: posts the ante 20
BUGG136: posts the ante 20
SapofPine: posts the ante 20
alcode422: posts the ante 20
JJin91: posts the ante 20
Booson11: posts the ante 20
senor stinks: posts the ante 20
SapofPine: posts small blind 75
alcode422: posts big blind 150
*** HOLE CARDS ***
Dealt to JJin91 [3c Td]
JJin91: folds=20
Booson11: folds=20
senor stinks: folds=20
Scooby-D0O: folds=20
EdgyEddie: folds=20
OceansO7: folds=20
BUGG136: folds=20
SapofPine: folds=20
Uncalled bet (75) returned to alcode422
alcode422 collected 330 from pot
alcode422: doesn't show hand=20
*** SUMMARY ***
Total pot 330 | Rake 0=20
Seat 1: Scooby-D0O folded before Flop (didn't bet)
Seat 2: EdgyEddie folded before Flop (didn't bet)
Seat 3: OceansO7 folded before Flop (didn't bet)
Seat 4: BUGG136 (button) folded before Flop (didn't bet)
Seat 5: SapofPine (small blind) folded before Flop
Seat 6: alcode422 (big blind) collected (330)
Seat 7: JJin91 folded before Flop (didn't bet)
Seat 8: Booson11 folded before Flop (didn't bet)
Seat 9: senor stinks folded before Flop (didn't bet)


*********** # 41 **************
PokerStars Hand #172138036181: Tournament #1648990476, $18.20+$1.80 USD=
 Hold'em No Limit - Level VI (75/150) - 2017/07/06 19:53:06 ET
Table '1648990476 2' 9-max Seat #5 is the button
Seat 1: Scooby-D0O (11786 in chips)=20
Seat 3: OceansO7 (13160 in chips)=20
Seat 4: BUGG136 (7695 in chips)=20
Seat 5: SapofPine (9033 in chips)=20
Seat 6: alcode422 (25877 in chips)=20
Seat 7: JJin91 (25607 in chips)=20
Seat 8: Booson11 (9960 in chips)=20
Seat 9: senor stinks (11560 in chips)=20
Scooby-D0O: posts the ante 20
OceansO7: posts the ante 20
BUGG136: posts the ante 20
SapofPine: posts the ante 20
alcode422: posts the ante 20
JJin91: posts the ante 20
Booson11: posts the ante 20
senor stinks: posts the ante 20
alcode422: posts small blind 75
JJin91: posts big blind 150
*** HOLE CARDS ***
Dealt to JJin91 [Ad 3c]
Booson11: folds=20
senor stinks: folds=20
Scooby-D0O: raises 225 to 375
OceansO7: raises 925 to 1300
BUGG136: folds=20
SapofPine: folds=20
alcode422: folds=20
JJin91: folds=20
Scooby-D0O: raises 1700 to 3000
OceansO7: calls 1700
*** FLOP *** [Jd 2s 4h]
Scooby-D0O: bets 1916
OceansO7: calls 1916
*** TURN *** [Jd 2s 4h] [5s]
Scooby-D0O: bets 6850 and is all-in
OceansO7: calls 6850
*** RIVER *** [Jd 2s 4h 5s] [Qc]
*** SHOW DOWN ***
Scooby-D0O: shows [Kh Ks] (a pair of Kings)
OceansO7: shows [Js Ah] (a pair of Jacks)
Scooby-D0O collected 23917 from pot
*** SUMMARY ***
Total pot 23917 | Rake 0=20
Board [Jd 2s 4h 5s Qc]
Seat 1: Scooby-D0O showed [Kh Ks] and won (23917) with a pair of Kings
Seat 3: OceansO7 showed [Js Ah] and lost with a pair of Jacks
Seat 4: BUGG136 folded before Flop (didn't bet)
Seat 5: SapofPine (button) folded before Flop (didn't bet)
Seat 6: alcode422 (small blind) folded before Flop
Seat 7: JJin91 (big blind) folded before Flop
Seat 8: Booson11 folded before Flop (didn't bet)
Seat 9: senor stinks folded before Flop (didn't bet)


*********** # 42 **************
PokerStars Hand #172138036522: Tournament #1648990476, $18.20+$1.80 USD=
 Hold'em No Limit - Level VI (75/150) - 2017/07/06 19:54:34 ET
Table '1648990476 2' 9-max Seat #6 is the button
Seat 1: Scooby-D0O (23917 in chips)=20
Seat 3: OceansO7 (1374 in chips)=20
Seat 4: BUGG136 (7675 in chips)=20
Seat 5: SapofPine (9013 in chips)=20
Seat 6: alcode422 (25782 in chips)=20
Seat 7: JJin91 (25437 in chips)=20
Seat 8: Booson11 (9940 in chips)=20
Seat 9: senor stinks (11540 in chips)=20
Scooby-D0O: posts the ante 20
OceansO7: posts the ante 20
BUGG136: posts the ante 20
SapofPine: posts the ante 20
alcode422: posts the ante 20
JJin91: posts the ante 20
Booson11: posts the ante 20
senor stinks: posts the ante 20
JJin91: posts small blind 75
Booson11: posts big blind 150
*** HOLE CARDS ***
Dealt to JJin91 [4h 3h]
senor stinks: folds=20
Scooby-D0O: folds=20
OceansO7: folds=20
BUGG136: folds=20
SapofPine: raises 223 to 373
alcode422: calls 373
JJin91: folds=20
Booson11: calls 223
*** FLOP *** [8h 9s 7h]
Booson11: checks=20
SapofPine: checks=20
alcode422: checks=20
*** TURN *** [8h 9s 7h] [2d]
Booson11: bets 600
SapofPine: calls 600
alcode422: calls 600
*** RIVER *** [8h 9s 7h 2d] [6s]
Booson11: checks=20
SapofPine: checks=20
alcode422: checks=20
*** SHOW DOWN ***
Booson11: shows [Jc 4c] (high card Jack)
SapofPine: shows [As Js] (high card Ace)
alcode422: shows [Th Qd] (a straight, Six to Ten)
alcode422 collected 3154 from pot
*** SUMMARY ***
Total pot 3154 | Rake 0=20
Board [8h 9s 7h 2d 6s]
Seat 1: Scooby-D0O folded before Flop (didn't bet)
Seat 3: OceansO7 folded before Flop (didn't bet)
Seat 4: BUGG136 folded before Flop (didn't bet)
Seat 5: SapofPine showed [As Js] and lost with high card Ace
Seat 6: alcode422 (button) showed [Th Qd] and won (3154) with a straigh=
t, Six to Ten
Seat 7: JJin91 (small blind) folded before Flop
Seat 8: Booson11 (big blind) showed [Jc 4c] and lost with high card Jack
Seat 9: senor stinks folded before Flop (didn't bet)


*********** # 43 **************
PokerStars Hand #172138037892: Tournament #1648990476, $18.20+$1.80 USD=
 Hold'em No Limit - Level VI (75/150) - 2017/07/06 20:01:03 ET
Table '1648990476 2' 9-max Seat #7 is the button
Seat 1: Scooby-D0O (23897 in chips)=20
Seat 2: TheBulldawgg (10000 in chips)=20
Seat 3: OceansO7 (1354 in chips)=20
Seat 4: BUGG136 (7655 in chips)=20
Seat 5: SapofPine (8020 in chips)=20
Seat 6: alcode422 (27943 in chips)=20
Seat 7: JJin91 (25342 in chips)=20
Seat 8: Booson11 (8947 in chips)=20
Scooby-D0O: posts the ante 20
TheBulldawgg: posts the ante 20
OceansO7: posts the ante 20
BUGG136: posts the ante 20
SapofPine: posts the ante 20
alcode422: posts the ante 20
JJin91: posts the ante 20
Booson11: posts the ante 20
Booson11: posts small blind 75
Scooby-D0O: posts big blind 150
*** HOLE CARDS ***
Dealt to JJin91 [Ah 2h]
TheBulldawgg: folds=20
OceansO7: folds=20
BUGG136: raises 300 to 450
SapofPine: folds=20
alcode422: folds=20
JJin91: calls 450
Booson11 has timed out while disconnected
Booson11: folds=20
Booson11 is sitting out
Scooby-D0O: folds=20
*** FLOP *** [9d Kd Qh]
BUGG136: bets 643
JJin91: folds=20
Uncalled bet (643) returned to BUGG136
BUGG136 collected 1285 from pot
*** SUMMARY ***
Total pot 1285 | Rake 0=20
Board [9d Kd Qh]
Seat 1: Scooby-D0O (big blind) folded before Flop
Seat 2: TheBulldawgg folded before Flop (didn't bet)
Seat 3: OceansO7 folded before Flop (didn't bet)
Seat 4: BUGG136 collected (1285)
Seat 5: SapofPine folded before Flop (didn't bet)
Seat 6: alcode422 folded before Flop (didn't bet)
Seat 7: JJin91 (button) folded on the Flop
Seat 8: Booson11 (small blind) folded before Flop


*********** # 44 **************
PokerStars Hand #172138038106: Tournament #1648990476, $18.20+$1.80 USD=
 Hold'em No Limit - Level VI (75/150) - 2017/07/06 20:01:58 ET
Table '1648990476 2' 9-max Seat #8 is the button
Seat 1: Scooby-D0O (23727 in chips)=20
Seat 2: TheBulldawgg (9980 in chips)=20
Seat 3: OceansO7 (1334 in chips)=20
Seat 4: BUGG136 (8470 in chips)=20
Seat 5: SapofPine (8000 in chips)=20
Seat 6: alcode422 (27923 in chips)=20
Seat 7: JJin91 (24872 in chips)=20
Seat 8: Booson11 (8852 in chips) is sitting out
Scooby-D0O: posts the ante 20
TheBulldawgg: posts the ante 20
OceansO7: posts the ante 20
BUGG136: posts the ante 20
SapofPine: posts the ante 20
alcode422: posts the ante 20
JJin91: posts the ante 20
Booson11: posts the ante 20
Scooby-D0O: posts small blind 75
TheBulldawgg: posts big blind 150
*** HOLE CARDS ***
Dealt to JJin91 [5h 3c]
OceansO7: folds=20
BUGG136: folds=20
SapofPine: folds=20
alcode422: calls 150
JJin91: folds=20
Booson11: folds=20
Scooby-D0O: calls 75
TheBulldawgg: checks=20
*** FLOP *** [Kh 4c 8d]
Scooby-D0O: checks=20
TheBulldawgg: checks=20
alcode422: bets 600
Scooby-D0O: folds=20
TheBulldawgg: folds=20
Uncalled bet (600) returned to alcode422
alcode422 collected 610 from pot
alcode422: doesn't show hand=20
*** SUMMARY ***
Total pot 610 | Rake 0=20
Board [Kh 4c 8d]
Seat 1: Scooby-D0O (small blind) folded on the Flop
Seat 2: TheBulldawgg (big blind) folded on the Flop
Seat 3: OceansO7 folded before Flop (didn't bet)
Seat 4: BUGG136 folded before Flop (didn't bet)
Seat 5: SapofPine folded before Flop (didn't bet)
Seat 6: alcode422 collected (610)
Seat 7: JJin91 folded before Flop (didn't bet)
Seat 8: Booson11 (button) folded before Flop (didn't bet)


*********** # 45 **************
PokerStars Hand #172138038275: Tournament #1648990476, $18.20+$1.80 USD=
 Hold'em No Limit - Level VI (75/150) - 2017/07/06 20:02:43 ET
Table '1648990476 2' 9-max Seat #1 is the button
Seat 1: Scooby-D0O (23557 in chips)=20
Seat 2: TheBulldawgg (9810 in chips)=20
Seat 3: OceansO7 (1314 in chips)=20
Seat 4: BUGG136 (8450 in chips)=20
Seat 5: SapofPine (7980 in chips)=20
Seat 6: alcode422 (28363 in chips)=20
Seat 7: JJin91 (24852 in chips)=20
Seat 8: Booson11 (8832 in chips) is sitting out
Scooby-D0O: posts the ante 20
TheBulldawgg: posts the ante 20
OceansO7: posts the ante 20
BUGG136: posts the ante 20
SapofPine: posts the ante 20
alcode422: posts the ante 20
JJin91: posts the ante 20
Booson11: posts the ante 20
TheBulldawgg: posts small blind 75
OceansO7: posts big blind 150
*** HOLE CARDS ***
Dealt to JJin91 [4h 5d]
BUGG136: folds=20
SapofPine: folds=20
alcode422: folds=20
JJin91: folds=20
Booson11: folds=20
Scooby-D0O: raises 225 to 375
Booson11 has returned
TheBulldawgg: folds=20
OceansO7: raises 919 to 1294 and is all-in
Scooby-D0O: calls 919
*** FLOP *** [Jd 5c 6s]
*** TURN *** [Jd 5c 6s] [Kh]
*** RIVER *** [Jd 5c 6s Kh] [Jh]
*** SHOW DOWN ***
OceansO7: shows [3d Kc] (two pair, Kings and Jacks)
Scooby-D0O: shows [9d 9h] (two pair, Jacks and Nines)
OceansO7 collected 2823 from pot
*** SUMMARY ***
Total pot 2823 | Rake 0=20
Board [Jd 5c 6s Kh Jh]
Seat 1: Scooby-D0O (button) showed [9d 9h] and lost with two pair, Jack=
s and Nines
Seat 2: TheBulldawgg (small blind) folded before Flop
Seat 3: OceansO7 (big blind) showed [3d Kc] and won (2823) with two pai=
r, Kings and Jacks
Seat 4: BUGG136 folded before Flop (didn't bet)
Seat 5: SapofPine folded before Flop (didn't bet)
Seat 6: alcode422 folded before Flop (didn't bet)
Seat 7: JJin91 folded before Flop (didn't bet)
Seat 8: Booson11 folded before Flop (didn't bet)


*********** # 46 **************
PokerStars Hand #172138038436: Tournament #1648990476, $18.20+$1.80 USD=
 Hold'em No Limit - Level VI (75/150) - 2017/07/06 20:03:20 ET
Table '1648990476 2' 9-max Seat #2 is the button
Seat 1: Scooby-D0O (22243 in chips)=20
Seat 2: TheBulldawgg (9715 in chips)=20
Seat 3: OceansO7 (2823 in chips)=20
Seat 4: BUGG136 (8430 in chips)=20
Seat 5: SapofPine (7960 in chips)=20
Seat 6: alcode422 (28343 in chips)=20
Seat 7: JJin91 (24832 in chips)=20
Seat 8: Booson11 (8812 in chips)=20
Scooby-D0O: posts the ante 20
TheBulldawgg: posts the ante 20
OceansO7: posts the ante 20
BUGG136: posts the ante 20
SapofPine: posts the ante 20
alcode422: posts the ante 20
JJin91: posts the ante 20
Booson11: posts the ante 20
OceansO7: posts small blind 75
BUGG136: posts big blind 150
*** HOLE CARDS ***
Dealt to JJin91 [Kc 8h]
SapofPine: raises 223 to 373
alcode422: calls 373
JJin91: folds=20
Booson11: calls 373
Scooby-D0O: folds=20
TheBulldawgg: folds=20
OceansO7: folds=20
BUGG136: folds=20
*** FLOP *** [3s 2s Ad]
SapofPine: checks=20
alcode422: checks=20
Booson11: bets 750
SapofPine: calls 750
alcode422: folds=20
*** TURN *** [3s 2s Ad] [7c]
SapofPine: checks=20
Booson11: checks=20
*** RIVER *** [3s 2s Ad 7c] [Jd]
SapofPine: checks=20
Booson11: checks=20
*** SHOW DOWN ***
SapofPine: shows [5h 5d] (a pair of Fives)
Booson11: shows [Ac 6c] (a pair of Aces)
Booson11 collected 3004 from pot
*** SUMMARY ***
Total pot 3004 | Rake 0=20
Board [3s 2s Ad 7c Jd]
Seat 1: Scooby-D0O folded before Flop (didn't bet)
Seat 2: TheBulldawgg (button) folded before Flop (didn't bet)
Seat 3: OceansO7 (small blind) folded before Flop
Seat 4: BUGG136 (big blind) folded before Flop
Seat 5: SapofPine showed [5h 5d] and lost with a pair of Fives
Seat 6: alcode422 folded on the Flop
Seat 7: JJin91 folded before Flop (didn't bet)
Seat 8: Booson11 showed [Ac 6c] and won (3004) with a pair of Aces


*********** # 47 **************
PokerStars Hand #172138038800: Tournament #1648990476, $18.20+$1.80 USD=
 Hold'em No Limit - Level VI (75/150) - 2017/07/06 20:04:44 ET
Table '1648990476 2' 9-max Seat #3 is the button
Seat 2: TheBulldawgg (9695 in chips)=20
Seat 3: OceansO7 (2728 in chips)=20
Seat 4: BUGG136 (8260 in chips)=20
Seat 5: SapofPine (6817 in chips)=20
Seat 6: alcode422 (27950 in chips)=20
Seat 7: JJin91 (24812 in chips)=20
Seat 8: Booson11 (10673 in chips)=20
Seat 9: jsulzman (10000 in chips)=20
TheBulldawgg: posts the ante 20
OceansO7: posts the ante 20
BUGG136: posts the ante 20
SapofPine: posts the ante 20
alcode422: posts the ante 20
JJin91: posts the ante 20
Booson11: posts the ante 20
jsulzman: posts the ante 20
BUGG136: posts small blind 75
SapofPine: posts big blind 150
*** HOLE CARDS ***
Dealt to JJin91 [7h Qc]
alcode422: calls 150
JJin91: folds=20
Booson11: calls 150
jsulzman: calls 150
TheBulldawgg: folds=20
OceansO7: folds=20
BUGG136: raises 910 to 1060
SapofPine: calls 910
alcode422: calls 910
Booson11: calls 910
jsulzman: calls 910
*** FLOP *** [Td 3h Qd]
BUGG136: checks=20
SapofPine: bets 5737 and is all-in
alcode422: folds=20
Booson11: folds=20
jsulzman: folds=20
BUGG136: folds=20
Uncalled bet (5737) returned to SapofPine
SapofPine collected 5460 from pot
*** SUMMARY ***
Total pot 5460 | Rake 0=20
Board [Td 3h Qd]
Seat 2: TheBulldawgg folded before Flop (didn't bet)
Seat 3: OceansO7 (button) folded before Flop (didn't bet)
Seat 4: BUGG136 (small blind) folded on the Flop
Seat 5: SapofPine (big blind) collected (5460)
Seat 6: alcode422 folded on the Flop
Seat 7: JJin91 folded before Flop (didn't bet)
Seat 8: Booson11 folded on the Flop
Seat 9: jsulzman folded on the Flop


*********** # 48 **************
PokerStars Hand #172138039116: Tournament #1648990476, $18.20+$1.80 USD=
 Hold'em No Limit - Level VII (100/200) - 2017/07/06 20:06:10 ET
Table '1648990476 2' 9-max Seat #4 is the button
Seat 1: LankySwag (10000 in chips)=20
Seat 2: TheBulldawgg (9675 in chips)=20
Seat 3: OceansO7 (2708 in chips)=20
Seat 4: BUGG136 (7180 in chips)=20
Seat 5: SapofPine (11197 in chips)=20
Seat 6: alcode422 (26870 in chips)=20
Seat 7: JJin91 (24792 in chips)=20
Seat 8: Booson11 (9593 in chips)=20
Seat 9: jsulzman (8920 in chips)=20
LankySwag: posts the ante 25
TheBulldawgg: posts the ante 25
OceansO7: posts the ante 25
BUGG136: posts the ante 25
SapofPine: posts the ante 25
alcode422: posts the ante 25
JJin91: posts the ante 25
Booson11: posts the ante 25
jsulzman: posts the ante 25
SapofPine: posts small blind 100
alcode422: posts big blind 200
*** HOLE CARDS ***
Dealt to JJin91 [4d Qc]
JJin91: folds=20
Booson11: folds=20
jsulzman: raises 400 to 600
LankySwag: folds=20
TheBulldawgg: folds=20
OceansO7: folds=20
SapofPine said, "ty]"
BUGG136: folds=20
SapofPine: folds=20
alcode422: folds=20
Uncalled bet (400) returned to jsulzman
jsulzman collected 725 from pot
jsulzman: doesn't show hand=20
*** SUMMARY ***
Total pot 725 | Rake 0=20
Seat 1: LankySwag folded before Flop (didn't bet)
Seat 2: TheBulldawgg folded before Flop (didn't bet)
Seat 3: OceansO7 folded before Flop (didn't bet)
Seat 4: BUGG136 (button) folded before Flop (didn't bet)
Seat 5: SapofPine (small blind) folded before Flop
Seat 6: alcode422 (big blind) folded before Flop
Seat 7: JJin91 folded before Flop (didn't bet)
Seat 8: Booson11 folded before Flop (didn't bet)
Seat 9: jsulzman collected (725)


*********** # 49 **************
PokerStars Hand #172138039369: Tournament #1648990476, $18.20+$1.80 USD=
 Hold'em No Limit - Level VII (100/200) - 2017/07/06 20:07:12 ET
Table '1648990476 7' 9-max Seat #1 is the button
Seat 1: lrb1024 (7212 in chips)=20
Seat 2: JJin91 (24767 in chips)=20
Seat 3: E9Polarizer (9725 in chips)=20
Seat 4: RandyVas (9975 in chips)=20
Seat 5: GiantGeniu$ (9935 in chips)=20
lrb1024: posts the ante 25
JJin91: posts the ante 25
E9Polarizer: posts the ante 25
RandyVas: posts the ante 25
GiantGeniu$: posts the ante 25
JJin91: posts small blind 100
E9Polarizer: posts big blind 200
*** HOLE CARDS ***
Dealt to JJin91 [3s 3c]
RandyVas: raises 200 to 400
GiantGeniu$: folds=20
lrb1024: folds=20
JJin91: calls 300
E9Polarizer: calls 200
*** FLOP *** [8d 5s Kh]
JJin91: checks=20
E9Polarizer: checks=20
RandyVas: bets 663
JJin91: calls 663
E9Polarizer: folds=20
*** TURN *** [8d 5s Kh] [9c]
JJin91: checks=20
RandyVas: bets 1326
JJin91: folds=20
Uncalled bet (1326) returned to RandyVas
RandyVas collected 2651 from pot
RandyVas: doesn't show hand=20
*** SUMMARY ***
Total pot 2651 | Rake 0=20
Board [8d 5s Kh 9c]
Seat 1: lrb1024 (button) folded before Flop (didn't bet)
Seat 2: JJin91 (small blind) folded on the Turn
Seat 3: E9Polarizer (big blind) folded on the Flop
Seat 4: RandyVas collected (2651)
Seat 5: GiantGeniu$ folded before Flop (didn't bet)


*********** # 50 **************
PokerStars Hand #172138039698: Tournament #1648990476, $18.20+$1.80 USD=
 Hold'em No Limit - Level VII (100/200) - 2017/07/06 20:08:30 ET
Table '1648990476 7' 9-max Seat #2 is the button
Seat 1: lrb1024 (7187 in chips)=20
Seat 2: JJin91 (23679 in chips)=20
Seat 3: E9Polarizer (9300 in chips)=20
Seat 4: RandyVas (11538 in chips)=20
Seat 5: GiantGeniu$ (9910 in chips)=20
Seat 6: TheBulldawgg (12175 in chips)=20
Seat 7: JJ2MG72 (19741 in chips)=20
lrb1024: posts the ante 25
JJin91: posts the ante 25
E9Polarizer: posts the ante 25
RandyVas: posts the ante 25
GiantGeniu$: posts the ante 25
TheBulldawgg: posts the ante 25
JJ2MG72: posts the ante 25
E9Polarizer: posts small blind 100
RandyVas: posts big blind 200
*** HOLE CARDS ***
Dealt to JJin91 [Jh 5d]
GiantGeniu$: folds=20
TheBulldawgg: folds=20
JJ2MG72: folds=20
lrb1024: folds=20
JJin91: folds=20
E9Polarizer: raises 300 to 500
RandyVas: folds=20
Uncalled bet (300) returned to E9Polarizer
E9Polarizer collected 575 from pot
E9Polarizer: doesn't show hand=20
*** SUMMARY ***
Total pot 575 | Rake 0=20
Seat 1: lrb1024 folded before Flop (didn't bet)
Seat 2: JJin91 (button) folded before Flop (didn't bet)
Seat 3: E9Polarizer (small blind) collected (575)
Seat 4: RandyVas (big blind) folded before Flop
Seat 5: GiantGeniu$ folded before Flop (didn't bet)
Seat 6: TheBulldawgg folded before Flop (didn't bet)
Seat 7: JJ2MG72 folded before Flop (didn't bet)


*********** # 51 **************
PokerStars Hand #172138039860: Tournament #1648990476, $18.20+$1.80 USD=
 Hold'em No Limit - Level VII (100/200) - 2017/07/06 20:09:05 ET
Table '1648990476 7' 9-max Seat #3 is the button
Seat 1: lrb1024 (7162 in chips)=20
Seat 2: JJin91 (23654 in chips)=20
Seat 3: E9Polarizer (9650 in chips)=20
Seat 4: RandyVas (11313 in chips)=20
Seat 5: GiantGeniu$ (9885 in chips)=20
Seat 6: TheBulldawgg (12150 in chips)=20
Seat 7: JJ2MG72 (19716 in chips)=20
lrb1024: posts the ante 25
JJin91: posts the ante 25
E9Polarizer: posts the ante 25
RandyVas: posts the ante 25
GiantGeniu$: posts the ante 25
TheBulldawgg: posts the ante 25
JJ2MG72: posts the ante 25
RandyVas: posts small blind 100
GiantGeniu$: posts big blind 200
*** HOLE CARDS ***
Dealt to JJin91 [Kd 3s]
TheBulldawgg: folds=20
JJ2MG72: folds=20
lrb1024: folds=20
JJin91: raises 222 to 422
E9Polarizer: folds=20
RandyVas: folds=20
GiantGeniu$: folds=20
Uncalled bet (222) returned to JJin91
JJin91 collected 675 from pot
JJin91: doesn't show hand=20
*** SUMMARY ***
Total pot 675 | Rake 0=20
Seat 1: lrb1024 folded before Flop (didn't bet)
Seat 2: JJin91 collected (675)
Seat 3: E9Polarizer (button) folded before Flop (didn't bet)
Seat 4: RandyVas (small blind) folded before Flop
Seat 5: GiantGeniu$ (big blind) folded before Flop
Seat 6: TheBulldawgg folded before Flop (didn't bet)
Seat 7: JJ2MG72 folded before Flop (didn't bet)


*********** # 52 **************
PokerStars Hand #172141068008: Tournament #1648990476, $18.20+$1.80 USD=
 Hold'em No Limit - Level VII (100/200) - 2017/07/06 20:09:39 ET
Table '1648990476 7' 9-max Seat #4 is the button
Seat 1: lrb1024 (7137 in chips)=20
Seat 2: JJin91 (24104 in chips)=20
Seat 3: E9Polarizer (9625 in chips)=20
Seat 4: RandyVas (11188 in chips)=20
Seat 5: GiantGeniu$ (9660 in chips)=20
Seat 6: TheBulldawgg (12125 in chips)=20
Seat 7: JJ2MG72 (19691 in chips)=20
lrb1024: posts the ante 25
JJin91: posts the ante 25
E9Polarizer: posts the ante 25
RandyVas: posts the ante 25
GiantGeniu$: posts the ante 25
TheBulldawgg: posts the ante 25
JJ2MG72: posts the ante 25
GiantGeniu$: posts small blind 100
TheBulldawgg: posts big blind 200
*** HOLE CARDS ***
Dealt to JJin91 [As 9c]
JJ2MG72: folds=20
lrb1024: folds=20
JJin91: raises 222 to 422
E9Polarizer: folds=20
RandyVas: raises 378 to 800
GiantGeniu$: folds=20
TheBulldawgg: folds=20
JJin91: calls 378
*** FLOP *** [Jd Kc Td]
JJin91: checks=20
RandyVas: checks=20
*** TURN *** [Jd Kc Td] [Jc]
JJin91: bets 1017
RandyVas: calls 1017
*** RIVER *** [Jd Kc Td Jc] [2s]
JJin91: bets 2262
RandyVas: calls 2262
*** SHOW DOWN ***
JJin91: shows [As 9c] (a pair of Jacks)
RandyVas: shows [Ad Ac] (two pair, Aces and Jacks)
RandyVas collected 8633 from pot
*** SUMMARY ***
Total pot 8633 | Rake 0=20
Board [Jd Kc Td Jc 2s]
Seat 1: lrb1024 folded before Flop (didn't bet)
Seat 2: JJin91 showed [As 9c] and lost with a pair of Jacks
Seat 3: E9Polarizer folded before Flop (didn't bet)
Seat 4: RandyVas (button) showed [Ad Ac] and won (8633) with two pair, =
Aces and Jacks
Seat 5: GiantGeniu$ (small blind) folded before Flop
Seat 6: TheBulldawgg (big blind) folded before Flop
Seat 7: JJ2MG72 folded before Flop (didn't bet)


*********** # 53 **************
PokerStars Hand #172141068311: Tournament #1648990476, $18.20+$1.80 USD=
 Hold'em No Limit - Level VII (100/200) - 2017/07/06 20:10:50 ET
Table '1648990476 7' 9-max Seat #5 is the button
Seat 1: lrb1024 (7112 in chips)=20
Seat 2: JJin91 (20000 in chips)=20
Seat 3: E9Polarizer (9600 in chips)=20
Seat 4: RandyVas (15717 in chips)=20
Seat 5: GiantGeniu$ (9535 in chips)=20
Seat 6: TheBulldawgg (11900 in chips)=20
Seat 7: JJ2MG72 (19666 in chips)=20
Seat 8: slachoooo (10000 in chips)=20
lrb1024: posts the ante 25
JJin91: posts the ante 25
E9Polarizer: posts the ante 25
RandyVas: posts the ante 25
GiantGeniu$: posts the ante 25
TheBulldawgg: posts the ante 25
JJ2MG72: posts the ante 25
slachoooo: posts the ante 25
TheBulldawgg: posts small blind 100
JJ2MG72: posts big blind 200
*** HOLE CARDS ***
Dealt to JJin91 [7s 9h]
slachoooo: folds=20
lrb1024: folds=20
JJin91: folds=20
E9Polarizer: folds=20
RandyVas: calls 200
GiantGeniu$: folds=20
TheBulldawgg: calls 100
JJ2MG72: raises 800 to 1000
RandyVas: folds=20
TheBulldawgg: folds=20
Uncalled bet (800) returned to JJ2MG72
JJ2MG72 collected 800 from pot
JJ2MG72: doesn't show hand=20
*** SUMMARY ***
Total pot 800 | Rake 0=20
Seat 1: lrb1024 folded before Flop (didn't bet)
Seat 2: JJin91 folded before Flop (didn't bet)
Seat 3: E9Polarizer folded before Flop (didn't bet)
Seat 4: RandyVas folded before Flop
Seat 5: GiantGeniu$ (button) folded before Flop (didn't bet)
Seat 6: TheBulldawgg (small blind) folded before Flop
Seat 7: JJ2MG72 (big blind) collected (800)
Seat 8: slachoooo folded before Flop (didn't bet)


*********** # 54 **************
PokerStars Hand #172141068436: Tournament #1648990476, $18.20+$1.80 USD=
 Hold'em No Limit - Level VII (100/200) - 2017/07/06 20:11:19 ET
Table '1648990476 7' 9-max Seat #6 is the button
Seat 1: lrb1024 (7087 in chips)=20
Seat 2: JJin91 (19975 in chips)=20
Seat 3: E9Polarizer (9575 in chips)=20
Seat 4: RandyVas (15492 in chips)=20
Seat 5: GiantGeniu$ (9510 in chips)=20
Seat 6: TheBulldawgg (11675 in chips)=20
Seat 7: JJ2MG72 (20241 in chips)=20
Seat 8: slachoooo (9975 in chips)=20
lrb1024: posts the ante 25
JJin91: posts the ante 25
E9Polarizer: posts the ante 25
RandyVas: posts the ante 25
GiantGeniu$: posts the ante 25
TheBulldawgg: posts the ante 25
JJ2MG72: posts the ante 25
slachoooo: posts the ante 25
JJ2MG72: posts small blind 100
slachoooo: posts big blind 200
*** HOLE CARDS ***
Dealt to JJin91 [Jc 5s]
lrb1024: folds=20
JJin91: folds=20
E9Polarizer: folds=20
RandyVas: raises 200 to 400
GiantGeniu$: folds=20
TheBulldawgg: folds=20
JJ2MG72: calls 300
slachoooo: calls 200
*** FLOP *** [Qs Qh 6s]
JJ2MG72: bets 600
slachoooo: folds=20
RandyVas: calls 600
*** TURN *** [Qs Qh 6s] [Ad]
JJ2MG72: checks=20
RandyVas: checks=20
*** RIVER *** [Qs Qh 6s Ad] [2c]
JJ2MG72: bets 1300
RandyVas: calls 1300
*** SHOW DOWN ***
JJ2MG72: shows [Qc 8d] (three of a kind, Queens)
RandyVas: mucks hand=20
JJ2MG72 collected 5200 from pot
*** SUMMARY ***
Total pot 5200 | Rake 0=20
Board [Qs Qh 6s Ad 2c]
Seat 1: lrb1024 folded before Flop (didn't bet)
Seat 2: JJin91 folded before Flop (didn't bet)
Seat 3: E9Polarizer folded before Flop (didn't bet)
Seat 4: RandyVas mucked [Ah Ts]
Seat 5: GiantGeniu$ folded before Flop (didn't bet)
Seat 6: TheBulldawgg (button) folded before Flop (didn't bet)
Seat 7: JJ2MG72 (small blind) showed [Qc 8d] and won (5200) with three =
of a kind, Queens
Seat 8: slachoooo (big blind) folded on the Flop


*********** # 55 **************
PokerStars Hand #172141068773: Tournament #1648990476, $18.20+$1.80 USD=
 Hold'em No Limit - Level VII (100/200) - 2017/07/06 20:12:34 ET
Table '1648990476 7' 9-max Seat #7 is the button
Seat 1: lrb1024 (7062 in chips)=20
Seat 2: JJin91 (19950 in chips)=20
Seat 3: E9Polarizer (9550 in chips)=20
Seat 4: RandyVas (13167 in chips)=20
Seat 5: GiantGeniu$ (9485 in chips)=20
Seat 6: TheBulldawgg (11650 in chips)=20
Seat 7: JJ2MG72 (23116 in chips)=20
Seat 8: slachoooo (9550 in chips)=20
lrb1024: posts the ante 25
JJin91: posts the ante 25
E9Polarizer: posts the ante 25
RandyVas: posts the ante 25
GiantGeniu$: posts the ante 25
TheBulldawgg: posts the ante 25
JJ2MG72: posts the ante 25
slachoooo: posts the ante 25
slachoooo: posts small blind 100
lrb1024: posts big blind 200
*** HOLE CARDS ***
Dealt to JJin91 [9s 4d]
JJin91: folds=20
E9Polarizer: folds=20
RandyVas: folds=20
GiantGeniu$: folds=20
TheBulldawgg: folds=20
JJ2MG72: folds=20
slachoooo: raises 400 to 600
lrb1024: calls 400
*** FLOP *** [5d 3h Qd]
slachoooo: bets 868
lrb1024: raises 868 to 1736
slachoooo: folds=20
Uncalled bet (868) returned to lrb1024
lrb1024 collected 3136 from pot
lrb1024: doesn't show hand=20
*** SUMMARY ***
Total pot 3136 | Rake 0=20
Board [5d 3h Qd]
Seat 1: lrb1024 (big blind) collected (3136)
Seat 2: JJin91 folded before Flop (didn't bet)
Seat 3: E9Polarizer folded before Flop (didn't bet)
Seat 4: RandyVas folded before Flop (didn't bet)
Seat 5: GiantGeniu$ folded before Flop (didn't bet)
Seat 6: TheBulldawgg folded before Flop (didn't bet)
Seat 7: JJ2MG72 (button) folded before Flop (didn't bet)
Seat 8: slachoooo (small blind) folded on the Flop


*********** # 56 **************
PokerStars Hand #172141068975: Tournament #1648990476, $18.20+$1.80 USD=
 Hold'em No Limit - Level VII (100/200) - 2017/07/06 20:13:21 ET
Table '1648990476 7' 9-max Seat #8 is the button
Seat 1: lrb1024 (8705 in chips)=20
Seat 2: JJin91 (19925 in chips)=20
Seat 3: E9Polarizer (9525 in chips)=20
Seat 4: RandyVas (13142 in chips)=20
Seat 5: GiantGeniu$ (9460 in chips)=20
Seat 6: TheBulldawgg (11625 in chips)=20
Seat 7: JJ2MG72 (23091 in chips)=20
Seat 8: slachoooo (8057 in chips)=20
lrb1024: posts the ante 25
JJin91: posts the ante 25
E9Polarizer: posts the ante 25
RandyVas: posts the ante 25
GiantGeniu$: posts the ante 25
TheBulldawgg: posts the ante 25
JJ2MG72: posts the ante 25
slachoooo: posts the ante 25
lrb1024: posts small blind 100
JJin91: posts big blind 200
*** HOLE CARDS ***
Dealt to JJin91 [8c 2d]
E9Polarizer: folds=20
RandyVas: folds=20
GiantGeniu$: folds=20
TheBulldawgg: folds=20
JJ2MG72: folds=20
slachoooo: folds=20
lrb1024: calls 100
JJin91: checks=20
*** FLOP *** [Js Th Kd]
lrb1024: bets 200
JJin91: folds=20
Uncalled bet (200) returned to lrb1024
lrb1024 collected 600 from pot
lrb1024: doesn't show hand=20
*** SUMMARY ***
Total pot 600 | Rake 0=20
Board [Js Th Kd]
Seat 1: lrb1024 (small blind) collected (600)
Seat 2: JJin91 (big blind) folded on the Flop
Seat 3: E9Polarizer folded before Flop (didn't bet)
Seat 4: RandyVas folded before Flop (didn't bet)
Seat 5: GiantGeniu$ folded before Flop (didn't bet)
Seat 6: TheBulldawgg folded before Flop (didn't bet)
Seat 7: JJ2MG72 folded before Flop (didn't bet)
Seat 8: slachoooo (button) folded before Flop (didn't bet)


*********** # 57 **************
PokerStars Hand #172141069111: Tournament #1648990476, $18.20+$1.80 USD=
 Hold'em No Limit - Level VII (100/200) - 2017/07/06 20:13:53 ET
Table '1648990476 7' 9-max Seat #1 is the button
Seat 1: lrb1024 (9080 in chips)=20
Seat 2: JJin91 (19700 in chips)=20
Seat 3: E9Polarizer (9500 in chips)=20
Seat 4: RandyVas (13117 in chips)=20
Seat 5: GiantGeniu$ (9435 in chips)=20
Seat 6: TheBulldawgg (11600 in chips)=20
Seat 7: JJ2MG72 (23066 in chips)=20
Seat 8: slachoooo (8032 in chips)=20
lrb1024: posts the ante 25
JJin91: posts the ante 25
E9Polarizer: posts the ante 25
RandyVas: posts the ante 25
GiantGeniu$: posts the ante 25
TheBulldawgg: posts the ante 25
JJ2MG72: posts the ante 25
slachoooo: posts the ante 25
JJin91: posts small blind 100
E9Polarizer: posts big blind 200
*** HOLE CARDS ***
Dealt to JJin91 [5s Th]
RandyVas: folds=20
GiantGeniu$: folds=20
TheBulldawgg: folds=20
JJ2MG72: calls 200
slachoooo: folds=20
lrb1024: calls 200
JJin91: folds=20
E9Polarizer: checks=20
*** FLOP *** [Ac Ks 4h]
E9Polarizer: checks=20
JJ2MG72: checks=20
lrb1024: checks=20
*** TURN *** [Ac Ks 4h] [2h]
E9Polarizer: checks=20
JJ2MG72: checks=20
lrb1024: bets 200
E9Polarizer: folds=20
JJ2MG72: calls 200
*** RIVER *** [Ac Ks 4h 2h] [Td]
JJ2MG72: checks=20
lrb1024: bets 1000
JJ2MG72: folds=20
Uncalled bet (1000) returned to lrb1024
lrb1024 collected 1300 from pot
lrb1024: doesn't show hand=20
*** SUMMARY ***
Total pot 1300 | Rake 0=20
Board [Ac Ks 4h 2h Td]
Seat 1: lrb1024 (button) collected (1300)
Seat 2: JJin91 (small blind) folded before Flop
Seat 3: E9Polarizer (big blind) folded on the Turn
Seat 4: RandyVas folded before Flop (didn't bet)
Seat 5: GiantGeniu$ folded before Flop (didn't bet)
Seat 6: TheBulldawgg folded before Flop (didn't bet)
Seat 7: JJ2MG72 folded on the River
Seat 8: slachoooo folded before Flop (didn't bet)


*********** # 58 **************
PokerStars Hand #172141069523: Tournament #1648990476, $18.20+$1.80 USD=
 Hold'em No Limit - Level VII (100/200) - 2017/07/06 20:15:23 ET
Table '1648990476 7' 9-max Seat #2 is the button
Seat 1: lrb1024 (9955 in chips)=20
Seat 2: JJin91 (19575 in chips)=20
Seat 3: E9Polarizer (9275 in chips)=20
Seat 4: RandyVas (13092 in chips)=20
Seat 5: GiantGeniu$ (9410 in chips)=20
Seat 6: TheBulldawgg (11575 in chips)=20
Seat 7: JJ2MG72 (22641 in chips)=20
Seat 8: slachoooo (8007 in chips)=20
lrb1024: posts the ante 25
JJin91: posts the ante 25
E9Polarizer: posts the ante 25
RandyVas: posts the ante 25
GiantGeniu$: posts the ante 25
TheBulldawgg: posts the ante 25
JJ2MG72: posts the ante 25
slachoooo: posts the ante 25
E9Polarizer: posts small blind 100
RandyVas: posts big blind 200
*** HOLE CARDS ***
Dealt to JJin91 [4c 5d]
GiantGeniu$: folds=20
TheBulldawgg: raises 300 to 500
JJ2MG72: calls 500
slachoooo: folds=20
lrb1024: folds=20
JJin91: folds=20
E9Polarizer: folds=20
RandyVas: calls 300
*** FLOP *** [Kd Qh Ad]
RandyVas: checks=20
TheBulldawgg: bets 800
JJ2MG72: folds=20
RandyVas: calls 800
*** TURN *** [Kd Qh Ad] [Ah]
RandyVas: checks=20
TheBulldawgg: checks=20
*** RIVER *** [Kd Qh Ad Ah] [Ac]
RandyVas: checks=20
TheBulldawgg: bets 2400
RandyVas: calls 2400
*** SHOW DOWN ***
TheBulldawgg: shows [Jh Jd] (a full house, Aces full of Jacks)
RandyVas: shows [Qs Kc] (a full house, Aces full of Kings)
RandyVas collected 8200 from pot
*** SUMMARY ***
Total pot 8200 | Rake 0=20
Board [Kd Qh Ad Ah Ac]
Seat 1: lrb1024 folded before Flop (didn't bet)
Seat 2: JJin91 (button) folded before Flop (didn't bet)
Seat 3: E9Polarizer (small blind) folded before Flop
Seat 4: RandyVas (big blind) showed [Qs Kc] and won (8200) with a full =
house, Aces full of Kings
Seat 5: GiantGeniu$ folded before Flop (didn't bet)
Seat 6: TheBulldawgg showed [Jh Jd] and lost with a full house, Aces fu=
ll of Jacks
Seat 7: JJ2MG72 folded on the Flop
Seat 8: slachoooo folded before Flop (didn't bet)


*********** # 59 **************
PokerStars Hand #172141069938: Tournament #1648990476, $18.20+$1.80 USD=
 Hold'em No Limit - Level VIII (125/250) - 2017/07/06 20:16:57 ET
Table '1648990476 7' 9-max Seat #3 is the button
Seat 1: lrb1024 (9930 in chips)=20
Seat 2: JJin91 (19550 in chips)=20
Seat 3: E9Polarizer (9150 in chips)=20
Seat 4: RandyVas (17567 in chips)=20
Seat 5: GiantGeniu$ (9385 in chips)=20
Seat 6: TheBulldawgg (7850 in chips)=20
Seat 7: JJ2MG72 (22116 in chips)=20
Seat 8: slachoooo (7982 in chips)=20
lrb1024: posts the ante 30
JJin91: posts the ante 30
E9Polarizer: posts the ante 30
RandyVas: posts the ante 30
GiantGeniu$: posts the ante 30
TheBulldawgg: posts the ante 30
JJ2MG72: posts the ante 30
slachoooo: posts the ante 30
RandyVas: posts small blind 125
GiantGeniu$: posts big blind 250
*** HOLE CARDS ***
Dealt to JJin91 [2c Td]
TheBulldawgg: folds=20
JJ2MG72: raises 250 to 500
slachoooo: folds=20
lrb1024: folds=20
JJin91: folds=20
E9Polarizer: folds=20
RandyVas: folds=20
GiantGeniu$: calls 250
*** FLOP *** [9c Th 4d]
GiantGeniu$: checks=20
JJ2MG72: checks=20
*** TURN *** [9c Th 4d] [As]
GiantGeniu$: checks=20
JJ2MG72: bets 250
GiantGeniu$: calls 250
*** RIVER *** [9c Th 4d As] [7s]
GiantGeniu$: checks=20
JJ2MG72: checks=20
*** SHOW DOWN ***
GiantGeniu$: shows [Kc Jc] (high card Ace)
JJ2MG72: shows [Ah 6s] (a pair of Aces)
JJ2MG72 collected 1865 from pot
*** SUMMARY ***
Total pot 1865 | Rake 0=20
Board [9c Th 4d As 7s]
Seat 1: lrb1024 folded before Flop (didn't bet)
Seat 2: JJin91 folded before Flop (didn't bet)
Seat 3: E9Polarizer (button) folded before Flop (didn't bet)
Seat 4: RandyVas (small blind) folded before Flop
Seat 5: GiantGeniu$ (big blind) showed [Kc Jc] and lost with high card =
Ace
Seat 6: TheBulldawgg folded before Flop (didn't bet)
Seat 7: JJ2MG72 showed [Ah 6s] and won (1865) with a pair of Aces
Seat 8: slachoooo folded before Flop (didn't bet)


*********** # 60 **************
PokerStars Hand #172141659168: Tournament #1648990476, $18.20+$1.80 USD=
 Hold'em No Limit - Level VIII (125/250) - 2017/07/06 20:17:54 ET
Table '1648990476 7' 9-max Seat #4 is the button
Seat 1: lrb1024 (9900 in chips)=20
Seat 2: JJin91 (19520 in chips)=20
Seat 3: E9Polarizer (9120 in chips)=20
Seat 4: RandyVas (17412 in chips)=20
Seat 5: GiantGeniu$ (8605 in chips)=20
Seat 6: TheBulldawgg (7820 in chips)=20
Seat 7: JJ2MG72 (23201 in chips)=20
Seat 8: slachoooo (7952 in chips)=20
lrb1024: posts the ante 30
JJin91: posts the ante 30
E9Polarizer: posts the ante 30
RandyVas: posts the ante 30
GiantGeniu$: posts the ante 30
TheBulldawgg: posts the ante 30
JJ2MG72: posts the ante 30
slachoooo: posts the ante 30
GiantGeniu$: posts small blind 125
TheBulldawgg: posts big blind 250
*** HOLE CARDS ***
Dealt to JJin91 [9c Jc]
JJ2MG72: calls 250
slachoooo: folds=20
lrb1024: folds=20
JJin91: folds=20
E9Polarizer: folds=20
RandyVas: calls 250
GiantGeniu$: raises 8325 to 8575 and is all-in
TheBulldawgg: folds=20
JJ2MG72: folds=20
RandyVas: folds=20
Uncalled bet (8325) returned to GiantGeniu$
GiantGeniu$ collected 1240 from pot
GiantGeniu$: doesn't show hand=20
*** SUMMARY ***
Total pot 1240 | Rake 0=20
Seat 1: lrb1024 folded before Flop (didn't bet)
Seat 2: JJin91 folded before Flop (didn't bet)
Seat 3: E9Polarizer folded before Flop (didn't bet)
Seat 4: RandyVas (button) folded before Flop
Seat 5: GiantGeniu$ (small blind) collected (1240)
Seat 6: TheBulldawgg (big blind) folded before Flop
Seat 7: JJ2MG72 folded before Flop
Seat 8: slachoooo folded before Flop (didn't bet)


*********** # 61 **************
PokerStars Hand #172141659346: Tournament #1648990476, $18.20+$1.80 USD=
 Hold'em No Limit - Level VIII (125/250) - 2017/07/06 20:18:39 ET
Table '1648990476 7' 9-max Seat #5 is the button
Seat 1: lrb1024 (9870 in chips)=20
Seat 2: JJin91 (19490 in chips)=20
Seat 3: E9Polarizer (9090 in chips)=20
Seat 4: RandyVas (17132 in chips)=20
Seat 5: GiantGeniu$ (9565 in chips)=20
Seat 6: TheBulldawgg (7540 in chips)=20
Seat 7: JJ2MG72 (22921 in chips)=20
Seat 8: slachoooo (7922 in chips)=20
lrb1024: posts the ante 30
JJin91: posts the ante 30
E9Polarizer: posts the ante 30
RandyVas: posts the ante 30
GiantGeniu$: posts the ante 30
TheBulldawgg: posts the ante 30
JJ2MG72: posts the ante 30
slachoooo: posts the ante 30
TheBulldawgg: posts small blind 125
JJ2MG72: posts big blind 250
*** HOLE CARDS ***
Dealt to JJin91 [2c 5c]
slachoooo: folds=20
lrb1024 has timed out
lrb1024: folds=20
lrb1024 is sitting out
JJin91: folds=20
lrb1024 has returned
E9Polarizer: folds=20
RandyVas: folds=20
GiantGeniu$: folds=20
TheBulldawgg: folds=20
Uncalled bet (125) returned to JJ2MG72
JJ2MG72 collected 490 from pot
JJ2MG72: doesn't show hand=20
*** SUMMARY ***
Total pot 490 | Rake 0=20
Seat 1: lrb1024 folded before Flop (didn't bet)
Seat 2: JJin91 folded before Flop (didn't bet)
Seat 3: E9Polarizer folded before Flop (didn't bet)
Seat 4: RandyVas folded before Flop (didn't bet)
Seat 5: GiantGeniu$ (button) folded before Flop (didn't bet)
Seat 6: TheBulldawgg (small blind) folded before Flop
Seat 7: JJ2MG72 (big blind) collected (490)
Seat 8: slachoooo folded before Flop (didn't bet)


*********** # 62 **************
PokerStars Hand #172141659560: Tournament #1648990476, $18.20+$1.80 USD=
 Hold'em No Limit - Level VIII (125/250) - 2017/07/06 20:19:32 ET
Table '1648990476 7' 9-max Seat #6 is the button
Seat 1: lrb1024 (9840 in chips)=20
Seat 2: JJin91 (19460 in chips)=20
Seat 3: E9Polarizer (9060 in chips)=20
Seat 4: RandyVas (17102 in chips)=20
Seat 5: GiantGeniu$ (9535 in chips)=20
Seat 6: TheBulldawgg (7385 in chips)=20
Seat 7: JJ2MG72 (23256 in chips)=20
Seat 9: harvgrizz (10000 in chips)=20
lrb1024: posts the ante 30
JJin91: posts the ante 30
E9Polarizer: posts the ante 30
RandyVas: posts the ante 30
GiantGeniu$: posts the ante 30
TheBulldawgg: posts the ante 30
JJ2MG72: posts the ante 30
harvgrizz: posts the ante 30
JJ2MG72: posts small blind 125
harvgrizz: posts big blind 250
*** HOLE CARDS ***
Dealt to JJin91 [Qd Ah]
lrb1024: folds=20
JJin91: raises 277 to 527
E9Polarizer: folds=20
RandyVas: folds=20
GiantGeniu$: folds=20
TheBulldawgg: folds=20
JJ2MG72: folds=20
harvgrizz: calls 277
*** FLOP *** [9s Td 5h]
harvgrizz: checks=20
JJin91: bets 468
harvgrizz: folds=20
Uncalled bet (468) returned to JJin91
JJin91 collected 1419 from pot
JJin91: doesn't show hand=20
*** SUMMARY ***
Total pot 1419 | Rake 0=20
Board [9s Td 5h]
Seat 1: lrb1024 folded before Flop (didn't bet)
Seat 2: JJin91 collected (1419)
Seat 3: E9Polarizer folded before Flop (didn't bet)
Seat 4: RandyVas folded before Flop (didn't bet)
Seat 5: GiantGeniu$ folded before Flop (didn't bet)
Seat 6: TheBulldawgg (button) folded before Flop (didn't bet)
Seat 7: JJ2MG72 (small blind) folded before Flop
Seat 9: harvgrizz (big blind) folded on the Flop


*********** # 63 **************
PokerStars Hand #172141659768: Tournament #1648990476, $18.20+$1.80 USD=
 Hold'em No Limit - Level VIII (125/250) - 2017/07/06 20:20:18 ET
Table '1648990476 7' 9-max Seat #7 is the button
Seat 1: lrb1024 (9810 in chips)=20
Seat 2: JJin91 (20322 in chips)=20
Seat 3: E9Polarizer (9030 in chips)=20
Seat 4: RandyVas (17072 in chips)=20
Seat 5: GiantGeniu$ (9505 in chips)=20
Seat 6: TheBulldawgg (7355 in chips)=20
Seat 7: JJ2MG72 (23101 in chips)=20
Seat 9: harvgrizz (9443 in chips)=20
lrb1024: posts the ante 30
JJin91: posts the ante 30
E9Polarizer: posts the ante 30
RandyVas: posts the ante 30
GiantGeniu$: posts the ante 30
TheBulldawgg: posts the ante 30
JJ2MG72: posts the ante 30
harvgrizz: posts the ante 30
harvgrizz: posts small blind 125
lrb1024: posts big blind 250
*** HOLE CARDS ***
Dealt to JJin91 [2h 9s]
JJin91: folds=20
E9Polarizer: folds=20
RandyVas: calls 250
GiantGeniu$: folds=20
TheBulldawgg: folds=20
JJ2MG72: folds=20
harvgrizz: folds=20
lrb1024: checks=20
*** FLOP *** [Qd Kh Kc]
lrb1024: checks=20
RandyVas: bets 250
lrb1024: calls 250
*** TURN *** [Qd Kh Kc] [8s]
lrb1024: checks=20
RandyVas: bets 250
lrb1024: calls 250
*** RIVER *** [Qd Kh Kc 8s] [5s]
lrb1024: checks=20
RandyVas: checks=20
*** SHOW DOWN ***
lrb1024: shows [Qc 7d] (two pair, Kings and Queens)
RandyVas: mucks hand=20
lrb1024 collected 1865 from pot
*** SUMMARY ***
Total pot 1865 | Rake 0=20
Board [Qd Kh Kc 8s 5s]
Seat 1: lrb1024 (big blind) showed [Qc 7d] and won (1865) with two pair=
, Kings and Queens
Seat 2: JJin91 folded before Flop (didn't bet)
Seat 3: E9Polarizer folded before Flop (didn't bet)
Seat 4: RandyVas mucked [Js Th]
Seat 5: GiantGeniu$ folded before Flop (didn't bet)
Seat 6: TheBulldawgg folded before Flop (didn't bet)
Seat 7: JJ2MG72 (button) folded before Flop (didn't bet)
Seat 9: harvgrizz (small blind) folded before Flop


*********** # 64 **************
PokerStars Hand #172141659954: Tournament #1648990476, $18.20+$1.80 USD=
 Hold'em No Limit - Level VIII (125/250) - 2017/07/06 20:21:00 ET
Table '1648990476 7' 9-max Seat #9 is the button
Seat 1: lrb1024 (10895 in chips)=20
Seat 2: JJin91 (20292 in chips)=20
Seat 3: E9Polarizer (9000 in chips)=20
Seat 4: RandyVas (16292 in chips)=20
Seat 5: GiantGeniu$ (9475 in chips)=20
Seat 6: TheBulldawgg (7325 in chips)=20
Seat 7: JJ2MG72 (23071 in chips)=20
Seat 9: harvgrizz (9288 in chips)=20
lrb1024: posts the ante 30
JJin91: posts the ante 30
E9Polarizer: posts the ante 30
RandyVas: posts the ante 30
GiantGeniu$: posts the ante 30
TheBulldawgg: posts the ante 30
JJ2MG72: posts the ante 30
harvgrizz: posts the ante 30
lrb1024: posts small blind 125
JJin91: posts big blind 250
*** HOLE CARDS ***
Dealt to JJin91 [2d 6c]
E9Polarizer: raises 375 to 625
RandyVas: calls 625
GiantGeniu$: folds=20
TheBulldawgg: calls 625
JJ2MG72: folds=20
harvgrizz: folds=20
lrb1024: calls 500
JJin91: folds=20
*** FLOP *** [4c 2c 3c]
lrb1024: checks=20
E9Polarizer: checks=20
RandyVas: checks=20
TheBulldawgg: checks=20
*** TURN *** [4c 2c 3c] [5h]
lrb1024: checks=20
E9Polarizer: checks=20
RandyVas: checks=20
TheBulldawgg: checks=20
*** RIVER *** [4c 2c 3c 5h] [Ks]
lrb1024: checks=20
E9Polarizer: bets 500
RandyVas: calls 500
TheBulldawgg: calls 500
lrb1024: folds=20
*** SHOW DOWN ***
E9Polarizer: shows [Js As] (a straight, Ace to Five)
RandyVas: shows [Ah Kc] (a straight, Ace to Five)
TheBulldawgg: mucks hand=20
E9Polarizer collected 2245 from pot
RandyVas collected 2245 from pot
*** SUMMARY ***
Total pot 4490 | Rake 0=20
Board [4c 2c 3c 5h Ks]
Seat 1: lrb1024 (small blind) folded on the River
Seat 2: JJin91 (big blind) folded before Flop
Seat 3: E9Polarizer showed [Js As] and won (2245) with a straight, Ace =
to Five
Seat 4: RandyVas showed [Ah Kc] and won (2245) with a straight, Ace to =
Five
Seat 5: GiantGeniu$ folded before Flop (didn't bet)
Seat 6: TheBulldawgg mucked [Qh Kh]
Seat 7: JJ2MG72 folded before Flop (didn't bet)
Seat 9: harvgrizz (button) folded before Flop (didn't bet)


*********** # 65 **************
PokerStars Hand #172141941069: Tournament #1648990476, $18.20+$1.80 USD=
 Hold'em No Limit - Level VIII (125/250) - 2017/07/06 20:22:43 ET
Table '1648990476 7' 9-max Seat #1 is the button
Seat 1: lrb1024 (10240 in chips)=20
Seat 2: JJin91 (20012 in chips)=20
Seat 3: E9Polarizer (10090 in chips)=20
Seat 4: RandyVas (17382 in chips)=20
Seat 5: GiantGeniu$ (9445 in chips)=20
Seat 6: TheBulldawgg (6170 in chips)=20
Seat 7: JJ2MG72 (23041 in chips)=20
Seat 9: harvgrizz (9258 in chips)=20
lrb1024: posts the ante 30
JJin91: posts the ante 30
E9Polarizer: posts the ante 30
RandyVas: posts the ante 30
GiantGeniu$: posts the ante 30
TheBulldawgg: posts the ante 30
JJ2MG72: posts the ante 30
harvgrizz: posts the ante 30
JJin91: posts small blind 125
E9Polarizer: posts big blind 250
*** HOLE CARDS ***
Dealt to JJin91 [3s Tc]
RandyVas: folds=20
GiantGeniu$: folds=20
TheBulldawgg: folds=20
JJ2MG72: raises 500 to 750
harvgrizz: folds=20
lrb1024: folds=20
JJin91: folds=20
E9Polarizer: calls 500
*** FLOP *** [Th 8d 7c]
E9Polarizer: checks=20
JJ2MG72: bets 750
E9Polarizer: folds=20
Uncalled bet (750) returned to JJ2MG72
JJ2MG72 collected 1865 from pot
JJ2MG72: doesn't show hand=20
*** SUMMARY ***
Total pot 1865 | Rake 0=20
Board [Th 8d 7c]
Seat 1: lrb1024 (button) folded before Flop (didn't bet)
Seat 2: JJin91 (small blind) folded before Flop
Seat 3: E9Polarizer (big blind) folded on the Flop
Seat 4: RandyVas folded before Flop (didn't bet)
Seat 5: GiantGeniu$ folded before Flop (didn't bet)
Seat 6: TheBulldawgg folded before Flop (didn't bet)
Seat 7: JJ2MG72 collected (1865)
Seat 9: harvgrizz folded before Flop (didn't bet)


*********** # 66 **************
PokerStars Hand #172141941333: Tournament #1648990476, $18.20+$1.80 USD=
 Hold'em No Limit - Level VIII (125/250) - 2017/07/06 20:23:50 ET
Table '1648990476 7' 9-max Seat #2 is the button
Seat 1: lrb1024 (10210 in chips)=20
Seat 2: JJin91 (19857 in chips)=20
Seat 3: E9Polarizer (9310 in chips)=20
Seat 4: RandyVas (17352 in chips)=20
Seat 5: GiantGeniu$ (9415 in chips)=20
Seat 6: TheBulldawgg (6140 in chips)=20
Seat 7: JJ2MG72 (24126 in chips)=20
Seat 8: DomainWhale (10000 in chips)=20
Seat 9: harvgrizz (9228 in chips)=20
lrb1024: posts the ante 30
JJin91: posts the ante 30
E9Polarizer: posts the ante 30
RandyVas: posts the ante 30
GiantGeniu$: posts the ante 30
TheBulldawgg: posts the ante 30
JJ2MG72: posts the ante 30
DomainWhale: posts the ante 30
harvgrizz: posts the ante 30
E9Polarizer: posts small blind 125
RandyVas: posts big blind 250
*** HOLE CARDS ***
Dealt to JJin91 [7h 2h]
GiantGeniu$: folds=20
TheBulldawgg: folds=20
JJ2MG72: calls 250
DomainWhale: folds=20
harvgrizz: folds=20
lrb1024: calls 250
JJin91: folds=20
E9Polarizer: folds=20
RandyVas: checks=20
*** FLOP *** [7d 8d 8h]
RandyVas: checks=20
JJ2MG72: checks=20
lrb1024: checks=20
*** TURN *** [7d 8d 8h] [Qs]
RandyVas: checks=20
JJ2MG72: checks=20
lrb1024: bets 250
RandyVas: folds=20
JJ2MG72: folds=20
Uncalled bet (250) returned to lrb1024
lrb1024 collected 1145 from pot
lrb1024: doesn't show hand=20
*** SUMMARY ***
Total pot 1145 | Rake 0=20
Board [7d 8d 8h Qs]
Seat 1: lrb1024 collected (1145)
Seat 2: JJin91 (button) folded before Flop (didn't bet)
Seat 3: E9Polarizer (small blind) folded before Flop
Seat 4: RandyVas (big blind) folded on the Turn
Seat 5: GiantGeniu$ folded before Flop (didn't bet)
Seat 6: TheBulldawgg folded before Flop (didn't bet)
Seat 7: JJ2MG72 folded on the Turn
Seat 8: DomainWhale folded before Flop (didn't bet)
Seat 9: harvgrizz folded before Flop (didn't bet)


*********** # 67 **************
PokerStars Hand #172141941516: Tournament #1648990476, $18.20+$1.80 USD=
 Hold'em No Limit - Level VIII (125/250) - 2017/07/06 20:24:33 ET
Table '1648990476 7' 9-max Seat #3 is the button
Seat 1: lrb1024 (11075 in chips)=20
Seat 2: JJin91 (19827 in chips)=20
Seat 3: E9Polarizer (9155 in chips)=20
Seat 4: RandyVas (17072 in chips)=20
Seat 5: GiantGeniu$ (9385 in chips)=20
Seat 6: TheBulldawgg (6110 in chips)=20
Seat 7: JJ2MG72 (23846 in chips)=20
Seat 9: harvgrizz (9198 in chips)=20
lrb1024: posts the ante 30
JJin91: posts the ante 30
E9Polarizer: posts the ante 30
RandyVas: posts the ante 30
GiantGeniu$: posts the ante 30
TheBulldawgg: posts the ante 30
JJ2MG72: posts the ante 30
harvgrizz: posts the ante 30
RandyVas: posts small blind 125
GiantGeniu$: posts big blind 250
*** HOLE CARDS ***
Dealt to JJin91 [6d Qh]
TheBulldawgg: folds=20
JJ2MG72: folds=20
harvgrizz: folds=20
lrb1024 has timed out
lrb1024: folds=20
lrb1024 is sitting out
JJin91: raises 277 to 527
lrb1024 has returned
E9Polarizer: folds=20
RandyVas: folds=20
GiantGeniu$: folds=20
Uncalled bet (277) returned to JJin91
JJin91 collected 865 from pot
JJin91: doesn't show hand=20
*** SUMMARY ***
Total pot 865 | Rake 0=20
Seat 1: lrb1024 folded before Flop (didn't bet)
Seat 2: JJin91 collected (865)
Seat 3: E9Polarizer (button) folded before Flop (didn't bet)
Seat 4: RandyVas (small blind) folded before Flop
Seat 5: GiantGeniu$ (big blind) folded before Flop
Seat 6: TheBulldawgg folded before Flop (didn't bet)
Seat 7: JJ2MG72 folded before Flop (didn't bet)
Seat 9: harvgrizz folded before Flop (didn't bet)


*********** # 68 **************
PokerStars Hand #172141941796: Tournament #1648990476, $18.20+$1.80 USD=
 Hold'em No Limit - Level VIII (125/250) - 2017/07/06 20:25:39 ET
Table '1648990476 7' 9-max Seat #4 is the button
Seat 1: lrb1024 (11045 in chips)=20
Seat 2: JJin91 (20412 in chips)=20
Seat 3: E9Polarizer (9125 in chips)=20
Seat 4: RandyVas (16917 in chips)=20
Seat 5: GiantGeniu$ (9105 in chips)=20
Seat 6: TheBulldawgg (6080 in chips)=20
Seat 7: JJ2MG72 (23816 in chips)=20
Seat 9: harvgrizz (9168 in chips)=20
lrb1024: posts the ante 30
JJin91: posts the ante 30
E9Polarizer: posts the ante 30
RandyVas: posts the ante 30
GiantGeniu$: posts the ante 30
TheBulldawgg: posts the ante 30
JJ2MG72: posts the ante 30
harvgrizz: posts the ante 30
GiantGeniu$: posts small blind 125
TheBulldawgg: posts big blind 250
*** HOLE CARDS ***
Dealt to JJin91 [4c 7s]
JJ2MG72: folds=20
harvgrizz: folds=20
lrb1024: raises 250 to 500
JJin91: folds=20
E9Polarizer: folds=20
RandyVas: folds=20
GiantGeniu$: folds=20
TheBulldawgg: raises 1500 to 2000
lrb1024: calls 1500
*** FLOP *** [5s 2h 7h]
TheBulldawgg: checks=20
lrb1024: bets 2250
TheBulldawgg: folds=20
Uncalled bet (2250) returned to lrb1024
lrb1024 collected 4365 from pot
lrb1024: doesn't show hand=20
*** SUMMARY ***
Total pot 4365 | Rake 0=20
Board [5s 2h 7h]
Seat 1: lrb1024 collected (4365)
Seat 2: JJin91 folded before Flop (didn't bet)
Seat 3: E9Polarizer folded before Flop (didn't bet)
Seat 4: RandyVas (button) folded before Flop (didn't bet)
Seat 5: GiantGeniu$ (small blind) folded before Flop
Seat 6: TheBulldawgg (big blind) folded on the Flop
Seat 7: JJ2MG72 folded before Flop (didn't bet)
Seat 9: harvgrizz folded before Flop (didn't bet)


*********** # 69 **************
PokerStars Hand #172141942183: Tournament #1648990476, $18.20+$1.80 USD=
 Hold'em No Limit - Level IX (150/300) - 2017/07/06 20:27:13 ET
Table '1648990476 7' 9-max Seat #5 is the button
Seat 1: lrb1024 (13380 in chips)=20
Seat 2: JJin91 (20382 in chips)=20
Seat 3: E9Polarizer (9095 in chips)=20
Seat 4: RandyVas (16887 in chips)=20
Seat 5: GiantGeniu$ (8950 in chips)=20
Seat 6: TheBulldawgg (4050 in chips)=20
Seat 7: JJ2MG72 (23786 in chips)=20
Seat 8: Sensor (10000 in chips)=20
Seat 9: harvgrizz (9138 in chips)=20
lrb1024: posts the ante 40
JJin91: posts the ante 40
E9Polarizer: posts the ante 40
RandyVas: posts the ante 40
GiantGeniu$: posts the ante 40
TheBulldawgg: posts the ante 40
JJ2MG72: posts the ante 40
Sensor: posts the ante 40
harvgrizz: posts the ante 40
TheBulldawgg: posts small blind 150
JJ2MG72: posts big blind 300
*** HOLE CARDS ***
Dealt to JJin91 [Tc 4h]
Sensor: folds=20
harvgrizz: folds=20
lrb1024: folds=20
JJin91: folds=20
E9Polarizer: folds=20
RandyVas: folds=20
GiantGeniu$: raises 450 to 750
TheBulldawgg: folds=20
JJ2MG72: folds=20
Uncalled bet (450) returned to GiantGeniu$
GiantGeniu$ collected 1110 from pot
GiantGeniu$: doesn't show hand=20
*** SUMMARY ***
Total pot 1110 | Rake 0=20
Seat 1: lrb1024 folded before Flop (didn't bet)
Seat 2: JJin91 folded before Flop (didn't bet)
Seat 3: E9Polarizer folded before Flop (didn't bet)
Seat 4: RandyVas folded before Flop (didn't bet)
Seat 5: GiantGeniu$ (button) collected (1110)
Seat 6: TheBulldawgg (small blind) folded before Flop
Seat 7: JJ2MG72 (big blind) folded before Flop
Seat 8: Sensor folded before Flop (didn't bet)
Seat 9: harvgrizz folded before Flop (didn't bet)


*********** # 70 **************
PokerStars Hand #172141942395: Tournament #1648990476, $18.20+$1.80 USD=
 Hold'em No Limit - Level IX (150/300) - 2017/07/06 20:28:01 ET
Table '1648990476 7' 9-max Seat #6 is the button
Seat 1: lrb1024 (13340 in chips)=20
Seat 2: JJin91 (20342 in chips)=20
Seat 3: E9Polarizer (9055 in chips)=20
Seat 4: RandyVas (16847 in chips)=20
Seat 5: GiantGeniu$ (9720 in chips)=20
Seat 6: TheBulldawgg (3860 in chips)=20
Seat 7: JJ2MG72 (23446 in chips)=20
Seat 8: Sensor (9960 in chips)=20
Seat 9: harvgrizz (9098 in chips)=20
lrb1024: posts the ante 40
JJin91: posts the ante 40
E9Polarizer: posts the ante 40
RandyVas: posts the ante 40
GiantGeniu$: posts the ante 40
TheBulldawgg: posts the ante 40
JJ2MG72: posts the ante 40
Sensor: posts the ante 40
harvgrizz: posts the ante 40
JJ2MG72: posts small blind 150
Sensor: posts big blind 300
*** HOLE CARDS ***
Dealt to JJin91 [Qh 3d]
harvgrizz: folds=20
lrb1024 has timed out while being disconnected
lrb1024: folds=20
lrb1024 is sitting out
JJin91: calls 300
E9Polarizer: folds=20
lrb1024 has returned
RandyVas: folds=20
GiantGeniu$: calls 300
TheBulldawgg: folds=20
JJ2MG72: calls 150
Sensor: checks=20
*** FLOP *** [5d Kc Qd]
JJ2MG72: bets 600
Sensor: folds=20
JJin91: folds=20
GiantGeniu$: calls 600
*** TURN *** [5d Kc Qd] [2d]
JJ2MG72: checks=20
GiantGeniu$: bets 1435
JJ2MG72: raises 1435 to 2870
GiantGeniu$: calls 1435
*** RIVER *** [5d Kc Qd 2d] [Ts]
JJ2MG72: bets 1500
GiantGeniu$: calls 1500
*** SHOW DOWN ***
JJ2MG72: shows [Kd 9d] (a flush, King high)
GiantGeniu$: mucks hand=20
JJ2MG72 collected 11500 from pot
*** SUMMARY ***
Total pot 11500 | Rake 0=20
Board [5d Kc Qd 2d Ts]
Seat 1: lrb1024 folded before Flop (didn't bet)
Seat 2: JJin91 folded on the Flop
Seat 3: E9Polarizer folded before Flop (didn't bet)
Seat 4: RandyVas folded before Flop (didn't bet)
Seat 5: GiantGeniu$ mucked [5c 5s]
Seat 6: TheBulldawgg (button) folded before Flop (didn't bet)
Seat 7: JJ2MG72 (small blind) showed [Kd 9d] and won (11500) with a flu=
sh, King high
Seat 8: Sensor (big blind) folded on the Flop
Seat 9: harvgrizz folded before Flop (didn't bet)


*********** # 71 **************
PokerStars Hand #172141942817: Tournament #1648990476, $18.20+$1.80 USD=
 Hold'em No Limit - Level IX (150/300) - 2017/07/06 20:29:44 ET
Table '1648990476 7' 9-max Seat #7 is the button
Seat 1: lrb1024 (13300 in chips)=20
Seat 2: JJin91 (20002 in chips)=20
Seat 3: E9Polarizer (9015 in chips)=20
Seat 4: RandyVas (16807 in chips)=20
Seat 5: GiantGeniu$ (4410 in chips)=20
Seat 6: TheBulldawgg (3820 in chips)=20
Seat 7: JJ2MG72 (29636 in chips)=20
Seat 8: Sensor (9620 in chips)=20
lrb1024: posts the ante 40
JJin91: posts the ante 40
E9Polarizer: posts the ante 40
RandyVas: posts the ante 40
GiantGeniu$: posts the ante 40
TheBulldawgg: posts the ante 40
JJ2MG72: posts the ante 40
Sensor: posts the ante 40
Sensor: posts small blind 150
lrb1024: posts big blind 300
*** HOLE CARDS ***
Dealt to JJin91 [6s Kc]
JJin91: folds=20
E9Polarizer: folds=20
RandyVas: folds=20
GiantGeniu$: raises 4070 to 4370 and is all-in
TheBulldawgg: folds=20
JJ2MG72: folds=20
Sensor: folds=20
lrb1024: calls 4070
*** FLOP *** [4c Th 6d]
*** TURN *** [4c Th 6d] [Kd]
*** RIVER *** [4c Th 6d Kd] [2s]
*** SHOW DOWN ***
lrb1024: shows [7d 7c] (a pair of Sevens)
GiantGeniu$: shows [9c As] (high card Ace)
lrb1024 collected 9210 from pot
GiantGeniu$ finished the tournament in 108th place
*** SUMMARY ***
Total pot 9210 | Rake 0=20
Board [4c Th 6d Kd 2s]
Seat 1: lrb1024 (big blind) showed [7d 7c] and won (9210) with a pair o=
f Sevens
Seat 2: JJin91 folded before Flop (didn't bet)
Seat 3: E9Polarizer folded before Flop (didn't bet)
Seat 4: RandyVas folded before Flop (didn't bet)
Seat 5: GiantGeniu$ showed [9c As] and lost with high card Ace
Seat 6: TheBulldawgg folded before Flop (didn't bet)
Seat 7: JJ2MG72 (button) folded before Flop (didn't bet)
Seat 8: Sensor (small blind) folded before Flop


*********** # 72 **************
PokerStars Hand #172141943013: Tournament #1648990476, $18.20+$1.80 USD=
 Hold'em No Limit - Level IX (150/300) - 2017/07/06 20:30:27 ET
Table '1648990476 7' 9-max Seat #8 is the button
Seat 1: lrb1024 (18100 in chips)=20
Seat 2: JJin91 (19962 in chips)=20
Seat 3: E9Polarizer (8975 in chips)=20
Seat 4: RandyVas (16767 in chips)=20
Seat 6: TheBulldawgg (3780 in chips)=20
Seat 7: JJ2MG72 (29596 in chips)=20
Seat 8: Sensor (9430 in chips)=20
lrb1024: posts the ante 40
JJin91: posts the ante 40
E9Polarizer: posts the ante 40
RandyVas: posts the ante 40
TheBulldawgg: posts the ante 40
JJ2MG72: posts the ante 40
Sensor: posts the ante 40
lrb1024: posts small blind 150
JJin91: posts big blind 300
*** HOLE CARDS ***
Dealt to JJin91 [Ks Ah]
E9Polarizer: folds=20
RandyVas: folds=20
TheBulldawgg: folds=20
JJ2MG72: folds=20
Sensor: raises 327 to 627
lrb1024: calls 477
JJin91: raises 1372 to 1999
Sensor: calls 1372
lrb1024: folds=20
*** FLOP *** [Kd 6s Qs]
JJin91: bets 1133
Sensor: calls 1133
*** TURN *** [Kd 6s Qs] [Ad]
JJin91: checks=20
Sensor: checks=20
*** RIVER *** [Kd 6s Qs Ad] [4d]
JJin91: bets 16790 and is all-in
Sensor: calls 6258 and is all-in
Uncalled bet (10532) returned to JJin91
*** SHOW DOWN ***
JJin91: shows [Ks Ah] (two pair, Aces and Kings)
Sensor: shows [8d 6d] (a flush, Ace high)
Sensor collected 19687 from pot
*** SUMMARY ***
Total pot 19687 | Rake 0=20
Board [Kd 6s Qs Ad 4d]
Seat 1: lrb1024 (small blind) folded before Flop
Seat 2: JJin91 (big blind) showed [Ks Ah] and lost with two pair, Aces =
and Kings
Seat 3: E9Polarizer folded before Flop (didn't bet)
Seat 4: RandyVas folded before Flop (didn't bet)
Seat 6: TheBulldawgg folded before Flop (didn't bet)
Seat 7: JJ2MG72 folded before Flop (didn't bet)
Seat 8: Sensor (button) showed [8d 6d] and won (19687) with a flush, Ac=
e high


*********** # 73 **************
PokerStars Hand #172141943383: Tournament #1648990476, $18.20+$1.80 USD=
 Hold'em No Limit - Level IX (150/300) - 2017/07/06 20:31:51 ET
Table '1648990476 7' 9-max Seat #1 is the button
Seat 1: lrb1024 (17433 in chips)=20
Seat 2: JJin91 (10532 in chips)=20
Seat 3: E9Polarizer (8935 in chips)=20
Seat 4: RandyVas (16727 in chips)=20
Seat 6: TheBulldawgg (3740 in chips)=20
Seat 7: JJ2MG72 (29556 in chips)=20
Seat 8: Sensor (19687 in chips)=20
Seat 9: GiantGeniu$ (10000 in chips)=20
lrb1024: posts the ante 40
JJin91: posts the ante 40
E9Polarizer: posts the ante 40
RandyVas: posts the ante 40
TheBulldawgg: posts the ante 40
JJ2MG72: posts the ante 40
Sensor: posts the ante 40
GiantGeniu$: posts the ante 40
JJin91: posts small blind 150
E9Polarizer: posts big blind 300
*** HOLE CARDS ***
Dealt to JJin91 [8s Qc]
RandyVas: raises 300 to 600
TheBulldawgg: folds=20
JJ2MG72: folds=20
Sensor: folds=20
GiantGeniu$: folds=20
lrb1024: raises 300 to 900
JJin91 said, "pro hand"
JJin91 said, "wp nh"
JJin91: folds=20
E9Polarizer: folds=20
RandyVas: calls 300
*** FLOP *** [7c 3h Kc]
RandyVas: checks=20
lrb1024: bets 1500
RandyVas: folds=20
Uncalled bet (1500) returned to lrb1024
lrb1024 collected 2570 from pot
lrb1024: doesn't show hand=20
*** SUMMARY ***
Total pot 2570 | Rake 0=20
Board [7c 3h Kc]
Seat 1: lrb1024 (button) collected (2570)
Seat 2: JJin91 (small blind) folded before Flop
Seat 3: E9Polarizer (big blind) folded before Flop
Seat 4: RandyVas folded on the Flop
Seat 6: TheBulldawgg folded before Flop (didn't bet)
Seat 7: JJ2MG72 folded before Flop (didn't bet)
Seat 8: Sensor folded before Flop (didn't bet)
Seat 9: GiantGeniu$ folded before Flop (didn't bet)


*********** # 74 **************
PokerStars Hand #172141943634: Tournament #1648990476, $18.20+$1.80 USD=
 Hold'em No Limit - Level IX (150/300) - 2017/07/06 20:32:42 ET
Table '1648990476 7' 9-max Seat #2 is the button
Seat 1: lrb1024 (19063 in chips)=20
Seat 2: JJin91 (10342 in chips)=20
Seat 3: E9Polarizer (8595 in chips)=20
Seat 4: RandyVas (15787 in chips)=20
Seat 6: TheBulldawgg (3700 in chips)=20
Seat 7: JJ2MG72 (29516 in chips)=20
Seat 8: Sensor (19647 in chips)=20
Seat 9: GiantGeniu$ (9960 in chips)=20
lrb1024: posts the ante 40
JJin91: posts the ante 40
E9Polarizer: posts the ante 40
RandyVas: posts the ante 40
TheBulldawgg: posts the ante 40
JJ2MG72: posts the ante 40
Sensor: posts the ante 40
GiantGeniu$: posts the ante 40
E9Polarizer: posts small blind 150
RandyVas: posts big blind 300
*** HOLE CARDS ***
Dealt to JJin91 [2h Qd]
TheBulldawgg: folds=20
JJ2MG72: folds=20
Sensor: raises 327 to 627
GiantGeniu$: folds=20
lrb1024: folds=20
JJin91: folds=20
E9Polarizer: folds=20
RandyVas: calls 327
*** FLOP *** [Kh 4d 6d]
RandyVas: checks=20
Sensor: bets 672
RandyVas: calls 672
*** TURN *** [Kh 4d 6d] [Qs]
RandyVas: checks=20
Sensor: checks=20
*** RIVER *** [Kh 4d 6d Qs] [Ks]
RandyVas: bets 1534
Sensor: folds=20
Uncalled bet (1534) returned to RandyVas
RandyVas collected 3068 from pot
RandyVas: doesn't show hand=20
*** SUMMARY ***
Total pot 3068 | Rake 0=20
Board [Kh 4d 6d Qs Ks]
Seat 1: lrb1024 folded before Flop (didn't bet)
Seat 2: JJin91 (button) folded before Flop (didn't bet)
Seat 3: E9Polarizer (small blind) folded before Flop
Seat 4: RandyVas (big blind) collected (3068)
Seat 6: TheBulldawgg folded before Flop (didn't bet)
Seat 7: JJ2MG72 folded before Flop (didn't bet)
Seat 8: Sensor folded on the River
Seat 9: GiantGeniu$ folded before Flop (didn't bet)


*********** # 75 **************
PokerStars Hand #172141943892: Tournament #1648990476, $18.20+$1.80 USD=
 Hold'em No Limit - Level IX (150/300) - 2017/07/06 20:33:41 ET
Table '1648990476 7' 9-max Seat #3 is the button
Seat 1: lrb1024 (19023 in chips)=20
Seat 2: JJin91 (10302 in chips)=20
Seat 3: E9Polarizer (8405 in chips)=20
Seat 4: RandyVas (17516 in chips)=20
Seat 6: TheBulldawgg (3660 in chips)=20
Seat 7: JJ2MG72 (29476 in chips)=20
Seat 8: Sensor (18308 in chips)=20
Seat 9: GiantGeniu$ (9920 in chips)=20
lrb1024: posts the ante 40
JJin91: posts the ante 40
E9Polarizer: posts the ante 40
RandyVas: posts the ante 40
TheBulldawgg: posts the ante 40
JJ2MG72: posts the ante 40
Sensor: posts the ante 40
GiantGeniu$: posts the ante 40
RandyVas: posts small blind 150
TheBulldawgg: posts big blind 300
*** HOLE CARDS ***
Dealt to JJin91 [5h 7d]
JJ2MG72: folds=20
Sensor: folds=20
GiantGeniu$: folds=20
lrb1024: folds=20
JJin91: folds=20
E9Polarizer: raises 450 to 750
RandyVas: folds=20
TheBulldawgg: folds=20
Uncalled bet (450) returned to E9Polarizer
E9Polarizer collected 1070 from pot
E9Polarizer: doesn't show hand=20
*** SUMMARY ***
Total pot 1070 | Rake 0=20
Seat 1: lrb1024 folded before Flop (didn't bet)
Seat 2: JJin91 folded before Flop (didn't bet)
Seat 3: E9Polarizer (button) collected (1070)
Seat 4: RandyVas (small blind) folded before Flop
Seat 6: TheBulldawgg (big blind) folded before Flop
Seat 7: JJ2MG72 folded before Flop (didn't bet)
Seat 8: Sensor folded before Flop (didn't bet)
Seat 9: GiantGeniu$ folded before Flop (didn't bet)


*********** # 76 **************
PokerStars Hand #172141944058: Tournament #1648990476, $18.20+$1.80 USD=
 Hold'em No Limit - Level IX (150/300) - 2017/07/06 20:34:18 ET
Table '1648990476 7' 9-max Seat #4 is the button
Seat 1: lrb1024 (18983 in chips)=20
Seat 2: JJin91 (10262 in chips)=20
Seat 3: E9Polarizer (9135 in chips)=20
Seat 4: RandyVas (17326 in chips)=20
Seat 6: TheBulldawgg (3320 in chips)=20
Seat 7: JJ2MG72 (29436 in chips)=20
Seat 8: Sensor (18268 in chips)=20
Seat 9: GiantGeniu$ (9880 in chips)=20
lrb1024: posts the ante 40
JJin91: posts the ante 40
E9Polarizer: posts the ante 40
RandyVas: posts the ante 40
TheBulldawgg: posts the ante 40
JJ2MG72: posts the ante 40
Sensor: posts the ante 40
GiantGeniu$: posts the ante 40
TheBulldawgg: posts small blind 150
JJ2MG72: posts big blind 300
*** HOLE CARDS ***
Dealt to JJin91 [5h 9d]
Sensor: folds=20
GiantGeniu$: folds=20
lrb1024: raises 600 to 900
JJin91: folds=20
E9Polarizer: folds=20
RandyVas: folds=20
TheBulldawgg: folds=20
JJ2MG72: folds=20
Uncalled bet (600) returned to lrb1024
lrb1024 collected 1070 from pot
lrb1024: doesn't show hand=20
*** SUMMARY ***
Total pot 1070 | Rake 0=20
Seat 1: lrb1024 collected (1070)
Seat 2: JJin91 folded before Flop (didn't bet)
Seat 3: E9Polarizer folded before Flop (didn't bet)
Seat 4: RandyVas (button) folded before Flop (didn't bet)
Seat 6: TheBulldawgg (small blind) folded before Flop
Seat 7: JJ2MG72 (big blind) folded before Flop
Seat 8: Sensor folded before Flop (didn't bet)
Seat 9: GiantGeniu$ folded before Flop (didn't bet)


*********** # 77 **************
PokerStars Hand #172141944183: Tournament #1648990476, $18.20+$1.80 USD=
 Hold'em No Limit - Level IX (150/300) - 2017/07/06 20:34:45 ET
Table '1648990476 7' 9-max Seat #6 is the button
Seat 1: lrb1024 (19713 in chips)=20
Seat 2: JJin91 (10222 in chips)=20
Seat 3: E9Polarizer (9095 in chips)=20
Seat 4: RandyVas (17286 in chips)=20
Seat 6: TheBulldawgg (3130 in chips)=20
Seat 7: JJ2MG72 (29096 in chips)=20
Seat 8: Sensor (18228 in chips)=20
Seat 9: GiantGeniu$ (9840 in chips)=20
lrb1024: posts the ante 40
JJin91: posts the ante 40
E9Polarizer: posts the ante 40
RandyVas: posts the ante 40
TheBulldawgg: posts the ante 40
JJ2MG72: posts the ante 40
Sensor: posts the ante 40
GiantGeniu$: posts the ante 40
JJ2MG72: posts small blind 150
Sensor: posts big blind 300
*** HOLE CARDS ***
Dealt to JJin91 [Jd Js]
GiantGeniu$: folds=20
lrb1024: folds=20
JJin91: raises 333 to 633
E9Polarizer: folds=20
RandyVas: calls 633
TheBulldawgg: raises 2457 to 3090 and is all-in
JJ2MG72: folds=20
Sensor: folds=20
JJin91: raises 7092 to 10182 and is all-in
RandyVas: folds=20
Uncalled bet (7092) returned to JJin91
*** FLOP *** [Ad 8s 2h]
*** TURN *** [Ad 8s 2h] [Td]
*** RIVER *** [Ad 8s 2h Td] [6h]
*** SHOW DOWN ***
JJin91: shows [Jd Js] (a pair of Jacks)
TheBulldawgg: shows [5h 5c] (a pair of Fives)
JJin91 collected 7583 from pot
TheBulldawgg finished the tournament in 104th place
*** SUMMARY ***
Total pot 7583 | Rake 0=20
Board [Ad 8s 2h Td 6h]
Seat 1: lrb1024 folded before Flop (didn't bet)
Seat 2: JJin91 showed [Jd Js] and won (7583) with a pair of Jacks
Seat 3: E9Polarizer folded before Flop (didn't bet)
Seat 4: RandyVas folded before Flop
Seat 6: TheBulldawgg (button) showed [5h 5c] and lost with a pair of Fi=
ves
Seat 7: JJ2MG72 (small blind) folded before Flop
Seat 8: Sensor (big blind) folded before Flop
Seat 9: GiantGeniu$ folded before Flop (didn't bet)


*********** # 78 **************
PokerStars Hand #172141944385: Tournament #1648990476, $18.20+$1.80 USD=
 Hold'em No Limit - Level IX (150/300) - 2017/07/06 20:35:30 ET
Table '1648990476 7' 9-max Seat #7 is the button
Seat 1: lrb1024 (19673 in chips)=20
Seat 2: JJin91 (14675 in chips)=20
Seat 3: E9Polarizer (9055 in chips)=20
Seat 4: RandyVas (16613 in chips)=20
Seat 7: JJ2MG72 (28906 in chips)=20
Seat 8: Sensor (17888 in chips)=20
Seat 9: GiantGeniu$ (9800 in chips)=20
lrb1024: posts the ante 40
JJin91: posts the ante 40
E9Polarizer: posts the ante 40
RandyVas: posts the ante 40
JJ2MG72: posts the ante 40
Sensor: posts the ante 40
GiantGeniu$: posts the ante 40
Sensor: posts small blind 150
GiantGeniu$: posts big blind 300
*** HOLE CARDS ***
Dealt to JJin91 [7d 9s]
lrb1024: folds=20
JJin91: folds=20
E9Polarizer: folds=20
RandyVas: folds=20
JJ2MG72: folds=20
Sensor: calls 150
GiantGeniu$: checks=20
*** FLOP *** [As 9h 5c]
Sensor: checks=20
GiantGeniu$: bets 458
Sensor: folds=20
Uncalled bet (458) returned to GiantGeniu$
GiantGeniu$ collected 880 from pot
GiantGeniu$: doesn't show hand=20
*** SUMMARY ***
Total pot 880 | Rake 0=20
Board [As 9h 5c]
Seat 1: lrb1024 folded before Flop (didn't bet)
Seat 2: JJin91 folded before Flop (didn't bet)
Seat 3: E9Polarizer folded before Flop (didn't bet)
Seat 4: RandyVas folded before Flop (didn't bet)
Seat 7: JJ2MG72 (button) folded before Flop (didn't bet)
Seat 8: Sensor (small blind) folded on the Flop
Seat 9: GiantGeniu$ (big blind) collected (880)


*********** # 79 **************
PokerStars Hand #172141944536: Tournament #1648990476, $18.20+$1.80 USD=
 Hold'em No Limit - Level X (200/400) - 2017/07/06 20:36:05 ET
Table '1648990476 7' 9-max Seat #8 is the button
Seat 1: lrb1024 (19633 in chips)=20
Seat 2: JJin91 (14635 in chips)=20
Seat 3: E9Polarizer (9015 in chips)=20
Seat 4: RandyVas (16573 in chips)=20
Seat 5: TrumpsDong (10000 in chips)=20
Seat 7: JJ2MG72 (28866 in chips)=20
Seat 8: Sensor (17548 in chips)=20
Seat 9: GiantGeniu$ (10340 in chips)=20
lrb1024: posts the ante 50
JJin91: posts the ante 50
E9Polarizer: posts the ante 50
RandyVas: posts the ante 50
TrumpsDong: posts the ante 50
JJ2MG72: posts the ante 50
Sensor: posts the ante 50
GiantGeniu$: posts the ante 50
GiantGeniu$: posts small blind 200
lrb1024: posts big blind 400
*** HOLE CARDS ***
Dealt to JJin91 [Js 9d]
JJin91: folds=20
E9Polarizer: raises 600 to 1000
RandyVas: folds=20
TrumpsDong: folds=20
JJ2MG72: folds=20
Sensor: folds=20
GiantGeniu$: folds=20
lrb1024: calls 600
*** FLOP *** [4h 6h 2c]
lrb1024: checks=20
E9Polarizer: bets 1560
lrb1024: folds=20
Uncalled bet (1560) returned to E9Polarizer
E9Polarizer collected 2600 from pot
E9Polarizer: doesn't show hand=20
*** SUMMARY ***
Total pot 2600 | Rake 0=20
Board [4h 6h 2c]
Seat 1: lrb1024 (big blind) folded on the Flop
Seat 2: JJin91 folded before Flop (didn't bet)
Seat 3: E9Polarizer collected (2600)
Seat 4: RandyVas folded before Flop (didn't bet)
Seat 5: TrumpsDong folded before Flop (didn't bet)
Seat 7: JJ2MG72 folded before Flop (didn't bet)
Seat 8: Sensor (button) folded before Flop (didn't bet)
Seat 9: GiantGeniu$ (small blind) folded before Flop


*********** # 80 **************
PokerStars Hand #172141944737: Tournament #1648990476, $18.20+$1.80 USD=
 Hold'em No Limit - Level X (200/400) - 2017/07/06 20:36:52 ET
Table '1648990476 7' 9-max Seat #9 is the button
Seat 1: lrb1024 (18583 in chips)=20
Seat 2: JJin91 (14585 in chips)=20
Seat 3: E9Polarizer (10565 in chips)=20
Seat 4: RandyVas (16523 in chips)=20
Seat 5: TrumpsDong (9950 in chips)=20
Seat 7: JJ2MG72 (28816 in chips)=20
Seat 8: Sensor (17498 in chips)=20
Seat 9: GiantGeniu$ (10090 in chips)=20
lrb1024: posts the ante 50
JJin91: posts the ante 50
E9Polarizer: posts the ante 50
RandyVas: posts the ante 50
TrumpsDong: posts the ante 50
JJ2MG72: posts the ante 50
Sensor: posts the ante 50
GiantGeniu$: posts the ante 50
lrb1024: posts small blind 200
JJin91: posts big blind 400
*** HOLE CARDS ***
Dealt to JJin91 [2c 7s]
E9Polarizer: raises 400 to 800
RandyVas: folds=20
TrumpsDong: folds=20
JJ2MG72: folds=20
Sensor: folds=20
GiantGeniu$: calls 800
lrb1024: folds=20
JJin91: folds=20
*** FLOP *** [6d Kc 5c]
E9Polarizer: bets 1040
GiantGeniu$: calls 1040
*** TURN *** [6d Kc 5c] [6s]
E9Polarizer: bets 2200
GiantGeniu$: calls 2200
*** RIVER *** [6d Kc 5c 6s] [Ad]
E9Polarizer: bets 6475 and is all-in
GiantGeniu$: calls 6000 and is all-in
Uncalled bet (475) returned to E9Polarizer
*** SHOW DOWN ***
E9Polarizer: shows [Ac Qc] (two pair, Aces and Sixes)
GiantGeniu$: shows [Jh Kh] (two pair, Kings and Sixes)
E9Polarizer collected 21080 from pot
GiantGeniu$ finished the tournament in 102nd place
*** SUMMARY ***
Total pot 21080 | Rake 0=20
Board [6d Kc 5c 6s Ad]
Seat 1: lrb1024 (small blind) folded before Flop
Seat 2: JJin91 (big blind) folded before Flop
Seat 3: E9Polarizer showed [Ac Qc] and won (21080) with two pair, Aces =
and Sixes
Seat 4: RandyVas folded before Flop (didn't bet)
Seat 5: TrumpsDong folded before Flop (didn't bet)
Seat 7: JJ2MG72 folded before Flop (didn't bet)
Seat 8: Sensor folded before Flop (didn't bet)
Seat 9: GiantGeniu$ (button) showed [Jh Kh] and lost with two pair, Kin=
gs and Sixes


*********** # 81 **************
PokerStars Hand #172141944979: Tournament #1648990476, $18.20+$1.80 USD=
 Hold'em No Limit - Level X (200/400) - 2017/07/06 20:37:43 ET
Table '1648990476 7' 9-max Seat #1 is the button
Seat 1: lrb1024 (18333 in chips)=20
Seat 2: JJin91 (14135 in chips)=20
Seat 3: E9Polarizer (21555 in chips)=20
Seat 4: RandyVas (16473 in chips)=20
Seat 5: TrumpsDong (9900 in chips)=20
Seat 7: JJ2MG72 (28766 in chips)=20
Seat 8: Sensor (17448 in chips)=20
lrb1024: posts the ante 50
JJin91: posts the ante 50
E9Polarizer: posts the ante 50
RandyVas: posts the ante 50
TrumpsDong: posts the ante 50
JJ2MG72: posts the ante 50
Sensor: posts the ante 50
JJin91: posts small blind 200
E9Polarizer: posts big blind 400
*** HOLE CARDS ***
Dealt to JJin91 [4c 7h]
RandyVas: raises 400 to 800
TrumpsDong: calls 800
JJ2MG72: folds=20
Sensor: folds=20
lrb1024: folds=20
JJin91: folds=20
E9Polarizer: calls 400
*** FLOP *** [8h 7d 2d]
E9Polarizer: checks=20
RandyVas: checks=20
TrumpsDong: checks=20
*** TURN *** [8h 7d 2d] [4d]
E9Polarizer: checks=20
RandyVas: checks=20
TrumpsDong: checks=20
*** RIVER *** [8h 7d 2d 4d] [6d]
E9Polarizer: checks=20
RandyVas: checks=20
TrumpsDong: checks=20
*** SHOW DOWN ***
E9Polarizer: shows [Ac 5d] (a flush, Seven high)
RandyVas: mucks hand=20
TrumpsDong: mucks hand=20
E9Polarizer collected 2950 from pot
*** SUMMARY ***
Total pot 2950 | Rake 0=20
Board [8h 7d 2d 4d 6d]
Seat 1: lrb1024 (button) folded before Flop (didn't bet)
Seat 2: JJin91 (small blind) folded before Flop
Seat 3: E9Polarizer (big blind) showed [Ac 5d] and won (2950) with a fl=
ush, Seven high
Seat 4: RandyVas mucked [Kc Qc]
Seat 5: TrumpsDong mucked [Ah Qs]
Seat 7: JJ2MG72 folded before Flop (didn't bet)
Seat 8: Sensor folded before Flop (didn't bet)


*********** # 82 **************
PokerStars Hand #172141945315: Tournament #1648990476, $18.20+$1.80 USD=
 Hold'em No Limit - Level X (200/400) - 2017/07/06 20:38:55 ET
Table '1648990476 7' 9-max Seat #2 is the button
Seat 1: lrb1024 (18283 in chips)=20
Seat 2: JJin91 (13885 in chips)=20
Seat 3: E9Polarizer (23655 in chips)=20
Seat 4: RandyVas (15623 in chips)=20
Seat 5: TrumpsDong (9050 in chips)=20
Seat 6: Brian3810 (10000 in chips)=20
Seat 7: JJ2MG72 (28716 in chips)=20
Seat 8: Sensor (17398 in chips)=20
lrb1024: posts the ante 50
JJin91: posts the ante 50
E9Polarizer: posts the ante 50
RandyVas: posts the ante 50
TrumpsDong: posts the ante 50
Brian3810: posts the ante 50
JJ2MG72: posts the ante 50
Sensor: posts the ante 50
E9Polarizer: posts small blind 200
RandyVas: posts big blind 400
*** HOLE CARDS ***
Dealt to JJin91 [2s 2h]
TrumpsDong: folds=20
Brian3810: folds=20
JJ2MG72: raises 400 to 800
Sensor: folds=20
lrb1024: folds=20
JJin91: calls 800
E9Polarizer: folds=20
RandyVas: calls 400
*** FLOP *** [8d 3c Js]
RandyVas: checks=20
JJ2MG72: checks=20
JJin91: bets 1888
RandyVas: folds=20
JJ2MG72: folds=20
Uncalled bet (1888) returned to JJin91
JJin91 collected 3000 from pot
JJin91: doesn't show hand=20
*** SUMMARY ***
Total pot 3000 | Rake 0=20
Board [8d 3c Js]
Seat 1: lrb1024 folded before Flop (didn't bet)
Seat 2: JJin91 (button) collected (3000)
Seat 3: E9Polarizer (small blind) folded before Flop
Seat 4: RandyVas (big blind) folded on the Flop
Seat 5: TrumpsDong folded before Flop (didn't bet)
Seat 6: Brian3810 folded before Flop (didn't bet)
Seat 7: JJ2MG72 folded on the Flop
Seat 8: Sensor folded before Flop (didn't bet)


*********** # 83 **************
PokerStars Hand #172141945647: Tournament #1648990476, $18.20+$1.80 USD=
 Hold'em No Limit - Level X (200/400) - 2017/07/06 20:40:02 ET
Table '1648990476 7' 9-max Seat #3 is the button
Seat 1: lrb1024 (18233 in chips)=20
Seat 2: JJin91 (16035 in chips)=20
Seat 3: E9Polarizer (23405 in chips)=20
Seat 4: RandyVas (14773 in chips)=20
Seat 5: TrumpsDong (9000 in chips)=20
Seat 6: Brian3810 (9950 in chips)=20
Seat 7: JJ2MG72 (27866 in chips)=20
Seat 8: Sensor (17348 in chips)=20
lrb1024: posts the ante 50
JJin91: posts the ante 50
E9Polarizer: posts the ante 50
RandyVas: posts the ante 50
TrumpsDong: posts the ante 50
Brian3810: posts the ante 50
JJ2MG72: posts the ante 50
Sensor: posts the ante 50
RandyVas: posts small blind 200
TrumpsDong: posts big blind 400
*** HOLE CARDS ***
Dealt to JJin91 [7c 4s]
Brian3810: raises 600 to 1000
JJ2MG72: folds=20
Sensor: folds=20
lrb1024: folds=20
JJin91: folds=20
E9Polarizer: calls 1000
RandyVas: folds=20
TrumpsDong: folds=20
*** FLOP *** [5d 8h 4c]
Brian3810: bets 1500
E9Polarizer: folds=20
Uncalled bet (1500) returned to Brian3810
Brian3810 collected 3000 from pot
Brian3810: doesn't show hand=20
*** SUMMARY ***
Total pot 3000 | Rake 0=20
Board [5d 8h 4c]
Seat 1: lrb1024 folded before Flop (didn't bet)
Seat 2: JJin91 folded before Flop (didn't bet)
Seat 3: E9Polarizer (button) folded on the Flop
Seat 4: RandyVas (small blind) folded before Flop
Seat 5: TrumpsDong (big blind) folded before Flop
Seat 6: Brian3810 collected (3000)
Seat 7: JJ2MG72 folded before Flop (didn't bet)
Seat 8: Sensor folded before Flop (didn't bet)


*********** # 84 **************
PokerStars Hand #172141945924: Tournament #1648990476, $18.20+$1.80 USD=
 Hold'em No Limit - Level X (200/400) - 2017/07/06 20:41:02 ET
Table '1648990476 7' 9-max Seat #4 is the button
Seat 1: lrb1024 (18183 in chips)=20
Seat 2: JJin91 (15985 in chips)=20
Seat 3: E9Polarizer (22355 in chips)=20
Seat 4: RandyVas (14523 in chips)=20
Seat 5: TrumpsDong (8550 in chips)=20
Seat 6: Brian3810 (11900 in chips)=20
Seat 7: JJ2MG72 (27816 in chips)=20
Seat 8: Sensor (17298 in chips)=20
lrb1024: posts the ante 50
JJin91: posts the ante 50
E9Polarizer: posts the ante 50
RandyVas: posts the ante 50
TrumpsDong: posts the ante 50
Brian3810: posts the ante 50
JJ2MG72: posts the ante 50
Sensor: posts the ante 50
TrumpsDong: posts small blind 200
Brian3810: posts big blind 400
*** HOLE CARDS ***
Dealt to JJin91 [9d Qd]
JJ2MG72: folds=20
Sensor: raises 796 to 1196
lrb1024: folds=20
JJin91: folds=20
E9Polarizer: folds=20
RandyVas: folds=20
TrumpsDong: folds=20
Brian3810: folds=20
Uncalled bet (796) returned to Sensor
Sensor collected 1400 from pot
Sensor: doesn't show hand=20
*** SUMMARY ***
Total pot 1400 | Rake 0=20
Seat 1: lrb1024 folded before Flop (didn't bet)
Seat 2: JJin91 folded before Flop (didn't bet)
Seat 3: E9Polarizer folded before Flop (didn't bet)
Seat 4: RandyVas (button) folded before Flop (didn't bet)
Seat 5: TrumpsDong (small blind) folded before Flop
Seat 6: Brian3810 (big blind) folded before Flop
Seat 7: JJ2MG72 folded before Flop (didn't bet)
Seat 8: Sensor collected (1400)


*********** # 85 **************
PokerStars Hand #172141946082: Tournament #1648990476, $18.20+$1.80 USD=
 Hold'em No Limit - Level X (200/400) - 2017/07/06 20:41:36 ET
Table '1648990476 7' 9-max Seat #5 is the button
Seat 1: lrb1024 (18133 in chips)=20
Seat 2: JJin91 (15935 in chips)=20
Seat 3: E9Polarizer (22305 in chips)=20
Seat 4: RandyVas (14473 in chips)=20
Seat 5: TrumpsDong (8300 in chips)=20
Seat 6: Brian3810 (11450 in chips)=20
Seat 7: JJ2MG72 (27766 in chips)=20
Seat 8: Sensor (18248 in chips)=20
lrb1024: posts the ante 50
JJin91: posts the ante 50
E9Polarizer: posts the ante 50
RandyVas: posts the ante 50
TrumpsDong: posts the ante 50
Brian3810: posts the ante 50
JJ2MG72: posts the ante 50
Sensor: posts the ante 50
Brian3810: posts small blind 200
JJ2MG72: posts big blind 400
*** HOLE CARDS ***
Dealt to JJin91 [3h 2d]
Sensor: folds=20
lrb1024: raises 400 to 800
JJin91: folds=20
E9Polarizer: folds=20
RandyVas: folds=20
TrumpsDong: calls 800
Brian3810: folds=20
JJ2MG72: calls 400
*** FLOP *** [Ah Ts Qh]
JJ2MG72: bets 400
lrb1024: calls 400
TrumpsDong: calls 400
*** TURN *** [Ah Ts Qh] [Js]
JJ2MG72: checks=20
lrb1024: bets 12000
TrumpsDong: folds=20
JJ2MG72: folds=20
Uncalled bet (12000) returned to lrb1024
lrb1024 collected 4200 from pot
lrb1024: doesn't show hand=20
*** SUMMARY ***
Total pot 4200 | Rake 0=20
Board [Ah Ts Qh Js]
Seat 1: lrb1024 collected (4200)
Seat 2: JJin91 folded before Flop (didn't bet)
Seat 3: E9Polarizer folded before Flop (didn't bet)
Seat 4: RandyVas folded before Flop (didn't bet)
Seat 5: TrumpsDong (button) folded on the Turn
Seat 6: Brian3810 (small blind) folded before Flop
Seat 7: JJ2MG72 (big blind) folded on the Turn
Seat 8: Sensor folded before Flop (didn't bet)


*********** # 86 **************
PokerStars Hand #172141946391: Tournament #1648990476, $18.20+$1.80 USD=
 Hold'em No Limit - Level X (200/400) - 2017/07/06 20:42:48 ET
Table '1648990476 7' 9-max Seat #6 is the button
Seat 1: lrb1024 (21083 in chips)=20
Seat 2: JJin91 (15885 in chips)=20
Seat 3: E9Polarizer (22255 in chips)=20
Seat 4: RandyVas (14423 in chips)=20
Seat 5: TrumpsDong (7050 in chips)=20
Seat 6: Brian3810 (11200 in chips)=20
Seat 7: JJ2MG72 (26516 in chips)=20
Seat 8: Sensor (18198 in chips)=20
lrb1024: posts the ante 50
JJin91: posts the ante 50
E9Polarizer: posts the ante 50
RandyVas: posts the ante 50
TrumpsDong: posts the ante 50
Brian3810: posts the ante 50
JJ2MG72: posts the ante 50
Sensor: posts the ante 50
JJ2MG72: posts small blind 200
Sensor: posts big blind 400
*** HOLE CARDS ***
Dealt to JJin91 [2d 6h]
lrb1024: raises 400 to 800
JJin91: folds=20
E9Polarizer: folds=20
RandyVas: folds=20
TrumpsDong: folds=20
Brian3810: calls 800
JJ2MG72: folds=20
Sensor: calls 400
*** FLOP *** [Js Qh Kh]
Sensor: checks=20
lrb1024: checks=20
Brian3810: checks=20
*** TURN *** [Js Qh Kh] [As]
Sensor: checks=20
lrb1024: bets 400
Brian3810: folds=20
Sensor: folds=20
Uncalled bet (400) returned to lrb1024
lrb1024 collected 3000 from pot
lrb1024: doesn't show hand=20
*** SUMMARY ***
Total pot 3000 | Rake 0=20
Board [Js Qh Kh As]
Seat 1: lrb1024 collected (3000)
Seat 2: JJin91 folded before Flop (didn't bet)
Seat 3: E9Polarizer folded before Flop (didn't bet)
Seat 4: RandyVas folded before Flop (didn't bet)
Seat 5: TrumpsDong folded before Flop (didn't bet)
Seat 6: Brian3810 (button) folded on the Turn
Seat 7: JJ2MG72 (small blind) folded before Flop
Seat 8: Sensor (big blind) folded on the Turn


*********** # 87 **************
PokerStars Hand #172141946680: Tournament #1648990476, $18.20+$1.80 USD=
 Hold'em No Limit - Level X (200/400) - 2017/07/06 20:43:51 ET
Table '1648990476 7' 9-max Seat #7 is the button
Seat 1: lrb1024 (23233 in chips)=20
Seat 2: JJin91 (15835 in chips)=20
Seat 3: E9Polarizer (22205 in chips)=20
Seat 4: RandyVas (14373 in chips)=20
Seat 5: TrumpsDong (7000 in chips)=20
Seat 6: Brian3810 (10350 in chips)=20
Seat 7: JJ2MG72 (26266 in chips)=20
Seat 8: Sensor (17348 in chips)=20
Seat 9: fingers911 (10000 in chips)=20
lrb1024: posts the ante 50
JJin91: posts the ante 50
E9Polarizer: posts the ante 50
RandyVas: posts the ante 50
TrumpsDong: posts the ante 50
Brian3810: posts the ante 50
JJ2MG72: posts the ante 50
Sensor: posts the ante 50
fingers911: posts the ante 50
Sensor: posts small blind 200
fingers911: posts big blind 400
*** HOLE CARDS ***
Dealt to JJin91 [6d Jd]
lrb1024: folds=20
JJin91: folds=20
E9Polarizer: folds=20
RandyVas: folds=20
TrumpsDong: folds=20
Brian3810: folds=20
JJ2MG72: folds=20
Sensor: raises 436 to 836
fingers911: raises 2122 to 2958
Sensor: calls 2122
*** FLOP *** [9c 8s As]
Sensor: checks=20
fingers911: checks=20
*** TURN *** [9c 8s As] [2h]
Sensor: bets 400
fingers911: raises 800 to 1200
Sensor: calls 800
*** RIVER *** [9c 8s As 2h] [9h]
Sensor: checks=20
fingers911: bets 5792 and is all-in
Sensor: calls 5792
*** SHOW DOWN ***
fingers911: shows [8d 8c] (a full house, Eights full of Nines)
Sensor: shows [8h 7d] (two pair, Nines and Eights)
fingers911 collected 20350 from pot
*** SUMMARY ***
Total pot 20350 | Rake 0=20
Board [9c 8s As 2h 9h]
Seat 1: lrb1024 folded before Flop (didn't bet)
Seat 2: JJin91 folded before Flop (didn't bet)
Seat 3: E9Polarizer folded before Flop (didn't bet)
Seat 4: RandyVas folded before Flop (didn't bet)
Seat 5: TrumpsDong folded before Flop (didn't bet)
Seat 6: Brian3810 folded before Flop (didn't bet)
Seat 7: JJ2MG72 (button) folded before Flop (didn't bet)
Seat 8: Sensor (small blind) showed [8h 7d] and lost with two pair, Nin=
es and Eights
Seat 9: fingers911 (big blind) showed [8d 8c] and won (20350) with a fu=
ll house, Eights full of Nines


*********** # 88 **************
PokerStars Hand #172141946933: Tournament #1648990476, $18.20+$1.80 USD=
 Hold'em No Limit - Level X (200/400) - 2017/07/06 20:44:50 ET
Table '1648990476 7' 9-max Seat #8 is the button
Seat 1: lrb1024 (23183 in chips)=20
Seat 2: JJin91 (15785 in chips)=20
Seat 3: E9Polarizer (22155 in chips)=20
Seat 4: RandyVas (14323 in chips)=20
Seat 5: TrumpsDong (6950 in chips)=20
Seat 6: Brian3810 (10300 in chips)=20
Seat 7: JJ2MG72 (26216 in chips)=20
Seat 8: Sensor (7348 in chips)=20
Seat 9: fingers911 (20350 in chips)=20
lrb1024: posts the ante 50
JJin91: posts the ante 50
E9Polarizer: posts the ante 50
RandyVas: posts the ante 50
TrumpsDong: posts the ante 50
Brian3810: posts the ante 50
JJ2MG72: posts the ante 50
Sensor: posts the ante 50
fingers911: posts the ante 50
fingers911: posts small blind 200
lrb1024: posts big blind 400
*** HOLE CARDS ***
Dealt to JJin91 [6c Kc]
JJin91: folds=20
E9Polarizer: raises 500 to 900
RandyVas: folds=20
TrumpsDong: folds=20
Brian3810: folds=20
JJ2MG72: folds=20
Sensor: raises 2850 to 3750
fingers911: folds=20
lrb1024: folds=20
E9Polarizer: raises 18355 to 22105 and is all-in
Sensor: calls 3548 and is all-in
Uncalled bet (14807) returned to E9Polarizer
*** FLOP *** [Th Qs 9c]
*** TURN *** [Th Qs 9c] [Qd]
*** RIVER *** [Th Qs 9c Qd] [As]
*** SHOW DOWN ***
E9Polarizer: shows [Ad Kd] (two pair, Aces and Queens)
Sensor: shows [4s 5d] (a pair of Queens)
E9Polarizer collected 15646 from pot
Sensor finished the tournament in 90th place
*** SUMMARY ***
Total pot 15646 | Rake 0=20
Board [Th Qs 9c Qd As]
Seat 1: lrb1024 (big blind) folded before Flop
Seat 2: JJin91 folded before Flop (didn't bet)
Seat 3: E9Polarizer showed [Ad Kd] and won (15646) with two pair, Aces =
and Queens
Seat 4: RandyVas folded before Flop (didn't bet)
Seat 5: TrumpsDong folded before Flop (didn't bet)
Seat 6: Brian3810 folded before Flop (didn't bet)
Seat 7: JJ2MG72 folded before Flop (didn't bet)
Seat 8: Sensor (button) showed [4s 5d] and lost with a pair of Queens
Seat 9: fingers911 (small blind) folded before Flop


*********** # 89 **************
PokerStars Hand #172141947141: Tournament #1648990476, $18.20+$1.80 USD=
 Hold'em No Limit - Level X (200/400) - 2017/07/06 20:45:40 ET
Table '1648990476 7' 9-max Seat #9 is the button
Seat 1: lrb1024 (22733 in chips)=20
Seat 2: JJin91 (15735 in chips)=20
Seat 3: E9Polarizer (30453 in chips)=20
Seat 4: RandyVas (14273 in chips)=20
Seat 5: TrumpsDong (6900 in chips)=20
Seat 6: Brian3810 (10250 in chips)=20
Seat 7: JJ2MG72 (26166 in chips)=20
Seat 9: fingers911 (20100 in chips)=20
lrb1024: posts the ante 50
JJin91: posts the ante 50
E9Polarizer: posts the ante 50
RandyVas: posts the ante 50
TrumpsDong: posts the ante 50
Brian3810: posts the ante 50
JJ2MG72: posts the ante 50
fingers911: posts the ante 50
lrb1024: posts small blind 200
JJin91: posts big blind 400
*** HOLE CARDS ***
Dealt to JJin91 [Jc Ad]
E9Polarizer: folds=20
RandyVas: folds=20
TrumpsDong: folds=20
Brian3810: raises 600 to 1000
JJ2MG72: folds=20
fingers911: folds=20
lrb1024 has timed out
lrb1024: folds=20
lrb1024 is sitting out
JJin91: calls 600
*** FLOP *** [Ac Td 2c]
JJin91: checks=20
Brian3810: bets 1300
lrb1024 has returned
JJin91 is disconnected=20
JJin91 is connected=20
JJin91: raises 1300 to 2600
Brian3810: folds=20
Uncalled bet (1300) returned to JJin91
JJin91 collected 5200 from pot
JJin91: doesn't show hand=20
*** SUMMARY ***
Total pot 5200 | Rake 0=20
Board [Ac Td 2c]
Seat 1: lrb1024 (small blind) folded before Flop
Seat 2: JJin91 (big blind) collected (5200)
Seat 3: E9Polarizer folded before Flop (didn't bet)
Seat 4: RandyVas folded before Flop (didn't bet)
Seat 5: TrumpsDong folded before Flop (didn't bet)
Seat 6: Brian3810 folded on the Flop
Seat 7: JJ2MG72 folded before Flop (didn't bet)
Seat 9: fingers911 (button) folded before Flop (didn't bet)


*********** # 90 **************
PokerStars Hand #172141947608: Tournament #1648990476, $18.20+$1.80 USD=
 Hold'em No Limit - Level XI (250/500) - 2017/07/06 20:47:12 ET
Table '1648990476 7' 9-max Seat #1 is the button
Seat 1: lrb1024 (22483 in chips)=20
Seat 2: JJin91 (18585 in chips)=20
Seat 3: E9Polarizer (30403 in chips)=20
Seat 4: RandyVas (14223 in chips)=20
Seat 5: TrumpsDong (6850 in chips)=20
Seat 6: Brian3810 (7900 in chips)=20
Seat 7: JJ2MG72 (26116 in chips)=20
Seat 9: fingers911 (20050 in chips)=20
lrb1024: posts the ante 60
JJin91: posts the ante 60
E9Polarizer: posts the ante 60
RandyVas: posts the ante 60
TrumpsDong: posts the ante 60
Brian3810: posts the ante 60
JJ2MG72: posts the ante 60
fingers911: posts the ante 60
JJin91: posts small blind 250
E9Polarizer: posts big blind 500
*** HOLE CARDS ***
Dealt to JJin91 [7s Ah]
RandyVas: folds=20
TrumpsDong: folds=20
Brian3810: folds=20
JJ2MG72: folds=20
fingers911: folds=20
lrb1024: folds=20
JJin91: raises 745 to 1245
E9Polarizer: calls 745
*** FLOP *** [8h 4d Ts]
JJin91: bets 1111
E9Polarizer: calls 1111
*** TURN *** [8h 4d Ts] [Ad]
JJin91: checks=20
E9Polarizer: checks=20
*** RIVER *** [8h 4d Ts Ad] [3s]
JJin91: bets 1772
E9Polarizer: folds=20
Uncalled bet (1772) returned to JJin91
JJin91 collected 5192 from pot
JJin91: doesn't show hand=20
*** SUMMARY ***
Total pot 5192 | Rake 0=20
Board [8h 4d Ts Ad 3s]
Seat 1: lrb1024 (button) folded before Flop (didn't bet)
Seat 2: JJin91 (small blind) collected (5192)
Seat 3: E9Polarizer (big blind) folded on the River
Seat 4: RandyVas folded before Flop (didn't bet)
Seat 5: TrumpsDong folded before Flop (didn't bet)
Seat 6: Brian3810 folded before Flop (didn't bet)
Seat 7: JJ2MG72 folded before Flop (didn't bet)
Seat 9: fingers911 folded before Flop (didn't bet)


*********** # 91 **************
PokerStars Hand #172141948030: Tournament #1648990476, $18.20+$1.80 USD=
 Hold'em No Limit - Level XI (250/500) - 2017/07/06 20:48:42 ET
Table '1648990476 7' 9-max Seat #2 is the button
Seat 1: lrb1024 (22423 in chips)=20
Seat 2: JJin91 (21361 in chips)=20
Seat 3: E9Polarizer (27987 in chips)=20
Seat 4: RandyVas (14163 in chips)=20
Seat 5: TrumpsDong (6790 in chips)=20
Seat 6: Brian3810 (7840 in chips)=20
Seat 7: JJ2MG72 (26056 in chips)=20
Seat 8: CHnet2 (10000 in chips)=20
Seat 9: fingers911 (19990 in chips)=20
lrb1024: posts the ante 60
JJin91: posts the ante 60
E9Polarizer: posts the ante 60
RandyVas: posts the ante 60
TrumpsDong: posts the ante 60
Brian3810: posts the ante 60
JJ2MG72: posts the ante 60
CHnet2: posts the ante 60
fingers911: posts the ante 60
E9Polarizer: posts small blind 250
RandyVas: posts big blind 500
*** HOLE CARDS ***
Dealt to JJin91 [9h Kc]
TrumpsDong: raises 6230 to 6730 and is all-in
Brian3810: folds=20
JJ2MG72: folds=20
CHnet2: calls 6730
fingers911: folds=20
lrb1024: folds=20
JJin91: folds=20
E9Polarizer: folds=20
RandyVas: folds=20
*** FLOP *** [6s 2d Qc]
*** TURN *** [6s 2d Qc] [Ts]
*** RIVER *** [6s 2d Qc Ts] [6d]
*** SHOW DOWN ***
TrumpsDong: shows [3s As] (a pair of Sixes)
CHnet2: shows [9d 9s] (two pair, Nines and Sixes)
CHnet2 collected 14750 from pot
TrumpsDong finished the tournament in 87th place
*** SUMMARY ***
Total pot 14750 | Rake 0=20
Board [6s 2d Qc Ts 6d]
Seat 1: lrb1024 folded before Flop (didn't bet)
Seat 2: JJin91 (button) folded before Flop (didn't bet)
Seat 3: E9Polarizer (small blind) folded before Flop
Seat 4: RandyVas (big blind) folded before Flop
Seat 5: TrumpsDong showed [3s As] and lost with a pair of Sixes
Seat 6: Brian3810 folded before Flop (didn't bet)
Seat 7: JJ2MG72 folded before Flop (didn't bet)
Seat 8: CHnet2 showed [9d 9s] and won (14750) with two pair, Nines and =
Sixes
Seat 9: fingers911 folded before Flop (didn't bet)


*********** # 92 **************
PokerStars Hand #172141948296: Tournament #1648990476, $18.20+$1.80 USD=
 Hold'em No Limit - Level XI (250/500) - 2017/07/06 20:49:40 ET
Table '1648990476 7' 9-max Seat #3 is the button
Seat 1: lrb1024 (22363 in chips)=20
Seat 2: JJin91 (21301 in chips)=20
Seat 3: E9Polarizer (27677 in chips)=20
Seat 4: RandyVas (13603 in chips)=20
Seat 6: Brian3810 (7780 in chips)=20
Seat 7: JJ2MG72 (25996 in chips)=20
Seat 8: CHnet2 (17960 in chips)=20
Seat 9: fingers911 (19930 in chips)=20
lrb1024: posts the ante 60
JJin91: posts the ante 60
E9Polarizer: posts the ante 60
RandyVas: posts the ante 60
Brian3810: posts the ante 60
JJ2MG72: posts the ante 60
CHnet2: posts the ante 60
fingers911: posts the ante 60
RandyVas: posts small blind 250
Brian3810: posts big blind 500
*** HOLE CARDS ***
Dealt to JJin91 [Tc As]
JJ2MG72: folds=20
CHnet2: folds=20
fingers911: folds=20
lrb1024: folds=20
JJin91: raises 555 to 1055
E9Polarizer: folds=20
RandyVas: folds=20
Brian3810: calls 555
*** FLOP *** [6d 4c 8s]
Brian3810: bets 6665 and is all-in
JJin91: folds=20
Uncalled bet (6665) returned to Brian3810
Brian3810 collected 2840 from pot
Brian3810: doesn't show hand=20
*** SUMMARY ***
Total pot 2840 | Rake 0=20
Board [6d 4c 8s]
Seat 1: lrb1024 folded before Flop (didn't bet)
Seat 2: JJin91 folded on the Flop
Seat 3: E9Polarizer (button) folded before Flop (didn't bet)
Seat 4: RandyVas (small blind) folded before Flop
Seat 6: Brian3810 (big blind) collected (2840)
Seat 7: JJ2MG72 folded before Flop (didn't bet)
Seat 8: CHnet2 folded before Flop (didn't bet)
Seat 9: fingers911 folded before Flop (didn't bet)


*********** # 93 **************
PokerStars Hand #172141948488: Tournament #1648990476, $18.20+$1.80 USD=
 Hold'em No Limit - Level XI (250/500) - 2017/07/06 20:50:19 ET
Table '1648990476 7' 9-max Seat #4 is the button
Seat 1: lrb1024 (22303 in chips)=20
Seat 2: JJin91 (20186 in chips)=20
Seat 3: E9Polarizer (27617 in chips)=20
Seat 4: RandyVas (13293 in chips)=20
Seat 6: Brian3810 (9505 in chips)=20
Seat 7: JJ2MG72 (25936 in chips)=20
Seat 8: CHnet2 (17900 in chips)=20
Seat 9: fingers911 (19870 in chips)=20
lrb1024: posts the ante 60
JJin91: posts the ante 60
E9Polarizer: posts the ante 60
RandyVas: posts the ante 60
Brian3810: posts the ante 60
JJ2MG72: posts the ante 60
CHnet2: posts the ante 60
fingers911: posts the ante 60
Brian3810: posts small blind 250
JJ2MG72: posts big blind 500
*** HOLE CARDS ***
Dealt to JJin91 [4d 5c]
CHnet2: folds=20
fingers911: folds=20
lrb1024: folds=20
JJin91: folds=20
E9Polarizer: folds=20
RandyVas: folds=20
Brian3810: raises 1000 to 1500
JJ2MG72: raises 24376 to 25876 and is all-in
Brian3810: folds=20
Uncalled bet (24376) returned to JJ2MG72
JJ2MG72 collected 3480 from pot
JJ2MG72: doesn't show hand=20
*** SUMMARY ***
Total pot 3480 | Rake 0=20
Seat 1: lrb1024 folded before Flop (didn't bet)
Seat 2: JJin91 folded before Flop (didn't bet)
Seat 3: E9Polarizer folded before Flop (didn't bet)
Seat 4: RandyVas (button) folded before Flop (didn't bet)
Seat 6: Brian3810 (small blind) folded before Flop
Seat 7: JJ2MG72 (big blind) collected (3480)
Seat 8: CHnet2 folded before Flop (didn't bet)
Seat 9: fingers911 folded before Flop (didn't bet)


*********** # 94 **************
PokerStars Hand #172141948651: Tournament #1648990476, $18.20+$1.80 USD=
 Hold'em No Limit - Level XI (250/500) - 2017/07/06 20:50:56 ET
Table '1648990476 7' 9-max Seat #6 is the button
Seat 1: lrb1024 (22243 in chips)=20
Seat 2: JJin91 (20126 in chips)=20
Seat 3: E9Polarizer (27557 in chips)=20
Seat 4: RandyVas (13233 in chips)=20
Seat 5: TrumpsDong (10000 in chips)=20
Seat 6: Brian3810 (7945 in chips)=20
Seat 7: JJ2MG72 (27856 in chips)=20
Seat 8: CHnet2 (17840 in chips)=20
Seat 9: fingers911 (19810 in chips)=20
lrb1024: posts the ante 60
JJin91: posts the ante 60
E9Polarizer: posts the ante 60
RandyVas: posts the ante 60
TrumpsDong: posts the ante 60
Brian3810: posts the ante 60
JJ2MG72: posts the ante 60
CHnet2: posts the ante 60
fingers911: posts the ante 60
JJ2MG72: posts small blind 250
CHnet2: posts big blind 500
*** HOLE CARDS ***
Dealt to JJin91 [Th 5c]
fingers911 has timed out
fingers911: folds=20
fingers911 is sitting out
lrb1024: folds=20
JJin91: folds=20
E9Polarizer: folds=20
RandyVas: folds=20
TrumpsDong: raises 750 to 1250
Brian3810: folds=20
JJ2MG72: folds=20
fingers911 has returned
CHnet2: folds=20
Uncalled bet (750) returned to TrumpsDong
TrumpsDong collected 1790 from pot
TrumpsDong: doesn't show hand=20
*** SUMMARY ***
Total pot 1790 | Rake 0=20
Seat 1: lrb1024 folded before Flop (didn't bet)
Seat 2: JJin91 folded before Flop (didn't bet)
Seat 3: E9Polarizer folded before Flop (didn't bet)
Seat 4: RandyVas folded before Flop (didn't bet)
Seat 5: TrumpsDong collected (1790)
Seat 6: Brian3810 (button) folded before Flop (didn't bet)
Seat 7: JJ2MG72 (small blind) folded before Flop
Seat 8: CHnet2 (big blind) folded before Flop
Seat 9: fingers911 folded before Flop (didn't bet)


*********** # 95 **************
PokerStars Hand #172141949118: Tournament #1648990476, $18.20+$1.80 USD=
 Hold'em No Limit - Level XI (250/500) - 2017/07/06 20:52:42 ET
Table '1648990476 7' 9-max Seat #7 is the button
Seat 1: lrb1024 (22183 in chips)=20
Seat 2: JJin91 (20066 in chips)=20
Seat 3: E9Polarizer (27497 in chips)=20
Seat 4: RandyVas (13173 in chips)=20
Seat 5: TrumpsDong (11230 in chips)=20
Seat 6: Brian3810 (7885 in chips)=20
Seat 7: JJ2MG72 (27546 in chips)=20
Seat 8: CHnet2 (17280 in chips)=20
Seat 9: fingers911 (19750 in chips)=20
lrb1024: posts the ante 60
JJin91: posts the ante 60
E9Polarizer: posts the ante 60
RandyVas: posts the ante 60
TrumpsDong: posts the ante 60
Brian3810: posts the ante 60
JJ2MG72: posts the ante 60
CHnet2: posts the ante 60
fingers911: posts the ante 60
CHnet2: posts small blind 250
fingers911: posts big blind 500
*** HOLE CARDS ***
Dealt to JJin91 [4h 5c]
lrb1024: folds=20
JJin91: folds=20
E9Polarizer: folds=20
RandyVas: folds=20
TrumpsDong: raises 750 to 1250
Brian3810: raises 6575 to 7825 and is all-in
JJ2MG72: folds=20
CHnet2: folds=20
fingers911: folds=20
TrumpsDong: calls 6575
*** FLOP *** [9s 6h Ks]
*** TURN *** [9s 6h Ks] [Qc]
*** RIVER *** [9s 6h Ks Qc] [5s]
*** SHOW DOWN ***
TrumpsDong: shows [Jc Ad] (high card Ace)
Brian3810: shows [3d 3h] (a pair of Threes)
Brian3810 collected 16940 from pot
*** SUMMARY ***
Total pot 16940 | Rake 0=20
Board [9s 6h Ks Qc 5s]
Seat 1: lrb1024 folded before Flop (didn't bet)
Seat 2: JJin91 folded before Flop (didn't bet)
Seat 3: E9Polarizer folded before Flop (didn't bet)
Seat 4: RandyVas folded before Flop (didn't bet)
Seat 5: TrumpsDong showed [Jc Ad] and lost with high card Ace
Seat 6: Brian3810 showed [3d 3h] and won (16940) with a pair of Threes
Seat 7: JJ2MG72 (button) folded before Flop (didn't bet)
Seat 8: CHnet2 (small blind) folded before Flop
Seat 9: fingers911 (big blind) folded before Flop


*********** # 96 **************
PokerStars Hand #172141949466: Tournament #1648990476, $18.20+$1.80 USD=
 Hold'em No Limit - Level XI (250/500) - 2017/07/06 20:53:53 ET
Table '1648990476 7' 9-max Seat #8 is the button
Seat 1: lrb1024 (22123 in chips)=20
Seat 2: JJin91 (20006 in chips)=20
Seat 3: E9Polarizer (27437 in chips)=20
Seat 4: RandyVas (13113 in chips)=20
Seat 5: TrumpsDong (3345 in chips)=20
Seat 6: Brian3810 (16940 in chips)=20
Seat 7: JJ2MG72 (27486 in chips)=20
Seat 8: CHnet2 (16970 in chips)=20
Seat 9: fingers911 (19190 in chips)=20
lrb1024: posts the ante 60
JJin91: posts the ante 60
E9Polarizer: posts the ante 60
RandyVas: posts the ante 60
TrumpsDong: posts the ante 60
Brian3810: posts the ante 60
JJ2MG72: posts the ante 60
CHnet2: posts the ante 60
fingers911: posts the ante 60
fingers911: posts small blind 250
lrb1024: posts big blind 500
*** HOLE CARDS ***
Dealt to JJin91 [Js 5d]
JJin91: folds=20
E9Polarizer: folds=20
RandyVas: folds=20
TrumpsDong: raises 2785 to 3285 and is all-in
Brian3810: folds=20
JJ2MG72: folds=20
CHnet2: folds=20
fingers911: calls 3035
lrb1024: calls 2785
*** FLOP *** [4d Qd 3d]
fingers911: checks=20
lrb1024: checks=20
*** TURN *** [4d Qd 3d] [5s]
fingers911: checks=20
lrb1024: checks=20
*** RIVER *** [4d Qd 3d 5s] [Ad]
fingers911: checks=20
lrb1024: checks=20
*** SHOW DOWN ***
fingers911: shows [9c 9h] (a pair of Nines)
lrb1024: shows [7d Kc] (a flush, Ace high)
TrumpsDong: mucks hand=20
lrb1024 collected 10395 from pot
TrumpsDong finished the tournament in 79th place
*** SUMMARY ***
Total pot 10395 | Rake 0=20
Board [4d Qd 3d 5s Ad]
Seat 1: lrb1024 (big blind) showed [7d Kc] and won (10395) with a flush=
, Ace high
Seat 2: JJin91 folded before Flop (didn't bet)
Seat 3: E9Polarizer folded before Flop (didn't bet)
Seat 4: RandyVas folded before Flop (didn't bet)
Seat 5: TrumpsDong mucked [Qs 7s]
Seat 6: Brian3810 folded before Flop (didn't bet)
Seat 7: JJ2MG72 folded before Flop (didn't bet)
Seat 8: CHnet2 (button) folded before Flop (didn't bet)
Seat 9: fingers911 (small blind) showed [9c 9h] and lost with a pair of=
 Nines


*********** # 97 **************
PokerStars Hand #172141949730: Tournament #1648990476, $18.20+$1.80 USD=
 Hold'em No Limit - Level XI (250/500) - 2017/07/06 20:54:48 ET
Table '1648990476 7' 9-max Seat #9 is the button
Seat 1: lrb1024 (29173 in chips)=20
Seat 2: JJin91 (19946 in chips)=20
Seat 3: E9Polarizer (27377 in chips)=20
Seat 4: RandyVas (13053 in chips)=20
Seat 6: Brian3810 (16880 in chips)=20
Seat 7: JJ2MG72 (27426 in chips)=20
Seat 8: CHnet2 (16910 in chips)=20
Seat 9: fingers911 (15845 in chips)=20
lrb1024: posts the ante 60
JJin91: posts the ante 60
E9Polarizer: posts the ante 60
RandyVas: posts the ante 60
Brian3810: posts the ante 60
JJ2MG72: posts the ante 60
CHnet2: posts the ante 60
fingers911: posts the ante 60
lrb1024: posts small blind 250
JJin91: posts big blind 500
*** HOLE CARDS ***
Dealt to JJin91 [7h 2h]
E9Polarizer: folds=20
RandyVas: folds=20
Brian3810: folds=20
JJ2MG72: raises 1500 to 2000
CHnet2: folds=20
fingers911: folds=20
lrb1024: calls 1750
JJin91: folds=20
*** FLOP *** [6h 8d 9s]
lrb1024: checks=20
JJ2MG72: checks=20
*** TURN *** [6h 8d 9s] [6d]
lrb1024: bets 500
JJ2MG72: calls 500
*** RIVER *** [6h 8d 9s 6d] [4s]
lrb1024: bets 500
JJ2MG72: calls 500
*** SHOW DOWN ***
lrb1024: shows [Qd Kd] (a pair of Sixes)
JJ2MG72: shows [Ad Kh] (a pair of Sixes - Ace kicker)
JJ2MG72 collected 6980 from pot
*** SUMMARY ***
Total pot 6980 | Rake 0=20
Board [6h 8d 9s 6d 4s]
Seat 1: lrb1024 (small blind) showed [Qd Kd] and lost with a pair of Si=
xes
Seat 2: JJin91 (big blind) folded before Flop
Seat 3: E9Polarizer folded before Flop (didn't bet)
Seat 4: RandyVas folded before Flop (didn't bet)
Seat 6: Brian3810 folded before Flop (didn't bet)
Seat 7: JJ2MG72 showed [Ad Kh] and won (6980) with a pair of Sixes
Seat 8: CHnet2 folded before Flop (didn't bet)
Seat 9: fingers911 (button) folded before Flop (didn't bet)


*********** # 98 **************
PokerStars Hand #172144646612: Tournament #1648990476, $18.20+$1.80 USD=
 Hold'em No Limit - Level XI (250/500) - 2017/07/06 21:00:44 ET
Table '1648990476 7' 9-max Seat #1 is the button
Seat 1: lrb1024 (26113 in chips)=20
Seat 2: JJin91 (19386 in chips)=20
Seat 3: E9Polarizer (27317 in chips)=20
Seat 4: RandyVas (12993 in chips)=20
Seat 6: Brian3810 (16820 in chips)=20
Seat 7: JJ2MG72 (31346 in chips)=20
Seat 8: CHnet2 (16850 in chips)=20
Seat 9: fingers911 (15785 in chips)=20
lrb1024: posts the ante 60
JJin91: posts the ante 60
E9Polarizer: posts the ante 60
RandyVas: posts the ante 60
Brian3810: posts the ante 60
JJ2MG72: posts the ante 60
CHnet2: posts the ante 60
fingers911: posts the ante 60
JJin91: posts small blind 250
E9Polarizer: posts big blind 500
*** HOLE CARDS ***
Dealt to JJin91 [8h Jc]
RandyVas: calls 500
Brian3810: folds=20
JJ2MG72 has timed out
JJ2MG72: folds=20
JJ2MG72 is sitting out
CHnet2: folds=20
fingers911: folds=20
lrb1024: folds=20
JJin91: folds=20
E9Polarizer: checks=20
*** FLOP *** [3d 4c Qs]
E9Polarizer: checks=20
RandyVas: checks=20
*** TURN *** [3d 4c Qs] [9c]
E9Polarizer: checks=20
RandyVas: bets 500
E9Polarizer: calls 500
*** RIVER *** [3d 4c Qs 9c] [4s]
E9Polarizer: checks=20
RandyVas: checks=20
*** SHOW DOWN ***
E9Polarizer: shows [Kd Ts] (a pair of Fours)
RandyVas: shows [9d Td] (two pair, Nines and Fours)
RandyVas collected 2730 from pot
*** SUMMARY ***
Total pot 2730 | Rake 0=20
Board [3d 4c Qs 9c 4s]
Seat 1: lrb1024 (button) folded before Flop (didn't bet)
Seat 2: JJin91 (small blind) folded before Flop
Seat 3: E9Polarizer (big blind) showed [Kd Ts] and lost with a pair of =
Fours
Seat 4: RandyVas showed [9d Td] and won (2730) with two pair, Nines and=
 Fours
Seat 6: Brian3810 folded before Flop (didn't bet)
Seat 7: JJ2MG72 folded before Flop (didn't bet)
Seat 8: CHnet2 folded before Flop (didn't bet)
Seat 9: fingers911 folded before Flop (didn't bet)


*********** # 99 **************
PokerStars Hand #172144647175: Tournament #1648990476, $18.20+$1.80 USD=
 Hold'em No Limit - Level XII (300/600) - 2017/07/06 21:02:52 ET
Table '1648990476 7' 9-max Seat #2 is the button
Seat 1: lrb1024 (26053 in chips)=20
Seat 2: JJin91 (19076 in chips)=20
Seat 3: E9Polarizer (26257 in chips)=20
Seat 4: RandyVas (14663 in chips)=20
Seat 6: Brian3810 (16760 in chips)=20
Seat 7: JJ2MG72 (31286 in chips) is sitting out
Seat 8: CHnet2 (16790 in chips)=20
Seat 9: fingers911 (15725 in chips)=20
lrb1024: posts the ante 70
JJin91: posts the ante 70
E9Polarizer: posts the ante 70
RandyVas: posts the ante 70
Brian3810: posts the ante 70
JJ2MG72: posts the ante 70
CHnet2: posts the ante 70
fingers911: posts the ante 70
E9Polarizer: posts small blind 300
RandyVas: posts big blind 600
*** HOLE CARDS ***
Dealt to JJin91 [9s 7c]
Brian3810: folds=20
JJ2MG72: folds=20
CHnet2: raises 600 to 1200
fingers911: folds=20
lrb1024: raises 600 to 1800
JJin91: folds=20
E9Polarizer: folds=20
RandyVas: folds=20
CHnet2: calls 600
*** FLOP *** [Qd Jd 9d]
CHnet2: checks=20
lrb1024: bets 2400
CHnet2: folds=20
Uncalled bet (2400) returned to lrb1024
lrb1024 collected 5060 from pot
lrb1024: doesn't show hand=20
*** SUMMARY ***
Total pot 5060 | Rake 0=20
Board [Qd Jd 9d]
Seat 1: lrb1024 collected (5060)
Seat 2: JJin91 (button) folded before Flop (didn't bet)
Seat 3: E9Polarizer (small blind) folded before Flop
Seat 4: RandyVas (big blind) folded before Flop
Seat 6: Brian3810 folded before Flop (didn't bet)
Seat 7: JJ2MG72 folded before Flop (didn't bet)
Seat 8: CHnet2 folded on the Flop
Seat 9: fingers911 folded before Flop (didn't bet)


*********** # 100 **************
PokerStars Hand #172144647455: Tournament #1648990476, $18.20+$1.80 USD=
 Hold'em No Limit - Level XII (300/600) - 2017/07/06 21:04:02 ET
Table '1648990476 7' 9-max Seat #3 is the button
Seat 1: lrb1024 (29243 in chips)=20
Seat 2: JJin91 (19006 in chips)=20
Seat 3: E9Polarizer (25887 in chips)=20
Seat 4: RandyVas (13993 in chips)=20
Seat 6: Brian3810 (16690 in chips)=20
Seat 7: JJ2MG72 (31216 in chips) is sitting out
Seat 8: CHnet2 (14920 in chips)=20
Seat 9: fingers911 (15655 in chips)=20
lrb1024: posts the ante 70
JJin91: posts the ante 70
E9Polarizer: posts the ante 70
RandyVas: posts the ante 70
Brian3810: posts the ante 70
JJ2MG72: posts the ante 70
CHnet2: posts the ante 70
fingers911: posts the ante 70
RandyVas: posts small blind 300
Brian3810: posts big blind 600
*** HOLE CARDS ***
Dealt to JJin91 [Qh Th]
JJ2MG72: folds=20
CHnet2: folds=20
fingers911: folds=20
lrb1024: folds=20
JJin91: raises 666 to 1266
E9Polarizer: raises 2034 to 3300
RandyVas: folds=20
Brian3810: folds=20
JJin91: folds=20
Uncalled bet (2034) returned to E9Polarizer
E9Polarizer collected 3992 from pot
E9Polarizer: doesn't show hand=20
*** SUMMARY ***
Total pot 3992 | Rake 0=20
Seat 1: lrb1024 folded before Flop (didn't bet)
Seat 2: JJin91 folded before Flop
Seat 3: E9Polarizer (button) collected (3992)
Seat 4: RandyVas (small blind) folded before Flop
Seat 6: Brian3810 (big blind) folded before Flop
Seat 7: JJ2MG72 folded before Flop (didn't bet)
Seat 8: CHnet2 folded before Flop (didn't bet)
Seat 9: fingers911 folded before Flop (didn't bet)


*********** # 101 **************
PokerStars Hand #172144647689: Tournament #1648990476, $18.20+$1.80 USD=
 Hold'em No Limit - Level XII (300/600) - 2017/07/06 21:04:52 ET
Table '1648990476 7' 9-max Seat #4 is the button
Seat 1: lrb1024 (29173 in chips)=20
Seat 2: JJin91 (17670 in chips)=20
Seat 3: E9Polarizer (28543 in chips)=20
Seat 4: RandyVas (13623 in chips)=20
Seat 6: Brian3810 (16020 in chips)=20
Seat 7: JJ2MG72 (31146 in chips) is sitting out
Seat 8: CHnet2 (14850 in chips)=20
Seat 9: fingers911 (15585 in chips)=20
lrb1024: posts the ante 70
JJin91: posts the ante 70
E9Polarizer: posts the ante 70
RandyVas: posts the ante 70
Brian3810: posts the ante 70
JJ2MG72: posts the ante 70
CHnet2: posts the ante 70
fingers911: posts the ante 70
Brian3810: posts small blind 300
JJ2MG72: posts big blind 600
*** HOLE CARDS ***
Dealt to JJin91 [3h 4h]
CHnet2: folds=20
fingers911: folds=20
lrb1024: folds=20
JJin91: folds=20
E9Polarizer: raises 600 to 1200
RandyVas: calls 1200
Brian3810: folds=20
JJ2MG72: folds=20
*** FLOP *** [3d 3s Jh]
E9Polarizer: bets 1544
RandyVas: calls 1544
*** TURN *** [3d 3s Jh] [8d]
E9Polarizer: checks=20
RandyVas: checks=20
*** RIVER *** [3d 3s Jh 8d] [Jc]
E9Polarizer: checks=20
RandyVas: checks=20
*** SHOW DOWN ***
E9Polarizer: shows [5h 7h] (two pair, Jacks and Threes)
RandyVas: shows [6c 6s] (two pair, Jacks and Sixes)
RandyVas collected 6948 from pot
*** SUMMARY ***
Total pot 6948 | Rake 0=20
Board [3d 3s Jh 8d Jc]
Seat 1: lrb1024 folded before Flop (didn't bet)
Seat 2: JJin91 folded before Flop (didn't bet)
Seat 3: E9Polarizer showed [5h 7h] and lost with two pair, Jacks and Th=
rees
Seat 4: RandyVas (button) showed [6c 6s] and won (6948) with two pair, =
Jacks and Sixes
Seat 6: Brian3810 (small blind) folded before Flop
Seat 7: JJ2MG72 (big blind) folded before Flop
Seat 8: CHnet2 folded before Flop (didn't bet)
Seat 9: fingers911 folded before Flop (didn't bet)


*********** # 102 **************
PokerStars Hand #172144647964: Tournament #1648990476, $18.20+$1.80 USD=
 Hold'em No Limit - Level XII (300/600) - 2017/07/06 21:05:52 ET
Table '1648990476 7' 9-max Seat #6 is the button
Seat 1: lrb1024 (29103 in chips)=20
Seat 2: JJin91 (17600 in chips)=20
Seat 3: E9Polarizer (25729 in chips)=20
Seat 4: RandyVas (17757 in chips)=20
Seat 5: naplesguy138 (35774 in chips)=20
Seat 6: Brian3810 (15650 in chips)=20
Seat 7: JJ2MG72 (30476 in chips) is sitting out
Seat 8: CHnet2 (14780 in chips)=20
Seat 9: fingers911 (15515 in chips)=20
lrb1024: posts the ante 70
JJin91: posts the ante 70
E9Polarizer: posts the ante 70
RandyVas: posts the ante 70
naplesguy138: posts the ante 70
Brian3810: posts the ante 70
JJ2MG72: posts the ante 70
CHnet2: posts the ante 70
fingers911: posts the ante 70
JJ2MG72: posts small blind 300
CHnet2: posts big blind 600
*** HOLE CARDS ***
Dealt to JJin91 [5c 2h]
fingers911: folds=20
lrb1024: raises 600 to 1200
JJin91: folds=20
E9Polarizer: folds=20
RandyVas: folds=20
naplesguy138: folds=20
Brian3810: calls 1200
JJ2MG72: folds=20
CHnet2: calls 600
*** FLOP *** [Ks Qh Js]
CHnet2: checks=20
lrb1024: checks=20
Brian3810: checks=20
*** TURN *** [Ks Qh Js] [Ac]
CHnet2: checks=20
lrb1024: bets 600
Brian3810: calls 600
CHnet2: calls 600
*** RIVER *** [Ks Qh Js Ac] [3h]
CHnet2: checks=20
lrb1024: bets 600
Brian3810: raises 2199 to 2799
CHnet2: folds=20
lrb1024: calls 2199
*** SHOW DOWN ***
Brian3810: shows [Qc Tc] (a straight, Ten to Ace)
lrb1024: mucks hand=20
Brian3810 collected 11928 from pot
*** SUMMARY ***
Total pot 11928 | Rake 0=20
Board [Ks Qh Js Ac 3h]
Seat 1: lrb1024 mucked [Jc As]
Seat 2: JJin91 folded before Flop (didn't bet)
Seat 3: E9Polarizer folded before Flop (didn't bet)
Seat 4: RandyVas folded before Flop (didn't bet)
Seat 5: naplesguy138 folded before Flop (didn't bet)
Seat 6: Brian3810 (button) showed [Qc Tc] and won (11928) with a straig=
ht, Ten to Ace
Seat 7: JJ2MG72 (small blind) folded before Flop
Seat 8: CHnet2 (big blind) folded on the River
Seat 9: fingers911 folded before Flop (didn't bet)


*********** # 103 **************
PokerStars Hand #172144648297: Tournament #1648990476, $18.20+$1.80 USD=
 Hold'em No Limit - Level XII (300/600) - 2017/07/06 21:06:58 ET
Table '1648990476 7' 9-max Seat #7 is the button
Seat 1: lrb1024 (24434 in chips)=20
Seat 2: JJin91 (17530 in chips)=20
Seat 3: E9Polarizer (25659 in chips)=20
Seat 4: RandyVas (17687 in chips)=20
Seat 5: naplesguy138 (35704 in chips)=20
Seat 6: Brian3810 (22909 in chips)=20
Seat 7: JJ2MG72 (30106 in chips) is sitting out
Seat 8: CHnet2 (12910 in chips)=20
Seat 9: fingers911 (15445 in chips)=20
lrb1024: posts the ante 70
JJin91: posts the ante 70
E9Polarizer: posts the ante 70
RandyVas: posts the ante 70
naplesguy138: posts the ante 70
Brian3810: posts the ante 70
JJ2MG72: posts the ante 70
CHnet2: posts the ante 70
fingers911: posts the ante 70
CHnet2: posts small blind 300
fingers911: posts big blind 600
*** HOLE CARDS ***
Dealt to JJin91 [9c Ad]
lrb1024: folds=20
JJin91: folds=20
E9Polarizer: folds=20
RandyVas: folds=20
naplesguy138: folds=20
Brian3810: folds=20
JJ2MG72: folds=20
CHnet2: calls 300
fingers911: checks=20
*** FLOP *** [Th 3c Js]
CHnet2: bets 600
fingers911: folds=20
Uncalled bet (600) returned to CHnet2
CHnet2 collected 1830 from pot
CHnet2: doesn't show hand=20
*** SUMMARY ***
Total pot 1830 | Rake 0=20
Board [Th 3c Js]
Seat 1: lrb1024 folded before Flop (didn't bet)
Seat 2: JJin91 folded before Flop (didn't bet)
Seat 3: E9Polarizer folded before Flop (didn't bet)
Seat 4: RandyVas folded before Flop (didn't bet)
Seat 5: naplesguy138 folded before Flop (didn't bet)
Seat 6: Brian3810 folded before Flop (didn't bet)
Seat 7: JJ2MG72 (button) folded before Flop (didn't bet)
Seat 8: CHnet2 (small blind) collected (1830)
Seat 9: fingers911 (big blind) folded on the Flop


*********** # 104 **************
PokerStars Hand #172144648416: Tournament #1648990476, $18.20+$1.80 USD=
 Hold'em No Limit - Level XII (300/600) - 2017/07/06 21:07:24 ET
Table '1648990476 7' 9-max Seat #8 is the button
Seat 1: lrb1024 (24364 in chips)=20
Seat 2: JJin91 (17460 in chips)=20
Seat 3: E9Polarizer (25589 in chips)=20
Seat 4: RandyVas (17617 in chips)=20
Seat 5: naplesguy138 (35634 in chips)=20
Seat 6: Brian3810 (22839 in chips)=20
Seat 7: JJ2MG72 (30036 in chips) is sitting out
Seat 8: CHnet2 (14070 in chips)=20
Seat 9: fingers911 (14775 in chips)=20
lrb1024: posts the ante 70
JJin91: posts the ante 70
E9Polarizer: posts the ante 70
RandyVas: posts the ante 70
naplesguy138: posts the ante 70
Brian3810: posts the ante 70
JJ2MG72: posts the ante 70
CHnet2: posts the ante 70
fingers911: posts the ante 70
fingers911: posts small blind 300
lrb1024: posts big blind 600
*** HOLE CARDS ***
Dealt to JJin91 [Kc Qh]
JJin91: raises 666 to 1266
JJ2MG72 has returned
E9Polarizer: folds=20
RandyVas: folds=20
naplesguy138: folds=20
Brian3810: folds=20
JJ2MG72: folds=20
CHnet2: folds=20
fingers911: folds=20
lrb1024: calls 666
*** FLOP *** [9d 2d 3c]
lrb1024: checks=20
JJin91: checks=20
*** TURN *** [9d 2d 3c] [6s]
lrb1024: bets 600
JJin91: calls 600
*** RIVER *** [9d 2d 3c 6s] [Kh]
lrb1024: bets 600
JJin91: raises 1934 to 2534
lrb1024: folds=20
Uncalled bet (1934) returned to JJin91
JJin91 collected 5862 from pot
JJin91: doesn't show hand=20
*** SUMMARY ***
Total pot 5862 | Rake 0=20
Board [9d 2d 3c 6s Kh]
Seat 1: lrb1024 (big blind) folded on the River
Seat 2: JJin91 collected (5862)
Seat 3: E9Polarizer folded before Flop (didn't bet)
Seat 4: RandyVas folded before Flop (didn't bet)
Seat 5: naplesguy138 folded before Flop (didn't bet)
Seat 6: Brian3810 folded before Flop (didn't bet)
Seat 7: JJ2MG72 folded before Flop (didn't bet)
Seat 8: CHnet2 (button) folded before Flop (didn't bet)
Seat 9: fingers911 (small blind) folded before Flop


*********** # 105 **************
PokerStars Hand #172144648759: Tournament #1648990476, $18.20+$1.80 USD=
 Hold'em No Limit - Level XII (300/600) - 2017/07/06 21:08:41 ET
Table '1648990476 7' 9-max Seat #9 is the button
Seat 1: lrb1024 (21828 in chips)=20
Seat 2: JJin91 (20786 in chips)=20
Seat 3: E9Polarizer (25519 in chips)=20
Seat 4: RandyVas (17547 in chips)=20
Seat 5: naplesguy138 (35564 in chips)=20
Seat 7: JJ2MG72 (29966 in chips)=20
Seat 8: CHnet2 (14000 in chips)=20
Seat 9: fingers911 (14405 in chips)=20
lrb1024: posts the ante 70
JJin91: posts the ante 70
E9Polarizer: posts the ante 70
RandyVas: posts the ante 70
naplesguy138: posts the ante 70
JJ2MG72: posts the ante 70
CHnet2: posts the ante 70
fingers911: posts the ante 70
lrb1024: posts small blind 300
JJin91: posts big blind 600
*** HOLE CARDS ***
Dealt to JJin91 [3h 2h]
E9Polarizer: folds=20
RandyVas: folds=20
naplesguy138: folds=20
JJ2MG72: folds=20
CHnet2: raises 600 to 1200
fingers911: calls 1200
lrb1024: folds=20
JJin91: calls 600
*** FLOP *** [Kc Ad Th]
JJin91: checks=20
CHnet2: checks=20
fingers911: bets 2230
JJin91: folds=20
CHnet2: folds=20
Uncalled bet (2230) returned to fingers911
fingers911 collected 4460 from pot
fingers911: doesn't show hand=20
*** SUMMARY ***
Total pot 4460 | Rake 0=20
Board [Kc Ad Th]
Seat 1: lrb1024 (small blind) folded before Flop
Seat 2: JJin91 (big blind) folded on the Flop
Seat 3: E9Polarizer folded before Flop (didn't bet)
Seat 4: RandyVas folded before Flop (didn't bet)
Seat 5: naplesguy138 folded before Flop (didn't bet)
Seat 7: JJ2MG72 folded before Flop (didn't bet)
Seat 8: CHnet2 folded on the Flop
Seat 9: fingers911 (button) collected (4460)


*********** # 106 **************
PokerStars Hand #172144649039: Tournament #1648990476, $18.20+$1.80 USD=
 Hold'em No Limit - Level XII (300/600) - 2017/07/06 21:09:40 ET
Table '1648990476 7' 9-max Seat #1 is the button
Seat 1: lrb1024 (21458 in chips)=20
Seat 2: JJin91 (19516 in chips)=20
Seat 3: E9Polarizer (25449 in chips)=20
Seat 4: RandyVas (17477 in chips)=20
Seat 5: naplesguy138 (35494 in chips)=20
Seat 6: GMMK426 (28910 in chips)=20
Seat 7: JJ2MG72 (29896 in chips)=20
Seat 8: CHnet2 (12730 in chips)=20
Seat 9: fingers911 (17595 in chips)=20
lrb1024: posts the ante 70
JJin91: posts the ante 70
E9Polarizer: posts the ante 70
RandyVas: posts the ante 70
naplesguy138: posts the ante 70
GMMK426: posts the ante 70
JJ2MG72: posts the ante 70
CHnet2: posts the ante 70
fingers911: posts the ante 70
JJin91: posts small blind 300
E9Polarizer: posts big blind 600
*** HOLE CARDS ***
Dealt to JJin91 [2d As]
RandyVas: calls 600
naplesguy138: folds=20
GMMK426: calls 600
JJ2MG72: folds=20
CHnet2: folds=20
fingers911: folds=20
lrb1024 has timed out
lrb1024: folds=20
lrb1024 is sitting out
JJin91: folds=20
lrb1024 has returned
E9Polarizer: checks=20
*** FLOP *** [4s 2c Js]
E9Polarizer: checks=20
RandyVas: bets 1365
GMMK426: folds=20
E9Polarizer: folds=20
Uncalled bet (1365) returned to RandyVas
RandyVas collected 2730 from pot
RandyVas: doesn't show hand=20
*** SUMMARY ***
Total pot 2730 | Rake 0=20
Board [4s 2c Js]
Seat 1: lrb1024 (button) folded before Flop (didn't bet)
Seat 2: JJin91 (small blind) folded before Flop
Seat 3: E9Polarizer (big blind) folded on the Flop
Seat 4: RandyVas collected (2730)
Seat 5: naplesguy138 folded before Flop (didn't bet)
Seat 6: GMMK426 folded on the Flop
Seat 7: JJ2MG72 folded before Flop (didn't bet)
Seat 8: CHnet2 folded before Flop (didn't bet)
Seat 9: fingers911 folded before Flop (didn't bet)


*********** # 107 **************
PokerStars Hand #172144649356: Tournament #1648990476, $18.20+$1.80 USD=
 Hold'em No Limit - Level XII (300/600) - 2017/07/06 21:10:50 ET
Table '1648990476 7' 9-max Seat #2 is the button
Seat 1: lrb1024 (21388 in chips)=20
Seat 2: JJin91 (19146 in chips)=20
Seat 3: E9Polarizer (24779 in chips)=20
Seat 4: RandyVas (19537 in chips)=20
Seat 5: naplesguy138 (35424 in chips)=20
Seat 6: GMMK426 (28240 in chips)=20
Seat 7: JJ2MG72 (29826 in chips)=20
Seat 8: CHnet2 (12660 in chips)=20
Seat 9: fingers911 (17525 in chips)=20
lrb1024: posts the ante 70
JJin91: posts the ante 70
E9Polarizer: posts the ante 70
RandyVas: posts the ante 70
naplesguy138: posts the ante 70
GMMK426: posts the ante 70
JJ2MG72: posts the ante 70
CHnet2: posts the ante 70
fingers911: posts the ante 70
E9Polarizer: posts small blind 300
RandyVas: posts big blind 600
*** HOLE CARDS ***
Dealt to JJin91 [5s 3h]
naplesguy138: folds=20
GMMK426: folds=20
JJ2MG72: folds=20
CHnet2: folds=20
fingers911: raises 600 to 1200
lrb1024: folds=20
JJin91: folds=20
E9Polarizer: folds=20
RandyVas: folds=20
Uncalled bet (600) returned to fingers911
fingers911 collected 2130 from pot
fingers911: doesn't show hand=20
*** SUMMARY ***
Total pot 2130 | Rake 0=20
Seat 1: lrb1024 folded before Flop (didn't bet)
Seat 2: JJin91 (button) folded before Flop (didn't bet)
Seat 3: E9Polarizer (small blind) folded before Flop
Seat 4: RandyVas (big blind) folded before Flop
Seat 5: naplesguy138 folded before Flop (didn't bet)
Seat 6: GMMK426 folded before Flop (didn't bet)
Seat 7: JJ2MG72 folded before Flop (didn't bet)
Seat 8: CHnet2 folded before Flop (didn't bet)
Seat 9: fingers911 collected (2130)


*********** # 108 **************
PokerStars Hand #172144649589: Tournament #1648990476, $18.20+$1.80 USD=
 Hold'em No Limit - Level XIII (350/700) - 2017/07/06 21:11:36 ET
Table '1648990476 7' 9-max Seat #3 is the button
Seat 1: lrb1024 (21318 in chips)=20
Seat 2: JJin91 (19076 in chips)=20
Seat 3: E9Polarizer (24409 in chips)=20
Seat 4: RandyVas (18867 in chips)=20
Seat 5: naplesguy138 (35354 in chips)=20
Seat 6: GMMK426 (28170 in chips)=20
Seat 7: JJ2MG72 (29756 in chips)=20
Seat 8: CHnet2 (12590 in chips)=20
Seat 9: fingers911 (18985 in chips)=20
lrb1024: posts the ante 85
JJin91: posts the ante 85
E9Polarizer: posts the ante 85
RandyVas: posts the ante 85
naplesguy138: posts the ante 85
GMMK426: posts the ante 85
JJ2MG72: posts the ante 85
CHnet2: posts the ante 85
fingers911: posts the ante 85
RandyVas: posts small blind 350
naplesguy138: posts big blind 700
*** HOLE CARDS ***
Dealt to JJin91 [Kh 9d]
GMMK426: raises 1400 to 2100
JJ2MG72: folds=20
CHnet2: folds=20
fingers911: folds=20
lrb1024: folds=20
JJin91: folds=20
E9Polarizer: folds=20
RandyVas: folds=20
naplesguy138: folds=20
Uncalled bet (1400) returned to GMMK426
GMMK426 collected 2515 from pot
GMMK426: doesn't show hand=20
*** SUMMARY ***
Total pot 2515 | Rake 0=20
Seat 1: lrb1024 folded before Flop (didn't bet)
Seat 2: JJin91 folded before Flop (didn't bet)
Seat 3: E9Polarizer (button) folded before Flop (didn't bet)
Seat 4: RandyVas (small blind) folded before Flop
Seat 5: naplesguy138 (big blind) folded before Flop
Seat 6: GMMK426 collected (2515)
Seat 7: JJ2MG72 folded before Flop (didn't bet)
Seat 8: CHnet2 folded before Flop (didn't bet)
Seat 9: fingers911 folded before Flop (didn't bet)


*********** # 109 **************
PokerStars Hand #172144649793: Tournament #1648990476, $18.20+$1.80 USD=
 Hold'em No Limit - Level XIII (350/700) - 2017/07/06 21:12:19 ET
Table '1648990476 7' 9-max Seat #4 is the button
Seat 1: lrb1024 (21233 in chips)=20
Seat 2: JJin91 (18991 in chips)=20
Seat 3: E9Polarizer (24324 in chips)=20
Seat 4: RandyVas (18432 in chips)=20
Seat 5: naplesguy138 (34569 in chips)=20
Seat 6: GMMK426 (29900 in chips)=20
Seat 7: JJ2MG72 (29671 in chips)=20
Seat 8: CHnet2 (12505 in chips)=20
Seat 9: fingers911 (18900 in chips)=20
lrb1024: posts the ante 85
JJin91: posts the ante 85
E9Polarizer: posts the ante 85
RandyVas: posts the ante 85
naplesguy138: posts the ante 85
GMMK426: posts the ante 85
JJ2MG72: posts the ante 85
CHnet2: posts the ante 85
fingers911: posts the ante 85
naplesguy138: posts small blind 350
GMMK426: posts big blind 700
*** HOLE CARDS ***
Dealt to JJin91 [Ah 6d]
JJ2MG72: folds=20
CHnet2: folds=20
fingers911: folds=20
lrb1024: folds=20
JJin91: folds=20
E9Polarizer: raises 700 to 1400
RandyVas: folds=20
naplesguy138: folds=20
GMMK426: folds=20
Uncalled bet (700) returned to E9Polarizer
E9Polarizer collected 2515 from pot
E9Polarizer: doesn't show hand=20
*** SUMMARY ***
Total pot 2515 | Rake 0=20
Seat 1: lrb1024 folded before Flop (didn't bet)
Seat 2: JJin91 folded before Flop (didn't bet)
Seat 3: E9Polarizer collected (2515)
Seat 4: RandyVas (button) folded before Flop (didn't bet)
Seat 5: naplesguy138 (small blind) folded before Flop
Seat 6: GMMK426 (big blind) folded before Flop
Seat 7: JJ2MG72 folded before Flop (didn't bet)
Seat 8: CHnet2 folded before Flop (didn't bet)
Seat 9: fingers911 folded before Flop (didn't bet)


*********** # 110 **************
PokerStars Hand #172144649901: Tournament #1648990476, $18.20+$1.80 USD=
 Hold'em No Limit - Level XIII (350/700) - 2017/07/06 21:12:40 ET
Table '1648990476 7' 9-max Seat #5 is the button
Seat 1: lrb1024 (21148 in chips)=20
Seat 2: JJin91 (18906 in chips)=20
Seat 3: E9Polarizer (26054 in chips)=20
Seat 4: RandyVas (18347 in chips)=20
Seat 5: naplesguy138 (34134 in chips)=20
Seat 6: GMMK426 (29115 in chips)=20
Seat 7: JJ2MG72 (29586 in chips)=20
Seat 8: CHnet2 (12420 in chips)=20
Seat 9: fingers911 (18815 in chips)=20
lrb1024: posts the ante 85
JJin91: posts the ante 85
E9Polarizer: posts the ante 85
RandyVas: posts the ante 85
naplesguy138: posts the ante 85
GMMK426: posts the ante 85
JJ2MG72: posts the ante 85
CHnet2: posts the ante 85
fingers911: posts the ante 85
GMMK426: posts small blind 350
JJ2MG72: posts big blind 700
*** HOLE CARDS ***
Dealt to JJin91 [Jd Ah]
CHnet2: folds=20
fingers911: folds=20
lrb1024: folds=20
JJin91: raises 777 to 1477
E9Polarizer: folds=20
RandyVas: folds=20
naplesguy138: folds=20
GMMK426: folds=20
JJ2MG72: calls 777
*** FLOP *** [3s 6c As]
JJ2MG72: checks=20
JJin91: bets 1994
JJ2MG72: folds=20
Uncalled bet (1994) returned to JJin91
JJin91 collected 4069 from pot
JJin91: doesn't show hand=20
*** SUMMARY ***
Total pot 4069 | Rake 0=20
Board [3s 6c As]
Seat 1: lrb1024 folded before Flop (didn't bet)
Seat 2: JJin91 collected (4069)
Seat 3: E9Polarizer folded before Flop (didn't bet)
Seat 4: RandyVas folded before Flop (didn't bet)
Seat 5: naplesguy138 (button) folded before Flop (didn't bet)
Seat 6: GMMK426 (small blind) folded before Flop
Seat 7: JJ2MG72 (big blind) folded on the Flop
Seat 8: CHnet2 folded before Flop (didn't bet)
Seat 9: fingers911 folded before Flop (didn't bet)


*********** # 111 **************
PokerStars Hand #172145817505: Tournament #1648990476, $18.20+$1.80 USD=
 Hold'em No Limit - Level XIII (350/700) - 2017/07/06 21:13:39 ET
Table '1648990476 7' 9-max Seat #6 is the button
Seat 1: lrb1024 (21063 in chips)=20
Seat 2: JJin91 (21413 in chips)=20
Seat 3: E9Polarizer (25969 in chips)=20
Seat 4: RandyVas (18262 in chips)=20
Seat 5: naplesguy138 (34049 in chips)=20
Seat 6: GMMK426 (28680 in chips)=20
Seat 7: JJ2MG72 (28024 in chips)=20
Seat 8: CHnet2 (12335 in chips)=20
lrb1024: posts the ante 85
JJin91: posts the ante 85
E9Polarizer: posts the ante 85
RandyVas: posts the ante 85
naplesguy138: posts the ante 85
GMMK426: posts the ante 85
JJ2MG72: posts the ante 85
CHnet2: posts the ante 85
JJ2MG72: posts small blind 350
CHnet2: posts big blind 700
*** HOLE CARDS ***
Dealt to JJin91 [Ts 8s]
lrb1024: folds=20
JJin91: folds=20
E9Polarizer: folds=20
RandyVas: folds=20
naplesguy138: folds=20
GMMK426: folds=20
JJ2MG72: calls 350
CHnet2: checks=20
*** FLOP *** [7h As Js]
JJ2MG72: checks=20
CHnet2: bets 700
JJ2MG72: folds=20
Uncalled bet (700) returned to CHnet2
CHnet2 collected 2080 from pot
CHnet2: doesn't show hand=20
*** SUMMARY ***
Total pot 2080 | Rake 0=20
Board [7h As Js]
Seat 1: lrb1024 folded before Flop (didn't bet)
Seat 2: JJin91 folded before Flop (didn't bet)
Seat 3: E9Polarizer folded before Flop (didn't bet)
Seat 4: RandyVas folded before Flop (didn't bet)
Seat 5: naplesguy138 folded before Flop (didn't bet)
Seat 6: GMMK426 (button) folded before Flop (didn't bet)
Seat 7: JJ2MG72 (small blind) folded on the Flop
Seat 8: CHnet2 (big blind) collected (2080)


*********** # 112 **************
PokerStars Hand #172145817635: Tournament #1648990476, $18.20+$1.80 USD=
 Hold'em No Limit - Level XIII (350/700) - 2017/07/06 21:14:09 ET
Table '1648990476 7' 9-max Seat #7 is the button
Seat 1: lrb1024 (20978 in chips)=20
Seat 2: JJin91 (21328 in chips)=20
Seat 3: E9Polarizer (25884 in chips)=20
Seat 4: RandyVas (18177 in chips)=20
Seat 5: naplesguy138 (33964 in chips)=20
Seat 6: GMMK426 (28595 in chips)=20
Seat 7: JJ2MG72 (27239 in chips)=20
Seat 8: CHnet2 (13630 in chips)=20
lrb1024: posts the ante 85
JJin91: posts the ante 85
E9Polarizer: posts the ante 85
RandyVas: posts the ante 85
naplesguy138: posts the ante 85
GMMK426: posts the ante 85
JJ2MG72: posts the ante 85
CHnet2: posts the ante 85
CHnet2: posts small blind 350
lrb1024: posts big blind 700
*** HOLE CARDS ***
Dealt to JJin91 [8s Th]
JJin91: folds=20
E9Polarizer: folds=20
RandyVas: folds=20
naplesguy138: raises 700 to 1400
GMMK426: folds=20
JJ2MG72: folds=20
CHnet2: folds=20
lrb1024: folds=20
Uncalled bet (700) returned to naplesguy138
naplesguy138 collected 2430 from pot
naplesguy138: doesn't show hand=20
*** SUMMARY ***
Total pot 2430 | Rake 0=20
Seat 1: lrb1024 (big blind) folded before Flop
Seat 2: JJin91 folded before Flop (didn't bet)
Seat 3: E9Polarizer folded before Flop (didn't bet)
Seat 4: RandyVas folded before Flop (didn't bet)
Seat 5: naplesguy138 collected (2430)
Seat 6: GMMK426 folded before Flop (didn't bet)
Seat 7: JJ2MG72 (button) folded before Flop (didn't bet)
Seat 8: CHnet2 (small blind) folded before Flop


*********** # 113 **************
PokerStars Hand #172145817751: Tournament #1648990476, $18.20+$1.80 USD=
 Hold'em No Limit - Level XIII (350/700) - 2017/07/06 21:14:33 ET
Table '1648990476 7' 9-max Seat #8 is the button
Seat 1: lrb1024 (20193 in chips)=20
Seat 2: JJin91 (21243 in chips)=20
Seat 3: E9Polarizer (25799 in chips)=20
Seat 4: RandyVas (18092 in chips)=20
Seat 5: naplesguy138 (35609 in chips)=20
Seat 6: GMMK426 (28510 in chips)=20
Seat 7: JJ2MG72 (27154 in chips)=20
Seat 8: CHnet2 (13195 in chips)=20
Seat 9: Tmiller198 (27196 in chips) out of hand (moved from another tab=
le into small blind)
lrb1024: posts the ante 85
JJin91: posts the ante 85
E9Polarizer: posts the ante 85
RandyVas: posts the ante 85
naplesguy138: posts the ante 85
GMMK426: posts the ante 85
JJ2MG72: posts the ante 85
CHnet2: posts the ante 85
lrb1024: posts small blind 350
JJin91: posts big blind 700
*** HOLE CARDS ***
Dealt to JJin91 [Ks 8s]
E9Polarizer: folds=20
RandyVas: folds=20
naplesguy138: folds=20
GMMK426: calls 700
JJ2MG72: folds=20
CHnet2: folds=20
lrb1024: calls 350
JJin91: checks=20
*** FLOP *** [4s 9h 5c]
lrb1024: checks=20
JJin91: bets 1114
GMMK426: folds=20
lrb1024: calls 1114
*** TURN *** [4s 9h 5c] [7d]
lrb1024: checks=20
JJin91: checks=20
*** RIVER *** [4s 9h 5c 7d] [6h]
lrb1024: bets 3500
JJin91: raises 5884 to 9384
lrb1024: raises 5884 to 15268
JJin91: raises 4076 to 19344 and is all-in
lrb1024: calls 3026 and is all-in
Uncalled bet (1050) returned to JJin91
*** SHOW DOWN ***
JJin91: shows [Ks 8s] (a straight, Five to Nine)
lrb1024: shows [8d 5d] (a straight, Five to Nine)
lrb1024 collected 20798 from pot
JJin91 collected 20798 from pot
*** SUMMARY ***
Total pot 41596 | Rake 0=20
Board [4s 9h 5c 7d 6h]
Seat 1: lrb1024 (small blind) showed [8d 5d] and won (20798) with a str=
aight, Five to Nine
Seat 2: JJin91 (big blind) showed [Ks 8s] and won (20798) with a straig=
ht, Five to Nine
Seat 3: E9Polarizer folded before Flop (didn't bet)
Seat 4: RandyVas folded before Flop (didn't bet)
Seat 5: naplesguy138 folded before Flop (didn't bet)
Seat 6: GMMK426 folded on the Flop
Seat 7: JJ2MG72 folded before Flop (didn't bet)
Seat 8: CHnet2 (button) folded before Flop (didn't bet)


*********** # 114 **************
PokerStars Hand #172145818212: Tournament #1648990476, $18.20+$1.80 USD=
 Hold'em No Limit - Level XIII (350/700) - 2017/07/06 21:16:09 ET
Table '1648990476 7' 9-max Seat #1 is the button
Seat 1: lrb1024 (20798 in chips)=20
Seat 2: JJin91 (21848 in chips)=20
Seat 3: E9Polarizer (25714 in chips)=20
Seat 4: RandyVas (18007 in chips)=20
Seat 5: naplesguy138 (35524 in chips)=20
Seat 6: GMMK426 (27725 in chips)=20
Seat 7: JJ2MG72 (27069 in chips)=20
Seat 8: CHnet2 (13110 in chips)=20
Seat 9: Tmiller198 (27196 in chips)=20
lrb1024: posts the ante 85
JJin91: posts the ante 85
E9Polarizer: posts the ante 85
RandyVas: posts the ante 85
naplesguy138: posts the ante 85
GMMK426: posts the ante 85
JJ2MG72: posts the ante 85
CHnet2: posts the ante 85
Tmiller198: posts the ante 85
JJin91: posts small blind 350
E9Polarizer: posts big blind 700
*** HOLE CARDS ***
Dealt to JJin91 [Jh 6d]
RandyVas: folds=20
naplesguy138: calls 700
GMMK426: folds=20
JJ2MG72: folds=20
CHnet2: folds=20
Tmiller198: calls 700
lrb1024: folds=20
JJin91: folds=20
E9Polarizer: checks=20
*** FLOP *** [As 4h 5h]
E9Polarizer: checks=20
naplesguy138: checks=20
Tmiller198: checks=20
*** TURN *** [As 4h 5h] [8d]
E9Polarizer: checks=20
naplesguy138: bets 1400
Tmiller198: folds=20
E9Polarizer: calls 1400
*** RIVER *** [As 4h 5h 8d] [Ks]
E9Polarizer: checks=20
naplesguy138: bets 2100
E9Polarizer: folds=20
Uncalled bet (2100) returned to naplesguy138
naplesguy138 collected 6015 from pot
naplesguy138: doesn't show hand=20
*** SUMMARY ***
Total pot 6015 | Rake 0=20
Board [As 4h 5h 8d Ks]
Seat 1: lrb1024 (button) folded before Flop (didn't bet)
Seat 2: JJin91 (small blind) folded before Flop
Seat 3: E9Polarizer (big blind) folded on the River
Seat 4: RandyVas folded before Flop (didn't bet)
Seat 5: naplesguy138 collected (6015)
Seat 6: GMMK426 folded before Flop (didn't bet)
Seat 7: JJ2MG72 folded before Flop (didn't bet)
Seat 8: CHnet2 folded before Flop (didn't bet)
Seat 9: Tmiller198 folded on the Turn


*********** # 115 **************
PokerStars Hand #172145818615: Tournament #1648990476, $18.20+$1.80 USD=
 Hold'em No Limit - Level XIII (350/700) - 2017/07/06 21:17:41 ET
Table '1648990476 7' 9-max Seat #2 is the button
Seat 1: lrb1024 (20713 in chips)=20
Seat 2: JJin91 (21413 in chips)=20
Seat 3: E9Polarizer (23529 in chips)=20
Seat 4: RandyVas (17922 in chips)=20
Seat 5: naplesguy138 (39354 in chips)=20
Seat 6: GMMK426 (27640 in chips)=20
Seat 7: JJ2MG72 (26984 in chips)=20
Seat 8: CHnet2 (13025 in chips)=20
Seat 9: Tmiller198 (26411 in chips)=20
lrb1024: posts the ante 85
JJin91: posts the ante 85
E9Polarizer: posts the ante 85
RandyVas: posts the ante 85
naplesguy138: posts the ante 85
GMMK426: posts the ante 85
JJ2MG72: posts the ante 85
CHnet2: posts the ante 85
Tmiller198: posts the ante 85
E9Polarizer: posts small blind 350
RandyVas: posts big blind 700
*** HOLE CARDS ***
Dealt to JJin91 [Ac 3s]
naplesguy138: folds=20
GMMK426: folds=20
JJ2MG72: raises 700 to 1400
CHnet2: folds=20
Tmiller198: folds=20
lrb1024: folds=20
JJin91: folds=20
E9Polarizer: folds=20
RandyVas: folds=20
Uncalled bet (700) returned to JJ2MG72
JJ2MG72 collected 2515 from pot
JJ2MG72: doesn't show hand=20
*** SUMMARY ***
Total pot 2515 | Rake 0=20
Seat 1: lrb1024 folded before Flop (didn't bet)
Seat 2: JJin91 (button) folded before Flop (didn't bet)
Seat 3: E9Polarizer (small blind) folded before Flop
Seat 4: RandyVas (big blind) folded before Flop
Seat 5: naplesguy138 folded before Flop (didn't bet)
Seat 6: GMMK426 folded before Flop (didn't bet)
Seat 7: JJ2MG72 collected (2515)
Seat 8: CHnet2 folded before Flop (didn't bet)
Seat 9: Tmiller198 folded before Flop (didn't bet)


*********** # 116 **************
PokerStars Hand #172145818779: Tournament #1648990476, $18.20+$1.80 USD=
 Hold'em No Limit - Level XIII (350/700) - 2017/07/06 21:18:14 ET
Table '1648990476 7' 9-max Seat #3 is the button
Seat 1: lrb1024 (20628 in chips)=20
Seat 2: JJin91 (21328 in chips)=20
Seat 3: E9Polarizer (23094 in chips)=20
Seat 4: RandyVas (17137 in chips)=20
Seat 5: naplesguy138 (39269 in chips)=20
Seat 6: GMMK426 (27555 in chips)=20
Seat 7: JJ2MG72 (28714 in chips)=20
Seat 8: CHnet2 (12940 in chips)=20
Seat 9: Tmiller198 (26326 in chips)=20
lrb1024: posts the ante 85
JJin91: posts the ante 85
E9Polarizer: posts the ante 85
RandyVas: posts the ante 85
naplesguy138: posts the ante 85
GMMK426: posts the ante 85
JJ2MG72: posts the ante 85
CHnet2: posts the ante 85
Tmiller198: posts the ante 85
RandyVas: posts small blind 350
naplesguy138: posts big blind 700
*** HOLE CARDS ***
Dealt to JJin91 [8s 6c]
GMMK426: calls 700
JJ2MG72: folds=20
CHnet2: folds=20
Tmiller198: folds=20
lrb1024: folds=20
JJin91: folds=20
E9Polarizer: folds=20
RandyVas: calls 350
naplesguy138: checks=20
*** FLOP *** [3c Tc Jd]
RandyVas: checks=20
naplesguy138: checks=20
GMMK426: bets 2865
RandyVas: folds=20
naplesguy138: folds=20
Uncalled bet (2865) returned to GMMK426
GMMK426 collected 2865 from pot
GMMK426: doesn't show hand=20
*** SUMMARY ***
Total pot 2865 | Rake 0=20
Board [3c Tc Jd]
Seat 1: lrb1024 folded before Flop (didn't bet)
Seat 2: JJin91 folded before Flop (didn't bet)
Seat 3: E9Polarizer (button) folded before Flop (didn't bet)
Seat 4: RandyVas (small blind) folded on the Flop
Seat 5: naplesguy138 (big blind) folded on the Flop
Seat 6: GMMK426 collected (2865)
Seat 7: JJ2MG72 folded before Flop (didn't bet)
Seat 8: CHnet2 folded before Flop (didn't bet)
Seat 9: Tmiller198 folded before Flop (didn't bet)


*********** # 117 **************
PokerStars Hand #172145818981: Tournament #1648990476, $18.20+$1.80 USD=
 Hold'em No Limit - Level XIII (350/700) - 2017/07/06 21:18:59 ET
Table '1648990476 7' 9-max Seat #4 is the button
Seat 1: lrb1024 (20543 in chips)=20
Seat 2: JJin91 (21243 in chips)=20
Seat 3: E9Polarizer (23009 in chips)=20
Seat 4: RandyVas (16352 in chips)=20
Seat 5: naplesguy138 (38484 in chips)=20
Seat 6: GMMK426 (29635 in chips)=20
Seat 7: JJ2MG72 (28629 in chips)=20
Seat 8: CHnet2 (12855 in chips)=20
Seat 9: Tmiller198 (26241 in chips)=20
lrb1024: posts the ante 85
JJin91: posts the ante 85
E9Polarizer: posts the ante 85
RandyVas: posts the ante 85
naplesguy138: posts the ante 85
GMMK426: posts the ante 85
JJ2MG72: posts the ante 85
CHnet2: posts the ante 85
Tmiller198: posts the ante 85
naplesguy138: posts small blind 350
GMMK426: posts big blind 700
*** HOLE CARDS ***
Dealt to JJin91 [6d Jd]
JJ2MG72: calls 700
CHnet2: folds=20
Tmiller198: folds=20
lrb1024: folds=20
JJin91: folds=20
E9Polarizer: raises 1400 to 2100
RandyVas: folds=20
naplesguy138: folds=20
GMMK426: calls 1400
JJ2MG72: calls 1400
*** FLOP *** [3d Jh 9c]
GMMK426: checks=20
JJ2MG72: checks=20
E9Polarizer: checks=20
*** TURN *** [3d Jh 9c] [5s]
GMMK426: bets 4200
JJ2MG72: folds=20
E9Polarizer: folds=20
Uncalled bet (4200) returned to GMMK426
GMMK426 collected 7415 from pot
GMMK426: doesn't show hand=20
*** SUMMARY ***
Total pot 7415 | Rake 0=20
Board [3d Jh 9c 5s]
Seat 1: lrb1024 folded before Flop (didn't bet)
Seat 2: JJin91 folded before Flop (didn't bet)
Seat 3: E9Polarizer folded on the Turn
Seat 4: RandyVas (button) folded before Flop (didn't bet)
Seat 5: naplesguy138 (small blind) folded before Flop
Seat 6: GMMK426 (big blind) collected (7415)
Seat 7: JJ2MG72 folded on the Turn
Seat 8: CHnet2 folded before Flop (didn't bet)
Seat 9: Tmiller198 folded before Flop (didn't bet)


*********** # 118 **************
PokerStars Hand #172145819429: Tournament #1648990476, $18.20+$1.80 USD=
 Hold'em No Limit - Level XIII (350/700) - 2017/07/06 21:20:27 ET
Table '1648990476 7' 9-max Seat #5 is the button
Seat 1: lrb1024 (20458 in chips)=20
Seat 2: JJin91 (21158 in chips)=20
Seat 3: E9Polarizer (20824 in chips)=20
Seat 4: RandyVas (16267 in chips)=20
Seat 5: naplesguy138 (38049 in chips)=20
Seat 6: GMMK426 (34865 in chips)=20
Seat 7: JJ2MG72 (26444 in chips)=20
Seat 9: Tmiller198 (26156 in chips)=20
lrb1024: posts the ante 85
JJin91: posts the ante 85
E9Polarizer: posts the ante 85
RandyVas: posts the ante 85
naplesguy138: posts the ante 85
GMMK426: posts the ante 85
JJ2MG72: posts the ante 85
Tmiller198: posts the ante 85
GMMK426: posts small blind 350
JJ2MG72: posts big blind 700
*** HOLE CARDS ***
Dealt to JJin91 [Qs 6d]
Tmiller198: folds=20
lrb1024: folds=20
JJin91: folds=20
E9Polarizer: folds=20
RandyVas: calls 700
naplesguy138: raises 700 to 1400
GMMK426: folds=20
JJ2MG72: folds=20
RandyVas: calls 700
*** FLOP *** [9c Ac 5c]
RandyVas: checks=20
naplesguy138: bets 2100
RandyVas: raises 4900 to 7000
naplesguy138: folds=20
Uncalled bet (4900) returned to RandyVas
RandyVas collected 8730 from pot
RandyVas: doesn't show hand=20
*** SUMMARY ***
Total pot 8730 | Rake 0=20
Board [9c Ac 5c]
Seat 1: lrb1024 folded before Flop (didn't bet)
Seat 2: JJin91 folded before Flop (didn't bet)
Seat 3: E9Polarizer folded before Flop (didn't bet)
Seat 4: RandyVas collected (8730)
Seat 5: naplesguy138 (button) folded on the Flop
Seat 6: GMMK426 (small blind) folded before Flop
Seat 7: JJ2MG72 (big blind) folded before Flop
Seat 9: Tmiller198 folded before Flop (didn't bet)


*********** # 119 **************
PokerStars Hand #172145819812: Tournament #1648990476, $18.20+$1.80 USD=
 Hold'em No Limit - Level XIV (400/800) - 2017/07/06 21:21:36 ET
Table '1648990476 7' 9-max Seat #6 is the button
Seat 1: lrb1024 (20373 in chips)=20
Seat 2: JJin91 (21073 in chips)=20
Seat 3: E9Polarizer (20739 in chips)=20
Seat 4: RandyVas (21412 in chips)=20
Seat 5: naplesguy138 (34464 in chips)=20
Seat 6: GMMK426 (34430 in chips)=20
Seat 7: JJ2MG72 (25659 in chips)=20
Seat 9: Tmiller198 (26071 in chips)=20
lrb1024: posts the ante 100
JJin91: posts the ante 100
E9Polarizer: posts the ante 100
RandyVas: posts the ante 100
naplesguy138: posts the ante 100
GMMK426: posts the ante 100
JJ2MG72: posts the ante 100
Tmiller198: posts the ante 100
JJ2MG72: posts small blind 400
Tmiller198: posts big blind 800
*** HOLE CARDS ***
Dealt to JJin91 [7s 7d]
lrb1024: folds=20
JJin91: raises 888 to 1688
E9Polarizer: folds=20
RandyVas: folds=20
naplesguy138: folds=20
GMMK426: folds=20
JJ2MG72: folds=20
Tmiller198: folds=20
Uncalled bet (888) returned to JJin91
JJin91 collected 2800 from pot
JJin91: doesn't show hand=20
*** SUMMARY ***
Total pot 2800 | Rake 0=20
Seat 1: lrb1024 folded before Flop (didn't bet)
Seat 2: JJin91 collected (2800)
Seat 3: E9Polarizer folded before Flop (didn't bet)
Seat 4: RandyVas folded before Flop (didn't bet)
Seat 5: naplesguy138 folded before Flop (didn't bet)
Seat 6: GMMK426 (button) folded before Flop (didn't bet)
Seat 7: JJ2MG72 (small blind) folded before Flop
Seat 9: Tmiller198 (big blind) folded before Flop


*********** # 120 **************
PokerStars Hand #172145819929: Tournament #1648990476, $18.20+$1.80 USD=
 Hold'em No Limit - Level XIV (400/800) - 2017/07/06 21:22:02 ET
Table '1648990476 7' 9-max Seat #7 is the button
Seat 1: lrb1024 (20273 in chips)=20
Seat 2: JJin91 (22973 in chips)=20
Seat 3: E9Polarizer (20639 in chips)=20
Seat 4: RandyVas (21312 in chips)=20
Seat 5: naplesguy138 (34364 in chips)=20
Seat 6: GMMK426 (34330 in chips)=20
Seat 7: JJ2MG72 (25159 in chips)=20
Seat 9: Tmiller198 (25171 in chips)=20
lrb1024: posts the ante 100
JJin91: posts the ante 100
E9Polarizer: posts the ante 100
RandyVas: posts the ante 100
naplesguy138: posts the ante 100
GMMK426: posts the ante 100
JJ2MG72: posts the ante 100
Tmiller198: posts the ante 100
Tmiller198: posts small blind 400
lrb1024: posts big blind 800
*** HOLE CARDS ***
Dealt to JJin91 [2d 5c]
JJin91: folds=20
E9Polarizer: folds=20
RandyVas: folds=20
naplesguy138: raises 800 to 1600
GMMK426: folds=20
JJ2MG72: folds=20
Tmiller198: folds=20
lrb1024: calls 800
*** FLOP *** [4d Kh 4h]
lrb1024: checks=20
naplesguy138: checks=20
*** TURN *** [4d Kh 4h] [Td]
lrb1024: bets 2400
naplesguy138: folds=20
Uncalled bet (2400) returned to lrb1024
lrb1024 collected 4400 from pot
lrb1024: doesn't show hand=20
*** SUMMARY ***
Total pot 4400 | Rake 0=20
Board [4d Kh 4h Td]
Seat 1: lrb1024 (big blind) collected (4400)
Seat 2: JJin91 folded before Flop (didn't bet)
Seat 3: E9Polarizer folded before Flop (didn't bet)
Seat 4: RandyVas folded before Flop (didn't bet)
Seat 5: naplesguy138 folded on the Turn
Seat 6: GMMK426 folded before Flop (didn't bet)
Seat 7: JJ2MG72 (button) folded before Flop (didn't bet)
Seat 9: Tmiller198 (small blind) folded before Flop


*********** # 121 **************
PokerStars Hand #172146528001: Tournament #1648990476, $18.20+$1.80 USD=
 Hold'em No Limit - Level XIV (400/800) - 2017/07/06 21:23:00 ET
Table '1648990476 7' 9-max Seat #9 is the button
Seat 1: lrb1024 (22973 in chips)=20
Seat 2: JJin91 (22873 in chips)=20
Seat 3: E9Polarizer (20539 in chips)=20
Seat 4: RandyVas (21212 in chips)=20
Seat 5: naplesguy138 (32664 in chips)=20
Seat 6: GMMK426 (34230 in chips)=20
Seat 7: JJ2MG72 (25059 in chips)=20
Seat 8: sirrylolzzzz (58512 in chips)=20
Seat 9: Tmiller198 (24671 in chips)=20
lrb1024: posts the ante 100
JJin91: posts the ante 100
E9Polarizer: posts the ante 100
RandyVas: posts the ante 100
naplesguy138: posts the ante 100
GMMK426: posts the ante 100
JJ2MG72: posts the ante 100
sirrylolzzzz: posts the ante 100
Tmiller198: posts the ante 100
lrb1024: posts small blind 400
JJin91: posts big blind 800
*** HOLE CARDS ***
Dealt to JJin91 [3d Ah]
E9Polarizer: folds=20
RandyVas: folds=20
naplesguy138: calls 800
GMMK426: raises 1600 to 2400
JJ2MG72: folds=20
sirrylolzzzz: folds=20
Tmiller198: folds=20
lrb1024: folds=20
JJin91: folds=20
naplesguy138: calls 1600
*** FLOP *** [8c 3c 9s]
naplesguy138: bets 3200
GMMK426: folds=20
Uncalled bet (3200) returned to naplesguy138
naplesguy138 collected 6900 from pot
naplesguy138: doesn't show hand=20
*** SUMMARY ***
Total pot 6900 | Rake 0=20
Board [8c 3c 9s]
Seat 1: lrb1024 (small blind) folded before Flop
Seat 2: JJin91 (big blind) folded before Flop
Seat 3: E9Polarizer folded before Flop (didn't bet)
Seat 4: RandyVas folded before Flop (didn't bet)
Seat 5: naplesguy138 collected (6900)
Seat 6: GMMK426 folded on the Flop
Seat 7: JJ2MG72 folded before Flop (didn't bet)
Seat 8: sirrylolzzzz folded before Flop (didn't bet)
Seat 9: Tmiller198 (button) folded before Flop (didn't bet)


*********** # 122 **************
PokerStars Hand #172146528314: Tournament #1648990476, $18.20+$1.80 USD=
 Hold'em No Limit - Level XIV (400/800) - 2017/07/06 21:24:10 ET
Table '1648990476 7' 9-max Seat #1 is the button
Seat 1: lrb1024 (22473 in chips)=20
Seat 2: JJin91 (21973 in chips)=20
Seat 3: E9Polarizer (20439 in chips)=20
Seat 4: RandyVas (21112 in chips)=20
Seat 5: naplesguy138 (37064 in chips)=20
Seat 6: GMMK426 (31730 in chips)=20
Seat 7: JJ2MG72 (24959 in chips)=20
Seat 8: sirrylolzzzz (58412 in chips)=20
Seat 9: Tmiller198 (24571 in chips)=20
lrb1024: posts the ante 100
JJin91: posts the ante 100
E9Polarizer: posts the ante 100
RandyVas: posts the ante 100
naplesguy138: posts the ante 100
GMMK426: posts the ante 100
JJ2MG72: posts the ante 100
sirrylolzzzz: posts the ante 100
Tmiller198: posts the ante 100
JJin91: posts small blind 400
E9Polarizer: posts big blind 800
*** HOLE CARDS ***
Dealt to JJin91 [Ah 9h]
RandyVas: folds=20
naplesguy138: calls 800
GMMK426: folds=20
JJ2MG72: folds=20
sirrylolzzzz: raises 2400 to 3200
Tmiller198: folds=20
lrb1024: folds=20
JJin91: raises 4000 to 7200
E9Polarizer: folds=20
naplesguy138: folds=20
sirrylolzzzz: raises 51112 to 58312 and is all-in
JJin91: folds=20
Uncalled bet (51112) returned to sirrylolzzzz
sirrylolzzzz collected 16900 from pot
sirrylolzzzz: doesn't show hand=20
*** SUMMARY ***
Total pot 16900 | Rake 0=20
Seat 1: lrb1024 (button) folded before Flop (didn't bet)
Seat 2: JJin91 (small blind) folded before Flop
Seat 3: E9Polarizer (big blind) folded before Flop
Seat 4: RandyVas folded before Flop (didn't bet)
Seat 5: naplesguy138 folded before Flop
Seat 6: GMMK426 folded before Flop (didn't bet)
Seat 7: JJ2MG72 folded before Flop (didn't bet)
Seat 8: sirrylolzzzz collected (16900)
Seat 9: Tmiller198 folded before Flop (didn't bet)


*********** # 123 **************
PokerStars Hand #172146528631: Tournament #1648990476, $18.20+$1.80 USD=
 Hold'em No Limit - Level XIV (400/800) - 2017/07/06 21:25:17 ET
Table '1648990476 7' 9-max Seat #2 is the button
Seat 1: lrb1024 (22373 in chips)=20
Seat 2: JJin91 (14673 in chips)=20
Seat 3: E9Polarizer (19539 in chips)=20
Seat 4: RandyVas (21012 in chips)=20
Seat 5: naplesguy138 (36164 in chips)=20
Seat 6: GMMK426 (31630 in chips)=20
Seat 7: JJ2MG72 (24859 in chips)=20
Seat 8: sirrylolzzzz (68012 in chips)=20
Seat 9: Tmiller198 (24471 in chips)=20
lrb1024: posts the ante 100
JJin91: posts the ante 100
E9Polarizer: posts the ante 100
RandyVas: posts the ante 100
naplesguy138: posts the ante 100
GMMK426: posts the ante 100
JJ2MG72: posts the ante 100
sirrylolzzzz: posts the ante 100
Tmiller198: posts the ante 100
E9Polarizer: posts small blind 400
RandyVas: posts big blind 800
*** HOLE CARDS ***
Dealt to JJin91 [5c Td]
naplesguy138: folds=20
GMMK426: folds=20
JJ2MG72: calls 800
sirrylolzzzz: raises 5778 to 6578
Tmiller198: folds=20
lrb1024: folds=20
JJin91: folds=20
E9Polarizer: folds=20
RandyVas: folds=20
JJ2MG72: folds=20
Uncalled bet (5778) returned to sirrylolzzzz
sirrylolzzzz collected 3700 from pot
sirrylolzzzz: doesn't show hand=20
*** SUMMARY ***
Total pot 3700 | Rake 0=20
Seat 1: lrb1024 folded before Flop (didn't bet)
Seat 2: JJin91 (button) folded before Flop (didn't bet)
Seat 3: E9Polarizer (small blind) folded before Flop
Seat 4: RandyVas (big blind) folded before Flop
Seat 5: naplesguy138 folded before Flop (didn't bet)
Seat 6: GMMK426 folded before Flop (didn't bet)
Seat 7: JJ2MG72 folded before Flop
Seat 8: sirrylolzzzz collected (3700)
Seat 9: Tmiller198 folded before Flop (didn't bet)


*********** # 124 **************
PokerStars Hand #172146528836: Tournament #1648990476, $18.20+$1.80 USD=
 Hold'em No Limit - Level XIV (400/800) - 2017/07/06 21:25:57 ET
Table '1648990476 7' 9-max Seat #3 is the button
Seat 1: lrb1024 (22273 in chips)=20
Seat 2: JJin91 (14573 in chips)=20
Seat 3: E9Polarizer (19039 in chips)=20
Seat 4: RandyVas (20112 in chips)=20
Seat 5: naplesguy138 (36064 in chips)=20
Seat 6: GMMK426 (31530 in chips)=20
Seat 7: JJ2MG72 (23959 in chips)=20
Seat 8: sirrylolzzzz (70812 in chips)=20
Seat 9: Tmiller198 (24371 in chips)=20
lrb1024: posts the ante 100
JJin91: posts the ante 100
E9Polarizer: posts the ante 100
RandyVas: posts the ante 100
naplesguy138: posts the ante 100
GMMK426: posts the ante 100
JJ2MG72: posts the ante 100
sirrylolzzzz: posts the ante 100
Tmiller198: posts the ante 100
RandyVas: posts small blind 400
naplesguy138: posts big blind 800
*** HOLE CARDS ***
Dealt to JJin91 [Jd 9c]
GMMK426: folds=20
JJ2MG72: folds=20
sirrylolzzzz: folds=20
Tmiller198: folds=20
lrb1024: folds=20
JJin91: folds=20
E9Polarizer: raises 1200 to 2000
RandyVas: folds=20
naplesguy138: raises 1200 to 3200
E9Polarizer: calls 1200
*** FLOP *** [Ad 2h Ks]
naplesguy138: bets 8000
E9Polarizer: raises 7739 to 15739 and is all-in
naplesguy138: folds=20
Uncalled bet (7739) returned to E9Polarizer
E9Polarizer collected 23700 from pot
E9Polarizer: doesn't show hand=20
*** SUMMARY ***
Total pot 23700 | Rake 0=20
Board [Ad 2h Ks]
Seat 1: lrb1024 folded before Flop (didn't bet)
Seat 2: JJin91 folded before Flop (didn't bet)
Seat 3: E9Polarizer (button) collected (23700)
Seat 4: RandyVas (small blind) folded before Flop
Seat 5: naplesguy138 (big blind) folded on the Flop
Seat 6: GMMK426 folded before Flop (didn't bet)
Seat 7: JJ2MG72 folded before Flop (didn't bet)
Seat 8: sirrylolzzzz folded before Flop (didn't bet)
Seat 9: Tmiller198 folded before Flop (didn't bet)


*********** # 125 **************
PokerStars Hand #172146529101: Tournament #1648990476, $18.20+$1.80 USD=
 Hold'em No Limit - Level XIV (400/800) - 2017/07/06 21:26:51 ET
Table '1648990476 7' 9-max Seat #4 is the button
Seat 1: lrb1024 (22173 in chips)=20
Seat 2: JJin91 (14473 in chips)=20
Seat 3: E9Polarizer (31439 in chips)=20
Seat 4: RandyVas (19612 in chips)=20
Seat 5: naplesguy138 (24764 in chips)=20
Seat 6: GMMK426 (31430 in chips)=20
Seat 7: JJ2MG72 (23859 in chips)=20
Seat 8: sirrylolzzzz (70712 in chips)=20
Seat 9: Tmiller198 (24271 in chips)=20
lrb1024: posts the ante 100
JJin91: posts the ante 100
E9Polarizer: posts the ante 100
RandyVas: posts the ante 100
naplesguy138: posts the ante 100
GMMK426: posts the ante 100
JJ2MG72: posts the ante 100
sirrylolzzzz: posts the ante 100
Tmiller198: posts the ante 100
naplesguy138: posts small blind 400
GMMK426: posts big blind 800
*** HOLE CARDS ***
Dealt to JJin91 [3s Ah]
JJ2MG72: folds=20
sirrylolzzzz: folds=20
Tmiller198: folds=20
lrb1024: folds=20
JJin91: raises 888 to 1688
E9Polarizer: folds=20
RandyVas: folds=20
naplesguy138: folds=20
GMMK426: calls 888
*** FLOP *** [9s 7h 4c]
GMMK426: bets 3200
JJin91: folds=20
Uncalled bet (3200) returned to GMMK426
GMMK426 collected 4676 from pot
GMMK426: doesn't show hand=20
*** SUMMARY ***
Total pot 4676 | Rake 0=20
Board [9s 7h 4c]
Seat 1: lrb1024 folded before Flop (didn't bet)
Seat 2: JJin91 folded on the Flop
Seat 3: E9Polarizer folded before Flop (didn't bet)
Seat 4: RandyVas (button) folded before Flop (didn't bet)
Seat 5: naplesguy138 (small blind) folded before Flop
Seat 6: GMMK426 (big blind) collected (4676)
Seat 7: JJ2MG72 folded before Flop (didn't bet)
Seat 8: sirrylolzzzz folded before Flop (didn't bet)
Seat 9: Tmiller198 folded before Flop (didn't bet)


*********** # 126 **************
PokerStars Hand #172146529333: Tournament #1648990476, $18.20+$1.80 USD=
 Hold'em No Limit - Level XIV (400/800) - 2017/07/06 21:27:40 ET
Table '1648990476 7' 9-max Seat #5 is the button
Seat 1: lrb1024 (22073 in chips)=20
Seat 2: JJin91 (12685 in chips)=20
Seat 3: E9Polarizer (31339 in chips)=20
Seat 4: RandyVas (19512 in chips)=20
Seat 5: naplesguy138 (24264 in chips)=20
Seat 6: GMMK426 (34318 in chips)=20
Seat 7: JJ2MG72 (23759 in chips)=20
Seat 8: sirrylolzzzz (70612 in chips)=20
Seat 9: Tmiller198 (24171 in chips)=20
lrb1024: posts the ante 100
JJin91: posts the ante 100
E9Polarizer: posts the ante 100
RandyVas: posts the ante 100
naplesguy138: posts the ante 100
GMMK426: posts the ante 100
JJ2MG72: posts the ante 100
sirrylolzzzz: posts the ante 100
Tmiller198: posts the ante 100
GMMK426: posts small blind 400
JJ2MG72: posts big blind 800
*** HOLE CARDS ***
Dealt to JJin91 [6d Ts]
sirrylolzzzz: raises 1600 to 2400
Tmiller198: folds=20
lrb1024: folds=20
JJin91: folds=20
E9Polarizer: folds=20
RandyVas: folds=20
naplesguy138: raises 21764 to 24164 and is all-in
GMMK426: folds=20
JJ2MG72: folds=20
sirrylolzzzz: calls 21764
*** FLOP *** [Qd 3d 6h]
*** TURN *** [Qd 3d 6h] [5s]
*** RIVER *** [Qd 3d 6h 5s] [Js]
*** SHOW DOWN ***
sirrylolzzzz: shows [Qc Ac] (a pair of Queens)
naplesguy138: shows [4c 4s] (a pair of Fours)
sirrylolzzzz collected 50428 from pot
naplesguy138 finished the tournament in 44th place
*** SUMMARY ***
Total pot 50428 | Rake 0=20
Board [Qd 3d 6h 5s Js]
Seat 1: lrb1024 folded before Flop (didn't bet)
Seat 2: JJin91 folded before Flop (didn't bet)
Seat 3: E9Polarizer folded before Flop (didn't bet)
Seat 4: RandyVas folded before Flop (didn't bet)
Seat 5: naplesguy138 (button) showed [4c 4s] and lost with a pair of Fo=
urs
Seat 6: GMMK426 (small blind) folded before Flop
Seat 7: JJ2MG72 (big blind) folded before Flop
Seat 8: sirrylolzzzz showed [Qc Ac] and won (50428) with a pair of Quee=
ns
Seat 9: Tmiller198 folded before Flop (didn't bet)


*********** # 127 **************
PokerStars Hand #172146529637: Tournament #1648990476, $18.20+$1.80 USD=
 Hold'em No Limit - Level XIV (400/800) - 2017/07/06 21:28:40 ET
Table '1648990476 7' 9-max Seat #6 is the button
Seat 1: lrb1024 (21973 in chips)=20
Seat 2: JJin91 (12585 in chips)=20
Seat 3: E9Polarizer (31239 in chips)=20
Seat 4: RandyVas (19412 in chips)=20
Seat 6: GMMK426 (33818 in chips)=20
Seat 7: JJ2MG72 (22859 in chips)=20
Seat 8: sirrylolzzzz (96776 in chips)=20
Seat 9: Tmiller198 (24071 in chips)=20
lrb1024: posts the ante 100
JJin91: posts the ante 100
E9Polarizer: posts the ante 100
RandyVas: posts the ante 100
GMMK426: posts the ante 100
JJ2MG72: posts the ante 100
sirrylolzzzz: posts the ante 100
Tmiller198: posts the ante 100
JJ2MG72: posts small blind 400
sirrylolzzzz: posts big blind 800
*** HOLE CARDS ***
Dealt to JJin91 [2d 8s]
Tmiller198: folds=20
lrb1024 has timed out
lrb1024: folds=20
lrb1024 is sitting out
JJin91: folds=20
E9Polarizer: folds=20
RandyVas: folds=20
GMMK426: raises 1600 to 2400
JJ2MG72: folds=20
sirrylolzzzz: calls 1600
*** FLOP *** [6d 9s 4s]
sirrylolzzzz: bets 8000
GMMK426: raises 23318 to 31318 and is all-in
sirrylolzzzz: calls 23318
*** TURN *** [6d 9s 4s] [Jh]
*** RIVER *** [6d 9s 4s Jh] [3s]
*** SHOW DOWN ***
sirrylolzzzz: shows [Kc 9d] (a pair of Nines)
GMMK426: shows [6c 4h] (two pair, Sixes and Fours)
GMMK426 collected 68636 from pot
*** SUMMARY ***
Total pot 68636 | Rake 0=20
Board [6d 9s 4s Jh 3s]
Seat 1: lrb1024 folded before Flop (didn't bet)
Seat 2: JJin91 folded before Flop (didn't bet)
Seat 3: E9Polarizer folded before Flop (didn't bet)
Seat 4: RandyVas folded before Flop (didn't bet)
Seat 6: GMMK426 (button) showed [6c 4h] and won (68636) with two pair, =
Sixes and Fours
Seat 7: JJ2MG72 (small blind) folded before Flop
Seat 8: sirrylolzzzz (big blind) showed [Kc 9d] and lost with a pair of=
 Nines
Seat 9: Tmiller198 folded before Flop (didn't bet)


*********** # 128 **************
PokerStars Hand #172146529889: Tournament #1648990476, $18.20+$1.80 USD=
 Hold'em No Limit - Level XIV (400/800) - 2017/07/06 21:29:31 ET
Table '1648990476 7' 9-max Seat #7 is the button
Seat 1: lrb1024 (21873 in chips) is sitting out
Seat 2: JJin91 (12485 in chips)=20
Seat 3: E9Polarizer (31139 in chips)=20
Seat 4: RandyVas (19312 in chips)=20
Seat 6: GMMK426 (68636 in chips)=20
Seat 7: JJ2MG72 (22359 in chips)=20
Seat 8: sirrylolzzzz (62958 in chips)=20
Seat 9: Tmiller198 (23971 in chips)=20
lrb1024: posts the ante 100
JJin91: posts the ante 100
E9Polarizer: posts the ante 100
RandyVas: posts the ante 100
GMMK426: posts the ante 100
JJ2MG72: posts the ante 100
sirrylolzzzz: posts the ante 100
Tmiller198: posts the ante 100
sirrylolzzzz: posts small blind 400
Tmiller198: posts big blind 800
*** HOLE CARDS ***
Dealt to JJin91 [2h 3h]
lrb1024: folds=20
JJin91: folds=20
E9Polarizer: raises 800 to 1600
RandyVas: folds=20
GMMK426: folds=20
lrb1024 has returned
JJ2MG72: folds=20
sirrylolzzzz: folds=20
Tmiller198: folds=20
Uncalled bet (800) returned to E9Polarizer
E9Polarizer collected 2800 from pot
E9Polarizer: doesn't show hand=20
*** SUMMARY ***
Total pot 2800 | Rake 0=20
Seat 1: lrb1024 folded before Flop (didn't bet)
Seat 2: JJin91 folded before Flop (didn't bet)
Seat 3: E9Polarizer collected (2800)
Seat 4: RandyVas folded before Flop (didn't bet)
Seat 6: GMMK426 folded before Flop (didn't bet)
Seat 7: JJ2MG72 (button) folded before Flop (didn't bet)
Seat 8: sirrylolzzzz (small blind) folded before Flop
Seat 9: Tmiller198 (big blind) folded before Flop


*********** # 129 **************
PokerStars Hand #172147182163: Tournament #1648990476, $18.20+$1.80 USD=
 Hold'em No Limit - Level XIV (400/800) - 2017/07/06 21:30:07 ET
Table '1648990476 7' 9-max Seat #8 is the button
Seat 1: lrb1024 (21773 in chips)=20
Seat 2: JJin91 (12385 in chips)=20
Seat 3: E9Polarizer (33039 in chips)=20
Seat 4: RandyVas (19212 in chips)=20
Seat 6: GMMK426 (68536 in chips)=20
Seat 7: JJ2MG72 (22259 in chips)=20
Seat 8: sirrylolzzzz (62458 in chips)=20
Seat 9: Tmiller198 (23071 in chips)=20
lrb1024: posts the ante 100
JJin91: posts the ante 100
E9Polarizer: posts the ante 100
RandyVas: posts the ante 100
GMMK426: posts the ante 100
JJ2MG72: posts the ante 100
sirrylolzzzz: posts the ante 100
Tmiller198: posts the ante 100
Tmiller198: posts small blind 400
lrb1024: posts big blind 800
*** HOLE CARDS ***
Dealt to JJin91 [As 9d]
JJin91: raises 11485 to 12285 and is all-in
E9Polarizer: folds=20
RandyVas: folds=20
GMMK426: folds=20
JJ2MG72: folds=20
sirrylolzzzz: raises 50073 to 62358 and is all-in
Tmiller198: folds=20
lrb1024: folds=20
Uncalled bet (50073) returned to sirrylolzzzz
*** FLOP *** [Ad Ts 2h]
*** TURN *** [Ad Ts 2h] [9s]
*** RIVER *** [Ad Ts 2h 9s] [3c]
*** SHOW DOWN ***
JJin91: shows [As 9d] (two pair, Aces and Nines)
sirrylolzzzz: shows [Kh Ac] (a pair of Aces)
JJin91 collected 26570 from pot
*** SUMMARY ***
Total pot 26570 | Rake 0=20
Board [Ad Ts 2h 9s 3c]
Seat 1: lrb1024 (big blind) folded before Flop
Seat 2: JJin91 showed [As 9d] and won (26570) with two pair, Aces and N=
ines
Seat 3: E9Polarizer folded before Flop (didn't bet)
Seat 4: RandyVas folded before Flop (didn't bet)
Seat 6: GMMK426 folded before Flop (didn't bet)
Seat 7: JJ2MG72 folded before Flop (didn't bet)
Seat 8: sirrylolzzzz (button) showed [Kh Ac] and lost with a pair of Ac=
es
Seat 9: Tmiller198 (small blind) folded before Flop


*********** # 130 **************
PokerStars Hand #172147182294: Tournament #1648990476, $18.20+$1.80 USD=
 Hold'em No Limit - Level XIV (400/800) - 2017/07/06 21:30:37 ET
Table '1648990476 7' 9-max Seat #9 is the button
Seat 1: lrb1024 (20873 in chips)=20
Seat 2: JJin91 (26570 in chips)=20
Seat 3: E9Polarizer (32939 in chips)=20
Seat 4: RandyVas (19112 in chips)=20
Seat 6: GMMK426 (68436 in chips)=20
Seat 7: JJ2MG72 (22159 in chips)=20
Seat 8: sirrylolzzzz (50073 in chips)=20
Seat 9: Tmiller198 (22571 in chips)=20
lrb1024: posts the ante 100
JJin91: posts the ante 100
E9Polarizer: posts the ante 100
RandyVas: posts the ante 100
GMMK426: posts the ante 100
JJ2MG72: posts the ante 100
sirrylolzzzz: posts the ante 100
Tmiller198: posts the ante 100
lrb1024: posts small blind 400
JJin91: posts big blind 800
*** HOLE CARDS ***
Dealt to JJin91 [4c Jc]
E9Polarizer: folds=20
RandyVas: folds=20
GMMK426: folds=20
JJ2MG72: folds=20
sirrylolzzzz: calls 800
Tmiller198: folds=20
lrb1024: calls 400
JJin91: checks=20
*** FLOP *** [6c 2h Ac]
lrb1024: checks=20
JJin91: checks=20
sirrylolzzzz: checks=20
*** TURN *** [6c 2h Ac] [Tc]
lrb1024: checks=20
JJin91: checks=20
sirrylolzzzz: checks=20
*** RIVER *** [6c 2h Ac Tc] [6s]
lrb1024: checks=20
JJin91: bets 1056
sirrylolzzzz: folds=20
lrb1024: folds=20
Uncalled bet (1056) returned to JJin91
JJin91 collected 3200 from pot
JJin91: doesn't show hand=20
*** SUMMARY ***
Total pot 3200 | Rake 0=20
Board [6c 2h Ac Tc 6s]
Seat 1: lrb1024 (small blind) folded on the River
Seat 2: JJin91 (big blind) collected (3200)
Seat 3: E9Polarizer folded before Flop (didn't bet)
Seat 4: RandyVas folded before Flop (didn't bet)
Seat 6: GMMK426 folded before Flop (didn't bet)
Seat 7: JJ2MG72 folded before Flop (didn't bet)
Seat 8: sirrylolzzzz folded on the River
Seat 9: Tmiller198 (button) folded before Flop (didn't bet)


*********** # 131 **************
PokerStars Hand #172147182722: Tournament #1648990476, $18.20+$1.80 USD=
 Hold'em No Limit - Level XV (500/1000) - 2017/07/06 21:32:04 ET
Table '1648990476 7' 9-max Seat #1 is the button
Seat 1: lrb1024 (19973 in chips)=20
Seat 2: JJin91 (28870 in chips)=20
Seat 3: E9Polarizer (32839 in chips)=20
Seat 4: RandyVas (19012 in chips)=20
Seat 6: GMMK426 (68336 in chips)=20
Seat 7: JJ2MG72 (22059 in chips)=20
Seat 8: sirrylolzzzz (49173 in chips)=20
Seat 9: Tmiller198 (22471 in chips)=20
lrb1024: posts the ante 125
JJin91: posts the ante 125
E9Polarizer: posts the ante 125
RandyVas: posts the ante 125
GMMK426: posts the ante 125
JJ2MG72: posts the ante 125
sirrylolzzzz: posts the ante 125
Tmiller198: posts the ante 125
JJin91: posts small blind 500
E9Polarizer: posts big blind 1000
*** HOLE CARDS ***
Dealt to JJin91 [6h 7s]
RandyVas: folds=20
GMMK426: calls 1000
JJ2MG72: folds=20
sirrylolzzzz: folds=20
Tmiller198: folds=20
lrb1024: folds=20
JJin91: folds=20
E9Polarizer: checks=20
*** FLOP *** [3h As 7c]
E9Polarizer: checks=20
GMMK426: bets 3500
E9Polarizer: folds=20
Uncalled bet (3500) returned to GMMK426
GMMK426 collected 3500 from pot
GMMK426: doesn't show hand=20
*** SUMMARY ***
Total pot 3500 | Rake 0=20
Board [3h As 7c]
Seat 1: lrb1024 (button) folded before Flop (didn't bet)
Seat 2: JJin91 (small blind) folded before Flop
Seat 3: E9Polarizer (big blind) folded on the Flop
Seat 4: RandyVas folded before Flop (didn't bet)
Seat 6: GMMK426 collected (3500)
Seat 7: JJ2MG72 folded before Flop (didn't bet)
Seat 8: sirrylolzzzz folded before Flop (didn't bet)
Seat 9: Tmiller198 folded before Flop (didn't bet)


*********** # 132 **************
PokerStars Hand #172147183011: Tournament #1648990476, $18.20+$1.80 USD=
 Hold'em No Limit - Level XV (500/1000) - 2017/07/06 21:33:01 ET
Table '1648990476 7' 9-max Seat #2 is the button
Seat 1: lrb1024 (19848 in chips)=20
Seat 2: JJin91 (28245 in chips)=20
Seat 3: E9Polarizer (31714 in chips)=20
Seat 4: RandyVas (18887 in chips)=20
Seat 6: GMMK426 (70711 in chips)=20
Seat 7: JJ2MG72 (21934 in chips)=20
Seat 8: sirrylolzzzz (49048 in chips)=20
Seat 9: Tmiller198 (22346 in chips)=20
lrb1024: posts the ante 125
JJin91: posts the ante 125
E9Polarizer: posts the ante 125
RandyVas: posts the ante 125
GMMK426: posts the ante 125
JJ2MG72: posts the ante 125
sirrylolzzzz: posts the ante 125
Tmiller198: posts the ante 125
E9Polarizer: posts small blind 500
RandyVas: posts big blind 1000
*** HOLE CARDS ***
Dealt to JJin91 [Qs As]
GMMK426: folds=20
JJ2MG72: folds=20
sirrylolzzzz: folds=20
Tmiller198: folds=20
lrb1024: folds=20
JJin91: raises 1110 to 2110
E9Polarizer: folds=20
RandyVas: folds=20
Uncalled bet (1110) returned to JJin91
JJin91 collected 3500 from pot
JJin91: doesn't show hand=20
*** SUMMARY ***
Total pot 3500 | Rake 0=20
Seat 1: lrb1024 folded before Flop (didn't bet)
Seat 2: JJin91 (button) collected (3500)
Seat 3: E9Polarizer (small blind) folded before Flop
Seat 4: RandyVas (big blind) folded before Flop
Seat 6: GMMK426 folded before Flop (didn't bet)
Seat 7: JJ2MG72 folded before Flop (didn't bet)
Seat 8: sirrylolzzzz folded before Flop (didn't bet)
Seat 9: Tmiller198 folded before Flop (didn't bet)


*********** # 133 **************
PokerStars Hand #172147183119: Tournament #1648990476, $18.20+$1.80 USD=
 Hold'em No Limit - Level XV (500/1000) - 2017/07/06 21:33:26 ET
Table '1648990476 7' 9-max Seat #3 is the button
Seat 1: lrb1024 (19723 in chips)=20
Seat 2: JJin91 (30620 in chips)=20
Seat 3: E9Polarizer (31089 in chips)=20
Seat 4: RandyVas (17762 in chips)=20
Seat 6: GMMK426 (70586 in chips)=20
Seat 7: JJ2MG72 (21809 in chips)=20
Seat 8: sirrylolzzzz (48923 in chips)=20
Seat 9: Tmiller198 (22221 in chips)=20
lrb1024: posts the ante 125
JJin91: posts the ante 125
E9Polarizer: posts the ante 125
RandyVas: posts the ante 125
GMMK426: posts the ante 125
JJ2MG72: posts the ante 125
sirrylolzzzz: posts the ante 125
Tmiller198: posts the ante 125
RandyVas: posts small blind 500
GMMK426: posts big blind 1000
*** HOLE CARDS ***
Dealt to JJin91 [2d Qh]
JJ2MG72: calls 1000
sirrylolzzzz: folds=20
Tmiller198: raises 1000 to 2000
lrb1024: folds=20
JJin91: folds=20
E9Polarizer: folds=20
RandyVas: folds=20
GMMK426: calls 1000
JJ2MG72: raises 19684 to 21684 and is all-in
Tmiller198: raises 412 to 22096 and is all-in
GMMK426: folds=20
Uncalled bet (412) returned to Tmiller198
*** FLOP *** [Kh 9c 3h]
*** TURN *** [Kh 9c 3h] [7d]
*** RIVER *** [Kh 9c 3h 7d] [4h]
*** SHOW DOWN ***
JJ2MG72: shows [Qd Ac] (high card Ace)
Tmiller198: shows [Ad As] (a pair of Aces)
Tmiller198 collected 46868 from pot
JJ2MG72 finished the tournament in 39th place
*** SUMMARY ***
Total pot 46868 | Rake 0=20
Board [Kh 9c 3h 7d 4h]
Seat 1: lrb1024 folded before Flop (didn't bet)
Seat 2: JJin91 folded before Flop (didn't bet)
Seat 3: E9Polarizer (button) folded before Flop (didn't bet)
Seat 4: RandyVas (small blind) folded before Flop
Seat 6: GMMK426 (big blind) folded before Flop
Seat 7: JJ2MG72 showed [Qd Ac] and lost with high card Ace
Seat 8: sirrylolzzzz folded before Flop (didn't bet)
Seat 9: Tmiller198 showed [Ad As] and won (46868) with a pair of Aces


*********** # 134 **************
PokerStars Hand #172147183392: Tournament #1648990476, $18.20+$1.80 USD=
 Hold'em No Limit - Level XV (500/1000) - 2017/07/06 21:34:30 ET
Table '1648990476 7' 9-max Seat #4 is the button
Seat 1: lrb1024 (19598 in chips)=20
Seat 2: JJin91 (30495 in chips)=20
Seat 3: E9Polarizer (30964 in chips)=20
Seat 4: RandyVas (17137 in chips)=20
Seat 6: GMMK426 (68461 in chips)=20
Seat 8: sirrylolzzzz (48798 in chips)=20
Seat 9: Tmiller198 (47280 in chips)=20
lrb1024: posts the ante 125
JJin91: posts the ante 125
E9Polarizer: posts the ante 125
RandyVas: posts the ante 125
GMMK426: posts the ante 125
sirrylolzzzz: posts the ante 125
Tmiller198: posts the ante 125
GMMK426: posts small blind 500
sirrylolzzzz: posts big blind 1000
*** HOLE CARDS ***
Dealt to JJin91 [4s 8s]
Tmiller198: folds=20
lrb1024: folds=20
JJin91: folds=20
E9Polarizer: raises 1500 to 2500
RandyVas: calls 2500
GMMK426: calls 2000
sirrylolzzzz: calls 1500
*** FLOP *** [Jd Ks Ah]
GMMK426: checks=20
sirrylolzzzz: bets 3000
E9Polarizer: folds=20
RandyVas: raises 11512 to 14512 and is all-in
GMMK426: folds=20
sirrylolzzzz: folds=20
Uncalled bet (11512) returned to RandyVas
RandyVas collected 16875 from pot
RandyVas: doesn't show hand=20
*** SUMMARY ***
Total pot 16875 | Rake 0=20
Board [Jd Ks Ah]
Seat 1: lrb1024 folded before Flop (didn't bet)
Seat 2: JJin91 folded before Flop (didn't bet)
Seat 3: E9Polarizer folded on the Flop
Seat 4: RandyVas (button) collected (16875)
Seat 6: GMMK426 (small blind) folded on the Flop
Seat 8: sirrylolzzzz (big blind) folded on the Flop
Seat 9: Tmiller198 folded before Flop (didn't bet)


*********** # 135 **************
PokerStars Hand #172147183639: Tournament #1648990476, $18.20+$1.80 USD=
 Hold'em No Limit - Level XV (500/1000) - 2017/07/06 21:35:24 ET
Table '1648990476 7' 9-max Seat #6 is the button
Seat 1: lrb1024 (19473 in chips)=20
Seat 2: JJin91 (30370 in chips)=20
Seat 3: E9Polarizer (28339 in chips)=20
Seat 4: RandyVas (28387 in chips)=20
Seat 6: GMMK426 (65836 in chips)=20
Seat 8: sirrylolzzzz (43173 in chips)=20
Seat 9: Tmiller198 (47155 in chips)=20
lrb1024: posts the ante 125
JJin91: posts the ante 125
E9Polarizer: posts the ante 125
RandyVas: posts the ante 125
GMMK426: posts the ante 125
sirrylolzzzz: posts the ante 125
Tmiller198: posts the ante 125
sirrylolzzzz: posts small blind 500
Tmiller198: posts big blind 1000
*** HOLE CARDS ***
Dealt to JJin91 [3h Td]
lrb1024: folds=20
JJin91: folds=20
E9Polarizer: folds=20
RandyVas: calls 1000
GMMK426: calls 1000
sirrylolzzzz: folds=20
Tmiller198: checks=20
*** FLOP *** [Kd 5d Jd]
Tmiller198: bets 2188
RandyVas: calls 2188
GMMK426: folds=20
*** TURN *** [Kd 5d Jd] [9s]
Tmiller198: bets 4376
RandyVas: calls 4376
*** RIVER *** [Kd 5d Jd 9s] [Ts]
Tmiller198: bets 8752
RandyVas: folds=20
Uncalled bet (8752) returned to Tmiller198
Tmiller198 collected 17503 from pot
Tmiller198: doesn't show hand=20
*** SUMMARY ***
Total pot 17503 | Rake 0=20
Board [Kd 5d Jd 9s Ts]
Seat 1: lrb1024 folded before Flop (didn't bet)
Seat 2: JJin91 folded before Flop (didn't bet)
Seat 3: E9Polarizer folded before Flop (didn't bet)
Seat 4: RandyVas folded on the River
Seat 6: GMMK426 (button) folded on the Flop
Seat 8: sirrylolzzzz (small blind) folded before Flop
Seat 9: Tmiller198 (big blind) collected (17503)


*********** # 136 **************
PokerStars Hand #172147183861: Tournament #1648990476, $18.20+$1.80 USD=
 Hold'em No Limit - Level XV (500/1000) - 2017/07/06 21:36:15 ET
Table '1648990476 7' 9-max Seat #8 is the button
Seat 1: lrb1024 (19348 in chips)=20
Seat 2: JJin91 (30245 in chips)=20
Seat 3: E9Polarizer (28214 in chips)=20
Seat 4: RandyVas (20698 in chips)=20
Seat 6: GMMK426 (64711 in chips)=20
Seat 8: sirrylolzzzz (42548 in chips)=20
Seat 9: Tmiller198 (56969 in chips)=20
lrb1024: posts the ante 125
JJin91: posts the ante 125
E9Polarizer: posts the ante 125
RandyVas: posts the ante 125
GMMK426: posts the ante 125
sirrylolzzzz: posts the ante 125
Tmiller198: posts the ante 125
Tmiller198: posts small blind 500
lrb1024: posts big blind 1000
*** HOLE CARDS ***
Dealt to JJin91 [7s Ad]
JJin91: folds=20
E9Polarizer: folds=20
RandyVas: folds=20
GMMK426: raises 2000 to 3000
sirrylolzzzz: raises 39423 to 42423 and is all-in
Tmiller198: folds=20
lrb1024 has timed out
lrb1024: folds=20
lrb1024 is sitting out
GMMK426: calls 39423
*** FLOP *** [9s 2c 5h]
*** TURN *** [9s 2c 5h] [3s]
*** RIVER *** [9s 2c 5h 3s] [9h]
*** SHOW DOWN ***
GMMK426: shows [Kc Ks] (two pair, Kings and Nines)
sirrylolzzzz: shows [As Jh] (a pair of Nines)
GMMK426 collected 87221 from pot
sirrylolzzzz finished the tournament in 38th place
*** SUMMARY ***
Total pot 87221 | Rake 0=20
Board [9s 2c 5h 3s 9h]
Seat 1: lrb1024 (big blind) folded before Flop
Seat 2: JJin91 folded before Flop (didn't bet)
Seat 3: E9Polarizer folded before Flop (didn't bet)
Seat 4: RandyVas folded before Flop (didn't bet)
Seat 6: GMMK426 showed [Kc Ks] and won (87221) with two pair, Kings and=
 Nines
Seat 8: sirrylolzzzz (button) showed [As Jh] and lost with a pair of Ni=
nes
Seat 9: Tmiller198 (small blind) folded before Flop


*********** # 137 **************
PokerStars Hand #172147184218: Tournament #1648990476, $18.20+$1.80 USD=
 Hold'em No Limit - Level XV (500/1000) - 2017/07/06 21:37:34 ET
Table '1648990476 7' 9-max Seat #9 is the button
Seat 1: lrb1024 (18223 in chips) is sitting out
Seat 2: JJin91 (30120 in chips)=20
Seat 3: E9Polarizer (28089 in chips)=20
Seat 4: RandyVas (20573 in chips)=20
Seat 6: GMMK426 (109384 in chips)=20
Seat 9: Tmiller198 (56344 in chips)=20
lrb1024: posts the ante 125
JJin91: posts the ante 125
E9Polarizer: posts the ante 125
RandyVas: posts the ante 125
GMMK426: posts the ante 125
Tmiller198: posts the ante 125
lrb1024: posts small blind 500
JJin91: posts big blind 1000
*** HOLE CARDS ***
Dealt to JJin91 [5h 3h]
E9Polarizer: folds=20
RandyVas: folds=20
GMMK426: raises 2000 to 3000
Tmiller198: folds=20
lrb1024: folds=20
lrb1024 has returned
JJin91: folds=20
Uncalled bet (2000) returned to GMMK426
GMMK426 collected 3250 from pot
GMMK426: doesn't show hand=20
*** SUMMARY ***
Total pot 3250 | Rake 0=20
Seat 1: lrb1024 (small blind) folded before Flop
Seat 2: JJin91 (big blind) folded before Flop
Seat 3: E9Polarizer folded before Flop (didn't bet)
Seat 4: RandyVas folded before Flop (didn't bet)
Seat 6: GMMK426 collected (3250)
Seat 9: Tmiller198 (button) folded before Flop (didn't bet)


*********** # 138 **************
PokerStars Hand #172147184314: Tournament #1648990476, $18.20+$1.80 USD=
 Hold'em No Limit - Level XV (500/1000) - 2017/07/06 21:37:56 ET
Table '1648990476 7' 9-max Seat #1 is the button
Seat 1: lrb1024 (17598 in chips)=20
Seat 2: JJin91 (28995 in chips)=20
Seat 3: E9Polarizer (27964 in chips)=20
Seat 4: RandyVas (20448 in chips)=20
Seat 6: GMMK426 (111509 in chips)=20
Seat 9: Tmiller198 (56219 in chips)=20
lrb1024: posts the ante 125
JJin91: posts the ante 125
E9Polarizer: posts the ante 125
RandyVas: posts the ante 125
GMMK426: posts the ante 125
Tmiller198: posts the ante 125
JJin91: posts small blind 500
E9Polarizer: posts big blind 1000
*** HOLE CARDS ***
Dealt to JJin91 [Ad Th]
RandyVas: folds=20
GMMK426: folds=20
Tmiller198: folds=20
lrb1024 has timed out
lrb1024: folds=20
lrb1024 is sitting out
lrb1024 has returned
JJin91: raises 1490 to 2490
E9Polarizer: calls 1490
*** FLOP *** [Qd 3h As]
JJin91: checks=20
E9Polarizer: bets 2292
JJin91: calls 2292
*** TURN *** [Qd 3h As] [4s]
JJin91: checks=20
E9Polarizer: checks=20
*** RIVER *** [Qd 3h As 4s] [6s]
JJin91: checks=20
E9Polarizer: checks=20
*** SHOW DOWN ***
JJin91: shows [Ad Th] (a pair of Aces)
E9Polarizer: mucks hand=20
JJin91 collected 10314 from pot
*** SUMMARY ***
Total pot 10314 | Rake 0=20
Board [Qd 3h As 4s 6s]
Seat 1: lrb1024 (button) folded before Flop (didn't bet)
Seat 2: JJin91 (small blind) showed [Ad Th] and won (10314) with a pair=
 of Aces
Seat 3: E9Polarizer (big blind) mucked [8d Ts]
Seat 4: RandyVas folded before Flop (didn't bet)
Seat 6: GMMK426 folded before Flop (didn't bet)
Seat 9: Tmiller198 folded before Flop (didn't bet)


*********** # 139 **************
PokerStars Hand #172147184778: Tournament #1648990476, $18.20+$1.80 USD=
 Hold'em No Limit - Level XV (500/1000) - 2017/07/06 21:39:36 ET
Table '1648990476 7' 9-max Seat #2 is the button
Seat 1: lrb1024 (17473 in chips)=20
Seat 2: JJin91 (34402 in chips)=20
Seat 3: E9Polarizer (23057 in chips)=20
Seat 4: RandyVas (20323 in chips)=20
Seat 5: akbongu1977 (16373 in chips)=20
Seat 6: GMMK426 (111384 in chips)=20
Seat 9: Tmiller198 (56094 in chips)=20
lrb1024: posts the ante 125
JJin91: posts the ante 125
E9Polarizer: posts the ante 125
RandyVas: posts the ante 125
akbongu1977: posts the ante 125
GMMK426: posts the ante 125
Tmiller198: posts the ante 125
E9Polarizer: posts small blind 500
RandyVas: posts big blind 1000
*** HOLE CARDS ***
Dealt to JJin91 [Tc Js]
akbongu1977: folds=20
GMMK426: folds=20
Tmiller198: folds=20
lrb1024: raises 1000 to 2000
JJin91: folds=20
E9Polarizer: folds=20
RandyVas: calls 1000
*** FLOP *** [5s 2s 7d]
RandyVas: bets 18198 and is all-in
lrb1024: folds=20
Uncalled bet (18198) returned to RandyVas
RandyVas collected 5375 from pot
RandyVas: doesn't show hand=20
*** SUMMARY ***
Total pot 5375 | Rake 0=20
Board [5s 2s 7d]
Seat 1: lrb1024 folded on the Flop
Seat 2: JJin91 (button) folded before Flop (didn't bet)
Seat 3: E9Polarizer (small blind) folded before Flop
Seat 4: RandyVas (big blind) collected (5375)
Seat 5: akbongu1977 folded before Flop (didn't bet)
Seat 6: GMMK426 folded before Flop (didn't bet)
Seat 9: Tmiller198 folded before Flop (didn't bet)


*********** # 140 **************
PokerStars Hand #172147184926: Tournament #1648990476, $18.20+$1.80 USD=
 Hold'em No Limit - Level XV (500/1000) - 2017/07/06 21:40:09 ET
Table '1648990476 7' 9-max Seat #3 is the button
Seat 1: lrb1024 (15348 in chips)=20
Seat 2: JJin91 (34277 in chips)=20
Seat 3: E9Polarizer (22432 in chips)=20
Seat 4: RandyVas (23573 in chips)=20
Seat 5: akbongu1977 (16248 in chips)=20
Seat 6: GMMK426 (111259 in chips)=20
Seat 7: fingers911 (12790 in chips)=20
Seat 8: GetLoose17 (47243 in chips)=20
Seat 9: Tmiller198 (55969 in chips)=20
lrb1024: posts the ante 125
JJin91: posts the ante 125
E9Polarizer: posts the ante 125
RandyVas: posts the ante 125
akbongu1977: posts the ante 125
GMMK426: posts the ante 125
fingers911: posts the ante 125
GetLoose17: posts the ante 125
Tmiller198: posts the ante 125
RandyVas: posts small blind 500
akbongu1977: posts big blind 1000
*** HOLE CARDS ***
Dealt to JJin91 [Ts 4s]
GMMK426: raises 2000 to 3000
fingers911: raises 9665 to 12665 and is all-in
GetLoose17: folds=20
Tmiller198: folds=20
lrb1024: folds=20
JJin91: folds=20
E9Polarizer: folds=20
RandyVas: folds=20
akbongu1977: folds=20
GMMK426: calls 9665
*** FLOP *** [Kh Ks 6h]
*** TURN *** [Kh Ks 6h] [8c]
*** RIVER *** [Kh Ks 6h 8c] [3d]
*** SHOW DOWN ***
GMMK426: shows [Qs Ad] (a pair of Kings)
fingers911: shows [8d 8h] (a full house, Eights full of Kings)
fingers911 collected 27955 from pot
*** SUMMARY ***
Total pot 27955 | Rake 0=20
Board [Kh Ks 6h 8c 3d]
Seat 1: lrb1024 folded before Flop (didn't bet)
Seat 2: JJin91 folded before Flop (didn't bet)
Seat 3: E9Polarizer (button) folded before Flop (didn't bet)
Seat 4: RandyVas (small blind) folded before Flop
Seat 5: akbongu1977 (big blind) folded before Flop
Seat 6: GMMK426 showed [Qs Ad] and lost with a pair of Kings
Seat 7: fingers911 showed [8d 8h] and won (27955) with a full house, Ei=
ghts full of Kings
Seat 8: GetLoose17 folded before Flop (didn't bet)
Seat 9: Tmiller198 folded before Flop (didn't bet)


*********** # 141 **************
PokerStars Hand #172147185061: Tournament #1648990476, $18.20+$1.80 USD=
 Hold'em No Limit - Level XV (500/1000) - 2017/07/06 21:40:35 ET
Table '1648990476 7' 9-max Seat #4 is the button
Seat 1: lrb1024 (15223 in chips)=20
Seat 2: JJin91 (34152 in chips)=20
Seat 3: E9Polarizer (22307 in chips)=20
Seat 4: RandyVas (22948 in chips)=20
Seat 5: akbongu1977 (15123 in chips)=20
Seat 6: GMMK426 (98469 in chips)=20
Seat 7: fingers911 (27955 in chips)=20
Seat 8: GetLoose17 (47118 in chips)=20
Seat 9: Tmiller198 (55844 in chips)=20
lrb1024: posts the ante 125
JJin91: posts the ante 125
E9Polarizer: posts the ante 125
RandyVas: posts the ante 125
akbongu1977: posts the ante 125
GMMK426: posts the ante 125
fingers911: posts the ante 125
GetLoose17: posts the ante 125
Tmiller198: posts the ante 125
akbongu1977: posts small blind 500
GMMK426: posts big blind 1000
*** HOLE CARDS ***
Dealt to JJin91 [Qs 7h]
fingers911: folds=20
GetLoose17: folds=20
Tmiller198: folds=20
lrb1024: folds=20
JJin91: folds=20
E9Polarizer: raises 1500 to 2500
RandyVas: raises 7625 to 10125
akbongu1977: folds=20
GMMK426: folds=20
E9Polarizer: folds [Ac]
Uncalled bet (7625) returned to RandyVas
RandyVas collected 7625 from pot
RandyVas: doesn't show hand=20
*** SUMMARY ***
Total pot 7625 | Rake 0=20
Seat 1: lrb1024 folded before Flop (didn't bet)
Seat 2: JJin91 folded before Flop (didn't bet)
Seat 3: E9Polarizer folded before Flop
Seat 4: RandyVas (button) collected (7625)
Seat 5: akbongu1977 (small blind) folded before Flop
Seat 6: GMMK426 (big blind) folded before Flop
Seat 7: fingers911 folded before Flop (didn't bet)
Seat 8: GetLoose17 folded before Flop (didn't bet)
Seat 9: Tmiller198 folded before Flop (didn't bet)


*********** # 142 **************
PokerStars Hand #172147185234: Tournament #1648990476, $18.20+$1.80 USD=
 Hold'em No Limit - Level XV (500/1000) - 2017/07/06 21:41:11 ET
Table '1648990476 7' 9-max Seat #5 is the button
Seat 1: lrb1024 (15098 in chips)=20
Seat 2: JJin91 (34027 in chips)=20
Seat 3: E9Polarizer (19682 in chips)=20
Seat 4: RandyVas (27948 in chips)=20
Seat 5: akbongu1977 (14498 in chips)=20
Seat 6: GMMK426 (97344 in chips)=20
Seat 7: fingers911 (27830 in chips)=20
Seat 8: GetLoose17 (46993 in chips)=20
Seat 9: Tmiller198 (55719 in chips)=20
lrb1024: posts the ante 125
JJin91: posts the ante 125
E9Polarizer: posts the ante 125
RandyVas: posts the ante 125
akbongu1977: posts the ante 125
GMMK426: posts the ante 125
fingers911: posts the ante 125
GetLoose17: posts the ante 125
Tmiller198: posts the ante 125
GMMK426: posts small blind 500
fingers911: posts big blind 1000
*** HOLE CARDS ***
Dealt to JJin91 [Jd 7h]
GetLoose17: folds=20
Tmiller198: folds=20
lrb1024: raises 1000 to 2000
JJin91: folds=20
E9Polarizer: folds=20
RandyVas: calls 2000
akbongu1977: folds=20
GMMK426: calls 1500
fingers911: calls 1000
*** FLOP *** [6c Qh 3s]
GMMK426: checks=20
fingers911: checks=20
lrb1024: bets 12973 and is all-in
RandyVas: folds=20
GMMK426: folds=20
fingers911: folds=20
Uncalled bet (12973) returned to lrb1024
lrb1024 collected 9125 from pot
lrb1024: doesn't show hand=20
*** SUMMARY ***
Total pot 9125 | Rake 0=20
Board [6c Qh 3s]
Seat 1: lrb1024 collected (9125)
Seat 2: JJin91 folded before Flop (didn't bet)
Seat 3: E9Polarizer folded before Flop (didn't bet)
Seat 4: RandyVas folded on the Flop
Seat 5: akbongu1977 (button) folded before Flop (didn't bet)
Seat 6: GMMK426 (small blind) folded on the Flop
Seat 7: fingers911 (big blind) folded on the Flop
Seat 8: GetLoose17 folded before Flop (didn't bet)
Seat 9: Tmiller198 folded before Flop (didn't bet)


*********** # 143 **************
PokerStars Hand #172147185521: Tournament #1648990476, $18.20+$1.80 USD=
 Hold'em No Limit - Level XVI (600/1200) - 2017/07/06 21:42:08 ET
Table '1648990476 7' 9-max Seat #6 is the button
Seat 1: lrb1024 (22098 in chips)=20
Seat 2: JJin91 (33902 in chips)=20
Seat 3: E9Polarizer (19557 in chips)=20
Seat 4: RandyVas (25823 in chips)=20
Seat 5: akbongu1977 (14373 in chips)=20
Seat 6: GMMK426 (95219 in chips)=20
Seat 7: fingers911 (25705 in chips)=20
Seat 8: GetLoose17 (46868 in chips)=20
Seat 9: Tmiller198 (55594 in chips)=20
lrb1024: posts the ante 150
JJin91: posts the ante 150
E9Polarizer: posts the ante 150
RandyVas: posts the ante 150
akbongu1977: posts the ante 150
GMMK426: posts the ante 150
fingers911: posts the ante 150
GetLoose17: posts the ante 150
Tmiller198: posts the ante 150
fingers911: posts small blind 600
GetLoose17: posts big blind 1200
*** HOLE CARDS ***
Dealt to JJin91 [5s 8h]
Tmiller198: folds=20
lrb1024: folds=20
JJin91: folds=20
E9Polarizer: folds=20
RandyVas: raises 1200 to 2400
akbongu1977: folds=20
GMMK426: folds=20
fingers911: folds=20
GetLoose17: calls 1200
*** FLOP *** [Ts 4s 2s]
GetLoose17: checks=20
RandyVas: bets 1200
GetLoose17: calls 1200
*** TURN *** [Ts 4s 2s] [5h]
GetLoose17: checks=20
RandyVas: bets 1200
GetLoose17: calls 1200
*** RIVER *** [Ts 4s 2s 5h] [8s]
GetLoose17: checks=20
RandyVas: bets 1200
GetLoose17: raises 11160 to 12360
RandyVas: calls 11160
*** SHOW DOWN ***
GetLoose17: shows [9c As] (a flush, Ace high)
RandyVas: mucks hand=20
GetLoose17 collected 36270 from pot
*** SUMMARY ***
Total pot 36270 | Rake 0=20
Board [Ts 4s 2s 5h 8s]
Seat 1: lrb1024 folded before Flop (didn't bet)
Seat 2: JJin91 folded before Flop (didn't bet)
Seat 3: E9Polarizer folded before Flop (didn't bet)
Seat 4: RandyVas mucked [Qs Ks]
Seat 5: akbongu1977 folded before Flop (didn't bet)
Seat 6: GMMK426 (button) folded before Flop (didn't bet)
Seat 7: fingers911 (small blind) folded before Flop
Seat 8: GetLoose17 (big blind) showed [9c As] and won (36270) with a fl=
ush, Ace high
Seat 9: Tmiller198 folded before Flop (didn't bet)


*********** # 144 **************
PokerStars Hand #172147185767: Tournament #1648990476, $18.20+$1.80 USD=
 Hold'em No Limit - Level XVI (600/1200) - 2017/07/06 21:42:58 ET
Table '1648990476 7' 9-max Seat #7 is the button
Seat 1: lrb1024 (21948 in chips)=20
Seat 2: JJin91 (33752 in chips)=20
Seat 3: E9Polarizer (19407 in chips)=20
Seat 4: RandyVas (8513 in chips)=20
Seat 5: akbongu1977 (14223 in chips)=20
Seat 6: GMMK426 (95069 in chips)=20
Seat 7: fingers911 (24955 in chips)=20
Seat 8: GetLoose17 (65828 in chips)=20
Seat 9: Tmiller198 (55444 in chips)=20
lrb1024: posts the ante 150
JJin91: posts the ante 150
E9Polarizer: posts the ante 150
RandyVas: posts the ante 150
akbongu1977: posts the ante 150
GMMK426: posts the ante 150
fingers911: posts the ante 150
GetLoose17: posts the ante 150
Tmiller198: posts the ante 150
GetLoose17: posts small blind 600
Tmiller198: posts big blind 1200
*** HOLE CARDS ***
Dealt to JJin91 [8s Ah]
lrb1024: folds=20
JJin91: folds=20
E9Polarizer: folds=20
RandyVas: folds=20
akbongu1977: raises 12873 to 14073 and is all-in
GMMK426: folds=20
fingers911: calls 14073
GetLoose17: folds=20
Tmiller198: folds=20
*** FLOP *** [6s Ks Qs]
*** TURN *** [6s Ks Qs] [3h]
*** RIVER *** [6s Ks Qs 3h] [2d]
*** SHOW DOWN ***
akbongu1977: shows [3d 3c] (three of a kind, Threes)
fingers911: shows [Jc Ac] (high card Ace)
akbongu1977 collected 31296 from pot
*** SUMMARY ***
Total pot 31296 | Rake 0=20
Board [6s Ks Qs 3h 2d]
Seat 1: lrb1024 folded before Flop (didn't bet)
Seat 2: JJin91 folded before Flop (didn't bet)
Seat 3: E9Polarizer folded before Flop (didn't bet)
Seat 4: RandyVas folded before Flop (didn't bet)
Seat 5: akbongu1977 showed [3d 3c] and won (31296) with three of a kind=
, Threes
Seat 6: GMMK426 folded before Flop (didn't bet)
Seat 7: fingers911 (button) showed [Jc Ac] and lost with high card Ace
Seat 8: GetLoose17 (small blind) folded before Flop
Seat 9: Tmiller198 (big blind) folded before Flop


*********** # 145 **************
PokerStars Hand #172147185926: Tournament #1648990476, $18.20+$1.80 USD=
 Hold'em No Limit - Level XVI (600/1200) - 2017/07/06 21:43:35 ET
Table '1648990476 7' 9-max Seat #8 is the button
Seat 1: lrb1024 (21798 in chips)=20
Seat 2: JJin91 (33602 in chips)=20
Seat 3: E9Polarizer (19257 in chips)=20
Seat 4: RandyVas (8363 in chips)=20
Seat 5: akbongu1977 (31296 in chips)=20
Seat 6: GMMK426 (94919 in chips)=20
Seat 7: fingers911 (10732 in chips)=20
Seat 8: GetLoose17 (65078 in chips)=20
Seat 9: Tmiller198 (54094 in chips)=20
lrb1024: posts the ante 150
JJin91: posts the ante 150
E9Polarizer: posts the ante 150
RandyVas: posts the ante 150
akbongu1977: posts the ante 150
GMMK426: posts the ante 150
fingers911: posts the ante 150
GetLoose17: posts the ante 150
Tmiller198: posts the ante 150
Tmiller198: posts small blind 600
lrb1024: posts big blind 1200
*** HOLE CARDS ***
Dealt to JJin91 [5c 6c]
JJin91: folds=20
E9Polarizer: folds=20
RandyVas: folds=20
akbongu1977: folds=20
GMMK426: folds=20
fingers911: folds=20
GetLoose17: folds=20
Tmiller198: folds=20
Uncalled bet (600) returned to lrb1024
lrb1024 collected 2550 from pot
lrb1024: doesn't show hand=20
*** SUMMARY ***
Total pot 2550 | Rake 0=20
Seat 1: lrb1024 (big blind) collected (2550)
Seat 2: JJin91 folded before Flop (didn't bet)
Seat 3: E9Polarizer folded before Flop (didn't bet)
Seat 4: RandyVas folded before Flop (didn't bet)
Seat 5: akbongu1977 folded before Flop (didn't bet)
Seat 6: GMMK426 folded before Flop (didn't bet)
Seat 7: fingers911 folded before Flop (didn't bet)
Seat 8: GetLoose17 (button) folded before Flop (didn't bet)
Seat 9: Tmiller198 (small blind) folded before Flop


*********** # 146 **************
PokerStars Hand #172147186034: Tournament #1648990476, $18.20+$1.80 USD=
 Hold'em No Limit - Level XVI (600/1200) - 2017/07/06 21:43:57 ET
Table '1648990476 7' 9-max Seat #9 is the button
Seat 1: lrb1024 (23598 in chips)=20
Seat 2: JJin91 (33452 in chips)=20
Seat 3: E9Polarizer (19107 in chips)=20
Seat 4: RandyVas (8213 in chips)=20
Seat 5: akbongu1977 (31146 in chips)=20
Seat 6: GMMK426 (94769 in chips)=20
Seat 7: fingers911 (10582 in chips)=20
Seat 8: GetLoose17 (64928 in chips)=20
Seat 9: Tmiller198 (53344 in chips)=20
lrb1024: posts the ante 150
JJin91: posts the ante 150
E9Polarizer: posts the ante 150
RandyVas: posts the ante 150
akbongu1977: posts the ante 150
GMMK426: posts the ante 150
fingers911: posts the ante 150
GetLoose17: posts the ante 150
Tmiller198: posts the ante 150
lrb1024: posts small blind 600
JJin91: posts big blind 1200
*** HOLE CARDS ***
Dealt to JJin91 [9s 3d]
E9Polarizer: folds=20
RandyVas: raises 6863 to 8063 and is all-in
akbongu1977: folds=20
GMMK426: folds=20
fingers911: raises 2369 to 10432 and is all-in
GetLoose17: folds=20
Tmiller198: folds=20
lrb1024: folds=20
JJin91: folds=20
Uncalled bet (2369) returned to fingers911
*** FLOP *** [8c 2c 9h]
*** TURN *** [8c 2c 9h] [8h]
*** RIVER *** [8c 2c 9h 8h] [3c]
*** SHOW DOWN ***
RandyVas: shows [Ts Js] (a pair of Eights)
fingers911: shows [Th Tc] (two pair, Tens and Eights)
fingers911 collected 19276 from pot
RandyVas finished the tournament in 34th place
*** SUMMARY ***
Total pot 19276 | Rake 0=20
Board [8c 2c 9h 8h 3c]
Seat 1: lrb1024 (small blind) folded before Flop
Seat 2: JJin91 (big blind) folded before Flop
Seat 3: E9Polarizer folded before Flop (didn't bet)
Seat 4: RandyVas showed [Ts Js] and lost with a pair of Eights
Seat 5: akbongu1977 folded before Flop (didn't bet)
Seat 6: GMMK426 folded before Flop (didn't bet)
Seat 7: fingers911 showed [Th Tc] and won (19276) with two pair, Tens a=
nd Eights
Seat 8: GetLoose17 folded before Flop (didn't bet)
Seat 9: Tmiller198 (button) folded before Flop (didn't bet)


*********** # 147 **************
PokerStars Hand #172147186198: Tournament #1648990476, $18.20+$1.80 USD=
 Hold'em No Limit - Level XVI (600/1200) - 2017/07/06 21:44:29 ET
Table '1648990476 7' 9-max Seat #1 is the button
Seat 1: lrb1024 (22848 in chips)=20
Seat 2: JJin91 (32102 in chips)=20
Seat 3: E9Polarizer (18957 in chips)=20
Seat 5: akbongu1977 (30996 in chips)=20
Seat 6: GMMK426 (94619 in chips)=20
Seat 7: fingers911 (21645 in chips)=20
Seat 8: GetLoose17 (64778 in chips)=20
Seat 9: Tmiller198 (53194 in chips)=20
lrb1024: posts the ante 150
JJin91: posts the ante 150
E9Polarizer: posts the ante 150
akbongu1977: posts the ante 150
GMMK426: posts the ante 150
fingers911: posts the ante 150
GetLoose17: posts the ante 150
Tmiller198: posts the ante 150
JJin91: posts small blind 600
E9Polarizer: posts big blind 1200
*** HOLE CARDS ***
Dealt to JJin91 [4d 6s]
akbongu1977: folds=20
GMMK426: folds=20
fingers911: raises 1200 to 2400
GetLoose17: folds=20
Tmiller198: folds=20
lrb1024 is disconnected=20
lrb1024 is connected=20
lrb1024: folds=20
JJin91: folds=20
E9Polarizer: calls 1200
*** FLOP *** [Kc 4h 6d]
E9Polarizer: checks=20
fingers911: bets 1200
E9Polarizer: folds=20
Uncalled bet (1200) returned to fingers911
fingers911 collected 6600 from pot
fingers911: doesn't show hand=20
*** SUMMARY ***
Total pot 6600 | Rake 0=20
Board [Kc 4h 6d]
Seat 1: lrb1024 (button) folded before Flop (didn't bet)
Seat 2: JJin91 (small blind) folded before Flop
Seat 3: E9Polarizer (big blind) folded on the Flop
Seat 5: akbongu1977 folded before Flop (didn't bet)
Seat 6: GMMK426 folded before Flop (didn't bet)
Seat 7: fingers911 collected (6600)
Seat 8: GetLoose17 folded before Flop (didn't bet)
Seat 9: Tmiller198 folded before Flop (didn't bet)


*********** # 148 **************
PokerStars Hand #172147186441: Tournament #1648990476, $18.20+$1.80 USD=
 Hold'em No Limit - Level XVI (600/1200) - 2017/07/06 21:45:22 ET
Table '1648990476 7' 9-max Seat #2 is the button
Seat 1: lrb1024 (22698 in chips)=20
Seat 2: JJin91 (31352 in chips)=20
Seat 3: E9Polarizer (16407 in chips)=20
Seat 5: akbongu1977 (30846 in chips)=20
Seat 6: GMMK426 (94469 in chips)=20
Seat 7: fingers911 (25695 in chips)=20
Seat 8: GetLoose17 (64628 in chips)=20
Seat 9: Tmiller198 (53044 in chips)=20
lrb1024: posts the ante 150
JJin91: posts the ante 150
E9Polarizer: posts the ante 150
akbongu1977: posts the ante 150
GMMK426: posts the ante 150
fingers911: posts the ante 150
GetLoose17: posts the ante 150
Tmiller198: posts the ante 150
E9Polarizer: posts small blind 600
akbongu1977: posts big blind 1200
*** HOLE CARDS ***
Dealt to JJin91 [4d Js]
GMMK426: folds=20
fingers911: folds=20
GetLoose17: folds=20
Tmiller198: folds=20
lrb1024: folds=20
JJin91: raises 1332 to 2532
E9Polarizer: raises 13725 to 16257 and is all-in
akbongu1977: folds=20
JJin91: folds=20
Uncalled bet (13725) returned to E9Polarizer
E9Polarizer collected 7464 from pot
E9Polarizer: doesn't show hand=20
*** SUMMARY ***
Total pot 7464 | Rake 0=20
Seat 1: lrb1024 folded before Flop (didn't bet)
Seat 2: JJin91 (button) folded before Flop
Seat 3: E9Polarizer (small blind) collected (7464)
Seat 5: akbongu1977 (big blind) folded before Flop
Seat 6: GMMK426 folded before Flop (didn't bet)
Seat 7: fingers911 folded before Flop (didn't bet)
Seat 8: GetLoose17 folded before Flop (didn't bet)
Seat 9: Tmiller198 folded before Flop (didn't bet)


*********** # 149 **************
PokerStars Hand #172147186619: Tournament #1648990476, $18.20+$1.80 USD=
 Hold'em No Limit - Level XVI (600/1200) - 2017/07/06 21:45:59 ET
Table '1648990476 7' 9-max Seat #3 is the button
Seat 1: lrb1024 (22548 in chips)=20
Seat 2: JJin91 (28670 in chips)=20
Seat 3: E9Polarizer (21189 in chips)=20
Seat 5: akbongu1977 (29496 in chips)=20
Seat 6: GMMK426 (94319 in chips)=20
Seat 7: fingers911 (25545 in chips)=20
Seat 8: GetLoose17 (64478 in chips)=20
Seat 9: Tmiller198 (52894 in chips)=20
lrb1024: posts the ante 150
JJin91: posts the ante 150
E9Polarizer: posts the ante 150
akbongu1977: posts the ante 150
GMMK426: posts the ante 150
fingers911: posts the ante 150
GetLoose17: posts the ante 150
Tmiller198: posts the ante 150
akbongu1977: posts small blind 600
GMMK426: posts big blind 1200
*** HOLE CARDS ***
Dealt to JJin91 [2d 3d]
fingers911: folds=20
GetLoose17: folds=20
Tmiller198: folds=20
lrb1024: folds=20
JJin91: folds=20
E9Polarizer: raises 1800 to 3000
akbongu1977: folds=20
GMMK426: calls 1800
*** FLOP *** [9d 8d 5d]
GMMK426: bets 3900
E9Polarizer: calls 3900
*** TURN *** [9d 8d 5d] [5s]
GMMK426: bets 87269 and is all-in
E9Polarizer: calls 14139 and is all-in
Uncalled bet (73130) returned to GMMK426
*** RIVER *** [9d 8d 5d 5s] [Kc]
*** SHOW DOWN ***
GMMK426: shows [Ac 5h] (three of a kind, Fives)
E9Polarizer: shows [Ad Kd] (a flush, Ace high)
E9Polarizer collected 43878 from pot
*** SUMMARY ***
Total pot 43878 | Rake 0=20
Board [9d 8d 5d 5s Kc]
Seat 1: lrb1024 folded before Flop (didn't bet)
Seat 2: JJin91 folded before Flop (didn't bet)
Seat 3: E9Polarizer (button) showed [Ad Kd] and won (43878) with a flus=
h, Ace high
Seat 5: akbongu1977 (small blind) folded before Flop
Seat 6: GMMK426 (big blind) showed [Ac 5h] and lost with three of a kin=
d, Fives
Seat 7: fingers911 folded before Flop (didn't bet)
Seat 8: GetLoose17 folded before Flop (didn't bet)
Seat 9: Tmiller198 folded before Flop (didn't bet)


*********** # 150 **************
PokerStars Hand #172147186890: Tournament #1648990476, $18.20+$1.80 USD=
 Hold'em No Limit - Level XVI (600/1200) - 2017/07/06 21:47:00 ET
Table '1648990476 7' 9-max Seat #5 is the button
Seat 1: lrb1024 (22398 in chips)=20
Seat 2: JJin91 (28520 in chips)=20
Seat 3: E9Polarizer (43878 in chips)=20
Seat 5: akbongu1977 (28746 in chips)=20
Seat 6: GMMK426 (73130 in chips)=20
Seat 7: fingers911 (25395 in chips)=20
Seat 8: GetLoose17 (64328 in chips)=20
Seat 9: Tmiller198 (52744 in chips)=20
lrb1024: posts the ante 150
JJin91: posts the ante 150
E9Polarizer: posts the ante 150
akbongu1977: posts the ante 150
GMMK426: posts the ante 150
fingers911: posts the ante 150
GetLoose17: posts the ante 150
Tmiller198: posts the ante 150
GMMK426: posts small blind 600
fingers911: posts big blind 1200
*** HOLE CARDS ***
Dealt to JJin91 [5h 8c]
GetLoose17: raises 1800 to 3000
Tmiller198: folds=20
lrb1024: raises 1800 to 4800
JJin91: folds=20
E9Polarizer: folds=20
akbongu1977: folds=20
GMMK426: folds=20
fingers911: folds=20
GetLoose17: calls 1800
*** FLOP *** [5d Kc 5s]
GetLoose17: checks=20
lrb1024: bets 4800
GetLoose17: folds=20
Uncalled bet (4800) returned to lrb1024
lrb1024 collected 12600 from pot
lrb1024: doesn't show hand=20
*** SUMMARY ***
Total pot 12600 | Rake 0=20
Board [5d Kc 5s]
Seat 1: lrb1024 collected (12600)
Seat 2: JJin91 folded before Flop (didn't bet)
Seat 3: E9Polarizer folded before Flop (didn't bet)
Seat 5: akbongu1977 (button) folded before Flop (didn't bet)
Seat 6: GMMK426 (small blind) folded before Flop
Seat 7: fingers911 (big blind) folded before Flop
Seat 8: GetLoose17 folded on the Flop
Seat 9: Tmiller198 folded before Flop (didn't bet)


*********** # 151 **************
PokerStars Hand #172147187097: Tournament #1648990476, $18.20+$1.80 USD=
 Hold'em No Limit - Level XVI (600/1200) - 2017/07/06 21:47:41 ET
Table '1648990476 7' 9-max Seat #6 is the button
Seat 1: lrb1024 (30048 in chips)=20
Seat 2: JJin91 (28370 in chips)=20
Seat 3: E9Polarizer (43728 in chips)=20
Seat 5: akbongu1977 (28596 in chips)=20
Seat 6: GMMK426 (72380 in chips)=20
Seat 7: fingers911 (24045 in chips)=20
Seat 8: GetLoose17 (59378 in chips)=20
Seat 9: Tmiller198 (52594 in chips)=20
lrb1024: posts the ante 150
JJin91: posts the ante 150
E9Polarizer: posts the ante 150
akbongu1977: posts the ante 150
GMMK426: posts the ante 150
fingers911: posts the ante 150
GetLoose17: posts the ante 150
Tmiller198: posts the ante 150
fingers911: posts small blind 600
GetLoose17: posts big blind 1200
*** HOLE CARDS ***
Dealt to JJin91 [Ks 2d]
Tmiller198: folds=20
lrb1024: folds=20
JJin91: folds=20
E9Polarizer: folds=20
akbongu1977: folds=20
GMMK426: folds=20
fingers911: calls 600
GetLoose17: checks=20
*** FLOP *** [9d 3c 5c]
fingers911: bets 1200
GetLoose17: calls 1200
*** TURN *** [9d 3c 5c] [Qs]
fingers911: checks=20
GetLoose17: bets 4800
fingers911: folds=20
Uncalled bet (4800) returned to GetLoose17
GetLoose17 collected 6000 from pot
GetLoose17: doesn't show hand=20
*** SUMMARY ***
Total pot 6000 | Rake 0=20
Board [9d 3c 5c Qs]
Seat 1: lrb1024 folded before Flop (didn't bet)
Seat 2: JJin91 folded before Flop (didn't bet)
Seat 3: E9Polarizer folded before Flop (didn't bet)
Seat 5: akbongu1977 folded before Flop (didn't bet)
Seat 6: GMMK426 (button) folded before Flop (didn't bet)
Seat 7: fingers911 (small blind) folded on the Turn
Seat 8: GetLoose17 (big blind) collected (6000)
Seat 9: Tmiller198 folded before Flop (didn't bet)


*********** # 152 **************
PokerStars Hand #172147187312: Tournament #1648990476, $18.20+$1.80 USD=
 Hold'em No Limit - Level XVI (600/1200) - 2017/07/06 21:48:29 ET
Table '1648990476 7' 9-max Seat #7 is the button
Seat 1: lrb1024 (29898 in chips)=20
Seat 2: JJin91 (28220 in chips)=20
Seat 3: E9Polarizer (43578 in chips)=20
Seat 5: akbongu1977 (28446 in chips)=20
Seat 6: GMMK426 (72230 in chips)=20
Seat 7: fingers911 (21495 in chips)=20
Seat 8: GetLoose17 (62828 in chips)=20
Seat 9: Tmiller198 (52444 in chips)=20
lrb1024: posts the ante 150
JJin91: posts the ante 150
E9Polarizer: posts the ante 150
akbongu1977: posts the ante 150
GMMK426: posts the ante 150
fingers911: posts the ante 150
GetLoose17: posts the ante 150
Tmiller198: posts the ante 150
GetLoose17: posts small blind 600
Tmiller198: posts big blind 1200
*** HOLE CARDS ***
Dealt to JJin91 [2d 2c]
lrb1024: raises 1200 to 2400
JJin91: folds=20
E9Polarizer: calls 2400
akbongu1977: folds=20
GMMK426: folds=20
fingers911: folds=20
GetLoose17: folds=20
Tmiller198: folds=20
*** FLOP *** [2h 5c 4s]
lrb1024: bets 6000
E9Polarizer: folds=20
Uncalled bet (6000) returned to lrb1024
lrb1024 collected 7800 from pot
lrb1024: doesn't show hand=20
*** SUMMARY ***
Total pot 7800 | Rake 0=20
Board [2h 5c 4s]
Seat 1: lrb1024 collected (7800)
Seat 2: JJin91 folded before Flop (didn't bet)
Seat 3: E9Polarizer folded on the Flop
Seat 5: akbongu1977 folded before Flop (didn't bet)
Seat 6: GMMK426 folded before Flop (didn't bet)
Seat 7: fingers911 (button) folded before Flop (didn't bet)
Seat 8: GetLoose17 (small blind) folded before Flop
Seat 9: Tmiller198 (big blind) folded before Flop


*********** # 153 **************
PokerStars Hand #172147187498: Tournament #1648990476, $18.20+$1.80 USD=
 Hold'em No Limit - Level XVI (600/1200) - 2017/07/06 21:49:08 ET
Table '1648990476 7' 9-max Seat #8 is the button
Seat 1: lrb1024 (35148 in chips)=20
Seat 2: JJin91 (28070 in chips)=20
Seat 3: E9Polarizer (41028 in chips)=20
Seat 5: akbongu1977 (28296 in chips)=20
Seat 6: GMMK426 (72080 in chips)=20
Seat 7: fingers911 (21345 in chips)=20
Seat 8: GetLoose17 (62078 in chips)=20
Seat 9: Tmiller198 (51094 in chips)=20
lrb1024: posts the ante 150
JJin91: posts the ante 150
E9Polarizer: posts the ante 150
akbongu1977: posts the ante 150
GMMK426: posts the ante 150
fingers911: posts the ante 150
GetLoose17: posts the ante 150
Tmiller198: posts the ante 150
Tmiller198: posts small blind 600
lrb1024: posts big blind 1200
*** HOLE CARDS ***
Dealt to JJin91 [7s Th]
JJin91: folds=20
E9Polarizer: raises 1200 to 2400
akbongu1977: folds=20
GMMK426: folds=20
fingers911: folds=20
GetLoose17: calls 2400
Tmiller198: folds=20
lrb1024: folds=20
*** FLOP *** [Ah Td Ks]
E9Polarizer: checks=20
GetLoose17: checks=20
*** TURN *** [Ah Td Ks] [8d]
E9Polarizer: checks=20
GetLoose17: bets 3600
E9Polarizer: folds=20
Uncalled bet (3600) returned to GetLoose17
GetLoose17 collected 7800 from pot
GetLoose17: doesn't show hand=20
*** SUMMARY ***
Total pot 7800 | Rake 0=20
Board [Ah Td Ks 8d]
Seat 1: lrb1024 (big blind) folded before Flop
Seat 2: JJin91 folded before Flop (didn't bet)
Seat 3: E9Polarizer folded on the Turn
Seat 5: akbongu1977 folded before Flop (didn't bet)
Seat 6: GMMK426 folded before Flop (didn't bet)
Seat 7: fingers911 folded before Flop (didn't bet)
Seat 8: GetLoose17 (button) collected (7800)
Seat 9: Tmiller198 (small blind) folded before Flop


*********** # 154 **************
PokerStars Hand #172147187909: Tournament #1648990476, $18.20+$1.80 USD=
 Hold'em No Limit - Level XVI (600/1200) - 2017/07/06 21:50:35 ET
Table '1648990476 7' 9-max Seat #9 is the button
Seat 1: lrb1024 (33798 in chips)=20
Seat 2: JJin91 (27920 in chips)=20
Seat 3: E9Polarizer (38478 in chips)=20
Seat 5: akbongu1977 (28146 in chips)=20
Seat 6: GMMK426 (71930 in chips)=20
Seat 7: fingers911 (21195 in chips)=20
Seat 8: GetLoose17 (67328 in chips)=20
Seat 9: Tmiller198 (50344 in chips)=20
lrb1024: posts the ante 150
JJin91: posts the ante 150
E9Polarizer: posts the ante 150
akbongu1977: posts the ante 150
GMMK426: posts the ante 150
fingers911: posts the ante 150
GetLoose17: posts the ante 150
Tmiller198: posts the ante 150
lrb1024: posts small blind 600
JJin91: posts big blind 1200
*** HOLE CARDS ***
Dealt to JJin91 [Ac 2d]
E9Polarizer: folds=20
akbongu1977: folds=20
GMMK426: folds=20
fingers911: folds=20
GetLoose17: folds=20
Tmiller198: raises 1200 to 2400
lrb1024: folds=20
JJin91: folds=20
Uncalled bet (1200) returned to Tmiller198
Tmiller198 collected 4200 from pot
Tmiller198: doesn't show hand=20
*** SUMMARY ***
Total pot 4200 | Rake 0=20
Seat 1: lrb1024 (small blind) folded before Flop
Seat 2: JJin91 (big blind) folded before Flop
Seat 3: E9Polarizer folded before Flop (didn't bet)
Seat 5: akbongu1977 folded before Flop (didn't bet)
Seat 6: GMMK426 folded before Flop (didn't bet)
Seat 7: fingers911 folded before Flop (didn't bet)
Seat 8: GetLoose17 folded before Flop (didn't bet)
Seat 9: Tmiller198 (button) collected (4200)


*********** # 155 **************
PokerStars Hand #172147188063: Tournament #1648990476, $18.20+$1.80 USD=
 Hold'em No Limit - Level XVI (600/1200) - 2017/07/06 21:51:09 ET
Table '1648990476 7' 9-max Seat #1 is the button
Seat 1: lrb1024 (33048 in chips)=20
Seat 2: JJin91 (26570 in chips)=20
Seat 3: E9Polarizer (38328 in chips)=20
Seat 5: akbongu1977 (27996 in chips)=20
Seat 6: GMMK426 (71780 in chips)=20
Seat 7: fingers911 (21045 in chips)=20
Seat 8: GetLoose17 (67178 in chips)=20
Seat 9: Tmiller198 (53194 in chips)=20
lrb1024: posts the ante 150
JJin91: posts the ante 150
E9Polarizer: posts the ante 150
akbongu1977: posts the ante 150
GMMK426: posts the ante 150
fingers911: posts the ante 150
GetLoose17: posts the ante 150
Tmiller198: posts the ante 150
JJin91: posts small blind 600
E9Polarizer: posts big blind 1200
*** HOLE CARDS ***
Dealt to JJin91 [2d Ts]
akbongu1977: folds=20
GMMK426: folds=20
fingers911: folds=20
GetLoose17: folds=20
Tmiller198: folds=20
lrb1024: raises 1200 to 2400
JJin91: folds=20
E9Polarizer: folds=20
Uncalled bet (1200) returned to lrb1024
lrb1024 collected 4200 from pot
lrb1024: doesn't show hand=20
*** SUMMARY ***
Total pot 4200 | Rake 0=20
Seat 1: lrb1024 (button) collected (4200)
Seat 2: JJin91 (small blind) folded before Flop
Seat 3: E9Polarizer (big blind) folded before Flop
Seat 5: akbongu1977 folded before Flop (didn't bet)
Seat 6: GMMK426 folded before Flop (didn't bet)
Seat 7: fingers911 folded before Flop (didn't bet)
Seat 8: GetLoose17 folded before Flop (didn't bet)
Seat 9: Tmiller198 folded before Flop (didn't bet)


*********** # 156 **************
PokerStars Hand #172147188311: Tournament #1648990476, $18.20+$1.80 USD=
 Hold'em No Limit - Level XVII (700/1400) - 2017/07/06 21:52:02 ET
Table '1648990476 7' 9-max Seat #2 is the button
Seat 1: lrb1024 (35898 in chips)=20
Seat 2: JJin91 (25820 in chips)=20
Seat 3: E9Polarizer (36978 in chips)=20
Seat 5: akbongu1977 (27846 in chips)=20
Seat 6: GMMK426 (71630 in chips)=20
Seat 7: fingers911 (20895 in chips)=20
Seat 8: GetLoose17 (67028 in chips)=20
Seat 9: Tmiller198 (53044 in chips)=20
lrb1024: posts the ante 175
JJin91: posts the ante 175
E9Polarizer: posts the ante 175
akbongu1977: posts the ante 175
GMMK426: posts the ante 175
fingers911: posts the ante 175
GetLoose17: posts the ante 175
Tmiller198: posts the ante 175
E9Polarizer: posts small blind 700
akbongu1977: posts big blind 1400
*** HOLE CARDS ***
Dealt to JJin91 [5h 2d]
GMMK426: folds=20
fingers911: raises 1400 to 2800
GetLoose17: folds=20
Tmiller198: folds=20
lrb1024: folds=20
JJin91: folds=20
E9Polarizer: folds=20
akbongu1977: folds=20
Uncalled bet (1400) returned to fingers911
fingers911 collected 4900 from pot
fingers911: doesn't show hand=20
*** SUMMARY ***
Total pot 4900 | Rake 0=20
Seat 1: lrb1024 folded before Flop (didn't bet)
Seat 2: JJin91 (button) folded before Flop (didn't bet)
Seat 3: E9Polarizer (small blind) folded before Flop
Seat 5: akbongu1977 (big blind) folded before Flop
Seat 6: GMMK426 folded before Flop (didn't bet)
Seat 7: fingers911 collected (4900)
Seat 8: GetLoose17 folded before Flop (didn't bet)
Seat 9: Tmiller198 folded before Flop (didn't bet)


*********** # 157 **************
PokerStars Hand #172147188472: Tournament #1648990476, $18.20+$1.80 USD=
 Hold'em No Limit - Level XVII (700/1400) - 2017/07/06 21:52:36 ET
Table '1648990476 7' 9-max Seat #3 is the button
Seat 1: lrb1024 (35723 in chips)=20
Seat 2: JJin91 (25645 in chips)=20
Seat 3: E9Polarizer (36103 in chips)=20
Seat 5: akbongu1977 (26271 in chips)=20
Seat 6: GMMK426 (71455 in chips)=20
Seat 7: fingers911 (24220 in chips)=20
Seat 8: GetLoose17 (66853 in chips)=20
Seat 9: Tmiller198 (52869 in chips)=20
lrb1024: posts the ante 175
JJin91: posts the ante 175
E9Polarizer: posts the ante 175
akbongu1977: posts the ante 175
GMMK426: posts the ante 175
fingers911: posts the ante 175
GetLoose17: posts the ante 175
Tmiller198: posts the ante 175
akbongu1977: posts small blind 700
GMMK426: posts big blind 1400
*** HOLE CARDS ***
Dealt to JJin91 [Qd Jc]
fingers911: folds=20
GetLoose17: folds=20
Tmiller198: folds=20
lrb1024: folds=20
JJin91: raises 1554 to 2954
E9Polarizer: folds=20
akbongu1977: folds=20
GMMK426: calls 1554
*** FLOP *** [7c 3h Tc]
GMMK426: checks=20
JJin91: checks=20
*** TURN *** [7c 3h Tc] [2s]
GMMK426: bets 4004
JJin91: folds=20
Uncalled bet (4004) returned to GMMK426
GMMK426 collected 8008 from pot
GMMK426: doesn't show hand=20
*** SUMMARY ***
Total pot 8008 | Rake 0=20
Board [7c 3h Tc 2s]
Seat 1: lrb1024 folded before Flop (didn't bet)
Seat 2: JJin91 folded on the Turn
Seat 3: E9Polarizer (button) folded before Flop (didn't bet)
Seat 5: akbongu1977 (small blind) folded before Flop
Seat 6: GMMK426 (big blind) collected (8008)
Seat 7: fingers911 folded before Flop (didn't bet)
Seat 8: GetLoose17 folded before Flop (didn't bet)
Seat 9: Tmiller198 folded before Flop (didn't bet)


*********** # 158 **************
PokerStars Hand #172147188760: Tournament #1648990476, $18.20+$1.80 USD=
 Hold'em No Limit - Level XVII (700/1400) - 2017/07/06 21:53:37 ET
Table '1648990476 7' 9-max Seat #5 is the button
Seat 1: lrb1024 (35548 in chips)=20
Seat 2: JJin91 (22516 in chips)=20
Seat 3: E9Polarizer (35928 in chips)=20
Seat 5: akbongu1977 (25396 in chips)=20
Seat 6: GMMK426 (76334 in chips)=20
Seat 7: fingers911 (24045 in chips)=20
Seat 8: GetLoose17 (66678 in chips)=20
Seat 9: Tmiller198 (52694 in chips)=20
lrb1024: posts the ante 175
JJin91: posts the ante 175
E9Polarizer: posts the ante 175
akbongu1977: posts the ante 175
GMMK426: posts the ante 175
fingers911: posts the ante 175
GetLoose17: posts the ante 175
Tmiller198: posts the ante 175
GMMK426: posts small blind 700
fingers911: posts big blind 1400
*** HOLE CARDS ***
Dealt to JJin91 [2d Js]
GetLoose17: folds=20
Tmiller198: folds=20
lrb1024: folds=20
JJin91: folds=20
E9Polarizer: folds=20
akbongu1977: folds=20
GMMK426: calls 700
fingers911: checks=20
*** FLOP *** [3s Ts 9d]
GMMK426: bets 1400
fingers911: folds=20
Uncalled bet (1400) returned to GMMK426
GMMK426 collected 4200 from pot
GMMK426: doesn't show hand=20
*** SUMMARY ***
Total pot 4200 | Rake 0=20
Board [3s Ts 9d]
Seat 1: lrb1024 folded before Flop (didn't bet)
Seat 2: JJin91 folded before Flop (didn't bet)
Seat 3: E9Polarizer folded before Flop (didn't bet)
Seat 5: akbongu1977 (button) folded before Flop (didn't bet)
Seat 6: GMMK426 (small blind) collected (4200)
Seat 7: fingers911 (big blind) folded on the Flop
Seat 8: GetLoose17 folded before Flop (didn't bet)
Seat 9: Tmiller198 folded before Flop (didn't bet)


*********** # 159 **************
PokerStars Hand #172147188954: Tournament #1648990476, $18.20+$1.80 USD=
 Hold'em No Limit - Level XVII (700/1400) - 2017/07/06 21:54:17 ET
Table '1648990476 7' 9-max Seat #6 is the button
Seat 1: lrb1024 (35373 in chips)=20
Seat 2: JJin91 (22341 in chips)=20
Seat 3: E9Polarizer (35753 in chips)=20
Seat 5: akbongu1977 (25221 in chips)=20
Seat 6: GMMK426 (78959 in chips)=20
Seat 7: fingers911 (22470 in chips)=20
Seat 8: GetLoose17 (66503 in chips)=20
Seat 9: Tmiller198 (52519 in chips)=20
lrb1024: posts the ante 175
JJin91: posts the ante 175
E9Polarizer: posts the ante 175
akbongu1977: posts the ante 175
GMMK426: posts the ante 175
fingers911: posts the ante 175
GetLoose17: posts the ante 175
Tmiller198: posts the ante 175
fingers911: posts small blind 700
GetLoose17: posts big blind 1400
*** HOLE CARDS ***
Dealt to JJin91 [8c 7h]
Tmiller198: folds=20
lrb1024 has timed out
lrb1024: folds=20
lrb1024 is sitting out
JJin91: folds=20
E9Polarizer: folds=20
akbongu1977: calls 1400
GMMK426: calls 1400
fingers911: calls 700
GetLoose17: checks=20
*** FLOP *** [4s 3d Ks]
fingers911: checks=20
GetLoose17: checks=20
akbongu1977: checks=20
GMMK426: bets 7000
fingers911: folds=20
GetLoose17: folds=20
akbongu1977: folds=20
Uncalled bet (7000) returned to GMMK426
GMMK426 collected 7000 from pot
GMMK426: doesn't show hand=20
*** SUMMARY ***
Total pot 7000 | Rake 0=20
Board [4s 3d Ks]
Seat 1: lrb1024 folded before Flop (didn't bet)
Seat 2: JJin91 folded before Flop (didn't bet)
Seat 3: E9Polarizer folded before Flop (didn't bet)
Seat 5: akbongu1977 folded on the Flop
Seat 6: GMMK426 (button) collected (7000)
Seat 7: fingers911 (small blind) folded on the Flop
Seat 8: GetLoose17 (big blind) folded on the Flop
Seat 9: Tmiller198 folded before Flop (didn't bet)


*********** # 160 **************
PokerStars Hand #172149567731: Tournament #1648990476, $18.20+$1.80 USD=
 Hold'em No Limit - Level XVII (700/1400) - 2017/07/06 22:01:04 ET
Table '1648990476 7' 9-max Seat #7 is the button
Seat 1: lrb1024 (35198 in chips)=20
Seat 2: JJin91 (22166 in chips)=20
Seat 3: E9Polarizer (35578 in chips)=20
Seat 5: akbongu1977 (23646 in chips)=20
Seat 6: GMMK426 (84384 in chips)=20
Seat 7: fingers911 (20895 in chips)=20
Seat 8: GetLoose17 (64928 in chips)=20
Seat 9: Tmiller198 (52344 in chips)=20
lrb1024: posts the ante 175
JJin91: posts the ante 175
E9Polarizer: posts the ante 175
akbongu1977: posts the ante 175
GMMK426: posts the ante 175
fingers911: posts the ante 175
GetLoose17: posts the ante 175
Tmiller198: posts the ante 175
GetLoose17: posts small blind 700
Tmiller198: posts big blind 1400
*** HOLE CARDS ***
Dealt to JJin91 [Ah 3c]
lrb1024: folds=20
JJin91: folds=20
E9Polarizer: folds=20
akbongu1977: folds=20
GMMK426: folds=20
fingers911: raises 1400 to 2800
GetLoose17: folds=20
Tmiller198: folds=20
Uncalled bet (1400) returned to fingers911
fingers911 collected 4900 from pot
fingers911: doesn't show hand=20
*** SUMMARY ***
Total pot 4900 | Rake 0=20
Seat 1: lrb1024 folded before Flop (didn't bet)
Seat 2: JJin91 folded before Flop (didn't bet)
Seat 3: E9Polarizer folded before Flop (didn't bet)
Seat 5: akbongu1977 folded before Flop (didn't bet)
Seat 6: GMMK426 folded before Flop (didn't bet)
Seat 7: fingers911 (button) collected (4900)
Seat 8: GetLoose17 (small blind) folded before Flop
Seat 9: Tmiller198 (big blind) folded before Flop


*********** # 161 **************
PokerStars Hand #172149567832: Tournament #1648990476, $18.20+$1.80 USD=
 Hold'em No Limit - Level XVII (700/1400) - 2017/07/06 22:01:23 ET
Table '1648990476 7' 9-max Seat #8 is the button
Seat 1: lrb1024 (35023 in chips)=20
Seat 2: JJin91 (21991 in chips)=20
Seat 3: E9Polarizer (35403 in chips)=20
Seat 5: akbongu1977 (23471 in chips)=20
Seat 6: GMMK426 (84209 in chips)=20
Seat 7: fingers911 (24220 in chips)=20
Seat 8: GetLoose17 (64053 in chips)=20
Seat 9: Tmiller198 (50769 in chips)=20
lrb1024: posts the ante 175
JJin91: posts the ante 175
E9Polarizer: posts the ante 175
akbongu1977: posts the ante 175
GMMK426: posts the ante 175
fingers911: posts the ante 175
GetLoose17: posts the ante 175
Tmiller198: posts the ante 175
Tmiller198: posts small blind 700
lrb1024: posts big blind 1400
*** HOLE CARDS ***
Dealt to JJin91 [Qs 8s]
JJin91: folds=20
E9Polarizer: folds=20
akbongu1977: folds=20
GMMK426: folds=20
fingers911: folds=20
GetLoose17: folds=20
Tmiller198: calls 700
lrb1024: checks=20
*** FLOP *** [2d 9h 5s]
Tmiller198: checks=20
lrb1024: checks=20
*** TURN *** [2d 9h 5s] [Kc]
Tmiller198: checks=20
lrb1024: checks=20
*** RIVER *** [2d 9h 5s Kc] [Kh]
Tmiller198: bets 1400
lrb1024: calls 1400
*** SHOW DOWN ***
Tmiller198: shows [Tc Qh] (a pair of Kings)
lrb1024: mucks hand=20
Tmiller198 collected 7000 from pot
*** SUMMARY ***
Total pot 7000 | Rake 0=20
Board [2d 9h 5s Kc Kh]
Seat 1: lrb1024 (big blind) mucked [Jd 3h]
Seat 2: JJin91 folded before Flop (didn't bet)
Seat 3: E9Polarizer folded before Flop (didn't bet)
Seat 5: akbongu1977 folded before Flop (didn't bet)
Seat 6: GMMK426 folded before Flop (didn't bet)
Seat 7: fingers911 folded before Flop (didn't bet)
Seat 8: GetLoose17 (button) folded before Flop (didn't bet)
Seat 9: Tmiller198 (small blind) showed [Tc Qh] and won (7000) with a p=
air of Kings


*********** # 162 **************
PokerStars Hand #172149568003: Tournament #1648990476, $18.20+$1.80 USD=
 Hold'em No Limit - Level XVII (700/1400) - 2017/07/06 22:01:58 ET
Table '1648990476 7' 9-max Seat #9 is the button
Seat 1: lrb1024 (32048 in chips)=20
Seat 2: JJin91 (21816 in chips)=20
Seat 3: E9Polarizer (35228 in chips)=20
Seat 5: akbongu1977 (23296 in chips)=20
Seat 6: GMMK426 (84034 in chips)=20
Seat 7: fingers911 (24045 in chips)=20
Seat 8: GetLoose17 (63878 in chips)=20
Seat 9: Tmiller198 (54794 in chips)=20
lrb1024: posts the ante 175
JJin91: posts the ante 175
E9Polarizer: posts the ante 175
akbongu1977: posts the ante 175
GMMK426: posts the ante 175
fingers911: posts the ante 175
GetLoose17: posts the ante 175
Tmiller198: posts the ante 175
lrb1024: posts small blind 700
JJin91: posts big blind 1400
*** HOLE CARDS ***
Dealt to JJin91 [Ac 3c]
E9Polarizer: folds=20
akbongu1977: folds=20
GMMK426: folds=20
fingers911: raises 1400 to 2800
GetLoose17: folds=20
Tmiller198: folds=20
lrb1024: calls 2100
JJin91: folds=20
*** FLOP *** [Kd Qc 8d]
lrb1024: checks=20
fingers911: bets 1400
lrb1024: raises 1400 to 2800
fingers911: calls 1400
*** TURN *** [Kd Qc 8d] [Ad]
lrb1024: bets 1400
fingers911: calls 1400
*** RIVER *** [Kd Qc 8d Ad] [2c]
lrb1024: bets 1400
fingers911: calls 1400
*** SHOW DOWN ***
lrb1024: shows [Ks Qd] (two pair, Kings and Queens)
fingers911: mucks hand=20
lrb1024 collected 19600 from pot
*** SUMMARY ***
Total pot 19600 | Rake 0=20
Board [Kd Qc 8d Ad 2c]
Seat 1: lrb1024 (small blind) showed [Ks Qd] and won (19600) with two p=
air, Kings and Queens
Seat 2: JJin91 (big blind) folded before Flop
Seat 3: E9Polarizer folded before Flop (didn't bet)
Seat 5: akbongu1977 folded before Flop (didn't bet)
Seat 6: GMMK426 folded before Flop (didn't bet)
Seat 7: fingers911 mucked [Qh Jd]
Seat 8: GetLoose17 folded before Flop (didn't bet)
Seat 9: Tmiller198 (button) folded before Flop (didn't bet)


*********** # 163 **************
PokerStars Hand #172149568156: Tournament #1648990476, $18.20+$1.80 USD=
 Hold'em No Limit - Level XVII (700/1400) - 2017/07/06 22:02:33 ET
Table '1648990476 7' 9-max Seat #1 is the button
Seat 1: lrb1024 (43073 in chips)=20
Seat 2: JJin91 (20241 in chips)=20
Seat 3: E9Polarizer (35053 in chips)=20
Seat 5: akbongu1977 (23121 in chips)=20
Seat 6: GMMK426 (83859 in chips)=20
Seat 7: fingers911 (15470 in chips)=20
Seat 8: GetLoose17 (63703 in chips)=20
Seat 9: Tmiller198 (54619 in chips)=20
lrb1024: posts the ante 175
JJin91: posts the ante 175
E9Polarizer: posts the ante 175
akbongu1977: posts the ante 175
GMMK426: posts the ante 175
fingers911: posts the ante 175
GetLoose17: posts the ante 175
Tmiller198: posts the ante 175
JJin91: posts small blind 700
E9Polarizer: posts big blind 1400
*** HOLE CARDS ***
Dealt to JJin91 [9d Ac]
akbongu1977: folds=20
GMMK426: folds=20
fingers911: raises 1400 to 2800
GetLoose17: folds=20
Tmiller198: folds=20
lrb1024: folds=20
JJin91: raises 17266 to 20066 and is all-in
E9Polarizer: folds=20
fingers911: folds=20
Uncalled bet (17266) returned to JJin91
JJin91 collected 8400 from pot
JJin91: doesn't show hand=20
*** SUMMARY ***
Total pot 8400 | Rake 0=20
Seat 1: lrb1024 (button) folded before Flop (didn't bet)
Seat 2: JJin91 (small blind) collected (8400)
Seat 3: E9Polarizer (big blind) folded before Flop
Seat 5: akbongu1977 folded before Flop (didn't bet)
Seat 6: GMMK426 folded before Flop (didn't bet)
Seat 7: fingers911 folded before Flop
Seat 8: GetLoose17 folded before Flop (didn't bet)
Seat 9: Tmiller198 folded before Flop (didn't bet)


*********** # 164 **************
PokerStars Hand #172149568272: Tournament #1648990476, $18.20+$1.80 USD=
 Hold'em No Limit - Level XVII (700/1400) - 2017/07/06 22:02:58 ET
Table '1648990476 7' 9-max Seat #2 is the button
Seat 1: lrb1024 (42898 in chips)=20
Seat 2: JJin91 (25666 in chips)=20
Seat 3: E9Polarizer (33478 in chips)=20
Seat 5: akbongu1977 (22946 in chips)=20
Seat 6: GMMK426 (83684 in chips)=20
Seat 7: fingers911 (12495 in chips)=20
Seat 8: GetLoose17 (63528 in chips)=20
Seat 9: Tmiller198 (54444 in chips)=20
lrb1024: posts the ante 175
JJin91: posts the ante 175
E9Polarizer: posts the ante 175
akbongu1977: posts the ante 175
GMMK426: posts the ante 175
fingers911: posts the ante 175
GetLoose17: posts the ante 175
Tmiller198: posts the ante 175
E9Polarizer: posts small blind 700
akbongu1977: posts big blind 1400
*** HOLE CARDS ***
Dealt to JJin91 [Kd Ks]
GMMK426: folds=20
fingers911: folds=20
GetLoose17: folds=20
Tmiller198: folds=20
lrb1024: raises 1400 to 2800
JJin91: raises 6088 to 8888
E9Polarizer: folds=20
akbongu1977: folds=20
lrb1024: folds=20
Uncalled bet (6088) returned to JJin91
JJin91 collected 9100 from pot
JJin91: doesn't show hand=20
*** SUMMARY ***
Total pot 9100 | Rake 0=20
Seat 1: lrb1024 folded before Flop
Seat 2: JJin91 (button) collected (9100)
Seat 3: E9Polarizer (small blind) folded before Flop
Seat 5: akbongu1977 (big blind) folded before Flop
Seat 6: GMMK426 folded before Flop (didn't bet)
Seat 7: fingers911 folded before Flop (didn't bet)
Seat 8: GetLoose17 folded before Flop (didn't bet)
Seat 9: Tmiller198 folded before Flop (didn't bet)


*********** # 165 **************
PokerStars Hand #172149568542: Tournament #1648990476, $18.20+$1.80 USD=
 Hold'em No Limit - Level XVII (700/1400) - 2017/07/06 22:03:57 ET
Table '1648990476 7' 9-max Seat #3 is the button
Seat 1: lrb1024 (39923 in chips)=20
Seat 2: JJin91 (31791 in chips)=20
Seat 3: E9Polarizer (32603 in chips)=20
Seat 5: akbongu1977 (21371 in chips)=20
Seat 6: GMMK426 (83509 in chips)=20
Seat 7: fingers911 (12320 in chips)=20
Seat 8: GetLoose17 (63353 in chips)=20
Seat 9: Tmiller198 (54269 in chips)=20
lrb1024: posts the ante 175
JJin91: posts the ante 175
E9Polarizer: posts the ante 175
akbongu1977: posts the ante 175
GMMK426: posts the ante 175
fingers911: posts the ante 175
GetLoose17: posts the ante 175
Tmiller198: posts the ante 175
akbongu1977: posts small blind 700
GMMK426: posts big blind 1400
*** HOLE CARDS ***
Dealt to JJin91 [5h 6c]
fingers911: folds=20
GetLoose17: folds=20
Tmiller198: folds=20
lrb1024: folds=20
JJin91: folds=20
E9Polarizer: folds=20
akbongu1977: calls 700
GMMK426: checks=20
*** FLOP *** [2d Kc Kd]
akbongu1977: checks=20
GMMK426: bets 1400
akbongu1977: folds=20
Uncalled bet (1400) returned to GMMK426
GMMK426 collected 4200 from pot
GMMK426: doesn't show hand=20
*** SUMMARY ***
Total pot 4200 | Rake 0=20
Board [2d Kc Kd]
Seat 1: lrb1024 folded before Flop (didn't bet)
Seat 2: JJin91 folded before Flop (didn't bet)
Seat 3: E9Polarizer (button) folded before Flop (didn't bet)
Seat 5: akbongu1977 (small blind) folded on the Flop
Seat 6: GMMK426 (big blind) collected (4200)
Seat 7: fingers911 folded before Flop (didn't bet)
Seat 8: GetLoose17 folded before Flop (didn't bet)
Seat 9: Tmiller198 folded before Flop (didn't bet)


*********** # 166 **************
PokerStars Hand #172149568764: Tournament #1648990476, $18.20+$1.80 USD=
 Hold'em No Limit - Level XVII (700/1400) - 2017/07/06 22:04:48 ET
Table '1648990476 3' 9-max Seat #2 is the button
Seat 1: JJin91 (31616 in chips)=20
Seat 2: CerPrisingLe (83225 in chips)=20
Seat 3: NoBadBeats44 (21964 in chips)=20
Seat 4: A A 5454 (47465 in chips)=20
Seat 5: Going2Ship (30056 in chips)=20
Seat 7: helzkitchen (117846 in chips)=20
Seat 8: nwmdnj (29802 in chips)=20
JJin91: posts the ante 175
CerPrisingLe: posts the ante 175
NoBadBeats44: posts the ante 175
A A 5454: posts the ante 175
Going2Ship: posts the ante 175
helzkitchen: posts the ante 175
nwmdnj: posts the ante 175
NoBadBeats44: posts small blind 700
A A 5454: posts big blind 1400
*** HOLE CARDS ***
Dealt to JJin91 [Qh 5h]
Going2Ship: folds=20
helzkitchen: raises 1400 to 2800
nwmdnj: folds=20
JJin91: folds=20
CerPrisingLe: calls 2800
NoBadBeats44: folds=20
A A 5454: folds=20
*** FLOP *** [8d 5c Kd]
helzkitchen: bets 4463
CerPrisingLe: raises 5337 to 9800
helzkitchen: calls 5337
*** TURN *** [8d 5c Kd] [Ac]
helzkitchen: checks=20
CerPrisingLe: checks=20
*** RIVER *** [8d 5c Kd Ac] [6h]
helzkitchen: bets 8558
CerPrisingLe: folds=20
Uncalled bet (8558) returned to helzkitchen
helzkitchen collected 28525 from pot
helzkitchen: doesn't show hand=20
*** SUMMARY ***
Total pot 28525 | Rake 0=20
Board [8d 5c Kd Ac 6h]
Seat 1: JJin91 folded before Flop (didn't bet)
Seat 2: CerPrisingLe (button) folded on the River
Seat 3: NoBadBeats44 (small blind) folded before Flop
Seat 4: A A 5454 (big blind) folded before Flop
Seat 5: Going2Ship folded before Flop (didn't bet)
Seat 7: helzkitchen collected (28525)
Seat 8: nwmdnj folded before Flop (didn't bet)


*********** # 167 **************
PokerStars Hand #172149568896: Tournament #1648990476, $18.20+$1.80 USD=
 Hold'em No Limit - Level XVII (700/1400) - 2017/07/06 22:05:21 ET
Table '1648990476 3' 9-max Seat #3 is the button
Seat 1: JJin91 (31441 in chips)=20
Seat 2: CerPrisingLe (70450 in chips)=20
Seat 3: NoBadBeats44 (21089 in chips)=20
Seat 4: A A 5454 (45890 in chips)=20
Seat 5: Going2Ship (29881 in chips)=20
Seat 7: helzkitchen (133596 in chips)=20
Seat 8: nwmdnj (29627 in chips)=20
JJin91: posts the ante 175
CerPrisingLe: posts the ante 175
NoBadBeats44: posts the ante 175
A A 5454: posts the ante 175
Going2Ship: posts the ante 175
helzkitchen: posts the ante 175
nwmdnj: posts the ante 175
A A 5454: posts small blind 700
Going2Ship: posts big blind 1400
*** HOLE CARDS ***
Dealt to JJin91 [4h 5s]
helzkitchen: raises 1400 to 2800
nwmdnj: folds=20
JJin91: folds=20
CerPrisingLe: folds=20
NoBadBeats44: folds=20
A A 5454: folds=20
Going2Ship: calls 1400
*** FLOP *** [9c Ad Js]
Going2Ship: checks=20
helzkitchen: bets 3763
Going2Ship: folds=20
Uncalled bet (3763) returned to helzkitchen
helzkitchen collected 7525 from pot
helzkitchen: doesn't show hand=20
*** SUMMARY ***
Total pot 7525 | Rake 0=20
Board [9c Ad Js]
Seat 1: JJin91 folded before Flop (didn't bet)
Seat 2: CerPrisingLe folded before Flop (didn't bet)
Seat 3: NoBadBeats44 (button) folded before Flop (didn't bet)
Seat 4: A A 5454 (small blind) folded before Flop
Seat 5: Going2Ship (big blind) folded on the Flop
Seat 7: helzkitchen collected (7525)
Seat 8: nwmdnj folded before Flop (didn't bet)


*********** # 168 **************
PokerStars Hand #172149569097: Tournament #1648990476, $18.20+$1.80 USD=
 Hold'em No Limit - Level XVII (700/1400) - 2017/07/06 22:06:09 ET
Table '1648990476 3' 9-max Seat #4 is the button
Seat 1: JJin91 (31266 in chips)=20
Seat 2: CerPrisingLe (70275 in chips)=20
Seat 3: NoBadBeats44 (20914 in chips)=20
Seat 4: A A 5454 (45015 in chips)=20
Seat 5: Going2Ship (26906 in chips)=20
Seat 7: helzkitchen (138146 in chips)=20
Seat 8: nwmdnj (29452 in chips)=20
JJin91: posts the ante 175
CerPrisingLe: posts the ante 175
NoBadBeats44: posts the ante 175
A A 5454: posts the ante 175
Going2Ship: posts the ante 175
helzkitchen: posts the ante 175
nwmdnj: posts the ante 175
Going2Ship: posts small blind 700
helzkitchen: posts big blind 1400
*** HOLE CARDS ***
Dealt to JJin91 [5c As]
nwmdnj: folds=20
JJin91: folds=20
CerPrisingLe: folds=20
NoBadBeats44 has timed out
NoBadBeats44: folds=20
NoBadBeats44 is sitting out
A A 5454: folds=20
Going2Ship: folds=20
Uncalled bet (700) returned to helzkitchen
helzkitchen collected 2625 from pot
helzkitchen: doesn't show hand=20
*** SUMMARY ***
Total pot 2625 | Rake 0=20
Seat 1: JJin91 folded before Flop (didn't bet)
Seat 2: CerPrisingLe folded before Flop (didn't bet)
Seat 3: NoBadBeats44 folded before Flop (didn't bet)
Seat 4: A A 5454 (button) folded before Flop (didn't bet)
Seat 5: Going2Ship (small blind) folded before Flop
Seat 7: helzkitchen (big blind) collected (2625)
Seat 8: nwmdnj folded before Flop (didn't bet)


*********** # 169 **************
PokerStars Hand #172149569341: Tournament #1648990476, $18.20+$1.80 USD=
 Hold'em No Limit - Level XVII (700/1400) - 2017/07/06 22:07:08 ET
Table '1648990476 3' 9-max Seat #5 is the button
Seat 1: JJin91 (31091 in chips)=20
Seat 2: CerPrisingLe (70100 in chips)=20
Seat 3: NoBadBeats44 (20739 in chips) is sitting out
Seat 4: A A 5454 (44840 in chips)=20
Seat 5: Going2Ship (26031 in chips)=20
Seat 7: helzkitchen (139896 in chips)=20
Seat 8: nwmdnj (29277 in chips)=20
JJin91: posts the ante 175
CerPrisingLe: posts the ante 175
NoBadBeats44: posts the ante 175
A A 5454: posts the ante 175
Going2Ship: posts the ante 175
helzkitchen: posts the ante 175
nwmdnj: posts the ante 175
helzkitchen: posts small blind 700
nwmdnj: posts big blind 1400
*** HOLE CARDS ***
Dealt to JJin91 [7d 3s]
JJin91: folds=20
CerPrisingLe: folds=20
NoBadBeats44: folds=20
A A 5454: folds=20
Going2Ship: folds=20
helzkitchen: calls 700
nwmdnj: checks=20
*** FLOP *** [3d Ah 2d]
helzkitchen: checks=20
nwmdnj: checks=20
*** TURN *** [3d Ah 2d] [Kd]
helzkitchen: checks=20
nwmdnj: checks=20
*** RIVER *** [3d Ah 2d Kd] [8s]
helzkitchen: checks=20
nwmdnj: checks=20
*** SHOW DOWN ***
helzkitchen: shows [Tc Qd] (high card Ace)
nwmdnj: mucks hand=20
helzkitchen collected 4025 from pot
*** SUMMARY ***
Total pot 4025 | Rake 0=20
Board [3d Ah 2d Kd 8s]
Seat 1: JJin91 folded before Flop (didn't bet)
Seat 2: CerPrisingLe folded before Flop (didn't bet)
Seat 3: NoBadBeats44 folded before Flop (didn't bet)
Seat 4: A A 5454 folded before Flop (didn't bet)
Seat 5: Going2Ship (button) folded before Flop (didn't bet)
Seat 7: helzkitchen (small blind) showed [Tc Qd] and won (4025) with hi=
gh card Ace
Seat 8: nwmdnj (big blind) mucked [4s 6h]


*********** # 170 **************
PokerStars Hand #172149569678: Tournament #1648990476, $18.20+$1.80 USD=
 Hold'em No Limit - Level XVIII (800/1600) - 2017/07/06 22:08:22 ET
Table '1648990476 3' 9-max Seat #7 is the button
Seat 1: JJin91 (30916 in chips)=20
Seat 2: CerPrisingLe (69925 in chips)=20
Seat 3: NoBadBeats44 (20564 in chips) is sitting out
Seat 4: A A 5454 (44665 in chips)=20
Seat 5: Going2Ship (25856 in chips)=20
Seat 7: helzkitchen (142346 in chips)=20
Seat 8: nwmdnj (27702 in chips)=20
JJin91: posts the ante 200
CerPrisingLe: posts the ante 200
NoBadBeats44: posts the ante 200
A A 5454: posts the ante 200
Going2Ship: posts the ante 200
helzkitchen: posts the ante 200
nwmdnj: posts the ante 200
nwmdnj: posts small blind 800
JJin91: posts big blind 1600
*** HOLE CARDS ***
Dealt to JJin91 [8d 4c]
CerPrisingLe: raises 3200 to 4800
NoBadBeats44: folds=20
A A 5454: folds=20
Going2Ship: folds=20
helzkitchen: folds=20
nwmdnj: folds=20
JJin91: folds=20
Uncalled bet (3200) returned to CerPrisingLe
CerPrisingLe collected 5400 from pot
CerPrisingLe: doesn't show hand=20
*** SUMMARY ***
Total pot 5400 | Rake 0=20
Seat 1: JJin91 (big blind) folded before Flop
Seat 2: CerPrisingLe collected (5400)
Seat 3: NoBadBeats44 folded before Flop (didn't bet)
Seat 4: A A 5454 folded before Flop (didn't bet)
Seat 5: Going2Ship folded before Flop (didn't bet)
Seat 7: helzkitchen (button) folded before Flop (didn't bet)
Seat 8: nwmdnj (small blind) folded before Flop


*********** # 171 **************
PokerStars Hand #172149569799: Tournament #1648990476, $18.20+$1.80 USD=
 Hold'em No Limit - Level XVIII (800/1600) - 2017/07/06 22:08:46 ET
Table '1648990476 3' 9-max Seat #8 is the button
Seat 1: JJin91 (29116 in chips)=20
Seat 2: CerPrisingLe (73525 in chips)=20
Seat 3: NoBadBeats44 (20364 in chips) is sitting out
Seat 4: A A 5454 (44465 in chips)=20
Seat 5: Going2Ship (25656 in chips)=20
Seat 7: helzkitchen (142146 in chips)=20
Seat 8: nwmdnj (26702 in chips)=20
JJin91: posts the ante 200
CerPrisingLe: posts the ante 200
NoBadBeats44: posts the ante 200
A A 5454: posts the ante 200
Going2Ship: posts the ante 200
helzkitchen: posts the ante 200
nwmdnj: posts the ante 200
JJin91: posts small blind 800
CerPrisingLe: posts big blind 1600
*** HOLE CARDS ***
Dealt to JJin91 [Ad Qd]
NoBadBeats44: folds=20
A A 5454: folds=20
Going2Ship: folds=20
helzkitchen: raises 1600 to 3200
nwmdnj: folds=20
JJin91: calls 2400
CerPrisingLe: calls 1600
*** FLOP *** [3s Kh 4s]
JJin91: checks=20
CerPrisingLe: checks=20
helzkitchen: checks=20
*** TURN *** [3s Kh 4s] [2d]
JJin91: checks=20
CerPrisingLe: bets 5500
helzkitchen: folds=20
JJin91: calls 5500
*** RIVER *** [3s Kh 4s 2d] [Kd]
JJin91: checks=20
CerPrisingLe: bets 22400
JJin91: folds=20
Uncalled bet (22400) returned to CerPrisingLe
CerPrisingLe collected 22000 from pot
CerPrisingLe: doesn't show hand=20
*** SUMMARY ***
Total pot 22000 | Rake 0=20
Board [3s Kh 4s 2d Kd]
Seat 1: JJin91 (small blind) folded on the River
Seat 2: CerPrisingLe (big blind) collected (22000)
Seat 3: NoBadBeats44 folded before Flop (didn't bet)
Seat 4: A A 5454 folded before Flop (didn't bet)
Seat 5: Going2Ship folded before Flop (didn't bet)
Seat 7: helzkitchen folded on the Turn
Seat 8: nwmdnj (button) folded before Flop (didn't bet)


*********** # 172 **************
PokerStars Hand #172150453137: Tournament #1648990476, $18.20+$1.80 USD=
 Hold'em No Limit - Level XVIII (800/1600) - 2017/07/06 22:10:43 ET
Table '1648990476 3' 9-max Seat #1 is the button
Seat 1: JJin91 (20216 in chips)=20
Seat 2: CerPrisingLe (86625 in chips)=20
Seat 3: NoBadBeats44 (20164 in chips) is sitting out
Seat 4: A A 5454 (44265 in chips)=20
Seat 5: Going2Ship (25456 in chips)=20
Seat 7: helzkitchen (138746 in chips)=20
Seat 8: nwmdnj (26502 in chips)=20
JJin91: posts the ante 200
CerPrisingLe: posts the ante 200
NoBadBeats44: posts the ante 200
A A 5454: posts the ante 200
Going2Ship: posts the ante 200
helzkitchen: posts the ante 200
nwmdnj: posts the ante 200
CerPrisingLe: posts small blind 800
NoBadBeats44: posts big blind 1600
*** HOLE CARDS ***
Dealt to JJin91 [Ac 9s]
A A 5454: folds=20
Going2Ship: folds=20
helzkitchen: folds=20
nwmdnj: folds=20
JJin91: raises 18416 to 20016 and is all-in
CerPrisingLe: calls 19216
NoBadBeats44: folds=20
*** FLOP *** [4s 3s 5c]
*** TURN *** [4s 3s 5c] [9c]
*** RIVER *** [4s 3s 5c 9c] [3d]
*** SHOW DOWN ***
CerPrisingLe: shows [Tc Jh] (a pair of Threes)
JJin91: shows [Ac 9s] (two pair, Nines and Threes)
JJin91 collected 43032 from pot
*** SUMMARY ***
Total pot 43032 | Rake 0=20
Board [4s 3s 5c 9c 3d]
Seat 1: JJin91 (button) showed [Ac 9s] and won (43032) with two pair, N=
ines and Threes
Seat 2: CerPrisingLe (small blind) showed [Tc Jh] and lost with a pair =
of Threes
Seat 3: NoBadBeats44 (big blind) folded before Flop
Seat 4: A A 5454 folded before Flop (didn't bet)
Seat 5: Going2Ship folded before Flop (didn't bet)
Seat 7: helzkitchen folded before Flop (didn't bet)
Seat 8: nwmdnj folded before Flop (didn't bet)


*********** # 173 **************
PokerStars Hand #172150453362: Tournament #1648990476, $18.20+$1.80 USD=
 Hold'em No Limit - Level XVIII (800/1600) - 2017/07/06 22:11:30 ET
Table '1648990476 3' 9-max Seat #2 is the button
Seat 1: JJin91 (43032 in chips)=20
Seat 2: CerPrisingLe (66409 in chips)=20
Seat 3: NoBadBeats44 (18364 in chips) is sitting out
Seat 4: A A 5454 (44065 in chips)=20
Seat 5: Going2Ship (25256 in chips)=20
Seat 6: apoch19 (54709 in chips)=20
Seat 7: helzkitchen (138546 in chips)=20
Seat 8: nwmdnj (26302 in chips)=20
Seat 9: BUGG136 (74175 in chips)=20
JJin91: posts the ante 200
CerPrisingLe: posts the ante 200
NoBadBeats44: posts the ante 200
A A 5454: posts the ante 200
Going2Ship: posts the ante 200
apoch19: posts the ante 200
helzkitchen: posts the ante 200
nwmdnj: posts the ante 200
BUGG136: posts the ante 200
NoBadBeats44: posts small blind 800
A A 5454: posts big blind 1600
*** HOLE CARDS ***
Dealt to JJin91 [8h Jc]
Going2Ship: folds=20
apoch19: folds=20
helzkitchen: folds=20
nwmdnj: folds=20
BUGG136: folds=20
JJin91: folds=20
CerPrisingLe: raises 1600 to 3200
NoBadBeats44: folds=20
A A 5454: calls 1600
*** FLOP *** [9d Ad Jh]
A A 5454: checks=20
CerPrisingLe: bets 4800
A A 5454: calls 4800
*** TURN *** [9d Ad Jh] [Kc]
A A 5454: checks=20
CerPrisingLe: checks=20
*** RIVER *** [9d Ad Jh Kc] [4s]
A A 5454: bets 9300
CerPrisingLe: folds=20
Uncalled bet (9300) returned to A A 5454
A A 5454 collected 18600 from pot
A A 5454: doesn't show hand=20
*** SUMMARY ***
Total pot 18600 | Rake 0=20
Board [9d Ad Jh Kc 4s]
Seat 1: JJin91 folded before Flop (didn't bet)
Seat 2: CerPrisingLe (button) folded on the River
Seat 3: NoBadBeats44 (small blind) folded before Flop
Seat 4: A A 5454 (big blind) collected (18600)
Seat 5: Going2Ship folded before Flop (didn't bet)
Seat 6: apoch19 folded before Flop (didn't bet)
Seat 7: helzkitchen folded before Flop (didn't bet)
Seat 8: nwmdnj folded before Flop (didn't bet)
Seat 9: BUGG136 folded before Flop (didn't bet)


*********** # 174 **************
PokerStars Hand #172150453653: Tournament #1648990476, $18.20+$1.80 USD=
 Hold'em No Limit - Level XVIII (800/1600) - 2017/07/06 22:12:29 ET
Table '1648990476 3' 9-max Seat #3 is the button
Seat 1: JJin91 (42832 in chips)=20
Seat 2: CerPrisingLe (58209 in chips)=20
Seat 3: NoBadBeats44 (17364 in chips) is sitting out
Seat 4: A A 5454 (54465 in chips)=20
Seat 5: Going2Ship (25056 in chips)=20
Seat 6: apoch19 (54509 in chips)=20
Seat 7: helzkitchen (138346 in chips)=20
Seat 8: nwmdnj (26102 in chips)=20
Seat 9: BUGG136 (73975 in chips)=20
JJin91: posts the ante 200
CerPrisingLe: posts the ante 200
NoBadBeats44: posts the ante 200
A A 5454: posts the ante 200
Going2Ship: posts the ante 200
apoch19: posts the ante 200
helzkitchen: posts the ante 200
nwmdnj: posts the ante 200
BUGG136: posts the ante 200
A A 5454: posts small blind 800
Going2Ship: posts big blind 1600
*** HOLE CARDS ***
Dealt to JJin91 [5h 8d]
apoch19: folds=20
helzkitchen: folds=20
nwmdnj: folds=20
BUGG136: folds=20
JJin91: folds=20
CerPrisingLe: raises 3200 to 4800
NoBadBeats44: folds=20
A A 5454: folds=20
Going2Ship: folds=20
Uncalled bet (3200) returned to CerPrisingLe
CerPrisingLe collected 5800 from pot
CerPrisingLe: doesn't show hand=20
NoBadBeats44 has returned
*** SUMMARY ***
Total pot 5800 | Rake 0=20
Seat 1: JJin91 folded before Flop (didn't bet)
Seat 2: CerPrisingLe collected (5800)
Seat 3: NoBadBeats44 (button) folded before Flop (didn't bet)
Seat 4: A A 5454 (small blind) folded before Flop
Seat 5: Going2Ship (big blind) folded before Flop
Seat 6: apoch19 folded before Flop (didn't bet)
Seat 7: helzkitchen folded before Flop (didn't bet)
Seat 8: nwmdnj folded before Flop (didn't bet)
Seat 9: BUGG136 folded before Flop (didn't bet)


*********** # 175 **************
PokerStars Hand #172150453744: Tournament #1648990476, $18.20+$1.80 USD=
 Hold'em No Limit - Level XVIII (800/1600) - 2017/07/06 22:12:47 ET
Table '1648990476 3' 9-max Seat #4 is the button
Seat 1: JJin91 (42632 in chips)=20
Seat 2: CerPrisingLe (62209 in chips)=20
Seat 3: NoBadBeats44 (17164 in chips)=20
Seat 4: A A 5454 (53465 in chips)=20
Seat 5: Going2Ship (23256 in chips)=20
Seat 6: apoch19 (54309 in chips)=20
Seat 7: helzkitchen (138146 in chips)=20
Seat 8: nwmdnj (25902 in chips)=20
Seat 9: BUGG136 (73775 in chips)=20
JJin91: posts the ante 200
CerPrisingLe: posts the ante 200
NoBadBeats44: posts the ante 200
A A 5454: posts the ante 200
Going2Ship: posts the ante 200
apoch19: posts the ante 200
helzkitchen: posts the ante 200
nwmdnj: posts the ante 200
BUGG136: posts the ante 200
Going2Ship: posts small blind 800
apoch19: posts big blind 1600
*** HOLE CARDS ***
Dealt to JJin91 [Qd 2d]
helzkitchen: folds=20
nwmdnj: folds=20
BUGG136: folds=20
JJin91: folds=20
CerPrisingLe: raises 1600 to 3200
NoBadBeats44: raises 13764 to 16964 and is all-in
A A 5454: folds=20
Going2Ship: folds=20
apoch19: folds=20
CerPrisingLe: folds=20
Uncalled bet (13764) returned to NoBadBeats44
NoBadBeats44 collected 10600 from pot
NoBadBeats44: doesn't show hand=20
*** SUMMARY ***
Total pot 10600 | Rake 0=20
Seat 1: JJin91 folded before Flop (didn't bet)
Seat 2: CerPrisingLe folded before Flop
Seat 3: NoBadBeats44 collected (10600)
Seat 4: A A 5454 (button) folded before Flop (didn't bet)
Seat 5: Going2Ship (small blind) folded before Flop
Seat 6: apoch19 (big blind) folded before Flop
Seat 7: helzkitchen folded before Flop (didn't bet)
Seat 8: nwmdnj folded before Flop (didn't bet)
Seat 9: BUGG136 folded before Flop (didn't bet)


*********** # 176 **************
PokerStars Hand #172150453955: Tournament #1648990476, $18.20+$1.80 USD=
 Hold'em No Limit - Level XVIII (800/1600) - 2017/07/06 22:13:30 ET
Table '1648990476 3' 9-max Seat #5 is the button
Seat 1: JJin91 (42432 in chips)=20
Seat 2: CerPrisingLe (58809 in chips)=20
Seat 3: NoBadBeats44 (24364 in chips)=20
Seat 4: A A 5454 (53265 in chips)=20
Seat 5: Going2Ship (22256 in chips)=20
Seat 6: apoch19 (52509 in chips)=20
Seat 7: helzkitchen (137946 in chips)=20
Seat 8: nwmdnj (25702 in chips)=20
Seat 9: BUGG136 (73575 in chips)=20
JJin91: posts the ante 200
CerPrisingLe: posts the ante 200
NoBadBeats44: posts the ante 200
A A 5454: posts the ante 200
Going2Ship: posts the ante 200
apoch19: posts the ante 200
helzkitchen: posts the ante 200
nwmdnj: posts the ante 200
BUGG136: posts the ante 200
apoch19: posts small blind 800
helzkitchen: posts big blind 1600
*** HOLE CARDS ***
Dealt to JJin91 [8d Ac]
nwmdnj: folds=20
BUGG136: folds=20
JJin91: folds=20
CerPrisingLe: raises 5800 to 7400
NoBadBeats44: folds=20
A A 5454: folds=20
Going2Ship: folds=20
apoch19: folds=20
helzkitchen: calls 5800
*** FLOP *** [9c 7c 8c]
helzkitchen: checks=20
CerPrisingLe: checks=20
*** TURN *** [9c 7c 8c] [Js]
helzkitchen: bets 8700
CerPrisingLe: calls 8700
*** RIVER *** [9c 7c 8c Js] [7s]
helzkitchen: bets 22400
CerPrisingLe: folds=20
Uncalled bet (22400) returned to helzkitchen
helzkitchen collected 34800 from pot
helzkitchen: doesn't show hand=20
*** SUMMARY ***
Total pot 34800 | Rake 0=20
Board [9c 7c 8c Js 7s]
Seat 1: JJin91 folded before Flop (didn't bet)
Seat 2: CerPrisingLe folded on the River
Seat 3: NoBadBeats44 folded before Flop (didn't bet)
Seat 4: A A 5454 folded before Flop (didn't bet)
Seat 5: Going2Ship (button) folded before Flop (didn't bet)
Seat 6: apoch19 (small blind) folded before Flop
Seat 7: helzkitchen (big blind) collected (34800)
Seat 8: nwmdnj folded before Flop (didn't bet)
Seat 9: BUGG136 folded before Flop (didn't bet)


*********** # 177 **************
PokerStars Hand #172150454199: Tournament #1648990476, $18.20+$1.80 USD=
 Hold'em No Limit - Level XVIII (800/1600) - 2017/07/06 22:14:24 ET
Table '1648990476 3' 9-max Seat #6 is the button
Seat 1: JJin91 (42232 in chips)=20
Seat 2: CerPrisingLe (42509 in chips)=20
Seat 3: NoBadBeats44 (24164 in chips)=20
Seat 4: A A 5454 (53065 in chips)=20
Seat 5: Going2Ship (22056 in chips)=20
Seat 6: apoch19 (51509 in chips)=20
Seat 7: helzkitchen (156446 in chips)=20
Seat 8: nwmdnj (25502 in chips)=20
Seat 9: BUGG136 (73375 in chips)=20
JJin91: posts the ante 200
CerPrisingLe: posts the ante 200
NoBadBeats44: posts the ante 200
A A 5454: posts the ante 200
Going2Ship: posts the ante 200
apoch19: posts the ante 200
helzkitchen: posts the ante 200
nwmdnj: posts the ante 200
BUGG136: posts the ante 200
helzkitchen: posts small blind 800
nwmdnj: posts big blind 1600
*** HOLE CARDS ***
Dealt to JJin91 [Jc Ad]
BUGG136: folds=20
JJin91: raises 1776 to 3376
CerPrisingLe: folds=20
NoBadBeats44: folds=20
A A 5454: folds=20
Going2Ship: folds=20
apoch19: folds=20
helzkitchen: folds=20
nwmdnj: folds=20
Uncalled bet (1776) returned to JJin91
JJin91 collected 5800 from pot
JJin91: doesn't show hand=20
*** SUMMARY ***
Total pot 5800 | Rake 0=20
Seat 1: JJin91 collected (5800)
Seat 2: CerPrisingLe folded before Flop (didn't bet)
Seat 3: NoBadBeats44 folded before Flop (didn't bet)
Seat 4: A A 5454 folded before Flop (didn't bet)
Seat 5: Going2Ship folded before Flop (didn't bet)
Seat 6: apoch19 (button) folded before Flop (didn't bet)
Seat 7: helzkitchen (small blind) folded before Flop
Seat 8: nwmdnj (big blind) folded before Flop
Seat 9: BUGG136 folded before Flop (didn't bet)


*********** # 178 **************
PokerStars Hand #172150454271: Tournament #1648990476, $18.20+$1.80 USD=
 Hold'em No Limit - Level XVIII (800/1600) - 2017/07/06 22:14:41 ET
Table '1648990476 3' 9-max Seat #7 is the button
Seat 1: JJin91 (46232 in chips)=20
Seat 2: CerPrisingLe (42309 in chips)=20
Seat 3: NoBadBeats44 (23964 in chips)=20
Seat 4: A A 5454 (52865 in chips)=20
Seat 5: Going2Ship (21856 in chips)=20
Seat 6: apoch19 (51309 in chips)=20
Seat 7: helzkitchen (155446 in chips)=20
Seat 8: nwmdnj (23702 in chips)=20
Seat 9: BUGG136 (73175 in chips)=20
JJin91: posts the ante 200
CerPrisingLe: posts the ante 200
NoBadBeats44: posts the ante 200
A A 5454: posts the ante 200
Going2Ship: posts the ante 200
apoch19: posts the ante 200
helzkitchen: posts the ante 200
nwmdnj: posts the ante 200
BUGG136: posts the ante 200
nwmdnj: posts small blind 800
BUGG136: posts big blind 1600
*** HOLE CARDS ***
Dealt to JJin91 [3d 2c]
JJin91: folds=20
CerPrisingLe: calls 1600
NoBadBeats44: folds=20
A A 5454: folds=20
Going2Ship: folds=20
apoch19: folds=20
helzkitchen: folds=20
nwmdnj: folds=20
BUGG136: checks=20
*** FLOP *** [4h Ad Qs]
BUGG136: bets 1600
CerPrisingLe: raises 3200 to 4800
BUGG136: folds=20
Uncalled bet (3200) returned to CerPrisingLe
CerPrisingLe collected 9000 from pot
CerPrisingLe: doesn't show hand=20
*** SUMMARY ***
Total pot 9000 | Rake 0=20
Board [4h Ad Qs]
Seat 1: JJin91 folded before Flop (didn't bet)
Seat 2: CerPrisingLe collected (9000)
Seat 3: NoBadBeats44 folded before Flop (didn't bet)
Seat 4: A A 5454 folded before Flop (didn't bet)
Seat 5: Going2Ship folded before Flop (didn't bet)
Seat 6: apoch19 folded before Flop (didn't bet)
Seat 7: helzkitchen (button) folded before Flop (didn't bet)
Seat 8: nwmdnj (small blind) folded before Flop
Seat 9: BUGG136 (big blind) folded on the Flop


*********** # 179 **************
PokerStars Hand #172150454417: Tournament #1648990476, $18.20+$1.80 USD=
 Hold'em No Limit - Level XVIII (800/1600) - 2017/07/06 22:15:10 ET
Table '1648990476 3' 9-max Seat #8 is the button
Seat 1: JJin91 (46032 in chips)=20
Seat 2: CerPrisingLe (47909 in chips)=20
Seat 3: NoBadBeats44 (23764 in chips)=20
Seat 4: A A 5454 (52665 in chips)=20
Seat 5: Going2Ship (21656 in chips)=20
Seat 6: apoch19 (51109 in chips)=20
Seat 7: helzkitchen (155246 in chips)=20
Seat 8: nwmdnj (22702 in chips)=20
Seat 9: BUGG136 (69775 in chips)=20
JJin91: posts the ante 200
CerPrisingLe: posts the ante 200
NoBadBeats44: posts the ante 200
A A 5454: posts the ante 200
Going2Ship: posts the ante 200
apoch19: posts the ante 200
helzkitchen: posts the ante 200
nwmdnj: posts the ante 200
BUGG136: posts the ante 200
BUGG136: posts small blind 800
JJin91: posts big blind 1600
*** HOLE CARDS ***
Dealt to JJin91 [3c 9s]
CerPrisingLe: folds=20
NoBadBeats44: folds=20
A A 5454: folds=20
Going2Ship: folds=20
apoch19: folds=20
helzkitchen: raises 1600 to 3200
nwmdnj: folds=20
BUGG136: calls 2400
JJin91: folds=20
*** FLOP *** [4d 9c As]
BUGG136: checks=20
helzkitchen: checks=20
*** TURN *** [4d 9c As] [5h]
BUGG136: bets 1600
helzkitchen: calls 1600
*** RIVER *** [4d 9c As 5h] [9d]
BUGG136: bets 1600
helzkitchen: raises 8000 to 9600
BUGG136: calls 8000
*** SHOW DOWN ***
helzkitchen: shows [Th Ks] (a pair of Nines)
BUGG136: shows [Ac Qd] (two pair, Aces and Nines)
BUGG136 collected 32200 from pot
*** SUMMARY ***
Total pot 32200 | Rake 0=20
Board [4d 9c As 5h 9d]
Seat 1: JJin91 (big blind) folded before Flop
Seat 2: CerPrisingLe folded before Flop (didn't bet)
Seat 3: NoBadBeats44 folded before Flop (didn't bet)
Seat 4: A A 5454 folded before Flop (didn't bet)
Seat 5: Going2Ship folded before Flop (didn't bet)
Seat 6: apoch19 folded before Flop (didn't bet)
Seat 7: helzkitchen showed [Th Ks] and lost with a pair of Nines
Seat 8: nwmdnj (button) folded before Flop (didn't bet)
Seat 9: BUGG136 (small blind) showed [Ac Qd] and won (32200) with two p=
air, Aces and Nines


*********** # 180 **************
PokerStars Hand #172150454733: Tournament #1648990476, $18.20+$1.80 USD=
 Hold'em No Limit - Level XVIII (800/1600) - 2017/07/06 22:16:17 ET
Table '1648990476 3' 9-max Seat #9 is the button
Seat 1: JJin91 (44232 in chips)=20
Seat 2: CerPrisingLe (47709 in chips)=20
Seat 3: NoBadBeats44 (23564 in chips)=20
Seat 4: A A 5454 (52465 in chips)=20
Seat 5: Going2Ship (21456 in chips)=20
Seat 6: apoch19 (50909 in chips)=20
Seat 7: helzkitchen (140646 in chips)=20
Seat 8: nwmdnj (22502 in chips)=20
Seat 9: BUGG136 (87375 in chips)=20
JJin91: posts the ante 200
CerPrisingLe: posts the ante 200
NoBadBeats44: posts the ante 200
A A 5454: posts the ante 200
Going2Ship: posts the ante 200
apoch19: posts the ante 200
helzkitchen: posts the ante 200
nwmdnj: posts the ante 200
BUGG136: posts the ante 200
JJin91: posts small blind 800
CerPrisingLe: posts big blind 1600
*** HOLE CARDS ***
Dealt to JJin91 [Td Qh]
NoBadBeats44: folds=20
A A 5454: folds=20
Going2Ship: folds=20
apoch19: raises 2250 to 3850
helzkitchen: folds=20
nwmdnj: folds=20
BUGG136: folds=20
JJin91: folds=20
CerPrisingLe: folds=20
Uncalled bet (2250) returned to apoch19
apoch19 collected 5800 from pot
apoch19: doesn't show hand=20
*** SUMMARY ***
Total pot 5800 | Rake 0=20
Seat 1: JJin91 (small blind) folded before Flop
Seat 2: CerPrisingLe (big blind) folded before Flop
Seat 3: NoBadBeats44 folded before Flop (didn't bet)
Seat 4: A A 5454 folded before Flop (didn't bet)
Seat 5: Going2Ship folded before Flop (didn't bet)
Seat 6: apoch19 collected (5800)
Seat 7: helzkitchen folded before Flop (didn't bet)
Seat 8: nwmdnj folded before Flop (didn't bet)
Seat 9: BUGG136 (button) folded before Flop (didn't bet)


*********** # 181 **************
PokerStars Hand #172150454889: Tournament #1648990476, $18.20+$1.80 USD=
 Hold'em No Limit - Level XVIII (800/1600) - 2017/07/06 22:16:48 ET
Table '1648990476 3' 9-max Seat #1 is the button
Seat 1: JJin91 (43232 in chips)=20
Seat 2: CerPrisingLe (45909 in chips)=20
Seat 3: NoBadBeats44 (23364 in chips)=20
Seat 4: A A 5454 (52265 in chips)=20
Seat 5: Going2Ship (21256 in chips)=20
Seat 6: apoch19 (54909 in chips)=20
Seat 7: helzkitchen (140446 in chips)=20
Seat 8: nwmdnj (22302 in chips)=20
Seat 9: BUGG136 (87175 in chips)=20
JJin91: posts the ante 200
CerPrisingLe: posts the ante 200
NoBadBeats44: posts the ante 200
A A 5454: posts the ante 200
Going2Ship: posts the ante 200
apoch19: posts the ante 200
helzkitchen: posts the ante 200
nwmdnj: posts the ante 200
BUGG136: posts the ante 200
CerPrisingLe: posts small blind 800
NoBadBeats44: posts big blind 1600
*** HOLE CARDS ***
Dealt to JJin91 [9s As]
A A 5454: folds=20
Going2Ship: folds=20
apoch19: folds=20
helzkitchen: folds=20
nwmdnj: folds=20
BUGG136: calls 1600
JJin91: calls 1600
CerPrisingLe: calls 800
NoBadBeats44: checks=20
*** FLOP *** [5h 6d Qc]
CerPrisingLe: checks=20
NoBadBeats44: checks=20
BUGG136: bets 1600
JJin91: folds=20
CerPrisingLe: calls 1600
NoBadBeats44: folds=20
*** TURN *** [5h 6d Qc] [Ts]
CerPrisingLe: checks=20
BUGG136: bets 1600
CerPrisingLe: raises 9600 to 11200
BUGG136: folds=20
Uncalled bet (9600) returned to CerPrisingLe
CerPrisingLe collected 14600 from pot
CerPrisingLe: doesn't show hand=20
*** SUMMARY ***
Total pot 14600 | Rake 0=20
Board [5h 6d Qc Ts]
Seat 1: JJin91 (button) folded on the Flop
Seat 2: CerPrisingLe (small blind) collected (14600)
Seat 3: NoBadBeats44 (big blind) folded on the Flop
Seat 4: A A 5454 folded before Flop (didn't bet)
Seat 5: Going2Ship folded before Flop (didn't bet)
Seat 6: apoch19 folded before Flop (didn't bet)
Seat 7: helzkitchen folded before Flop (didn't bet)
Seat 8: nwmdnj folded before Flop (didn't bet)
Seat 9: BUGG136 folded on the Turn


*********** # 182 **************
PokerStars Hand #172150455253: Tournament #1648990476, $18.20+$1.80 USD=
 Hold'em No Limit - Level XIX (1000/2000) - 2017/07/06 22:18:07 ET
Table '1648990476 3' 9-max Seat #2 is the button
Seat 1: JJin91 (41432 in chips)=20
Seat 2: CerPrisingLe (55509 in chips)=20
Seat 3: NoBadBeats44 (21564 in chips)=20
Seat 4: A A 5454 (52065 in chips)=20
Seat 5: Going2Ship (21056 in chips)=20
Seat 6: apoch19 (54709 in chips)=20
Seat 7: helzkitchen (140246 in chips)=20
Seat 8: nwmdnj (22102 in chips)=20
Seat 9: BUGG136 (82175 in chips)=20
JJin91: posts the ante 250
CerPrisingLe: posts the ante 250
NoBadBeats44: posts the ante 250
A A 5454: posts the ante 250
Going2Ship: posts the ante 250
apoch19: posts the ante 250
helzkitchen: posts the ante 250
nwmdnj: posts the ante 250
BUGG136: posts the ante 250
NoBadBeats44: posts small blind 1000
A A 5454: posts big blind 2000
*** HOLE CARDS ***
Dealt to JJin91 [6c 7h]
Going2Ship: folds=20
apoch19: folds=20
helzkitchen: raises 2000 to 4000
nwmdnj: folds=20
BUGG136: folds=20
JJin91: folds=20
CerPrisingLe: folds=20
NoBadBeats44: raises 17314 to 21314 and is all-in
A A 5454: folds=20
helzkitchen: calls 17314
*** FLOP *** [3s 5s Kc]
*** TURN *** [3s 5s Kc] [9s]
*** RIVER *** [3s 5s Kc 9s] [8s]
*** SHOW DOWN ***
NoBadBeats44: shows [Ah 7c] (high card Ace)
helzkitchen: shows [Jd Td] (high card King)
NoBadBeats44 collected 46878 from pot
*** SUMMARY ***
Total pot 46878 | Rake 0=20
Board [3s 5s Kc 9s 8s]
Seat 1: JJin91 folded before Flop (didn't bet)
Seat 2: CerPrisingLe (button) folded before Flop (didn't bet)
Seat 3: NoBadBeats44 (small blind) showed [Ah 7c] and won (46878) with =
high card Ace
Seat 4: A A 5454 (big blind) folded before Flop
Seat 5: Going2Ship folded before Flop (didn't bet)
Seat 6: apoch19 folded before Flop (didn't bet)
Seat 7: helzkitchen showed [Jd Td] and lost with high card King
Seat 8: nwmdnj folded before Flop (didn't bet)
Seat 9: BUGG136 folded before Flop (didn't bet)


*********** # 183 **************
PokerStars Hand #172150455463: Tournament #1648990476, $18.20+$1.80 USD=
 Hold'em No Limit - Level XIX (1000/2000) - 2017/07/06 22:18:44 ET
Table '1648990476 3' 9-max Seat #3 is the button
Seat 1: JJin91 (41182 in chips)=20
Seat 2: CerPrisingLe (55259 in chips)=20
Seat 3: NoBadBeats44 (46878 in chips)=20
Seat 4: A A 5454 (49815 in chips)=20
Seat 5: Going2Ship (20806 in chips)=20
Seat 6: apoch19 (54459 in chips)=20
Seat 7: helzkitchen (118682 in chips)=20
Seat 8: nwmdnj (21852 in chips)=20
Seat 9: BUGG136 (81925 in chips)=20
JJin91: posts the ante 250
CerPrisingLe: posts the ante 250
NoBadBeats44: posts the ante 250
A A 5454: posts the ante 250
Going2Ship: posts the ante 250
apoch19: posts the ante 250
helzkitchen: posts the ante 250
nwmdnj: posts the ante 250
BUGG136: posts the ante 250
A A 5454: posts small blind 1000
Going2Ship: posts big blind 2000
*** HOLE CARDS ***
Dealt to JJin91 [4s 3d]
apoch19: raises 2850 to 4850
helzkitchen: folds=20
nwmdnj: folds=20
BUGG136: folds=20
JJin91: folds=20
CerPrisingLe: folds=20
NoBadBeats44: folds=20
A A 5454: calls 3850
Going2Ship: folds=20
*** FLOP *** [7s 5h Ts]
A A 5454: checks=20
apoch19: bets 7850
A A 5454: folds=20
Uncalled bet (7850) returned to apoch19
apoch19 collected 13950 from pot
apoch19: doesn't show hand=20
*** SUMMARY ***
Total pot 13950 | Rake 0=20
Board [7s 5h Ts]
Seat 1: JJin91 folded before Flop (didn't bet)
Seat 2: CerPrisingLe folded before Flop (didn't bet)
Seat 3: NoBadBeats44 (button) folded before Flop (didn't bet)
Seat 4: A A 5454 (small blind) folded on the Flop
Seat 5: Going2Ship (big blind) folded before Flop
Seat 6: apoch19 collected (13950)
Seat 7: helzkitchen folded before Flop (didn't bet)
Seat 8: nwmdnj folded before Flop (didn't bet)
Seat 9: BUGG136 folded before Flop (didn't bet)


*********** # 184 **************
PokerStars Hand #172150455646: Tournament #1648990476, $18.20+$1.80 USD=
 Hold'em No Limit - Level XIX (1000/2000) - 2017/07/06 22:19:26 ET
Table '1648990476 3' 9-max Seat #4 is the button
Seat 1: JJin91 (40932 in chips)=20
Seat 2: CerPrisingLe (55009 in chips)=20
Seat 3: NoBadBeats44 (46628 in chips)=20
Seat 4: A A 5454 (44715 in chips)=20
Seat 5: Going2Ship (18556 in chips)=20
Seat 6: apoch19 (63309 in chips)=20
Seat 7: helzkitchen (118432 in chips)=20
Seat 8: nwmdnj (21602 in chips)=20
Seat 9: BUGG136 (81675 in chips)=20
JJin91: posts the ante 250
CerPrisingLe: posts the ante 250
NoBadBeats44: posts the ante 250
A A 5454: posts the ante 250
Going2Ship: posts the ante 250
apoch19: posts the ante 250
helzkitchen: posts the ante 250
nwmdnj: posts the ante 250
BUGG136: posts the ante 250
Going2Ship: posts small blind 1000
apoch19: posts big blind 2000
*** HOLE CARDS ***
Dealt to JJin91 [Th Ts]
helzkitchen: folds=20
nwmdnj: folds=20
BUGG136: folds=20
JJin91: raises 2220 to 4220
CerPrisingLe: folds=20
NoBadBeats44: folds=20
A A 5454: folds=20
Going2Ship: folds=20
apoch19: folds=20
Uncalled bet (2220) returned to JJin91
JJin91 collected 7250 from pot
JJin91: doesn't show hand=20
*** SUMMARY ***
Total pot 7250 | Rake 0=20
Seat 1: JJin91 collected (7250)
Seat 2: CerPrisingLe folded before Flop (didn't bet)
Seat 3: NoBadBeats44 folded before Flop (didn't bet)
Seat 4: A A 5454 (button) folded before Flop (didn't bet)
Seat 5: Going2Ship (small blind) folded before Flop
Seat 6: apoch19 (big blind) folded before Flop
Seat 7: helzkitchen folded before Flop (didn't bet)
Seat 8: nwmdnj folded before Flop (didn't bet)
Seat 9: BUGG136 folded before Flop (didn't bet)


*********** # 185 **************
PokerStars Hand #172150455751: Tournament #1648990476, $18.20+$1.80 USD=
 Hold'em No Limit - Level XIX (1000/2000) - 2017/07/06 22:19:46 ET
Table '1648990476 3' 9-max Seat #5 is the button
Seat 1: JJin91 (45932 in chips)=20
Seat 2: CerPrisingLe (54759 in chips)=20
Seat 3: NoBadBeats44 (46378 in chips)=20
Seat 4: A A 5454 (44465 in chips)=20
Seat 5: Going2Ship (17306 in chips)=20
Seat 6: apoch19 (61059 in chips)=20
Seat 7: helzkitchen (118182 in chips)=20
Seat 8: nwmdnj (21352 in chips)=20
Seat 9: BUGG136 (81425 in chips)=20
JJin91: posts the ante 250
CerPrisingLe: posts the ante 250
NoBadBeats44: posts the ante 250
A A 5454: posts the ante 250
Going2Ship: posts the ante 250
apoch19: posts the ante 250
helzkitchen: posts the ante 250
nwmdnj: posts the ante 250
BUGG136: posts the ante 250
apoch19: posts small blind 1000
helzkitchen: posts big blind 2000
*** HOLE CARDS ***
Dealt to JJin91 [3s Kd]
nwmdnj: folds=20
BUGG136: folds=20
JJin91: folds=20
CerPrisingLe: folds=20
NoBadBeats44: raises 2400 to 4400
A A 5454: calls 4400
Going2Ship: raises 12656 to 17056 and is all-in
apoch19: folds=20
helzkitchen: folds=20
NoBadBeats44: raises 29072 to 46128 and is all-in
A A 5454: folds=20
Uncalled bet (29072) returned to NoBadBeats44
*** FLOP *** [8c Ks 4d]
*** TURN *** [8c Ks 4d] [Qh]
*** RIVER *** [8c Ks 4d Qh] [Jc]
*** SHOW DOWN ***
NoBadBeats44: shows [7d 7s] (a pair of Sevens)
Going2Ship: shows [Ac Td] (a straight, Ten to Ace)
Going2Ship collected 43762 from pot
*** SUMMARY ***
Total pot 43762 | Rake 0=20
Board [8c Ks 4d Qh Jc]
Seat 1: JJin91 folded before Flop (didn't bet)
Seat 2: CerPrisingLe folded before Flop (didn't bet)
Seat 3: NoBadBeats44 showed [7d 7s] and lost with a pair of Sevens
Seat 4: A A 5454 folded before Flop
Seat 5: Going2Ship (button) showed [Ac Td] and won (43762) with a strai=
ght, Ten to Ace
Seat 6: apoch19 (small blind) folded before Flop
Seat 7: helzkitchen (big blind) folded before Flop
Seat 8: nwmdnj folded before Flop (didn't bet)
Seat 9: BUGG136 folded before Flop (didn't bet)


*********** # 186 **************
PokerStars Hand #172150455941: Tournament #1648990476, $18.20+$1.80 USD=
 Hold'em No Limit - Level XIX (1000/2000) - 2017/07/06 22:20:26 ET
Table '1648990476 3' 9-max Seat #6 is the button
Seat 1: JJin91 (45682 in chips)=20
Seat 2: CerPrisingLe (54509 in chips)=20
Seat 3: NoBadBeats44 (29072 in chips)=20
Seat 4: A A 5454 (39815 in chips)=20
Seat 5: Going2Ship (43762 in chips)=20
Seat 6: apoch19 (59809 in chips)=20
Seat 7: helzkitchen (115932 in chips)=20
Seat 8: nwmdnj (21102 in chips)=20
Seat 9: BUGG136 (81175 in chips)=20
JJin91: posts the ante 250
CerPrisingLe: posts the ante 250
NoBadBeats44: posts the ante 250
A A 5454: posts the ante 250
Going2Ship: posts the ante 250
apoch19: posts the ante 250
helzkitchen: posts the ante 250
nwmdnj: posts the ante 250
BUGG136: posts the ante 250
helzkitchen: posts small blind 1000
nwmdnj: posts big blind 2000
*** HOLE CARDS ***
Dealt to JJin91 [Ts 5c]
BUGG136: folds=20
JJin91: folds=20
CerPrisingLe: folds=20
NoBadBeats44: folds=20
A A 5454: folds=20
Going2Ship: folds=20
apoch19: raises 2850 to 4850
helzkitchen: folds=20
nwmdnj: folds=20
Uncalled bet (2850) returned to apoch19
apoch19 collected 7250 from pot
apoch19: doesn't show hand=20
*** SUMMARY ***
Total pot 7250 | Rake 0=20
Seat 1: JJin91 folded before Flop (didn't bet)
Seat 2: CerPrisingLe folded before Flop (didn't bet)
Seat 3: NoBadBeats44 folded before Flop (didn't bet)
Seat 4: A A 5454 folded before Flop (didn't bet)
Seat 5: Going2Ship folded before Flop (didn't bet)
Seat 6: apoch19 (button) collected (7250)
Seat 7: helzkitchen (small blind) folded before Flop
Seat 8: nwmdnj (big blind) folded before Flop
Seat 9: BUGG136 folded before Flop (didn't bet)


*********** # 187 **************
PokerStars Hand #172150456117: Tournament #1648990476, $18.20+$1.80 USD=
 Hold'em No Limit - Level XIX (1000/2000) - 2017/07/06 22:20:57 ET
Table '1648990476 3' 9-max Seat #7 is the button
Seat 1: JJin91 (45432 in chips)=20
Seat 2: CerPrisingLe (54259 in chips)=20
Seat 3: NoBadBeats44 (28822 in chips)=20
Seat 4: A A 5454 (39565 in chips)=20
Seat 5: Going2Ship (43512 in chips)=20
Seat 6: apoch19 (64809 in chips)=20
Seat 7: helzkitchen (114682 in chips)=20
Seat 8: nwmdnj (18852 in chips)=20
Seat 9: BUGG136 (80925 in chips)=20
JJin91: posts the ante 250
CerPrisingLe: posts the ante 250
NoBadBeats44: posts the ante 250
A A 5454: posts the ante 250
Going2Ship: posts the ante 250
apoch19: posts the ante 250
helzkitchen: posts the ante 250
nwmdnj: posts the ante 250
BUGG136: posts the ante 250
nwmdnj: posts small blind 1000
BUGG136: posts big blind 2000
*** HOLE CARDS ***
Dealt to JJin91 [3c Qs]
JJin91: folds=20
CerPrisingLe: raises 2000 to 4000
NoBadBeats44: folds=20
A A 5454: folds=20
Going2Ship: folds=20
apoch19: folds=20
helzkitchen: calls 4000
nwmdnj: folds=20
BUGG136: folds=20
*** FLOP *** [Js Kc 9c]
CerPrisingLe: bets 6000
helzkitchen: folds=20
Uncalled bet (6000) returned to CerPrisingLe
CerPrisingLe collected 13250 from pot
CerPrisingLe: doesn't show hand=20
*** SUMMARY ***
Total pot 13250 | Rake 0=20
Board [Js Kc 9c]
Seat 1: JJin91 folded before Flop (didn't bet)
Seat 2: CerPrisingLe collected (13250)
Seat 3: NoBadBeats44 folded before Flop (didn't bet)
Seat 4: A A 5454 folded before Flop (didn't bet)
Seat 5: Going2Ship folded before Flop (didn't bet)
Seat 6: apoch19 folded before Flop (didn't bet)
Seat 7: helzkitchen (button) folded on the Flop
Seat 8: nwmdnj (small blind) folded before Flop
Seat 9: BUGG136 (big blind) folded before Flop


*********** # 188 **************
PokerStars Hand #172150456240: Tournament #1648990476, $18.20+$1.80 USD=
 Hold'em No Limit - Level XIX (1000/2000) - 2017/07/06 22:21:21 ET
Table '1648990476 3' 9-max Seat #8 is the button
Seat 1: JJin91 (45182 in chips)=20
Seat 2: CerPrisingLe (63259 in chips)=20
Seat 3: NoBadBeats44 (28572 in chips)=20
Seat 4: A A 5454 (39315 in chips)=20
Seat 5: Going2Ship (43262 in chips)=20
Seat 6: apoch19 (64559 in chips)=20
Seat 7: helzkitchen (110432 in chips)=20
Seat 8: nwmdnj (17602 in chips)=20
Seat 9: BUGG136 (78675 in chips)=20
JJin91: posts the ante 250
CerPrisingLe: posts the ante 250
NoBadBeats44: posts the ante 250
A A 5454: posts the ante 250
Going2Ship: posts the ante 250
apoch19: posts the ante 250
helzkitchen: posts the ante 250
nwmdnj: posts the ante 250
BUGG136: posts the ante 250
BUGG136: posts small blind 1000
JJin91: posts big blind 2000
*** HOLE CARDS ***
Dealt to JJin91 [Qs Ts]
CerPrisingLe: raises 2000 to 4000
NoBadBeats44: raises 24322 to 28322 and is all-in
A A 5454: folds=20
Going2Ship: folds=20
apoch19: folds=20
helzkitchen: folds=20
nwmdnj: folds=20
BUGG136: folds=20
JJin91: folds=20
CerPrisingLe: folds=20
Uncalled bet (24322) returned to NoBadBeats44
NoBadBeats44 collected 13250 from pot
NoBadBeats44: doesn't show hand=20
*** SUMMARY ***
Total pot 13250 | Rake 0=20
Seat 1: JJin91 (big blind) folded before Flop
Seat 2: CerPrisingLe folded before Flop
Seat 3: NoBadBeats44 collected (13250)
Seat 4: A A 5454 folded before Flop (didn't bet)
Seat 5: Going2Ship folded before Flop (didn't bet)
Seat 6: apoch19 folded before Flop (didn't bet)
Seat 7: helzkitchen folded before Flop (didn't bet)
Seat 8: nwmdnj (button) folded before Flop (didn't bet)
Seat 9: BUGG136 (small blind) folded before Flop


*********** # 189 **************
PokerStars Hand #172150456409: Tournament #1648990476, $18.20+$1.80 USD=
 Hold'em No Limit - Level XIX (1000/2000) - 2017/07/06 22:21:56 ET
Table '1648990476 3' 9-max Seat #9 is the button
Seat 1: JJin91 (42932 in chips)=20
Seat 2: CerPrisingLe (59009 in chips)=20
Seat 3: NoBadBeats44 (37572 in chips)=20
Seat 4: A A 5454 (39065 in chips)=20
Seat 5: Going2Ship (43012 in chips)=20
Seat 6: apoch19 (64309 in chips)=20
Seat 7: helzkitchen (110182 in chips)=20
Seat 8: nwmdnj (17352 in chips)=20
Seat 9: BUGG136 (77425 in chips)=20
JJin91: posts the ante 250
CerPrisingLe: posts the ante 250
NoBadBeats44: posts the ante 250
A A 5454: posts the ante 250
Going2Ship: posts the ante 250
apoch19: posts the ante 250
helzkitchen: posts the ante 250
nwmdnj: posts the ante 250
BUGG136: posts the ante 250
JJin91: posts small blind 1000
CerPrisingLe: posts big blind 2000
*** HOLE CARDS ***
Dealt to JJin91 [5c Th]
NoBadBeats44: folds=20
A A 5454: folds=20
Going2Ship: folds=20
apoch19: folds=20
helzkitchen: folds=20
nwmdnj: raises 15102 to 17102 and is all-in
BUGG136: folds=20
JJin91: folds=20
CerPrisingLe: folds=20
Uncalled bet (15102) returned to nwmdnj
nwmdnj collected 7250 from pot
nwmdnj: doesn't show hand=20
*** SUMMARY ***
Total pot 7250 | Rake 0=20
Seat 1: JJin91 (small blind) folded before Flop
Seat 2: CerPrisingLe (big blind) folded before Flop
Seat 3: NoBadBeats44 folded before Flop (didn't bet)
Seat 4: A A 5454 folded before Flop (didn't bet)
Seat 5: Going2Ship folded before Flop (didn't bet)
Seat 6: apoch19 folded before Flop (didn't bet)
Seat 7: helzkitchen folded before Flop (didn't bet)
Seat 8: nwmdnj collected (7250)
Seat 9: BUGG136 (button) folded before Flop (didn't bet)


*********** # 190 **************
PokerStars Hand #172150456562: Tournament #1648990476, $18.20+$1.80 USD=
 Hold'em No Limit - Level XIX (1000/2000) - 2017/07/06 22:22:26 ET
Table '1648990476 3' 9-max Seat #1 is the button
Seat 1: JJin91 (41682 in chips)=20
Seat 2: CerPrisingLe (56759 in chips)=20
Seat 3: NoBadBeats44 (37322 in chips)=20
Seat 4: A A 5454 (38815 in chips)=20
Seat 5: Going2Ship (42762 in chips)=20
Seat 6: apoch19 (64059 in chips)=20
Seat 7: helzkitchen (109932 in chips)=20
Seat 8: nwmdnj (22352 in chips)=20
Seat 9: BUGG136 (77175 in chips)=20
JJin91: posts the ante 250
CerPrisingLe: posts the ante 250
NoBadBeats44: posts the ante 250
A A 5454: posts the ante 250
Going2Ship: posts the ante 250
apoch19: posts the ante 250
helzkitchen: posts the ante 250
nwmdnj: posts the ante 250
BUGG136: posts the ante 250
CerPrisingLe: posts small blind 1000
NoBadBeats44: posts big blind 2000
*** HOLE CARDS ***
Dealt to JJin91 [Ah 5s]
A A 5454: folds=20
Going2Ship: folds=20
apoch19: folds=20
helzkitchen: raises 2000 to 4000
nwmdnj: folds=20
BUGG136: folds=20
JJin91: folds=20
CerPrisingLe: folds=20
NoBadBeats44: folds=20
Uncalled bet (2000) returned to helzkitchen
helzkitchen collected 7250 from pot
helzkitchen: doesn't show hand=20
*** SUMMARY ***
Total pot 7250 | Rake 0=20
Seat 1: JJin91 (button) folded before Flop (didn't bet)
Seat 2: CerPrisingLe (small blind) folded before Flop
Seat 3: NoBadBeats44 (big blind) folded before Flop
Seat 4: A A 5454 folded before Flop (didn't bet)
Seat 5: Going2Ship folded before Flop (didn't bet)
Seat 6: apoch19 folded before Flop (didn't bet)
Seat 7: helzkitchen collected (7250)
Seat 8: nwmdnj folded before Flop (didn't bet)
Seat 9: BUGG136 folded before Flop (didn't bet)


*********** # 191 **************
PokerStars Hand #172150456634: Tournament #1648990476, $18.20+$1.80 USD=
 Hold'em No Limit - Level XIX (1000/2000) - 2017/07/06 22:22:45 ET
Table '1648990476 3' 9-max Seat #2 is the button
Seat 1: JJin91 (41432 in chips)=20
Seat 2: CerPrisingLe (55509 in chips)=20
Seat 3: NoBadBeats44 (35072 in chips)=20
Seat 4: A A 5454 (38565 in chips)=20
Seat 5: Going2Ship (42512 in chips)=20
Seat 6: apoch19 (63809 in chips)=20
Seat 7: helzkitchen (114932 in chips)=20
Seat 8: nwmdnj (22102 in chips)=20
Seat 9: BUGG136 (76925 in chips)=20
JJin91: posts the ante 250
CerPrisingLe: posts the ante 250
NoBadBeats44: posts the ante 250
A A 5454: posts the ante 250
Going2Ship: posts the ante 250
apoch19: posts the ante 250
helzkitchen: posts the ante 250
nwmdnj: posts the ante 250
BUGG136: posts the ante 250
NoBadBeats44: posts small blind 1000
A A 5454: posts big blind 2000
*** HOLE CARDS ***
Dealt to JJin91 [2h Tc]
Going2Ship: folds=20
apoch19: folds=20
helzkitchen: folds=20
nwmdnj: folds=20
BUGG136: calls 2000
JJin91: folds=20
CerPrisingLe: raises 4000 to 6000
NoBadBeats44: calls 5000
A A 5454: folds=20
BUGG136: calls 4000
*** FLOP *** [Qs 4c Qd]
NoBadBeats44: checks=20
BUGG136: checks=20
CerPrisingLe: bets 8000
NoBadBeats44: folds=20
BUGG136: folds=20
Uncalled bet (8000) returned to CerPrisingLe
CerPrisingLe collected 22250 from pot
CerPrisingLe: doesn't show hand=20
*** SUMMARY ***
Total pot 22250 | Rake 0=20
Board [Qs 4c Qd]
Seat 1: JJin91 folded before Flop (didn't bet)
Seat 2: CerPrisingLe (button) collected (22250)
Seat 3: NoBadBeats44 (small blind) folded on the Flop
Seat 4: A A 5454 (big blind) folded before Flop
Seat 5: Going2Ship folded before Flop (didn't bet)
Seat 6: apoch19 folded before Flop (didn't bet)
Seat 7: helzkitchen folded before Flop (didn't bet)
Seat 8: nwmdnj folded before Flop (didn't bet)
Seat 9: BUGG136 folded on the Flop


*********** # 192 **************
PokerStars Hand #172150456813: Tournament #1648990476, $18.20+$1.80 USD=
 Hold'em No Limit - Level XIX (1000/2000) - 2017/07/06 22:23:25 ET
Table '1648990476 3' 9-max Seat #3 is the button
Seat 1: JJin91 (41182 in chips)=20
Seat 2: CerPrisingLe (71509 in chips)=20
Seat 3: NoBadBeats44 (28822 in chips)=20
Seat 4: A A 5454 (36315 in chips)=20
Seat 5: Going2Ship (42262 in chips)=20
Seat 6: apoch19 (63559 in chips)=20
Seat 7: helzkitchen (114682 in chips)=20
Seat 8: nwmdnj (21852 in chips)=20
Seat 9: BUGG136 (70675 in chips)=20
JJin91: posts the ante 250
CerPrisingLe: posts the ante 250
NoBadBeats44: posts the ante 250
A A 5454: posts the ante 250
Going2Ship: posts the ante 250
apoch19: posts the ante 250
helzkitchen: posts the ante 250
nwmdnj: posts the ante 250
BUGG136: posts the ante 250
A A 5454: posts small blind 1000
Going2Ship: posts big blind 2000
*** HOLE CARDS ***
Dealt to JJin91 [Tc 3h]
apoch19: folds=20
helzkitchen: folds=20
nwmdnj: raises 19602 to 21602 and is all-in
BUGG136: folds=20
JJin91: folds=20
CerPrisingLe: folds=20
NoBadBeats44: raises 6970 to 28572 and is all-in
A A 5454: folds=20
Going2Ship: folds=20
Uncalled bet (6970) returned to NoBadBeats44
*** FLOP *** [Qh 5s Jh]
*** TURN *** [Qh 5s Jh] [7d]
*** RIVER *** [Qh 5s Jh 7d] [4h]
*** SHOW DOWN ***
nwmdnj: shows [9c 9d] (a pair of Nines)
NoBadBeats44: shows [Td Kc] (high card King)
nwmdnj collected 48454 from pot
*** SUMMARY ***
Total pot 48454 | Rake 0=20
Board [Qh 5s Jh 7d 4h]
Seat 1: JJin91 folded before Flop (didn't bet)
Seat 2: CerPrisingLe folded before Flop (didn't bet)
Seat 3: NoBadBeats44 (button) showed [Td Kc] and lost with high card Ki=
ng
Seat 4: A A 5454 (small blind) folded before Flop
Seat 5: Going2Ship (big blind) folded before Flop
Seat 6: apoch19 folded before Flop (didn't bet)
Seat 7: helzkitchen folded before Flop (didn't bet)
Seat 8: nwmdnj showed [9c 9d] and won (48454) with a pair of Nines
Seat 9: BUGG136 folded before Flop (didn't bet)


*********** # 193 **************
PokerStars Hand #172150457055: Tournament #1648990476, $18.20+$1.80 USD=
 Hold'em No Limit - Level XIX (1000/2000) - 2017/07/06 22:24:18 ET
Table '1648990476 3' 9-max Seat #4 is the button
Seat 1: JJin91 (40932 in chips)=20
Seat 2: CerPrisingLe (71259 in chips)=20
Seat 3: NoBadBeats44 (6970 in chips)=20
Seat 4: A A 5454 (35065 in chips)=20
Seat 5: Going2Ship (40012 in chips)=20
Seat 6: apoch19 (63309 in chips)=20
Seat 7: helzkitchen (114432 in chips)=20
Seat 8: nwmdnj (48454 in chips)=20
Seat 9: BUGG136 (70425 in chips)=20
JJin91: posts the ante 250
CerPrisingLe: posts the ante 250
NoBadBeats44: posts the ante 250
A A 5454: posts the ante 250
Going2Ship: posts the ante 250
apoch19: posts the ante 250
helzkitchen: posts the ante 250
nwmdnj: posts the ante 250
BUGG136: posts the ante 250
Going2Ship: posts small blind 1000
apoch19: posts big blind 2000
*** HOLE CARDS ***
Dealt to JJin91 [8s Qh]
helzkitchen: folds=20
nwmdnj: raises 2000 to 4000
BUGG136: folds=20
JJin91: folds=20
CerPrisingLe has timed out
CerPrisingLe: folds=20
CerPrisingLe is sitting out
NoBadBeats44: raises 2720 to 6720 and is all-in
A A 5454: folds=20
Going2Ship: folds=20
apoch19: folds=20
CerPrisingLe has returned
nwmdnj: calls 2720
*** FLOP *** [Qs Ts 5d]
*** TURN *** [Qs Ts 5d] [2d]
*** RIVER *** [Qs Ts 5d 2d] [8c]
*** SHOW DOWN ***
nwmdnj: shows [5s 5h] (three of a kind, Fives)
NoBadBeats44: shows [Kd As] (high card Ace)
nwmdnj collected 18690 from pot
NoBadBeats44 finished the tournament in 26th place and received $24.57.
*** SUMMARY ***
Total pot 18690 | Rake 0=20
Board [Qs Ts 5d 2d 8c]
Seat 1: JJin91 folded before Flop (didn't bet)
Seat 2: CerPrisingLe folded before Flop (didn't bet)
Seat 3: NoBadBeats44 showed [Kd As] and lost with high card Ace
Seat 4: A A 5454 (button) folded before Flop (didn't bet)
Seat 5: Going2Ship (small blind) folded before Flop
Seat 6: apoch19 (big blind) folded before Flop
Seat 7: helzkitchen folded before Flop (didn't bet)
Seat 8: nwmdnj showed [5s 5h] and won (18690) with three of a kind, Fiv=
es
Seat 9: BUGG136 folded before Flop (didn't bet)


*********** # 194 **************
PokerStars Hand #172150457349: Tournament #1648990476, $18.20+$1.80 USD=
 Hold'em No Limit - Level XIX (1000/2000) - 2017/07/06 22:25:30 ET
Table '1648990476 3' 9-max Seat #5 is the button
Seat 1: JJin91 (40682 in chips)=20
Seat 2: CerPrisingLe (71009 in chips)=20
Seat 4: A A 5454 (34815 in chips)=20
Seat 5: Going2Ship (38762 in chips)=20
Seat 6: apoch19 (61059 in chips)=20
Seat 7: helzkitchen (114182 in chips)=20
Seat 8: nwmdnj (60174 in chips)=20
Seat 9: BUGG136 (70175 in chips)=20
JJin91: posts the ante 250
CerPrisingLe: posts the ante 250
A A 5454: posts the ante 250
Going2Ship: posts the ante 250
apoch19: posts the ante 250
helzkitchen: posts the ante 250
nwmdnj: posts the ante 250
BUGG136: posts the ante 250
apoch19: posts small blind 1000
helzkitchen: posts big blind 2000
*** HOLE CARDS ***
Dealt to JJin91 [5h 7c]
nwmdnj: raises 3000 to 5000
BUGG136: folds=20
JJin91: folds=20
CerPrisingLe: folds=20
A A 5454: folds=20
Going2Ship: folds=20
apoch19: raises 9500 to 14500
helzkitchen: folds=20
nwmdnj: raises 45424 to 59924 and is all-in
apoch19: calls 45424
*** FLOP *** [5d Ts 8d]
*** TURN *** [5d Ts 8d] [2s]
*** RIVER *** [5d Ts 8d 2s] [Js]
*** SHOW DOWN ***
apoch19: shows [Ah Ac] (a pair of Aces)
nwmdnj: shows [Kc Kh] (a pair of Kings)
apoch19 collected 123848 from pot
nwmdnj finished the tournament in 25th place and received $24.57.
*** SUMMARY ***
Total pot 123848 | Rake 0=20
Board [5d Ts 8d 2s Js]
Seat 1: JJin91 folded before Flop (didn't bet)
Seat 2: CerPrisingLe folded before Flop (didn't bet)
Seat 4: A A 5454 folded before Flop (didn't bet)
Seat 5: Going2Ship (button) folded before Flop (didn't bet)
Seat 6: apoch19 (small blind) showed [Ah Ac] and won (123848) with a pa=
ir of Aces
Seat 7: helzkitchen (big blind) folded before Flop
Seat 8: nwmdnj showed [Kc Kh] and lost with a pair of Kings
Seat 9: BUGG136 folded before Flop (didn't bet)


*********** # 195 **************
PokerStars Hand #172150457631: Tournament #1648990476, $18.20+$1.80 USD=
 Hold'em No Limit - Level XIX (1000/2000) - 2017/07/06 22:26:26 ET
Table '1648990476 3' 9-max Seat #6 is the button
Seat 1: JJin91 (40432 in chips)=20
Seat 2: CerPrisingLe (70759 in chips)=20
Seat 4: A A 5454 (34565 in chips)=20
Seat 5: Going2Ship (38512 in chips)=20
Seat 6: apoch19 (124733 in chips)=20
Seat 7: helzkitchen (111932 in chips)=20
Seat 9: BUGG136 (69925 in chips)=20
JJin91: posts the ante 250
CerPrisingLe: posts the ante 250
A A 5454: posts the ante 250
Going2Ship: posts the ante 250
apoch19: posts the ante 250
helzkitchen: posts the ante 250
BUGG136: posts the ante 250
helzkitchen: posts small blind 1000
BUGG136: posts big blind 2000
*** HOLE CARDS ***
Dealt to JJin91 [8c Qd]
JJin91: folds=20
CerPrisingLe has timed out
CerPrisingLe: folds=20
CerPrisingLe is sitting out
A A 5454: folds=20
Going2Ship: folds=20
apoch19: raises 2850 to 4850
CerPrisingLe has returned
helzkitchen: folds=20
BUGG136: calls 2850
*** FLOP *** [Kc Td 9s]
BUGG136: checks=20
apoch19: checks=20
*** TURN *** [Kc Td 9s] [5c]
BUGG136: checks=20
apoch19: checks=20
*** RIVER *** [Kc Td 9s 5c] [Kh]
BUGG136: checks=20
apoch19: checks=20
*** SHOW DOWN ***
BUGG136: shows [As Qh] (a pair of Kings)
apoch19: mucks hand=20
BUGG136 collected 12450 from pot
*** SUMMARY ***
Total pot 12450 | Rake 0=20
Board [Kc Td 9s 5c Kh]
Seat 1: JJin91 folded before Flop (didn't bet)
Seat 2: CerPrisingLe folded before Flop (didn't bet)
Seat 4: A A 5454 folded before Flop (didn't bet)
Seat 5: Going2Ship folded before Flop (didn't bet)
Seat 6: apoch19 (button) mucked [2c Ac]
Seat 7: helzkitchen (small blind) folded before Flop
Seat 9: BUGG136 (big blind) showed [As Qh] and won (12450) with a pair =
of Kings


*********** # 196 **************
PokerStars Hand #172150457969: Tournament #1648990476, $18.20+$1.80 USD=
 Hold'em No Limit - Level XX (1250/2500) - 2017/07/06 22:27:39 ET
Table '1648990476 3' 9-max Seat #7 is the button
Seat 1: JJin91 (40182 in chips)=20
Seat 2: CerPrisingLe (70509 in chips)=20
Seat 4: A A 5454 (34315 in chips)=20
Seat 5: Going2Ship (38262 in chips)=20
Seat 6: apoch19 (119633 in chips)=20
Seat 7: helzkitchen (110682 in chips)=20
Seat 8: GetLoose17 (47068 in chips) out of hand (moved from another tab=
le into small blind)
Seat 9: BUGG136 (77275 in chips)=20
JJin91: posts the ante 325
CerPrisingLe: posts the ante 325
A A 5454: posts the ante 325
Going2Ship: posts the ante 325
apoch19: posts the ante 325
helzkitchen: posts the ante 325
BUGG136: posts the ante 325
BUGG136: posts small blind 1250
JJin91: posts big blind 2500
*** HOLE CARDS ***
Dealt to JJin91 [Js 8d]
CerPrisingLe: folds=20
A A 5454: folds=20
Going2Ship: folds=20
apoch19: folds=20
helzkitchen: raises 2500 to 5000
BUGG136: folds=20
JJin91: folds=20
Uncalled bet (2500) returned to helzkitchen
helzkitchen collected 8525 from pot
helzkitchen: doesn't show hand=20
*** SUMMARY ***
Total pot 8525 | Rake 0=20
Seat 1: JJin91 (big blind) folded before Flop
Seat 2: CerPrisingLe folded before Flop (didn't bet)
Seat 4: A A 5454 folded before Flop (didn't bet)
Seat 5: Going2Ship folded before Flop (didn't bet)
Seat 6: apoch19 folded before Flop (didn't bet)
Seat 7: helzkitchen (button) collected (8525)
Seat 9: BUGG136 (small blind) folded before Flop


*********** # 197 **************
PokerStars Hand #172150458106: Tournament #1648990476, $18.20+$1.80 USD=
 Hold'em No Limit - Level XX (1250/2500) - 2017/07/06 22:28:07 ET
Table '1648990476 3' 9-max Seat #9 is the button
Seat 1: JJin91 (37357 in chips)=20
Seat 2: CerPrisingLe (70184 in chips)=20
Seat 4: A A 5454 (33990 in chips)=20
Seat 5: Going2Ship (37937 in chips)=20
Seat 6: apoch19 (119308 in chips)=20
Seat 7: helzkitchen (116382 in chips)=20
Seat 8: GetLoose17 (47068 in chips)=20
Seat 9: BUGG136 (75700 in chips)=20
JJin91: posts the ante 325
CerPrisingLe: posts the ante 325
A A 5454: posts the ante 325
Going2Ship: posts the ante 325
apoch19: posts the ante 325
helzkitchen: posts the ante 325
GetLoose17: posts the ante 325
BUGG136: posts the ante 325
JJin91: posts small blind 1250
CerPrisingLe: posts big blind 2500
*** HOLE CARDS ***
Dealt to JJin91 [2d 9s]
A A 5454: folds=20
Going2Ship: folds=20
apoch19: folds=20
helzkitchen: folds=20
GetLoose17: folds=20
BUGG136: folds=20
JJin91: folds=20
Uncalled bet (1250) returned to CerPrisingLe
CerPrisingLe collected 5100 from pot
CerPrisingLe: doesn't show hand=20
*** SUMMARY ***
Total pot 5100 | Rake 0=20
Seat 1: JJin91 (small blind) folded before Flop
Seat 2: CerPrisingLe (big blind) collected (5100)
Seat 4: A A 5454 folded before Flop (didn't bet)
Seat 5: Going2Ship folded before Flop (didn't bet)
Seat 6: apoch19 folded before Flop (didn't bet)
Seat 7: helzkitchen folded before Flop (didn't bet)
Seat 8: GetLoose17 folded before Flop (didn't bet)
Seat 9: BUGG136 (button) folded before Flop (didn't bet)


*********** # 198 **************
PokerStars Hand #172150458172: Tournament #1648990476, $18.20+$1.80 USD=
 Hold'em No Limit - Level XX (1250/2500) - 2017/07/06 22:28:22 ET
Table '1648990476 3' 9-max Seat #1 is the button
Seat 1: JJin91 (35782 in chips)=20
Seat 2: CerPrisingLe (73709 in chips)=20
Seat 4: A A 5454 (33665 in chips)=20
Seat 5: Going2Ship (37612 in chips)=20
Seat 6: apoch19 (118983 in chips)=20
Seat 7: helzkitchen (116057 in chips)=20
Seat 8: GetLoose17 (46743 in chips)=20
Seat 9: BUGG136 (75375 in chips)=20
JJin91: posts the ante 325
CerPrisingLe: posts the ante 325
A A 5454: posts the ante 325
Going2Ship: posts the ante 325
apoch19: posts the ante 325
helzkitchen: posts the ante 325
GetLoose17: posts the ante 325
BUGG136: posts the ante 325
CerPrisingLe: posts small blind 1250
A A 5454: posts big blind 2500
*** HOLE CARDS ***
Dealt to JJin91 [2c Qs]
Going2Ship: folds=20
apoch19: folds=20
helzkitchen: raises 2500 to 5000
GetLoose17: folds=20
BUGG136: folds=20
JJin91: folds=20
CerPrisingLe: folds=20
A A 5454: folds=20
Uncalled bet (2500) returned to helzkitchen
helzkitchen collected 8850 from pot
helzkitchen: doesn't show hand=20
*** SUMMARY ***
Total pot 8850 | Rake 0=20
Seat 1: JJin91 (button) folded before Flop (didn't bet)
Seat 2: CerPrisingLe (small blind) folded before Flop
Seat 4: A A 5454 (big blind) folded before Flop
Seat 5: Going2Ship folded before Flop (didn't bet)
Seat 6: apoch19 folded before Flop (didn't bet)
Seat 7: helzkitchen collected (8850)
Seat 8: GetLoose17 folded before Flop (didn't bet)
Seat 9: BUGG136 folded before Flop (didn't bet)


*********** # 199 **************
PokerStars Hand #172150458299: Tournament #1648990476, $18.20+$1.80 USD=
 Hold'em No Limit - Level XX (1250/2500) - 2017/07/06 22:28:47 ET
Table '1648990476 3' 9-max Seat #2 is the button
Seat 1: JJin91 (35457 in chips)=20
Seat 2: CerPrisingLe (72134 in chips)=20
Seat 4: A A 5454 (30840 in chips)=20
Seat 5: Going2Ship (37287 in chips)=20
Seat 6: apoch19 (118658 in chips)=20
Seat 7: helzkitchen (122082 in chips)=20
Seat 8: GetLoose17 (46418 in chips)=20
Seat 9: BUGG136 (75050 in chips)=20
JJin91: posts the ante 325
CerPrisingLe: posts the ante 325
A A 5454: posts the ante 325
Going2Ship: posts the ante 325
apoch19: posts the ante 325
helzkitchen: posts the ante 325
GetLoose17: posts the ante 325
BUGG136: posts the ante 325
A A 5454: posts small blind 1250
Going2Ship: posts big blind 2500
*** HOLE CARDS ***
Dealt to JJin91 [7h Js]
apoch19: folds=20
helzkitchen: folds=20
GetLoose17: folds=20
BUGG136: folds=20
JJin91: folds=20
CerPrisingLe: raises 2500 to 5000
A A 5454: folds=20
Going2Ship: folds=20
Uncalled bet (2500) returned to CerPrisingLe
CerPrisingLe collected 8850 from pot
CerPrisingLe: doesn't show hand=20
*** SUMMARY ***
Total pot 8850 | Rake 0=20
Seat 1: JJin91 folded before Flop (didn't bet)
Seat 2: CerPrisingLe (button) collected (8850)
Seat 4: A A 5454 (small blind) folded before Flop
Seat 5: Going2Ship (big blind) folded before Flop
Seat 6: apoch19 folded before Flop (didn't bet)
Seat 7: helzkitchen folded before Flop (didn't bet)
Seat 8: GetLoose17 folded before Flop (didn't bet)
Seat 9: BUGG136 folded before Flop (didn't bet)


*********** # 200 **************
PokerStars Hand #172150458366: Tournament #1648990476, $18.20+$1.80 USD=
 Hold'em No Limit - Level XX (1250/2500) - 2017/07/06 22:29:00 ET
Table '1648990476 3' 9-max Seat #4 is the button
Seat 1: JJin91 (35132 in chips)=20
Seat 2: CerPrisingLe (78159 in chips)=20
Seat 4: A A 5454 (29265 in chips)=20
Seat 5: Going2Ship (34462 in chips)=20
Seat 6: apoch19 (118333 in chips)=20
Seat 7: helzkitchen (121757 in chips)=20
Seat 8: GetLoose17 (46093 in chips)=20
Seat 9: BUGG136 (74725 in chips)=20
JJin91: posts the ante 325
CerPrisingLe: posts the ante 325
A A 5454: posts the ante 325
Going2Ship: posts the ante 325
apoch19: posts the ante 325
helzkitchen: posts the ante 325
GetLoose17: posts the ante 325
BUGG136: posts the ante 325
Going2Ship: posts small blind 1250
apoch19: posts big blind 2500
*** HOLE CARDS ***
Dealt to JJin91 [2c 5h]
helzkitchen: folds=20
GetLoose17: folds=20
BUGG136: folds=20
JJin91: folds=20
CerPrisingLe: folds=20
A A 5454: folds=20
Going2Ship: folds=20
Uncalled bet (1250) returned to apoch19
apoch19 collected 5100 from pot
apoch19: doesn't show hand=20
*** SUMMARY ***
Total pot 5100 | Rake 0=20
Seat 1: JJin91 folded before Flop (didn't bet)
Seat 2: CerPrisingLe folded before Flop (didn't bet)
Seat 4: A A 5454 (button) folded before Flop (didn't bet)
Seat 5: Going2Ship (small blind) folded before Flop
Seat 6: apoch19 (big blind) collected (5100)
Seat 7: helzkitchen folded before Flop (didn't bet)
Seat 8: GetLoose17 folded before Flop (didn't bet)
Seat 9: BUGG136 folded before Flop (didn't bet)


*********** # 201 **************
PokerStars Hand #172150458451: Tournament #1648990476, $18.20+$1.80 USD=
 Hold'em No Limit - Level XX (1250/2500) - 2017/07/06 22:29:22 ET
Table '1648990476 3' 9-max Seat #5 is the button
Seat 1: JJin91 (34807 in chips)=20
Seat 2: CerPrisingLe (77834 in chips)=20
Seat 4: A A 5454 (28940 in chips)=20
Seat 5: Going2Ship (32887 in chips)=20
Seat 6: apoch19 (121858 in chips)=20
Seat 7: helzkitchen (121432 in chips)=20
Seat 8: GetLoose17 (45768 in chips)=20
Seat 9: BUGG136 (74400 in chips)=20
JJin91: posts the ante 325
CerPrisingLe: posts the ante 325
A A 5454: posts the ante 325
Going2Ship: posts the ante 325
apoch19: posts the ante 325
helzkitchen: posts the ante 325
GetLoose17: posts the ante 325
BUGG136: posts the ante 325
apoch19: posts small blind 1250
helzkitchen: posts big blind 2500
*** HOLE CARDS ***
Dealt to JJin91 [3h 7h]
GetLoose17: raises 3750 to 6250
BUGG136: folds=20
JJin91: folds=20
CerPrisingLe: folds=20
A A 5454: folds=20
Going2Ship: folds=20
apoch19: folds=20
helzkitchen: folds=20
Uncalled bet (3750) returned to GetLoose17
GetLoose17 collected 8850 from pot
GetLoose17: doesn't show hand=20
*** SUMMARY ***
Total pot 8850 | Rake 0=20
Seat 1: JJin91 folded before Flop (didn't bet)
Seat 2: CerPrisingLe folded before Flop (didn't bet)
Seat 4: A A 5454 folded before Flop (didn't bet)
Seat 5: Going2Ship (button) folded before Flop (didn't bet)
Seat 6: apoch19 (small blind) folded before Flop
Seat 7: helzkitchen (big blind) folded before Flop
Seat 8: GetLoose17 collected (8850)
Seat 9: BUGG136 folded before Flop (didn't bet)


*********** # 202 **************
PokerStars Hand #172150458521: Tournament #1648990476, $18.20+$1.80 USD=
 Hold'em No Limit - Level XX (1250/2500) - 2017/07/06 22:29:37 ET
Table '1648990476 3' 9-max Seat #6 is the button
Seat 1: JJin91 (34482 in chips)=20
Seat 2: CerPrisingLe (77509 in chips)=20
Seat 4: A A 5454 (28615 in chips)=20
Seat 5: Going2Ship (32562 in chips)=20
Seat 6: apoch19 (120283 in chips)=20
Seat 7: helzkitchen (118607 in chips)=20
Seat 8: GetLoose17 (51793 in chips)=20
Seat 9: BUGG136 (74075 in chips)=20
JJin91: posts the ante 325
CerPrisingLe: posts the ante 325
A A 5454: posts the ante 325
Going2Ship: posts the ante 325
apoch19: posts the ante 325
helzkitchen: posts the ante 325
GetLoose17: posts the ante 325
BUGG136: posts the ante 325
helzkitchen: posts small blind 1250
GetLoose17: posts big blind 2500
*** HOLE CARDS ***
Dealt to JJin91 [3d Kc]
BUGG136: folds=20
JJin91: folds=20
CerPrisingLe: folds=20
A A 5454: folds=20
Going2Ship: folds=20
apoch19: raises 3350 to 5850
helzkitchen: folds=20
GetLoose17: calls 3350
*** FLOP *** [6s 3h Js]
GetLoose17: checks=20
apoch19: checks=20
*** TURN *** [6s 3h Js] [Kd]
GetLoose17: checks=20
apoch19: bets 6842
GetLoose17: folds=20
Uncalled bet (6842) returned to apoch19
apoch19 collected 15550 from pot
apoch19: doesn't show hand=20
*** SUMMARY ***
Total pot 15550 | Rake 0=20
Board [6s 3h Js Kd]
Seat 1: JJin91 folded before Flop (didn't bet)
Seat 2: CerPrisingLe folded before Flop (didn't bet)
Seat 4: A A 5454 folded before Flop (didn't bet)
Seat 5: Going2Ship folded before Flop (didn't bet)
Seat 6: apoch19 (button) collected (15550)
Seat 7: helzkitchen (small blind) folded before Flop
Seat 8: GetLoose17 (big blind) folded on the Turn
Seat 9: BUGG136 folded before Flop (didn't bet)


*********** # 203 **************
PokerStars Hand #172150458679: Tournament #1648990476, $18.20+$1.80 USD=
 Hold'em No Limit - Level XX (1250/2500) - 2017/07/06 22:30:10 ET
Table '1648990476 3' 9-max Seat #7 is the button
Seat 1: JJin91 (34157 in chips)=20
Seat 2: CerPrisingLe (77184 in chips)=20
Seat 4: A A 5454 (28290 in chips)=20
Seat 5: Going2Ship (32237 in chips)=20
Seat 6: apoch19 (129658 in chips)=20
Seat 7: helzkitchen (117032 in chips)=20
Seat 8: GetLoose17 (45618 in chips)=20
JJin91: posts the ante 325
CerPrisingLe: posts the ante 325
A A 5454: posts the ante 325
Going2Ship: posts the ante 325
apoch19: posts the ante 325
helzkitchen: posts the ante 325
GetLoose17: posts the ante 325
GetLoose17: posts small blind 1250
JJin91: posts big blind 2500
*** HOLE CARDS ***
Dealt to JJin91 [Js 5h]
CerPrisingLe: folds=20
A A 5454: folds=20
Going2Ship: folds=20
apoch19: folds=20
helzkitchen: folds=20
GetLoose17: folds=20
Uncalled bet (1250) returned to JJin91
JJin91 collected 4775 from pot
JJin91: doesn't show hand=20
*** SUMMARY ***
Total pot 4775 | Rake 0=20
Seat 1: JJin91 (big blind) collected (4775)
Seat 2: CerPrisingLe folded before Flop (didn't bet)
Seat 4: A A 5454 folded before Flop (didn't bet)
Seat 5: Going2Ship folded before Flop (didn't bet)
Seat 6: apoch19 folded before Flop (didn't bet)
Seat 7: helzkitchen (button) folded before Flop (didn't bet)
Seat 8: GetLoose17 (small blind) folded before Flop


*********** # 204 **************
PokerStars Hand #172150458739: Tournament #1648990476, $18.20+$1.80 USD=
 Hold'em No Limit - Level XX (1250/2500) - 2017/07/06 22:30:23 ET
Table '1648990476 3' 9-max Seat #8 is the button
Seat 1: JJin91 (37357 in chips)=20
Seat 2: CerPrisingLe (76859 in chips)=20
Seat 4: A A 5454 (27965 in chips)=20
Seat 5: Going2Ship (31912 in chips)=20
Seat 6: apoch19 (129333 in chips)=20
Seat 7: helzkitchen (116707 in chips)=20
Seat 8: GetLoose17 (44043 in chips)=20
JJin91: posts the ante 325
CerPrisingLe: posts the ante 325
A A 5454: posts the ante 325
Going2Ship: posts the ante 325
apoch19: posts the ante 325
helzkitchen: posts the ante 325
GetLoose17: posts the ante 325
JJin91: posts small blind 1250
CerPrisingLe: posts big blind 2500
*** HOLE CARDS ***
Dealt to JJin91 [Tc 2s]
A A 5454: folds=20
Going2Ship: folds=20
apoch19: raises 3350 to 5850
helzkitchen: folds=20
GetLoose17: folds=20
JJin91: folds=20
CerPrisingLe: folds=20
Uncalled bet (3350) returned to apoch19
apoch19 collected 8525 from pot
apoch19: doesn't show hand=20
*** SUMMARY ***
Total pot 8525 | Rake 0=20
Seat 1: JJin91 (small blind) folded before Flop
Seat 2: CerPrisingLe (big blind) folded before Flop
Seat 4: A A 5454 folded before Flop (didn't bet)
Seat 5: Going2Ship folded before Flop (didn't bet)
Seat 6: apoch19 collected (8525)
Seat 7: helzkitchen folded before Flop (didn't bet)
Seat 8: GetLoose17 (button) folded before Flop (didn't bet)


*********** # 205 **************
PokerStars Hand #172150458904: Tournament #1648990476, $18.20+$1.80 USD=
 Hold'em No Limit - Level XX (1250/2500) - 2017/07/06 22:30:55 ET
Table '1648990476 3' 9-max Seat #1 is the button
Seat 1: JJin91 (35782 in chips)=20
Seat 2: CerPrisingLe (74034 in chips)=20
Seat 4: A A 5454 (27640 in chips)=20
Seat 5: Going2Ship (31587 in chips)=20
Seat 6: apoch19 (135033 in chips)=20
Seat 7: helzkitchen (116382 in chips)=20
Seat 8: GetLoose17 (43718 in chips)=20
JJin91: posts the ante 325
CerPrisingLe: posts the ante 325
A A 5454: posts the ante 325
Going2Ship: posts the ante 325
apoch19: posts the ante 325
helzkitchen: posts the ante 325
GetLoose17: posts the ante 325
CerPrisingLe: posts small blind 1250
A A 5454: posts big blind 2500
*** HOLE CARDS ***
Dealt to JJin91 [Js 8h]
Going2Ship: folds=20
apoch19: folds=20
helzkitchen: folds=20
GetLoose17: folds=20
JJin91: raises 32957 to 35457 and is all-in
CerPrisingLe: folds=20
A A 5454: calls 24815 and is all-in
Uncalled bet (8142) returned to JJin91
*** FLOP *** [5d Tc Jh]
*** TURN *** [5d Tc Jh] [Qd]
*** RIVER *** [5d Tc Jh Qd] [Jd]
*** SHOW DOWN ***
A A 5454: shows [Td Qh] (two pair, Queens and Jacks)
JJin91: shows [Js 8h] (three of a kind, Jacks)
JJin91 collected 58155 from pot
A A 5454 finished the tournament in 22nd place and received $24.57.
*** SUMMARY ***
Total pot 58155 | Rake 0=20
Board [5d Tc Jh Qd Jd]
Seat 1: JJin91 (button) showed [Js 8h] and won (58155) with three of a =
kind, Jacks
Seat 2: CerPrisingLe (small blind) folded before Flop
Seat 4: A A 5454 (big blind) showed [Td Qh] and lost with two pair, Que=
ens and Jacks
Seat 5: Going2Ship folded before Flop (didn't bet)
Seat 6: apoch19 folded before Flop (didn't bet)
Seat 7: helzkitchen folded before Flop (didn't bet)
Seat 8: GetLoose17 folded before Flop (didn't bet)


*********** # 206 **************
PokerStars Hand #172150459037: Tournament #1648990476, $18.20+$1.80 USD=
 Hold'em No Limit - Level XX (1250/2500) - 2017/07/06 22:31:23 ET
Table '1648990476 3' 9-max Seat #2 is the button
Seat 1: JJin91 (66297 in chips)=20
Seat 2: CerPrisingLe (72459 in chips)=20
Seat 5: Going2Ship (31262 in chips)=20
Seat 6: apoch19 (134708 in chips)=20
Seat 7: helzkitchen (116057 in chips)=20
Seat 8: GetLoose17 (43393 in chips)=20
JJin91: posts the ante 325
CerPrisingLe: posts the ante 325
Going2Ship: posts the ante 325
apoch19: posts the ante 325
helzkitchen: posts the ante 325
GetLoose17: posts the ante 325
Going2Ship: posts small blind 1250
apoch19: posts big blind 2500
*** HOLE CARDS ***
Dealt to JJin91 [7c 7s]
helzkitchen: folds=20
GetLoose17: raises 3750 to 6250
JJin91: folds=20
CerPrisingLe: folds=20
Going2Ship: folds=20
apoch19: raises 128133 to 134383 and is all-in
GetLoose17: calls 36818 and is all-in
Uncalled bet (91315) returned to apoch19
*** FLOP *** [Qc Kh Jd]
*** TURN *** [Qc Kh Jd] [2s]
*** RIVER *** [Qc Kh Jd 2s] [4c]
*** SHOW DOWN ***
apoch19: shows [Ad Qs] (a pair of Queens)
GetLoose17: shows [Ah Ks] (a pair of Kings)
GetLoose17 collected 89336 from pot
*** SUMMARY ***
Total pot 89336 | Rake 0=20
Board [Qc Kh Jd 2s 4c]
Seat 1: JJin91 folded before Flop (didn't bet)
Seat 2: CerPrisingLe (button) folded before Flop (didn't bet)
Seat 5: Going2Ship (small blind) folded before Flop
Seat 6: apoch19 (big blind) showed [Ad Qs] and lost with a pair of Quee=
ns
Seat 7: helzkitchen folded before Flop (didn't bet)
Seat 8: GetLoose17 showed [Ah Ks] and won (89336) with a pair of Kings


*********** # 207 **************
PokerStars Hand #172150459170: Tournament #1648990476, $18.20+$1.80 USD=
 Hold'em No Limit - Level XX (1250/2500) - 2017/07/06 22:31:54 ET
Table '1648990476 3' 9-max Seat #5 is the button
Seat 1: JJin91 (65972 in chips)=20
Seat 2: CerPrisingLe (72134 in chips)=20
Seat 5: Going2Ship (29687 in chips)=20
Seat 6: apoch19 (91315 in chips)=20
Seat 7: helzkitchen (115732 in chips)=20
Seat 8: GetLoose17 (89336 in chips)=20
JJin91: posts the ante 325
CerPrisingLe: posts the ante 325
Going2Ship: posts the ante 325
apoch19: posts the ante 325
helzkitchen: posts the ante 325
GetLoose17: posts the ante 325
apoch19: posts small blind 1250
helzkitchen: posts big blind 2500
*** HOLE CARDS ***
Dealt to JJin91 [2d 9s]
GetLoose17: raises 3750 to 6250
JJin91: folds=20
CerPrisingLe: folds=20
Going2Ship: folds=20
apoch19: folds=20
helzkitchen: folds=20
Uncalled bet (3750) returned to GetLoose17
GetLoose17 collected 8200 from pot
GetLoose17: doesn't show hand=20
*** SUMMARY ***
Total pot 8200 | Rake 0=20
Seat 1: JJin91 folded before Flop (didn't bet)
Seat 2: CerPrisingLe folded before Flop (didn't bet)
Seat 5: Going2Ship (button) folded before Flop (didn't bet)
Seat 6: apoch19 (small blind) folded before Flop
Seat 7: helzkitchen (big blind) folded before Flop
Seat 8: GetLoose17 collected (8200)


*********** # 208 **************
PokerStars Hand #172150459222: Tournament #1648990476, $18.20+$1.80 USD=
 Hold'em No Limit - Level XX (1250/2500) - 2017/07/06 22:32:03 ET
Table '1648990476 3' 9-max Seat #6 is the button
Seat 1: JJin91 (65647 in chips)=20
Seat 2: CerPrisingLe (71809 in chips)=20
Seat 5: Going2Ship (29362 in chips)=20
Seat 6: apoch19 (89740 in chips)=20
Seat 7: helzkitchen (112907 in chips)=20
Seat 8: GetLoose17 (94711 in chips)=20
Seat 9: lrb1024 (45423 in chips)=20
JJin91: posts the ante 325
CerPrisingLe: posts the ante 325
Going2Ship: posts the ante 325
apoch19: posts the ante 325
helzkitchen: posts the ante 325
GetLoose17: posts the ante 325
lrb1024: posts the ante 325
helzkitchen: posts small blind 1250
GetLoose17: posts big blind 2500
*** HOLE CARDS ***
Dealt to JJin91 [8s 7d]
lrb1024: folds=20
JJin91: folds=20
CerPrisingLe: raises 2500 to 5000
Going2Ship: folds=20
apoch19: folds=20
helzkitchen: folds=20
GetLoose17: calls 2500
*** FLOP *** [Qs 3h Kh]
GetLoose17: checks=20
CerPrisingLe: bets 7500
GetLoose17: folds=20
Uncalled bet (7500) returned to CerPrisingLe
CerPrisingLe collected 13525 from pot
CerPrisingLe: doesn't show hand=20
*** SUMMARY ***
Total pot 13525 | Rake 0=20
Board [Qs 3h Kh]
Seat 1: JJin91 folded before Flop (didn't bet)
Seat 2: CerPrisingLe collected (13525)
Seat 5: Going2Ship folded before Flop (didn't bet)
Seat 6: apoch19 (button) folded before Flop (didn't bet)
Seat 7: helzkitchen (small blind) folded before Flop
Seat 8: GetLoose17 (big blind) folded on the Flop
Seat 9: lrb1024 folded before Flop (didn't bet)


*********** # 209 **************
PokerStars Hand #172150459399: Tournament #1648990476, $18.20+$1.80 USD=
 Hold'em No Limit - Level XX (1250/2500) - 2017/07/06 22:32:41 ET
Table '1648990476 3' 9-max Seat #7 is the button
Seat 1: JJin91 (65322 in chips)=20
Seat 2: CerPrisingLe (80009 in chips)=20
Seat 5: Going2Ship (29037 in chips)=20
Seat 6: apoch19 (89415 in chips)=20
Seat 7: helzkitchen (111332 in chips)=20
Seat 8: GetLoose17 (89386 in chips)=20
Seat 9: lrb1024 (45098 in chips)=20
JJin91: posts the ante 325
CerPrisingLe: posts the ante 325
Going2Ship: posts the ante 325
apoch19: posts the ante 325
helzkitchen: posts the ante 325
GetLoose17: posts the ante 325
lrb1024: posts the ante 325
GetLoose17: posts small blind 1250
lrb1024: posts big blind 2500
*** HOLE CARDS ***
Dealt to JJin91 [5d 9h]
JJin91: folds=20
CerPrisingLe: folds=20
Going2Ship: folds=20
apoch19: folds=20
helzkitchen: folds=20
GetLoose17: calls 1250
lrb1024: checks=20
*** FLOP *** [7h 3c Ac]
GetLoose17: bets 5000
lrb1024: calls 5000
*** TURN *** [7h 3c Ac] [7s]
GetLoose17: checks=20
lrb1024: checks=20
*** RIVER *** [7h 3c Ac 7s] [Qs]
GetLoose17: bets 6565
lrb1024: calls 6565
*** SHOW DOWN ***
GetLoose17: shows [5s Ah] (two pair, Aces and Sevens)
lrb1024: shows [4c As] (two pair, Aces and Sevens)
GetLoose17 collected 15203 from pot
lrb1024 collected 15202 from pot
*** SUMMARY ***
Total pot 30405 | Rake 0=20
Board [7h 3c Ac 7s Qs]
Seat 1: JJin91 folded before Flop (didn't bet)
Seat 2: CerPrisingLe folded before Flop (didn't bet)
Seat 5: Going2Ship folded before Flop (didn't bet)
Seat 6: apoch19 folded before Flop (didn't bet)
Seat 7: helzkitchen (button) folded before Flop (didn't bet)
Seat 8: GetLoose17 (small blind) showed [5s Ah] and won (15203) with tw=
o pair, Aces and Sevens
Seat 9: lrb1024 (big blind) showed [4c As] and won (15202) with two pai=
r, Aces and Sevens


*********** # 210 **************
PokerStars Hand #172150459634: Tournament #1648990476, $18.20+$1.80 USD=
 Hold'em No Limit - Level XX (1250/2500) - 2017/07/06 22:33:26 ET
Table '1648990476 3' 9-max Seat #8 is the button
Seat 1: JJin91 (64997 in chips)=20
Seat 2: CerPrisingLe (79684 in chips)=20
Seat 5: Going2Ship (28712 in chips)=20
Seat 6: apoch19 (89090 in chips)=20
Seat 7: helzkitchen (111007 in chips)=20
Seat 8: GetLoose17 (90199 in chips)=20
Seat 9: lrb1024 (45910 in chips)=20
JJin91: posts the ante 325
CerPrisingLe: posts the ante 325
Going2Ship: posts the ante 325
apoch19: posts the ante 325
helzkitchen: posts the ante 325
GetLoose17: posts the ante 325
lrb1024: posts the ante 325
lrb1024: posts small blind 1250
JJin91: posts big blind 2500
*** HOLE CARDS ***
Dealt to JJin91 [9s 9d]
CerPrisingLe: folds=20
Going2Ship: folds=20
apoch19: folds=20
helzkitchen: raises 2500 to 5000
GetLoose17: folds=20
lrb1024 has timed out
lrb1024: folds=20
lrb1024 is sitting out
JJin91: raises 59672 to 64672 and is all-in
helzkitchen: folds=20
Uncalled bet (59672) returned to JJin91
JJin91 collected 13525 from pot
JJin91: doesn't show hand=20
*** SUMMARY ***
Total pot 13525 | Rake 0=20
Seat 1: JJin91 (big blind) collected (13525)
Seat 2: CerPrisingLe folded before Flop (didn't bet)
Seat 5: Going2Ship folded before Flop (didn't bet)
Seat 6: apoch19 folded before Flop (didn't bet)
Seat 7: helzkitchen folded before Flop
Seat 8: GetLoose17 (button) folded before Flop (didn't bet)
Seat 9: lrb1024 (small blind) folded before Flop


*********** # 211 **************
PokerStars Hand #172150459798: Tournament #1648990476, $18.20+$1.80 USD=
 Hold'em No Limit - Level XX (1250/2500) - 2017/07/06 22:34:04 ET
Table '1648990476 3' 9-max Seat #9 is the button
Seat 1: JJin91 (73197 in chips)=20
Seat 2: CerPrisingLe (79359 in chips)=20
Seat 5: Going2Ship (28387 in chips)=20
Seat 6: apoch19 (88765 in chips)=20
Seat 7: helzkitchen (105682 in chips)=20
Seat 8: GetLoose17 (89874 in chips)=20
Seat 9: lrb1024 (44335 in chips) is sitting out
JJin91: posts the ante 325
CerPrisingLe: posts the ante 325
Going2Ship: posts the ante 325
apoch19: posts the ante 325
helzkitchen: posts the ante 325
GetLoose17: posts the ante 325
lrb1024: posts the ante 325
JJin91: posts small blind 1250
CerPrisingLe: posts big blind 2500
*** HOLE CARDS ***
Dealt to JJin91 [Tc Th]
Going2Ship: folds=20
apoch19: raises 3350 to 5850
helzkitchen: folds=20
GetLoose17: folds=20
lrb1024: folds=20
JJin91: raises 3350 to 9200
CerPrisingLe: calls 6700
apoch19: calls 3350
*** FLOP *** [3d 4d 9c]
JJin91: checks=20
CerPrisingLe: bets 10000
apoch19: folds=20
JJin91: raises 16459 to 26459
CerPrisingLe: calls 16459
*** TURN *** [3d 4d 9c] [Jh]
JJin91: checks=20
CerPrisingLe: checks=20
*** RIVER *** [3d 4d 9c Jh] [Kd]
lrb1024 has returned
JJin91: checks=20
CerPrisingLe: checks=20
*** SHOW DOWN ***
JJin91: shows [Tc Th] (a pair of Tens)
CerPrisingLe: mucks hand=20
JJin91 collected 82793 from pot
*** SUMMARY ***
Total pot 82793 | Rake 0=20
Board [3d 4d 9c Jh Kd]
Seat 1: JJin91 (small blind) showed [Tc Th] and won (82793) with a pair=
 of Tens
Seat 2: CerPrisingLe (big blind) mucked [Ah 9h]
Seat 5: Going2Ship folded before Flop (didn't bet)
Seat 6: apoch19 folded on the Flop
Seat 7: helzkitchen folded before Flop (didn't bet)
Seat 8: GetLoose17 folded before Flop (didn't bet)
Seat 9: lrb1024 (button) folded before Flop (didn't bet)


*********** # 212 **************
PokerStars Hand #172152621632: Tournament #1648990476, $18.20+$1.80 USD=
 Hold'em No Limit - Level XX (1250/2500) - 2017/07/06 22:35:12 ET
Table '1648990476 3' 9-max Seat #1 is the button
Seat 1: JJin91 (120006 in chips)=20
Seat 2: CerPrisingLe (43375 in chips)=20
Seat 5: Going2Ship (28062 in chips)=20
Seat 6: apoch19 (79240 in chips)=20
Seat 7: helzkitchen (105357 in chips)=20
Seat 8: GetLoose17 (89549 in chips)=20
Seat 9: lrb1024 (44010 in chips)=20
JJin91: posts the ante 325
CerPrisingLe: posts the ante 325
Going2Ship: posts the ante 325
apoch19: posts the ante 325
helzkitchen: posts the ante 325
GetLoose17: posts the ante 325
lrb1024: posts the ante 325
CerPrisingLe: posts small blind 1250
Going2Ship: posts big blind 2500
*** HOLE CARDS ***
Dealt to JJin91 [7d 5c]
apoch19: raises 3350 to 5850
helzkitchen: folds=20
GetLoose17: calls 5850
lrb1024: folds=20
JJin91: folds=20
CerPrisingLe: folds=20
Going2Ship: folds=20
*** FLOP *** [Qd Ah 9s]
apoch19: checks=20
GetLoose17: bets 7500
apoch19: calls 7500
*** TURN *** [Qd Ah 9s] [Ks]
apoch19: checks=20
GetLoose17: checks=20
*** RIVER *** [Qd Ah 9s Ks] [Kh]
apoch19: bets 22908
GetLoose17: folds=20
Uncalled bet (22908) returned to apoch19
apoch19 collected 32725 from pot
apoch19: doesn't show hand=20
*** SUMMARY ***
Total pot 32725 | Rake 0=20
Board [Qd Ah 9s Ks Kh]
Seat 1: JJin91 (button) folded before Flop (didn't bet)
Seat 2: CerPrisingLe (small blind) folded before Flop
Seat 5: Going2Ship (big blind) folded before Flop
Seat 6: apoch19 collected (32725)
Seat 7: helzkitchen folded before Flop (didn't bet)
Seat 8: GetLoose17 folded on the River
Seat 9: lrb1024 folded before Flop (didn't bet)


*********** # 213 **************
PokerStars Hand #172152621978: Tournament #1648990476, $18.20+$1.80 USD=
 Hold'em No Limit - Level XX (1250/2500) - 2017/07/06 22:36:18 ET
Table '1648990476 3' 9-max Seat #2 is the button
Seat 1: JJin91 (119681 in chips)=20
Seat 2: CerPrisingLe (41800 in chips)=20
Seat 5: Going2Ship (25237 in chips)=20
Seat 6: apoch19 (98290 in chips)=20
Seat 7: helzkitchen (105032 in chips)=20
Seat 8: GetLoose17 (75874 in chips)=20
Seat 9: lrb1024 (43685 in chips)=20
JJin91: posts the ante 325
CerPrisingLe: posts the ante 325
Going2Ship: posts the ante 325
apoch19: posts the ante 325
helzkitchen: posts the ante 325
GetLoose17: posts the ante 325
lrb1024: posts the ante 325
Going2Ship: posts small blind 1250
apoch19: posts big blind 2500
*** HOLE CARDS ***
Dealt to JJin91 [Qc 8d]
helzkitchen: folds=20
GetLoose17: folds=20
lrb1024: folds=20
JJin91: folds=20
CerPrisingLe: raises 5000 to 7500
Going2Ship: folds=20
apoch19: folds=20
Uncalled bet (5000) returned to CerPrisingLe
CerPrisingLe collected 8525 from pot
CerPrisingLe: doesn't show hand=20
*** SUMMARY ***
Total pot 8525 | Rake 0=20
Seat 1: JJin91 folded before Flop (didn't bet)
Seat 2: CerPrisingLe (button) collected (8525)
Seat 5: Going2Ship (small blind) folded before Flop
Seat 6: apoch19 (big blind) folded before Flop
Seat 7: helzkitchen folded before Flop (didn't bet)
Seat 8: GetLoose17 folded before Flop (didn't bet)
Seat 9: lrb1024 folded before Flop (didn't bet)


*********** # 214 **************
PokerStars Hand #172152622131: Tournament #1648990476, $18.20+$1.80 USD=
 Hold'em No Limit - Level XX (1250/2500) - 2017/07/06 22:36:46 ET
Table '1648990476 3' 9-max Seat #5 is the button
Seat 1: JJin91 (119356 in chips)=20
Seat 2: CerPrisingLe (47500 in chips)=20
Seat 5: Going2Ship (23662 in chips)=20
Seat 6: apoch19 (95465 in chips)=20
Seat 7: helzkitchen (104707 in chips)=20
Seat 8: GetLoose17 (75549 in chips)=20
Seat 9: lrb1024 (43360 in chips)=20
JJin91: posts the ante 325
CerPrisingLe: posts the ante 325
Going2Ship: posts the ante 325
apoch19: posts the ante 325
helzkitchen: posts the ante 325
GetLoose17: posts the ante 325
lrb1024: posts the ante 325
apoch19: posts small blind 1250
helzkitchen: posts big blind 2500
*** HOLE CARDS ***
Dealt to JJin91 [Ac 7s]
GetLoose17: raises 3750 to 6250
lrb1024: folds=20
JJin91: folds=20
CerPrisingLe has timed out
CerPrisingLe: folds=20
CerPrisingLe is sitting out
Going2Ship: folds=20
apoch19: raises 10530 to 16780
helzkitchen: folds=20
GetLoose17: calls 10530
*** FLOP *** [6h 3s Jd]
CerPrisingLe has returned
apoch19: bets 17844
GetLoose17: calls 17844
*** TURN *** [6h 3s Jd] [Kh]
apoch19: checks=20
GetLoose17: checks=20
*** RIVER *** [6h 3s Jd Kh] [8s]
apoch19: bets 28422
GetLoose17: folds=20
Uncalled bet (28422) returned to apoch19
apoch19 collected 74023 from pot
apoch19: doesn't show hand=20
*** SUMMARY ***
Total pot 74023 | Rake 0=20
Board [6h 3s Jd Kh 8s]
Seat 1: JJin91 folded before Flop (didn't bet)
Seat 2: CerPrisingLe folded before Flop (didn't bet)
Seat 5: Going2Ship (button) folded before Flop (didn't bet)
Seat 6: apoch19 (small blind) collected (74023)
Seat 7: helzkitchen (big blind) folded before Flop
Seat 8: GetLoose17 folded on the River
Seat 9: lrb1024 folded before Flop (didn't bet)


*********** # 215 **************
PokerStars Hand #172152622605: Tournament #1648990476, $18.20+$1.80 USD=
 Hold'em No Limit - Level XXI (1500/3000) - 2017/07/06 22:38:26 ET
Table '1648990476 3' 9-max Seat #6 is the button
Seat 1: JJin91 (119031 in chips)=20
Seat 2: CerPrisingLe (47175 in chips)=20
Seat 5: Going2Ship (23337 in chips)=20
Seat 6: apoch19 (134539 in chips)=20
Seat 7: helzkitchen (101882 in chips)=20
Seat 8: GetLoose17 (40600 in chips)=20
Seat 9: lrb1024 (43035 in chips)=20
JJin91: posts the ante 375
CerPrisingLe: posts the ante 375
Going2Ship: posts the ante 375
apoch19: posts the ante 375
helzkitchen: posts the ante 375
GetLoose17: posts the ante 375
lrb1024: posts the ante 375
helzkitchen: posts small blind 1500
GetLoose17: posts big blind 3000
*** HOLE CARDS ***
Dealt to JJin91 [8d 9h]
lrb1024: folds=20
JJin91: folds=20
CerPrisingLe: folds=20
Going2Ship: raises 19962 to 22962 and is all-in
apoch19: folds=20
helzkitchen: folds=20
GetLoose17: folds=20
Uncalled bet (19962) returned to Going2Ship
Going2Ship collected 10125 from pot
Going2Ship: doesn't show hand=20
*** SUMMARY ***
Total pot 10125 | Rake 0=20
Seat 1: JJin91 folded before Flop (didn't bet)
Seat 2: CerPrisingLe folded before Flop (didn't bet)
Seat 5: Going2Ship collected (10125)
Seat 6: apoch19 (button) folded before Flop (didn't bet)
Seat 7: helzkitchen (small blind) folded before Flop
Seat 8: GetLoose17 (big blind) folded before Flop
Seat 9: lrb1024 folded before Flop (didn't bet)


*********** # 216 **************
PokerStars Hand #172152622711: Tournament #1648990476, $18.20+$1.80 USD=
 Hold'em No Limit - Level XXI (1500/3000) - 2017/07/06 22:38:47 ET
Table '1648990476 3' 9-max Seat #7 is the button
Seat 1: JJin91 (118656 in chips)=20
Seat 2: CerPrisingLe (46800 in chips)=20
Seat 5: Going2Ship (30087 in chips)=20
Seat 6: apoch19 (134164 in chips)=20
Seat 7: helzkitchen (100007 in chips)=20
Seat 8: GetLoose17 (37225 in chips)=20
Seat 9: lrb1024 (42660 in chips)=20
JJin91: posts the ante 375
CerPrisingLe: posts the ante 375
Going2Ship: posts the ante 375
apoch19: posts the ante 375
helzkitchen: posts the ante 375
GetLoose17: posts the ante 375
lrb1024: posts the ante 375
GetLoose17: posts small blind 1500
lrb1024: posts big blind 3000
*** HOLE CARDS ***
Dealt to JJin91 [Ad 6d]
JJin91: raises 3330 to 6330
CerPrisingLe has timed out
CerPrisingLe: folds=20
CerPrisingLe is sitting out
Going2Ship: folds=20
apoch19: folds=20
helzkitchen: folds=20
GetLoose17: folds=20
CerPrisingLe has returned
lrb1024: folds=20
Uncalled bet (3330) returned to JJin91
JJin91 collected 10125 from pot
JJin91: doesn't show hand=20
*** SUMMARY ***
Total pot 10125 | Rake 0=20
Seat 1: JJin91 collected (10125)
Seat 2: CerPrisingLe folded before Flop (didn't bet)
Seat 5: Going2Ship folded before Flop (didn't bet)
Seat 6: apoch19 folded before Flop (didn't bet)
Seat 7: helzkitchen (button) folded before Flop (didn't bet)
Seat 8: GetLoose17 (small blind) folded before Flop
Seat 9: lrb1024 (big blind) folded before Flop


*********** # 217 **************
PokerStars Hand #172152623004: Tournament #1648990476, $18.20+$1.80 USD=
 Hold'em No Limit - Level XXI (1500/3000) - 2017/07/06 22:39:49 ET
Table '1648990476 3' 9-max Seat #8 is the button
Seat 1: JJin91 (125406 in chips)=20
Seat 2: CerPrisingLe (46425 in chips)=20
Seat 5: Going2Ship (29712 in chips)=20
Seat 6: apoch19 (133789 in chips)=20
Seat 7: helzkitchen (99632 in chips)=20
Seat 8: GetLoose17 (35350 in chips)=20
Seat 9: lrb1024 (39285 in chips)=20
JJin91: posts the ante 375
CerPrisingLe: posts the ante 375
Going2Ship: posts the ante 375
apoch19: posts the ante 375
helzkitchen: posts the ante 375
GetLoose17: posts the ante 375
lrb1024: posts the ante 375
lrb1024: posts small blind 1500
JJin91: posts big blind 3000
*** HOLE CARDS ***
Dealt to JJin91 [As 3h]
CerPrisingLe: folds=20
Going2Ship: folds=20
apoch19: folds=20
helzkitchen: raises 3000 to 6000
GetLoose17: folds=20
lrb1024 has timed out
lrb1024: folds=20
lrb1024 is sitting out
JJin91: calls 3000
*** FLOP *** [Kc Qd 3d]
JJin91: checks=20
helzkitchen: bets 8063
JJin91: folds=20
Uncalled bet (8063) returned to helzkitchen
helzkitchen collected 16125 from pot
helzkitchen: doesn't show hand=20
lrb1024 has returned
*** SUMMARY ***
Total pot 16125 | Rake 0=20
Board [Kc Qd 3d]
Seat 1: JJin91 (big blind) folded on the Flop
Seat 2: CerPrisingLe folded before Flop (didn't bet)
Seat 5: Going2Ship folded before Flop (didn't bet)
Seat 6: apoch19 folded before Flop (didn't bet)
Seat 7: helzkitchen collected (16125)
Seat 8: GetLoose17 (button) folded before Flop (didn't bet)
Seat 9: lrb1024 (small blind) folded before Flop


*********** # 218 **************
PokerStars Hand #172152623229: Tournament #1648990476, $18.20+$1.80 USD=
 Hold'em No Limit - Level XXI (1500/3000) - 2017/07/06 22:40:37 ET
Table '1648990476 3' 9-max Seat #9 is the button
Seat 1: JJin91 (119031 in chips)=20
Seat 2: CerPrisingLe (46050 in chips)=20
Seat 5: Going2Ship (29337 in chips)=20
Seat 6: apoch19 (133414 in chips)=20
Seat 7: helzkitchen (109382 in chips)=20
Seat 8: GetLoose17 (34975 in chips)=20
Seat 9: lrb1024 (37410 in chips)=20
JJin91: posts the ante 375
CerPrisingLe: posts the ante 375
Going2Ship: posts the ante 375
apoch19: posts the ante 375
helzkitchen: posts the ante 375
GetLoose17: posts the ante 375
lrb1024: posts the ante 375
JJin91: posts small blind 1500
CerPrisingLe: posts big blind 3000
*** HOLE CARDS ***
Dealt to JJin91 [7s 8d]
Going2Ship: folds=20
apoch19: folds=20
helzkitchen: folds=20
GetLoose17: raises 31600 to 34600 and is all-in
lrb1024: folds=20
JJin91: folds=20
CerPrisingLe: folds=20
Uncalled bet (31600) returned to GetLoose17
GetLoose17 collected 10125 from pot
GetLoose17: doesn't show hand=20
*** SUMMARY ***
Total pot 10125 | Rake 0=20
Seat 1: JJin91 (small blind) folded before Flop
Seat 2: CerPrisingLe (big blind) folded before Flop
Seat 5: Going2Ship folded before Flop (didn't bet)
Seat 6: apoch19 folded before Flop (didn't bet)
Seat 7: helzkitchen folded before Flop (didn't bet)
Seat 8: GetLoose17 collected (10125)
Seat 9: lrb1024 (button) folded before Flop (didn't bet)


*********** # 219 **************
PokerStars Hand #172152623332: Tournament #1648990476, $18.20+$1.80 USD=
 Hold'em No Limit - Level XXI (1500/3000) - 2017/07/06 22:40:59 ET
Table '1648990476 3' 9-max Seat #1 is the button
Seat 1: JJin91 (117156 in chips)=20
Seat 2: CerPrisingLe (42675 in chips)=20
Seat 5: Going2Ship (28962 in chips)=20
Seat 6: apoch19 (133039 in chips)=20
Seat 7: helzkitchen (109007 in chips)=20
Seat 8: GetLoose17 (41725 in chips)=20
Seat 9: lrb1024 (37035 in chips)=20
JJin91: posts the ante 375
CerPrisingLe: posts the ante 375
Going2Ship: posts the ante 375
apoch19: posts the ante 375
helzkitchen: posts the ante 375
GetLoose17: posts the ante 375
lrb1024: posts the ante 375
CerPrisingLe: posts small blind 1500
Going2Ship: posts big blind 3000
*** HOLE CARDS ***
Dealt to JJin91 [Th 6d]
apoch19: raises 3715 to 6715
helzkitchen: folds=20
GetLoose17: folds=20
lrb1024: folds=20
JJin91: folds=20
CerPrisingLe: folds=20
Going2Ship: folds=20
Uncalled bet (3715) returned to apoch19
apoch19 collected 10125 from pot
apoch19: doesn't show hand=20
*** SUMMARY ***
Total pot 10125 | Rake 0=20
Seat 1: JJin91 (button) folded before Flop (didn't bet)
Seat 2: CerPrisingLe (small blind) folded before Flop
Seat 5: Going2Ship (big blind) folded before Flop
Seat 6: apoch19 collected (10125)
Seat 7: helzkitchen folded before Flop (didn't bet)
Seat 8: GetLoose17 folded before Flop (didn't bet)
Seat 9: lrb1024 folded before Flop (didn't bet)


*********** # 220 **************
PokerStars Hand #172152623397: Tournament #1648990476, $18.20+$1.80 USD=
 Hold'em No Limit - Level XXI (1500/3000) - 2017/07/06 22:41:13 ET
Table '1648990476 3' 9-max Seat #2 is the button
Seat 1: JJin91 (116781 in chips)=20
Seat 2: CerPrisingLe (40800 in chips)=20
Seat 5: Going2Ship (25587 in chips)=20
Seat 6: apoch19 (139789 in chips)=20
Seat 7: helzkitchen (108632 in chips)=20
Seat 8: GetLoose17 (41350 in chips)=20
Seat 9: lrb1024 (36660 in chips)=20
JJin91: posts the ante 375
CerPrisingLe: posts the ante 375
Going2Ship: posts the ante 375
apoch19: posts the ante 375
helzkitchen: posts the ante 375
GetLoose17: posts the ante 375
lrb1024: posts the ante 375
Going2Ship: posts small blind 1500
apoch19: posts big blind 3000
*** HOLE CARDS ***
Dealt to JJin91 [As 7c]
helzkitchen: folds=20
GetLoose17: folds=20
lrb1024 has timed out
lrb1024: folds=20
lrb1024 is sitting out
lrb1024 has returned
JJin91: raises 3330 to 6330
CerPrisingLe: raises 34095 to 40425 and is all-in
Going2Ship: folds=20
apoch19: folds=20
JJin91: calls 34095
*** FLOP *** [4s 5c Jd]
*** TURN *** [4s 5c Jd] [8h]
*** RIVER *** [4s 5c Jd 8h] [Qd]
*** SHOW DOWN ***
JJin91: shows [As 7c] (high card Ace)
CerPrisingLe: shows [Kd Ac] (high card Ace - King kicker)
CerPrisingLe collected 87975 from pot
*** SUMMARY ***
Total pot 87975 | Rake 0=20
Board [4s 5c Jd 8h Qd]
Seat 1: JJin91 showed [As 7c] and lost with high card Ace
Seat 2: CerPrisingLe (button) showed [Kd Ac] and won (87975) with high =
card Ace
Seat 5: Going2Ship (small blind) folded before Flop
Seat 6: apoch19 (big blind) folded before Flop
Seat 7: helzkitchen folded before Flop (didn't bet)
Seat 8: GetLoose17 folded before Flop (didn't bet)
Seat 9: lrb1024 folded before Flop (didn't bet)


*********** # 221 **************
PokerStars Hand #172152623598: Tournament #1648990476, $18.20+$1.80 USD=
 Hold'em No Limit - Level XXI (1500/3000) - 2017/07/06 22:41:58 ET
Table '1648990476 3' 9-max Seat #5 is the button
Seat 1: JJin91 (75981 in chips)=20
Seat 2: CerPrisingLe (87975 in chips)=20
Seat 5: Going2Ship (23712 in chips)=20
Seat 6: apoch19 (136414 in chips)=20
Seat 7: helzkitchen (108257 in chips)=20
Seat 8: GetLoose17 (40975 in chips)=20
Seat 9: lrb1024 (36285 in chips)=20
JJin91: posts the ante 375
CerPrisingLe: posts the ante 375
Going2Ship: posts the ante 375
apoch19: posts the ante 375
helzkitchen: posts the ante 375
GetLoose17: posts the ante 375
lrb1024: posts the ante 375
apoch19: posts small blind 1500
helzkitchen: posts big blind 3000
*** HOLE CARDS ***
Dealt to JJin91 [Kh Qs]
GetLoose17: folds=20
lrb1024: folds=20
JJin91: raises 3330 to 6330
CerPrisingLe: folds=20
Going2Ship: raises 17007 to 23337 and is all-in
apoch19: folds=20
helzkitchen: calls 20337
JJin91: folds=20
*** FLOP *** [2d Js 7h]
*** TURN *** [2d Js 7h] [6d]
*** RIVER *** [2d Js 7h 6d] [4h]
*** SHOW DOWN ***
helzkitchen: shows [Kc Qc] (high card King)
Going2Ship: shows [Jd As] (a pair of Jacks)
Going2Ship collected 57129 from pot
*** SUMMARY ***
Total pot 57129 | Rake 0=20
Board [2d Js 7h 6d 4h]
Seat 1: JJin91 folded before Flop
Seat 2: CerPrisingLe folded before Flop (didn't bet)
Seat 5: Going2Ship (button) showed [Jd As] and won (57129) with a pair =
of Jacks
Seat 6: apoch19 (small blind) folded before Flop
Seat 7: helzkitchen (big blind) showed [Kc Qc] and lost with high card =
King
Seat 8: GetLoose17 folded before Flop (didn't bet)
Seat 9: lrb1024 folded before Flop (didn't bet)


*********** # 222 **************
PokerStars Hand #172152623775: Tournament #1648990476, $18.20+$1.80 USD=
 Hold'em No Limit - Level XXI (1500/3000) - 2017/07/06 22:42:41 ET
Table '1648990476 3' 9-max Seat #6 is the button
Seat 1: JJin91 (69276 in chips)=20
Seat 2: CerPrisingLe (87600 in chips)=20
Seat 5: Going2Ship (57129 in chips)=20
Seat 6: apoch19 (134539 in chips)=20
Seat 7: helzkitchen (84545 in chips)=20
Seat 8: GetLoose17 (40600 in chips)=20
Seat 9: lrb1024 (35910 in chips)=20
JJin91: posts the ante 375
CerPrisingLe: posts the ante 375
Going2Ship: posts the ante 375
apoch19: posts the ante 375
helzkitchen: posts the ante 375
GetLoose17: posts the ante 375
lrb1024: posts the ante 375
helzkitchen: posts small blind 1500
GetLoose17: posts big blind 3000
*** HOLE CARDS ***
Dealt to JJin91 [2h 5h]
lrb1024: folds=20
JJin91: folds=20
CerPrisingLe has timed out
CerPrisingLe: folds=20
CerPrisingLe is sitting out
Going2Ship: folds=20
apoch19: folds=20
helzkitchen: folds=20
Uncalled bet (1500) returned to GetLoose17
GetLoose17 collected 5625 from pot
GetLoose17: doesn't show hand=20
*** SUMMARY ***
Total pot 5625 | Rake 0=20
Seat 1: JJin91 folded before Flop (didn't bet)
Seat 2: CerPrisingLe folded before Flop (didn't bet)
Seat 5: Going2Ship folded before Flop (didn't bet)
Seat 6: apoch19 (button) folded before Flop (didn't bet)
Seat 7: helzkitchen (small blind) folded before Flop
Seat 8: GetLoose17 (big blind) collected (5625)
Seat 9: lrb1024 folded before Flop (didn't bet)


*********** # 223 **************
PokerStars Hand #172152623954: Tournament #1648990476, $18.20+$1.80 USD=
 Hold'em No Limit - Level XXI (1500/3000) - 2017/07/06 22:43:16 ET
Table '1648990476 3' 9-max Seat #7 is the button
Seat 1: JJin91 (68901 in chips)=20
Seat 2: CerPrisingLe (87225 in chips) is sitting out
Seat 5: Going2Ship (56754 in chips)=20
Seat 7: helzkitchen (82670 in chips)=20
Seat 8: GetLoose17 (44350 in chips)=20
Seat 9: lrb1024 (35535 in chips)=20
JJin91: posts the ante 375
CerPrisingLe: posts the ante 375
Going2Ship: posts the ante 375
helzkitchen: posts the ante 375
GetLoose17: posts the ante 375
lrb1024: posts the ante 375
GetLoose17: posts small blind 1500
lrb1024: posts big blind 3000
*** HOLE CARDS ***
Dealt to JJin91 [Jh Td]
JJin91: folds=20
CerPrisingLe: folds=20
Going2Ship: raises 3000 to 6000
helzkitchen: folds=20
GetLoose17: raises 37975 to 43975 and is all-in
lrb1024: folds=20
Going2Ship: folds=20
Uncalled bet (37975) returned to GetLoose17
GetLoose17 collected 17250 from pot
GetLoose17: doesn't show hand=20
*** SUMMARY ***
Total pot 17250 | Rake 0=20
Seat 1: JJin91 folded before Flop (didn't bet)
Seat 2: CerPrisingLe folded before Flop (didn't bet)
Seat 5: Going2Ship folded before Flop
Seat 7: helzkitchen (button) folded before Flop (didn't bet)
Seat 8: GetLoose17 (small blind) collected (17250)
Seat 9: lrb1024 (big blind) folded before Flop


*********** # 224 **************
PokerStars Hand #172152624025: Tournament #1648990476, $18.20+$1.80 USD=
 Hold'em No Limit - Level XXI (1500/3000) - 2017/07/06 22:43:34 ET
Table '1648990476 3' 9-max Seat #8 is the button
Seat 1: JJin91 (68526 in chips)=20
Seat 2: CerPrisingLe (86850 in chips) is sitting out
Seat 5: Going2Ship (50379 in chips)=20
Seat 7: helzkitchen (82295 in chips)=20
Seat 8: GetLoose17 (55225 in chips)=20
Seat 9: lrb1024 (32160 in chips)=20
JJin91: posts the ante 375
CerPrisingLe: posts the ante 375
Going2Ship: posts the ante 375
helzkitchen: posts the ante 375
GetLoose17: posts the ante 375
lrb1024: posts the ante 375
lrb1024: posts small blind 1500
JJin91: posts big blind 3000
*** HOLE CARDS ***
Dealt to JJin91 [Ah 2d]
CerPrisingLe: folds=20
Going2Ship: folds=20
helzkitchen: raises 3000 to 6000
GetLoose17: folds=20
lrb1024: folds=20
JJin91: calls 3000
*** FLOP *** [Ac Kc Jc]
JJin91: checks=20
helzkitchen: checks=20
*** TURN *** [Ac Kc Jc] [7h]
JJin91: bets 7718
helzkitchen: calls 7718
*** RIVER *** [Ac Kc Jc 7h] [4s]
JJin91: checks=20
helzkitchen: checks=20
*** SHOW DOWN ***
JJin91: shows [Ah 2d] (a pair of Aces)
helzkitchen: mucks hand=20
JJin91 collected 31186 from pot
*** SUMMARY ***
Total pot 31186 | Rake 0=20
Board [Ac Kc Jc 7h 4s]
Seat 1: JJin91 (big blind) showed [Ah 2d] and won (31186) with a pair o=
f Aces
Seat 2: CerPrisingLe folded before Flop (didn't bet)
Seat 5: Going2Ship folded before Flop (didn't bet)
Seat 7: helzkitchen mucked [Kd Th]
Seat 8: GetLoose17 (button) folded before Flop (didn't bet)
Seat 9: lrb1024 (small blind) folded before Flop


*********** # 225 **************
PokerStars Hand #172152624168: Tournament #1648990476, $18.20+$1.80 USD=
 Hold'em No Limit - Level XXI (1500/3000) - 2017/07/06 22:44:05 ET
Table '1648990476 3' 9-max Seat #9 is the button
Seat 1: JJin91 (85619 in chips)=20
Seat 2: CerPrisingLe (86475 in chips) is sitting out
Seat 5: Going2Ship (50004 in chips)=20
Seat 7: helzkitchen (68202 in chips)=20
Seat 8: GetLoose17 (54850 in chips)=20
Seat 9: lrb1024 (30285 in chips)=20
JJin91: posts the ante 375
CerPrisingLe: posts the ante 375
Going2Ship: posts the ante 375
helzkitchen: posts the ante 375
GetLoose17: posts the ante 375
lrb1024: posts the ante 375
JJin91: posts small blind 1500
CerPrisingLe: posts big blind 3000
*** HOLE CARDS ***
Dealt to JJin91 [Td 2c]
Going2Ship: folds=20
helzkitchen: folds=20
GetLoose17: folds=20
lrb1024: raises 6000 to 9000
CerPrisingLe has returned
JJin91: folds=20
CerPrisingLe: calls 6000
*** FLOP *** [Jc Ks 8d]
CerPrisingLe: bets 21000
lrb1024: folds=20
Uncalled bet (21000) returned to CerPrisingLe
CerPrisingLe collected 21750 from pot
CerPrisingLe: doesn't show hand=20
*** SUMMARY ***
Total pot 21750 | Rake 0=20
Board [Jc Ks 8d]
Seat 1: JJin91 (small blind) folded before Flop
Seat 2: CerPrisingLe (big blind) collected (21750)
Seat 5: Going2Ship folded before Flop (didn't bet)
Seat 7: helzkitchen folded before Flop (didn't bet)
Seat 8: GetLoose17 folded before Flop (didn't bet)
Seat 9: lrb1024 (button) folded on the Flop


*********** # 226 **************
PokerStars Hand #172152624290: Tournament #1648990476, $18.20+$1.80 USD=
 Hold'em No Limit - Level XXI (1500/3000) - 2017/07/06 22:44:30 ET
Table '1648990476 3' 9-max Seat #1 is the button
Seat 1: JJin91 (83744 in chips)=20
Seat 2: CerPrisingLe (98850 in chips)=20
Seat 5: Going2Ship (49629 in chips)=20
Seat 7: helzkitchen (67827 in chips)=20
Seat 8: GetLoose17 (54475 in chips)=20
Seat 9: lrb1024 (20910 in chips)=20
JJin91: posts the ante 375
CerPrisingLe: posts the ante 375
Going2Ship: posts the ante 375
helzkitchen: posts the ante 375
GetLoose17: posts the ante 375
lrb1024: posts the ante 375
CerPrisingLe: posts small blind 1500
Going2Ship: posts big blind 3000
*** HOLE CARDS ***
Dealt to JJin91 [Jc 8c]
helzkitchen: folds=20
GetLoose17: folds=20
lrb1024: folds=20
JJin91: folds=20
CerPrisingLe: raises 3000 to 6000
Going2Ship: folds=20
Uncalled bet (3000) returned to CerPrisingLe
CerPrisingLe collected 8250 from pot
CerPrisingLe: doesn't show hand=20
*** SUMMARY ***
Total pot 8250 | Rake 0=20
Seat 1: JJin91 (button) folded before Flop (didn't bet)
Seat 2: CerPrisingLe (small blind) collected (8250)
Seat 5: Going2Ship (big blind) folded before Flop
Seat 7: helzkitchen folded before Flop (didn't bet)
Seat 8: GetLoose17 folded before Flop (didn't bet)
Seat 9: lrb1024 folded before Flop (didn't bet)


*********** # 227 **************
PokerStars Hand #172152624377: Tournament #1648990476, $18.20+$1.80 USD=
 Hold'em No Limit - Level XXI (1500/3000) - 2017/07/06 22:44:46 ET
Table '1648990476 3' 9-max Seat #2 is the button
Seat 1: JJin91 (83369 in chips)=20
Seat 2: CerPrisingLe (103725 in chips)=20
Seat 5: Going2Ship (46254 in chips)=20
Seat 7: helzkitchen (67452 in chips)=20
Seat 8: GetLoose17 (54100 in chips)=20
Seat 9: lrb1024 (20535 in chips)=20
JJin91: posts the ante 375
CerPrisingLe: posts the ante 375
Going2Ship: posts the ante 375
helzkitchen: posts the ante 375
GetLoose17: posts the ante 375
lrb1024: posts the ante 375
Going2Ship: posts small blind 1500
helzkitchen: posts big blind 3000
*** HOLE CARDS ***
Dealt to JJin91 [Qc 6s]
GetLoose17: folds=20
lrb1024: folds=20
JJin91: folds=20
CerPrisingLe: raises 3000 to 6000
Going2Ship: folds=20
helzkitchen: calls 3000
*** FLOP *** [2h 2c 5s]
helzkitchen: checks=20
CerPrisingLe: bets 9000
helzkitchen: raises 18000 to 27000
CerPrisingLe: folds=20
Uncalled bet (18000) returned to helzkitchen
helzkitchen collected 33750 from pot
helzkitchen: doesn't show hand=20
*** SUMMARY ***
Total pot 33750 | Rake 0=20
Board [2h 2c 5s]
Seat 1: JJin91 folded before Flop (didn't bet)
Seat 2: CerPrisingLe (button) folded on the Flop
Seat 5: Going2Ship (small blind) folded before Flop
Seat 7: helzkitchen (big blind) collected (33750)
Seat 8: GetLoose17 folded before Flop (didn't bet)
Seat 9: lrb1024 folded before Flop (didn't bet)


*********** # 228 **************
PokerStars Hand #172152624547: Tournament #1648990476, $18.20+$1.80 USD=
 Hold'em No Limit - Level XXI (1500/3000) - 2017/07/06 22:45:25 ET
Table '1648990476 3' 9-max Seat #5 is the button
Seat 1: JJin91 (82994 in chips)=20
Seat 2: CerPrisingLe (88350 in chips)=20
Seat 5: Going2Ship (44379 in chips)=20
Seat 7: helzkitchen (85827 in chips)=20
Seat 8: GetLoose17 (53725 in chips)=20
Seat 9: lrb1024 (20160 in chips)=20
JJin91: posts the ante 375
CerPrisingLe: posts the ante 375
Going2Ship: posts the ante 375
helzkitchen: posts the ante 375
GetLoose17: posts the ante 375
lrb1024: posts the ante 375
helzkitchen: posts small blind 1500
GetLoose17: posts big blind 3000
*** HOLE CARDS ***
Dealt to JJin91 [As 8d]
lrb1024: folds=20
JJin91: raises 3330 to 6330
CerPrisingLe: folds=20
Going2Ship: folds=20
helzkitchen: folds=20
GetLoose17: folds=20
Uncalled bet (3330) returned to JJin91
JJin91 collected 9750 from pot
JJin91: doesn't show hand=20
*** SUMMARY ***
Total pot 9750 | Rake 0=20
Seat 1: JJin91 collected (9750)
Seat 2: CerPrisingLe folded before Flop (didn't bet)
Seat 5: Going2Ship (button) folded before Flop (didn't bet)
Seat 7: helzkitchen (small blind) folded before Flop
Seat 8: GetLoose17 (big blind) folded before Flop
Seat 9: lrb1024 folded before Flop (didn't bet)


*********** # 229 **************
PokerStars Hand #172152624659: Tournament #1648990476, $18.20+$1.80 USD=
 Hold'em No Limit - Level XXI (1500/3000) - 2017/07/06 22:45:49 ET
Table '1648990476 3' 9-max Seat #7 is the button
Seat 1: JJin91 (89369 in chips)=20
Seat 2: CerPrisingLe (87975 in chips)=20
Seat 5: Going2Ship (44004 in chips)=20
Seat 7: helzkitchen (83952 in chips)=20
Seat 8: GetLoose17 (50350 in chips)=20
Seat 9: lrb1024 (19785 in chips)=20
JJin91: posts the ante 375
CerPrisingLe: posts the ante 375
Going2Ship: posts the ante 375
helzkitchen: posts the ante 375
GetLoose17: posts the ante 375
lrb1024: posts the ante 375
GetLoose17: posts small blind 1500
lrb1024: posts big blind 3000
*** HOLE CARDS ***
Dealt to JJin91 [2h 8d]
JJin91: folds=20
CerPrisingLe: raises 3000 to 6000
Going2Ship: folds=20
helzkitchen: folds=20
GetLoose17: folds=20
lrb1024: folds=20
Uncalled bet (3000) returned to CerPrisingLe
CerPrisingLe collected 9750 from pot
CerPrisingLe: doesn't show hand=20
*** SUMMARY ***
Total pot 9750 | Rake 0=20
Seat 1: JJin91 folded before Flop (didn't bet)
Seat 2: CerPrisingLe collected (9750)
Seat 5: Going2Ship folded before Flop (didn't bet)
Seat 7: helzkitchen (button) folded before Flop (didn't bet)
Seat 8: GetLoose17 (small blind) folded before Flop
Seat 9: lrb1024 (big blind) folded before Flop


*********** # 230 **************
PokerStars Hand #172152624806: Tournament #1648990476, $18.20+$1.80 USD=
 Hold'em No Limit - Level XXI (1500/3000) - 2017/07/06 22:46:22 ET
Table '1648990476 3' 9-max Seat #8 is the button
Seat 1: JJin91 (88994 in chips)=20
Seat 2: CerPrisingLe (94350 in chips)=20
Seat 5: Going2Ship (43629 in chips)=20
Seat 7: helzkitchen (83577 in chips)=20
Seat 8: GetLoose17 (48475 in chips)=20
Seat 9: lrb1024 (16410 in chips)=20
JJin91: posts the ante 375
CerPrisingLe: posts the ante 375
Going2Ship: posts the ante 375
helzkitchen: posts the ante 375
GetLoose17: posts the ante 375
lrb1024: posts the ante 375
lrb1024: posts small blind 1500
JJin91: posts big blind 3000
*** HOLE CARDS ***
Dealt to JJin91 [Jh 3d]
CerPrisingLe: raises 3000 to 6000
Going2Ship: folds=20
helzkitchen: folds=20
GetLoose17: folds=20
lrb1024: folds=20
JJin91: folds=20
Uncalled bet (3000) returned to CerPrisingLe
CerPrisingLe collected 9750 from pot
CerPrisingLe: doesn't show hand=20
*** SUMMARY ***
Total pot 9750 | Rake 0=20
Seat 1: JJin91 (big blind) folded before Flop
Seat 2: CerPrisingLe collected (9750)
Seat 5: Going2Ship folded before Flop (didn't bet)
Seat 7: helzkitchen folded before Flop (didn't bet)
Seat 8: GetLoose17 (button) folded before Flop (didn't bet)
Seat 9: lrb1024 (small blind) folded before Flop


*********** # 231 **************
PokerStars Hand #172152624874: Tournament #1648990476, $18.20+$1.80 USD=
 Hold'em No Limit - Level XXI (1500/3000) - 2017/07/06 22:46:35 ET
Table '1648990476 3' 9-max Seat #9 is the button
Seat 1: JJin91 (85619 in chips)=20
Seat 2: CerPrisingLe (100725 in chips)=20
Seat 5: Going2Ship (43254 in chips)=20
Seat 7: helzkitchen (83202 in chips)=20
Seat 8: GetLoose17 (48100 in chips)=20
Seat 9: lrb1024 (14535 in chips)=20
JJin91: posts the ante 375
CerPrisingLe: posts the ante 375
Going2Ship: posts the ante 375
helzkitchen: posts the ante 375
GetLoose17: posts the ante 375
lrb1024: posts the ante 375
JJin91: posts small blind 1500
CerPrisingLe: posts big blind 3000
*** HOLE CARDS ***
Dealt to JJin91 [5s 3c]
Going2Ship: folds=20
helzkitchen: raises 3000 to 6000
GetLoose17: raises 41725 to 47725 and is all-in
lrb1024: folds=20
JJin91: folds=20
CerPrisingLe: folds=20
helzkitchen: calls 41725
*** FLOP *** [3s 4d Td]
*** TURN *** [3s 4d Td] [7c]
*** RIVER *** [3s 4d Td 7c] [2h]
*** SHOW DOWN ***
helzkitchen: shows [Ac 6c] (high card Ace)
GetLoose17: shows [As Th] (a pair of Tens)
GetLoose17 collected 102200 from pot
*** SUMMARY ***
Total pot 102200 | Rake 0=20
Board [3s 4d Td 7c 2h]
Seat 1: JJin91 (small blind) folded before Flop
Seat 2: CerPrisingLe (big blind) folded before Flop
Seat 5: Going2Ship folded before Flop (didn't bet)
Seat 7: helzkitchen showed [Ac 6c] and lost with high card Ace
Seat 8: GetLoose17 showed [As Th] and won (102200) with a pair of Tens
Seat 9: lrb1024 (button) folded before Flop (didn't bet)


*********** # 232 **************
PokerStars Hand #172152624983: Tournament #1648990476, $18.20+$1.80 USD=
 Hold'em No Limit - Level XXI (1500/3000) - 2017/07/06 22:46:58 ET
Table '1648990476 3' 9-max Seat #1 is the button
Seat 1: JJin91 (83744 in chips)=20
Seat 2: CerPrisingLe (97350 in chips)=20
Seat 5: Going2Ship (42879 in chips)=20
Seat 7: helzkitchen (35102 in chips)=20
Seat 8: GetLoose17 (102200 in chips)=20
Seat 9: lrb1024 (14160 in chips)=20
JJin91: posts the ante 375
CerPrisingLe: posts the ante 375
Going2Ship: posts the ante 375
helzkitchen: posts the ante 375
GetLoose17: posts the ante 375
lrb1024: posts the ante 375
CerPrisingLe: posts small blind 1500
Going2Ship: posts big blind 3000
*** HOLE CARDS ***
Dealt to JJin91 [6c Ts]
helzkitchen: folds=20
GetLoose17: folds=20
lrb1024: folds=20
JJin91: folds=20
CerPrisingLe: raises 3000 to 6000
Going2Ship: folds=20
Uncalled bet (3000) returned to CerPrisingLe
CerPrisingLe collected 8250 from pot
CerPrisingLe: doesn't show hand=20
*** SUMMARY ***
Total pot 8250 | Rake 0=20
Seat 1: JJin91 (button) folded before Flop (didn't bet)
Seat 2: CerPrisingLe (small blind) collected (8250)
Seat 5: Going2Ship (big blind) folded before Flop
Seat 7: helzkitchen folded before Flop (didn't bet)
Seat 8: GetLoose17 folded before Flop (didn't bet)
Seat 9: lrb1024 folded before Flop (didn't bet)


*********** # 233 **************
PokerStars Hand #172152625029: Tournament #1648990476, $18.20+$1.80 USD=
 Hold'em No Limit - Level XXI (1500/3000) - 2017/07/06 22:47:09 ET
Table '1648990476 3' 9-max Seat #2 is the button
Seat 1: JJin91 (83369 in chips)=20
Seat 2: CerPrisingLe (102225 in chips)=20
Seat 5: Going2Ship (39504 in chips)=20
Seat 7: helzkitchen (34727 in chips)=20
Seat 8: GetLoose17 (101825 in chips)=20
Seat 9: lrb1024 (13785 in chips)=20
JJin91: posts the ante 375
CerPrisingLe: posts the ante 375
Going2Ship: posts the ante 375
helzkitchen: posts the ante 375
GetLoose17: posts the ante 375
lrb1024: posts the ante 375
Going2Ship: posts small blind 1500
helzkitchen: posts big blind 3000
*** HOLE CARDS ***
Dealt to JJin91 [4c 7d]
helzkitchen said, "fcxxxxx"
GetLoose17: folds=20
lrb1024: folds=20
JJin91: folds=20
CerPrisingLe: raises 3000 to 6000
Going2Ship: raises 33129 to 39129 and is all-in
helzkitchen: folds=20
CerPrisingLe: folds=20
Uncalled bet (33129) returned to Going2Ship
Going2Ship collected 17250 from pot
Going2Ship: doesn't show hand=20
*** SUMMARY ***
Total pot 17250 | Rake 0=20
Seat 1: JJin91 folded before Flop (didn't bet)
Seat 2: CerPrisingLe (button) folded before Flop
Seat 5: Going2Ship (small blind) collected (17250)
Seat 7: helzkitchen (big blind) folded before Flop
Seat 8: GetLoose17 folded before Flop (didn't bet)
Seat 9: lrb1024 folded before Flop (didn't bet)


*********** # 234 **************
PokerStars Hand #172152625103: Tournament #1648990476, $18.20+$1.80 USD=
 Hold'em No Limit - Level XXII (2000/4000) - 2017/07/06 22:47:25 ET
Table '1648990476 3' 9-max Seat #5 is the button
Seat 1: JJin91 (82994 in chips)=20
Seat 2: CerPrisingLe (95850 in chips)=20
Seat 5: Going2Ship (50379 in chips)=20
Seat 7: helzkitchen (31352 in chips)=20
Seat 8: GetLoose17 (101450 in chips)=20
Seat 9: lrb1024 (13410 in chips)=20
JJin91: posts the ante 500
CerPrisingLe: posts the ante 500
Going2Ship: posts the ante 500
helzkitchen: posts the ante 500
GetLoose17: posts the ante 500
lrb1024: posts the ante 500
helzkitchen: posts small blind 2000
GetLoose17: posts big blind 4000
*** HOLE CARDS ***
Dealt to JJin91 [7s 3s]
lrb1024: folds=20
JJin91: folds=20
CerPrisingLe: folds=20
Going2Ship: folds=20
helzkitchen: folds=20
Uncalled bet (2000) returned to GetLoose17
GetLoose17 collected 7000 from pot
GetLoose17: doesn't show hand=20
*** SUMMARY ***
Total pot 7000 | Rake 0=20
Seat 1: JJin91 folded before Flop (didn't bet)
Seat 2: CerPrisingLe folded before Flop (didn't bet)
Seat 5: Going2Ship (button) folded before Flop (didn't bet)
Seat 7: helzkitchen (small blind) folded before Flop
Seat 8: GetLoose17 (big blind) collected (7000)
Seat 9: lrb1024 folded before Flop (didn't bet)


*********** # 235 **************
PokerStars Hand #172152625142: Tournament #1648990476, $18.20+$1.80 USD=
 Hold'em No Limit - Level XXII (2000/4000) - 2017/07/06 22:47:33 ET
Table '1648990476 3' 9-max Seat #7 is the button
Seat 1: JJin91 (82494 in chips)=20
Seat 2: CerPrisingLe (95350 in chips)=20
Seat 5: Going2Ship (49879 in chips)=20
Seat 7: helzkitchen (28852 in chips)=20
Seat 8: GetLoose17 (105950 in chips)=20
Seat 9: lrb1024 (12910 in chips)=20
JJin91: posts the ante 500
CerPrisingLe: posts the ante 500
Going2Ship: posts the ante 500
helzkitchen: posts the ante 500
GetLoose17: posts the ante 500
lrb1024: posts the ante 500
GetLoose17: posts small blind 2000
lrb1024: posts big blind 4000
*** HOLE CARDS ***
Dealt to JJin91 [Ac 3h]
JJin91: folds=20
CerPrisingLe: folds=20
Going2Ship: folds=20
helzkitchen: raises 24352 to 28352 and is all-in
GetLoose17: folds=20
lrb1024: folds=20
Uncalled bet (24352) returned to helzkitchen
helzkitchen collected 13000 from pot
helzkitchen: doesn't show hand=20
*** SUMMARY ***
Total pot 13000 | Rake 0=20
Seat 1: JJin91 folded before Flop (didn't bet)
Seat 2: CerPrisingLe folded before Flop (didn't bet)
Seat 5: Going2Ship folded before Flop (didn't bet)
Seat 7: helzkitchen (button) collected (13000)
Seat 8: GetLoose17 (small blind) folded before Flop
Seat 9: lrb1024 (big blind) folded before Flop


*********** # 236 **************
PokerStars Hand #172152625218: Tournament #1648990476, $18.20+$1.80 USD=
 Hold'em No Limit - Level XXII (2000/4000) - 2017/07/06 22:47:50 ET
Table '1648990476 3' 9-max Seat #8 is the button
Seat 1: JJin91 (81994 in chips)=20
Seat 2: CerPrisingLe (94850 in chips)=20
Seat 5: Going2Ship (49379 in chips)=20
Seat 7: helzkitchen (37352 in chips)=20
Seat 8: GetLoose17 (103450 in chips)=20
Seat 9: lrb1024 (8410 in chips)=20
JJin91: posts the ante 500
CerPrisingLe: posts the ante 500
Going2Ship: posts the ante 500
helzkitchen: posts the ante 500
GetLoose17: posts the ante 500
lrb1024: posts the ante 500
lrb1024: posts small blind 2000
JJin91: posts big blind 4000
*** HOLE CARDS ***
Dealt to JJin91 [4d 4s]
CerPrisingLe: raises 4000 to 8000
Going2Ship: folds=20
helzkitchen: folds=20
GetLoose17: folds=20
lrb1024: calls 5910 and is all-in
JJin91: calls 4000
*** FLOP *** [Js 3c 9d]
JJin91: checks=20
CerPrisingLe: bets 12000
JJin91: folds=20
Uncalled bet (12000) returned to CerPrisingLe
*** TURN *** [Js 3c 9d] [7d]
*** RIVER *** [Js 3c 9d 7d] [Kc]
*** SHOW DOWN ***
CerPrisingLe: shows [Qc Jc] (a pair of Jacks)
CerPrisingLe collected 180 from side pot
lrb1024: shows [4c Ah] (high card Ace)
CerPrisingLe collected 26730 from main pot
lrb1024 finished the tournament in 19th place and received $24.57.
*** SUMMARY ***
Total pot 26910 Main pot 26730. Side pot 180. | Rake 0=20
Board [Js 3c 9d 7d Kc]
Seat 1: JJin91 (big blind) folded on the Flop
Seat 2: CerPrisingLe showed [Qc Jc] and won (26910) with a pair of Jacks
Seat 5: Going2Ship folded before Flop (didn't bet)
Seat 7: helzkitchen folded before Flop (didn't bet)
Seat 8: GetLoose17 (button) folded before Flop (didn't bet)
Seat 9: lrb1024 (small blind) showed [4c Ah] and lost with high card Ace


*********** # 237 **************
PokerStars Hand #172152625372: Tournament #1648990476, $18.20+$1.80 USD=
 Hold'em No Limit - Level XXII (2000/4000) - 2017/07/06 22:48:20 ET
Table '1648990476 7' 9-max Seat #5 is the button
Seat 1: JJin91 (73494 in chips)=20
Seat 2: GetLoose17 (102950 in chips)=20
Seat 3: E9Polarizer (71596 in chips)=20
Seat 4: kitkattbp (26595 in chips)=20
Seat 5: akbongu1977 (36559 in chips)=20
Seat 6: GMMK426 (171632 in chips)=20
Seat 7: fingers911 (26854 in chips)=20
Seat 8: apoch19 (121589 in chips)=20
Seat 9: helzkitchen (36852 in chips)=20
JJin91: posts the ante 500
GetLoose17: posts the ante 500
E9Polarizer: posts the ante 500
kitkattbp: posts the ante 500
akbongu1977: posts the ante 500
GMMK426: posts the ante 500
fingers911: posts the ante 500
apoch19: posts the ante 500
helzkitchen: posts the ante 500
GMMK426: posts small blind 2000
fingers911: posts big blind 4000
*** HOLE CARDS ***
Dealt to JJin91 [9s 4d]
apoch19: raises 4750 to 8750
helzkitchen: folds=20
JJin91: folds=20
GetLoose17: folds=20
E9Polarizer: folds=20
kitkattbp: folds=20
akbongu1977: folds=20
GMMK426: calls 6750
fingers911: folds=20
*** FLOP *** [9d 8d 3h]
GMMK426: checks=20
apoch19: checks=20
*** TURN *** [9d 8d 3h] [8h]
GMMK426: bets 13000
apoch19: folds=20
Uncalled bet (13000) returned to GMMK426
GMMK426 collected 26000 from pot
GMMK426: doesn't show hand=20
*** SUMMARY ***
Total pot 26000 | Rake 0=20
Board [9d 8d 3h 8h]
Seat 1: JJin91 folded before Flop (didn't bet)
Seat 2: GetLoose17 folded before Flop (didn't bet)
Seat 3: E9Polarizer folded before Flop (didn't bet)
Seat 4: kitkattbp folded before Flop (didn't bet)
Seat 5: akbongu1977 (button) folded before Flop (didn't bet)
Seat 6: GMMK426 (small blind) collected (26000)
Seat 7: fingers911 (big blind) folded before Flop
Seat 8: apoch19 folded on the Turn
Seat 9: helzkitchen folded before Flop (didn't bet)


*********** # 238 **************
PokerStars Hand #172152625616: Tournament #1648990476, $18.20+$1.80 USD=
 Hold'em No Limit - Level XXII (2000/4000) - 2017/07/06 22:49:16 ET
Table '1648990476 7' 9-max Seat #6 is the button
Seat 1: JJin91 (72994 in chips)=20
Seat 2: GetLoose17 (102450 in chips)=20
Seat 3: E9Polarizer (71096 in chips)=20
Seat 4: kitkattbp (26095 in chips)=20
Seat 5: akbongu1977 (36059 in chips)=20
Seat 6: GMMK426 (188382 in chips)=20
Seat 7: fingers911 (22354 in chips)=20
Seat 8: apoch19 (112339 in chips)=20
Seat 9: helzkitchen (36352 in chips)=20
JJin91: posts the ante 500
GetLoose17: posts the ante 500
E9Polarizer: posts the ante 500
kitkattbp: posts the ante 500
akbongu1977: posts the ante 500
GMMK426: posts the ante 500
fingers911: posts the ante 500
apoch19: posts the ante 500
helzkitchen: posts the ante 500
fingers911: posts small blind 2000
apoch19: posts big blind 4000
*** HOLE CARDS ***
Dealt to JJin91 [Jc 2h]
helzkitchen: folds=20
JJin91: folds=20
GetLoose17: folds=20
E9Polarizer: folds=20
kitkattbp: folds=20
akbongu1977: folds=20
GMMK426: raises 8000 to 12000
fingers911: folds=20
apoch19: raises 20850 to 32850
GMMK426: folds=20
Uncalled bet (20850) returned to apoch19
apoch19 collected 30500 from pot
apoch19: doesn't show hand=20
*** SUMMARY ***
Total pot 30500 | Rake 0=20
Seat 1: JJin91 folded before Flop (didn't bet)
Seat 2: GetLoose17 folded before Flop (didn't bet)
Seat 3: E9Polarizer folded before Flop (didn't bet)
Seat 4: kitkattbp folded before Flop (didn't bet)
Seat 5: akbongu1977 folded before Flop (didn't bet)
Seat 6: GMMK426 (button) folded before Flop
Seat 7: fingers911 (small blind) folded before Flop
Seat 8: apoch19 (big blind) collected (30500)
Seat 9: helzkitchen folded before Flop (didn't bet)


*********** # 239 **************
PokerStars Hand #172152625853: Tournament #1648990476, $18.20+$1.80 USD=
 Hold'em No Limit - Level XXII (2000/4000) - 2017/07/06 22:50:07 ET
Table '1648990476 7' 9-max Seat #7 is the button
Seat 1: JJin91 (72494 in chips)=20
Seat 2: GetLoose17 (101950 in chips)=20
Seat 3: E9Polarizer (70596 in chips)=20
Seat 4: kitkattbp (25595 in chips)=20
Seat 5: akbongu1977 (35559 in chips)=20
Seat 6: GMMK426 (175882 in chips)=20
Seat 7: fingers911 (19854 in chips)=20
Seat 8: apoch19 (130339 in chips)=20
Seat 9: helzkitchen (35852 in chips)=20
JJin91: posts the ante 500
GetLoose17: posts the ante 500
E9Polarizer: posts the ante 500
kitkattbp: posts the ante 500
akbongu1977: posts the ante 500
GMMK426: posts the ante 500
fingers911: posts the ante 500
apoch19: posts the ante 500
helzkitchen: posts the ante 500
apoch19: posts small blind 2000
helzkitchen: posts big blind 4000
*** HOLE CARDS ***
Dealt to JJin91 [7s Ad]
JJin91: folds=20
GetLoose17: folds=20
E9Polarizer: folds=20
kitkattbp: folds=20
akbongu1977: folds=20
GMMK426: folds=20
fingers911: folds=20
apoch19: calls 2000
helzkitchen: raises 31352 to 35352 and is all-in
apoch19: folds=20
Uncalled bet (31352) returned to helzkitchen
helzkitchen collected 12500 from pot
helzkitchen: doesn't show hand=20
*** SUMMARY ***
Total pot 12500 | Rake 0=20
Seat 1: JJin91 folded before Flop (didn't bet)
Seat 2: GetLoose17 folded before Flop (didn't bet)
Seat 3: E9Polarizer folded before Flop (didn't bet)
Seat 4: kitkattbp folded before Flop (didn't bet)
Seat 5: akbongu1977 folded before Flop (didn't bet)
Seat 6: GMMK426 folded before Flop (didn't bet)
Seat 7: fingers911 (button) folded before Flop (didn't bet)
Seat 8: apoch19 (small blind) folded before Flop
Seat 9: helzkitchen (big blind) collected (12500)


*********** # 240 **************
PokerStars Hand #172152625990: Tournament #1648990476, $18.20+$1.80 USD=
 Hold'em No Limit - Level XXII (2000/4000) - 2017/07/06 22:50:39 ET
Table '1648990476 7' 9-max Seat #8 is the button
Seat 1: JJin91 (71994 in chips)=20
Seat 2: GetLoose17 (101450 in chips)=20
Seat 3: E9Polarizer (70096 in chips)=20
Seat 4: kitkattbp (25095 in chips)=20
Seat 5: akbongu1977 (35059 in chips)=20
Seat 6: GMMK426 (175382 in chips)=20
Seat 7: fingers911 (19354 in chips)=20
Seat 8: apoch19 (125839 in chips)=20
Seat 9: helzkitchen (43852 in chips)=20
JJin91: posts the ante 500
GetLoose17: posts the ante 500
E9Polarizer: posts the ante 500
kitkattbp: posts the ante 500
akbongu1977: posts the ante 500
GMMK426: posts the ante 500
fingers911: posts the ante 500
apoch19: posts the ante 500
helzkitchen: posts the ante 500
helzkitchen: posts small blind 2000
JJin91: posts big blind 4000
*** HOLE CARDS ***
Dealt to JJin91 [4d Ac]
GetLoose17: folds=20
E9Polarizer: folds=20
kitkattbp: folds=20
akbongu1977: raises 30559 to 34559 and is all-in
GMMK426: folds=20
fingers911: folds=20
apoch19: folds=20
helzkitchen: folds=20
JJin91: folds=20
Uncalled bet (30559) returned to akbongu1977
akbongu1977 collected 14500 from pot
akbongu1977: doesn't show hand=20
*** SUMMARY ***
Total pot 14500 | Rake 0=20
Seat 1: JJin91 (big blind) folded before Flop
Seat 2: GetLoose17 folded before Flop (didn't bet)
Seat 3: E9Polarizer folded before Flop (didn't bet)
Seat 4: kitkattbp folded before Flop (didn't bet)
Seat 5: akbongu1977 collected (14500)
Seat 6: GMMK426 folded before Flop (didn't bet)
Seat 7: fingers911 folded before Flop (didn't bet)
Seat 8: apoch19 (button) folded before Flop (didn't bet)
Seat 9: helzkitchen (small blind) folded before Flop


*********** # 241 **************
PokerStars Hand #172152626124: Tournament #1648990476, $18.20+$1.80 USD=
 Hold'em No Limit - Level XXII (2000/4000) - 2017/07/06 22:51:10 ET
Table '1648990476 7' 9-max Seat #9 is the button
Seat 1: JJin91 (67494 in chips)=20
Seat 2: GetLoose17 (100950 in chips)=20
Seat 3: E9Polarizer (69596 in chips)=20
Seat 4: kitkattbp (24595 in chips)=20
Seat 5: akbongu1977 (45059 in chips)=20
Seat 6: GMMK426 (174882 in chips)=20
Seat 7: fingers911 (18854 in chips)=20
Seat 8: apoch19 (125339 in chips)=20
Seat 9: helzkitchen (41352 in chips)=20
JJin91: posts the ante 500
GetLoose17: posts the ante 500
E9Polarizer: posts the ante 500
kitkattbp: posts the ante 500
akbongu1977: posts the ante 500
GMMK426: posts the ante 500
fingers911: posts the ante 500
apoch19: posts the ante 500
helzkitchen: posts the ante 500
JJin91: posts small blind 2000
GetLoose17: posts big blind 4000
*** HOLE CARDS ***
Dealt to JJin91 [4s Ah]
E9Polarizer: folds=20
kitkattbp: folds=20
akbongu1977: folds=20
GMMK426: folds=20
fingers911: folds=20
apoch19: folds=20
helzkitchen: folds=20
JJin91: raises 62994 to 66994 and is all-in
GetLoose17: folds=20
Uncalled bet (62994) returned to JJin91
JJin91 collected 12500 from pot
JJin91: doesn't show hand=20
*** SUMMARY ***
Total pot 12500 | Rake 0=20
Seat 1: JJin91 (small blind) collected (12500)
Seat 2: GetLoose17 (big blind) folded before Flop
Seat 3: E9Polarizer folded before Flop (didn't bet)
Seat 4: kitkattbp folded before Flop (didn't bet)
Seat 5: akbongu1977 folded before Flop (didn't bet)
Seat 6: GMMK426 folded before Flop (didn't bet)
Seat 7: fingers911 folded before Flop (didn't bet)
Seat 8: apoch19 folded before Flop (didn't bet)
Seat 9: helzkitchen (button) folded before Flop (didn't bet)


*********** # 242 **************
PokerStars Hand #172152626319: Tournament #1648990476, $18.20+$1.80 USD=
 Hold'em No Limit - Level XXII (2000/4000) - 2017/07/06 22:51:56 ET
Table '1648990476 7' 9-max Seat #1 is the button
Seat 1: JJin91 (75494 in chips)=20
Seat 2: GetLoose17 (96450 in chips)=20
Seat 3: E9Polarizer (69096 in chips)=20
Seat 4: kitkattbp (24095 in chips)=20
Seat 5: akbongu1977 (44559 in chips)=20
Seat 6: GMMK426 (174382 in chips)=20
Seat 7: fingers911 (18354 in chips)=20
Seat 8: apoch19 (124839 in chips)=20
Seat 9: helzkitchen (40852 in chips)=20
JJin91: posts the ante 500
GetLoose17: posts the ante 500
E9Polarizer: posts the ante 500
kitkattbp: posts the ante 500
akbongu1977: posts the ante 500
GMMK426: posts the ante 500
fingers911: posts the ante 500
apoch19: posts the ante 500
helzkitchen: posts the ante 500
GetLoose17: posts small blind 2000
E9Polarizer: posts big blind 4000
*** HOLE CARDS ***
Dealt to JJin91 [8d 6d]
kitkattbp: folds=20
akbongu1977: folds=20
GMMK426: folds=20
fingers911: folds=20
apoch19: folds=20
helzkitchen: raises 36352 to 40352 and is all-in
JJin91: folds=20
GetLoose17: folds=20
E9Polarizer: folds=20
Uncalled bet (36352) returned to helzkitchen
helzkitchen collected 14500 from pot
helzkitchen: doesn't show hand=20
*** SUMMARY ***
Total pot 14500 | Rake 0=20
Seat 1: JJin91 (button) folded before Flop (didn't bet)
Seat 2: GetLoose17 (small blind) folded before Flop
Seat 3: E9Polarizer (big blind) folded before Flop
Seat 4: kitkattbp folded before Flop (didn't bet)
Seat 5: akbongu1977 folded before Flop (didn't bet)
Seat 6: GMMK426 folded before Flop (didn't bet)
Seat 7: fingers911 folded before Flop (didn't bet)
Seat 8: apoch19 folded before Flop (didn't bet)
Seat 9: helzkitchen collected (14500)


*********** # 243 **************
PokerStars Hand #172152626455: Tournament #1648990476, $18.20+$1.80 USD=
 Hold'em No Limit - Level XXII (2000/4000) - 2017/07/06 22:52:28 ET
Table '1648990476 7' 9-max Seat #2 is the button
Seat 1: JJin91 (74994 in chips)=20
Seat 2: GetLoose17 (93950 in chips)=20
Seat 3: E9Polarizer (64596 in chips)=20
Seat 4: kitkattbp (23595 in chips)=20
Seat 5: akbongu1977 (44059 in chips)=20
Seat 6: GMMK426 (173882 in chips)=20
Seat 7: fingers911 (17854 in chips)=20
Seat 8: apoch19 (124339 in chips)=20
Seat 9: helzkitchen (50852 in chips)=20
JJin91: posts the ante 500
GetLoose17: posts the ante 500
E9Polarizer: posts the ante 500
kitkattbp: posts the ante 500
akbongu1977: posts the ante 500
GMMK426: posts the ante 500
fingers911: posts the ante 500
apoch19: posts the ante 500
helzkitchen: posts the ante 500
E9Polarizer: posts small blind 2000
kitkattbp: posts big blind 4000
*** HOLE CARDS ***
Dealt to JJin91 [Qc 3h]
akbongu1977: folds=20
GMMK426: folds=20
fingers911: folds=20
apoch19: folds=20
helzkitchen: folds=20
JJin91: folds=20
GetLoose17: folds=20
E9Polarizer: folds=20
Uncalled bet (2000) returned to kitkattbp
kitkattbp collected 8500 from pot
kitkattbp: doesn't show hand=20
*** SUMMARY ***
Total pot 8500 | Rake 0=20
Seat 1: JJin91 folded before Flop (didn't bet)
Seat 2: GetLoose17 (button) folded before Flop (didn't bet)
Seat 3: E9Polarizer (small blind) folded before Flop
Seat 4: kitkattbp (big blind) collected (8500)
Seat 5: akbongu1977 folded before Flop (didn't bet)
Seat 6: GMMK426 folded before Flop (didn't bet)
Seat 7: fingers911 folded before Flop (didn't bet)
Seat 8: apoch19 folded before Flop (didn't bet)
Seat 9: helzkitchen folded before Flop (didn't bet)


*********** # 244 **************
PokerStars Hand #172152626558: Tournament #1648990476, $18.20+$1.80 USD=
 Hold'em No Limit - Level XXII (2000/4000) - 2017/07/06 22:52:52 ET
Table '1648990476 7' 9-max Seat #3 is the button
Seat 1: JJin91 (74494 in chips)=20
Seat 2: GetLoose17 (93450 in chips)=20
Seat 3: E9Polarizer (62096 in chips)=20
Seat 4: kitkattbp (29595 in chips)=20
Seat 5: akbongu1977 (43559 in chips)=20
Seat 6: GMMK426 (173382 in chips)=20
Seat 7: fingers911 (17354 in chips)=20
Seat 8: apoch19 (123839 in chips)=20
Seat 9: helzkitchen (50352 in chips)=20
JJin91: posts the ante 500
GetLoose17: posts the ante 500
E9Polarizer: posts the ante 500
kitkattbp: posts the ante 500
akbongu1977: posts the ante 500
GMMK426: posts the ante 500
fingers911: posts the ante 500
apoch19: posts the ante 500
helzkitchen: posts the ante 500
kitkattbp: posts small blind 2000
akbongu1977: posts big blind 4000
*** HOLE CARDS ***
Dealt to JJin91 [Ts 5c]
GMMK426: raises 4000 to 8000
fingers911: folds=20
apoch19: calls 8000
helzkitchen: folds=20
JJin91: folds=20
GetLoose17: folds=20
E9Polarizer: folds=20
kitkattbp: folds=20
akbongu1977: folds=20
*** FLOP *** [Qd 7d 4s]
GMMK426: bets 26500
apoch19: folds=20
Uncalled bet (26500) returned to GMMK426
GMMK426 collected 26500 from pot
GMMK426: doesn't show hand=20
*** SUMMARY ***
Total pot 26500 | Rake 0=20
Board [Qd 7d 4s]
Seat 1: JJin91 folded before Flop (didn't bet)
Seat 2: GetLoose17 folded before Flop (didn't bet)
Seat 3: E9Polarizer (button) folded before Flop (didn't bet)
Seat 4: kitkattbp (small blind) folded before Flop
Seat 5: akbongu1977 (big blind) folded before Flop
Seat 6: GMMK426 collected (26500)
Seat 7: fingers911 folded before Flop (didn't bet)
Seat 8: apoch19 folded on the Flop
Seat 9: helzkitchen folded before Flop (didn't bet)


*********** # 245 **************
PokerStars Hand #172152626765: Tournament #1648990476, $18.20+$1.80 USD=
 Hold'em No Limit - Level XXII (2000/4000) - 2017/07/06 22:53:41 ET
Table '1648990476 7' 9-max Seat #4 is the button
Seat 1: JJin91 (73994 in chips)=20
Seat 2: GetLoose17 (92950 in chips)=20
Seat 3: E9Polarizer (61596 in chips)=20
Seat 4: kitkattbp (27095 in chips)=20
Seat 5: akbongu1977 (39059 in chips)=20
Seat 6: GMMK426 (191382 in chips)=20
Seat 7: fingers911 (16854 in chips)=20
Seat 8: apoch19 (115339 in chips)=20
Seat 9: helzkitchen (49852 in chips)=20
JJin91: posts the ante 500
GetLoose17: posts the ante 500
E9Polarizer: posts the ante 500
kitkattbp: posts the ante 500
akbongu1977: posts the ante 500
GMMK426: posts the ante 500
fingers911: posts the ante 500
apoch19: posts the ante 500
helzkitchen: posts the ante 500
akbongu1977: posts small blind 2000
GMMK426: posts big blind 4000
*** HOLE CARDS ***
Dealt to JJin91 [8d 3c]
fingers911: folds=20
apoch19: folds=20
helzkitchen: folds=20
JJin91: folds=20
GetLoose17: raises 6000 to 10000
E9Polarizer: folds=20
kitkattbp: raises 16595 to 26595 and is all-in
akbongu1977: folds=20
GMMK426: folds=20
GetLoose17: calls 16595
*** FLOP *** [4c 7c 8c]
*** TURN *** [4c 7c 8c] [6d]
*** RIVER *** [4c 7c 8c 6d] [9h]
*** SHOW DOWN ***
GetLoose17: shows [Ah Qc] (high card Ace)
kitkattbp: shows [Js 9s] (a pair of Nines)
kitkattbp collected 63690 from pot
*** SUMMARY ***
Total pot 63690 | Rake 0=20
Board [4c 7c 8c 6d 9h]
Seat 1: JJin91 folded before Flop (didn't bet)
Seat 2: GetLoose17 showed [Ah Qc] and lost with high card Ace
Seat 3: E9Polarizer folded before Flop (didn't bet)
Seat 4: kitkattbp (button) showed [Js 9s] and won (63690) with a pair o=
f Nines
Seat 5: akbongu1977 (small blind) folded before Flop
Seat 6: GMMK426 (big blind) folded before Flop
Seat 7: fingers911 folded before Flop (didn't bet)
Seat 8: apoch19 folded before Flop (didn't bet)
Seat 9: helzkitchen folded before Flop (didn't bet)


*********** # 246 **************
PokerStars Hand #172152626924: Tournament #1648990476, $18.20+$1.80 USD=
 Hold'em No Limit - Level XXII (2000/4000) - 2017/07/06 22:54:17 ET
Table '1648990476 7' 9-max Seat #5 is the button
Seat 1: JJin91 (73494 in chips)=20
Seat 2: GetLoose17 (65855 in chips)=20
Seat 3: E9Polarizer (61096 in chips)=20
Seat 4: kitkattbp (63690 in chips)=20
Seat 5: akbongu1977 (36559 in chips)=20
Seat 6: GMMK426 (186882 in chips)=20
Seat 7: fingers911 (16354 in chips)=20
Seat 8: apoch19 (114839 in chips)=20
Seat 9: helzkitchen (49352 in chips)=20
JJin91: posts the ante 500
GetLoose17: posts the ante 500
E9Polarizer: posts the ante 500
kitkattbp: posts the ante 500
akbongu1977: posts the ante 500
GMMK426: posts the ante 500
fingers911: posts the ante 500
apoch19: posts the ante 500
helzkitchen: posts the ante 500
GMMK426: posts small blind 2000
fingers911: posts big blind 4000
*** HOLE CARDS ***
Dealt to JJin91 [4h 4s]
apoch19: folds=20
helzkitchen: raises 44852 to 48852 and is all-in
JJin91: folds=20
GetLoose17: folds=20
E9Polarizer: folds=20
kitkattbp: folds=20
akbongu1977: folds=20
GMMK426: folds=20
fingers911: calls 11854 and is all-in
Uncalled bet (32998) returned to helzkitchen
*** FLOP *** [6h Kc Jc]
*** TURN *** [6h Kc Jc] [3s]
*** RIVER *** [6h Kc Jc 3s] [3c]
*** SHOW DOWN ***
fingers911: shows [7s As] (a pair of Threes)
helzkitchen: shows [Ah Qd] (a pair of Threes - Ace+King+Queen kicker)
helzkitchen collected 38208 from pot
fingers911 finished the tournament in 17th place and received $30.71.
*** SUMMARY ***
Total pot 38208 | Rake 0=20
Board [6h Kc Jc 3s 3c]
Seat 1: JJin91 folded before Flop (didn't bet)
Seat 2: GetLoose17 folded before Flop (didn't bet)
Seat 3: E9Polarizer folded before Flop (didn't bet)
Seat 4: kitkattbp folded before Flop (didn't bet)
Seat 5: akbongu1977 (button) folded before Flop (didn't bet)
Seat 6: GMMK426 (small blind) folded before Flop
Seat 7: fingers911 (big blind) showed [7s As] and lost with a pair of T=
hrees
Seat 8: apoch19 folded before Flop (didn't bet)
Seat 9: helzkitchen showed [Ah Qd] and won (38208) with a pair of Threes


*********** # 247 **************
PokerStars Hand #172152627043: Tournament #1648990476, $18.20+$1.80 USD=
 Hold'em No Limit - Level XXII (2000/4000) - 2017/07/06 22:54:42 ET
Table '1648990476 7' 9-max Seat #6 is the button
Seat 1: JJin91 (72994 in chips)=20
Seat 2: GetLoose17 (65355 in chips)=20
Seat 3: E9Polarizer (60596 in chips)=20
Seat 4: kitkattbp (63190 in chips)=20
Seat 5: akbongu1977 (36059 in chips)=20
Seat 6: GMMK426 (184382 in chips)=20
Seat 8: apoch19 (114339 in chips)=20
Seat 9: helzkitchen (71206 in chips)=20
JJin91: posts the ante 500
GetLoose17: posts the ante 500
E9Polarizer: posts the ante 500
kitkattbp: posts the ante 500
akbongu1977: posts the ante 500
GMMK426: posts the ante 500
apoch19: posts the ante 500
helzkitchen: posts the ante 500
apoch19: posts small blind 2000
helzkitchen: posts big blind 4000
*** HOLE CARDS ***
Dealt to JJin91 [Ad 8d]
JJin91: raises 4440 to 8440
GetLoose17: folds=20
E9Polarizer: folds=20
kitkattbp: folds=20
akbongu1977: folds=20
GMMK426: folds=20
apoch19: folds=20
helzkitchen: folds=20
Uncalled bet (4440) returned to JJin91
JJin91 collected 14000 from pot
JJin91: doesn't show hand=20
*** SUMMARY ***
Total pot 14000 | Rake 0=20
Seat 1: JJin91 collected (14000)
Seat 2: GetLoose17 folded before Flop (didn't bet)
Seat 3: E9Polarizer folded before Flop (didn't bet)
Seat 4: kitkattbp folded before Flop (didn't bet)
Seat 5: akbongu1977 folded before Flop (didn't bet)
Seat 6: GMMK426 (button) folded before Flop (didn't bet)
Seat 8: apoch19 (small blind) folded before Flop
Seat 9: helzkitchen (big blind) folded before Flop


*********** # 248 **************
PokerStars Hand #172152627129: Tournament #1648990476, $18.20+$1.80 USD=
 Hold'em No Limit - Level XXII (2000/4000) - 2017/07/06 22:55:03 ET
Table '1648990476 7' 9-max Seat #8 is the button
Seat 1: JJin91 (82494 in chips)=20
Seat 2: GetLoose17 (64855 in chips)=20
Seat 3: E9Polarizer (60096 in chips)=20
Seat 4: kitkattbp (62690 in chips)=20
Seat 5: akbongu1977 (35559 in chips)=20
Seat 6: GMMK426 (183882 in chips)=20
Seat 8: apoch19 (111839 in chips)=20
Seat 9: helzkitchen (66706 in chips)=20
JJin91: posts the ante 500
GetLoose17: posts the ante 500
E9Polarizer: posts the ante 500
kitkattbp: posts the ante 500
akbongu1977: posts the ante 500
GMMK426: posts the ante 500
apoch19: posts the ante 500
helzkitchen: posts the ante 500
helzkitchen: posts small blind 2000
JJin91: posts big blind 4000
*** HOLE CARDS ***
Dealt to JJin91 [3h Qd]
GetLoose17: folds=20
E9Polarizer: folds=20
kitkattbp: calls 4000
akbongu1977: folds=20
GMMK426: calls 4000
apoch19: folds=20
helzkitchen: folds=20
JJin91: checks=20
*** FLOP *** [5d Qh 5c]
JJin91: bets 5940
kitkattbp: raises 5940 to 11880
GMMK426: folds=20
JJin91: calls 5940
*** TURN *** [5d Qh 5c] [2s]
JJin91: checks=20
kitkattbp: bets 46310 and is all-in
JJin91: folds=20
Uncalled bet (46310) returned to kitkattbp
kitkattbp collected 41760 from pot
kitkattbp: doesn't show hand=20
*** SUMMARY ***
Total pot 41760 | Rake 0=20
Board [5d Qh 5c 2s]
Seat 1: JJin91 (big blind) folded on the Turn
Seat 2: GetLoose17 folded before Flop (didn't bet)
Seat 3: E9Polarizer folded before Flop (didn't bet)
Seat 4: kitkattbp collected (41760)
Seat 5: akbongu1977 folded before Flop (didn't bet)
Seat 6: GMMK426 folded on the Flop
Seat 8: apoch19 (button) folded before Flop (didn't bet)
Seat 9: helzkitchen (small blind) folded before Flop


*********** # 249 **************
PokerStars Hand #172152628439: Tournament #1648990476, $18.20+$1.80 USD=
 Hold'em No Limit - Level XXII (2000/4000) - 2017/07/06 23:01:11 ET
Table '1648990476 7' 9-max Seat #9 is the button
Seat 1: JJin91 (66114 in chips)=20
Seat 2: GetLoose17 (64355 in chips)=20
Seat 3: E9Polarizer (59596 in chips)=20
Seat 4: kitkattbp (88070 in chips)=20
Seat 5: akbongu1977 (35059 in chips)=20
Seat 6: GMMK426 (179382 in chips)=20
Seat 8: apoch19 (111339 in chips)=20
Seat 9: helzkitchen (64206 in chips)=20
JJin91: posts the ante 500
GetLoose17: posts the ante 500
E9Polarizer: posts the ante 500
kitkattbp: posts the ante 500
akbongu1977: posts the ante 500
GMMK426: posts the ante 500
apoch19: posts the ante 500
helzkitchen: posts the ante 500
JJin91: posts small blind 2000
GetLoose17: posts big blind 4000
*** HOLE CARDS ***
Dealt to JJin91 [8c 6c]
E9Polarizer: raises 4000 to 8000
kitkattbp: folds=20
akbongu1977: folds=20
GMMK426: folds=20
apoch19: folds=20
helzkitchen: folds=20
JJin91: folds=20
GetLoose17: folds=20
Uncalled bet (4000) returned to E9Polarizer
E9Polarizer collected 14000 from pot
E9Polarizer: doesn't show hand=20
*** SUMMARY ***
Total pot 14000 | Rake 0=20
Seat 1: JJin91 (small blind) folded before Flop
Seat 2: GetLoose17 (big blind) folded before Flop
Seat 3: E9Polarizer collected (14000)
Seat 4: kitkattbp folded before Flop (didn't bet)
Seat 5: akbongu1977 folded before Flop (didn't bet)
Seat 6: GMMK426 folded before Flop (didn't bet)
Seat 8: apoch19 folded before Flop (didn't bet)
Seat 9: helzkitchen (button) folded before Flop (didn't bet)


*********** # 250 **************
PokerStars Hand #172152628571: Tournament #1648990476, $18.20+$1.80 USD=
 Hold'em No Limit - Level XXII (2000/4000) - 2017/07/06 23:01:45 ET
Table '1648990476 7' 9-max Seat #1 is the button
Seat 1: JJin91 (63614 in chips)=20
Seat 2: GetLoose17 (59855 in chips)=20
Seat 3: E9Polarizer (69096 in chips)=20
Seat 4: kitkattbp (87570 in chips)=20
Seat 5: akbongu1977 (34559 in chips)=20
Seat 6: GMMK426 (178882 in chips)=20
Seat 8: apoch19 (110839 in chips)=20
Seat 9: helzkitchen (63706 in chips)=20
JJin91: posts the ante 500
GetLoose17: posts the ante 500
E9Polarizer: posts the ante 500
kitkattbp: posts the ante 500
akbongu1977: posts the ante 500
GMMK426: posts the ante 500
apoch19: posts the ante 500
helzkitchen: posts the ante 500
GetLoose17: posts small blind 2000
E9Polarizer: posts big blind 4000
*** HOLE CARDS ***
Dealt to JJin91 [4h 7d]
kitkattbp: folds=20
akbongu1977: folds=20
GMMK426: folds=20
apoch19: folds=20
helzkitchen: raises 59206 to 63206 and is all-in
JJin91: folds=20
GetLoose17: folds=20
E9Polarizer: folds=20
Uncalled bet (59206) returned to helzkitchen
helzkitchen collected 14000 from pot
helzkitchen: doesn't show hand=20
*** SUMMARY ***
Total pot 14000 | Rake 0=20
Seat 1: JJin91 (button) folded before Flop (didn't bet)
Seat 2: GetLoose17 (small blind) folded before Flop
Seat 3: E9Polarizer (big blind) folded before Flop
Seat 4: kitkattbp folded before Flop (didn't bet)
Seat 5: akbongu1977 folded before Flop (didn't bet)
Seat 6: GMMK426 folded before Flop (didn't bet)
Seat 8: apoch19 folded before Flop (didn't bet)
Seat 9: helzkitchen collected (14000)


*********** # 251 **************
PokerStars Hand #172152628700: Tournament #1648990476, $18.20+$1.80 USD=
 Hold'em No Limit - Level XXII (2000/4000) - 2017/07/06 23:02:16 ET
Table '1648990476 7' 9-max Seat #2 is the button
Seat 1: JJin91 (63114 in chips)=20
Seat 2: GetLoose17 (57355 in chips)=20
Seat 3: E9Polarizer (64596 in chips)=20
Seat 4: kitkattbp (87070 in chips)=20
Seat 5: akbongu1977 (34059 in chips)=20
Seat 6: GMMK426 (178382 in chips)=20
Seat 8: apoch19 (110339 in chips)=20
Seat 9: helzkitchen (73206 in chips)=20
JJin91: posts the ante 500
GetLoose17: posts the ante 500
E9Polarizer: posts the ante 500
kitkattbp: posts the ante 500
akbongu1977: posts the ante 500
GMMK426: posts the ante 500
apoch19: posts the ante 500
helzkitchen: posts the ante 500
E9Polarizer: posts small blind 2000
kitkattbp: posts big blind 4000
*** HOLE CARDS ***
Dealt to JJin91 [Qs 4d]
akbongu1977: folds=20
GMMK426: folds=20
apoch19: raises 5520 to 9520
helzkitchen: folds=20
JJin91: folds=20
GetLoose17: folds=20
E9Polarizer: folds=20
kitkattbp: folds=20
Uncalled bet (5520) returned to apoch19
apoch19 collected 14000 from pot
apoch19: doesn't show hand=20
*** SUMMARY ***
Total pot 14000 | Rake 0=20
Seat 1: JJin91 folded before Flop (didn't bet)
Seat 2: GetLoose17 (button) folded before Flop (didn't bet)
Seat 3: E9Polarizer (small blind) folded before Flop
Seat 4: kitkattbp (big blind) folded before Flop
Seat 5: akbongu1977 folded before Flop (didn't bet)
Seat 6: GMMK426 folded before Flop (didn't bet)
Seat 8: apoch19 collected (14000)
Seat 9: helzkitchen folded before Flop (didn't bet)


*********** # 252 **************
PokerStars Hand #172152628810: Tournament #1648990476, $18.20+$1.80 USD=
 Hold'em No Limit - Level XXII (2000/4000) - 2017/07/06 23:02:42 ET
Table '1648990476 7' 9-max Seat #3 is the button
Seat 1: JJin91 (62614 in chips)=20
Seat 2: GetLoose17 (56855 in chips)=20
Seat 3: E9Polarizer (62096 in chips)=20
Seat 4: kitkattbp (82570 in chips)=20
Seat 5: akbongu1977 (33559 in chips)=20
Seat 6: GMMK426 (177882 in chips)=20
Seat 8: apoch19 (119839 in chips)=20
Seat 9: helzkitchen (72706 in chips)=20
JJin91: posts the ante 500
GetLoose17: posts the ante 500
E9Polarizer: posts the ante 500
kitkattbp: posts the ante 500
akbongu1977: posts the ante 500
GMMK426: posts the ante 500
apoch19: posts the ante 500
helzkitchen: posts the ante 500
kitkattbp: posts small blind 2000
akbongu1977: posts big blind 4000
*** HOLE CARDS ***
Dealt to JJin91 [5c 9c]
GMMK426: folds=20
apoch19: folds=20
helzkitchen: folds=20
JJin91: folds=20
GetLoose17: folds=20
E9Polarizer: folds=20
kitkattbp: calls 2000
akbongu1977: checks=20
*** FLOP *** [6c Kc 8c]
kitkattbp: checks=20
akbongu1977: checks=20
*** TURN *** [6c Kc 8c] [Th]
kitkattbp: bets 12000
akbongu1977: folds=20
Uncalled bet (12000) returned to kitkattbp
kitkattbp collected 12000 from pot
kitkattbp: doesn't show hand=20
*** SUMMARY ***
Total pot 12000 | Rake 0=20
Board [6c Kc 8c Th]
Seat 1: JJin91 folded before Flop (didn't bet)
Seat 2: GetLoose17 folded before Flop (didn't bet)
Seat 3: E9Polarizer (button) folded before Flop (didn't bet)
Seat 4: kitkattbp (small blind) collected (12000)
Seat 5: akbongu1977 (big blind) folded on the Turn
Seat 6: GMMK426 folded before Flop (didn't bet)
Seat 8: apoch19 folded before Flop (didn't bet)
Seat 9: helzkitchen folded before Flop (didn't bet)


*********** # 253 **************
PokerStars Hand #172152629028: Tournament #1648990476, $18.20+$1.80 USD=
 Hold'em No Limit - Level XXIII (2500/5000) - 2017/07/06 23:03:33 ET
Table '1648990476 7' 9-max Seat #4 is the button
Seat 1: JJin91 (62114 in chips)=20
Seat 2: GetLoose17 (56355 in chips)=20
Seat 3: E9Polarizer (61596 in chips)=20
Seat 4: kitkattbp (90070 in chips)=20
Seat 5: akbongu1977 (29059 in chips)=20
Seat 6: GMMK426 (177382 in chips)=20
Seat 8: apoch19 (119339 in chips)=20
Seat 9: helzkitchen (72206 in chips)=20
JJin91: posts the ante 625
GetLoose17: posts the ante 625
E9Polarizer: posts the ante 625
kitkattbp: posts the ante 625
akbongu1977: posts the ante 625
GMMK426: posts the ante 625
apoch19: posts the ante 625
helzkitchen: posts the ante 625
akbongu1977: posts small blind 2500
GMMK426: posts big blind 5000
*** HOLE CARDS ***
Dealt to JJin91 [Js 8d]
apoch19: folds=20
helzkitchen: folds=20
JJin91: folds=20
GetLoose17: folds=20
E9Polarizer: raises 55971 to 60971 and is all-in
kitkattbp: folds=20
akbongu1977: folds=20
GMMK426: folds=20
Uncalled bet (55971) returned to E9Polarizer
E9Polarizer collected 17500 from pot
E9Polarizer: doesn't show hand=20
*** SUMMARY ***
Total pot 17500 | Rake 0=20
Seat 1: JJin91 folded before Flop (didn't bet)
Seat 2: GetLoose17 folded before Flop (didn't bet)
Seat 3: E9Polarizer collected (17500)
Seat 4: kitkattbp (button) folded before Flop (didn't bet)
Seat 5: akbongu1977 (small blind) folded before Flop
Seat 6: GMMK426 (big blind) folded before Flop
Seat 8: apoch19 folded before Flop (didn't bet)
Seat 9: helzkitchen folded before Flop (didn't bet)


*********** # 254 **************
PokerStars Hand #172152629146: Tournament #1648990476, $18.20+$1.80 USD=
 Hold'em No Limit - Level XXIII (2500/5000) - 2017/07/06 23:03:58 ET
Table '1648990476 7' 9-max Seat #5 is the button
Seat 1: JJin91 (61489 in chips)=20
Seat 2: GetLoose17 (55730 in chips)=20
Seat 3: E9Polarizer (73471 in chips)=20
Seat 4: kitkattbp (89445 in chips)=20
Seat 5: akbongu1977 (25934 in chips)=20
Seat 6: GMMK426 (171757 in chips)=20
Seat 8: apoch19 (118714 in chips)=20
Seat 9: helzkitchen (71581 in chips)=20
JJin91: posts the ante 625
GetLoose17: posts the ante 625
E9Polarizer: posts the ante 625
kitkattbp: posts the ante 625
akbongu1977: posts the ante 625
GMMK426: posts the ante 625
apoch19: posts the ante 625
helzkitchen: posts the ante 625
GMMK426: posts small blind 2500
apoch19: posts big blind 5000
*** HOLE CARDS ***
Dealt to JJin91 [Td 5c]
helzkitchen: folds=20
JJin91: folds=20
GetLoose17: folds=20
E9Polarizer: raises 67846 to 72846 and is all-in
kitkattbp: folds=20
akbongu1977: folds=20
GMMK426: folds=20
apoch19: folds=20
Uncalled bet (67846) returned to E9Polarizer
E9Polarizer collected 17500 from pot
E9Polarizer: doesn't show hand=20
*** SUMMARY ***
Total pot 17500 | Rake 0=20
Seat 1: JJin91 folded before Flop (didn't bet)
Seat 2: GetLoose17 folded before Flop (didn't bet)
Seat 3: E9Polarizer collected (17500)
Seat 4: kitkattbp folded before Flop (didn't bet)
Seat 5: akbongu1977 (button) folded before Flop (didn't bet)
Seat 6: GMMK426 (small blind) folded before Flop
Seat 8: apoch19 (big blind) folded before Flop
Seat 9: helzkitchen folded before Flop (didn't bet)


*********** # 255 **************
PokerStars Hand #172152629211: Tournament #1648990476, $18.20+$1.80 USD=
 Hold'em No Limit - Level XXIII (2500/5000) - 2017/07/06 23:04:16 ET
Table '1648990476 7' 9-max Seat #6 is the button
Seat 1: JJin91 (60864 in chips)=20
Seat 2: GetLoose17 (55105 in chips)=20
Seat 3: E9Polarizer (85346 in chips)=20
Seat 4: kitkattbp (88820 in chips)=20
Seat 5: akbongu1977 (25309 in chips)=20
Seat 6: GMMK426 (168632 in chips)=20
Seat 8: apoch19 (113089 in chips)=20
Seat 9: helzkitchen (70956 in chips)=20
JJin91: posts the ante 625
GetLoose17: posts the ante 625
E9Polarizer: posts the ante 625
kitkattbp: posts the ante 625
akbongu1977: posts the ante 625
GMMK426: posts the ante 625
apoch19: posts the ante 625
helzkitchen: posts the ante 625
apoch19: posts small blind 2500
helzkitchen: posts big blind 5000
*** HOLE CARDS ***
Dealt to JJin91 [2s 7c]
JJin91: folds=20
kitkattbp said, "is anyone else hearing music"
GetLoose17: folds=20
E9Polarizer: raises 5000 to 10000
kitkattbp: folds=20
akbongu1977: folds=20
GMMK426: calls 10000
apoch19: folds=20
helzkitchen: calls 5000
*** FLOP *** [2c 6h 6c]
helzkitchen: checks=20
E9Polarizer: bets 15000
GMMK426: folds=20
helzkitchen: folds=20
Uncalled bet (15000) returned to E9Polarizer
E9Polarizer collected 37500 from pot
E9Polarizer: doesn't show hand=20
*** SUMMARY ***
Total pot 37500 | Rake 0=20
Board [2c 6h 6c]
Seat 1: JJin91 folded before Flop (didn't bet)
Seat 2: GetLoose17 folded before Flop (didn't bet)
Seat 3: E9Polarizer collected (37500)
Seat 4: kitkattbp folded before Flop (didn't bet)
Seat 5: akbongu1977 folded before Flop (didn't bet)
Seat 6: GMMK426 (button) folded on the Flop
Seat 8: apoch19 (small blind) folded before Flop
Seat 9: helzkitchen (big blind) folded on the Flop


*********** # 256 **************
PokerStars Hand #172152629378: Tournament #1648990476, $18.20+$1.80 USD=
 Hold'em No Limit - Level XXIII (2500/5000) - 2017/07/06 23:04:54 ET
Table '1648990476 7' 9-max Seat #8 is the button
Seat 1: JJin91 (60239 in chips)=20
Seat 2: GetLoose17 (54480 in chips)=20
Seat 3: E9Polarizer (112221 in chips)=20
Seat 4: kitkattbp (88195 in chips)=20
Seat 5: akbongu1977 (24684 in chips)=20
Seat 6: GMMK426 (158007 in chips)=20
Seat 8: apoch19 (109964 in chips)=20
Seat 9: helzkitchen (60331 in chips)=20
JJin91: posts the ante 625
GetLoose17: posts the ante 625
E9Polarizer: posts the ante 625
kitkattbp: posts the ante 625
akbongu1977: posts the ante 625
GMMK426: posts the ante 625
apoch19: posts the ante 625
helzkitchen: posts the ante 625
helzkitchen: posts small blind 2500
JJin91: posts big blind 5000
*** HOLE CARDS ***
Dealt to JJin91 [3c 9s]
helzkitchen said, "no"
GetLoose17: folds=20
E9Polarizer: folds=20
kitkattbp: raises 17500 to 22500
akbongu1977: folds=20
GMMK426: folds=20
apoch19: folds=20
helzkitchen: folds=20
JJin91: folds=20
Uncalled bet (17500) returned to kitkattbp
kitkattbp collected 17500 from pot
kitkattbp: doesn't show hand=20
*** SUMMARY ***
Total pot 17500 | Rake 0=20
Seat 1: JJin91 (big blind) folded before Flop
Seat 2: GetLoose17 folded before Flop (didn't bet)
Seat 3: E9Polarizer folded before Flop (didn't bet)
Seat 4: kitkattbp collected (17500)
Seat 5: akbongu1977 folded before Flop (didn't bet)
Seat 6: GMMK426 folded before Flop (didn't bet)
Seat 8: apoch19 (button) folded before Flop (didn't bet)
Seat 9: helzkitchen (small blind) folded before Flop


*********** # 257 **************
PokerStars Hand #172152629543: Tournament #1648990476, $18.20+$1.80 USD=
 Hold'em No Limit - Level XXIII (2500/5000) - 2017/07/06 23:05:27 ET
Table '1648990476 7' 9-max Seat #9 is the button
Seat 1: JJin91 (54614 in chips)=20
Seat 2: GetLoose17 (53855 in chips)=20
Seat 3: E9Polarizer (111596 in chips)=20
Seat 4: kitkattbp (100070 in chips)=20
Seat 5: akbongu1977 (24059 in chips)=20
Seat 6: GMMK426 (157382 in chips)=20
Seat 8: apoch19 (109339 in chips)=20
Seat 9: helzkitchen (57206 in chips)=20
JJin91: posts the ante 625
GetLoose17: posts the ante 625
E9Polarizer: posts the ante 625
kitkattbp: posts the ante 625
akbongu1977: posts the ante 625
GMMK426: posts the ante 625
apoch19: posts the ante 625
helzkitchen: posts the ante 625
JJin91: posts small blind 2500
GetLoose17: posts big blind 5000
*** HOLE CARDS ***
Dealt to JJin91 [Qh 2d]
E9Polarizer: folds=20
kitkattbp: folds=20
akbongu1977: folds=20
GMMK426: folds=20
apoch19: folds=20
helzkitchen: raises 51581 to 56581 and is all-in
JJin91: folds=20
GetLoose17: folds=20
Uncalled bet (51581) returned to helzkitchen
helzkitchen collected 17500 from pot
helzkitchen: doesn't show hand=20
*** SUMMARY ***
Total pot 17500 | Rake 0=20
Seat 1: JJin91 (small blind) folded before Flop
Seat 2: GetLoose17 (big blind) folded before Flop
Seat 3: E9Polarizer folded before Flop (didn't bet)
Seat 4: kitkattbp folded before Flop (didn't bet)
Seat 5: akbongu1977 folded before Flop (didn't bet)
Seat 6: GMMK426 folded before Flop (didn't bet)
Seat 8: apoch19 folded before Flop (didn't bet)
Seat 9: helzkitchen (button) collected (17500)


*********** # 258 **************
PokerStars Hand #172152629659: Tournament #1648990476, $18.20+$1.80 USD=
 Hold'em No Limit - Level XXIII (2500/5000) - 2017/07/06 23:05:53 ET
Table '1648990476 7' 9-max Seat #1 is the button
Seat 1: JJin91 (51489 in chips)=20
Seat 2: GetLoose17 (48230 in chips)=20
Seat 3: E9Polarizer (110971 in chips)=20
Seat 4: kitkattbp (99445 in chips)=20
Seat 5: akbongu1977 (23434 in chips)=20
Seat 6: GMMK426 (156757 in chips)=20
Seat 8: apoch19 (108714 in chips)=20
Seat 9: helzkitchen (69081 in chips)=20
JJin91: posts the ante 625
GetLoose17: posts the ante 625
E9Polarizer: posts the ante 625
kitkattbp: posts the ante 625
akbongu1977: posts the ante 625
GMMK426: posts the ante 625
apoch19: posts the ante 625
helzkitchen: posts the ante 625
GetLoose17: posts small blind 2500
E9Polarizer: posts big blind 5000
*** HOLE CARDS ***
Dealt to JJin91 [4d 5c]
kitkattbp: raises 10000 to 15000
akbongu1977: folds=20
GMMK426: folds=20
apoch19: folds=20
helzkitchen: folds=20
JJin91: folds=20
GetLoose17: folds=20
E9Polarizer: calls 10000
*** FLOP *** [3s 5d 9s]
E9Polarizer: bets 15000
kitkattbp: raises 68820 to 83820 and is all-in
E9Polarizer: folds=20
Uncalled bet (68820) returned to kitkattbp
kitkattbp collected 67500 from pot
kitkattbp: doesn't show hand=20
*** SUMMARY ***
Total pot 67500 | Rake 0=20
Board [3s 5d 9s]
Seat 1: JJin91 (button) folded before Flop (didn't bet)
Seat 2: GetLoose17 (small blind) folded before Flop
Seat 3: E9Polarizer (big blind) folded on the Flop
Seat 4: kitkattbp collected (67500)
Seat 5: akbongu1977 folded before Flop (didn't bet)
Seat 6: GMMK426 folded before Flop (didn't bet)
Seat 8: apoch19 folded before Flop (didn't bet)
Seat 9: helzkitchen folded before Flop (didn't bet)


*********** # 259 **************
PokerStars Hand #172152629880: Tournament #1648990476, $18.20+$1.80 USD=
 Hold'em No Limit - Level XXIII (2500/5000) - 2017/07/06 23:06:45 ET
Table '1648990476 7' 9-max Seat #2 is the button
Seat 1: JJin91 (50864 in chips)=20
Seat 2: GetLoose17 (45105 in chips)=20
Seat 3: E9Polarizer (80346 in chips)=20
Seat 4: kitkattbp (136320 in chips)=20
Seat 5: akbongu1977 (22809 in chips)=20
Seat 6: GMMK426 (156132 in chips)=20
Seat 8: apoch19 (108089 in chips)=20
Seat 9: helzkitchen (68456 in chips)=20
JJin91: posts the ante 625
GetLoose17: posts the ante 625
E9Polarizer: posts the ante 625
kitkattbp: posts the ante 625
akbongu1977: posts the ante 625
GMMK426: posts the ante 625
apoch19: posts the ante 625
helzkitchen: posts the ante 625
E9Polarizer: posts small blind 2500
kitkattbp: posts big blind 5000
*** HOLE CARDS ***
Dealt to JJin91 [Jd 3c]
akbongu1977: folds=20
E9Polarizer said, ":D"
GMMK426: calls 5000
apoch19: folds=20
helzkitchen: folds=20
JJin91: folds=20
GetLoose17: folds=20
E9Polarizer: calls 2500
kitkattbp: checks=20
*** FLOP *** [2d 7c Ah]
E9Polarizer: checks=20
kitkattbp: checks=20
GMMK426: bets 20000
E9Polarizer: folds=20
kitkattbp: folds=20
Uncalled bet (20000) returned to GMMK426
GMMK426 collected 20000 from pot
GMMK426: doesn't show hand=20
*** SUMMARY ***
Total pot 20000 | Rake 0=20
Board [2d 7c Ah]
Seat 1: JJin91 folded before Flop (didn't bet)
Seat 2: GetLoose17 (button) folded before Flop (didn't bet)
Seat 3: E9Polarizer (small blind) folded on the Flop
Seat 4: kitkattbp (big blind) folded on the Flop
Seat 5: akbongu1977 folded before Flop (didn't bet)
Seat 6: GMMK426 collected (20000)
Seat 8: apoch19 folded before Flop (didn't bet)
Seat 9: helzkitchen folded before Flop (didn't bet)


*********** # 260 **************
PokerStars Hand #172154998054: Tournament #1648990476, $18.20+$1.80 USD=
 Hold'em No Limit - Level XXIII (2500/5000) - 2017/07/06 23:07:19 ET
Table '1648990476 7' 9-max Seat #3 is the button
Seat 1: JJin91 (50239 in chips)=20
Seat 2: GetLoose17 (44480 in chips)=20
Seat 3: E9Polarizer (74721 in chips)=20
Seat 4: kitkattbp (130695 in chips)=20
Seat 5: akbongu1977 (22184 in chips)=20
Seat 6: GMMK426 (170507 in chips)=20
Seat 8: apoch19 (107464 in chips)=20
Seat 9: helzkitchen (67831 in chips)=20
JJin91: posts the ante 625
GetLoose17: posts the ante 625
E9Polarizer: posts the ante 625
kitkattbp: posts the ante 625
akbongu1977: posts the ante 625
GMMK426: posts the ante 625
apoch19: posts the ante 625
helzkitchen: posts the ante 625
kitkattbp: posts small blind 2500
akbongu1977: posts big blind 5000
*** HOLE CARDS ***
Dealt to JJin91 [Qs 3h]
GMMK426: folds=20
apoch19: folds=20
helzkitchen: folds=20
JJin91: folds=20
GetLoose17: folds=20
E9Polarizer: folds=20
kitkattbp: calls 2500
akbongu1977: raises 16559 to 21559 and is all-in
kitkattbp: folds=20
Uncalled bet (16559) returned to akbongu1977
akbongu1977 collected 15000 from pot
akbongu1977: doesn't show hand=20
*** SUMMARY ***
Total pot 15000 | Rake 0=20
Seat 1: JJin91 folded before Flop (didn't bet)
Seat 2: GetLoose17 folded before Flop (didn't bet)
Seat 3: E9Polarizer (button) folded before Flop (didn't bet)
Seat 4: kitkattbp (small blind) folded before Flop
Seat 5: akbongu1977 (big blind) collected (15000)
Seat 6: GMMK426 folded before Flop (didn't bet)
Seat 8: apoch19 folded before Flop (didn't bet)
Seat 9: helzkitchen folded before Flop (didn't bet)


*********** # 261 **************
PokerStars Hand #172154998196: Tournament #1648990476, $18.20+$1.80 USD=
 Hold'em No Limit - Level XXIII (2500/5000) - 2017/07/06 23:07:52 ET
Table '1648990476 7' 9-max Seat #4 is the button
Seat 1: JJin91 (49614 in chips)=20
Seat 2: GetLoose17 (43855 in chips)=20
Seat 3: E9Polarizer (74096 in chips)=20
Seat 4: kitkattbp (125070 in chips)=20
Seat 5: akbongu1977 (31559 in chips)=20
Seat 6: GMMK426 (169882 in chips)=20
Seat 8: apoch19 (106839 in chips)=20
Seat 9: helzkitchen (67206 in chips)=20
JJin91: posts the ante 625
GetLoose17: posts the ante 625
E9Polarizer: posts the ante 625
kitkattbp: posts the ante 625
akbongu1977: posts the ante 625
GMMK426: posts the ante 625
apoch19: posts the ante 625
helzkitchen: posts the ante 625
akbongu1977: posts small blind 2500
GMMK426: posts big blind 5000
*** HOLE CARDS ***
Dealt to JJin91 [6d Jd]
apoch19: folds=20
helzkitchen: folds=20
JJin91: folds=20
GetLoose17: raises 38230 to 43230 and is all-in
E9Polarizer: folds=20
kitkattbp: calls 43230
akbongu1977: folds=20
GMMK426: folds=20
*** FLOP *** [2h 5c 4s]
*** TURN *** [2h 5c 4s] [Th]
*** RIVER *** [2h 5c 4s Th] [2s]
*** SHOW DOWN ***
GetLoose17: shows [Ad 4d] (two pair, Fours and Deuces)
kitkattbp: shows [Qc Qs] (two pair, Queens and Deuces)
kitkattbp collected 98960 from pot
GetLoose17 finished the tournament in 15th place and received $36.85.
*** SUMMARY ***
Total pot 98960 | Rake 0=20
Board [2h 5c 4s Th 2s]
Seat 1: JJin91 folded before Flop (didn't bet)
Seat 2: GetLoose17 showed [Ad 4d] and lost with two pair, Fours and Deu=
ces
Seat 3: E9Polarizer folded before Flop (didn't bet)
Seat 4: kitkattbp (button) showed [Qc Qs] and won (98960) with two pair=
, Queens and Deuces
Seat 5: akbongu1977 (small blind) folded before Flop
Seat 6: GMMK426 (big blind) folded before Flop
Seat 8: apoch19 folded before Flop (didn't bet)
Seat 9: helzkitchen folded before Flop (didn't bet)


*********** # 262 **************
PokerStars Hand #172154998336: Tournament #1648990476, $18.20+$1.80 USD=
 Hold'em No Limit - Level XXIII (2500/5000) - 2017/07/06 23:08:19 ET
Table '1648990476 7' 9-max Seat #5 is the button
Seat 1: JJin91 (48989 in chips)=20
Seat 3: E9Polarizer (73471 in chips)=20
Seat 4: kitkattbp (180175 in chips)=20
Seat 5: akbongu1977 (28434 in chips)=20
Seat 6: GMMK426 (164257 in chips)=20
Seat 8: apoch19 (106214 in chips)=20
Seat 9: helzkitchen (66581 in chips)=20
JJin91: posts the ante 625
E9Polarizer: posts the ante 625
kitkattbp: posts the ante 625
akbongu1977: posts the ante 625
GMMK426: posts the ante 625
apoch19: posts the ante 625
helzkitchen: posts the ante 625
GMMK426: posts small blind 2500
apoch19: posts big blind 5000
*** HOLE CARDS ***
Dealt to JJin91 [6c 8s]
helzkitchen: folds=20
JJin91: folds=20
E9Polarizer: raises 67846 to 72846 and is all-in
kitkattbp: folds=20
akbongu1977: folds=20
GMMK426: folds=20
apoch19: folds=20
Uncalled bet (67846) returned to E9Polarizer
E9Polarizer collected 16875 from pot
E9Polarizer: doesn't show hand=20
*** SUMMARY ***
Total pot 16875 | Rake 0=20
Seat 1: JJin91 folded before Flop (didn't bet)
Seat 3: E9Polarizer collected (16875)
Seat 4: kitkattbp folded before Flop (didn't bet)
Seat 5: akbongu1977 (button) folded before Flop (didn't bet)
Seat 6: GMMK426 (small blind) folded before Flop
Seat 8: apoch19 (big blind) folded before Flop
Seat 9: helzkitchen folded before Flop (didn't bet)


*********** # 263 **************
PokerStars Hand #172154998394: Tournament #1648990476, $18.20+$1.80 USD=
 Hold'em No Limit - Level XXIII (2500/5000) - 2017/07/06 23:08:36 ET
Table '1648990476 7' 9-max Seat #6 is the button
Seat 1: JJin91 (48364 in chips)=20
Seat 3: E9Polarizer (84721 in chips)=20
Seat 4: kitkattbp (179550 in chips)=20
Seat 5: akbongu1977 (27809 in chips)=20
Seat 6: GMMK426 (161132 in chips)=20
Seat 8: apoch19 (100589 in chips)=20
Seat 9: helzkitchen (65956 in chips)=20
JJin91: posts the ante 625
E9Polarizer: posts the ante 625
kitkattbp: posts the ante 625
akbongu1977: posts the ante 625
GMMK426: posts the ante 625
apoch19: posts the ante 625
helzkitchen: posts the ante 625
apoch19: posts small blind 2500
helzkitchen: posts big blind 5000
*** HOLE CARDS ***
Dealt to JJin91 [6c 8h]
JJin91: folds=20
E9Polarizer: folds=20
kitkattbp: folds=20
akbongu1977: raises 22184 to 27184 and is all-in
GMMK426: folds=20
apoch19: folds=20
helzkitchen: folds=20
Uncalled bet (22184) returned to akbongu1977
akbongu1977 collected 16875 from pot
akbongu1977: doesn't show hand=20
*** SUMMARY ***
Total pot 16875 | Rake 0=20
Seat 1: JJin91 folded before Flop (didn't bet)
Seat 3: E9Polarizer folded before Flop (didn't bet)
Seat 4: kitkattbp folded before Flop (didn't bet)
Seat 5: akbongu1977 collected (16875)
Seat 6: GMMK426 (button) folded before Flop (didn't bet)
Seat 8: apoch19 (small blind) folded before Flop
Seat 9: helzkitchen (big blind) folded before Flop


*********** # 264 **************
PokerStars Hand #172154998501: Tournament #1648990476, $18.20+$1.80 USD=
 Hold'em No Limit - Level XXIII (2500/5000) - 2017/07/06 23:08:56 ET
Table '1648990476 7' 9-max Seat #8 is the button
Seat 1: JJin91 (47739 in chips)=20
Seat 3: E9Polarizer (84096 in chips)=20
Seat 4: kitkattbp (178925 in chips)=20
Seat 5: akbongu1977 (39059 in chips)=20
Seat 6: GMMK426 (160507 in chips)=20
Seat 8: apoch19 (97464 in chips)=20
Seat 9: helzkitchen (60331 in chips)=20
JJin91: posts the ante 625
E9Polarizer: posts the ante 625
kitkattbp: posts the ante 625
akbongu1977: posts the ante 625
GMMK426: posts the ante 625
apoch19: posts the ante 625
helzkitchen: posts the ante 625
helzkitchen: posts small blind 2500
JJin91: posts big blind 5000
*** HOLE CARDS ***
Dealt to JJin91 [2h As]
E9Polarizer: folds=20
kitkattbp: folds=20
akbongu1977: folds=20
GMMK426: folds=20
apoch19: raises 6500 to 11500
helzkitchen: folds=20
JJin91: raises 35614 to 47114 and is all-in
apoch19: calls 35614
*** FLOP *** [9d 4c Jc]
*** TURN *** [9d 4c Jc] [3c]
*** RIVER *** [9d 4c Jc 3c] [5s]
*** SHOW DOWN ***
JJin91: shows [2h As] (a straight, Ace to Five)
apoch19: shows [Ad 6h] (high card Ace)
JJin91 collected 101103 from pot
*** SUMMARY ***
Total pot 101103 | Rake 0=20
Board [9d 4c Jc 3c 5s]
Seat 1: JJin91 (big blind) showed [2h As] and won (101103) with a strai=
ght, Ace to Five
Seat 3: E9Polarizer folded before Flop (didn't bet)
Seat 4: kitkattbp folded before Flop (didn't bet)
Seat 5: akbongu1977 folded before Flop (didn't bet)
Seat 6: GMMK426 folded before Flop (didn't bet)
Seat 8: apoch19 (button) showed [Ad 6h] and lost with high card Ace
Seat 9: helzkitchen (small blind) folded before Flop


*********** # 265 **************
PokerStars Hand #172154998676: Tournament #1648990476, $18.20+$1.80 USD=
 Hold'em No Limit - Level XXIII (2500/5000) - 2017/07/06 23:09:33 ET
Table '1648990476 7' 9-max Seat #9 is the button
Seat 1: JJin91 (101103 in chips)=20
Seat 3: E9Polarizer (83471 in chips)=20
Seat 4: kitkattbp (178300 in chips)=20
Seat 5: akbongu1977 (38434 in chips)=20
Seat 6: GMMK426 (159882 in chips)=20
Seat 8: apoch19 (49725 in chips)=20
Seat 9: helzkitchen (57206 in chips)=20
JJin91: posts the ante 625
E9Polarizer: posts the ante 625
kitkattbp: posts the ante 625
akbongu1977: posts the ante 625
GMMK426: posts the ante 625
apoch19: posts the ante 625
helzkitchen: posts the ante 625
JJin91: posts small blind 2500
E9Polarizer: posts big blind 5000
*** HOLE CARDS ***
Dealt to JJin91 [Jc 6h]
kitkattbp: folds=20
akbongu1977: folds=20
GMMK426: folds=20
apoch19: folds=20
helzkitchen: raises 51581 to 56581 and is all-in
JJin91: folds=20
E9Polarizer: folds=20
Uncalled bet (51581) returned to helzkitchen
helzkitchen collected 16875 from pot
helzkitchen: doesn't show hand=20
*** SUMMARY ***
Total pot 16875 | Rake 0=20
Seat 1: JJin91 (small blind) folded before Flop
Seat 3: E9Polarizer (big blind) folded before Flop
Seat 4: kitkattbp folded before Flop (didn't bet)
Seat 5: akbongu1977 folded before Flop (didn't bet)
Seat 6: GMMK426 folded before Flop (didn't bet)
Seat 8: apoch19 folded before Flop (didn't bet)
Seat 9: helzkitchen (button) collected (16875)


*********** # 266 **************
PokerStars Hand #172154998819: Tournament #1648990476, $18.20+$1.80 USD=
 Hold'em No Limit - Level XXIII (2500/5000) - 2017/07/06 23:10:08 ET
Table '1648990476 7' 9-max Seat #1 is the button
Seat 1: JJin91 (97978 in chips)=20
Seat 3: E9Polarizer (77846 in chips)=20
Seat 4: kitkattbp (177675 in chips)=20
Seat 5: akbongu1977 (37809 in chips)=20
Seat 6: GMMK426 (159257 in chips)=20
Seat 8: apoch19 (49100 in chips)=20
Seat 9: helzkitchen (68456 in chips)=20
JJin91: posts the ante 625
E9Polarizer: posts the ante 625
kitkattbp: posts the ante 625
akbongu1977: posts the ante 625
GMMK426: posts the ante 625
apoch19: posts the ante 625
helzkitchen: posts the ante 625
E9Polarizer: posts small blind 2500
kitkattbp: posts big blind 5000
*** HOLE CARDS ***
Dealt to JJin91 [8h 9d]
akbongu1977: folds=20
GMMK426: folds=20
apoch19: folds=20
helzkitchen: raises 62831 to 67831 and is all-in
JJin91: folds=20
E9Polarizer: folds=20
kitkattbp: folds=20
Uncalled bet (62831) returned to helzkitchen
helzkitchen collected 16875 from pot
helzkitchen: doesn't show hand=20
*** SUMMARY ***
Total pot 16875 | Rake 0=20
Seat 1: JJin91 (button) folded before Flop (didn't bet)
Seat 3: E9Polarizer (small blind) folded before Flop
Seat 4: kitkattbp (big blind) folded before Flop
Seat 5: akbongu1977 folded before Flop (didn't bet)
Seat 6: GMMK426 folded before Flop (didn't bet)
Seat 8: apoch19 folded before Flop (didn't bet)
Seat 9: helzkitchen collected (16875)


*********** # 267 **************
PokerStars Hand #172154998914: Tournament #1648990476, $18.20+$1.80 USD=
 Hold'em No Limit - Level XXIII (2500/5000) - 2017/07/06 23:10:28 ET
Table '1648990476 7' 9-max Seat #3 is the button
Seat 1: JJin91 (97353 in chips)=20
Seat 3: E9Polarizer (74721 in chips)=20
Seat 4: kitkattbp (172050 in chips)=20
Seat 5: akbongu1977 (37184 in chips)=20
Seat 6: GMMK426 (158632 in chips)=20
Seat 8: apoch19 (48475 in chips)=20
Seat 9: helzkitchen (79706 in chips)=20
JJin91: posts the ante 625
E9Polarizer: posts the ante 625
kitkattbp: posts the ante 625
akbongu1977: posts the ante 625
GMMK426: posts the ante 625
apoch19: posts the ante 625
helzkitchen: posts the ante 625
kitkattbp: posts small blind 2500
akbongu1977: posts big blind 5000
*** HOLE CARDS ***
Dealt to JJin91 [7d Th]
GMMK426: calls 5000
apoch19: folds=20
helzkitchen: folds=20
JJin91: folds=20
E9Polarizer: folds=20
kitkattbp: calls 2500
akbongu1977: checks=20
*** FLOP *** [4h Jc Qs]
kitkattbp: checks=20
akbongu1977: checks=20
GMMK426: bets 19375
kitkattbp: folds=20
akbongu1977: folds=20
Uncalled bet (19375) returned to GMMK426
GMMK426 collected 19375 from pot
GMMK426: doesn't show hand=20
*** SUMMARY ***
Total pot 19375 | Rake 0=20
Board [4h Jc Qs]
Seat 1: JJin91 folded before Flop (didn't bet)
Seat 3: E9Polarizer (button) folded before Flop (didn't bet)
Seat 4: kitkattbp (small blind) folded on the Flop
Seat 5: akbongu1977 (big blind) folded on the Flop
Seat 6: GMMK426 collected (19375)
Seat 8: apoch19 folded before Flop (didn't bet)
Seat 9: helzkitchen folded before Flop (didn't bet)


*********** # 268 **************
PokerStars Hand #172154999107: Tournament #1648990476, $18.20+$1.80 USD=
 Hold'em No Limit - Level XXIII (2500/5000) - 2017/07/06 23:11:08 ET
Table '1648990476 7' 9-max Seat #4 is the button
Seat 1: JJin91 (96728 in chips)=20
Seat 3: E9Polarizer (74096 in chips)=20
Seat 4: kitkattbp (166425 in chips)=20
Seat 5: akbongu1977 (31559 in chips)=20
Seat 6: GMMK426 (172382 in chips)=20
Seat 8: apoch19 (47850 in chips)=20
Seat 9: helzkitchen (79081 in chips)=20
JJin91: posts the ante 625
E9Polarizer: posts the ante 625
kitkattbp: posts the ante 625
akbongu1977: posts the ante 625
GMMK426: posts the ante 625
apoch19: posts the ante 625
helzkitchen: posts the ante 625
akbongu1977: posts small blind 2500
GMMK426: posts big blind 5000
*** HOLE CARDS ***
Dealt to JJin91 [2h Ts]
apoch19: raises 42225 to 47225 and is all-in
helzkitchen: folds=20
JJin91: folds=20
E9Polarizer: folds=20
kitkattbp: folds=20
akbongu1977: folds=20
GMMK426: folds=20
Uncalled bet (42225) returned to apoch19
apoch19 collected 16875 from pot
apoch19: doesn't show hand=20
*** SUMMARY ***
Total pot 16875 | Rake 0=20
Seat 1: JJin91 folded before Flop (didn't bet)
Seat 3: E9Polarizer folded before Flop (didn't bet)
Seat 4: kitkattbp (button) folded before Flop (didn't bet)
Seat 5: akbongu1977 (small blind) folded before Flop
Seat 6: GMMK426 (big blind) folded before Flop
Seat 8: apoch19 collected (16875)
Seat 9: helzkitchen folded before Flop (didn't bet)


*********** # 269 **************
PokerStars Hand #172154999254: Tournament #1648990476, $18.20+$1.80 USD=
 Hold'em No Limit - Level XXIII (2500/5000) - 2017/07/06 23:11:41 ET
Table '1648990476 7' 9-max Seat #5 is the button
Seat 1: JJin91 (96103 in chips)=20
Seat 3: E9Polarizer (73471 in chips)=20
Seat 4: kitkattbp (165800 in chips)=20
Seat 5: akbongu1977 (28434 in chips)=20
Seat 6: GMMK426 (166757 in chips)=20
Seat 8: apoch19 (59100 in chips)=20
Seat 9: helzkitchen (78456 in chips)=20
JJin91: posts the ante 625
E9Polarizer: posts the ante 625
kitkattbp: posts the ante 625
akbongu1977: posts the ante 625
GMMK426: posts the ante 625
apoch19: posts the ante 625
helzkitchen: posts the ante 625
GMMK426: posts small blind 2500
apoch19: posts big blind 5000
*** HOLE CARDS ***
Dealt to JJin91 [2s 6d]
helzkitchen: folds=20
JJin91: folds=20
E9Polarizer: folds=20
kitkattbp: folds=20
akbongu1977: folds=20
GMMK426: calls 2500
apoch19: checks=20
*** FLOP *** [Jd 8c Ks]
GMMK426: checks=20
apoch19: checks=20
*** TURN *** [Jd 8c Ks] [Jh]
GMMK426: bets 10000
apoch19: folds=20
Uncalled bet (10000) returned to GMMK426
GMMK426 collected 14375 from pot
GMMK426: doesn't show hand=20
*** SUMMARY ***
Total pot 14375 | Rake 0=20
Board [Jd 8c Ks Jh]
Seat 1: JJin91 folded before Flop (didn't bet)
Seat 3: E9Polarizer folded before Flop (didn't bet)
Seat 4: kitkattbp folded before Flop (didn't bet)
Seat 5: akbongu1977 (button) folded before Flop (didn't bet)
Seat 6: GMMK426 (small blind) collected (14375)
Seat 8: apoch19 (big blind) folded on the Turn
Seat 9: helzkitchen folded before Flop (didn't bet)


*********** # 270 **************
PokerStars Hand #172154999394: Tournament #1648990476, $18.20+$1.80 USD=
 Hold'em No Limit - Level XXIII (2500/5000) - 2017/07/06 23:12:12 ET
Table '1648990476 7' 9-max Seat #6 is the button
Seat 1: JJin91 (95478 in chips)=20
Seat 3: E9Polarizer (72846 in chips)=20
Seat 4: kitkattbp (165175 in chips)=20
Seat 5: akbongu1977 (27809 in chips)=20
Seat 6: GMMK426 (175507 in chips)=20
Seat 8: apoch19 (53475 in chips)=20
Seat 9: helzkitchen (77831 in chips)=20
JJin91: posts the ante 625
E9Polarizer: posts the ante 625
kitkattbp: posts the ante 625
akbongu1977: posts the ante 625
GMMK426: posts the ante 625
apoch19: posts the ante 625
helzkitchen: posts the ante 625
apoch19: posts small blind 2500
helzkitchen: posts big blind 5000
*** HOLE CARDS ***
Dealt to JJin91 [3c Qc]
JJin91: folds=20
E9Polarizer: raises 5000 to 10000
kitkattbp: calls 10000
akbongu1977: folds=20
GMMK426: calls 10000
apoch19: folds=20
helzkitchen: calls 5000
*** FLOP *** [Ts 8h Kh]
helzkitchen: checks=20
E9Polarizer: bets 62221 and is all-in
kitkattbp: calls 62221
GMMK426: folds=20
helzkitchen: folds=20
*** TURN *** [Ts 8h Kh] [Ad]
*** RIVER *** [Ts 8h Kh Ad] [8c]
*** SHOW DOWN ***
E9Polarizer: shows [Qd Ks] (two pair, Kings and Eights)
kitkattbp: shows [Qh 9h] (a pair of Eights)
E9Polarizer collected 171317 from pot
*** SUMMARY ***
Total pot 171317 | Rake 0=20
Board [Ts 8h Kh Ad 8c]
Seat 1: JJin91 folded before Flop (didn't bet)
Seat 3: E9Polarizer showed [Qd Ks] and won (171317) with two pair, King=
s and Eights
Seat 4: kitkattbp showed [Qh 9h] and lost with a pair of Eights
Seat 5: akbongu1977 folded before Flop (didn't bet)
Seat 6: GMMK426 (button) folded on the Flop
Seat 8: apoch19 (small blind) folded before Flop
Seat 9: helzkitchen (big blind) folded on the Flop


*********** # 271 **************
PokerStars Hand #172154999588: Tournament #1648990476, $18.20+$1.80 USD=
 Hold'em No Limit - Level XXIII (2500/5000) - 2017/07/06 23:12:54 ET
Table '1648990476 7' 9-max Seat #8 is the button
Seat 1: JJin91 (94853 in chips)=20
Seat 3: E9Polarizer (171317 in chips)=20
Seat 4: kitkattbp (92329 in chips)=20
Seat 5: akbongu1977 (27184 in chips)=20
Seat 6: GMMK426 (164882 in chips)=20
Seat 8: apoch19 (50350 in chips)=20
Seat 9: helzkitchen (67206 in chips)=20
JJin91: posts the ante 625
E9Polarizer: posts the ante 625
kitkattbp: posts the ante 625
akbongu1977: posts the ante 625
GMMK426: posts the ante 625
apoch19: posts the ante 625
helzkitchen: posts the ante 625
helzkitchen: posts small blind 2500
JJin91: posts big blind 5000
*** HOLE CARDS ***
Dealt to JJin91 [Qd 5c]
E9Polarizer: folds=20
kitkattbp: folds=20
akbongu1977: folds=20
GMMK426: folds=20
kitkattbp said, "a million outs"
apoch19: folds=20
helzkitchen: folds=20
Uncalled bet (2500) returned to JJin91
JJin91 collected 9375 from pot
JJin91: doesn't show hand=20
*** SUMMARY ***
Total pot 9375 | Rake 0=20
Seat 1: JJin91 (big blind) collected (9375)
Seat 3: E9Polarizer folded before Flop (didn't bet)
Seat 4: kitkattbp folded before Flop (didn't bet)
Seat 5: akbongu1977 folded before Flop (didn't bet)
Seat 6: GMMK426 folded before Flop (didn't bet)
Seat 8: apoch19 (button) folded before Flop (didn't bet)
Seat 9: helzkitchen (small blind) folded before Flop


*********** # 272 **************
PokerStars Hand #172154999721: Tournament #1648990476, $18.20+$1.80 USD=
 Hold'em No Limit - Level XXIV (3000/6000) - 2017/07/06 23:13:21 ET
Table '1648990476 7' 9-max Seat #9 is the button
Seat 1: JJin91 (101103 in chips)=20
Seat 4: kitkattbp (91704 in chips)=20
Seat 5: akbongu1977 (26559 in chips)=20
Seat 6: GMMK426 (164257 in chips)=20
Seat 8: apoch19 (49725 in chips)=20
Seat 9: helzkitchen (64081 in chips)=20
JJin91: posts the ante 750
kitkattbp: posts the ante 750
akbongu1977: posts the ante 750
GMMK426: posts the ante 750
apoch19: posts the ante 750
helzkitchen: posts the ante 750
JJin91: posts small blind 3000
kitkattbp: posts big blind 6000
*** HOLE CARDS ***
Dealt to JJin91 [Ac 2s]
akbongu1977: raises 19809 to 25809 and is all-in
GMMK426: folds=20
apoch19: folds=20
helzkitchen: folds=20
JJin91: raises 74544 to 100353 and is all-in
kitkattbp: folds=20
Uncalled bet (74544) returned to JJin91
*** FLOP *** [5h 4c 7s]
*** TURN *** [5h 4c 7s] [3s]
*** RIVER *** [5h 4c 7s 3s] [4d]
*** SHOW DOWN ***
JJin91: shows [Ac 2s] (a straight, Ace to Five)
akbongu1977: shows [9d Ad] (a pair of Fours)
JJin91 collected 62118 from pot
akbongu1977 finished the tournament in 12th place and received $42.99.
*** SUMMARY ***
Total pot 62118 | Rake 0=20
Board [5h 4c 7s 3s 4d]
Seat 1: JJin91 (small blind) showed [Ac 2s] and won (62118) with a stra=
ight, Ace to Five
Seat 4: kitkattbp (big blind) folded before Flop
Seat 5: akbongu1977 showed [9d Ad] and lost with a pair of Fours
Seat 6: GMMK426 folded before Flop (didn't bet)
Seat 8: apoch19 folded before Flop (didn't bet)
Seat 9: helzkitchen (button) folded before Flop (didn't bet)


*********** # 273 **************
PokerStars Hand #172154999854: Tournament #1648990476, $18.20+$1.80 USD=
 Hold'em No Limit - Level XXIV (3000/6000) - 2017/07/06 23:13:49 ET
Table '1648990476 7' 9-max Seat #1 is the button
Seat 1: JJin91 (136662 in chips)=20
Seat 4: kitkattbp (84954 in chips)=20
Seat 6: GMMK426 (163507 in chips)=20
Seat 8: apoch19 (48975 in chips)=20
Seat 9: helzkitchen (63331 in chips)=20
JJin91: posts the ante 750
kitkattbp: posts the ante 750
GMMK426: posts the ante 750
apoch19: posts the ante 750
helzkitchen: posts the ante 750
kitkattbp: posts small blind 3000
GMMK426: posts big blind 6000
*** HOLE CARDS ***
Dealt to JJin91 [9c Kc]
apoch19: folds=20
JJin91 said, " yo the a2 off tho"
JJin91 said, "g"
JJin91 said, "g"
helzkitchen: folds=20
JJin91: raises 6660 to 12660
kitkattbp: calls 9660
GMMK426: calls 6660
*** FLOP *** [7c Js Kh]
helzkitchen said, ":*"
kitkattbp: checks=20
GMMK426: checks=20
JJin91: bets 20448
kitkattbp: folds=20
GMMK426: folds=20
Uncalled bet (20448) returned to JJin91
JJin91 collected 41730 from pot
JJin91: doesn't show hand=20
*** SUMMARY ***
Total pot 41730 | Rake 0=20
Board [7c Js Kh]
Seat 1: JJin91 (button) collected (41730)
Seat 4: kitkattbp (small blind) folded on the Flop
Seat 6: GMMK426 (big blind) folded on the Flop
Seat 8: apoch19 folded before Flop (didn't bet)
Seat 9: helzkitchen folded before Flop (didn't bet)


*********** # 274 **************
PokerStars Hand #172155546849: Tournament #1648990476, $18.20+$1.80 USD=
 Hold'em No Limit - Level XXIV (3000/6000) - 2017/07/06 23:14:33 ET
Table '1648990476 7' 9-max Seat #4 is the button
Seat 1: JJin91 (164982 in chips)=20
Seat 4: kitkattbp (71544 in chips)=20
Seat 6: GMMK426 (150097 in chips)=20
Seat 8: apoch19 (48225 in chips)=20
Seat 9: helzkitchen (62581 in chips)=20
JJin91: posts the ante 750
kitkattbp: posts the ante 750
GMMK426: posts the ante 750
apoch19: posts the ante 750
helzkitchen: posts the ante 750
GMMK426: posts small blind 3000
apoch19: posts big blind 6000
*** HOLE CARDS ***
Dealt to JJin91 [7h 9s]
helzkitchen: raises 55831 to 61831 and is all-in
JJin91: folds=20
kitkattbp: folds=20
GMMK426: folds=20
apoch19: folds=20
Uncalled bet (55831) returned to helzkitchen
helzkitchen collected 18750 from pot
helzkitchen: doesn't show hand=20
*** SUMMARY ***
Total pot 18750 | Rake 0=20
Seat 1: JJin91 folded before Flop (didn't bet)
Seat 4: kitkattbp (button) folded before Flop (didn't bet)
Seat 6: GMMK426 (small blind) folded before Flop
Seat 8: apoch19 (big blind) folded before Flop
Seat 9: helzkitchen collected (18750)


*********** # 275 **************
PokerStars Hand #172155546953: Tournament #1648990476, $18.20+$1.80 USD=
 Hold'em No Limit - Level XXIV (3000/6000) - 2017/07/06 23:14:55 ET
Table '1648990476 7' 9-max Seat #6 is the button
Seat 1: JJin91 (164232 in chips)=20
Seat 4: kitkattbp (70794 in chips)=20
Seat 6: GMMK426 (146347 in chips)=20
Seat 8: apoch19 (41475 in chips)=20
Seat 9: helzkitchen (74581 in chips)=20
JJin91: posts the ante 750
kitkattbp: posts the ante 750
GMMK426: posts the ante 750
apoch19: posts the ante 750
helzkitchen: posts the ante 750
apoch19: posts small blind 3000
helzkitchen: posts big blind 6000
*** HOLE CARDS ***
Dealt to JJin91 [Th 2d]
JJin91: folds=20
kitkattbp: raises 64044 to 70044 and is all-in
GMMK426: folds=20
apoch19: folds=20
helzkitchen: folds=20
Uncalled bet (64044) returned to kitkattbp
kitkattbp collected 18750 from pot
kitkattbp: doesn't show hand=20
*** SUMMARY ***
Total pot 18750 | Rake 0=20
Seat 1: JJin91 folded before Flop (didn't bet)
Seat 4: kitkattbp collected (18750)
Seat 6: GMMK426 (button) folded before Flop (didn't bet)
Seat 8: apoch19 (small blind) folded before Flop
Seat 9: helzkitchen (big blind) folded before Flop


*********** # 276 **************
PokerStars Hand #172155547050: Tournament #1648990476, $18.20+$1.80 USD=
 Hold'em No Limit - Level XXIV (3000/6000) - 2017/07/06 23:15:15 ET
Table '1648990476 7' 9-max Seat #8 is the button
Seat 1: JJin91 (163482 in chips)=20
Seat 4: kitkattbp (82794 in chips)=20
Seat 6: GMMK426 (145597 in chips)=20
Seat 8: apoch19 (37725 in chips)=20
Seat 9: helzkitchen (67831 in chips)=20
JJin91: posts the ante 750
kitkattbp: posts the ante 750
GMMK426: posts the ante 750
apoch19: posts the ante 750
helzkitchen: posts the ante 750
helzkitchen: posts small blind 3000
JJin91: posts big blind 6000
*** HOLE CARDS ***
Dealt to JJin91 [9s Jd]
kitkattbp: folds=20
GMMK426: folds=20
apoch19: folds=20
helzkitchen: raises 61081 to 67081 and is all-in
JJin91: folds=20
Uncalled bet (61081) returned to helzkitchen
helzkitchen collected 15750 from pot
helzkitchen: doesn't show hand=20
*** SUMMARY ***
Total pot 15750 | Rake 0=20
Seat 1: JJin91 (big blind) folded before Flop
Seat 4: kitkattbp folded before Flop (didn't bet)
Seat 6: GMMK426 folded before Flop (didn't bet)
Seat 8: apoch19 (button) folded before Flop (didn't bet)
Seat 9: helzkitchen (small blind) collected (15750)


*********** # 277 **************
PokerStars Hand #172155547150: Tournament #1648990476, $18.20+$1.80 USD=
 Hold'em No Limit - Level XXIV (3000/6000) - 2017/07/06 23:15:36 ET
Table '1648990476 7' 9-max Seat #9 is the button
Seat 1: JJin91 (156732 in chips)=20
Seat 4: kitkattbp (82044 in chips)=20
Seat 6: GMMK426 (144847 in chips)=20
Seat 8: apoch19 (36975 in chips)=20
Seat 9: helzkitchen (76831 in chips)=20
JJin91: posts the ante 750
kitkattbp: posts the ante 750
GMMK426: posts the ante 750
apoch19: posts the ante 750
helzkitchen: posts the ante 750
JJin91: posts small blind 3000
kitkattbp: posts big blind 6000
*** HOLE CARDS ***
Dealt to JJin91 [8h Qd]
GMMK426: raises 6000 to 12000
apoch19: folds=20
helzkitchen: folds=20
JJin91: folds=20
kitkattbp: folds=20
Uncalled bet (6000) returned to GMMK426
GMMK426 collected 18750 from pot
GMMK426: doesn't show hand=20
*** SUMMARY ***
Total pot 18750 | Rake 0=20
Seat 1: JJin91 (small blind) folded before Flop
Seat 4: kitkattbp (big blind) folded before Flop
Seat 6: GMMK426 collected (18750)
Seat 8: apoch19 folded before Flop (didn't bet)
Seat 9: helzkitchen (button) folded before Flop (didn't bet)


*********** # 278 **************
PokerStars Hand #172155547235: Tournament #1648990476, $18.20+$1.80 USD=
 Hold'em No Limit - Level XXIV (3000/6000) - 2017/07/06 23:15:56 ET
Table '1648990476 7' 9-max Seat #1 is the button
Seat 1: JJin91 (152982 in chips)=20
Seat 4: kitkattbp (75294 in chips)=20
Seat 6: GMMK426 (156847 in chips)=20
Seat 8: apoch19 (36225 in chips)=20
Seat 9: helzkitchen (76081 in chips)=20
JJin91: posts the ante 750
kitkattbp: posts the ante 750
GMMK426: posts the ante 750
apoch19: posts the ante 750
helzkitchen: posts the ante 750
kitkattbp: posts small blind 3000
GMMK426: posts big blind 6000
*** HOLE CARDS ***
Dealt to JJin91 [Kc Ts]
apoch19: folds=20
helzkitchen: folds=20
JJin91: raises 6660 to 12660
kitkattbp: folds=20
GMMK426: folds=20
Uncalled bet (6660) returned to JJin91
JJin91 collected 18750 from pot
JJin91: doesn't show hand=20
*** SUMMARY ***
Total pot 18750 | Rake 0=20
Seat 1: JJin91 (button) collected (18750)
Seat 4: kitkattbp (small blind) folded before Flop
Seat 6: GMMK426 (big blind) folded before Flop
Seat 8: apoch19 folded before Flop (didn't bet)
Seat 9: helzkitchen folded before Flop (didn't bet)


*********** # 279 **************
PokerStars Hand #172155547317: Tournament #1648990476, $18.20+$1.80 USD=
 Hold'em No Limit - Level XXIV (3000/6000) - 2017/07/06 23:16:12 ET
Table '1648990476 7' 9-max Seat #4 is the button
Seat 1: JJin91 (164982 in chips)=20
Seat 4: kitkattbp (71544 in chips)=20
Seat 6: GMMK426 (150097 in chips)=20
Seat 8: apoch19 (35475 in chips)=20
Seat 9: helzkitchen (75331 in chips)=20
JJin91: posts the ante 750
kitkattbp: posts the ante 750
GMMK426: posts the ante 750
apoch19: posts the ante 750
helzkitchen: posts the ante 750
GMMK426: posts small blind 3000
apoch19: posts big blind 6000
*** HOLE CARDS ***
Dealt to JJin91 [4s 6h]
helzkitchen: folds=20
JJin91: folds=20
kitkattbp: folds=20
GMMK426: raises 143347 to 149347 and is all-in
apoch19: folds=20
Uncalled bet (143347) returned to GMMK426
GMMK426 collected 15750 from pot
GMMK426: doesn't show hand=20
*** SUMMARY ***
Total pot 15750 | Rake 0=20
Seat 1: JJin91 folded before Flop (didn't bet)
Seat 4: kitkattbp (button) folded before Flop (didn't bet)
Seat 6: GMMK426 (small blind) collected (15750)
Seat 8: apoch19 (big blind) folded before Flop
Seat 9: helzkitchen folded before Flop (didn't bet)


*********** # 280 **************
PokerStars Hand #172155547394: Tournament #1648990476, $18.20+$1.80 USD=
 Hold'em No Limit - Level XXIV (3000/6000) - 2017/07/06 23:16:29 ET
Table '1648990476 7' 9-max Seat #6 is the button
Seat 1: JJin91 (164232 in chips)=20
Seat 4: kitkattbp (70794 in chips)=20
Seat 6: GMMK426 (159097 in chips)=20
Seat 8: apoch19 (28725 in chips)=20
Seat 9: helzkitchen (74581 in chips)=20
JJin91: posts the ante 750
kitkattbp: posts the ante 750
GMMK426: posts the ante 750
apoch19: posts the ante 750
helzkitchen: posts the ante 750
apoch19: posts small blind 3000
helzkitchen: posts big blind 6000
*** HOLE CARDS ***
Dealt to JJin91 [Ks 9c]
JJin91: raises 6660 to 12660
kitkattbp: folds=20
GMMK426: folds=20
apoch19: folds=20
helzkitchen: folds=20
Uncalled bet (6660) returned to JJin91
JJin91 collected 18750 from pot
JJin91: doesn't show hand=20
*** SUMMARY ***
Total pot 18750 | Rake 0=20
Seat 1: JJin91 collected (18750)
Seat 4: kitkattbp folded before Flop (didn't bet)
Seat 6: GMMK426 (button) folded before Flop (didn't bet)
Seat 8: apoch19 (small blind) folded before Flop
Seat 9: helzkitchen (big blind) folded before Flop


*********** # 281 **************
PokerStars Hand #172155547533: Tournament #1648990476, $18.20+$1.80 USD=
 Hold'em No Limit - Level XXIV (3000/6000) - 2017/07/06 23:16:59 ET
Table '1648990476 7' 9-max Seat #8 is the button
Seat 1: JJin91 (176232 in chips)=20
Seat 4: kitkattbp (70044 in chips)=20
Seat 6: GMMK426 (158347 in chips)=20
Seat 8: apoch19 (24975 in chips)=20
Seat 9: helzkitchen (67831 in chips)=20
JJin91: posts the ante 750
kitkattbp: posts the ante 750
GMMK426: posts the ante 750
apoch19: posts the ante 750
helzkitchen: posts the ante 750
helzkitchen: posts small blind 3000
JJin91: posts big blind 6000
*** HOLE CARDS ***
Dealt to JJin91 [2d 8s]
kitkattbp: folds=20
GMMK426: folds=20
apoch19: folds=20
helzkitchen: folds=20
Uncalled bet (3000) returned to JJin91
JJin91 collected 9750 from pot
JJin91: doesn't show hand=20
*** SUMMARY ***
Total pot 9750 | Rake 0=20
Seat 1: JJin91 (big blind) collected (9750)
Seat 4: kitkattbp folded before Flop (didn't bet)
Seat 6: GMMK426 folded before Flop (didn't bet)
Seat 8: apoch19 (button) folded before Flop (didn't bet)
Seat 9: helzkitchen (small blind) folded before Flop


*********** # 282 **************
PokerStars Hand #172155547577: Tournament #1648990476, $18.20+$1.80 USD=
 Hold'em No Limit - Level XXIV (3000/6000) - 2017/07/06 23:17:10 ET
Table '1648990476 7' 9-max Seat #9 is the button
Seat 1: JJin91 (182232 in chips)=20
Seat 4: kitkattbp (69294 in chips)=20
Seat 6: GMMK426 (157597 in chips)=20
Seat 8: apoch19 (24225 in chips)=20
Seat 9: helzkitchen (64081 in chips)=20
JJin91: posts the ante 750
kitkattbp: posts the ante 750
GMMK426: posts the ante 750
apoch19: posts the ante 750
helzkitchen: posts the ante 750
JJin91: posts small blind 3000
kitkattbp: posts big blind 6000
*** HOLE CARDS ***
Dealt to JJin91 [6s 5h]
GMMK426: folds=20
apoch19: folds=20
helzkitchen: raises 57331 to 63331 and is all-in
JJin91: folds=20
kitkattbp: folds=20
Uncalled bet (57331) returned to helzkitchen
helzkitchen collected 18750 from pot
helzkitchen: doesn't show hand=20
*** SUMMARY ***
Total pot 18750 | Rake 0=20
Seat 1: JJin91 (small blind) folded before Flop
Seat 4: kitkattbp (big blind) folded before Flop
Seat 6: GMMK426 folded before Flop (didn't bet)
Seat 8: apoch19 folded before Flop (didn't bet)
Seat 9: helzkitchen (button) collected (18750)


*********** # 283 **************
PokerStars Hand #172155547715: Tournament #1648990476, $18.20+$1.80 USD=
 Hold'em No Limit - Level XXIV (3000/6000) - 2017/07/06 23:17:38 ET
Table '1648990476 7' 9-max Seat #1 is the button
Seat 1: JJin91 (178482 in chips)=20
Seat 4: kitkattbp (62544 in chips)=20
Seat 6: GMMK426 (156847 in chips)=20
Seat 8: apoch19 (23475 in chips)=20
Seat 9: helzkitchen (76081 in chips)=20
JJin91: posts the ante 750
kitkattbp: posts the ante 750
GMMK426: posts the ante 750
apoch19: posts the ante 750
helzkitchen: posts the ante 750
kitkattbp: posts small blind 3000
GMMK426: posts big blind 6000
*** HOLE CARDS ***
Dealt to JJin91 [3c 2c]
apoch19: folds=20
helzkitchen: folds=20
JJin91: raises 6660 to 12660
kitkattbp: folds=20
GMMK426: folds=20
Uncalled bet (6660) returned to JJin91
JJin91 collected 18750 from pot
JJin91: doesn't show hand=20
*** SUMMARY ***
Total pot 18750 | Rake 0=20
Seat 1: JJin91 (button) collected (18750)
Seat 4: kitkattbp (small blind) folded before Flop
Seat 6: GMMK426 (big blind) folded before Flop
Seat 8: apoch19 folded before Flop (didn't bet)
Seat 9: helzkitchen folded before Flop (didn't bet)


*********** # 284 **************
PokerStars Hand #172155547806: Tournament #1648990476, $18.20+$1.80 USD=
 Hold'em No Limit - Level XXIV (3000/6000) - 2017/07/06 23:17:59 ET
Table '1648990476 7' 9-max Seat #4 is the button
Seat 1: JJin91 (190482 in chips)=20
Seat 4: kitkattbp (58794 in chips)=20
Seat 6: GMMK426 (150097 in chips)=20
Seat 8: apoch19 (22725 in chips)=20
Seat 9: helzkitchen (75331 in chips)=20
JJin91: posts the ante 750
kitkattbp: posts the ante 750
GMMK426: posts the ante 750
apoch19: posts the ante 750
helzkitchen: posts the ante 750
GMMK426: posts small blind 3000
apoch19: posts big blind 6000
*** HOLE CARDS ***
Dealt to JJin91 [9c Ac]
helzkitchen: raises 68581 to 74581 and is all-in
JJin91: calls 74581
kitkattbp: folds=20
GMMK426: folds=20
apoch19: folds=20
*** FLOP *** [Qc 2h Ad]
*** TURN *** [Qc 2h Ad] [2s]
*** RIVER *** [Qc 2h Ad 2s] [7s]
*** SHOW DOWN ***
helzkitchen: shows [Ah Kc] (two pair, Aces and Deuces)
JJin91: shows [9c Ac] (two pair, Aces and Deuces - lower kicker)
helzkitchen collected 161912 from pot
*** SUMMARY ***
Total pot 161912 | Rake 0=20
Board [Qc 2h Ad 2s 7s]
Seat 1: JJin91 showed [9c Ac] and lost with two pair, Aces and Deuces
Seat 4: kitkattbp (button) folded before Flop (didn't bet)
Seat 6: GMMK426 (small blind) folded before Flop
Seat 8: apoch19 (big blind) folded before Flop
Seat 9: helzkitchen showed [Ah Kc] and won (161912) with two pair, Aces=
 and Deuces


*********** # 285 **************
PokerStars Hand #172155547917: Tournament #1648990476, $18.20+$1.80 USD=
 Hold'em No Limit - Level XXIV (3000/6000) - 2017/07/06 23:18:21 ET
Table '1648990476 7' 9-max Seat #6 is the button
Seat 1: JJin91 (115151 in chips)=20
Seat 4: kitkattbp (58044 in chips)=20
Seat 6: GMMK426 (146347 in chips)=20
Seat 8: apoch19 (15975 in chips)=20
Seat 9: helzkitchen (161912 in chips)=20
JJin91: posts the ante 750
kitkattbp: posts the ante 750
GMMK426: posts the ante 750
apoch19: posts the ante 750
helzkitchen: posts the ante 750
apoch19: posts small blind 3000
helzkitchen: posts big blind 6000
*** HOLE CARDS ***
Dealt to JJin91 [5c 4h]
JJin91: folds=20
kitkattbp: raises 51294 to 57294 and is all-in
GMMK426: folds=20
apoch19: calls 12225 and is all-in
helzkitchen: folds=20
Uncalled bet (42069) returned to kitkattbp
*** FLOP *** [Ks Kh 6d]
*** TURN *** [Ks Kh 6d] [Ac]
*** RIVER *** [Ks Kh 6d Ac] [9d]
*** SHOW DOWN ***
apoch19: shows [Kd Ah] (a full house, Kings full of Aces)
kitkattbp: shows [8c 8d] (two pair, Kings and Eights)
apoch19 collected 40200 from pot
*** SUMMARY ***
Total pot 40200 | Rake 0=20
Board [Ks Kh 6d Ac 9d]
Seat 1: JJin91 folded before Flop (didn't bet)
Seat 4: kitkattbp showed [8c 8d] and lost with two pair, Kings and Eigh=
ts
Seat 6: GMMK426 (button) folded before Flop (didn't bet)
Seat 8: apoch19 (small blind) showed [Kd Ah] and won (40200) with a ful=
l house, Kings full of Aces
Seat 9: helzkitchen (big blind) folded before Flop


*********** # 286 **************
PokerStars Hand #172155548054: Tournament #1648990476, $18.20+$1.80 USD=
 Hold'em No Limit - Level XXIV (3000/6000) - 2017/07/06 23:18:54 ET
Table '1648990476 7' 9-max Seat #8 is the button
Seat 1: JJin91 (114401 in chips)=20
Seat 4: kitkattbp (42069 in chips)=20
Seat 6: GMMK426 (145597 in chips)=20
Seat 8: apoch19 (40200 in chips)=20
Seat 9: helzkitchen (155162 in chips)=20
JJin91: posts the ante 750
kitkattbp: posts the ante 750
GMMK426: posts the ante 750
apoch19: posts the ante 750
helzkitchen: posts the ante 750
helzkitchen: posts small blind 3000
JJin91: posts big blind 6000
*** HOLE CARDS ***
Dealt to JJin91 [Jd 9d]
kitkattbp said, "lol"
kitkattbp: folds=20
GMMK426: folds=20
apoch19: folds=20
helzkitchen: folds=20
Uncalled bet (3000) returned to JJin91
JJin91 collected 9750 from pot
JJin91: doesn't show hand=20
*** SUMMARY ***
Total pot 9750 | Rake 0=20
Seat 1: JJin91 (big blind) collected (9750)
Seat 4: kitkattbp folded before Flop (didn't bet)
Seat 6: GMMK426 folded before Flop (didn't bet)
Seat 8: apoch19 (button) folded before Flop (didn't bet)
Seat 9: helzkitchen (small blind) folded before Flop


*********** # 287 **************
PokerStars Hand #172155548145: Tournament #1648990476, $18.20+$1.80 USD=
 Hold'em No Limit - Level XXIV (3000/6000) - 2017/07/06 23:19:13 ET
Table '1648990476 7' 9-max Seat #9 is the button
Seat 1: JJin91 (120401 in chips)=20
Seat 4: kitkattbp (41319 in chips)=20
Seat 6: GMMK426 (144847 in chips)=20
Seat 8: apoch19 (39450 in chips)=20
Seat 9: helzkitchen (151412 in chips)=20
JJin91: posts the ante 750
kitkattbp: posts the ante 750
GMMK426: posts the ante 750
apoch19: posts the ante 750
helzkitchen: posts the ante 750
JJin91: posts small blind 3000
kitkattbp: posts big blind 6000
*** HOLE CARDS ***
Dealt to JJin91 [7h Qc]
GMMK426: calls 6000
apoch19: folds=20
helzkitchen: folds=20
JJin91: folds=20
kitkattbp: checks=20
*** FLOP *** [3c Qs Js]
kitkattbp: checks=20
GMMK426: bets 18750
kitkattbp: folds=20
Uncalled bet (18750) returned to GMMK426
GMMK426 collected 18750 from pot
GMMK426: doesn't show hand=20
*** SUMMARY ***
Total pot 18750 | Rake 0=20
Board [3c Qs Js]
Seat 1: JJin91 (small blind) folded before Flop
Seat 4: kitkattbp (big blind) folded on the Flop
Seat 6: GMMK426 collected (18750)
Seat 8: apoch19 folded before Flop (didn't bet)
Seat 9: helzkitchen (button) folded before Flop (didn't bet)


*********** # 288 **************
PokerStars Hand #172155548291: Tournament #1648990476, $18.20+$1.80 USD=
 Hold'em No Limit - Level XXIV (3000/6000) - 2017/07/06 23:19:43 ET
Table '1648990476 7' 9-max Seat #1 is the button
Seat 1: JJin91 (116651 in chips)=20
Seat 4: kitkattbp (34569 in chips)=20
Seat 6: GMMK426 (156847 in chips)=20
Seat 8: apoch19 (38700 in chips)=20
Seat 9: helzkitchen (150662 in chips)=20
JJin91: posts the ante 750
kitkattbp: posts the ante 750
GMMK426: posts the ante 750
apoch19: posts the ante 750
helzkitchen: posts the ante 750
kitkattbp: posts small blind 3000
GMMK426: posts big blind 6000
*** HOLE CARDS ***
Dealt to JJin91 [8c 9d]
apoch19: folds=20
helzkitchen: folds=20
JJin91: folds=20
kitkattbp: raises 27819 to 33819 and is all-in
GMMK426: folds=20
Uncalled bet (27819) returned to kitkattbp
kitkattbp collected 15750 from pot
kitkattbp: doesn't show hand=20
*** SUMMARY ***
Total pot 15750 | Rake 0=20
Seat 1: JJin91 (button) folded before Flop (didn't bet)
Seat 4: kitkattbp (small blind) collected (15750)
Seat 6: GMMK426 (big blind) folded before Flop
Seat 8: apoch19 folded before Flop (didn't bet)
Seat 9: helzkitchen folded before Flop (didn't bet)


*********** # 289 **************
PokerStars Hand #172155548400: Tournament #1648990476, $18.20+$1.80 USD=
 Hold'em No Limit - Level XXIV (3000/6000) - 2017/07/06 23:20:07 ET
Table '1648990476 7' 9-max Seat #4 is the button
Seat 1: JJin91 (115901 in chips)=20
Seat 4: kitkattbp (43569 in chips)=20
Seat 6: GMMK426 (150097 in chips)=20
Seat 8: apoch19 (37950 in chips)=20
Seat 9: helzkitchen (149912 in chips)=20
JJin91: posts the ante 750
kitkattbp: posts the ante 750
GMMK426: posts the ante 750
apoch19: posts the ante 750
helzkitchen: posts the ante 750
GMMK426: posts small blind 3000
apoch19: posts big blind 6000
*** HOLE CARDS ***
Dealt to JJin91 [Kc 7h]
helzkitchen: folds=20
JJin91: folds=20
kitkattbp: folds=20
GMMK426: folds=20
Uncalled bet (3000) returned to apoch19
apoch19 collected 9750 from pot
apoch19: doesn't show hand=20
*** SUMMARY ***
Total pot 9750 | Rake 0=20
Seat 1: JJin91 folded before Flop (didn't bet)
Seat 4: kitkattbp (button) folded before Flop (didn't bet)
Seat 6: GMMK426 (small blind) folded before Flop
Seat 8: apoch19 (big blind) collected (9750)
Seat 9: helzkitchen folded before Flop (didn't bet)


*********** # 290 **************
PokerStars Hand #172155548439: Tournament #1648990476, $18.20+$1.80 USD=
 Hold'em No Limit - Level XXIV (3000/6000) - 2017/07/06 23:20:17 ET
Table '1648990476 7' 9-max Seat #6 is the button
Seat 1: JJin91 (115151 in chips)=20
Seat 4: kitkattbp (42819 in chips)=20
Seat 6: GMMK426 (146347 in chips)=20
Seat 8: apoch19 (43950 in chips)=20
Seat 9: helzkitchen (149162 in chips)=20
JJin91: posts the ante 750
kitkattbp: posts the ante 750
GMMK426: posts the ante 750
apoch19: posts the ante 750
helzkitchen: posts the ante 750
apoch19: posts small blind 3000
helzkitchen: posts big blind 6000
*** HOLE CARDS ***
Dealt to JJin91 [6h 5d]
JJin91: folds=20
kitkattbp: raises 36069 to 42069 and is all-in
GMMK426: folds=20
apoch19: folds=20
helzkitchen: calls 36069
*** FLOP *** [6d 4c Qc]
*** TURN *** [6d 4c Qc] [5c]
*** RIVER *** [6d 4c Qc 5c] [Ts]
*** SHOW DOWN ***
helzkitchen: shows [Kc Jc] (a flush, King high)
kitkattbp: shows [Ad Js] (high card Ace)
helzkitchen collected 90888 from pot
kitkattbp finished the tournament in 10th place and received $42.99.
*** SUMMARY ***
Total pot 90888 | Rake 0=20
Board [6d 4c Qc 5c Ts]
Seat 1: JJin91 folded before Flop (didn't bet)
Seat 4: kitkattbp showed [Ad Js] and lost with high card Ace
Seat 6: GMMK426 (button) folded before Flop (didn't bet)
Seat 8: apoch19 (small blind) folded before Flop
Seat 9: helzkitchen (big blind) showed [Kc Jc] and won (90888) with a f=
lush, King high


*********** # 291 **************
PokerStars Hand #172155548664: Tournament #1648990476, $18.20+$1.80 USD=
 Hold'em No Limit - Level XXIV (3000/6000) - 2017/07/06 23:21:06 ET
Table '1648990476 1' 9-max Seat #9 is the button
Seat 1: E9Polarizer (119392 in chips)=20
Seat 2: apoch19 (40200 in chips)=20
Seat 3: GMMK426 (145597 in chips)=20
Seat 4: JJin91 (114401 in chips)=20
Seat 5: jsulzman (323742 in chips)=20
Seat 6: helzkitchen (197231 in chips)=20
Seat 7: Paceman2jr (134028 in chips)=20
Seat 8: Going2Ship (92758 in chips)=20
Seat 9: CerPrisingLe (182651 in chips)=20
E9Polarizer: posts the ante 750
apoch19: posts the ante 750
GMMK426: posts the ante 750
JJin91: posts the ante 750
jsulzman: posts the ante 750
helzkitchen: posts the ante 750
Paceman2jr: posts the ante 750
Going2Ship: posts the ante 750
CerPrisingLe: posts the ante 750
E9Polarizer: posts small blind 3000
apoch19: posts big blind 6000
*** HOLE CARDS ***
Dealt to JJin91 [8d 7c]
GMMK426: calls 6000
JJin91: folds=20
jsulzman: raises 12000 to 18000
helzkitchen: folds=20
Paceman2jr: folds=20
Going2Ship: folds=20
CerPrisingLe: folds=20
E9Polarizer: folds=20
apoch19: folds=20
GMMK426: calls 12000
*** FLOP *** [Js 8s 7h]
GMMK426: checks=20
jsulzman: bets 25875
GMMK426: folds=20
Uncalled bet (25875) returned to jsulzman
jsulzman collected 51750 from pot
*** SUMMARY ***
Total pot 51750 | Rake 0=20
Board [Js 8s 7h]
Seat 1: E9Polarizer (small blind) folded before Flop
Seat 2: apoch19 (big blind) folded before Flop
Seat 3: GMMK426 folded on the Flop
Seat 4: JJin91 folded before Flop (didn't bet)
Seat 5: jsulzman collected (51750)
Seat 6: helzkitchen folded before Flop (didn't bet)
Seat 7: Paceman2jr folded before Flop (didn't bet)
Seat 8: Going2Ship folded before Flop (didn't bet)
Seat 9: CerPrisingLe (button) folded before Flop (didn't bet)


*********** # 292 **************
PokerStars Hand #172155549054: Tournament #1648990476, $18.20+$1.80 USD=
 Hold'em No Limit - Level XXIV (3000/6000) - 2017/07/06 23:22:34 ET
Table '1648990476 1' 9-max Seat #1 is the button
Seat 1: E9Polarizer (115642 in chips)=20
Seat 2: apoch19 (33450 in chips)=20
Seat 3: GMMK426 (126847 in chips)=20
Seat 4: JJin91 (113651 in chips)=20
Seat 5: jsulzman (356742 in chips)=20
Seat 6: helzkitchen (196481 in chips)=20
Seat 7: Paceman2jr (133278 in chips)=20
Seat 8: Going2Ship (92008 in chips)=20
Seat 9: CerPrisingLe (181901 in chips)=20
E9Polarizer: posts the ante 750
apoch19: posts the ante 750
GMMK426: posts the ante 750
JJin91: posts the ante 750
jsulzman: posts the ante 750
helzkitchen: posts the ante 750
Paceman2jr: posts the ante 750
Going2Ship: posts the ante 750
CerPrisingLe: posts the ante 750
apoch19: posts small blind 3000
GMMK426: posts big blind 6000
*** HOLE CARDS ***
Dealt to JJin91 [As 3s]
JJin91: folds=20
jsulzman: raises 12000 to 18000
helzkitchen: calls 18000
Paceman2jr: folds=20
Going2Ship: folds=20
CerPrisingLe: folds=20
E9Polarizer: folds=20
apoch19: folds=20
GMMK426: folds=20
*** FLOP *** [Kh 9c Kd]
jsulzman: bets 25875
helzkitchen: calls 25875
*** TURN *** [Kh 9c Kd] [Ks]
jsulzman: bets 51750
helzkitchen: folds=20
Uncalled bet (51750) returned to jsulzman
jsulzman collected 103500 from pot
*** SUMMARY ***
Total pot 103500 | Rake 0=20
Board [Kh 9c Kd Ks]
Seat 1: E9Polarizer (button) folded before Flop (didn't bet)
Seat 2: apoch19 (small blind) folded before Flop
Seat 3: GMMK426 (big blind) folded before Flop
Seat 4: JJin91 folded before Flop (didn't bet)
Seat 5: jsulzman collected (103500)
Seat 6: helzkitchen folded on the Turn
Seat 7: Paceman2jr folded before Flop (didn't bet)
Seat 8: Going2Ship folded before Flop (didn't bet)
Seat 9: CerPrisingLe folded before Flop (didn't bet)


*********** # 293 **************
PokerStars Hand #172155549298: Tournament #1648990476, $18.20+$1.80 USD=
 Hold'em No Limit - Level XXV (3500/7000) - 2017/07/06 23:23:28 ET
Table '1648990476 1' 9-max Seat #2 is the button
Seat 1: E9Polarizer (114892 in chips)=20
Seat 2: apoch19 (29700 in chips)=20
Seat 3: GMMK426 (120097 in chips)=20
Seat 4: JJin91 (112901 in chips)=20
Seat 5: jsulzman (415617 in chips)=20
Seat 6: helzkitchen (151856 in chips)=20
Seat 7: Paceman2jr (132528 in chips)=20
Seat 8: Going2Ship (91258 in chips)=20
Seat 9: CerPrisingLe (181151 in chips)=20
E9Polarizer: posts the ante 875
apoch19: posts the ante 875
GMMK426: posts the ante 875
JJin91: posts the ante 875
jsulzman: posts the ante 875
helzkitchen: posts the ante 875
Paceman2jr: posts the ante 875
Going2Ship: posts the ante 875
CerPrisingLe: posts the ante 875
GMMK426: posts small blind 3500
JJin91: posts big blind 7000
*** HOLE CARDS ***
Dealt to JJin91 [Jc 5c]
jsulzman: folds=20
helzkitchen: folds=20
Paceman2jr: folds=20
Going2Ship: folds=20
CerPrisingLe: raises 7000 to 14000
E9Polarizer: folds=20
apoch19: folds=20
GMMK426: folds=20
JJin91: folds=20
Uncalled bet (7000) returned to CerPrisingLe
CerPrisingLe collected 25375 from pot
CerPrisingLe: doesn't show hand=20
*** SUMMARY ***
Total pot 25375 | Rake 0=20
Seat 1: E9Polarizer folded before Flop (didn't bet)
Seat 2: apoch19 (button) folded before Flop (didn't bet)
Seat 3: GMMK426 (small blind) folded before Flop
Seat 4: JJin91 (big blind) folded before Flop
Seat 5: jsulzman folded before Flop (didn't bet)
Seat 6: helzkitchen folded before Flop (didn't bet)
Seat 7: Paceman2jr folded before Flop (didn't bet)
Seat 8: Going2Ship folded before Flop (didn't bet)
Seat 9: CerPrisingLe collected (25375)


*********** # 294 **************
PokerStars Hand #172155549446: Tournament #1648990476, $18.20+$1.80 USD=
 Hold'em No Limit - Level XXV (3500/7000) - 2017/07/06 23:23:57 ET
Table '1648990476 1' 9-max Seat #3 is the button
Seat 1: E9Polarizer (114017 in chips)=20
Seat 2: apoch19 (28825 in chips)=20
Seat 3: GMMK426 (115722 in chips)=20
Seat 4: JJin91 (105026 in chips)=20
Seat 5: jsulzman (414742 in chips)=20
Seat 6: helzkitchen (150981 in chips)=20
Seat 7: Paceman2jr (131653 in chips)=20
Seat 8: Going2Ship (90383 in chips)=20
Seat 9: CerPrisingLe (198651 in chips)=20
E9Polarizer: posts the ante 875
apoch19: posts the ante 875
GMMK426: posts the ante 875
JJin91: posts the ante 875
jsulzman: posts the ante 875
helzkitchen: posts the ante 875
Paceman2jr: posts the ante 875
Going2Ship: posts the ante 875
CerPrisingLe: posts the ante 875
JJin91: posts small blind 3500
jsulzman: posts big blind 7000
*** HOLE CARDS ***
Dealt to JJin91 [8d Ts]
helzkitchen: raises 7000 to 14000
Paceman2jr: folds=20
Going2Ship: folds=20
CerPrisingLe: folds=20
E9Polarizer: folds=20
apoch19: folds=20
GMMK426: folds=20
JJin91: folds=20
jsulzman: calls 7000
*** FLOP *** [7d Th 9h]
jsulzman: checks=20
helzkitchen: checks=20
*** TURN *** [7d Th 9h] [4s]
jsulzman: bets 19688
helzkitchen: folds=20
Uncalled bet (19688) returned to jsulzman
jsulzman collected 39375 from pot
*** SUMMARY ***
Total pot 39375 | Rake 0=20
Board [7d Th 9h 4s]
Seat 1: E9Polarizer folded before Flop (didn't bet)
Seat 2: apoch19 folded before Flop (didn't bet)
Seat 3: GMMK426 (button) folded before Flop (didn't bet)
Seat 4: JJin91 (small blind) folded before Flop
Seat 5: jsulzman (big blind) collected (39375)
Seat 6: helzkitchen folded on the Turn
Seat 7: Paceman2jr folded before Flop (didn't bet)
Seat 8: Going2Ship folded before Flop (didn't bet)
Seat 9: CerPrisingLe folded before Flop (didn't bet)


*********** # 295 **************
PokerStars Hand #172155549601: Tournament #1648990476, $18.20+$1.80 USD=
 Hold'em No Limit - Level XXV (3500/7000) - 2017/07/06 23:24:31 ET
Table '1648990476 1' 9-max Seat #4 is the button
Seat 1: E9Polarizer (113142 in chips)=20
Seat 2: apoch19 (27950 in chips)=20
Seat 3: GMMK426 (114847 in chips)=20
Seat 4: JJin91 (100651 in chips)=20
Seat 5: jsulzman (439242 in chips)=20
Seat 6: helzkitchen (136106 in chips)=20
Seat 7: Paceman2jr (130778 in chips)=20
Seat 8: Going2Ship (89508 in chips)=20
Seat 9: CerPrisingLe (197776 in chips)=20
E9Polarizer: posts the ante 875
apoch19: posts the ante 875
GMMK426: posts the ante 875
JJin91: posts the ante 875
jsulzman: posts the ante 875
helzkitchen: posts the ante 875
Paceman2jr: posts the ante 875
Going2Ship: posts the ante 875
CerPrisingLe: posts the ante 875
jsulzman: posts small blind 3500
helzkitchen: posts big blind 7000
*** HOLE CARDS ***
Dealt to JJin91 [3d Kc]
Paceman2jr: folds=20
Going2Ship: folds=20
CerPrisingLe: folds=20
E9Polarizer: raises 7000 to 14000
apoch19: folds=20
GMMK426: folds=20
JJin91: folds=20
jsulzman: calls 10500
helzkitchen: folds=20
*** FLOP *** [Th Kh Ad]
jsulzman: bets 21438
E9Polarizer: folds=20
Uncalled bet (21438) returned to jsulzman
jsulzman collected 42875 from pot
*** SUMMARY ***
Total pot 42875 | Rake 0=20
Board [Th Kh Ad]
Seat 1: E9Polarizer folded on the Flop
Seat 2: apoch19 folded before Flop (didn't bet)
Seat 3: GMMK426 folded before Flop (didn't bet)
Seat 4: JJin91 (button) folded before Flop (didn't bet)
Seat 5: jsulzman (small blind) collected (42875)
Seat 6: helzkitchen (big blind) folded before Flop
Seat 7: Paceman2jr folded before Flop (didn't bet)
Seat 8: Going2Ship folded before Flop (didn't bet)
Seat 9: CerPrisingLe folded before Flop (didn't bet)


*********** # 296 **************
PokerStars Hand #172155549744: Tournament #1648990476, $18.20+$1.80 USD=
 Hold'em No Limit - Level XXV (3500/7000) - 2017/07/06 23:25:07 ET
Table '1648990476 1' 9-max Seat #5 is the button
Seat 1: E9Polarizer (98267 in chips)=20
Seat 2: apoch19 (27075 in chips)=20
Seat 3: GMMK426 (113972 in chips)=20
Seat 4: JJin91 (99776 in chips)=20
Seat 5: jsulzman (467242 in chips)=20
Seat 6: helzkitchen (128231 in chips)=20
Seat 7: Paceman2jr (129903 in chips)=20
Seat 8: Going2Ship (88633 in chips)=20
Seat 9: CerPrisingLe (196901 in chips)=20
E9Polarizer: posts the ante 875
apoch19: posts the ante 875
GMMK426: posts the ante 875
JJin91: posts the ante 875
jsulzman: posts the ante 875
helzkitchen: posts the ante 875
Paceman2jr: posts the ante 875
Going2Ship: posts the ante 875
CerPrisingLe: posts the ante 875
helzkitchen: posts small blind 3500
Paceman2jr: posts big blind 7000
*** HOLE CARDS ***
Dealt to JJin91 [8d 5h]
Going2Ship: raises 7000 to 14000
CerPrisingLe: folds=20
E9Polarizer: folds=20
apoch19: folds=20
GMMK426: folds=20
JJin91: folds=20
jsulzman: folds=20
helzkitchen: folds=20
Paceman2jr: calls 7000
*** FLOP *** [Ac 2s 5c]
Paceman2jr: checks=20
Going2Ship: checks=20
*** TURN *** [Ac 2s 5c] [3d]
Paceman2jr: checks=20
Going2Ship: checks=20
*** RIVER *** [Ac 2s 5c 3d] [Qc]
Paceman2jr: checks=20
Going2Ship: checks=20
*** SHOW DOWN ***
Paceman2jr: shows [Ts Qs] (a pair of Queens)
Going2Ship: mucks hand=20
Paceman2jr collected 39375 from pot
*** SUMMARY ***
Total pot 39375 | Rake 0=20
Board [Ac 2s 5c 3d Qc]
Seat 1: E9Polarizer folded before Flop (didn't bet)
Seat 2: apoch19 folded before Flop (didn't bet)
Seat 3: GMMK426 folded before Flop (didn't bet)
Seat 4: JJin91 folded before Flop (didn't bet)
Seat 5: jsulzman (button) folded before Flop (didn't bet)
Seat 6: helzkitchen (small blind) folded before Flop
Seat 7: Paceman2jr (big blind) showed [Ts Qs] and won (39375) with a pa=
ir of Queens
Seat 8: Going2Ship mucked [Th Kh]
Seat 9: CerPrisingLe folded before Flop (didn't bet)


*********** # 297 **************
PokerStars Hand #172155549903: Tournament #1648990476, $18.20+$1.80 USD=
 Hold'em No Limit - Level XXV (3500/7000) - 2017/07/06 23:25:42 ET
Table '1648990476 1' 9-max Seat #6 is the button
Seat 1: E9Polarizer (97392 in chips)=20
Seat 2: apoch19 (26200 in chips)=20
Seat 3: GMMK426 (113097 in chips)=20
Seat 4: JJin91 (98901 in chips)=20
Seat 5: jsulzman (466367 in chips)=20
Seat 6: helzkitchen (123856 in chips)=20
Seat 7: Paceman2jr (154403 in chips)=20
Seat 8: Going2Ship (73758 in chips)=20
Seat 9: CerPrisingLe (196026 in chips)=20
E9Polarizer: posts the ante 875
apoch19: posts the ante 875
GMMK426: posts the ante 875
JJin91: posts the ante 875
jsulzman: posts the ante 875
helzkitchen: posts the ante 875
Paceman2jr: posts the ante 875
Going2Ship: posts the ante 875
CerPrisingLe: posts the ante 875
Paceman2jr: posts small blind 3500
Going2Ship: posts big blind 7000
*** HOLE CARDS ***
Dealt to JJin91 [4d As]
CerPrisingLe: folds=20
E9Polarizer: folds=20
apoch19: raises 18325 to 25325 and is all-in
GMMK426: folds=20
JJin91: folds=20
jsulzman: folds=20
helzkitchen: folds=20
Paceman2jr: folds=20
Going2Ship: calls 18325
*** FLOP *** [8s Jc 6c]
*** TURN *** [8s Jc 6c] [2d]
*** RIVER *** [8s Jc 6c 2d] [Qh]
*** SHOW DOWN ***
Going2Ship: shows [Kh 7c] (high card King)
apoch19: shows [9h 9c] (a pair of Nines)
apoch19 collected 62025 from pot
*** SUMMARY ***
Total pot 62025 | Rake 0=20
Board [8s Jc 6c 2d Qh]
Seat 1: E9Polarizer folded before Flop (didn't bet)
Seat 2: apoch19 showed [9h 9c] and won (62025) with a pair of Nines
Seat 3: GMMK426 folded before Flop (didn't bet)
Seat 4: JJin91 folded before Flop (didn't bet)
Seat 5: jsulzman folded before Flop (didn't bet)
Seat 6: helzkitchen (button) folded before Flop (didn't bet)
Seat 7: Paceman2jr (small blind) folded before Flop
Seat 8: Going2Ship (big blind) showed [Kh 7c] and lost with high card K=
ing
Seat 9: CerPrisingLe folded before Flop (didn't bet)


*********** # 298 **************
PokerStars Hand #172156259844: Tournament #1648990476, $18.20+$1.80 USD=
 Hold'em No Limit - Level XXV (3500/7000) - 2017/07/06 23:26:19 ET
Table '1648990476 1' 9-max Seat #7 is the button
Seat 1: E9Polarizer (96517 in chips)=20
Seat 2: apoch19 (62025 in chips)=20
Seat 3: GMMK426 (112222 in chips)=20
Seat 4: JJin91 (98026 in chips)=20
Seat 5: jsulzman (465492 in chips)=20
Seat 6: helzkitchen (122981 in chips)=20
Seat 7: Paceman2jr (150028 in chips)=20
Seat 8: Going2Ship (47558 in chips)=20
Seat 9: CerPrisingLe (195151 in chips)=20
E9Polarizer: posts the ante 875
apoch19: posts the ante 875
GMMK426: posts the ante 875
JJin91: posts the ante 875
jsulzman: posts the ante 875
helzkitchen: posts the ante 875
Paceman2jr: posts the ante 875
Going2Ship: posts the ante 875
CerPrisingLe: posts the ante 875
Going2Ship: posts small blind 3500
CerPrisingLe: posts big blind 7000
*** HOLE CARDS ***
Dealt to JJin91 [9c 9s]
E9Polarizer: raises 88642 to 95642 and is all-in
apoch19: folds=20
GMMK426: folds=20
JJin91: raises 1509 to 97151 and is all-in
jsulzman: folds=20
helzkitchen: folds=20
Paceman2jr: folds=20
Going2Ship: folds=20
CerPrisingLe: folds=20
Uncalled bet (1509) returned to JJin91
*** FLOP *** [Kd 3h 5s]
*** TURN *** [Kd 3h 5s] [6d]
*** RIVER *** [Kd 3h 5s 6d] [Th]
*** SHOW DOWN ***
E9Polarizer: shows [Ah Qd] (high card Ace)
JJin91: shows [9c 9s] (a pair of Nines)
JJin91 collected 209659 from pot
E9Polarizer finished the tournament in 9th place and received $49.14.
*** SUMMARY ***
Total pot 209659 | Rake 0=20
Board [Kd 3h 5s 6d Th]
Seat 1: E9Polarizer showed [Ah Qd] and lost with high card Ace
Seat 2: apoch19 folded before Flop (didn't bet)
Seat 3: GMMK426 folded before Flop (didn't bet)
Seat 4: JJin91 showed [9c 9s] and won (209659) with a pair of Nines
Seat 5: jsulzman folded before Flop (didn't bet)
Seat 6: helzkitchen folded before Flop (didn't bet)
Seat 7: Paceman2jr (button) folded before Flop (didn't bet)
Seat 8: Going2Ship (small blind) folded before Flop
Seat 9: CerPrisingLe (big blind) folded before Flop


*********** # 299 **************
PokerStars Hand #172156259941: Tournament #1648990476, $18.20+$1.80 USD=
 Hold'em No Limit - Level XXV (3500/7000) - 2017/07/06 23:26:40 ET
Table '1648990476 1' 9-max Seat #8 is the button
Seat 2: apoch19 (61150 in chips)=20
Seat 3: GMMK426 (111347 in chips)=20
Seat 4: JJin91 (211168 in chips)=20
Seat 5: jsulzman (464617 in chips)=20
Seat 6: helzkitchen (122106 in chips)=20
Seat 7: Paceman2jr (149153 in chips)=20
Seat 8: Going2Ship (43183 in chips)=20
Seat 9: CerPrisingLe (187276 in chips)=20
apoch19: posts the ante 875
GMMK426: posts the ante 875
JJin91: posts the ante 875
jsulzman: posts the ante 875
helzkitchen: posts the ante 875
Paceman2jr: posts the ante 875
Going2Ship: posts the ante 875
CerPrisingLe: posts the ante 875
CerPrisingLe: posts small blind 3500
apoch19: posts big blind 7000
*** HOLE CARDS ***
Dealt to JJin91 [Ad 6d]
GMMK426: folds=20
JJin91: raises 7770 to 14770
jsulzman: folds=20
helzkitchen: folds=20
Paceman2jr: folds=20
Going2Ship: folds=20
CerPrisingLe: folds=20
apoch19: calls 7770
*** FLOP *** [3h 3c 9c]
apoch19: checks=20
JJin91: checks=20
*** TURN *** [3h 3c 9c] [Js]
apoch19: checks=20
JJin91: bets 13213
apoch19: calls 13213
*** RIVER *** [3h 3c 9c Js] [Ks]
apoch19: checks=20
JJin91: checks=20
*** SHOW DOWN ***
apoch19: shows [7s 7h] (two pair, Sevens and Threes)
JJin91: mucks hand=20
apoch19 collected 66466 from pot
*** SUMMARY ***
Total pot 66466 | Rake 0=20
Board [3h 3c 9c Js Ks]
Seat 2: apoch19 (big blind) showed [7s 7h] and won (66466) with two pai=
r, Sevens and Threes
Seat 3: GMMK426 folded before Flop (didn't bet)
Seat 4: JJin91 mucked [Ad 6d]
Seat 5: jsulzman folded before Flop (didn't bet)
Seat 6: helzkitchen folded before Flop (didn't bet)
Seat 7: Paceman2jr folded before Flop (didn't bet)
Seat 8: Going2Ship (button) folded before Flop (didn't bet)
Seat 9: CerPrisingLe (small blind) folded before Flop


*********** # 300 **************
PokerStars Hand #172156307672: Tournament #1648990476, $18.20+$1.80 USD=
 Hold'em No Limit - Level XXV (3500/7000) - 2017/07/06 23:27:59 ET
Table '1648990476 1' 9-max Seat #9 is the button
Seat 2: apoch19 (98758 in chips)=20
Seat 3: GMMK426 (110472 in chips)=20
Seat 4: JJin91 (182310 in chips)=20
Seat 5: jsulzman (463742 in chips)=20
Seat 6: helzkitchen (121231 in chips)=20
Seat 7: Paceman2jr (148278 in chips)=20
Seat 8: Going2Ship (42308 in chips)=20
Seat 9: CerPrisingLe (182901 in chips)=20
apoch19: posts the ante 875
GMMK426: posts the ante 875
JJin91: posts the ante 875
jsulzman: posts the ante 875
helzkitchen: posts the ante 875
Paceman2jr: posts the ante 875
Going2Ship: posts the ante 875
CerPrisingLe: posts the ante 875
apoch19: posts small blind 3500
GMMK426: posts big blind 7000
*** HOLE CARDS ***
Dealt to JJin91 [Jd Tc]
JJin91: folds=20
jsulzman: raises 14000 to 21000
helzkitchen: folds=20
Paceman2jr: folds=20
Going2Ship: folds=20
JJin91 said, " nh"
CerPrisingLe: folds=20
apoch19: folds=20
GMMK426: folds=20
Uncalled bet (14000) returned to jsulzman
jsulzman collected 24500 from pot
*** SUMMARY ***
Total pot 24500 | Rake 0=20
Seat 2: apoch19 (small blind) folded before Flop
Seat 3: GMMK426 (big blind) folded before Flop
Seat 4: JJin91 folded before Flop (didn't bet)
Seat 5: jsulzman collected (24500)
Seat 6: helzkitchen folded before Flop (didn't bet)
Seat 7: Paceman2jr folded before Flop (didn't bet)
Seat 8: Going2Ship folded before Flop (didn't bet)
Seat 9: CerPrisingLe (button) folded before Flop (didn't bet)


*********** # 301 **************
PokerStars Hand #172156307750: Tournament #1648990476, $18.20+$1.80 USD=
 Hold'em No Limit - Level XXV (3500/7000) - 2017/07/06 23:28:16 ET
Table '1648990476 1' 9-max Seat #2 is the button
Seat 2: apoch19 (94383 in chips)=20
Seat 3: GMMK426 (102597 in chips)=20
Seat 4: JJin91 (181435 in chips)=20
Seat 5: jsulzman (480367 in chips)=20
Seat 6: helzkitchen (120356 in chips)=20
Seat 7: Paceman2jr (147403 in chips)=20
Seat 8: Going2Ship (41433 in chips)=20
Seat 9: CerPrisingLe (182026 in chips)=20
apoch19: posts the ante 875
GMMK426: posts the ante 875
JJin91: posts the ante 875
jsulzman: posts the ante 875
helzkitchen: posts the ante 875
Paceman2jr: posts the ante 875
Going2Ship: posts the ante 875
CerPrisingLe: posts the ante 875
GMMK426: posts small blind 3500
JJin91: posts big blind 7000
*** HOLE CARDS ***
Dealt to JJin91 [Qh Ks]
jsulzman: calls 7000
helzkitchen: folds=20
Paceman2jr: folds=20
Going2Ship: folds=20
CerPrisingLe: folds=20
apoch19: folds=20
GMMK426: calls 3500
JJin91: checks=20
*** FLOP *** [6d 4d 9d]
GMMK426: bets 28000
JJin91: folds=20
jsulzman: folds=20
Uncalled bet (28000) returned to GMMK426
GMMK426 collected 28000 from pot
GMMK426: doesn't show hand=20
*** SUMMARY ***
Total pot 28000 | Rake 0=20
Board [6d 4d 9d]
Seat 2: apoch19 (button) folded before Flop (didn't bet)
Seat 3: GMMK426 (small blind) collected (28000)
Seat 4: JJin91 (big blind) folded on the Flop
Seat 5: jsulzman folded on the Flop
Seat 6: helzkitchen folded before Flop (didn't bet)
Seat 7: Paceman2jr folded before Flop (didn't bet)
Seat 8: Going2Ship folded before Flop (didn't bet)
Seat 9: CerPrisingLe folded before Flop (didn't bet)


*********** # 302 **************
PokerStars Hand #172156307843: Tournament #1648990476, $18.20+$1.80 USD=
 Hold'em No Limit - Level XXV (3500/7000) - 2017/07/06 23:28:39 ET
Table '1648990476 1' 9-max Seat #3 is the button
Seat 2: apoch19 (93508 in chips)=20
Seat 3: GMMK426 (122722 in chips)=20
Seat 4: JJin91 (173560 in chips)=20
Seat 5: jsulzman (472492 in chips)=20
Seat 6: helzkitchen (119481 in chips)=20
Seat 7: Paceman2jr (146528 in chips)=20
Seat 8: Going2Ship (40558 in chips)=20
Seat 9: CerPrisingLe (181151 in chips)=20
apoch19: posts the ante 875
GMMK426: posts the ante 875
JJin91: posts the ante 875
jsulzman: posts the ante 875
helzkitchen: posts the ante 875
Paceman2jr: posts the ante 875
Going2Ship: posts the ante 875
CerPrisingLe: posts the ante 875
JJin91: posts small blind 3500
jsulzman: posts big blind 7000
*** HOLE CARDS ***
Dealt to JJin91 [5d 5s]
helzkitchen: folds=20
Paceman2jr: raises 7000 to 14000
Going2Ship: folds=20
CerPrisingLe: folds=20
apoch19: raises 78633 to 92633 and is all-in
GMMK426: folds=20
JJin91: folds=20
jsulzman: calls 85633
Paceman2jr: folds=20
*** FLOP *** [9c Th Ts]
*** TURN *** [9c Th Ts] [2h]
*** RIVER *** [9c Th Ts 2h] [7s]
*** SHOW DOWN ***
jsulzman: shows [As Ad] (two pair, Aces and Tens)
apoch19: shows [Kc Ac] (a pair of Tens)
jsulzman collected 209766 from pot
apoch19 finished the tournament in 8th place and received $73.71.
*** SUMMARY ***
Total pot 209766 | Rake 0=20
Board [9c Th Ts 2h 7s]
Seat 2: apoch19 showed [Kc Ac] and lost with a pair of Tens
Seat 3: GMMK426 (button) folded before Flop (didn't bet)
Seat 4: JJin91 (small blind) folded before Flop
Seat 5: jsulzman (big blind) showed [As Ad] and won (209766) with two p=
air, Aces and Tens
Seat 6: helzkitchen folded before Flop (didn't bet)
Seat 7: Paceman2jr folded before Flop
Seat 8: Going2Ship folded before Flop (didn't bet)
Seat 9: CerPrisingLe folded before Flop (didn't bet)


*********** # 303 **************
PokerStars Hand #172156307955: Tournament #1648990476, $18.20+$1.80 USD=
 Hold'em No Limit - Level XXV (3500/7000) - 2017/07/06 23:29:10 ET
Table '1648990476 1' 9-max Seat #4 is the button
Seat 3: GMMK426 (121847 in chips)=20
Seat 4: JJin91 (169185 in chips)=20
Seat 5: jsulzman (588750 in chips)=20
Seat 6: helzkitchen (118606 in chips)=20
Seat 7: Paceman2jr (131653 in chips)=20
Seat 8: Going2Ship (39683 in chips)=20
Seat 9: CerPrisingLe (180276 in chips)=20
GMMK426: posts the ante 875
JJin91: posts the ante 875
jsulzman: posts the ante 875
helzkitchen: posts the ante 875
Paceman2jr: posts the ante 875
Going2Ship: posts the ante 875
CerPrisingLe: posts the ante 875
jsulzman: posts small blind 3500
helzkitchen: posts big blind 7000
*** HOLE CARDS ***
Dealt to JJin91 [3s 7s]
Paceman2jr: folds=20
Going2Ship: folds=20
CerPrisingLe: folds=20
GMMK426: folds=20
JJin91: folds=20
jsulzman: raises 7000 to 14000
helzkitchen: folds=20
Uncalled bet (7000) returned to jsulzman
jsulzman collected 20125 from pot
*** SUMMARY ***
Total pot 20125 | Rake 0=20
Seat 3: GMMK426 folded before Flop (didn't bet)
Seat 4: JJin91 (button) folded before Flop (didn't bet)
Seat 5: jsulzman (small blind) collected (20125)
Seat 6: helzkitchen (big blind) folded before Flop
Seat 7: Paceman2jr folded before Flop (didn't bet)
Seat 8: Going2Ship folded before Flop (didn't bet)
Seat 9: CerPrisingLe folded before Flop (didn't bet)


*********** # 304 **************
PokerStars Hand #172156308054: Tournament #1648990476, $18.20+$1.80 USD=
 Hold'em No Limit - Level XXV (3500/7000) - 2017/07/06 23:29:32 ET
Table '1648990476 1' 9-max Seat #5 is the button
Seat 3: GMMK426 (120972 in chips)=20
Seat 4: JJin91 (168310 in chips)=20
Seat 5: jsulzman (601000 in chips)=20
Seat 6: helzkitchen (110731 in chips)=20
Seat 7: Paceman2jr (130778 in chips)=20
Seat 8: Going2Ship (38808 in chips)=20
Seat 9: CerPrisingLe (179401 in chips)=20
GMMK426: posts the ante 875
JJin91: posts the ante 875
jsulzman: posts the ante 875
helzkitchen: posts the ante 875
Paceman2jr: posts the ante 875
Going2Ship: posts the ante 875
CerPrisingLe: posts the ante 875
helzkitchen: posts small blind 3500
Paceman2jr: posts big blind 7000
*** HOLE CARDS ***
Dealt to JJin91 [Kc Qs]
Going2Ship: raises 30933 to 37933 and is all-in
CerPrisingLe: calls 37933
GMMK426: folds=20
JJin91: folds=20
jsulzman: calls 37933
helzkitchen: folds=20
Paceman2jr: folds=20
*** FLOP *** [Kh Tc 9s]
CerPrisingLe: checks=20
jsulzman: checks=20
*** TURN *** [Kh Tc 9s] [7h]
CerPrisingLe: checks=20
jsulzman: checks=20
*** RIVER *** [Kh Tc 9s 7h] [Jd]
CerPrisingLe: bets 49000
jsulzman: calls 49000
*** SHOW DOWN ***
CerPrisingLe: shows [Qc Ad] (a straight, Ten to Ace)
jsulzman: mucks hand=20
CerPrisingLe collected 98000 from side pot
Going2Ship: mucks hand=20
CerPrisingLe collected 130424 from main pot
Going2Ship finished the tournament in 7th place and received $98.28.
*** SUMMARY ***
Total pot 228424 Main pot 130424. Side pot 98000. | Rake 0=20
Board [Kh Tc 9s 7h Jd]
Seat 3: GMMK426 folded before Flop (didn't bet)
Seat 4: JJin91 folded before Flop (didn't bet)
Seat 5: jsulzman (button) mucked [Js Th]
Seat 6: helzkitchen (small blind) folded before Flop
Seat 7: Paceman2jr (big blind) folded before Flop
Seat 8: Going2Ship mucked [7c 8c]
Seat 9: CerPrisingLe showed [Qc Ad] and won (228424) with a straight, T=
en to Ace


*********** # 305 **************
PokerStars Hand #172156308233: Tournament #1648990476, $18.20+$1.80 USD=
 Hold'em No Limit - Level XXV (3500/7000) - 2017/07/06 23:30:14 ET
Table '1648990476 1' 9-max Seat #6 is the button
Seat 3: GMMK426 (120097 in chips)=20
Seat 4: JJin91 (167435 in chips)=20
Seat 5: jsulzman (513192 in chips)=20
Seat 6: helzkitchen (106356 in chips)=20
Seat 7: Paceman2jr (122903 in chips)=20
Seat 9: CerPrisingLe (320017 in chips)=20
GMMK426: posts the ante 875
JJin91: posts the ante 875
jsulzman: posts the ante 875
helzkitchen: posts the ante 875
Paceman2jr: posts the ante 875
CerPrisingLe: posts the ante 875
Paceman2jr: posts small blind 3500
CerPrisingLe: posts big blind 7000
*** HOLE CARDS ***
Dealt to JJin91 [Qc 7h]
GMMK426: folds=20
JJin91: folds=20
jsulzman: folds=20
helzkitchen: raises 98481 to 105481 and is all-in
Paceman2jr: folds=20
CerPrisingLe: folds=20
Uncalled bet (98481) returned to helzkitchen
helzkitchen collected 22750 from pot
helzkitchen: doesn't show hand=20
*** SUMMARY ***
Total pot 22750 | Rake 0=20
Seat 3: GMMK426 folded before Flop (didn't bet)
Seat 4: JJin91 folded before Flop (didn't bet)
Seat 5: jsulzman folded before Flop (didn't bet)
Seat 6: helzkitchen (button) collected (22750)
Seat 7: Paceman2jr (small blind) folded before Flop
Seat 9: CerPrisingLe (big blind) folded before Flop


*********** # 306 **************
PokerStars Hand #172156308311: Tournament #1648990476, $18.20+$1.80 USD=
 Hold'em No Limit - Level XXV (3500/7000) - 2017/07/06 23:30:34 ET
Table '1648990476 1' 9-max Seat #7 is the button
Seat 3: GMMK426 (119222 in chips)=20
Seat 4: JJin91 (166560 in chips)=20
Seat 5: jsulzman (512317 in chips)=20
Seat 6: helzkitchen (121231 in chips)=20
Seat 7: Paceman2jr (118528 in chips)=20
Seat 9: CerPrisingLe (312142 in chips)=20
GMMK426: posts the ante 875
JJin91: posts the ante 875
jsulzman: posts the ante 875
helzkitchen: posts the ante 875
Paceman2jr: posts the ante 875
CerPrisingLe: posts the ante 875
CerPrisingLe: posts small blind 3500
GMMK426: posts big blind 7000
*** HOLE CARDS ***
Dealt to JJin91 [Jd Ah]
JJin91: raises 7770 to 14770
jsulzman: folds=20
helzkitchen: folds=20
Paceman2jr: folds=20
CerPrisingLe: calls 11270
GMMK426: calls 7770
*** FLOP *** [4h 6s 3d]
CerPrisingLe: checks=20
GMMK426: bets 7000
JJin91: calls 7000
CerPrisingLe: raises 35280 to 42280
GMMK426: raises 61297 to 103577 and is all-in
JJin91: folds=20
CerPrisingLe: folds=20
Uncalled bet (61297) returned to GMMK426
GMMK426 collected 141120 from pot
GMMK426: doesn't show hand=20
*** SUMMARY ***
Total pot 141120 | Rake 0=20
Board [4h 6s 3d]
Seat 3: GMMK426 (big blind) collected (141120)
Seat 4: JJin91 folded on the Flop
Seat 5: jsulzman folded before Flop (didn't bet)
Seat 6: helzkitchen folded before Flop (didn't bet)
Seat 7: Paceman2jr (button) folded before Flop (didn't bet)
Seat 9: CerPrisingLe (small blind) folded on the Flop


*********** # 307 **************
PokerStars Hand #172156308499: Tournament #1648990476, $18.20+$1.80 USD=
 Hold'em No Limit - Level XXV (3500/7000) - 2017/07/06 23:31:17 ET
Table '1648990476 1' 9-max Seat #9 is the button
Seat 3: GMMK426 (202417 in chips)=20
Seat 4: JJin91 (143915 in chips)=20
Seat 5: jsulzman (511442 in chips)=20
Seat 6: helzkitchen (120356 in chips)=20
Seat 7: Paceman2jr (117653 in chips)=20
Seat 9: CerPrisingLe (254217 in chips)=20
GMMK426: posts the ante 875
JJin91: posts the ante 875
jsulzman: posts the ante 875
helzkitchen: posts the ante 875
Paceman2jr: posts the ante 875
CerPrisingLe: posts the ante 875
GMMK426: posts small blind 3500
JJin91: posts big blind 7000
*** HOLE CARDS ***
Dealt to JJin91 [Kd Jc]
jsulzman: folds=20
helzkitchen: folds=20
Paceman2jr: folds=20
CerPrisingLe: raises 7000 to 14000
GMMK426: calls 10500
JJin91: calls 7000
*** FLOP *** [Qs Ah 2s]
GMMK426: checks=20
JJin91: checks=20
CerPrisingLe: bets 28000
GMMK426: folds=20
JJin91: folds=20
Uncalled bet (28000) returned to CerPrisingLe
CerPrisingLe collected 47250 from pot
CerPrisingLe: doesn't show hand=20
*** SUMMARY ***
Total pot 47250 | Rake 0=20
Board [Qs Ah 2s]
Seat 3: GMMK426 (small blind) folded on the Flop
Seat 4: JJin91 (big blind) folded on the Flop
Seat 5: jsulzman folded before Flop (didn't bet)
Seat 6: helzkitchen folded before Flop (didn't bet)
Seat 7: Paceman2jr folded before Flop (didn't bet)
Seat 9: CerPrisingLe (button) collected (47250)


*********** # 308 **************
PokerStars Hand #172156308732: Tournament #1648990476, $18.20+$1.80 USD=
 Hold'em No Limit - Level XXV (3500/7000) - 2017/07/06 23:32:06 ET
Table '1648990476 1' 9-max Seat #3 is the button
Seat 3: GMMK426 (187542 in chips)=20
Seat 4: JJin91 (129040 in chips)=20
Seat 5: jsulzman (510567 in chips)=20
Seat 6: helzkitchen (119481 in chips)=20
Seat 7: Paceman2jr (116778 in chips)=20
Seat 9: CerPrisingLe (286592 in chips)=20
GMMK426: posts the ante 875
JJin91: posts the ante 875
jsulzman: posts the ante 875
helzkitchen: posts the ante 875
Paceman2jr: posts the ante 875
CerPrisingLe: posts the ante 875
JJin91: posts small blind 3500
jsulzman: posts big blind 7000
*** HOLE CARDS ***
Dealt to JJin91 [5d 8c]
helzkitchen: folds=20
Paceman2jr: folds=20
CerPrisingLe: raises 7000 to 14000
GMMK426: folds=20
JJin91: folds=20
jsulzman: calls 7000
*** FLOP *** [2c Kc 3h]
jsulzman: checks=20
CerPrisingLe: bets 14000
jsulzman: folds=20
Uncalled bet (14000) returned to CerPrisingLe
CerPrisingLe collected 36750 from pot
CerPrisingLe: doesn't show hand=20
*** SUMMARY ***
Total pot 36750 | Rake 0=20
Board [2c Kc 3h]
Seat 3: GMMK426 (button) folded before Flop (didn't bet)
Seat 4: JJin91 (small blind) folded before Flop
Seat 5: jsulzman (big blind) folded on the Flop
Seat 6: helzkitchen folded before Flop (didn't bet)
Seat 7: Paceman2jr folded before Flop (didn't bet)
Seat 9: CerPrisingLe collected (36750)


*********** # 309 **************
PokerStars Hand #172156308835: Tournament #1648990476, $18.20+$1.80 USD=
 Hold'em No Limit - Level XXV (3500/7000) - 2017/07/06 23:32:29 ET
Table '1648990476 1' 9-max Seat #4 is the button
Seat 3: GMMK426 (186667 in chips)=20
Seat 4: JJin91 (124665 in chips)=20
Seat 5: jsulzman (495692 in chips)=20
Seat 6: helzkitchen (118606 in chips)=20
Seat 7: Paceman2jr (115903 in chips)=20
Seat 9: CerPrisingLe (308467 in chips)=20
GMMK426: posts the ante 875
JJin91: posts the ante 875
jsulzman: posts the ante 875
helzkitchen: posts the ante 875
Paceman2jr: posts the ante 875
CerPrisingLe: posts the ante 875
jsulzman: posts small blind 3500
helzkitchen: posts big blind 7000
*** HOLE CARDS ***
Dealt to JJin91 [Jh 3s]
Paceman2jr: calls 7000
CerPrisingLe: folds=20
GMMK426: folds=20
JJin91: folds=20
jsulzman: raises 14000 to 21000
helzkitchen: folds=20
Paceman2jr: folds=20
Uncalled bet (14000) returned to jsulzman
jsulzman collected 26250 from pot
jsulzman: shows [7d 2h] (high card Seven)
*** SUMMARY ***
Total pot 26250 | Rake 0=20
Seat 3: GMMK426 folded before Flop (didn't bet)
Seat 4: JJin91 (button) folded before Flop (didn't bet)
Seat 5: jsulzman (small blind) collected (26250)
Seat 6: helzkitchen (big blind) folded before Flop
Seat 7: Paceman2jr folded before Flop
Seat 9: CerPrisingLe folded before Flop (didn't bet)


*********** # 310 **************
PokerStars Hand #172156308906: Tournament #1648990476, $18.20+$1.80 USD=
 Hold'em No Limit - Level XXV (3500/7000) - 2017/07/06 23:32:46 ET
Table '1648990476 1' 9-max Seat #5 is the button
Seat 3: GMMK426 (185792 in chips)=20
Seat 4: JJin91 (123790 in chips)=20
Seat 5: jsulzman (514067 in chips)=20
Seat 6: helzkitchen (110731 in chips)=20
Seat 7: Paceman2jr (108028 in chips)=20
Seat 9: CerPrisingLe (307592 in chips)=20
GMMK426: posts the ante 875
JJin91: posts the ante 875
jsulzman: posts the ante 875
helzkitchen: posts the ante 875
Paceman2jr: posts the ante 875
CerPrisingLe: posts the ante 875
helzkitchen: posts small blind 3500
Paceman2jr: posts big blind 7000
*** HOLE CARDS ***
Dealt to JJin91 [8c 7d]
CerPrisingLe: folds=20
GMMK426: folds=20
JJin91: folds=20
jsulzman: calls 7000
helzkitchen: raises 102856 to 109856 and is all-in
Paceman2jr: folds=20
jsulzman: folds=20
Uncalled bet (102856) returned to helzkitchen
helzkitchen collected 26250 from pot
helzkitchen: doesn't show hand=20
*** SUMMARY ***
Total pot 26250 | Rake 0=20
Seat 3: GMMK426 folded before Flop (didn't bet)
Seat 4: JJin91 folded before Flop (didn't bet)
Seat 5: jsulzman (button) folded before Flop
Seat 6: helzkitchen (small blind) collected (26250)
Seat 7: Paceman2jr (big blind) folded before Flop
Seat 9: CerPrisingLe folded before Flop (didn't bet)


*********** # 311 **************
PokerStars Hand #172156308970: Tournament #1648990476, $18.20+$1.80 USD=
 Hold'em No Limit - Level XXV (3500/7000) - 2017/07/06 23:33:01 ET
Table '1648990476 1' 9-max Seat #6 is the button
Seat 3: GMMK426 (184917 in chips)=20
Seat 4: JJin91 (122915 in chips)=20
Seat 5: jsulzman (506192 in chips)=20
Seat 6: helzkitchen (129106 in chips)=20
Seat 7: Paceman2jr (100153 in chips)=20
Seat 9: CerPrisingLe (306717 in chips)=20
GMMK426: posts the ante 875
JJin91: posts the ante 875
jsulzman: posts the ante 875
helzkitchen: posts the ante 875
Paceman2jr: posts the ante 875
CerPrisingLe: posts the ante 875
Paceman2jr: posts small blind 3500
CerPrisingLe: posts big blind 7000
*** HOLE CARDS ***
Dealt to JJin91 [3h Th]
GMMK426: folds=20
JJin91: folds=20
jsulzman: raises 7000 to 14000
helzkitchen: folds=20
Paceman2jr: folds=20
CerPrisingLe: calls 7000
*** FLOP *** [5c Ks Jd]
CerPrisingLe: checks=20
jsulzman: checks=20
*** TURN *** [5c Ks Jd] [Js]
CerPrisingLe: bets 27563
jsulzman: folds=20
Uncalled bet (27563) returned to CerPrisingLe
CerPrisingLe collected 36750 from pot
CerPrisingLe: doesn't show hand=20
*** SUMMARY ***
Total pot 36750 | Rake 0=20
Board [5c Ks Jd Js]
Seat 3: GMMK426 folded before Flop (didn't bet)
Seat 4: JJin91 folded before Flop (didn't bet)
Seat 5: jsulzman folded on the Turn
Seat 6: helzkitchen (button) folded before Flop (didn't bet)
Seat 7: Paceman2jr (small blind) folded before Flop
Seat 9: CerPrisingLe (big blind) collected (36750)


*********** # 312 **************
PokerStars Hand #172156309080: Tournament #1648990476, $18.20+$1.80 USD=
 Hold'em No Limit - Level XXVI (4000/8000) - 2017/07/06 23:33:26 ET
Table '1648990476 1' 9-max Seat #7 is the button
Seat 3: GMMK426 (184042 in chips)=20
Seat 4: JJin91 (122040 in chips)=20
Seat 5: jsulzman (491317 in chips)=20
Seat 6: helzkitchen (128231 in chips)=20
Seat 7: Paceman2jr (95778 in chips)=20
Seat 9: CerPrisingLe (328592 in chips)=20
GMMK426: posts the ante 1000
JJin91: posts the ante 1000
jsulzman: posts the ante 1000
helzkitchen: posts the ante 1000
Paceman2jr: posts the ante 1000
CerPrisingLe: posts the ante 1000
CerPrisingLe: posts small blind 4000
GMMK426: posts big blind 8000
*** HOLE CARDS ***
Dealt to JJin91 [6d Qc]
JJin91: folds=20
jsulzman: folds=20
helzkitchen: folds=20
Paceman2jr: folds=20
CerPrisingLe: raises 8000 to 16000
GMMK426: raises 167042 to 183042 and is all-in
CerPrisingLe: folds=20
Uncalled bet (167042) returned to GMMK426
GMMK426 collected 38000 from pot
GMMK426: doesn't show hand=20
*** SUMMARY ***
Total pot 38000 | Rake 0=20
Seat 3: GMMK426 (big blind) collected (38000)
Seat 4: JJin91 folded before Flop (didn't bet)
Seat 5: jsulzman folded before Flop (didn't bet)
Seat 6: helzkitchen folded before Flop (didn't bet)
Seat 7: Paceman2jr (button) folded before Flop (didn't bet)
Seat 9: CerPrisingLe (small blind) folded before Flop


*********** # 313 **************
PokerStars Hand #172156309161: Tournament #1648990476, $18.20+$1.80 USD=
 Hold'em No Limit - Level XXVI (4000/8000) - 2017/07/06 23:33:46 ET
Table '1648990476 1' 9-max Seat #9 is the button
Seat 3: GMMK426 (205042 in chips)=20
Seat 4: JJin91 (121040 in chips)=20
Seat 5: jsulzman (490317 in chips)=20
Seat 6: helzkitchen (127231 in chips)=20
Seat 7: Paceman2jr (94778 in chips)=20
Seat 9: CerPrisingLe (311592 in chips)=20
GMMK426: posts the ante 1000
JJin91: posts the ante 1000
jsulzman: posts the ante 1000
helzkitchen: posts the ante 1000
Paceman2jr: posts the ante 1000
CerPrisingLe: posts the ante 1000
GMMK426: posts small blind 4000
JJin91: posts big blind 8000
*** HOLE CARDS ***
Dealt to JJin91 [8d 4d]
jsulzman: raises 16000 to 24000
helzkitchen: folds=20
Paceman2jr: folds=20
CerPrisingLe: folds=20
GMMK426: folds=20
JJin91: folds=20
Uncalled bet (16000) returned to jsulzman
jsulzman collected 26000 from pot
*** SUMMARY ***
Total pot 26000 | Rake 0=20
Seat 3: GMMK426 (small blind) folded before Flop
Seat 4: JJin91 (big blind) folded before Flop
Seat 5: jsulzman collected (26000)
Seat 6: helzkitchen folded before Flop (didn't bet)
Seat 7: Paceman2jr folded before Flop (didn't bet)
Seat 9: CerPrisingLe (button) folded before Flop (didn't bet)


*********** # 314 **************
PokerStars Hand #172156309222: Tournament #1648990476, $18.20+$1.80 USD=
 Hold'em No Limit - Level XXVI (4000/8000) - 2017/07/06 23:34:01 ET
Table '1648990476 1' 9-max Seat #3 is the button
Seat 3: GMMK426 (200042 in chips)=20
Seat 4: JJin91 (112040 in chips)=20
Seat 5: jsulzman (507317 in chips)=20
Seat 6: helzkitchen (126231 in chips)=20
Seat 7: Paceman2jr (93778 in chips)=20
Seat 9: CerPrisingLe (310592 in chips)=20
GMMK426: posts the ante 1000
JJin91: posts the ante 1000
jsulzman: posts the ante 1000
helzkitchen: posts the ante 1000
Paceman2jr: posts the ante 1000
CerPrisingLe: posts the ante 1000
JJin91: posts small blind 4000
jsulzman: posts big blind 8000
*** HOLE CARDS ***
Dealt to JJin91 [Ah 8d]
helzkitchen: raises 117231 to 125231 and is all-in
Paceman2jr: folds=20
CerPrisingLe: folds=20
GMMK426: folds=20
JJin91: folds=20
jsulzman: calls 117231
*** FLOP *** [2s Tc Ac]
*** TURN *** [2s Tc Ac] [Kh]
*** RIVER *** [2s Tc Ac Kh] [Td]
*** SHOW DOWN ***
jsulzman: shows [As 4d] (two pair, Aces and Tens)
helzkitchen: shows [6d Ad] (two pair, Aces and Tens)
jsulzman collected 130231 from pot
helzkitchen collected 130231 from pot
*** SUMMARY ***
Total pot 260462 | Rake 0=20
Board [2s Tc Ac Kh Td]
Seat 3: GMMK426 (button) folded before Flop (didn't bet)
Seat 4: JJin91 (small blind) folded before Flop
Seat 5: jsulzman (big blind) showed [As 4d] and won (130231) with two p=
air, Aces and Tens
Seat 6: helzkitchen showed [6d Ad] and won (130231) with two pair, Aces=
 and Tens
Seat 7: Paceman2jr folded before Flop (didn't bet)
Seat 9: CerPrisingLe folded before Flop (didn't bet)


*********** # 315 **************
PokerStars Hand #172156309340: Tournament #1648990476, $18.20+$1.80 USD=
 Hold'em No Limit - Level XXVI (4000/8000) - 2017/07/06 23:34:27 ET
Table '1648990476 1' 9-max Seat #4 is the button
Seat 3: GMMK426 (199042 in chips)=20
Seat 4: JJin91 (107040 in chips)=20
Seat 5: jsulzman (511317 in chips)=20
Seat 6: helzkitchen (130231 in chips)=20
Seat 7: Paceman2jr (92778 in chips)=20
Seat 9: CerPrisingLe (309592 in chips)=20
GMMK426: posts the ante 1000
JJin91: posts the ante 1000
jsulzman: posts the ante 1000
helzkitchen: posts the ante 1000
Paceman2jr: posts the ante 1000
CerPrisingLe: posts the ante 1000
jsulzman: posts small blind 4000
helzkitchen: posts big blind 8000
*** HOLE CARDS ***
Dealt to JJin91 [Ac 6h]
Paceman2jr: folds=20
CerPrisingLe: raises 8000 to 16000
GMMK426: folds=20
JJin91: raises 90040 to 106040 and is all-in
jsulzman: folds=20
helzkitchen: folds=20
CerPrisingLe: calls 90040
*** FLOP *** [2d Jc Kh]
*** TURN *** [2d Jc Kh] [6c]
*** RIVER *** [2d Jc Kh 6c] [3h]
*** SHOW DOWN ***
CerPrisingLe: shows [6d 5d] (a pair of Sixes)
JJin91: shows [Ac 6h] (a pair of Sixes - Ace kicker)
JJin91 collected 230080 from pot
*** SUMMARY ***
Total pot 230080 | Rake 0=20
Board [2d Jc Kh 6c 3h]
Seat 3: GMMK426 folded before Flop (didn't bet)
Seat 4: JJin91 (button) showed [Ac 6h] and won (230080) with a pair of =
Sixes
Seat 5: jsulzman (small blind) folded before Flop
Seat 6: helzkitchen (big blind) folded before Flop
Seat 7: Paceman2jr folded before Flop (didn't bet)
Seat 9: CerPrisingLe showed [6d 5d] and lost with a pair of Sixes


*********** # 316 **************
PokerStars Hand #172156309473: Tournament #1648990476, $18.20+$1.80 USD=
 Hold'em No Limit - Level XXVI (4000/8000) - 2017/07/06 23:34:58 ET
Table '1648990476 1' 9-max Seat #5 is the button
Seat 3: GMMK426 (198042 in chips)=20
Seat 4: JJin91 (230080 in chips)=20
Seat 5: jsulzman (506317 in chips)=20
Seat 6: helzkitchen (121231 in chips)=20
Seat 7: Paceman2jr (91778 in chips)=20
Seat 9: CerPrisingLe (202552 in chips)=20
GMMK426: posts the ante 1000
JJin91: posts the ante 1000
jsulzman: posts the ante 1000
helzkitchen: posts the ante 1000
Paceman2jr: posts the ante 1000
CerPrisingLe: posts the ante 1000
helzkitchen: posts small blind 4000
Paceman2jr: posts big blind 8000
*** HOLE CARDS ***
Dealt to JJin91 [8d 7c]
CerPrisingLe: folds=20
GMMK426: raises 16000 to 24000
JJin91: folds=20
jsulzman: folds=20
helzkitchen: folds=20
Paceman2jr: folds=20
Uncalled bet (16000) returned to GMMK426
GMMK426 collected 26000 from pot
GMMK426: doesn't show hand=20
*** SUMMARY ***
Total pot 26000 | Rake 0=20
Seat 3: GMMK426 collected (26000)
Seat 4: JJin91 folded before Flop (didn't bet)
Seat 5: jsulzman (button) folded before Flop (didn't bet)
Seat 6: helzkitchen (small blind) folded before Flop
Seat 7: Paceman2jr (big blind) folded before Flop
Seat 9: CerPrisingLe folded before Flop (didn't bet)


*********** # 317 **************
PokerStars Hand #172156309527: Tournament #1648990476, $18.20+$1.80 USD=
 Hold'em No Limit - Level XXVI (4000/8000) - 2017/07/06 23:35:09 ET
Table '1648990476 1' 9-max Seat #6 is the button
Seat 3: GMMK426 (215042 in chips)=20
Seat 4: JJin91 (229080 in chips)=20
Seat 5: jsulzman (505317 in chips)=20
Seat 6: helzkitchen (116231 in chips)=20
Seat 7: Paceman2jr (82778 in chips)=20
Seat 9: CerPrisingLe (201552 in chips)=20
GMMK426: posts the ante 1000
JJin91: posts the ante 1000
jsulzman: posts the ante 1000
helzkitchen: posts the ante 1000
Paceman2jr: posts the ante 1000
CerPrisingLe: posts the ante 1000
Paceman2jr: posts small blind 4000
CerPrisingLe: posts big blind 8000
*** HOLE CARDS ***
Dealt to JJin91 [Kh 7h]
GMMK426: folds=20
JJin91: folds=20
jsulzman: folds=20
helzkitchen: folds=20
Paceman2jr: folds=20
Uncalled bet (4000) returned to CerPrisingLe
CerPrisingLe collected 14000 from pot
CerPrisingLe: doesn't show hand=20
*** SUMMARY ***
Total pot 14000 | Rake 0=20
Seat 3: GMMK426 folded before Flop (didn't bet)
Seat 4: JJin91 folded before Flop (didn't bet)
Seat 5: jsulzman folded before Flop (didn't bet)
Seat 6: helzkitchen (button) folded before Flop (didn't bet)
Seat 7: Paceman2jr (small blind) folded before Flop
Seat 9: CerPrisingLe (big blind) collected (14000)


*********** # 318 **************
PokerStars Hand #172156309556: Tournament #1648990476, $18.20+$1.80 USD=
 Hold'em No Limit - Level XXVI (4000/8000) - 2017/07/06 23:35:17 ET
Table '1648990476 1' 9-max Seat #7 is the button
Seat 3: GMMK426 (214042 in chips)=20
Seat 4: JJin91 (228080 in chips)=20
Seat 5: jsulzman (504317 in chips)=20
Seat 6: helzkitchen (115231 in chips)=20
Seat 7: Paceman2jr (77778 in chips)=20
Seat 9: CerPrisingLe (210552 in chips)=20
GMMK426: posts the ante 1000
JJin91: posts the ante 1000
jsulzman: posts the ante 1000
helzkitchen: posts the ante 1000
Paceman2jr: posts the ante 1000
CerPrisingLe: posts the ante 1000
CerPrisingLe: posts small blind 4000
GMMK426: posts big blind 8000
*** HOLE CARDS ***
Dealt to JJin91 [6h Qs]
JJin91: folds=20
jsulzman: folds=20
helzkitchen: folds=20
Paceman2jr: raises 68778 to 76778 and is all-in
CerPrisingLe: folds=20
GMMK426: calls 68778
*** FLOP *** [5c Ks Kh]
*** TURN *** [5c Ks Kh] [9h]
*** RIVER *** [5c Ks Kh 9h] [Js]
*** SHOW DOWN ***
GMMK426: shows [Ah As] (two pair, Aces and Kings)
Paceman2jr: shows [9d Td] (two pair, Kings and Nines)
GMMK426 collected 163556 from pot
Paceman2jr finished the tournament in 6th place and received $122.85.
*** SUMMARY ***
Total pot 163556 | Rake 0=20
Board [5c Ks Kh 9h Js]
Seat 3: GMMK426 (big blind) showed [Ah As] and won (163556) with two pa=
ir, Aces and Kings
Seat 4: JJin91 folded before Flop (didn't bet)
Seat 5: jsulzman folded before Flop (didn't bet)
Seat 6: helzkitchen folded before Flop (didn't bet)
Seat 7: Paceman2jr (button) showed [9d Td] and lost with two pair, King=
s and Nines
Seat 9: CerPrisingLe (small blind) folded before Flop


*********** # 319 **************
PokerStars Hand #172156309632: Tournament #1648990476, $18.20+$1.80 USD=
 Hold'em No Limit - Level XXVI (4000/8000) - 2017/07/06 23:35:36 ET
Table '1648990476 1' 9-max Seat #9 is the button
Seat 3: GMMK426 (299820 in chips)=20
Seat 4: JJin91 (227080 in chips)=20
Seat 5: jsulzman (503317 in chips)=20
Seat 6: helzkitchen (114231 in chips)=20
Seat 9: CerPrisingLe (205552 in chips)=20
GMMK426: posts the ante 1000
JJin91: posts the ante 1000
jsulzman: posts the ante 1000
helzkitchen: posts the ante 1000
CerPrisingLe: posts the ante 1000
GMMK426: posts small blind 4000
JJin91: posts big blind 8000
*** HOLE CARDS ***
Dealt to JJin91 [Qc 5c]
jsulzman: folds=20
helzkitchen: folds=20
CerPrisingLe: folds=20
GMMK426: calls 4000
JJin91: checks=20
*** FLOP *** [Jd 4s 7c]
GMMK426: checks=20
JJin91: bets 8888
GMMK426: folds=20
Uncalled bet (8888) returned to JJin91
JJin91 collected 21000 from pot
JJin91: doesn't show hand=20
*** SUMMARY ***
Total pot 21000 | Rake 0=20
Board [Jd 4s 7c]
Seat 3: GMMK426 (small blind) folded on the Flop
Seat 4: JJin91 (big blind) collected (21000)
Seat 5: jsulzman folded before Flop (didn't bet)
Seat 6: helzkitchen folded before Flop (didn't bet)
Seat 9: CerPrisingLe (button) folded before Flop (didn't bet)


*********** # 320 **************
PokerStars Hand #172156309734: Tournament #1648990476, $18.20+$1.80 USD=
 Hold'em No Limit - Level XXVI (4000/8000) - 2017/07/06 23:36:03 ET
Table '1648990476 1' 9-max Seat #3 is the button
Seat 3: GMMK426 (290820 in chips)=20
Seat 4: JJin91 (239080 in chips)=20
Seat 5: jsulzman (502317 in chips)=20
Seat 6: helzkitchen (113231 in chips)=20
Seat 9: CerPrisingLe (204552 in chips)=20
GMMK426: posts the ante 1000
JJin91: posts the ante 1000
jsulzman: posts the ante 1000
helzkitchen: posts the ante 1000
CerPrisingLe: posts the ante 1000
JJin91: posts small blind 4000
jsulzman: posts big blind 8000
*** HOLE CARDS ***
Dealt to JJin91 [Th 3h]
helzkitchen: folds=20
CerPrisingLe: folds=20
GMMK426: folds=20
JJin91: calls 4000
jsulzman: raises 16000 to 24000
JJin91: folds=20
Uncalled bet (16000) returned to jsulzman
jsulzman collected 21000 from pot
*** SUMMARY ***
Total pot 21000 | Rake 0=20
Seat 3: GMMK426 (button) folded before Flop (didn't bet)
Seat 4: JJin91 (small blind) folded before Flop
Seat 5: jsulzman (big blind) collected (21000)
Seat 6: helzkitchen folded before Flop (didn't bet)
Seat 9: CerPrisingLe folded before Flop (didn't bet)


*********** # 321 **************
PokerStars Hand #172156309823: Tournament #1648990476, $18.20+$1.80 USD=
 Hold'em No Limit - Level XXVI (4000/8000) - 2017/07/06 23:36:23 ET
Table '1648990476 1' 9-max Seat #4 is the button
Seat 3: GMMK426 (289820 in chips)=20
Seat 4: JJin91 (230080 in chips)=20
Seat 5: jsulzman (514317 in chips)=20
Seat 6: helzkitchen (112231 in chips)=20
Seat 9: CerPrisingLe (203552 in chips)=20
GMMK426: posts the ante 1000
JJin91: posts the ante 1000
jsulzman: posts the ante 1000
helzkitchen: posts the ante 1000
CerPrisingLe: posts the ante 1000
jsulzman: posts small blind 4000
helzkitchen: posts big blind 8000
*** HOLE CARDS ***
Dealt to JJin91 [Ah 6d]
CerPrisingLe: folds=20
GMMK426: folds=20
JJin91: raises 8880 to 16880
jsulzman: calls 12880
helzkitchen: calls 8880
*** FLOP *** [6h Tc Jh]
jsulzman: bets 8000
helzkitchen: calls 8000
JJin91: folds=20
*** TURN *** [6h Tc Jh] [5h]
jsulzman: bets 35820
helzkitchen: raises 50531 to 86351 and is all-in
jsulzman: folds=20
Uncalled bet (50531) returned to helzkitchen
helzkitchen collected 143280 from pot
helzkitchen: doesn't show hand=20
*** SUMMARY ***
Total pot 143280 | Rake 0=20
Board [6h Tc Jh 5h]
Seat 3: GMMK426 folded before Flop (didn't bet)
Seat 4: JJin91 (button) folded on the Flop
Seat 5: jsulzman (small blind) folded on the Turn
Seat 6: helzkitchen (big blind) collected (143280)
Seat 9: CerPrisingLe folded before Flop (didn't bet)


*********** # 322 **************
PokerStars Hand #172156847106: Tournament #1648990476, $18.20+$1.80 USD=
 Hold'em No Limit - Level XXVI (4000/8000) - 2017/07/06 23:37:06 ET
Table '1648990476 1' 9-max Seat #5 is the button
Seat 3: GMMK426 (288820 in chips)=20
Seat 4: JJin91 (212200 in chips)=20
Seat 5: jsulzman (452617 in chips)=20
Seat 6: helzkitchen (193811 in chips)=20
Seat 9: CerPrisingLe (202552 in chips)=20
GMMK426: posts the ante 1000
JJin91: posts the ante 1000
jsulzman: posts the ante 1000
helzkitchen: posts the ante 1000
CerPrisingLe: posts the ante 1000
helzkitchen: posts small blind 4000
CerPrisingLe: posts big blind 8000
*** HOLE CARDS ***
Dealt to JJin91 [Qc 6d]
GMMK426: calls 8000
JJin91: folds=20
jsulzman: folds=20
helzkitchen: folds=20
CerPrisingLe: checks=20
*** FLOP *** [4c 3h Th]
CerPrisingLe: checks=20
GMMK426: checks=20
*** TURN *** [4c 3h Th] [5s]
CerPrisingLe: bets 8000
GMMK426: folds=20
Uncalled bet (8000) returned to CerPrisingLe
CerPrisingLe collected 25000 from pot
CerPrisingLe: doesn't show hand=20
*** SUMMARY ***
Total pot 25000 | Rake 0=20
Board [4c 3h Th 5s]
Seat 3: GMMK426 folded on the Turn
Seat 4: JJin91 folded before Flop (didn't bet)
Seat 5: jsulzman (button) folded before Flop (didn't bet)
Seat 6: helzkitchen (small blind) folded before Flop
Seat 9: CerPrisingLe (big blind) collected (25000)


*********** # 323 **************
PokerStars Hand #172156847172: Tournament #1648990476, $18.20+$1.80 USD=
 Hold'em No Limit - Level XXVI (4000/8000) - 2017/07/06 23:37:25 ET
Table '1648990476 1' 9-max Seat #6 is the button
Seat 3: GMMK426 (279820 in chips)=20
Seat 4: JJin91 (211200 in chips)=20
Seat 5: jsulzman (451617 in chips)=20
Seat 6: helzkitchen (188811 in chips)=20
Seat 9: CerPrisingLe (218552 in chips)=20
GMMK426: posts the ante 1000
JJin91: posts the ante 1000
jsulzman: posts the ante 1000
helzkitchen: posts the ante 1000
CerPrisingLe: posts the ante 1000
CerPrisingLe: posts small blind 4000
GMMK426: posts big blind 8000
*** HOLE CARDS ***
Dealt to JJin91 [9c Kh]
JJin91: raises 8880 to 16880
jsulzman: calls 16880
helzkitchen: folds=20
CerPrisingLe: folds=20
GMMK426: calls 8880
*** FLOP *** [Qc As Ah]
GMMK426: checks=20
JJin91: bets 19681
jsulzman: calls 19681
GMMK426: folds=20
*** TURN *** [Qc As Ah] [3d]
JJin91: bets 33333
jsulzman: calls 33333
*** RIVER *** [Qc As Ah 3d] [Kd]
JJin91: bets 54670
jsulzman: folds=20
Uncalled bet (54670) returned to JJin91
JJin91 collected 165668 from pot
JJin91: doesn't show hand=20
*** SUMMARY ***
Total pot 165668 | Rake 0=20
Board [Qc As Ah 3d Kd]
Seat 3: GMMK426 (big blind) folded on the Flop
Seat 4: JJin91 collected (165668)
Seat 5: jsulzman folded on the River
Seat 6: helzkitchen (button) folded before Flop (didn't bet)
Seat 9: CerPrisingLe (small blind) folded before Flop


*********** # 324 **************
PokerStars Hand #172156847388: Tournament #1648990476, $18.20+$1.80 USD=
 Hold'em No Limit - Level XXVI (4000/8000) - 2017/07/06 23:38:20 ET
Table '1648990476 1' 9-max Seat #9 is the button
Seat 3: GMMK426 (261940 in chips)=20
Seat 4: JJin91 (305974 in chips)=20
Seat 5: jsulzman (380723 in chips)=20
Seat 6: helzkitchen (187811 in chips)=20
Seat 9: CerPrisingLe (213552 in chips)=20
GMMK426: posts the ante 1000
JJin91: posts the ante 1000
jsulzman: posts the ante 1000
helzkitchen: posts the ante 1000
CerPrisingLe: posts the ante 1000
GMMK426: posts small blind 4000
JJin91: posts big blind 8000
*** HOLE CARDS ***
Dealt to JJin91 [Ks As]
jsulzman: folds=20
helzkitchen: folds=20
CerPrisingLe: folds=20
GMMK426: calls 4000
JJin91: raises 18160 to 26160
GMMK426: folds=20
Uncalled bet (18160) returned to JJin91
JJin91 collected 21000 from pot
JJin91: doesn't show hand=20
*** SUMMARY ***
Total pot 21000 | Rake 0=20
Seat 3: GMMK426 (small blind) folded before Flop
Seat 4: JJin91 (big blind) collected (21000)
Seat 5: jsulzman folded before Flop (didn't bet)
Seat 6: helzkitchen folded before Flop (didn't bet)
Seat 9: CerPrisingLe (button) folded before Flop (didn't bet)


*********** # 325 **************
PokerStars Hand #172156847473: Tournament #1648990476, $18.20+$1.80 USD=
 Hold'em No Limit - Level XXVI (4000/8000) - 2017/07/06 23:38:43 ET
Table '1648990476 1' 9-max Seat #3 is the button
Seat 3: GMMK426 (252940 in chips)=20
Seat 4: JJin91 (317974 in chips)=20
Seat 5: jsulzman (379723 in chips)=20
Seat 6: helzkitchen (186811 in chips)=20
Seat 9: CerPrisingLe (212552 in chips)=20
GMMK426: posts the ante 1000
JJin91: posts the ante 1000
jsulzman: posts the ante 1000
helzkitchen: posts the ante 1000
CerPrisingLe: posts the ante 1000
JJin91: posts small blind 4000
jsulzman: posts big blind 8000
*** HOLE CARDS ***
Dealt to JJin91 [7s 8h]
helzkitchen: folds=20
CerPrisingLe: folds=20
GMMK426: folds=20
JJin91: calls 4000
jsulzman: checks=20
*** FLOP *** [2s Qh 4c]
JJin91: checks=20
jsulzman: bets 8000
JJin91: calls 8000
*** TURN *** [2s Qh 4c] [Ad]
JJin91: checks=20
jsulzman: bets 8000
JJin91: calls 8000
*** RIVER *** [2s Qh 4c Ad] [3d]
JJin91: bets 25970
jsulzman: calls 25970
*** SHOW DOWN ***
JJin91: shows [7s 8h] (high card Ace)
jsulzman: shows [4d 7h] (a pair of Fours)
jsulzman collected 104940 from pot
*** SUMMARY ***
Total pot 104940 | Rake 0=20
Board [2s Qh 4c Ad 3d]
Seat 3: GMMK426 (button) folded before Flop (didn't bet)
Seat 4: JJin91 (small blind) showed [7s 8h] and lost with high card Ace
Seat 5: jsulzman (big blind) showed [4d 7h] and won (104940) with a pai=
r of Fours
Seat 6: helzkitchen folded before Flop (didn't bet)
Seat 9: CerPrisingLe folded before Flop (didn't bet)


*********** # 326 **************
PokerStars Hand #172156847681: Tournament #1648990476, $18.20+$1.80 USD=
 Hold'em No Limit - Level XXVI (4000/8000) - 2017/07/06 23:39:36 ET
Table '1648990476 1' 9-max Seat #4 is the button
Seat 3: GMMK426 (251940 in chips)=20
Seat 4: JJin91 (267004 in chips)=20
Seat 5: jsulzman (433693 in chips)=20
Seat 6: helzkitchen (185811 in chips)=20
Seat 9: CerPrisingLe (211552 in chips)=20
GMMK426: posts the ante 1000
JJin91: posts the ante 1000
jsulzman: posts the ante 1000
helzkitchen: posts the ante 1000
CerPrisingLe: posts the ante 1000
jsulzman: posts small blind 4000
helzkitchen: posts big blind 8000
*** HOLE CARDS ***
Dealt to JJin91 [8c 8h]
CerPrisingLe: raises 8000 to 16000
GMMK426: calls 16000
JJin91: calls 16000
jsulzman: folds=20
helzkitchen: folds=20
*** FLOP *** [8d Kd 6h]
CerPrisingLe: bets 16000
GMMK426: raises 218940 to 234940 and is all-in
JJin91: raises 15064 to 250004 and is all-in
CerPrisingLe: folds=20
Uncalled bet (15064) returned to JJin91
*** TURN *** [8d Kd 6h] [3c]
*** RIVER *** [8d Kd 6h 3c] [Ac]
*** SHOW DOWN ***
GMMK426: shows [Ks Jd] (a pair of Kings)
JJin91: shows [8c 8h] (three of a kind, Eights)
JJin91 collected 550880 from pot
GMMK426 finished the tournament in 5th place and received $147.42.
*** SUMMARY ***
Total pot 550880 | Rake 0=20
Board [8d Kd 6h 3c Ac]
Seat 3: GMMK426 showed [Ks Jd] and lost with a pair of Kings
Seat 4: JJin91 (button) showed [8c 8h] and won (550880) with three of a=
 kind, Eights
Seat 5: jsulzman (small blind) folded before Flop
Seat 6: helzkitchen (big blind) folded before Flop
Seat 9: CerPrisingLe folded on the Flop


*********** # 327 **************
PokerStars Hand #172156847823: Tournament #1648990476, $18.20+$1.80 USD=
 Hold'em No Limit - Level XXVI (4000/8000) - 2017/07/06 23:40:11 ET
Table '1648990476 1' 9-max Seat #5 is the button
Seat 4: JJin91 (565944 in chips)=20
Seat 5: jsulzman (428693 in chips)=20
Seat 6: helzkitchen (176811 in chips)=20
Seat 9: CerPrisingLe (178552 in chips)=20
JJin91: posts the ante 1000
jsulzman: posts the ante 1000
helzkitchen: posts the ante 1000
CerPrisingLe: posts the ante 1000
helzkitchen: posts small blind 4000
CerPrisingLe: posts big blind 8000
*** HOLE CARDS ***
Dealt to JJin91 [Ac As]
JJin91: raises 8880 to 16880
jsulzman: raises 23120 to 40000
helzkitchen: folds=20
CerPrisingLe: folds=20
JJin91: raises 59999 to 99999
jsulzman: calls 59999
*** FLOP *** [3d Tc Js]
JJin91: checks=20
jsulzman: checks=20
*** TURN *** [3d Tc Js] [2d]
JJin91: bets 148892
jsulzman: calls 148892
*** RIVER *** [3d Tc Js 2d] [9c]
JJin91: checks=20
jsulzman: bets 178802 and is all-in
JJin91: calls 178802
*** SHOW DOWN ***
jsulzman: shows [Kc Qs] (a straight, Nine to King)
JJin91: shows [Ac As] (a pair of Aces)
jsulzman collected 871386 from pot
*** SUMMARY ***
Total pot 871386 | Rake 0=20
Board [3d Tc Js 2d 9c]
Seat 4: JJin91 showed [Ac As] and lost with a pair of Aces
Seat 5: jsulzman (button) showed [Kc Qs] and won (871386) with a straig=
ht, Nine to King
Seat 6: helzkitchen (small blind) folded before Flop
Seat 9: CerPrisingLe (big blind) folded before Flop


*********** # 328 **************
PokerStars Hand #172156848281: Tournament #1648990476, $18.20+$1.80 USD=
 Hold'em No Limit - Level XXVI (4000/8000) - 2017/07/06 23:42:04 ET
Table '1648990476 1' 9-max Seat #6 is the button
Seat 4: JJin91 (137251 in chips)=20
Seat 5: jsulzman (871386 in chips)=20
Seat 6: helzkitchen (171811 in chips)=20
Seat 9: CerPrisingLe (169552 in chips)=20
JJin91: posts the ante 1000
jsulzman: posts the ante 1000
helzkitchen: posts the ante 1000
CerPrisingLe: posts the ante 1000
CerPrisingLe: posts small blind 4000
JJin91: posts big blind 8000
*** HOLE CARDS ***
Dealt to JJin91 [Ah Qs]
jsulzman: folds=20
helzkitchen: folds=20
CerPrisingLe: calls 4000
JJin91: raises 18160 to 26160
CerPrisingLe: calls 18160
*** FLOP *** [7c 4h 9c]
CerPrisingLe: checks=20
JJin91: checks=20
*** TURN *** [7c 4h 9c] [4s]
CerPrisingLe: bets 24000
JJin91: calls 24000
*** RIVER *** [7c 4h 9c 4s] [9h]
CerPrisingLe: checks=20
JJin91: checks=20
*** SHOW DOWN ***
CerPrisingLe: shows [Jd 5h] (two pair, Nines and Fours)
JJin91: shows [Ah Qs] (two pair, Nines and Fours - Ace kicker)
JJin91 collected 104320 from pot
*** SUMMARY ***
Total pot 104320 | Rake 0=20
Board [7c 4h 9c 4s 9h]
Seat 4: JJin91 (big blind) showed [Ah Qs] and won (104320) with two pai=
r, Nines and Fours
Seat 5: jsulzman folded before Flop (didn't bet)
Seat 6: helzkitchen (button) folded before Flop (didn't bet)
Seat 9: CerPrisingLe (small blind) showed [Jd 5h] and lost with two pai=
r, Nines and Fours


*********** # 329 **************
PokerStars Hand #172156848483: Tournament #1648990476, $18.20+$1.80 USD=
 Hold'em No Limit - Level XXVI (4000/8000) - 2017/07/06 23:42:52 ET
Table '1648990476 1' 9-max Seat #9 is the button
Seat 4: JJin91 (190411 in chips)=20
Seat 5: jsulzman (870386 in chips)=20
Seat 6: helzkitchen (170811 in chips)=20
Seat 9: CerPrisingLe (118392 in chips)=20
JJin91: posts the ante 1000
jsulzman: posts the ante 1000
helzkitchen: posts the ante 1000
CerPrisingLe: posts the ante 1000
JJin91: posts small blind 4000
jsulzman: posts big blind 8000
*** HOLE CARDS ***
Dealt to JJin91 [9d 3c]
helzkitchen: raises 161811 to 169811 and is all-in
CerPrisingLe: folds=20
JJin91: folds=20
jsulzman: folds=20
Uncalled bet (161811) returned to helzkitchen
helzkitchen collected 24000 from pot
helzkitchen: doesn't show hand=20
*** SUMMARY ***
Total pot 24000 | Rake 0=20
Seat 4: JJin91 (small blind) folded before Flop
Seat 5: jsulzman (big blind) folded before Flop
Seat 6: helzkitchen collected (24000)
Seat 9: CerPrisingLe (button) folded before Flop (didn't bet)


*********** # 330 **************
PokerStars Hand #172156848527: Tournament #1648990476, $18.20+$1.80 USD=
 Hold'em No Limit - Level XXVI (4000/8000) - 2017/07/06 23:43:05 ET
Table '1648990476 1' 9-max Seat #4 is the button
Seat 4: JJin91 (185411 in chips)=20
Seat 5: jsulzman (861386 in chips)=20
Seat 6: helzkitchen (185811 in chips)=20
Seat 9: CerPrisingLe (117392 in chips)=20
JJin91: posts the ante 1000
jsulzman: posts the ante 1000
helzkitchen: posts the ante 1000
CerPrisingLe: posts the ante 1000
jsulzman: posts small blind 4000
helzkitchen: posts big blind 8000
*** HOLE CARDS ***
Dealt to JJin91 [4h 7c]
CerPrisingLe: folds=20
JJin91: folds=20
jsulzman: calls 4000
helzkitchen: raises 176811 to 184811 and is all-in
jsulzman: folds=20
Uncalled bet (176811) returned to helzkitchen
helzkitchen collected 20000 from pot
helzkitchen: doesn't show hand=20
*** SUMMARY ***
Total pot 20000 | Rake 0=20
Seat 4: JJin91 (button) folded before Flop (didn't bet)
Seat 5: jsulzman (small blind) folded before Flop
Seat 6: helzkitchen (big blind) collected (20000)
Seat 9: CerPrisingLe folded before Flop (didn't bet)


*********** # 331 **************
PokerStars Hand #172156848659: Tournament #1648990476, $18.20+$1.80 USD=
 Hold'em No Limit - Level XXVII (5000/10000) - 2017/07/06 23:43:36 ET
Table '1648990476 1' 9-max Seat #5 is the button
Seat 4: JJin91 (184411 in chips)=20
Seat 5: jsulzman (852386 in chips)=20
Seat 6: helzkitchen (196811 in chips)=20
Seat 9: CerPrisingLe (116392 in chips)=20
JJin91: posts the ante 1250
jsulzman: posts the ante 1250
helzkitchen: posts the ante 1250
CerPrisingLe: posts the ante 1250
helzkitchen: posts small blind 5000
CerPrisingLe: posts big blind 10000
*** HOLE CARDS ***
Dealt to JJin91 [4h 4d]
JJin91: raises 11100 to 21100
jsulzman: calls 21100
helzkitchen: folds=20
CerPrisingLe: folds=20
*** FLOP *** [5d Ad 7h]
JJin91: checks=20
jsulzman: bets 31100
JJin91: folds=20
Uncalled bet (31100) returned to jsulzman
jsulzman collected 62200 from pot
jsulzman: shows [Ac Ts] (a pair of Aces)
*** SUMMARY ***
Total pot 62200 | Rake 0=20
Board [5d Ad 7h]
Seat 4: JJin91 folded on the Flop
Seat 5: jsulzman (button) collected (62200)
Seat 6: helzkitchen (small blind) folded before Flop
Seat 9: CerPrisingLe (big blind) folded before Flop


*********** # 332 **************
PokerStars Hand #172156848778: Tournament #1648990476, $18.20+$1.80 USD=
 Hold'em No Limit - Level XXVII (5000/10000) - 2017/07/06 23:44:07 ET
Table '1648990476 1' 9-max Seat #6 is the button
Seat 4: JJin91 (162061 in chips)=20
Seat 5: jsulzman (892236 in chips)=20
Seat 6: helzkitchen (190561 in chips)=20
Seat 9: CerPrisingLe (105142 in chips)=20
JJin91: posts the ante 1250
jsulzman: posts the ante 1250
helzkitchen: posts the ante 1250
CerPrisingLe: posts the ante 1250
CerPrisingLe: posts small blind 5000
JJin91: posts big blind 10000
*** HOLE CARDS ***
Dealt to JJin91 [9d 6h]
jsulzman: calls 10000
helzkitchen: folds=20
CerPrisingLe: calls 5000
JJin91: checks=20
*** FLOP *** [3s 3d Kc]
CerPrisingLe: checks=20
JJin91: checks=20
jsulzman: checks=20
*** TURN *** [3s 3d Kc] [9s]
CerPrisingLe: bets 10000
JJin91: calls 10000
jsulzman: folds=20
*** RIVER *** [3s 3d Kc 9s] [Jd]
CerPrisingLe: bets 10000
JJin91: calls 10000
*** SHOW DOWN ***
CerPrisingLe: shows [4s Js] (two pair, Jacks and Threes)
JJin91: mucks hand=20
CerPrisingLe collected 75000 from pot
*** SUMMARY ***
Total pot 75000 | Rake 0=20
Board [3s 3d Kc 9s Jd]
Seat 4: JJin91 (big blind) mucked [9d 6h]
Seat 5: jsulzman folded on the Turn
Seat 6: helzkitchen (button) folded before Flop (didn't bet)
Seat 9: CerPrisingLe (small blind) showed [4s Js] and won (75000) with =
two pair, Jacks and Threes


*********** # 333 **************
PokerStars Hand #172156848894: Tournament #1648990476, $18.20+$1.80 USD=
 Hold'em No Limit - Level XXVII (5000/10000) - 2017/07/06 23:44:38 ET
Table '1648990476 1' 9-max Seat #9 is the button
Seat 4: JJin91 (130811 in chips)=20
Seat 5: jsulzman (880986 in chips)=20
Seat 6: helzkitchen (189311 in chips)=20
Seat 9: CerPrisingLe (148892 in chips)=20
JJin91: posts the ante 1250
jsulzman: posts the ante 1250
helzkitchen: posts the ante 1250
CerPrisingLe: posts the ante 1250
JJin91: posts small blind 5000
jsulzman: posts big blind 10000
*** HOLE CARDS ***
Dealt to JJin91 [7h 8h]
helzkitchen: folds=20
CerPrisingLe: folds=20
JJin91: calls 5000
jsulzman: checks=20
*** FLOP *** [9s 8s Qh]
JJin91: checks=20
jsulzman: bets 10000
JJin91: raises 11344 to 21344
jsulzman: calls 11344
*** TURN *** [9s 8s Qh] [Kh]
JJin91: checks=20
jsulzman: checks=20
*** RIVER *** [9s 8s Qh Kh] [Kc]
JJin91: checks=20
jsulzman: bets 33844
JJin91: folds=20
Uncalled bet (33844) returned to jsulzman
jsulzman collected 67688 from pot
*** SUMMARY ***
Total pot 67688 | Rake 0=20
Board [9s 8s Qh Kh Kc]
Seat 4: JJin91 (small blind) folded on the River
Seat 5: jsulzman (big blind) collected (67688)
Seat 6: helzkitchen folded before Flop (didn't bet)
Seat 9: CerPrisingLe (button) folded before Flop (didn't bet)


*********** # 334 **************
PokerStars Hand #172156849138: Tournament #1648990476, $18.20+$1.80 USD=
 Hold'em No Limit - Level XXVII (5000/10000) - 2017/07/06 23:45:37 ET
Table '1648990476 1' 9-max Seat #4 is the button
Seat 4: JJin91 (98217 in chips)=20
Seat 5: jsulzman (916080 in chips)=20
Seat 6: helzkitchen (188061 in chips)=20
Seat 9: CerPrisingLe (147642 in chips)=20
JJin91: posts the ante 1250
jsulzman: posts the ante 1250
helzkitchen: posts the ante 1250
CerPrisingLe: posts the ante 1250
jsulzman: posts small blind 5000
helzkitchen: posts big blind 10000
*** HOLE CARDS ***
Dealt to JJin91 [6d 2c]
CerPrisingLe: folds=20
JJin91: folds=20
jsulzman: calls 5000
helzkitchen: checks=20
*** FLOP *** [Qs Kc 7d]
jsulzman: bets 10000
helzkitchen: calls 10000
*** TURN *** [Qs Kc 7d] [5d]
jsulzman: bets 10000
helzkitchen: calls 10000
*** RIVER *** [Qs Kc 7d 5d] [3d]
jsulzman: bets 65000
helzkitchen: folds=20
Uncalled bet (65000) returned to jsulzman
jsulzman collected 65000 from pot
*** SUMMARY ***
Total pot 65000 | Rake 0=20
Board [Qs Kc 7d 5d 3d]
Seat 4: JJin91 (button) folded before Flop (didn't bet)
Seat 5: jsulzman (small blind) collected (65000)
Seat 6: helzkitchen (big blind) folded on the River
Seat 9: CerPrisingLe folded before Flop (didn't bet)


*********** # 335 **************
PokerStars Hand #172156849243: Tournament #1648990476, $18.20+$1.80 USD=
 Hold'em No Limit - Level XXVII (5000/10000) - 2017/07/06 23:46:04 ET
Table '1648990476 1' 9-max Seat #5 is the button
Seat 4: JJin91 (96967 in chips)=20
Seat 5: jsulzman (949830 in chips)=20
Seat 6: helzkitchen (156811 in chips)=20
Seat 9: CerPrisingLe (146392 in chips)=20
JJin91: posts the ante 1250
jsulzman: posts the ante 1250
helzkitchen: posts the ante 1250
CerPrisingLe: posts the ante 1250
helzkitchen: posts small blind 5000
CerPrisingLe: posts big blind 10000
*** HOLE CARDS ***
Dealt to JJin91 [7d 8c]
JJin91: folds=20
jsulzman: raises 20000 to 30000
helzkitchen: folds=20
CerPrisingLe: folds=20
Uncalled bet (20000) returned to jsulzman
jsulzman collected 30000 from pot
*** SUMMARY ***
Total pot 30000 | Rake 0=20
Seat 4: JJin91 folded before Flop (didn't bet)
Seat 5: jsulzman (button) collected (30000)
Seat 6: helzkitchen (small blind) folded before Flop
Seat 9: CerPrisingLe (big blind) folded before Flop


*********** # 336 **************
PokerStars Hand #172156849285: Tournament #1648990476, $18.20+$1.80 USD=
 Hold'em No Limit - Level XXVII (5000/10000) - 2017/07/06 23:46:14 ET
Table '1648990476 1' 9-max Seat #6 is the button
Seat 4: JJin91 (95717 in chips)=20
Seat 5: jsulzman (968580 in chips)=20
Seat 6: helzkitchen (150561 in chips)=20
Seat 9: CerPrisingLe (135142 in chips)=20
JJin91: posts the ante 1250
jsulzman: posts the ante 1250
helzkitchen: posts the ante 1250
CerPrisingLe: posts the ante 1250
CerPrisingLe: posts small blind 5000
JJin91: posts big blind 10000
*** HOLE CARDS ***
Dealt to JJin91 [Qd Jd]
jsulzman: raises 20000 to 30000
helzkitchen: folds=20
CerPrisingLe: folds=20
JJin91: raises 64467 to 94467 and is all-in
jsulzman: calls 64467
*** FLOP *** [9d 8c Kd]
*** TURN *** [9d 8c Kd] [Kc]
*** RIVER *** [9d 8c Kd Kc] [2s]
*** SHOW DOWN ***
JJin91: shows [Qd Jd] (a pair of Kings)
jsulzman: shows [3d Qh] (a pair of Kings - lower kicker)
JJin91 collected 198934 from pot
*** SUMMARY ***
Total pot 198934 | Rake 0=20
Board [9d 8c Kd Kc 2s]
Seat 4: JJin91 (big blind) showed [Qd Jd] and won (198934) with a pair =
of Kings
Seat 5: jsulzman showed [3d Qh] and lost with a pair of Kings
Seat 6: helzkitchen (button) folded before Flop (didn't bet)
Seat 9: CerPrisingLe (small blind) folded before Flop


*********** # 337 **************
PokerStars Hand #172156849379: Tournament #1648990476, $18.20+$1.80 USD=
 Hold'em No Limit - Level XXVII (5000/10000) - 2017/07/06 23:46:38 ET
Table '1648990476 1' 9-max Seat #9 is the button
Seat 4: JJin91 (198934 in chips)=20
Seat 5: jsulzman (872863 in chips)=20
Seat 6: helzkitchen (149311 in chips)=20
Seat 9: CerPrisingLe (128892 in chips)=20
JJin91: posts the ante 1250
jsulzman: posts the ante 1250
helzkitchen: posts the ante 1250
CerPrisingLe: posts the ante 1250
JJin91: posts small blind 5000
jsulzman: posts big blind 10000
*** HOLE CARDS ***
Dealt to JJin91 [Jd 3s]
helzkitchen: folds=20
CerPrisingLe: folds=20
JJin91: calls 5000
jsulzman: raises 25000 to 35000
JJin91: folds=20
Uncalled bet (25000) returned to jsulzman
jsulzman collected 25000 from pot
*** SUMMARY ***
Total pot 25000 | Rake 0=20
Seat 4: JJin91 (small blind) folded before Flop
Seat 5: jsulzman (big blind) collected (25000)
Seat 6: helzkitchen folded before Flop (didn't bet)
Seat 9: CerPrisingLe (button) folded before Flop (didn't bet)


*********** # 338 **************
PokerStars Hand #172156849435: Tournament #1648990476, $18.20+$1.80 USD=
 Hold'em No Limit - Level XXVII (5000/10000) - 2017/07/06 23:46:52 ET
Table '1648990476 1' 9-max Seat #4 is the button
Seat 4: JJin91 (187684 in chips)=20
Seat 5: jsulzman (886613 in chips)=20
Seat 6: helzkitchen (148061 in chips)=20
Seat 9: CerPrisingLe (127642 in chips)=20
JJin91: posts the ante 1250
jsulzman: posts the ante 1250
helzkitchen: posts the ante 1250
CerPrisingLe: posts the ante 1250
jsulzman: posts small blind 5000
helzkitchen: posts big blind 10000
*** HOLE CARDS ***
Dealt to JJin91 [2d 8h]
CerPrisingLe: folds=20
JJin91: folds=20
jsulzman: raises 20000 to 30000
helzkitchen: folds=20
Uncalled bet (20000) returned to jsulzman
jsulzman collected 25000 from pot
*** SUMMARY ***
Total pot 25000 | Rake 0=20
Seat 4: JJin91 (button) folded before Flop (didn't bet)
Seat 5: jsulzman (small blind) collected (25000)
Seat 6: helzkitchen (big blind) folded before Flop
Seat 9: CerPrisingLe folded before Flop (didn't bet)


*********** # 339 **************
PokerStars Hand #172156849478: Tournament #1648990476, $18.20+$1.80 USD=
 Hold'em No Limit - Level XXVII (5000/10000) - 2017/07/06 23:47:02 ET
Table '1648990476 1' 9-max Seat #5 is the button
Seat 4: JJin91 (186434 in chips)=20
Seat 5: jsulzman (900363 in chips)=20
Seat 6: helzkitchen (136811 in chips)=20
Seat 9: CerPrisingLe (126392 in chips)=20
JJin91: posts the ante 1250
jsulzman: posts the ante 1250
helzkitchen: posts the ante 1250
CerPrisingLe: posts the ante 1250
helzkitchen: posts small blind 5000
CerPrisingLe: posts big blind 10000
*** HOLE CARDS ***
Dealt to JJin91 [6h 3s]
JJin91: folds=20
jsulzman: raises 20000 to 30000
helzkitchen: folds=20
CerPrisingLe: folds=20
Uncalled bet (20000) returned to jsulzman
jsulzman collected 30000 from pot
*** SUMMARY ***
Total pot 30000 | Rake 0=20
Seat 4: JJin91 folded before Flop (didn't bet)
Seat 5: jsulzman (button) collected (30000)
Seat 6: helzkitchen (small blind) folded before Flop
Seat 9: CerPrisingLe (big blind) folded before Flop


*********** # 340 **************
PokerStars Hand #172156849520: Tournament #1648990476, $18.20+$1.80 USD=
 Hold'em No Limit - Level XXVII (5000/10000) - 2017/07/06 23:47:11 ET
Table '1648990476 1' 9-max Seat #6 is the button
Seat 4: JJin91 (185184 in chips)=20
Seat 5: jsulzman (919113 in chips)=20
Seat 6: helzkitchen (130561 in chips)=20
Seat 9: CerPrisingLe (115142 in chips)=20
JJin91: posts the ante 1250
jsulzman: posts the ante 1250
helzkitchen: posts the ante 1250
CerPrisingLe: posts the ante 1250
CerPrisingLe: posts small blind 5000
JJin91: posts big blind 10000
*** HOLE CARDS ***
Dealt to JJin91 [7c Kh]
jsulzman: raises 20000 to 30000
helzkitchen: folds=20
CerPrisingLe: folds=20
JJin91: calls 20000
*** FLOP *** [2c Kd 2d]
JJin91: checks=20
jsulzman: checks=20
*** TURN *** [2c Kd 2d] [Ks]
JJin91: bets 55300
jsulzman: folds=20
Uncalled bet (55300) returned to JJin91
JJin91 collected 70000 from pot
JJin91: doesn't show hand=20
*** SUMMARY ***
Total pot 70000 | Rake 0=20
Board [2c Kd 2d Ks]
Seat 4: JJin91 (big blind) collected (70000)
Seat 5: jsulzman folded on the Turn
Seat 6: helzkitchen (button) folded before Flop (didn't bet)
Seat 9: CerPrisingLe (small blind) folded before Flop


*********** # 341 **************
PokerStars Hand #172156849631: Tournament #1648990476, $18.20+$1.80 USD=
 Hold'em No Limit - Level XXVII (5000/10000) - 2017/07/06 23:47:40 ET
Table '1648990476 1' 9-max Seat #9 is the button
Seat 4: JJin91 (223934 in chips)=20
Seat 5: jsulzman (887863 in chips)=20
Seat 6: helzkitchen (129311 in chips)=20
Seat 9: CerPrisingLe (108892 in chips)=20
JJin91: posts the ante 1250
jsulzman: posts the ante 1250
helzkitchen: posts the ante 1250
CerPrisingLe: posts the ante 1250
JJin91: posts small blind 5000
jsulzman: posts big blind 10000
*** HOLE CARDS ***
Dealt to JJin91 [8h 2c]
helzkitchen: folds=20
CerPrisingLe: raises 20000 to 30000
JJin91: folds=20
jsulzman: calls 20000
*** FLOP *** [Qd 8c 2s]
jsulzman: checks=20
CerPrisingLe: bets 10000
jsulzman: calls 10000
*** TURN *** [Qd 8c 2s] [Tc]
jsulzman: checks=20
CerPrisingLe: bets 67642 and is all-in
jsulzman: folds=20
Uncalled bet (67642) returned to CerPrisingLe
CerPrisingLe collected 90000 from pot
CerPrisingLe: doesn't show hand=20
*** SUMMARY ***
Total pot 90000 | Rake 0=20
Board [Qd 8c 2s Tc]
Seat 4: JJin91 (small blind) folded before Flop
Seat 5: jsulzman (big blind) folded on the Turn
Seat 6: helzkitchen folded before Flop (didn't bet)
Seat 9: CerPrisingLe (button) collected (90000)


*********** # 342 **************
PokerStars Hand #172156849715: Tournament #1648990476, $18.20+$1.80 USD=
 Hold'em No Limit - Level XXVII (5000/10000) - 2017/07/06 23:48:04 ET
Table '1648990476 1' 9-max Seat #4 is the button
Seat 4: JJin91 (217684 in chips)=20
Seat 5: jsulzman (846613 in chips)=20
Seat 6: helzkitchen (128061 in chips)=20
Seat 9: CerPrisingLe (157642 in chips)=20
JJin91: posts the ante 1250
jsulzman: posts the ante 1250
helzkitchen: posts the ante 1250
CerPrisingLe: posts the ante 1250
jsulzman: posts small blind 5000
helzkitchen: posts big blind 10000
*** HOLE CARDS ***
Dealt to JJin91 [8c 3h]
CerPrisingLe: folds=20
JJin91: folds=20
jsulzman: raises 20000 to 30000
helzkitchen: raises 96811 to 126811 and is all-in
jsulzman: calls 96811
*** FLOP *** [3c 6h Tc]
*** TURN *** [3c 6h Tc] [5d]
*** RIVER *** [3c 6h Tc 5d] [Ts]
*** SHOW DOWN ***
jsulzman: shows [Jc Ad] (a pair of Tens)
helzkitchen: shows [4d 4h] (two pair, Tens and Fours)
helzkitchen collected 258622 from pot
*** SUMMARY ***
Total pot 258622 | Rake 0=20
Board [3c 6h Tc 5d Ts]
Seat 4: JJin91 (button) folded before Flop (didn't bet)
Seat 5: jsulzman (small blind) showed [Jc Ad] and lost with a pair of T=
ens
Seat 6: helzkitchen (big blind) showed [4d 4h] and won (258622) with tw=
o pair, Tens and Fours
Seat 9: CerPrisingLe folded before Flop (didn't bet)


*********** # 343 **************
PokerStars Hand #172156849817: Tournament #1648990476, $18.20+$1.80 USD=
 Hold'em No Limit - Level XXVII (5000/10000) - 2017/07/06 23:48:28 ET
Table '1648990476 1' 9-max Seat #5 is the button
Seat 4: JJin91 (216434 in chips)=20
Seat 5: jsulzman (718552 in chips)=20
Seat 6: helzkitchen (258622 in chips)=20
Seat 9: CerPrisingLe (156392 in chips)=20
JJin91: posts the ante 1250
jsulzman: posts the ante 1250
helzkitchen: posts the ante 1250
CerPrisingLe: posts the ante 1250
helzkitchen: posts small blind 5000
CerPrisingLe: posts big blind 10000
*** HOLE CARDS ***
Dealt to JJin91 [6s 9s]
JJin91: folds=20
jsulzman: folds=20
helzkitchen: calls 5000
CerPrisingLe: checks=20
*** FLOP *** [5c Kd 3s]
helzkitchen: bets 10000
CerPrisingLe: calls 10000
*** TURN *** [5c Kd 3s] [5d]
helzkitchen: bets 22500
CerPrisingLe: calls 22500
*** RIVER *** [5c Kd 3s 5d] [Js]
helzkitchen: bets 45000
CerPrisingLe: calls 45000
*** SHOW DOWN ***
helzkitchen: shows [3h Qs] (two pair, Fives and Threes)
CerPrisingLe: shows [3c Tc] (two pair, Fives and Threes)
helzkitchen collected 90000 from pot
CerPrisingLe collected 90000 from pot
*** SUMMARY ***
Total pot 180000 | Rake 0=20
Board [5c Kd 3s 5d Js]
Seat 4: JJin91 folded before Flop (didn't bet)
Seat 5: jsulzman (button) folded before Flop (didn't bet)
Seat 6: helzkitchen (small blind) showed [3h Qs] and won (90000) with t=
wo pair, Fives and Threes
Seat 9: CerPrisingLe (big blind) showed [3c Tc] and won (90000) with tw=
o pair, Fives and Threes


*********** # 344 **************
PokerStars Hand #172156849914: Tournament #1648990476, $18.20+$1.80 USD=
 Hold'em No Limit - Level XXVII (5000/10000) - 2017/07/06 23:48:55 ET
Table '1648990476 1' 9-max Seat #6 is the button
Seat 4: JJin91 (215184 in chips)=20
Seat 5: jsulzman (717302 in chips)=20
Seat 6: helzkitchen (259872 in chips)=20
Seat 9: CerPrisingLe (157642 in chips)=20
JJin91: posts the ante 1250
jsulzman: posts the ante 1250
helzkitchen: posts the ante 1250
CerPrisingLe: posts the ante 1250
CerPrisingLe: posts small blind 5000
JJin91: posts big blind 10000
*** HOLE CARDS ***
Dealt to JJin91 [9s 5h]
jsulzman: calls 10000
helzkitchen: folds=20
CerPrisingLe: calls 5000
JJin91: checks=20
*** FLOP *** [3c 5d Kh]
CerPrisingLe: checks=20
JJin91: bets 11550
jsulzman: calls 11550
CerPrisingLe: folds=20
*** TURN *** [3c 5d Kh] [2h]
CerPrisingLe is disconnected=20
JJin91: bets 21382
jsulzman: calls 21382
*** RIVER *** [3c 5d Kh 2h] [7s]
JJin91: checks=20
jsulzman: checks=20
*** SHOW DOWN ***
JJin91: shows [9s 5h] (a pair of Fives)
jsulzman: mucks hand=20
JJin91 collected 100864 from pot
*** SUMMARY ***
Total pot 100864 | Rake 0=20
Board [3c 5d Kh 2h 7s]
Seat 4: JJin91 (big blind) showed [9s 5h] and won (100864) with a pair =
of Fives
Seat 5: jsulzman mucked [4c 2c]
Seat 6: helzkitchen (button) folded before Flop (didn't bet)
Seat 9: CerPrisingLe (small blind) folded on the Flop


*********** # 345 **************
PokerStars Hand #172157428445: Tournament #1648990476, $18.20+$1.80 USD=
 Hold'em No Limit - Level XXVII (5000/10000) - 2017/07/06 23:49:30 ET
Table '1648990476 1' 9-max Seat #9 is the button
Seat 4: JJin91 (271866 in chips)=20
Seat 5: jsulzman (673120 in chips)=20
Seat 6: helzkitchen (258622 in chips)=20
Seat 9: CerPrisingLe (146392 in chips)=20
JJin91: posts the ante 1250
jsulzman: posts the ante 1250
helzkitchen: posts the ante 1250
CerPrisingLe: posts the ante 1250
JJin91: posts small blind 5000
jsulzman: posts big blind 10000
*** HOLE CARDS ***
Dealt to JJin91 [3c 5c]
helzkitchen: raises 10000 to 20000
helzkitchen said, "terrible time to disconnect"
CerPrisingLe is connected=20
CerPrisingLe said, "sry guys bad connec"
CerPrisingLe: folds=20
JJin91: folds=20
jsulzman: folds=20
Uncalled bet (10000) returned to helzkitchen
helzkitchen collected 30000 from pot
helzkitchen: doesn't show hand=20
*** SUMMARY ***
Total pot 30000 | Rake 0=20
Seat 4: JJin91 (small blind) folded before Flop
Seat 5: jsulzman (big blind) folded before Flop
Seat 6: helzkitchen collected (30000)
Seat 9: CerPrisingLe (button) folded before Flop (didn't bet)


*********** # 346 **************
PokerStars Hand #172157429228: Tournament #1648990476, $18.20+$1.80 USD=
 Hold'em No Limit - Level XXVII (5000/10000) - 2017/07/06 23:53:06 ET
Table '1648990476 1' 9-max Seat #4 is the button
Seat 4: JJin91 (265616 in chips)=20
Seat 5: jsulzman (661870 in chips)=20
Seat 6: helzkitchen (277372 in chips)=20
Seat 9: CerPrisingLe (145142 in chips)=20
JJin91: posts the ante 1250
jsulzman: posts the ante 1250
helzkitchen: posts the ante 1250
CerPrisingLe: posts the ante 1250
jsulzman: posts small blind 5000
helzkitchen: posts big blind 10000
*** HOLE CARDS ***
Dealt to JJin91 [Ac Qc]
CerPrisingLe: folds=20
JJin91: raises 14900 to 24900
jsulzman: folds=20
helzkitchen said, "its ok i was just saying bad timing for it"
helzkitchen: folds=20
Uncalled bet (14900) returned to JJin91
JJin91 collected 30000 from pot
JJin91: doesn't show hand=20
*** SUMMARY ***
Total pot 30000 | Rake 0=20
Seat 4: JJin91 (button) collected (30000)
Seat 5: jsulzman (small blind) folded before Flop
Seat 6: helzkitchen (big blind) folded before Flop
Seat 9: CerPrisingLe folded before Flop (didn't bet)


*********** # 347 **************
PokerStars Hand #172157429289: Tournament #1648990476, $18.20+$1.80 USD=
 Hold'em No Limit - Level XXVII (5000/10000) - 2017/07/06 23:53:24 ET
Table '1648990476 1' 9-max Seat #5 is the button
Seat 4: JJin91 (284366 in chips)=20
Seat 5: jsulzman (655620 in chips)=20
Seat 6: helzkitchen (266122 in chips)=20
Seat 9: CerPrisingLe (143892 in chips)=20
JJin91: posts the ante 1250
jsulzman: posts the ante 1250
helzkitchen: posts the ante 1250
CerPrisingLe: posts the ante 1250
helzkitchen: posts small blind 5000
CerPrisingLe: posts big blind 10000
*** HOLE CARDS ***
Dealt to JJin91 [4c 6d]
JJin91: folds=20
jsulzman: raises 10000 to 20000
helzkitchen: folds=20
CerPrisingLe: folds=20
Uncalled bet (10000) returned to jsulzman
jsulzman collected 30000 from pot
*** SUMMARY ***
Total pot 30000 | Rake 0=20
Seat 4: JJin91 folded before Flop (didn't bet)
Seat 5: jsulzman (button) collected (30000)
Seat 6: helzkitchen (small blind) folded before Flop
Seat 9: CerPrisingLe (big blind) folded before Flop


*********** # 348 **************
PokerStars Hand #172157429339: Tournament #1648990476, $18.20+$1.80 USD=
 Hold'em No Limit - Level XXVII (5000/10000) - 2017/07/06 23:53:36 ET
Table '1648990476 1' 9-max Seat #6 is the button
Seat 4: JJin91 (283116 in chips)=20
Seat 5: jsulzman (674370 in chips)=20
Seat 6: helzkitchen (259872 in chips)=20
Seat 9: CerPrisingLe (132642 in chips)=20
JJin91: posts the ante 1250
jsulzman: posts the ante 1250
helzkitchen: posts the ante 1250
CerPrisingLe: posts the ante 1250
CerPrisingLe: posts small blind 5000
JJin91: posts big blind 10000
*** HOLE CARDS ***
Dealt to JJin91 [7s 5h]
jsulzman: raises 10000 to 20000
helzkitchen: folds=20
CerPrisingLe: folds=20
JJin91: folds=20
Uncalled bet (10000) returned to jsulzman
jsulzman collected 30000 from pot
*** SUMMARY ***
Total pot 30000 | Rake 0=20
Seat 4: JJin91 (big blind) folded before Flop
Seat 5: jsulzman collected (30000)
Seat 6: helzkitchen (button) folded before Flop (didn't bet)
Seat 9: CerPrisingLe (small blind) folded before Flop


*********** # 349 **************
PokerStars Hand #172157429381: Tournament #1648990476, $18.20+$1.80 USD=
 Hold'em No Limit - Level XXVII (5000/10000) - 2017/07/06 23:53:47 ET
Table '1648990476 1' 9-max Seat #9 is the button
Seat 4: JJin91 (271866 in chips)=20
Seat 5: jsulzman (693120 in chips)=20
Seat 6: helzkitchen (258622 in chips)=20
Seat 9: CerPrisingLe (126392 in chips)=20
JJin91: posts the ante 1250
jsulzman: posts the ante 1250
helzkitchen: posts the ante 1250
CerPrisingLe: posts the ante 1250
JJin91: posts small blind 5000
jsulzman: posts big blind 10000
*** HOLE CARDS ***
Dealt to JJin91 [8s 8c]
CerPrisingLe said, "yea it seems like it happens at the worst times"
helzkitchen: raises 10000 to 20000
CerPrisingLe: folds=20
JJin91: calls 15000
jsulzman: calls 10000
*** FLOP *** [Qs 6c 6h]
JJin91: checks=20
jsulzman: bets 10000
helzkitchen: raises 30000 to 40000
JJin91: folds=20
jsulzman: calls 30000
*** TURN *** [Qs 6c 6h] [8d]
jsulzman: checks=20
helzkitchen: checks=20
*** RIVER *** [Qs 6c 6h 8d] [Kc]
jsulzman: bets 145000
helzkitchen: raises 52372 to 197372 and is all-in
jsulzman: calls 52372
*** SHOW DOWN ***
helzkitchen: shows [Qd Kh] (two pair, Kings and Queens)
jsulzman: shows [3h 6s] (three of a kind, Sixes)
jsulzman collected 539744 from pot
helzkitchen finished the tournament in 4th place and received $214.98.
*** SUMMARY ***
Total pot 539744 | Rake 0=20
Board [Qs 6c 6h 8d Kc]
Seat 4: JJin91 (small blind) folded on the Flop
Seat 5: jsulzman (big blind) showed [3h 6s] and won (539744) with three=
 of a kind, Sixes
Seat 6: helzkitchen showed [Qd Kh] and lost with two pair, Kings and Qu=
eens
Seat 9: CerPrisingLe (button) folded before Flop (didn't bet)


*********** # 350 **************
PokerStars Hand #172157429554: Tournament #1648990476, $18.20+$1.80 USD=
 Hold'em No Limit - Level XXVII (5000/10000) - 2017/07/06 23:54:38 ET
Table '1648990476 1' 9-max Seat #4 is the button
Seat 4: JJin91 (250616 in chips)=20
Seat 5: jsulzman (974242 in chips)=20
Seat 9: CerPrisingLe (125142 in chips)=20
JJin91: posts the ante 1250
jsulzman: posts the ante 1250
CerPrisingLe: posts the ante 1250
jsulzman: posts small blind 5000
CerPrisingLe: posts big blind 10000
*** HOLE CARDS ***
Dealt to JJin91 [9h 7h]
JJin91: raises 11100 to 21100
jsulzman: folds=20
CerPrisingLe: calls 11100
*** FLOP *** [Kh Js 8d]
CerPrisingLe: checks=20
JJin91 said, "i had eights T.T"
JJin91: bets 16814
CerPrisingLe: calls 16814
*** TURN *** [Kh Js 8d] [Qc]
CerPrisingLe: checks=20
JJin91: checks=20
*** RIVER *** [Kh Js 8d Qc] [9d]
CerPrisingLe: bets 50000
JJin91: folds=20
Uncalled bet (50000) returned to CerPrisingLe
CerPrisingLe collected 84578 from pot
CerPrisingLe: doesn't show hand=20
*** SUMMARY ***
Total pot 84578 | Rake 0=20
Board [Kh Js 8d Qc 9d]
Seat 4: JJin91 (button) folded on the River
Seat 5: jsulzman (small blind) folded before Flop
Seat 9: CerPrisingLe (big blind) collected (84578)


*********** # 351 **************
PokerStars Hand #172157429694: Tournament #1648990476, $18.20+$1.80 USD=
 Hold'em No Limit - Level XXVII (5000/10000) - 2017/07/06 23:55:13 ET
Table '1648990476 1' 9-max Seat #5 is the button
Seat 4: JJin91 (211452 in chips)=20
Seat 5: jsulzman (967992 in chips)=20
Seat 9: CerPrisingLe (170556 in chips)=20
JJin91: posts the ante 1250
jsulzman: posts the ante 1250
CerPrisingLe: posts the ante 1250
CerPrisingLe: posts small blind 5000
JJin91: posts big blind 10000
*** HOLE CARDS ***
Dealt to JJin91 [9c 2s]
jsulzman: calls 10000
CerPrisingLe: folds=20
JJin91: checks=20
*** FLOP *** [8d 5s As]
JJin91: checks=20
jsulzman: bets 10000
JJin91: folds=20
Uncalled bet (10000) returned to jsulzman
jsulzman collected 28750 from pot
JJin91 is disconnected=20
jsulzman is disconnected=20
CerPrisingLe is disconnected=20
jsulzman is connected=20
*** SUMMARY ***
Total pot 28750 | Rake 0=20
Board [8d 5s As]
Seat 4: JJin91 (big blind) folded on the Flop
Seat 5: jsulzman (button) collected (28750)
Seat 9: CerPrisingLe (small blind) folded before Flop


*********** # 352 **************
PokerStars Hand #172157429761: Tournament #1648990476, $18.20+$1.80 USD=
 Hold'em No Limit - Level XXVII (5000/10000) - 2017/07/06 23:55:35 ET
Table '1648990476 1' 9-max Seat #9 is the button
Seat 4: JJin91 (200202 in chips)=20
Seat 5: jsulzman (985492 in chips)=20
Seat 9: CerPrisingLe (164306 in chips)=20
All players have agreed to skip the break. Game resuming.
JJin91: posts the ante 1250
jsulzman: posts the ante 1250
CerPrisingLe: posts the ante 1250
JJin91: posts small blind 5000
jsulzman: posts big blind 10000
*** HOLE CARDS ***
Dealt to JJin91 [8d 4c]
CerPrisingLe: folds=20
JJin91: folds=20
Uncalled bet (5000) returned to jsulzman
jsulzman collected 13750 from pot
*** SUMMARY ***
Total pot 13750 | Rake 0=20
Seat 4: JJin91 (small blind) folded before Flop
Seat 5: jsulzman (big blind) collected (13750)
Seat 9: CerPrisingLe (button) folded before Flop (didn't bet)


*********** # 353 **************
PokerStars Hand #172157429784: Tournament #1648990476, $18.20+$1.80 USD=
 Hold'em No Limit - Level XXVII (5000/10000) - 2017/07/06 23:55:42 ET
Table '1648990476 1' 9-max Seat #4 is the button
Seat 4: JJin91 (193952 in chips)=20
Seat 5: jsulzman (992992 in chips)=20
Seat 9: CerPrisingLe (163056 in chips)=20
JJin91: posts the ante 1250
jsulzman: posts the ante 1250
CerPrisingLe: posts the ante 1250
jsulzman: posts small blind 5000
CerPrisingLe: posts big blind 10000
*** HOLE CARDS ***
Dealt to JJin91 [9c 4c]
JJin91: folds=20
jsulzman: raises 10000 to 20000
CerPrisingLe: raises 141806 to 161806 and is all-in
jsulzman: calls 141806
*** FLOP *** [3d 4h Tc]
*** TURN *** [3d 4h Tc] [2d]
*** RIVER *** [3d 4h Tc 2d] [9d]
*** SHOW DOWN ***
jsulzman: shows [As 5h] (a straight, Ace to Five)
CerPrisingLe: shows [8d 8c] (a pair of Eights)
jsulzman collected 327362 from pot
CerPrisingLe finished the tournament in 3rd place and received $288.69.
*** SUMMARY ***
Total pot 327362 | Rake 0=20
Board [3d 4h Tc 2d 9d]
Seat 4: JJin91 (button) folded before Flop (didn't bet)
Seat 5: jsulzman (small blind) showed [As 5h] and won (327362) with a s=
traight, Ace to Five
Seat 9: CerPrisingLe (big blind) showed [8d 8c] and lost with a pair of=
 Eights


*********** # 354 **************
PokerStars Hand #172157429871: Tournament #1648990476, $18.20+$1.80 USD=
 Hold'em No Limit - Level XXVII (5000/10000) - 2017/07/06 23:56:08 ET
Table '1648990476 1' 9-max Seat #5 is the button
Seat 4: JJin91 (192702 in chips)=20
Seat 5: jsulzman (1157298 in chips)=20
JJin91: posts the ante 1250
jsulzman: posts the ante 1250
jsulzman: posts small blind 5000
JJin91: posts big blind 10000
*** HOLE CARDS ***
Dealt to JJin91 [9h 4d]
jsulzman said, "u 2"
jsulzman: raises 10000 to 20000
JJin91: folds=20
Uncalled bet (10000) returned to jsulzman
jsulzman collected 22500 from pot
*** SUMMARY ***
Total pot 22500 | Rake 0=20
Seat 4: JJin91 (big blind) folded before Flop
Seat 5: jsulzman (button) (small blind) collected (22500)


*********** # 355 **************
PokerStars Hand #172157429921: Tournament #1648990476, $18.20+$1.80 USD=
 Hold'em No Limit - Level XXVII (5000/10000) - 2017/07/06 23:56:24 ET
Table '1648990476 1' 9-max Seat #4 is the button
Seat 4: JJin91 (181452 in chips)=20
Seat 5: jsulzman (1168548 in chips)=20
JJin91: posts the ante 1250
jsulzman: posts the ante 1250
JJin91: posts small blind 5000
jsulzman: posts big blind 10000
*** HOLE CARDS ***
Dealt to JJin91 [5h 7c]
JJin91: folds=20
Uncalled bet (5000) returned to jsulzman
jsulzman collected 12500 from pot
*** SUMMARY ***
Total pot 12500 | Rake 0=20
Seat 4: JJin91 (button) (small blind) folded before Flop
Seat 5: jsulzman (big blind) collected (12500)


*********** # 356 **************
PokerStars Hand #172157429945: Tournament #1648990476, $18.20+$1.80 USD=
 Hold'em No Limit - Level XXVII (5000/10000) - 2017/07/06 23:56:33 ET
Table '1648990476 1' 9-max Seat #5 is the button
Seat 4: JJin91 (175202 in chips)=20
Seat 5: jsulzman (1174798 in chips)=20
JJin91: posts the ante 1250
jsulzman: posts the ante 1250
jsulzman: posts small blind 5000
JJin91: posts big blind 10000
*** HOLE CARDS ***
Dealt to JJin91 [2c Qc]
jsulzman: raises 20000 to 30000
JJin91: raises 143952 to 173952 and is all-in
jsulzman: calls 143952
*** FLOP *** [Qd Kd 5s]
*** TURN *** [Qd Kd 5s] [4h]
*** RIVER *** [Qd Kd 5s 4h] [Ts]
*** SHOW DOWN ***
JJin91: shows [2c Qc] (a pair of Queens)
jsulzman: shows [Ad 8h] (high card Ace)
JJin91 collected 350404 from pot
*** SUMMARY ***
Total pot 350404 | Rake 0=20
Board [Qd Kd 5s 4h Ts]
Seat 4: JJin91 (big blind) showed [2c Qc] and won (350404) with a pair =
of Queens
Seat 5: jsulzman (button) (small blind) showed [Ad 8h] and lost with hi=
gh card Ace


*********** # 357 **************
PokerStars Hand #172157692537: Tournament #1648990476, $18.20+$1.80 USD=
 Hold'em No Limit - Level XXVIII (6000/12000) - 2017/07/06 23:56:59 ET
Table '1648990476 1' 9-max Seat #4 is the button
Seat 4: JJin91 (350404 in chips)=20
Seat 5: jsulzman (999596 in chips)=20
JJin91: posts the ante 1500
jsulzman: posts the ante 1500
JJin91: posts small blind 6000
jsulzman: posts big blind 12000
*** HOLE CARDS ***
Dealt to JJin91 [9d Qh]
JJin91: calls 6000
jsulzman: checks=20
*** FLOP *** [4d Kc 7c]
jsulzman: checks=20
JJin91: checks=20
*** TURN *** [4d Kc 7c] [2c]
jsulzman: bets 12000
JJin91: folds=20
Uncalled bet (12000) returned to jsulzman
jsulzman collected 27000 from pot
*** SUMMARY ***
Total pot 27000 | Rake 0=20
Board [4d Kc 7c 2c]
Seat 4: JJin91 (button) (small blind) folded on the Turn
Seat 5: jsulzman (big blind) collected (27000)


*********** # 358 **************
PokerStars Hand #172157692593: Tournament #1648990476, $18.20+$1.80 USD=
 Hold'em No Limit - Level XXVIII (6000/12000) - 2017/07/06 23:57:19 ET
Table '1648990476 1' 9-max Seat #5 is the button
Seat 4: JJin91 (336904 in chips)=20
Seat 5: jsulzman (1013096 in chips)=20
JJin91: posts the ante 1500
jsulzman: posts the ante 1500
jsulzman: posts small blind 6000
JJin91: posts big blind 12000
*** HOLE CARDS ***
Dealt to JJin91 [6c 5h]
jsulzman: raises 12000 to 24000
JJin91: folds=20
Uncalled bet (12000) returned to jsulzman
jsulzman collected 27000 from pot
*** SUMMARY ***
Total pot 27000 | Rake 0=20
Seat 4: JJin91 (big blind) folded before Flop
Seat 5: jsulzman (button) (small blind) collected (27000)


*********** # 359 **************
PokerStars Hand #172157692629: Tournament #1648990476, $18.20+$1.80 USD=
 Hold'em No Limit - Level XXVIII (6000/12000) - 2017/07/06 23:57:29 ET
Table '1648990476 1' 9-max Seat #4 is the button
Seat 4: JJin91 (323404 in chips)=20
Seat 5: jsulzman (1026596 in chips)=20
JJin91: posts the ante 1500
jsulzman: posts the ante 1500
JJin91: posts small blind 6000
jsulzman: posts big blind 12000
*** HOLE CARDS ***
Dealt to JJin91 [5d 7d]
JJin91: folds=20
Uncalled bet (6000) returned to jsulzman
jsulzman collected 15000 from pot
*** SUMMARY ***
Total pot 15000 | Rake 0=20
Seat 4: JJin91 (button) (small blind) folded before Flop
Seat 5: jsulzman (big blind) collected (15000)


*********** # 360 **************
PokerStars Hand #172157692665: Tournament #1648990476, $18.20+$1.80 USD=
 Hold'em No Limit - Level XXVIII (6000/12000) - 2017/07/06 23:57:40 ET
Table '1648990476 1' 9-max Seat #5 is the button
Seat 4: JJin91 (315904 in chips)=20
Seat 5: jsulzman (1034096 in chips)=20
JJin91: posts the ante 1500
jsulzman: posts the ante 1500
jsulzman: posts small blind 6000
JJin91: posts big blind 12000
*** HOLE CARDS ***
Dealt to JJin91 [5c Qs]
jsulzman: raises 24000 to 36000
JJin91: folds=20
Uncalled bet (24000) returned to jsulzman
jsulzman collected 27000 from pot
*** SUMMARY ***
Total pot 27000 | Rake 0=20
Seat 4: JJin91 (big blind) folded before Flop
Seat 5: jsulzman (button) (small blind) collected (27000)


*********** # 361 **************
PokerStars Hand #172157692682: Tournament #1648990476, $18.20+$1.80 USD=
 Hold'em No Limit - Level XXVIII (6000/12000) - 2017/07/06 23:57:48 ET
Table '1648990476 1' 9-max Seat #4 is the button
Seat 4: JJin91 (302404 in chips)=20
Seat 5: jsulzman (1047596 in chips)=20
JJin91: posts the ante 1500
jsulzman: posts the ante 1500
JJin91: posts small blind 6000
jsulzman: posts big blind 12000
*** HOLE CARDS ***
Dealt to JJin91 [As 4h]
JJin91: calls 6000
jsulzman: checks=20
*** FLOP *** [Kd 5s Ah]
jsulzman: checks=20
JJin91: bets 13230
jsulzman: folds=20
Uncalled bet (13230) returned to JJin91
JJin91 collected 27000 from pot
JJin91: doesn't show hand=20
*** SUMMARY ***
Total pot 27000 | Rake 0=20
Board [Kd 5s Ah]
Seat 4: JJin91 (button) (small blind) collected (27000)
Seat 5: jsulzman (big blind) folded on the Flop


*********** # 362 **************
PokerStars Hand #172157692738: Tournament #1648990476, $18.20+$1.80 USD=
 Hold'em No Limit - Level XXVIII (6000/12000) - 2017/07/06 23:58:05 ET
Table '1648990476 1' 9-max Seat #5 is the button
Seat 4: JJin91 (315904 in chips)=20
Seat 5: jsulzman (1034096 in chips)=20
JJin91: posts the ante 1500
jsulzman: posts the ante 1500
jsulzman: posts small blind 6000
JJin91: posts big blind 12000
*** HOLE CARDS ***
Dealt to JJin91 [Js 8d]
jsulzman: raises 24000 to 36000
JJin91: raises 60000 to 96000
jsulzman: raises 60000 to 156000
JJin91: folds=20
Uncalled bet (60000) returned to jsulzman
jsulzman collected 195000 from pot
*** SUMMARY ***
Total pot 195000 | Rake 0=20
Seat 4: JJin91 (big blind) folded before Flop
Seat 5: jsulzman (button) (small blind) collected (195000)


*********** # 363 **************
PokerStars Hand #172157692829: Tournament #1648990476, $18.20+$1.80 USD=
 Hold'em No Limit - Level XXVIII (6000/12000) - 2017/07/06 23:58:35 ET
Table '1648990476 1' 9-max Seat #4 is the button
Seat 4: JJin91 (218404 in chips)=20
Seat 5: jsulzman (1131596 in chips)=20
JJin91: posts the ante 1500
jsulzman: posts the ante 1500
JJin91: posts small blind 6000
jsulzman: posts big blind 12000
*** HOLE CARDS ***
Dealt to JJin91 [2s 4d]
JJin91: folds=20
Uncalled bet (6000) returned to jsulzman
jsulzman collected 15000 from pot
*** SUMMARY ***
Total pot 15000 | Rake 0=20
Seat 4: JJin91 (button) (small blind) folded before Flop
Seat 5: jsulzman (big blind) collected (15000)


*********** # 364 **************
PokerStars Hand #172157692844: Tournament #1648990476, $18.20+$1.80 USD=
 Hold'em No Limit - Level XXVIII (6000/12000) - 2017/07/06 23:58:40 ET
Table '1648990476 1' 9-max Seat #5 is the button
Seat 4: JJin91 (210904 in chips)=20
Seat 5: jsulzman (1139096 in chips)=20
JJin91: posts the ante 1500
jsulzman: posts the ante 1500
jsulzman: posts small blind 6000
JJin91: posts big blind 12000
*** HOLE CARDS ***
Dealt to JJin91 [Tc 3d]
jsulzman: raises 24000 to 36000
JJin91: folds=20
Uncalled bet (24000) returned to jsulzman
jsulzman collected 27000 from pot
*** SUMMARY ***
Total pot 27000 | Rake 0=20
Seat 4: JJin91 (big blind) folded before Flop
Seat 5: jsulzman (button) (small blind) collected (27000)


*********** # 365 **************
PokerStars Hand #172157692875: Tournament #1648990476, $18.20+$1.80 USD=
 Hold'em No Limit - Level XXVIII (6000/12000) - 2017/07/06 23:58:49 ET
Table '1648990476 1' 9-max Seat #4 is the button
Seat 4: JJin91 (197404 in chips)=20
Seat 5: jsulzman (1152596 in chips)=20
JJin91: posts the ante 1500
jsulzman: posts the ante 1500
JJin91: posts small blind 6000
jsulzman: posts big blind 12000
*** HOLE CARDS ***
Dealt to JJin91 [4h Tc]
JJin91: folds=20
Uncalled bet (6000) returned to jsulzman
jsulzman collected 15000 from pot
*** SUMMARY ***
Total pot 15000 | Rake 0=20
Seat 4: JJin91 (button) (small blind) folded before Flop
Seat 5: jsulzman (big blind) collected (15000)


*********** # 366 **************
PokerStars Hand #172157692894: Tournament #1648990476, $18.20+$1.80 USD=
 Hold'em No Limit - Level XXVIII (6000/12000) - 2017/07/06 23:58:56 ET
Table '1648990476 1' 9-max Seat #5 is the button
Seat 4: JJin91 (189904 in chips)=20
Seat 5: jsulzman (1160096 in chips)=20
JJin91: posts the ante 1500
jsulzman: posts the ante 1500
jsulzman: posts small blind 6000
JJin91: posts big blind 12000
*** HOLE CARDS ***
Dealt to JJin91 [Jh 4s]
jsulzman: calls 6000
JJin91: checks=20
*** FLOP *** [Ah 8d 6h]
JJin91: checks=20
jsulzman: checks=20
*** TURN *** [Ah 8d 6h] [9h]
JJin91: bets 16772
jsulzman: folds=20
Uncalled bet (16772) returned to JJin91
JJin91 collected 27000 from pot
JJin91: doesn't show hand=20
*** SUMMARY ***
Total pot 27000 | Rake 0=20
Board [Ah 8d 6h 9h]
Seat 4: JJin91 (big blind) collected (27000)
Seat 5: jsulzman (button) (small blind) folded on the Turn


*********** # 367 **************
PokerStars Hand #172157692984: Tournament #1648990476, $18.20+$1.80 USD=
 Hold'em No Limit - Level XXVIII (6000/12000) - 2017/07/06 23:59:26 ET
Table '1648990476 1' 9-max Seat #4 is the button
Seat 4: JJin91 (203404 in chips)=20
Seat 5: jsulzman (1146596 in chips)=20
JJin91: posts the ante 1500
jsulzman: posts the ante 1500
JJin91: posts small blind 6000
jsulzman: posts big blind 12000
*** HOLE CARDS ***
Dealt to JJin91 [5h 5d]
JJin91: calls 6000
jsulzman: checks=20
*** FLOP *** [Tc Js Qh]
jsulzman: bets 12000
JJin91: folds=20
Uncalled bet (12000) returned to jsulzman
jsulzman collected 27000 from pot
*** SUMMARY ***
Total pot 27000 | Rake 0=20
Board [Tc Js Qh]
Seat 4: JJin91 (button) (small blind) folded on the Flop
Seat 5: jsulzman (big blind) collected (27000)


*********** # 368 **************
PokerStars Hand #172157693023: Tournament #1648990476, $18.20+$1.80 USD=
 Hold'em No Limit - Level XXVIII (6000/12000) - 2017/07/06 23:59:38 ET
Table '1648990476 1' 9-max Seat #5 is the button
Seat 4: JJin91 (189904 in chips)=20
Seat 5: jsulzman (1160096 in chips)=20
JJin91: posts the ante 1500
jsulzman: posts the ante 1500
jsulzman: posts small blind 6000
JJin91: posts big blind 12000
*** HOLE CARDS ***
Dealt to JJin91 [Tc 7h]
jsulzman: calls 6000
JJin91: checks=20
*** FLOP *** [4s Th 2c]
JJin91: checks=20
jsulzman: bets 12000
JJin91: raises 24990 to 36990
jsulzman: calls 24990
*** TURN *** [4s Th 2c] [Js]
JJin91: bets 139414 and is all-in
jsulzman: calls 139414
*** RIVER *** [4s Th 2c Js] [Jh]
*** SHOW DOWN ***
JJin91: shows [Tc 7h] (two pair, Jacks and Tens)
jsulzman: shows [4c Ks] (two pair, Jacks and Fours)
JJin91 collected 379808 from pot
*** SUMMARY ***
Total pot 379808 | Rake 0=20
Board [4s Th 2c Js Jh]
Seat 4: JJin91 (big blind) showed [Tc 7h] and won (379808) with two pai=
r, Jacks and Tens
Seat 5: jsulzman (button) (small blind) showed [4c Ks] and lost with tw=
o pair, Jacks and Fours


*********** # 369 **************
PokerStars Hand #172157693134: Tournament #1648990476, $18.20+$1.80 USD=
 Hold'em No Limit - Level XXVIII (6000/12000) - 2017/07/07 0:00:10 ET
Table '1648990476 1' 9-max Seat #4 is the button
Seat 4: JJin91 (379808 in chips)=20
Seat 5: jsulzman (970192 in chips)=20
JJin91: posts the ante 1500
jsulzman: posts the ante 1500
JJin91: posts small blind 6000
jsulzman: posts big blind 12000
*** HOLE CARDS ***
Dealt to JJin91 [6h 4h]
JJin91: calls 6000
jsulzman: raises 24000 to 36000
JJin91: calls 24000
*** FLOP *** [7h 9h 9c]
jsulzman: bets 75000
JJin91: calls 75000
*** TURN *** [7h 9h 9c] [5s]
jsulzman: bets 12000
JJin91: raises 255308 to 267308 and is all-in
jsulzman: folds=20
Uncalled bet (255308) returned to JJin91
JJin91 collected 249000 from pot
JJin91: doesn't show hand=20
*** SUMMARY ***
Total pot 249000 | Rake 0=20
Board [7h 9h 9c 5s]
Seat 4: JJin91 (button) (small blind) collected (249000)
Seat 5: jsulzman (big blind) folded on the Turn


*********** # 370 **************
PokerStars Hand #172157693254: Tournament #1648990476, $18.20+$1.80 USD=
 Hold'em No Limit - Level XXVIII (6000/12000) - 2017/07/07 0:00:41 ET
Table '1648990476 1' 9-max Seat #5 is the button
Seat 4: JJin91 (504308 in chips)=20
Seat 5: jsulzman (845692 in chips)=20
JJin91: posts the ante 1500
jsulzman: posts the ante 1500
jsulzman: posts small blind 6000
JJin91: posts big blind 12000
*** HOLE CARDS ***
Dealt to JJin91 [Td Qh]
jsulzman said, "i fucking missed my bet lol"
jsulzman: calls 6000
JJin91: checks=20
*** FLOP *** [Ks 3c 3h]
JJin91: checks=20
jsulzman: checks=20
*** TURN *** [Ks 3c 3h] [9s]
JJin91: checks=20
jsulzman: bets 27000
JJin91: folds=20
Uncalled bet (27000) returned to jsulzman
jsulzman collected 27000 from pot
*** SUMMARY ***
Total pot 27000 | Rake 0=20
Board [Ks 3c 3h 9s]
Seat 4: JJin91 (big blind) folded on the Turn
Seat 5: jsulzman (button) (small blind) collected (27000)


*********** # 371 **************
PokerStars Hand #172157693359: Tournament #1648990476, $18.20+$1.80 USD=
 Hold'em No Limit - Level XXVIII (6000/12000) - 2017/07/07 0:01:12 ET
Table '1648990476 1' 9-max Seat #4 is the button
Seat 4: JJin91 (490808 in chips)=20
Seat 5: jsulzman (859192 in chips)=20
JJin91: posts the ante 1500
jsulzman: posts the ante 1500
JJin91: posts small blind 6000
jsulzman: posts big blind 12000
*** HOLE CARDS ***
Dealt to JJin91 [Ac Td]
JJin91: calls 6000
jsulzman: raises 24000 to 36000
JJin91: raises 63999 to 99999
jsulzman: calls 63999
*** FLOP *** [Ah 9s 5c]
jsulzman: bets 202998
JJin91: calls 202998
*** TURN *** [Ah 9s 5c] [7c]
jsulzman: bets 554695 and is all-in
JJin91: folds=20
Uncalled bet (554695) returned to jsulzman
jsulzman collected 608994 from pot
*** SUMMARY ***
Total pot 608994 | Rake 0=20
Board [Ah 9s 5c 7c]
Seat 4: JJin91 (button) (small blind) folded on the Turn
Seat 5: jsulzman (big blind) collected (608994)


*********** # 372 **************
PokerStars Hand #172157693573: Tournament #1648990476, $18.20+$1.80 USD=
 Hold'em No Limit - Level XXVIII (6000/12000) - 2017/07/07 0:02:09 ET
Table '1648990476 1' 9-max Seat #5 is the button
Seat 4: JJin91 (186311 in chips)=20
Seat 5: jsulzman (1163689 in chips)=20
JJin91: posts the ante 1500
jsulzman: posts the ante 1500
jsulzman: posts small blind 6000
JJin91: posts big blind 12000
*** HOLE CARDS ***
Dealt to JJin91 [5s 7c]
jsulzman: calls 6000
JJin91: checks=20
*** FLOP *** [5d 9c Qh]
JJin91: bets 172811 and is all-in
jsulzman: folds=20
Uncalled bet (172811) returned to JJin91
JJin91 collected 27000 from pot
JJin91: doesn't show hand=20
*** SUMMARY ***
Total pot 27000 | Rake 0=20
Board [5d 9c Qh]
Seat 4: JJin91 (big blind) collected (27000)
Seat 5: jsulzman (button) (small blind) folded on the Flop


*********** # 373 **************
PokerStars Hand #172157693631: Tournament #1648990476, $18.20+$1.80 USD=
 Hold'em No Limit - Level XXVIII (6000/12000) - 2017/07/07 0:02:23 ET
Table '1648990476 1' 9-max Seat #4 is the button
Seat 4: JJin91 (199811 in chips)=20
Seat 5: jsulzman (1150189 in chips)=20
JJin91: posts the ante 1500
jsulzman: posts the ante 1500
JJin91: posts small blind 6000
jsulzman: posts big blind 12000
*** HOLE CARDS ***
Dealt to JJin91 [7c Ac]
JJin91: raises 186311 to 198311 and is all-in
jsulzman: folds=20
Uncalled bet (186311) returned to JJin91
JJin91 collected 27000 from pot
JJin91: doesn't show hand=20
*** SUMMARY ***
Total pot 27000 | Rake 0=20
Seat 4: JJin91 (button) (small blind) collected (27000)
Seat 5: jsulzman (big blind) folded before Flop


*********** # 374 **************
PokerStars Hand #172157693663: Tournament #1648990476, $18.20+$1.80 USD=
 Hold'em No Limit - Level XXVIII (6000/12000) - 2017/07/07 0:02:33 ET
Table '1648990476 1' 9-max Seat #5 is the button
Seat 4: JJin91 (213311 in chips)=20
Seat 5: jsulzman (1136689 in chips)=20
JJin91: posts the ante 1500
jsulzman: posts the ante 1500
jsulzman: posts small blind 6000
JJin91: posts big blind 12000
*** HOLE CARDS ***
Dealt to JJin91 [2h 8c]
jsulzman: raises 12000 to 24000
JJin91: folds=20
Uncalled bet (12000) returned to jsulzman
jsulzman collected 27000 from pot
*** SUMMARY ***
Total pot 27000 | Rake 0=20
Seat 4: JJin91 (big blind) folded before Flop
Seat 5: jsulzman (button) (small blind) collected (27000)


*********** # 375 **************
PokerStars Hand #172157693697: Tournament #1648990476, $18.20+$1.80 USD=
 Hold'em No Limit - Level XXVIII (6000/12000) - 2017/07/07 0:02:41 ET
Table '1648990476 1' 9-max Seat #4 is the button
Seat 4: JJin91 (199811 in chips)=20
Seat 5: jsulzman (1150189 in chips)=20
JJin91: posts the ante 1500
jsulzman: posts the ante 1500
JJin91: posts small blind 6000
jsulzman: posts big blind 12000
*** HOLE CARDS ***
Dealt to JJin91 [Qh Ah]
JJin91: raises 186311 to 198311 and is all-in
jsulzman: calls 186311
*** FLOP *** [8s Jd Qs]
*** TURN *** [8s Jd Qs] [9h]
*** RIVER *** [8s Jd Qs 9h] [5s]
*** SHOW DOWN ***
jsulzman: shows [9d 8c] (two pair, Nines and Eights)
JJin91: shows [Qh Ah] (a pair of Queens)
jsulzman collected 399622 from pot
JJin91 finished the tournament in 2nd place and received $380.83.
jsulzman wins the tournament and receives $528.32 - congratulations!
*** SUMMARY ***
Total pot 399622 | Rake 0=20
Board [8s Jd Qs 9h 5s]
Seat 4: JJin91 (button) (small blind) showed [Qh Ah] and lost with a pa=
ir of Queens
Seat 5: jsulzman (big blind) showed [9d 8c] and won (399622) with two p=
air, Nines and Eights



If you have any questions, please contact us at "PokerStars Support" <s=
upport@pokerstarsnj.com>


