Transcript for tournament #1648956582 requested by JJin91 (jamiejin91@g=
mail.com)

*********** # 1 **************
PokerStars Hand #171440452377: Tournament #1648956582, $18.20+$1.80 USD=
 Hold'em No Limit - Level VIII (125/250) - 2017/06/19 20:19:57 ET
Table '1648956582 5' 9-max Seat #1 is the button
Seat 1: asremb (18569 in chips)=20
Seat 2: jrollsup1 (32447 in chips)=20
Seat 3: apoch19 (23743 in chips)=20
Seat 4: JJin91 (10000 in chips)=20
Seat 5: Studsg (9880 in chips)=20
Seat 6: jimbo070985 (8344 in chips)=20
Seat 7: GetLoose17 (3310 in chips)=20
Seat 8: RandyVas (9505 in chips)=20
Seat 9: lukystrike84 (14228 in chips)=20
asremb: posts the ante 30
jrollsup1: posts the ante 30
apoch19: posts the ante 30
JJin91: posts the ante 30
Studsg: posts the ante 30
jimbo070985: posts the ante 30
GetLoose17: posts the ante 30
RandyVas: posts the ante 30
lukystrike84: posts the ante 30
jrollsup1: posts small blind 125
apoch19: posts big blind 250
*** HOLE CARDS ***
Dealt to JJin91 [3s 4s]
JJin91: folds=20
Studsg: raises 350 to 600
jimbo070985: folds=20
GetLoose17: folds=20
RandyVas: folds=20
lukystrike84: folds=20
asremb: folds=20
JJin91 is sitting out
jrollsup1: folds=20
apoch19: folds=20
Uncalled bet (350) returned to Studsg
Studsg collected 895 from pot
JJin91 has returned
*** SUMMARY ***
Total pot 895 | Rake 0=20
Seat 1: asremb (button) folded before Flop (didn't bet)
Seat 2: jrollsup1 (small blind) folded before Flop
Seat 3: apoch19 (big blind) folded before Flop
Seat 4: JJin91 folded before Flop (didn't bet)
Seat 5: Studsg collected (895)
Seat 6: jimbo070985 folded before Flop (didn't bet)
Seat 7: GetLoose17 folded before Flop (didn't bet)
Seat 8: RandyVas folded before Flop (didn't bet)
Seat 9: lukystrike84 folded before Flop (didn't bet)


*********** # 2 **************
PokerStars Hand #171440452748: Tournament #1648956582, $18.20+$1.80 USD=
 Hold'em No Limit - Level VIII (125/250) - 2017/06/19 20:21:06 ET
Table '1648956582 5' 9-max Seat #2 is the button
Seat 1: asremb (18539 in chips)=20
Seat 2: jrollsup1 (32292 in chips)=20
Seat 3: apoch19 (23463 in chips)=20
Seat 4: JJin91 (9970 in chips)=20
Seat 5: Studsg (10495 in chips)=20
Seat 6: jimbo070985 (8314 in chips)=20
Seat 7: GetLoose17 (3280 in chips)=20
Seat 8: RandyVas (9475 in chips)=20
Seat 9: lukystrike84 (14198 in chips)=20
asremb: posts the ante 30
jrollsup1: posts the ante 30
apoch19: posts the ante 30
JJin91: posts the ante 30
Studsg: posts the ante 30
jimbo070985: posts the ante 30
GetLoose17: posts the ante 30
RandyVas: posts the ante 30
lukystrike84: posts the ante 30
apoch19: posts small blind 125
JJin91: posts big blind 250
*** HOLE CARDS ***
Dealt to JJin91 [5s Tc]
Studsg: folds=20
jimbo070985: folds=20
GetLoose17: folds=20
RandyVas: folds=20
lukystrike84: raises 500 to 750
asremb: folds=20
jrollsup1: folds=20
apoch19: folds=20
JJin91: folds=20
Uncalled bet (500) returned to lukystrike84
lukystrike84 collected 895 from pot
lukystrike84: doesn't show hand=20
*** SUMMARY ***
Total pot 895 | Rake 0=20
Seat 1: asremb folded before Flop (didn't bet)
Seat 2: jrollsup1 (button) folded before Flop (didn't bet)
Seat 3: apoch19 (small blind) folded before Flop
Seat 4: JJin91 (big blind) folded before Flop
Seat 5: Studsg folded before Flop (didn't bet)
Seat 6: jimbo070985 folded before Flop (didn't bet)
Seat 7: GetLoose17 folded before Flop (didn't bet)
Seat 8: RandyVas folded before Flop (didn't bet)
Seat 9: lukystrike84 collected (895)


*********** # 3 **************
PokerStars Hand #171440452894: Tournament #1648956582, $18.20+$1.80 USD=
 Hold'em No Limit - Level VIII (125/250) - 2017/06/19 20:21:34 ET
Table '1648956582 5' 9-max Seat #3 is the button
Seat 1: asremb (18509 in chips)=20
Seat 2: jrollsup1 (32262 in chips)=20
Seat 3: apoch19 (23308 in chips)=20
Seat 4: JJin91 (9690 in chips)=20
Seat 5: Studsg (10465 in chips)=20
Seat 6: jimbo070985 (8284 in chips)=20
Seat 7: GetLoose17 (3250 in chips)=20
Seat 8: RandyVas (9445 in chips)=20
Seat 9: lukystrike84 (14813 in chips)=20
asremb: posts the ante 30
jrollsup1: posts the ante 30
apoch19: posts the ante 30
JJin91: posts the ante 30
Studsg: posts the ante 30
jimbo070985: posts the ante 30
GetLoose17: posts the ante 30
RandyVas: posts the ante 30
lukystrike84: posts the ante 30
JJin91: posts small blind 125
Studsg: posts big blind 250
*** HOLE CARDS ***
Dealt to JJin91 [4c 2h]
jimbo070985: folds=20
GetLoose17: raises 2970 to 3220 and is all-in
RandyVas: folds=20
lukystrike84: folds=20
asremb: folds=20
jrollsup1: folds=20
apoch19: folds=20
JJin91: folds=20
Studsg: folds=20
Uncalled bet (2970) returned to GetLoose17
GetLoose17 collected 895 from pot
GetLoose17: doesn't show hand=20
*** SUMMARY ***
Total pot 895 | Rake 0=20
Seat 1: asremb folded before Flop (didn't bet)
Seat 2: jrollsup1 folded before Flop (didn't bet)
Seat 3: apoch19 (button) folded before Flop (didn't bet)
Seat 4: JJin91 (small blind) folded before Flop
Seat 5: Studsg (big blind) folded before Flop
Seat 6: jimbo070985 folded before Flop (didn't bet)
Seat 7: GetLoose17 collected (895)
Seat 8: RandyVas folded before Flop (didn't bet)
Seat 9: lukystrike84 folded before Flop (didn't bet)


*********** # 4 **************
PokerStars Hand #171440453037: Tournament #1648956582, $18.20+$1.80 USD=
 Hold'em No Limit - Level VIII (125/250) - 2017/06/19 20:22:02 ET
Table '1648956582 5' 9-max Seat #4 is the button
Seat 1: asremb (18479 in chips)=20
Seat 2: jrollsup1 (32232 in chips)=20
Seat 3: apoch19 (23278 in chips)=20
Seat 4: JJin91 (9535 in chips)=20
Seat 5: Studsg (10185 in chips)=20
Seat 6: jimbo070985 (8254 in chips)=20
Seat 7: GetLoose17 (3865 in chips)=20
Seat 8: RandyVas (9415 in chips)=20
Seat 9: lukystrike84 (14783 in chips)=20
asremb: posts the ante 30
jrollsup1: posts the ante 30
apoch19: posts the ante 30
JJin91: posts the ante 30
Studsg: posts the ante 30
jimbo070985: posts the ante 30
GetLoose17: posts the ante 30
RandyVas: posts the ante 30
lukystrike84: posts the ante 30
Studsg: posts small blind 125
jimbo070985: posts big blind 250
*** HOLE CARDS ***
Dealt to JJin91 [6c 7d]
GetLoose17: folds=20
RandyVas: folds=20
lukystrike84: folds=20
asremb: folds=20
jrollsup1: folds=20
apoch19: folds=20
JJin91: raises 392 to 642
Studsg: raises 608 to 1250
jimbo070985: folds=20
JJin91: calls 608
*** FLOP *** [3s Ts 2h]
Studsg: checks=20
JJin91: checks=20
*** TURN *** [3s Ts 2h] [Jd]
Studsg: checks=20
JJin91: bets 1921
Studsg: folds=20
Uncalled bet (1921) returned to JJin91
JJin91 collected 3020 from pot
JJin91: doesn't show hand=20
*** SUMMARY ***
Total pot 3020 | Rake 0=20
Board [3s Ts 2h Jd]
Seat 1: asremb folded before Flop (didn't bet)
Seat 2: jrollsup1 folded before Flop (didn't bet)
Seat 3: apoch19 folded before Flop (didn't bet)
Seat 4: JJin91 (button) collected (3020)
Seat 5: Studsg (small blind) folded on the Turn
Seat 6: jimbo070985 (big blind) folded before Flop
Seat 7: GetLoose17 folded before Flop (didn't bet)
Seat 8: RandyVas folded before Flop (didn't bet)
Seat 9: lukystrike84 folded before Flop (didn't bet)


*********** # 5 **************
PokerStars Hand #171440453443: Tournament #1648956582, $18.20+$1.80 USD=
 Hold'em No Limit - Level VIII (125/250) - 2017/06/19 20:23:25 ET
Table '1648956582 5' 9-max Seat #5 is the button
Seat 1: asremb (18449 in chips)=20
Seat 2: jrollsup1 (32202 in chips)=20
Seat 3: apoch19 (23248 in chips)=20
Seat 4: JJin91 (11275 in chips)=20
Seat 5: Studsg (8905 in chips)=20
Seat 6: jimbo070985 (7974 in chips)=20
Seat 8: RandyVas (9385 in chips)=20
Seat 9: lukystrike84 (14753 in chips)=20
asremb: posts the ante 30
jrollsup1: posts the ante 30
apoch19: posts the ante 30
JJin91: posts the ante 30
Studsg: posts the ante 30
jimbo070985: posts the ante 30
RandyVas: posts the ante 30
lukystrike84: posts the ante 30
jimbo070985: posts small blind 125
RandyVas: posts big blind 250
*** HOLE CARDS ***
Dealt to JJin91 [9c 2d]
lukystrike84: folds=20
asremb: folds=20
jrollsup1: raises 250 to 500
apoch19: folds=20
JJin91: folds=20
Studsg: folds=20
jimbo070985: raises 250 to 750
RandyVas: folds=20
jrollsup1: calls 250
*** FLOP *** [Qc Ah Qd]
jimbo070985: bets 750
jrollsup1: calls 750
*** TURN *** [Qc Ah Qd] [Qs]
jimbo070985: bets 1000
jrollsup1: folds=20
Uncalled bet (1000) returned to jimbo070985
jimbo070985 collected 3490 from pot
jimbo070985: doesn't show hand=20
*** SUMMARY ***
Total pot 3490 | Rake 0=20
Board [Qc Ah Qd Qs]
Seat 1: asremb folded before Flop (didn't bet)
Seat 2: jrollsup1 folded on the Turn
Seat 3: apoch19 folded before Flop (didn't bet)
Seat 4: JJin91 folded before Flop (didn't bet)
Seat 5: Studsg (button) folded before Flop (didn't bet)
Seat 6: jimbo070985 (small blind) collected (3490)
Seat 8: RandyVas (big blind) folded before Flop
Seat 9: lukystrike84 folded before Flop (didn't bet)


*********** # 6 **************
PokerStars Hand #171440453674: Tournament #1648956582, $18.20+$1.80 USD=
 Hold'em No Limit - Level VIII (125/250) - 2017/06/19 20:24:07 ET
Table '1648956582 5' 9-max Seat #6 is the button
Seat 1: asremb (18419 in chips)=20
Seat 2: jrollsup1 (30672 in chips)=20
Seat 3: apoch19 (23218 in chips)=20
Seat 4: JJin91 (11245 in chips)=20
Seat 5: Studsg (8875 in chips)=20
Seat 6: jimbo070985 (9934 in chips)=20
Seat 8: RandyVas (9105 in chips)=20
Seat 9: lukystrike84 (14723 in chips)=20
asremb: posts the ante 30
jrollsup1: posts the ante 30
apoch19: posts the ante 30
JJin91: posts the ante 30
Studsg: posts the ante 30
jimbo070985: posts the ante 30
RandyVas: posts the ante 30
lukystrike84: posts the ante 30
RandyVas: posts small blind 125
lukystrike84: posts big blind 250
*** HOLE CARDS ***
Dealt to JJin91 [Kh Ad]
asremb: folds=20
jrollsup1: folds=20
apoch19: folds=20
JJin91: raises 297 to 547
Studsg: folds=20
jimbo070985: folds=20
RandyVas: folds=20
lukystrike84: calls 297
*** FLOP *** [Qd 3d 4h]
lukystrike84: checks=20
JJin91: bets 555
lukystrike84: calls 555
*** TURN *** [Qd 3d 4h] [Jh]
lukystrike84: checks=20
JJin91: checks=20
*** RIVER *** [Qd 3d 4h Jh] [Qh]
lukystrike84: bets 1000
JJin91: folds=20
Uncalled bet (1000) returned to lukystrike84
lukystrike84 collected 2569 from pot
lukystrike84: doesn't show hand=20
*** SUMMARY ***
Total pot 2569 | Rake 0=20
Board [Qd 3d 4h Jh Qh]
Seat 1: asremb folded before Flop (didn't bet)
Seat 2: jrollsup1 folded before Flop (didn't bet)
Seat 3: apoch19 folded before Flop (didn't bet)
Seat 4: JJin91 folded on the River
Seat 5: Studsg folded before Flop (didn't bet)
Seat 6: jimbo070985 (button) folded before Flop (didn't bet)
Seat 8: RandyVas (small blind) folded before Flop
Seat 9: lukystrike84 (big blind) collected (2569)


*********** # 7 **************
PokerStars Hand #171440454102: Tournament #1648956582, $18.20+$1.80 USD=
 Hold'em No Limit - Level VIII (125/250) - 2017/06/19 20:25:31 ET
Table '1648956582 5' 9-max Seat #8 is the button
Seat 1: asremb (18389 in chips)=20
Seat 2: jrollsup1 (30642 in chips)=20
Seat 3: apoch19 (23188 in chips)=20
Seat 4: JJin91 (10113 in chips)=20
Seat 5: Studsg (8845 in chips)=20
Seat 6: jimbo070985 (9904 in chips)=20
Seat 7: caseycards3 (10000 in chips)=20
Seat 8: RandyVas (8950 in chips)=20
Seat 9: lukystrike84 (16160 in chips)=20
asremb: posts the ante 30
jrollsup1: posts the ante 30
apoch19: posts the ante 30
JJin91: posts the ante 30
Studsg: posts the ante 30
jimbo070985: posts the ante 30
caseycards3: posts the ante 30
RandyVas: posts the ante 30
lukystrike84: posts the ante 30
lukystrike84: posts small blind 125
asremb: posts big blind 250
*** HOLE CARDS ***
Dealt to JJin91 [3s Tc]
jrollsup1: folds=20
apoch19: folds=20
JJin91: folds=20
Studsg: folds=20
jimbo070985: folds=20
caseycards3: folds=20
RandyVas: folds=20
lukystrike84: calls 125
asremb: raises 500 to 750
lukystrike84: calls 500
*** FLOP *** [As Jd Ad]
lukystrike84: checks=20
asremb: bets 750
lukystrike84: folds=20
Uncalled bet (750) returned to asremb
asremb collected 1770 from pot
asremb: doesn't show hand=20
*** SUMMARY ***
Total pot 1770 | Rake 0=20
Board [As Jd Ad]
Seat 1: asremb (big blind) collected (1770)
Seat 2: jrollsup1 folded before Flop (didn't bet)
Seat 3: apoch19 folded before Flop (didn't bet)
Seat 4: JJin91 folded before Flop (didn't bet)
Seat 5: Studsg folded before Flop (didn't bet)
Seat 6: jimbo070985 folded before Flop (didn't bet)
Seat 7: caseycards3 folded before Flop (didn't bet)
Seat 8: RandyVas (button) folded before Flop (didn't bet)
Seat 9: lukystrike84 (small blind) folded on the Flop


*********** # 8 **************
PokerStars Hand #171440454359: Tournament #1648956582, $18.20+$1.80 USD=
 Hold'em No Limit - Level IX (150/300) - 2017/06/19 20:26:21 ET
Table '1648956582 5' 9-max Seat #9 is the button
Seat 1: asremb (19379 in chips)=20
Seat 2: jrollsup1 (30612 in chips)=20
Seat 3: apoch19 (23158 in chips)=20
Seat 4: JJin91 (10083 in chips)=20
Seat 5: Studsg (8815 in chips)=20
Seat 6: jimbo070985 (9874 in chips)=20
Seat 7: caseycards3 (9970 in chips)=20
Seat 8: RandyVas (8920 in chips)=20
Seat 9: lukystrike84 (15380 in chips)=20
asremb: posts the ante 40
jrollsup1: posts the ante 40
apoch19: posts the ante 40
JJin91: posts the ante 40
Studsg: posts the ante 40
jimbo070985: posts the ante 40
caseycards3: posts the ante 40
RandyVas: posts the ante 40
lukystrike84: posts the ante 40
asremb: posts small blind 150
jrollsup1: posts big blind 300
*** HOLE CARDS ***
Dealt to JJin91 [2c 2h]
apoch19: raises 450 to 750
JJin91: folds=20
Studsg: folds=20
jimbo070985: folds=20
caseycards3: folds=20
RandyVas: folds=20
lukystrike84: folds=20
asremb: folds=20
jrollsup1: folds=20
Uncalled bet (450) returned to apoch19
apoch19 collected 1110 from pot
apoch19: doesn't show hand=20
*** SUMMARY ***
Total pot 1110 | Rake 0=20
Seat 1: asremb (small blind) folded before Flop
Seat 2: jrollsup1 (big blind) folded before Flop
Seat 3: apoch19 collected (1110)
Seat 4: JJin91 folded before Flop (didn't bet)
Seat 5: Studsg folded before Flop (didn't bet)
Seat 6: jimbo070985 folded before Flop (didn't bet)
Seat 7: caseycards3 folded before Flop (didn't bet)
Seat 8: RandyVas folded before Flop (didn't bet)
Seat 9: lukystrike84 (button) folded before Flop (didn't bet)


*********** # 9 **************
PokerStars Hand #171440454525: Tournament #1648956582, $18.20+$1.80 USD=
 Hold'em No Limit - Level IX (150/300) - 2017/06/19 20:26:50 ET
Table '1648956582 5' 9-max Seat #1 is the button
Seat 1: asremb (19189 in chips)=20
Seat 2: jrollsup1 (30272 in chips)=20
Seat 3: apoch19 (23928 in chips)=20
Seat 4: JJin91 (10043 in chips)=20
Seat 5: Studsg (8775 in chips)=20
Seat 6: jimbo070985 (9834 in chips)=20
Seat 7: caseycards3 (9930 in chips)=20
Seat 8: RandyVas (8880 in chips)=20
Seat 9: lukystrike84 (15340 in chips)=20
asremb: posts the ante 40
jrollsup1: posts the ante 40
apoch19: posts the ante 40
JJin91: posts the ante 40
Studsg: posts the ante 40
jimbo070985: posts the ante 40
caseycards3: posts the ante 40
RandyVas: posts the ante 40
lukystrike84: posts the ante 40
jrollsup1: posts small blind 150
apoch19: posts big blind 300
*** HOLE CARDS ***
Dealt to JJin91 [4c Td]
JJin91: folds=20
Studsg: folds=20
jimbo070985: folds=20
caseycards3: folds=20
RandyVas: folds=20
lukystrike84: folds=20
asremb: folds=20
jrollsup1: raises 300 to 600
apoch19: calls 300
*** FLOP *** [6h 4s 8d]
jrollsup1: checks=20
apoch19: checks=20
*** TURN *** [6h 4s 8d] [3s]
jrollsup1: bets 780
apoch19: folds=20
Uncalled bet (780) returned to jrollsup1
jrollsup1 collected 1560 from pot
jrollsup1: doesn't show hand=20
*** SUMMARY ***
Total pot 1560 | Rake 0=20
Board [6h 4s 8d 3s]
Seat 1: asremb (button) folded before Flop (didn't bet)
Seat 2: jrollsup1 (small blind) collected (1560)
Seat 3: apoch19 (big blind) folded on the Turn
Seat 4: JJin91 folded before Flop (didn't bet)
Seat 5: Studsg folded before Flop (didn't bet)
Seat 6: jimbo070985 folded before Flop (didn't bet)
Seat 7: caseycards3 folded before Flop (didn't bet)
Seat 8: RandyVas folded before Flop (didn't bet)
Seat 9: lukystrike84 folded before Flop (didn't bet)


*********** # 10 **************
PokerStars Hand #171440454786: Tournament #1648956582, $18.20+$1.80 USD=
 Hold'em No Limit - Level IX (150/300) - 2017/06/19 20:27:39 ET
Table '1648956582 5' 9-max Seat #2 is the button
Seat 1: asremb (19149 in chips)=20
Seat 2: jrollsup1 (31192 in chips)=20
Seat 3: apoch19 (23288 in chips)=20
Seat 4: JJin91 (10003 in chips)=20
Seat 5: Studsg (8735 in chips)=20
Seat 6: jimbo070985 (9794 in chips)=20
Seat 7: caseycards3 (9890 in chips)=20
Seat 8: RandyVas (8840 in chips)=20
Seat 9: lukystrike84 (15300 in chips)=20
asremb: posts the ante 40
jrollsup1: posts the ante 40
apoch19: posts the ante 40
JJin91: posts the ante 40
Studsg: posts the ante 40
jimbo070985: posts the ante 40
caseycards3: posts the ante 40
RandyVas: posts the ante 40
lukystrike84: posts the ante 40
apoch19: posts small blind 150
JJin91: posts big blind 300
*** HOLE CARDS ***
Dealt to JJin91 [Ad 5s]
Studsg: folds=20
jimbo070985: folds=20
caseycards3: folds=20
RandyVas: calls 300
lukystrike84: folds=20
asremb: folds=20
jrollsup1: folds=20
apoch19: calls 150
JJin91: checks=20
*** FLOP *** [Js Ac Qd]
apoch19: checks=20
JJin91: bets 899
RandyVas: calls 899
apoch19: folds=20
*** TURN *** [Js Ac Qd] [Qs]
JJin91: checks=20
RandyVas: bets 1529
JJin91: calls 1529
*** RIVER *** [Js Ac Qd Qs] [9s]
JJin91: checks=20
RandyVas: bets 1800
JJin91: folds=20
Uncalled bet (1800) returned to RandyVas
RandyVas collected 6116 from pot
RandyVas: doesn't show hand=20
*** SUMMARY ***
Total pot 6116 | Rake 0=20
Board [Js Ac Qd Qs 9s]
Seat 1: asremb folded before Flop (didn't bet)
Seat 2: jrollsup1 (button) folded before Flop (didn't bet)
Seat 3: apoch19 (small blind) folded on the Flop
Seat 4: JJin91 (big blind) folded on the River
Seat 5: Studsg folded before Flop (didn't bet)
Seat 6: jimbo070985 folded before Flop (didn't bet)
Seat 7: caseycards3 folded before Flop (didn't bet)
Seat 8: RandyVas collected (6116)
Seat 9: lukystrike84 folded before Flop (didn't bet)


*********** # 11 **************
PokerStars Hand #171440455339: Tournament #1648956582, $18.20+$1.80 USD=
 Hold'em No Limit - Level IX (150/300) - 2017/06/19 20:29:23 ET
Table '1648956582 5' 9-max Seat #3 is the button
Seat 1: asremb (19109 in chips)=20
Seat 2: jrollsup1 (31152 in chips)=20
Seat 3: apoch19 (22948 in chips)=20
Seat 4: JJin91 (7235 in chips)=20
Seat 5: Studsg (8695 in chips)=20
Seat 6: jimbo070985 (9754 in chips)=20
Seat 7: caseycards3 (9850 in chips)=20
Seat 8: RandyVas (12188 in chips)=20
Seat 9: lukystrike84 (15260 in chips)=20
asremb: posts the ante 40
jrollsup1: posts the ante 40
apoch19: posts the ante 40
JJin91: posts the ante 40
Studsg: posts the ante 40
jimbo070985: posts the ante 40
caseycards3: posts the ante 40
RandyVas: posts the ante 40
lukystrike84: posts the ante 40
JJin91: posts small blind 150
Studsg: posts big blind 300
*** HOLE CARDS ***
Dealt to JJin91 [7c Th]
jimbo070985: folds=20
caseycards3: folds=20
RandyVas: calls 300
lukystrike84: folds=20
asremb: folds=20
jrollsup1: raises 600 to 900
apoch19: folds=20
JJin91: folds=20
Studsg: folds=20
RandyVas: calls 600
*** FLOP *** [9s 3h 2c]
RandyVas: checks=20
jrollsup1: bets 1200
RandyVas: folds=20
Uncalled bet (1200) returned to jrollsup1
jrollsup1 collected 2610 from pot
jrollsup1: doesn't show hand=20
*** SUMMARY ***
Total pot 2610 | Rake 0=20
Board [9s 3h 2c]
Seat 1: asremb folded before Flop (didn't bet)
Seat 2: jrollsup1 collected (2610)
Seat 3: apoch19 (button) folded before Flop (didn't bet)
Seat 4: JJin91 (small blind) folded before Flop
Seat 5: Studsg (big blind) folded before Flop
Seat 6: jimbo070985 folded before Flop (didn't bet)
Seat 7: caseycards3 folded before Flop (didn't bet)
Seat 8: RandyVas folded on the Flop
Seat 9: lukystrike84 folded before Flop (didn't bet)


*********** # 12 **************
PokerStars Hand #171440455541: Tournament #1648956582, $18.20+$1.80 USD=
 Hold'em No Limit - Level IX (150/300) - 2017/06/19 20:30:02 ET
Table '1648956582 5' 9-max Seat #4 is the button
Seat 1: asremb (19069 in chips)=20
Seat 2: jrollsup1 (32822 in chips)=20
Seat 3: apoch19 (22908 in chips)=20
Seat 4: JJin91 (7045 in chips)=20
Seat 5: Studsg (8355 in chips)=20
Seat 6: jimbo070985 (9714 in chips)=20
Seat 7: caseycards3 (9810 in chips)=20
Seat 8: RandyVas (11248 in chips)=20
Seat 9: lukystrike84 (15220 in chips)=20
asremb: posts the ante 40
jrollsup1: posts the ante 40
apoch19: posts the ante 40
JJin91: posts the ante 40
Studsg: posts the ante 40
jimbo070985: posts the ante 40
caseycards3: posts the ante 40
RandyVas: posts the ante 40
lukystrike84: posts the ante 40
Studsg: posts small blind 150
jimbo070985: posts big blind 300
*** HOLE CARDS ***
Dealt to JJin91 [7h 3h]
caseycards3: folds=20
RandyVas: folds=20
lukystrike84: folds=20
asremb: folds=20
jrollsup1: folds=20
apoch19: folds=20
JJin91: folds=20
Studsg: calls 150
jimbo070985: checks=20
*** FLOP *** [4d Qh Ah]
Studsg: checks=20
jimbo070985: bets 600
Studsg: calls 600
*** TURN *** [4d Qh Ah] [7s]
Studsg: checks=20
jimbo070985: checks=20
*** RIVER *** [4d Qh Ah 7s] [5c]
Studsg: checks=20
jimbo070985: checks=20
*** SHOW DOWN ***
Studsg: shows [Js Qd] (a pair of Queens)
jimbo070985: mucks hand=20
Studsg collected 2160 from pot
*** SUMMARY ***
Total pot 2160 | Rake 0=20
Board [4d Qh Ah 7s 5c]
Seat 1: asremb folded before Flop (didn't bet)
Seat 2: jrollsup1 folded before Flop (didn't bet)
Seat 3: apoch19 folded before Flop (didn't bet)
Seat 4: JJin91 (button) folded before Flop (didn't bet)
Seat 5: Studsg (small blind) showed [Js Qd] and won (2160) with a pair =
of Queens
Seat 6: jimbo070985 (big blind) mucked [6h 7d]
Seat 7: caseycards3 folded before Flop (didn't bet)
Seat 8: RandyVas folded before Flop (didn't bet)
Seat 9: lukystrike84 folded before Flop (didn't bet)


*********** # 13 **************
PokerStars Hand #171440455771: Tournament #1648956582, $18.20+$1.80 USD=
 Hold'em No Limit - Level IX (150/300) - 2017/06/19 20:30:45 ET
Table '1648956582 5' 9-max Seat #5 is the button
Seat 1: asremb (19029 in chips)=20
Seat 2: jrollsup1 (32782 in chips)=20
Seat 3: apoch19 (22868 in chips)=20
Seat 4: JJin91 (7005 in chips)=20
Seat 5: Studsg (9575 in chips)=20
Seat 6: jimbo070985 (8774 in chips)=20
Seat 7: caseycards3 (9770 in chips)=20
Seat 8: RandyVas (11208 in chips)=20
Seat 9: lukystrike84 (15180 in chips)=20
asremb: posts the ante 40
jrollsup1: posts the ante 40
apoch19: posts the ante 40
JJin91: posts the ante 40
Studsg: posts the ante 40
jimbo070985: posts the ante 40
caseycards3: posts the ante 40
RandyVas: posts the ante 40
lukystrike84: posts the ante 40
jimbo070985: posts small blind 150
caseycards3: posts big blind 300
*** HOLE CARDS ***
Dealt to JJin91 [9h 6d]
RandyVas: calls 300
lukystrike84: folds=20
asremb: calls 300
jrollsup1: folds=20
apoch19: calls 300
JJin91: folds=20
Studsg: folds=20
jimbo070985: calls 150
caseycards3: raises 9430 to 9730 and is all-in
RandyVas: folds=20
asremb: folds=20
apoch19: folds=20
jimbo070985: folds=20
Uncalled bet (9430) returned to caseycards3
caseycards3 collected 1860 from pot
caseycards3: doesn't show hand=20
*** SUMMARY ***
Total pot 1860 | Rake 0=20
Seat 1: asremb folded before Flop
Seat 2: jrollsup1 folded before Flop (didn't bet)
Seat 3: apoch19 folded before Flop
Seat 4: JJin91 folded before Flop (didn't bet)
Seat 5: Studsg (button) folded before Flop (didn't bet)
Seat 6: jimbo070985 (small blind) folded before Flop
Seat 7: caseycards3 (big blind) collected (1860)
Seat 8: RandyVas folded before Flop
Seat 9: lukystrike84 folded before Flop (didn't bet)


*********** # 14 **************
PokerStars Hand #171440456021: Tournament #1648956582, $18.20+$1.80 USD=
 Hold'em No Limit - Level IX (150/300) - 2017/06/19 20:31:33 ET
Table '1648956582 5' 9-max Seat #6 is the button
Seat 1: asremb (18689 in chips)=20
Seat 2: jrollsup1 (32742 in chips)=20
Seat 3: apoch19 (22528 in chips)=20
Seat 4: JJin91 (6965 in chips)=20
Seat 5: Studsg (9535 in chips)=20
Seat 6: jimbo070985 (8434 in chips)=20
Seat 7: caseycards3 (11290 in chips)=20
Seat 8: RandyVas (10868 in chips)=20
Seat 9: lukystrike84 (15140 in chips)=20
asremb: posts the ante 40
jrollsup1: posts the ante 40
apoch19: posts the ante 40
JJin91: posts the ante 40
Studsg: posts the ante 40
jimbo070985: posts the ante 40
caseycards3: posts the ante 40
RandyVas: posts the ante 40
lukystrike84: posts the ante 40
caseycards3: posts small blind 150
RandyVas: posts big blind 300
*** HOLE CARDS ***
Dealt to JJin91 [4d 9s]
lukystrike84: folds=20
asremb: raises 600 to 900
jrollsup1: folds=20
apoch19: folds=20
JJin91: folds=20
Studsg: folds=20
jimbo070985: folds=20
caseycards3: folds=20
RandyVas: folds=20
Uncalled bet (600) returned to asremb
asremb collected 1110 from pot
asremb: doesn't show hand=20
*** SUMMARY ***
Total pot 1110 | Rake 0=20
Seat 1: asremb collected (1110)
Seat 2: jrollsup1 folded before Flop (didn't bet)
Seat 3: apoch19 folded before Flop (didn't bet)
Seat 4: JJin91 folded before Flop (didn't bet)
Seat 5: Studsg folded before Flop (didn't bet)
Seat 6: jimbo070985 (button) folded before Flop (didn't bet)
Seat 7: caseycards3 (small blind) folded before Flop
Seat 8: RandyVas (big blind) folded before Flop
Seat 9: lukystrike84 folded before Flop (didn't bet)


*********** # 15 **************
PokerStars Hand #171440456161: Tournament #1648956582, $18.20+$1.80 USD=
 Hold'em No Limit - Level IX (150/300) - 2017/06/19 20:31:57 ET
Table '1648956582 5' 9-max Seat #7 is the button
Seat 1: asremb (19459 in chips)=20
Seat 2: jrollsup1 (32702 in chips)=20
Seat 3: apoch19 (22488 in chips)=20
Seat 4: JJin91 (6925 in chips)=20
Seat 5: Studsg (9495 in chips)=20
Seat 6: jimbo070985 (8394 in chips)=20
Seat 7: caseycards3 (11100 in chips)=20
Seat 8: RandyVas (10528 in chips)=20
Seat 9: lukystrike84 (15100 in chips)=20
asremb: posts the ante 40
jrollsup1: posts the ante 40
apoch19: posts the ante 40
JJin91: posts the ante 40
Studsg: posts the ante 40
jimbo070985: posts the ante 40
caseycards3: posts the ante 40
RandyVas: posts the ante 40
lukystrike84: posts the ante 40
RandyVas: posts small blind 150
lukystrike84: posts big blind 300
*** HOLE CARDS ***
Dealt to JJin91 [4c Kc]
asremb: folds=20
jrollsup1: folds=20
apoch19: folds=20
JJin91: folds=20
Studsg: folds=20
jimbo070985: folds=20
caseycards3: raises 330 to 630
RandyVas: folds=20
lukystrike84: folds=20
Uncalled bet (330) returned to caseycards3
caseycards3 collected 1110 from pot
caseycards3: doesn't show hand=20
*** SUMMARY ***
Total pot 1110 | Rake 0=20
Seat 1: asremb folded before Flop (didn't bet)
Seat 2: jrollsup1 folded before Flop (didn't bet)
Seat 3: apoch19 folded before Flop (didn't bet)
Seat 4: JJin91 folded before Flop (didn't bet)
Seat 5: Studsg folded before Flop (didn't bet)
Seat 6: jimbo070985 folded before Flop (didn't bet)
Seat 7: caseycards3 (button) collected (1110)
Seat 8: RandyVas (small blind) folded before Flop
Seat 9: lukystrike84 (big blind) folded before Flop


*********** # 16 **************
PokerStars Hand #171440456309: Tournament #1648956582, $18.20+$1.80 USD=
 Hold'em No Limit - Level IX (150/300) - 2017/06/19 20:32:26 ET
Table '1648956582 5' 9-max Seat #8 is the button
Seat 1: asremb (19419 in chips)=20
Seat 2: jrollsup1 (32662 in chips)=20
Seat 3: apoch19 (22448 in chips)=20
Seat 4: JJin91 (6885 in chips)=20
Seat 5: Studsg (9455 in chips)=20
Seat 6: jimbo070985 (8354 in chips)=20
Seat 7: caseycards3 (11870 in chips)=20
Seat 8: RandyVas (10338 in chips)=20
Seat 9: lukystrike84 (14760 in chips)=20
asremb: posts the ante 40
jrollsup1: posts the ante 40
apoch19: posts the ante 40
JJin91: posts the ante 40
Studsg: posts the ante 40
jimbo070985: posts the ante 40
caseycards3: posts the ante 40
RandyVas: posts the ante 40
lukystrike84: posts the ante 40
lukystrike84: posts small blind 150
asremb: posts big blind 300
*** HOLE CARDS ***
Dealt to JJin91 [5s Ah]
jrollsup1: raises 450 to 750
apoch19: folds=20
JJin91: folds=20
Studsg: folds=20
jimbo070985: calls 750
caseycards3: folds=20
RandyVas: folds=20
lukystrike84: folds=20
asremb: folds=20
*** FLOP *** [3d Tc 7h]
jrollsup1: checks=20
jimbo070985: checks=20
*** TURN *** [3d Tc 7h] [2d]
jrollsup1: bets 900
jimbo070985: calls 900
*** RIVER *** [3d Tc 7h 2d] [9s]
jrollsup1: bets 2055
jimbo070985: calls 2055
*** SHOW DOWN ***
jrollsup1: shows [Ac Qh] (high card Ace)
jimbo070985: shows [4d 4s] (a pair of Fours)
jimbo070985 collected 8220 from pot
*** SUMMARY ***
Total pot 8220 | Rake 0=20
Board [3d Tc 7h 2d 9s]
Seat 1: asremb (big blind) folded before Flop
Seat 2: jrollsup1 showed [Ac Qh] and lost with high card Ace
Seat 3: apoch19 folded before Flop (didn't bet)
Seat 4: JJin91 folded before Flop (didn't bet)
Seat 5: Studsg folded before Flop (didn't bet)
Seat 6: jimbo070985 showed [4d 4s] and won (8220) with a pair of Fours
Seat 7: caseycards3 folded before Flop (didn't bet)
Seat 8: RandyVas (button) folded before Flop (didn't bet)
Seat 9: lukystrike84 (small blind) folded before Flop


*********** # 17 **************
PokerStars Hand #171440456752: Tournament #1648956582, $18.20+$1.80 USD=
 Hold'em No Limit - Level IX (150/300) - 2017/06/19 20:33:45 ET
Table '1648956582 5' 9-max Seat #9 is the button
Seat 1: asremb (19079 in chips)=20
Seat 2: jrollsup1 (28917 in chips)=20
Seat 3: apoch19 (22408 in chips)=20
Seat 4: JJin91 (6845 in chips)=20
Seat 5: Studsg (9415 in chips)=20
Seat 6: jimbo070985 (12829 in chips)=20
Seat 7: caseycards3 (11830 in chips)=20
Seat 8: RandyVas (10298 in chips)=20
Seat 9: lukystrike84 (14570 in chips)=20
asremb: posts the ante 40
jrollsup1: posts the ante 40
apoch19: posts the ante 40
JJin91: posts the ante 40
Studsg: posts the ante 40
jimbo070985: posts the ante 40
caseycards3: posts the ante 40
RandyVas: posts the ante 40
lukystrike84: posts the ante 40
asremb: posts small blind 150
jrollsup1: posts big blind 300
*** HOLE CARDS ***
Dealt to JJin91 [5c 7c]
apoch19: folds=20
JJin91: folds=20
Studsg: folds=20
jimbo070985: folds=20
caseycards3: raises 300 to 600
RandyVas: folds=20
lukystrike84: folds=20
asremb: folds=20
jrollsup1: calls 300
*** FLOP *** [9h 9c Kh]
jrollsup1: checks=20
caseycards3: checks=20
*** TURN *** [9h 9c Kh] [3h]
jrollsup1: bets 855
caseycards3: raises 1545 to 2400
jrollsup1: folds=20
Uncalled bet (1545) returned to caseycards3
caseycards3 collected 3420 from pot
caseycards3: doesn't show hand=20
*** SUMMARY ***
Total pot 3420 | Rake 0=20
Board [9h 9c Kh 3h]
Seat 1: asremb (small blind) folded before Flop
Seat 2: jrollsup1 (big blind) folded on the Turn
Seat 3: apoch19 folded before Flop (didn't bet)
Seat 4: JJin91 folded before Flop (didn't bet)
Seat 5: Studsg folded before Flop (didn't bet)
Seat 6: jimbo070985 folded before Flop (didn't bet)
Seat 7: caseycards3 collected (3420)
Seat 8: RandyVas folded before Flop (didn't bet)
Seat 9: lukystrike84 (button) folded before Flop (didn't bet)


*********** # 18 **************
PokerStars Hand #171440457027: Tournament #1648956582, $18.20+$1.80 USD=
 Hold'em No Limit - Level IX (150/300) - 2017/06/19 20:34:38 ET
Table '1648956582 5' 9-max Seat #1 is the button
Seat 1: asremb (18889 in chips)=20
Seat 2: jrollsup1 (27422 in chips)=20
Seat 3: apoch19 (22368 in chips)=20
Seat 4: JJin91 (6805 in chips)=20
Seat 5: Studsg (9375 in chips)=20
Seat 6: jimbo070985 (12789 in chips)=20
Seat 7: caseycards3 (13755 in chips)=20
Seat 8: RandyVas (10258 in chips)=20
Seat 9: lukystrike84 (14530 in chips)=20
asremb: posts the ante 40
jrollsup1: posts the ante 40
apoch19: posts the ante 40
JJin91: posts the ante 40
Studsg: posts the ante 40
jimbo070985: posts the ante 40
caseycards3: posts the ante 40
RandyVas: posts the ante 40
lukystrike84: posts the ante 40
jrollsup1: posts small blind 150
apoch19: posts big blind 300
*** HOLE CARDS ***
Dealt to JJin91 [Qd 2d]
JJin91: folds=20
Studsg: folds=20
jimbo070985: folds=20
caseycards3: folds=20
RandyVas: folds=20
lukystrike84: folds=20
asremb: raises 600 to 900
jrollsup1: folds=20
apoch19: folds=20
Uncalled bet (600) returned to asremb
asremb collected 1110 from pot
asremb: doesn't show hand=20
*** SUMMARY ***
Total pot 1110 | Rake 0=20
Seat 1: asremb (button) collected (1110)
Seat 2: jrollsup1 (small blind) folded before Flop
Seat 3: apoch19 (big blind) folded before Flop
Seat 4: JJin91 folded before Flop (didn't bet)
Seat 5: Studsg folded before Flop (didn't bet)
Seat 6: jimbo070985 folded before Flop (didn't bet)
Seat 7: caseycards3 folded before Flop (didn't bet)
Seat 8: RandyVas folded before Flop (didn't bet)
Seat 9: lukystrike84 folded before Flop (didn't bet)


*********** # 19 **************
PokerStars Hand #171440457158: Tournament #1648956582, $18.20+$1.80 USD=
 Hold'em No Limit - Level IX (150/300) - 2017/06/19 20:35:03 ET
Table '1648956582 5' 9-max Seat #2 is the button
Seat 1: asremb (19659 in chips)=20
Seat 2: jrollsup1 (27232 in chips)=20
Seat 3: apoch19 (22028 in chips)=20
Seat 4: JJin91 (6765 in chips)=20
Seat 5: Studsg (9335 in chips)=20
Seat 6: jimbo070985 (12749 in chips)=20
Seat 7: caseycards3 (13715 in chips)=20
Seat 8: RandyVas (10218 in chips)=20
Seat 9: lukystrike84 (14490 in chips)=20
asremb: posts the ante 40
jrollsup1: posts the ante 40
apoch19: posts the ante 40
JJin91: posts the ante 40
Studsg: posts the ante 40
jimbo070985: posts the ante 40
caseycards3: posts the ante 40
RandyVas: posts the ante 40
lukystrike84: posts the ante 40
apoch19: posts small blind 150
JJin91: posts big blind 300
*** HOLE CARDS ***
Dealt to JJin91 [9s 3s]
Studsg: folds=20
jimbo070985: folds=20
caseycards3: folds=20
RandyVas: folds=20
lukystrike84: raises 300 to 600
asremb: calls 600
jrollsup1: folds=20
apoch19: folds=20
JJin91: calls 300
*** FLOP *** [7d 8s 2c]
JJin91: checks=20
lukystrike84: checks=20
asremb: checks=20
*** TURN *** [7d 8s 2c] [3d]
JJin91: checks=20
lukystrike84: checks=20
asremb: checks=20
*** RIVER *** [7d 8s 2c 3d] [2s]
JJin91: checks=20
lukystrike84: checks=20
asremb: checks=20
*** SHOW DOWN ***
JJin91: shows [9s 3s] (two pair, Threes and Deuces)
lukystrike84: mucks hand=20
asremb: mucks hand=20
JJin91 collected 2310 from pot
*** SUMMARY ***
Total pot 2310 | Rake 0=20
Board [7d 8s 2c 3d 2s]
Seat 1: asremb mucked [Tc Jc]
Seat 2: jrollsup1 (button) folded before Flop (didn't bet)
Seat 3: apoch19 (small blind) folded before Flop
Seat 4: JJin91 (big blind) showed [9s 3s] and won (2310) with two pair,=
 Threes and Deuces
Seat 5: Studsg folded before Flop (didn't bet)
Seat 6: jimbo070985 folded before Flop (didn't bet)
Seat 7: caseycards3 folded before Flop (didn't bet)
Seat 8: RandyVas folded before Flop (didn't bet)
Seat 9: lukystrike84 mucked [Qs Ts]


*********** # 20 **************
PokerStars Hand #171440457707: Tournament #1648956582, $18.20+$1.80 USD=
 Hold'em No Limit - Level X (200/400) - 2017/06/19 20:36:45 ET
Table '1648956582 5' 9-max Seat #3 is the button
Seat 1: asremb (19019 in chips)=20
Seat 2: jrollsup1 (27192 in chips)=20
Seat 3: apoch19 (21838 in chips)=20
Seat 4: JJin91 (8435 in chips)=20
Seat 5: Studsg (9295 in chips)=20
Seat 6: jimbo070985 (12709 in chips)=20
Seat 7: caseycards3 (13675 in chips)=20
Seat 8: RandyVas (10178 in chips)=20
Seat 9: lukystrike84 (13850 in chips)=20
asremb: posts the ante 50
jrollsup1: posts the ante 50
apoch19: posts the ante 50
JJin91: posts the ante 50
Studsg: posts the ante 50
jimbo070985: posts the ante 50
caseycards3: posts the ante 50
RandyVas: posts the ante 50
lukystrike84: posts the ante 50
JJin91: posts small blind 200
Studsg: posts big blind 400
*** HOLE CARDS ***
Dealt to JJin91 [6c 8c]
jimbo070985: folds=20
caseycards3: folds=20
RandyVas: calls 400
lukystrike84: calls 400
asremb: folds=20
jrollsup1: folds=20
apoch19: folds=20
JJin91: calls 200
Studsg: checks=20
*** FLOP *** [Kh 4d Ts]
JJin91: checks=20
Studsg: checks=20
RandyVas: checks=20
lukystrike84: bets 1025
JJin91: folds=20
Studsg: folds=20
RandyVas: calls 1025
*** TURN *** [Kh 4d Ts] [Kd]
RandyVas: checks=20
lukystrike84: checks=20
*** RIVER *** [Kh 4d Ts Kd] [8h]
RandyVas: checks=20
lukystrike84: checks=20
*** SHOW DOWN ***
RandyVas: shows [Jc Qs] (a pair of Kings)
lukystrike84: shows [Ac 5c] (a pair of Kings - Ace kicker)
lukystrike84 collected 4100 from pot
*** SUMMARY ***
Total pot 4100 | Rake 0=20
Board [Kh 4d Ts Kd 8h]
Seat 1: asremb folded before Flop (didn't bet)
Seat 2: jrollsup1 folded before Flop (didn't bet)
Seat 3: apoch19 (button) folded before Flop (didn't bet)
Seat 4: JJin91 (small blind) folded on the Flop
Seat 5: Studsg (big blind) folded on the Flop
Seat 6: jimbo070985 folded before Flop (didn't bet)
Seat 7: caseycards3 folded before Flop (didn't bet)
Seat 8: RandyVas showed [Jc Qs] and lost with a pair of Kings
Seat 9: lukystrike84 showed [Ac 5c] and won (4100) with a pair of Kings


*********** # 21 **************
PokerStars Hand #171440458139: Tournament #1648956582, $18.20+$1.80 USD=
 Hold'em No Limit - Level X (200/400) - 2017/06/19 20:38:09 ET
Table '1648956582 5' 9-max Seat #4 is the button
Seat 1: asremb (18969 in chips)=20
Seat 2: jrollsup1 (27142 in chips)=20
Seat 3: apoch19 (21788 in chips)=20
Seat 4: JJin91 (7985 in chips)=20
Seat 5: Studsg (8845 in chips)=20
Seat 6: jimbo070985 (12659 in chips)=20
Seat 7: caseycards3 (13625 in chips)=20
Seat 8: RandyVas (8703 in chips)=20
Seat 9: lukystrike84 (16475 in chips)=20
asremb: posts the ante 50
jrollsup1: posts the ante 50
apoch19: posts the ante 50
JJin91: posts the ante 50
Studsg: posts the ante 50
jimbo070985: posts the ante 50
caseycards3: posts the ante 50
RandyVas: posts the ante 50
lukystrike84: posts the ante 50
Studsg: posts small blind 200
jimbo070985: posts big blind 400
*** HOLE CARDS ***
Dealt to JJin91 [8s 5d]
caseycards3: folds=20
RandyVas: folds=20
lukystrike84: raises 800 to 1200
asremb: calls 1200
jrollsup1: folds=20
apoch19: calls 1200
JJin91: folds=20
Studsg: folds=20
jimbo070985: raises 2400 to 3600
lukystrike84: raises 12825 to 16425 and is all-in
asremb: folds=20
apoch19: folds=20
jimbo070985: calls 9009 and is all-in
Uncalled bet (3816) returned to lukystrike84
*** FLOP *** [6c 4h 4c]
*** TURN *** [6c 4h 4c] [Jc]
*** RIVER *** [6c 4h 4c Jc] [Kh]
*** SHOW DOWN ***
jimbo070985: shows [Qc Qd] (two pair, Queens and Fours)
lukystrike84: shows [Ad Ks] (two pair, Kings and Fours)
lukystrike84 collected 28268 from pot
jimbo070985 finished the tournament in 113th place
*** SUMMARY ***
Total pot 28268 | Rake 0=20
Board [6c 4h 4c Jc Kh]
Seat 1: asremb folded before Flop
Seat 2: jrollsup1 folded before Flop (didn't bet)
Seat 3: apoch19 folded before Flop
Seat 4: JJin91 (button) folded before Flop (didn't bet)
Seat 5: Studsg (small blind) folded before Flop
Seat 6: jimbo070985 (big blind) showed [Qc Qd] and lost with two pair, =
Queens and Fours
Seat 7: caseycards3 folded before Flop (didn't bet)
Seat 8: RandyVas folded before Flop (didn't bet)
Seat 9: lukystrike84 showed [Ad Ks] and won (28268) with two pair, King=
s and Fours


*********** # 22 **************
PokerStars Hand #171440458460: Tournament #1648956582, $18.20+$1.80 USD=
 Hold'em No Limit - Level X (200/400) - 2017/06/19 20:39:08 ET
Table '1648956582 5' 9-max Seat #5 is the button
Seat 1: asremb (17719 in chips)=20
Seat 2: jrollsup1 (27092 in chips)=20
Seat 3: apoch19 (20538 in chips)=20
Seat 4: JJin91 (7935 in chips)=20
Seat 5: Studsg (8595 in chips)=20
Seat 7: caseycards3 (13575 in chips)=20
Seat 8: RandyVas (8653 in chips)=20
Seat 9: lukystrike84 (32084 in chips)=20
asremb: posts the ante 50
jrollsup1: posts the ante 50
apoch19: posts the ante 50
JJin91: posts the ante 50
Studsg: posts the ante 50
caseycards3: posts the ante 50
RandyVas: posts the ante 50
lukystrike84: posts the ante 50
caseycards3: posts small blind 200
RandyVas: posts big blind 400
*** HOLE CARDS ***
Dealt to JJin91 [Ad 9c]
lukystrike84: folds=20
asremb: folds=20
jrollsup1: folds=20
apoch19: folds=20
JJin91: folds=20
Studsg: raises 475 to 875
caseycards3: folds=20
RandyVas: folds=20
Uncalled bet (475) returned to Studsg
Studsg collected 1400 from pot
*** SUMMARY ***
Total pot 1400 | Rake 0=20
Seat 1: asremb folded before Flop (didn't bet)
Seat 2: jrollsup1 folded before Flop (didn't bet)
Seat 3: apoch19 folded before Flop (didn't bet)
Seat 4: JJin91 folded before Flop (didn't bet)
Seat 5: Studsg (button) collected (1400)
Seat 7: caseycards3 (small blind) folded before Flop
Seat 8: RandyVas (big blind) folded before Flop
Seat 9: lukystrike84 folded before Flop (didn't bet)


*********** # 23 **************
PokerStars Hand #171440458644: Tournament #1648956582, $18.20+$1.80 USD=
 Hold'em No Limit - Level X (200/400) - 2017/06/19 20:39:41 ET
Table '1648956582 5' 9-max Seat #7 is the button
Seat 1: asremb (17669 in chips)=20
Seat 2: jrollsup1 (27042 in chips)=20
Seat 3: apoch19 (20488 in chips)=20
Seat 4: JJin91 (7885 in chips)=20
Seat 5: Studsg (9545 in chips)=20
Seat 6: jimbo070985 (10000 in chips)=20
Seat 7: caseycards3 (13325 in chips)=20
Seat 8: RandyVas (8203 in chips)=20
Seat 9: lukystrike84 (32034 in chips)=20
asremb: posts the ante 50
jrollsup1: posts the ante 50
apoch19: posts the ante 50
JJin91: posts the ante 50
Studsg: posts the ante 50
jimbo070985: posts the ante 50
caseycards3: posts the ante 50
RandyVas: posts the ante 50
lukystrike84: posts the ante 50
RandyVas: posts small blind 200
lukystrike84: posts big blind 400
*** HOLE CARDS ***
Dealt to JJin91 [7s Qh]
asremb: folds=20
jrollsup1: folds=20
apoch19: folds=20
JJin91: folds=20
Studsg: folds=20
jimbo070985: raises 800 to 1200
caseycards3: folds=20
RandyVas: folds=20
lukystrike84: folds=20
Uncalled bet (800) returned to jimbo070985
jimbo070985 collected 1450 from pot
jimbo070985: doesn't show hand=20
*** SUMMARY ***
Total pot 1450 | Rake 0=20
Seat 1: asremb folded before Flop (didn't bet)
Seat 2: jrollsup1 folded before Flop (didn't bet)
Seat 3: apoch19 folded before Flop (didn't bet)
Seat 4: JJin91 folded before Flop (didn't bet)
Seat 5: Studsg folded before Flop (didn't bet)
Seat 6: jimbo070985 collected (1450)
Seat 7: caseycards3 (button) folded before Flop (didn't bet)
Seat 8: RandyVas (small blind) folded before Flop
Seat 9: lukystrike84 (big blind) folded before Flop


*********** # 24 **************
PokerStars Hand #171440458737: Tournament #1648956582, $18.20+$1.80 USD=
 Hold'em No Limit - Level X (200/400) - 2017/06/19 20:39:58 ET
Table '1648956582 5' 9-max Seat #8 is the button
Seat 2: jrollsup1 (26992 in chips)=20
Seat 3: apoch19 (20438 in chips)=20
Seat 4: JJin91 (7835 in chips)=20
Seat 5: Studsg (9495 in chips)=20
Seat 6: jimbo070985 (11000 in chips)=20
Seat 7: caseycards3 (13275 in chips)=20
Seat 8: RandyVas (7953 in chips)=20
Seat 9: lukystrike84 (31584 in chips)=20
jrollsup1: posts the ante 50
apoch19: posts the ante 50
JJin91: posts the ante 50
Studsg: posts the ante 50
jimbo070985: posts the ante 50
caseycards3: posts the ante 50
RandyVas: posts the ante 50
lukystrike84: posts the ante 50
lukystrike84: posts small blind 200
jrollsup1: posts big blind 400
*** HOLE CARDS ***
Dealt to JJin91 [6c Jc]
apoch19: folds=20
JJin91: folds=20
Studsg: folds=20
jimbo070985: calls 400
caseycards3: raises 680 to 1080
RandyVas: calls 1080
lukystrike84: folds=20
jrollsup1: folds=20
jimbo070985: calls 680
*** FLOP *** [2d 4h 3d]
jimbo070985: checks=20
caseycards3: checks=20
RandyVas: checks=20
*** TURN *** [2d 4h 3d] [Td]
jimbo070985: checks=20
caseycards3: bets 2629
RandyVas: raises 4194 to 6823 and is all-in
jimbo070985: folds=20
caseycards3: calls 4194
*** RIVER *** [2d 4h 3d Td] [3c]
*** SHOW DOWN ***
caseycards3: shows [Tc Js] (two pair, Tens and Threes)
RandyVas: shows [Ad Qc] (a pair of Threes)
caseycards3 collected 17886 from pot
RandyVas finished the tournament in 108th place
*** SUMMARY ***
Total pot 17886 | Rake 0=20
Board [2d 4h 3d Td 3c]
Seat 2: jrollsup1 (big blind) folded before Flop
Seat 3: apoch19 folded before Flop (didn't bet)
Seat 4: JJin91 folded before Flop (didn't bet)
Seat 5: Studsg folded before Flop (didn't bet)
Seat 6: jimbo070985 folded on the Turn
Seat 7: caseycards3 showed [Tc Js] and won (17886) with two pair, Tens =
and Threes
Seat 8: RandyVas (button) showed [Ad Qc] and lost with a pair of Threes
Seat 9: lukystrike84 (small blind) folded before Flop


*********** # 25 **************
PokerStars Hand #171440459024: Tournament #1648956582, $18.20+$1.80 USD=
 Hold'em No Limit - Level X (200/400) - 2017/06/19 20:40:51 ET
Table '1648956582 5' 9-max Seat #9 is the button
Seat 2: jrollsup1 (26542 in chips)=20
Seat 3: apoch19 (20388 in chips)=20
Seat 4: JJin91 (7785 in chips)=20
Seat 5: Studsg (9445 in chips)=20
Seat 6: jimbo070985 (9870 in chips)=20
Seat 7: caseycards3 (23208 in chips)=20
Seat 9: lukystrike84 (31334 in chips)=20
jrollsup1: posts the ante 50
apoch19: posts the ante 50
JJin91: posts the ante 50
Studsg: posts the ante 50
jimbo070985: posts the ante 50
caseycards3: posts the ante 50
lukystrike84: posts the ante 50
jrollsup1: posts small blind 200
apoch19: posts big blind 400
*** HOLE CARDS ***
Dealt to JJin91 [Ks 6s]
JJin91: folds=20
Studsg: raises 475 to 875
jimbo070985: folds=20
caseycards3: folds=20
lukystrike84: folds=20
jrollsup1: folds=20
apoch19: folds=20
Uncalled bet (475) returned to Studsg
Studsg collected 1350 from pot
*** SUMMARY ***
Total pot 1350 | Rake 0=20
Seat 2: jrollsup1 (small blind) folded before Flop
Seat 3: apoch19 (big blind) folded before Flop
Seat 4: JJin91 folded before Flop (didn't bet)
Seat 5: Studsg collected (1350)
Seat 6: jimbo070985 folded before Flop (didn't bet)
Seat 7: caseycards3 folded before Flop (didn't bet)
Seat 9: lukystrike84 (button) folded before Flop (didn't bet)


*********** # 26 **************
PokerStars Hand #171440459132: Tournament #1648956582, $18.20+$1.80 USD=
 Hold'em No Limit - Level X (200/400) - 2017/06/19 20:41:10 ET
Table '1648956582 5' 9-max Seat #2 is the button
Seat 2: jrollsup1 (26292 in chips)=20
Seat 3: apoch19 (19938 in chips)=20
Seat 4: JJin91 (7735 in chips)=20
Seat 5: Studsg (10345 in chips)=20
Seat 6: jimbo070985 (9820 in chips)=20
Seat 7: caseycards3 (23158 in chips)=20
Seat 9: lukystrike84 (31284 in chips)=20
jrollsup1: posts the ante 50
apoch19: posts the ante 50
JJin91: posts the ante 50
Studsg: posts the ante 50
jimbo070985: posts the ante 50
caseycards3: posts the ante 50
lukystrike84: posts the ante 50
apoch19: posts small blind 200
JJin91: posts big blind 400
*** HOLE CARDS ***
Dealt to JJin91 [7s Qc]
Studsg: folds=20
jimbo070985: folds=20
caseycards3: folds=20
lukystrike84: folds=20
jrollsup1: folds=20
apoch19: folds=20
Uncalled bet (200) returned to JJin91
JJin91 collected 750 from pot
JJin91: doesn't show hand=20
*** SUMMARY ***
Total pot 750 | Rake 0=20
Seat 2: jrollsup1 (button) folded before Flop (didn't bet)
Seat 3: apoch19 (small blind) folded before Flop
Seat 4: JJin91 (big blind) collected (750)
Seat 5: Studsg folded before Flop (didn't bet)
Seat 6: jimbo070985 folded before Flop (didn't bet)
Seat 7: caseycards3 folded before Flop (didn't bet)
Seat 9: lukystrike84 folded before Flop (didn't bet)


*********** # 27 **************
PokerStars Hand #171440459213: Tournament #1648956582, $18.20+$1.80 USD=
 Hold'em No Limit - Level X (200/400) - 2017/06/19 20:41:25 ET
Table '1648956582 5' 9-max Seat #3 is the button
Seat 2: jrollsup1 (26242 in chips)=20
Seat 3: apoch19 (19688 in chips)=20
Seat 4: JJin91 (8235 in chips)=20
Seat 5: Studsg (10295 in chips)=20
Seat 6: jimbo070985 (9770 in chips)=20
Seat 7: caseycards3 (23108 in chips)=20
Seat 8: arizonagolf3 (14275 in chips)=20
Seat 9: lukystrike84 (31234 in chips)=20
jrollsup1: posts the ante 50
apoch19: posts the ante 50
JJin91: posts the ante 50
Studsg: posts the ante 50
jimbo070985: posts the ante 50
caseycards3: posts the ante 50
arizonagolf3: posts the ante 50
lukystrike84: posts the ante 50
JJin91: posts small blind 200
Studsg: posts big blind 400
*** HOLE CARDS ***
Dealt to JJin91 [Ad Jc]
jimbo070985: folds=20
caseycards3: raises 440 to 840
arizonagolf3: folds=20
lukystrike84: folds=20
jrollsup1: folds=20
apoch19: folds=20
JJin91: calls 640
Studsg: calls 440
*** FLOP *** [Tc Jd 3h]
JJin91: bets 1664
Studsg: folds=20
caseycards3: raises 5136 to 6800
JJin91: raises 545 to 7345 and is all-in
caseycards3: calls 545
*** TURN *** [Tc Jd 3h] [5s]
*** RIVER *** [Tc Jd 3h 5s] [Kh]
*** SHOW DOWN ***
JJin91: shows [Ad Jc] (a pair of Jacks)
caseycards3: shows [2s 2c] (a pair of Deuces)
JJin91 collected 17610 from pot
*** SUMMARY ***
Total pot 17610 | Rake 0=20
Board [Tc Jd 3h 5s Kh]
Seat 2: jrollsup1 folded before Flop (didn't bet)
Seat 3: apoch19 (button) folded before Flop (didn't bet)
Seat 4: JJin91 (small blind) showed [Ad Jc] and won (17610) with a pair=
 of Jacks
Seat 5: Studsg (big blind) folded on the Flop
Seat 6: jimbo070985 folded before Flop (didn't bet)
Seat 7: caseycards3 showed [2s 2c] and lost with a pair of Deuces
Seat 8: arizonagolf3 folded before Flop (didn't bet)
Seat 9: lukystrike84 folded before Flop (didn't bet)


*********** # 28 **************
PokerStars Hand #171440459480: Tournament #1648956582, $18.20+$1.80 USD=
 Hold'em No Limit - Level X (200/400) - 2017/06/19 20:42:19 ET
Table '1648956582 5' 9-max Seat #4 is the button
Seat 2: jrollsup1 (26192 in chips)=20
Seat 3: apoch19 (19638 in chips)=20
Seat 4: JJin91 (17610 in chips)=20
Seat 5: Studsg (9405 in chips)=20
Seat 6: jimbo070985 (9720 in chips)=20
Seat 7: caseycards3 (14873 in chips)=20
Seat 8: arizonagolf3 (14225 in chips)=20
Seat 9: lukystrike84 (31184 in chips)=20
jrollsup1: posts the ante 50
apoch19: posts the ante 50
JJin91: posts the ante 50
Studsg: posts the ante 50
jimbo070985: posts the ante 50
caseycards3: posts the ante 50
arizonagolf3: posts the ante 50
lukystrike84: posts the ante 50
Studsg: posts small blind 200
jimbo070985: posts big blind 400
*** HOLE CARDS ***
Dealt to JJin91 [4s Jd]
caseycards3: folds=20
arizonagolf3: folds=20
lukystrike84: folds=20
jrollsup1: folds=20
apoch19: folds=20
JJin91: raises 628 to 1028
Studsg: folds=20
jimbo070985: folds=20
Uncalled bet (628) returned to JJin91
JJin91 collected 1400 from pot
JJin91: doesn't show hand=20
*** SUMMARY ***
Total pot 1400 | Rake 0=20
Seat 2: jrollsup1 folded before Flop (didn't bet)
Seat 3: apoch19 folded before Flop (didn't bet)
Seat 4: JJin91 (button) collected (1400)
Seat 5: Studsg (small blind) folded before Flop
Seat 6: jimbo070985 (big blind) folded before Flop
Seat 7: caseycards3 folded before Flop (didn't bet)
Seat 8: arizonagolf3 folded before Flop (didn't bet)
Seat 9: lukystrike84 folded before Flop (didn't bet)


*********** # 29 **************
PokerStars Hand #171440459608: Tournament #1648956582, $18.20+$1.80 USD=
 Hold'em No Limit - Level X (200/400) - 2017/06/19 20:42:43 ET
Table '1648956582 5' 9-max Seat #5 is the button
Seat 1: sfarbs (19490 in chips)=20
Seat 2: jrollsup1 (26142 in chips)=20
Seat 3: apoch19 (19588 in chips)=20
Seat 4: JJin91 (18560 in chips)=20
Seat 5: Studsg (9155 in chips)=20
Seat 6: jimbo070985 (9270 in chips)=20
Seat 7: caseycards3 (14823 in chips)=20
Seat 8: arizonagolf3 (14175 in chips)=20
Seat 9: lukystrike84 (31134 in chips)=20
sfarbs: posts the ante 50
jrollsup1: posts the ante 50
apoch19: posts the ante 50
JJin91: posts the ante 50
Studsg: posts the ante 50
jimbo070985: posts the ante 50
caseycards3: posts the ante 50
arizonagolf3: posts the ante 50
lukystrike84: posts the ante 50
jimbo070985: posts small blind 200
caseycards3: posts big blind 400
*** HOLE CARDS ***
Dealt to JJin91 [2s 9d]
arizonagolf3: calls 400
lukystrike84: folds=20
sfarbs: folds=20
jrollsup1: folds=20
apoch19: folds=20
JJin91: folds=20
Studsg: calls 400
jimbo070985: calls 200
caseycards3: checks=20
*** FLOP *** [2c Qd 4s]
jimbo070985: bets 400
caseycards3: folds=20
arizonagolf3: calls 400
Studsg: folds=20
*** TURN *** [2c Qd 4s] [3h]
jimbo070985: checks=20
arizonagolf3: checks=20
*** RIVER *** [2c Qd 4s 3h] [3s]
jimbo070985: checks=20
arizonagolf3: bets 1600
jimbo070985: folds=20
Uncalled bet (1600) returned to arizonagolf3
arizonagolf3 collected 2850 from pot
arizonagolf3: doesn't show hand=20
*** SUMMARY ***
Total pot 2850 | Rake 0=20
Board [2c Qd 4s 3h 3s]
Seat 1: sfarbs folded before Flop (didn't bet)
Seat 2: jrollsup1 folded before Flop (didn't bet)
Seat 3: apoch19 folded before Flop (didn't bet)
Seat 4: JJin91 folded before Flop (didn't bet)
Seat 5: Studsg (button) folded on the Flop
Seat 6: jimbo070985 (small blind) folded on the River
Seat 7: caseycards3 (big blind) folded on the Flop
Seat 8: arizonagolf3 collected (2850)
Seat 9: lukystrike84 folded before Flop (didn't bet)


*********** # 30 **************
PokerStars Hand #171440459905: Tournament #1648956582, $18.20+$1.80 USD=
 Hold'em No Limit - Level X (200/400) - 2017/06/19 20:43:40 ET
Table '1648956582 5' 9-max Seat #6 is the button
Seat 1: sfarbs (19440 in chips)=20
Seat 2: jrollsup1 (26092 in chips)=20
Seat 3: apoch19 (19538 in chips)=20
Seat 4: JJin91 (18510 in chips)=20
Seat 5: Studsg (8705 in chips)=20
Seat 6: jimbo070985 (8420 in chips)=20
Seat 7: caseycards3 (14373 in chips)=20
Seat 8: arizonagolf3 (16175 in chips)=20
Seat 9: lukystrike84 (31084 in chips)=20
sfarbs: posts the ante 50
jrollsup1: posts the ante 50
apoch19: posts the ante 50
JJin91: posts the ante 50
Studsg: posts the ante 50
jimbo070985: posts the ante 50
caseycards3: posts the ante 50
arizonagolf3: posts the ante 50
lukystrike84: posts the ante 50
caseycards3: posts small blind 200
arizonagolf3: posts big blind 400
*** HOLE CARDS ***
Dealt to JJin91 [Qd 6h]
lukystrike84: folds=20
sfarbs: folds=20
jrollsup1: folds=20
apoch19: folds=20
JJin91: folds=20
Studsg: folds=20
jimbo070985: raises 400 to 800
caseycards3: folds=20
arizonagolf3: calls 400
*** FLOP *** [6c Kc 2c]
arizonagolf3: checks=20
jimbo070985: checks=20
*** TURN *** [6c Kc 2c] [Jc]
arizonagolf3: bets 400
jimbo070985: calls 400
*** RIVER *** [6c Kc 2c Jc] [Jd]
arizonagolf3: bets 3200
jimbo070985: calls 3200
*** SHOW DOWN ***
arizonagolf3: shows [Kd Jh] (a full house, Jacks full of Kings)
jimbo070985: mucks hand=20
arizonagolf3 collected 9450 from pot
*** SUMMARY ***
Total pot 9450 | Rake 0=20
Board [6c Kc 2c Jc Jd]
Seat 1: sfarbs folded before Flop (didn't bet)
Seat 2: jrollsup1 folded before Flop (didn't bet)
Seat 3: apoch19 folded before Flop (didn't bet)
Seat 4: JJin91 folded before Flop (didn't bet)
Seat 5: Studsg folded before Flop (didn't bet)
Seat 6: jimbo070985 (button) mucked [Tc 8c]
Seat 7: caseycards3 (small blind) folded before Flop
Seat 8: arizonagolf3 (big blind) showed [Kd Jh] and won (9450) with a f=
ull house, Jacks full of Kings
Seat 9: lukystrike84 folded before Flop (didn't bet)


*********** # 31 **************
PokerStars Hand #171441910641: Tournament #1648956582, $18.20+$1.80 USD=
 Hold'em No Limit - Level X (200/400) - 2017/06/19 20:45:08 ET
Table '1648956582 5' 9-max Seat #7 is the button
Seat 1: sfarbs (19390 in chips)=20
Seat 2: jrollsup1 (26042 in chips)=20
Seat 3: apoch19 (19488 in chips)=20
Seat 4: JJin91 (18460 in chips)=20
Seat 5: Studsg (8655 in chips)=20
Seat 6: jimbo070985 (3970 in chips)=20
Seat 7: caseycards3 (14123 in chips)=20
Seat 8: arizonagolf3 (21175 in chips)=20
Seat 9: lukystrike84 (31034 in chips)=20
sfarbs: posts the ante 50
jrollsup1: posts the ante 50
apoch19: posts the ante 50
JJin91: posts the ante 50
Studsg: posts the ante 50
jimbo070985: posts the ante 50
caseycards3: posts the ante 50
arizonagolf3: posts the ante 50
lukystrike84: posts the ante 50
arizonagolf3: posts small blind 200
lukystrike84: posts big blind 400
*** HOLE CARDS ***
Dealt to JJin91 [2s 6s]
sfarbs: folds=20
jrollsup1: folds=20
apoch19: folds=20
JJin91: folds=20
Studsg: folds=20
jimbo070985: folds=20
caseycards3: folds=20
arizonagolf3: raises 1200 to 1600
lukystrike84: folds=20
Uncalled bet (1200) returned to arizonagolf3
arizonagolf3 collected 1250 from pot
arizonagolf3: doesn't show hand=20
*** SUMMARY ***
Total pot 1250 | Rake 0=20
Seat 1: sfarbs folded before Flop (didn't bet)
Seat 2: jrollsup1 folded before Flop (didn't bet)
Seat 3: apoch19 folded before Flop (didn't bet)
Seat 4: JJin91 folded before Flop (didn't bet)
Seat 5: Studsg folded before Flop (didn't bet)
Seat 6: jimbo070985 folded before Flop (didn't bet)
Seat 7: caseycards3 (button) folded before Flop (didn't bet)
Seat 8: arizonagolf3 (small blind) collected (1250)
Seat 9: lukystrike84 (big blind) folded before Flop


*********** # 32 **************
PokerStars Hand #171441910760: Tournament #1648956582, $18.20+$1.80 USD=
 Hold'em No Limit - Level X (200/400) - 2017/06/19 20:45:29 ET
Table '1648956582 5' 9-max Seat #8 is the button
Seat 1: sfarbs (19340 in chips)=20
Seat 2: jrollsup1 (25992 in chips)=20
Seat 3: apoch19 (19438 in chips)=20
Seat 4: JJin91 (18410 in chips)=20
Seat 5: Studsg (8605 in chips)=20
Seat 6: jimbo070985 (3920 in chips)=20
Seat 7: caseycards3 (14073 in chips)=20
Seat 8: arizonagolf3 (21975 in chips)=20
Seat 9: lukystrike84 (30584 in chips)=20
sfarbs: posts the ante 50
jrollsup1: posts the ante 50
apoch19: posts the ante 50
JJin91: posts the ante 50
Studsg: posts the ante 50
jimbo070985: posts the ante 50
caseycards3: posts the ante 50
arizonagolf3: posts the ante 50
lukystrike84: posts the ante 50
lukystrike84: posts small blind 200
sfarbs: posts big blind 400
*** HOLE CARDS ***
Dealt to JJin91 [Ks Kc]
jrollsup1: folds=20
apoch19: folds=20
JJin91: raises 628 to 1028
Studsg: folds=20
jimbo070985: folds=20
caseycards3: folds=20
arizonagolf3: folds=20
lukystrike84: folds=20
sfarbs: folds=20
Uncalled bet (628) returned to JJin91
JJin91 collected 1450 from pot
JJin91: doesn't show hand=20
*** SUMMARY ***
Total pot 1450 | Rake 0=20
Seat 1: sfarbs (big blind) folded before Flop
Seat 2: jrollsup1 folded before Flop (didn't bet)
Seat 3: apoch19 folded before Flop (didn't bet)
Seat 4: JJin91 collected (1450)
Seat 5: Studsg folded before Flop (didn't bet)
Seat 6: jimbo070985 folded before Flop (didn't bet)
Seat 7: caseycards3 folded before Flop (didn't bet)
Seat 8: arizonagolf3 (button) folded before Flop (didn't bet)
Seat 9: lukystrike84 (small blind) folded before Flop


*********** # 33 **************
PokerStars Hand #171441910973: Tournament #1648956582, $18.20+$1.80 USD=
 Hold'em No Limit - Level X (200/400) - 2017/06/19 20:46:06 ET
Table '1648956582 5' 9-max Seat #9 is the button
Seat 1: sfarbs (18890 in chips)=20
Seat 2: jrollsup1 (25942 in chips)=20
Seat 3: apoch19 (19388 in chips)=20
Seat 4: JJin91 (19410 in chips)=20
Seat 5: Studsg (8555 in chips)=20
Seat 6: jimbo070985 (3870 in chips)=20
Seat 7: caseycards3 (14023 in chips)=20
Seat 8: arizonagolf3 (21925 in chips)=20
Seat 9: lukystrike84 (30334 in chips)=20
sfarbs: posts the ante 50
jrollsup1: posts the ante 50
apoch19: posts the ante 50
JJin91: posts the ante 50
Studsg: posts the ante 50
jimbo070985: posts the ante 50
caseycards3: posts the ante 50
arizonagolf3: posts the ante 50
lukystrike84: posts the ante 50
sfarbs: posts small blind 200
jrollsup1: posts big blind 400
*** HOLE CARDS ***
Dealt to JJin91 [5c Ac]
apoch19: folds=20
JJin91: folds=20
Studsg: folds=20
jimbo070985: folds=20
caseycards3: raises 440 to 840
arizonagolf3: calls 840
lukystrike84: folds=20
sfarbs: folds=20
jrollsup1: folds=20
*** FLOP *** [8h 4d 7d]
caseycards3: checks=20
arizonagolf3: checks=20
*** TURN *** [8h 4d 7d] [2s]
caseycards3: checks=20
arizonagolf3: checks=20
*** RIVER *** [8h 4d 7d 2s] [9c]
caseycards3: bets 1600
arizonagolf3: folds=20
Uncalled bet (1600) returned to caseycards3
caseycards3 collected 2730 from pot
caseycards3: doesn't show hand=20
*** SUMMARY ***
Total pot 2730 | Rake 0=20
Board [8h 4d 7d 2s 9c]
Seat 1: sfarbs (small blind) folded before Flop
Seat 2: jrollsup1 (big blind) folded before Flop
Seat 3: apoch19 folded before Flop (didn't bet)
Seat 4: JJin91 folded before Flop (didn't bet)
Seat 5: Studsg folded before Flop (didn't bet)
Seat 6: jimbo070985 folded before Flop (didn't bet)
Seat 7: caseycards3 collected (2730)
Seat 8: arizonagolf3 folded on the River
Seat 9: lukystrike84 (button) folded before Flop (didn't bet)


*********** # 34 **************
PokerStars Hand #171441911302: Tournament #1648956582, $18.20+$1.80 USD=
 Hold'em No Limit - Level XI (250/500) - 2017/06/19 20:47:06 ET
Table '1648956582 5' 9-max Seat #1 is the button
Seat 1: sfarbs (18640 in chips)=20
Seat 2: jrollsup1 (25492 in chips)=20
Seat 3: apoch19 (19338 in chips)=20
Seat 4: JJin91 (19360 in chips)=20
Seat 5: Studsg (8505 in chips)=20
Seat 6: jimbo070985 (3820 in chips)=20
Seat 7: caseycards3 (15863 in chips)=20
Seat 8: arizonagolf3 (21035 in chips)=20
Seat 9: lukystrike84 (30284 in chips)=20
sfarbs: posts the ante 60
jrollsup1: posts the ante 60
apoch19: posts the ante 60
JJin91: posts the ante 60
Studsg: posts the ante 60
jimbo070985: posts the ante 60
caseycards3: posts the ante 60
arizonagolf3: posts the ante 60
lukystrike84: posts the ante 60
jrollsup1: posts small blind 250
apoch19: posts big blind 500
*** HOLE CARDS ***
Dealt to JJin91 [Qd Jc]
JJin91: folds=20
Studsg: folds=20
jimbo070985: calls 500
caseycards3: folds=20
arizonagolf3: folds=20
lukystrike84: folds=20
sfarbs: folds=20
jrollsup1: calls 250
apoch19: checks=20
*** FLOP *** [2h Js 8c]
jrollsup1: checks=20
apoch19: checks=20
jimbo070985: bets 500
jrollsup1: folds=20
apoch19: folds=20
Uncalled bet (500) returned to jimbo070985
jimbo070985 collected 2040 from pot
jimbo070985: doesn't show hand=20
*** SUMMARY ***
Total pot 2040 | Rake 0=20
Board [2h Js 8c]
Seat 1: sfarbs (button) folded before Flop (didn't bet)
Seat 2: jrollsup1 (small blind) folded on the Flop
Seat 3: apoch19 (big blind) folded on the Flop
Seat 4: JJin91 folded before Flop (didn't bet)
Seat 5: Studsg folded before Flop (didn't bet)
Seat 6: jimbo070985 collected (2040)
Seat 7: caseycards3 folded before Flop (didn't bet)
Seat 8: arizonagolf3 folded before Flop (didn't bet)
Seat 9: lukystrike84 folded before Flop (didn't bet)


*********** # 35 **************
PokerStars Hand #171441911542: Tournament #1648956582, $18.20+$1.80 USD=
 Hold'em No Limit - Level XI (250/500) - 2017/06/19 20:47:47 ET
Table '1648956582 5' 9-max Seat #2 is the button
Seat 1: sfarbs (18580 in chips)=20
Seat 2: jrollsup1 (24932 in chips)=20
Seat 3: apoch19 (18778 in chips)=20
Seat 4: JJin91 (19300 in chips)=20
Seat 5: Studsg (8445 in chips)=20
Seat 6: jimbo070985 (5300 in chips)=20
Seat 7: caseycards3 (15803 in chips)=20
Seat 8: arizonagolf3 (20975 in chips)=20
Seat 9: lukystrike84 (30224 in chips)=20
sfarbs: posts the ante 60
jrollsup1: posts the ante 60
apoch19: posts the ante 60
JJin91: posts the ante 60
Studsg: posts the ante 60
jimbo070985: posts the ante 60
caseycards3: posts the ante 60
arizonagolf3: posts the ante 60
lukystrike84: posts the ante 60
apoch19: posts small blind 250
JJin91: posts big blind 500
*** HOLE CARDS ***
Dealt to JJin91 [Td 4h]
Studsg: folds=20
jimbo070985: folds=20
caseycards3: folds=20
arizonagolf3: raises 1790 to 2290
lukystrike84: folds=20
sfarbs: folds=20
jrollsup1: folds=20
apoch19: folds=20
JJin91: folds=20
Uncalled bet (1790) returned to arizonagolf3
arizonagolf3 collected 1790 from pot
arizonagolf3: doesn't show hand=20
*** SUMMARY ***
Total pot 1790 | Rake 0=20
Seat 1: sfarbs folded before Flop (didn't bet)
Seat 2: jrollsup1 (button) folded before Flop (didn't bet)
Seat 3: apoch19 (small blind) folded before Flop
Seat 4: JJin91 (big blind) folded before Flop
Seat 5: Studsg folded before Flop (didn't bet)
Seat 6: jimbo070985 folded before Flop (didn't bet)
Seat 7: caseycards3 folded before Flop (didn't bet)
Seat 8: arizonagolf3 collected (1790)
Seat 9: lukystrike84 folded before Flop (didn't bet)


*********** # 36 **************
PokerStars Hand #171441911670: Tournament #1648956582, $18.20+$1.80 USD=
 Hold'em No Limit - Level XI (250/500) - 2017/06/19 20:48:09 ET
Table '1648956582 5' 9-max Seat #3 is the button
Seat 1: sfarbs (18520 in chips)=20
Seat 2: jrollsup1 (24872 in chips)=20
Seat 3: apoch19 (18468 in chips)=20
Seat 4: JJin91 (18740 in chips)=20
Seat 5: Studsg (8385 in chips)=20
Seat 6: jimbo070985 (5240 in chips)=20
Seat 7: caseycards3 (15743 in chips)=20
Seat 8: arizonagolf3 (22205 in chips)=20
Seat 9: lukystrike84 (30164 in chips)=20
sfarbs: posts the ante 60
jrollsup1: posts the ante 60
apoch19: posts the ante 60
JJin91: posts the ante 60
Studsg: posts the ante 60
jimbo070985: posts the ante 60
caseycards3: posts the ante 60
arizonagolf3: posts the ante 60
lukystrike84: posts the ante 60
JJin91: posts small blind 250
Studsg: posts big blind 500
*** HOLE CARDS ***
Dealt to JJin91 [Kc Qc]
jimbo070985: folds=20
caseycards3: folds=20
arizonagolf3: folds=20
lukystrike84: folds=20
sfarbs: folds=20
jrollsup1: folds=20
apoch19: folds=20
JJin91: raises 18180 to 18680 and is all-in
Studsg: folds=20
Uncalled bet (18180) returned to JJin91
JJin91 collected 1540 from pot
JJin91: doesn't show hand=20
*** SUMMARY ***
Total pot 1540 | Rake 0=20
Seat 1: sfarbs folded before Flop (didn't bet)
Seat 2: jrollsup1 folded before Flop (didn't bet)
Seat 3: apoch19 (button) folded before Flop (didn't bet)
Seat 4: JJin91 (small blind) collected (1540)
Seat 5: Studsg (big blind) folded before Flop
Seat 6: jimbo070985 folded before Flop (didn't bet)
Seat 7: caseycards3 folded before Flop (didn't bet)
Seat 8: arizonagolf3 folded before Flop (didn't bet)
Seat 9: lukystrike84 folded before Flop (didn't bet)


*********** # 37 **************
PokerStars Hand #171441911782: Tournament #1648956582, $18.20+$1.80 USD=
 Hold'em No Limit - Level XI (250/500) - 2017/06/19 20:48:33 ET
Table '1648956582 5' 9-max Seat #4 is the button
Seat 1: sfarbs (18460 in chips)=20
Seat 2: jrollsup1 (24812 in chips)=20
Seat 3: apoch19 (18408 in chips)=20
Seat 4: JJin91 (19720 in chips)=20
Seat 5: Studsg (7825 in chips)=20
Seat 6: jimbo070985 (5180 in chips)=20
Seat 7: caseycards3 (15683 in chips)=20
Seat 8: arizonagolf3 (22145 in chips)=20
Seat 9: lukystrike84 (30104 in chips)=20
sfarbs: posts the ante 60
jrollsup1: posts the ante 60
apoch19: posts the ante 60
JJin91: posts the ante 60
Studsg: posts the ante 60
jimbo070985: posts the ante 60
caseycards3: posts the ante 60
arizonagolf3: posts the ante 60
lukystrike84: posts the ante 60
Studsg: posts small blind 250
jimbo070985: posts big blind 500
*** HOLE CARDS ***
Dealt to JJin91 [4h 6c]
caseycards3: calls 500
arizonagolf3: calls 500
lukystrike84: folds=20
sfarbs: raises 1255 to 1755
jrollsup1: folds=20
apoch19: folds=20
JJin91: folds=20
Studsg: folds=20
jimbo070985: folds=20
caseycards3: calls 1255
arizonagolf3: calls 1255
*** FLOP *** [2s 5c 7h]
caseycards3: checks=20
arizonagolf3: checks=20
sfarbs: checks=20
*** TURN *** [2s 5c 7h] [Ac]
caseycards3: checks=20
arizonagolf3: checks=20
sfarbs: bets 3146
caseycards3: calls 3146
arizonagolf3: folds=20
*** RIVER *** [2s 5c 7h Ac] [7d]
caseycards3: bets 10722 and is all-in
sfarbs: calls 10722
*** SHOW DOWN ***
caseycards3: shows [Js As] (two pair, Aces and Sevens)
sfarbs: shows [Ad Qd] (two pair, Aces and Sevens - Queen kicker)
sfarbs collected 34291 from pot
caseycards3 finished the tournament in 94th place
*** SUMMARY ***
Total pot 34291 | Rake 0=20
Board [2s 5c 7h Ac 7d]
Seat 1: sfarbs showed [Ad Qd] and won (34291) with two pair, Aces and S=
evens
Seat 2: jrollsup1 folded before Flop (didn't bet)
Seat 3: apoch19 folded before Flop (didn't bet)
Seat 4: JJin91 (button) folded before Flop (didn't bet)
Seat 5: Studsg (small blind) folded before Flop
Seat 6: jimbo070985 (big blind) folded before Flop
Seat 7: caseycards3 showed [Js As] and lost with two pair, Aces and Sev=
ens
Seat 8: arizonagolf3 folded on the Turn
Seat 9: lukystrike84 folded before Flop (didn't bet)


*********** # 38 **************
PokerStars Hand #171441912350: Tournament #1648956582, $18.20+$1.80 USD=
 Hold'em No Limit - Level XI (250/500) - 2017/06/19 20:50:23 ET
Table '1648956582 5' 9-max Seat #5 is the button
Seat 1: sfarbs (37068 in chips)=20
Seat 2: jrollsup1 (24752 in chips)=20
Seat 3: apoch19 (18348 in chips)=20
Seat 4: JJin91 (19660 in chips)=20
Seat 5: Studsg (7515 in chips)=20
Seat 6: jimbo070985 (4620 in chips)=20
Seat 8: arizonagolf3 (20330 in chips)=20
Seat 9: lukystrike84 (30044 in chips)=20
sfarbs: posts the ante 60
jrollsup1: posts the ante 60
apoch19: posts the ante 60
JJin91: posts the ante 60
Studsg: posts the ante 60
jimbo070985: posts the ante 60
arizonagolf3: posts the ante 60
lukystrike84: posts the ante 60
jimbo070985: posts small blind 250
arizonagolf3: posts big blind 500
*** HOLE CARDS ***
Dealt to JJin91 [Kd 6c]
lukystrike84: folds=20
sfarbs: folds=20
jrollsup1: folds=20
apoch19: raises 750 to 1250
JJin91: folds=20
Studsg: folds=20
jimbo070985: folds=20
arizonagolf3: folds=20
Uncalled bet (750) returned to apoch19
apoch19 collected 1730 from pot
apoch19: doesn't show hand=20
*** SUMMARY ***
Total pot 1730 | Rake 0=20
Seat 1: sfarbs folded before Flop (didn't bet)
Seat 2: jrollsup1 folded before Flop (didn't bet)
Seat 3: apoch19 collected (1730)
Seat 4: JJin91 folded before Flop (didn't bet)
Seat 5: Studsg (button) folded before Flop (didn't bet)
Seat 6: jimbo070985 (small blind) folded before Flop
Seat 8: arizonagolf3 (big blind) folded before Flop
Seat 9: lukystrike84 folded before Flop (didn't bet)


*********** # 39 **************
PokerStars Hand #171441912434: Tournament #1648956582, $18.20+$1.80 USD=
 Hold'em No Limit - Level XI (250/500) - 2017/06/19 20:50:40 ET
Table '1648956582 5' 9-max Seat #6 is the button
Seat 1: sfarbs (37008 in chips)=20
Seat 2: jrollsup1 (24692 in chips)=20
Seat 3: apoch19 (19518 in chips)=20
Seat 4: JJin91 (19600 in chips)=20
Seat 5: Studsg (7455 in chips)=20
Seat 6: jimbo070985 (4310 in chips)=20
Seat 8: arizonagolf3 (19770 in chips)=20
Seat 9: lukystrike84 (29984 in chips)=20
sfarbs: posts the ante 60
jrollsup1: posts the ante 60
apoch19: posts the ante 60
JJin91: posts the ante 60
Studsg: posts the ante 60
jimbo070985: posts the ante 60
arizonagolf3: posts the ante 60
lukystrike84: posts the ante 60
arizonagolf3: posts small blind 250
lukystrike84: posts big blind 500
*** HOLE CARDS ***
Dealt to JJin91 [Kd 6h]
sfarbs: folds=20
jrollsup1: raises 750 to 1250
apoch19: folds=20
JJin91: folds=20
Studsg: folds=20
jimbo070985: folds=20
arizonagolf3: folds=20
lukystrike84: calls 750
*** FLOP *** [5h 9d 3c]
lukystrike84: checks=20
jrollsup1: bets 1615
lukystrike84: folds=20
Uncalled bet (1615) returned to jrollsup1
jrollsup1 collected 3230 from pot
jrollsup1: doesn't show hand=20
*** SUMMARY ***
Total pot 3230 | Rake 0=20
Board [5h 9d 3c]
Seat 1: sfarbs folded before Flop (didn't bet)
Seat 2: jrollsup1 collected (3230)
Seat 3: apoch19 folded before Flop (didn't bet)
Seat 4: JJin91 folded before Flop (didn't bet)
Seat 5: Studsg folded before Flop (didn't bet)
Seat 6: jimbo070985 (button) folded before Flop (didn't bet)
Seat 8: arizonagolf3 (small blind) folded before Flop
Seat 9: lukystrike84 (big blind) folded on the Flop


*********** # 40 **************
PokerStars Hand #171441912639: Tournament #1648956582, $18.20+$1.80 USD=
 Hold'em No Limit - Level XI (250/500) - 2017/06/19 20:51:19 ET
Table '1648956582 5' 9-max Seat #8 is the button
Seat 1: sfarbs (36948 in chips)=20
Seat 2: jrollsup1 (26612 in chips)=20
Seat 3: apoch19 (19458 in chips)=20
Seat 4: JJin91 (19540 in chips)=20
Seat 5: Studsg (7395 in chips)=20
Seat 6: jimbo070985 (4250 in chips)=20
Seat 8: arizonagolf3 (19460 in chips)=20
Seat 9: lukystrike84 (28674 in chips)=20
sfarbs: posts the ante 60
jrollsup1: posts the ante 60
apoch19: posts the ante 60
JJin91: posts the ante 60
Studsg: posts the ante 60
jimbo070985: posts the ante 60
arizonagolf3: posts the ante 60
lukystrike84: posts the ante 60
lukystrike84: posts small blind 250
sfarbs: posts big blind 500
*** HOLE CARDS ***
Dealt to JJin91 [9d 9c]
jrollsup1: folds=20
apoch19: folds=20
JJin91: raises 595 to 1095
Studsg: raises 6240 to 7335 and is all-in
jimbo070985: folds=20
arizonagolf3: folds=20
lukystrike84: folds=20
sfarbs: folds=20
JJin91: calls 6240
*** FLOP *** [Kd Kh 7h]
*** TURN *** [Kd Kh 7h] [2s]
*** RIVER *** [Kd Kh 7h 2s] [6d]
*** SHOW DOWN ***
JJin91: shows [9d 9c] (two pair, Kings and Nines)
Studsg: shows [Ac Jh] (a pair of Kings)
JJin91 collected 15900 from pot
Studsg finished the tournament in 92nd place
*** SUMMARY ***
Total pot 15900 | Rake 0=20
Board [Kd Kh 7h 2s 6d]
Seat 1: sfarbs (big blind) folded before Flop
Seat 2: jrollsup1 folded before Flop (didn't bet)
Seat 3: apoch19 folded before Flop (didn't bet)
Seat 4: JJin91 showed [9d 9c] and won (15900) with two pair, Kings and =
Nines
Seat 5: Studsg showed [Ac Jh] and lost with a pair of Kings
Seat 6: jimbo070985 folded before Flop (didn't bet)
Seat 8: arizonagolf3 (button) folded before Flop (didn't bet)
Seat 9: lukystrike84 (small blind) folded before Flop


*********** # 41 **************
PokerStars Hand #171441912843: Tournament #1648956582, $18.20+$1.80 USD=
 Hold'em No Limit - Level XI (250/500) - 2017/06/19 20:51:53 ET
Table '1648956582 5' 9-max Seat #9 is the button
Seat 1: sfarbs (36388 in chips)=20
Seat 2: jrollsup1 (26552 in chips)=20
Seat 3: apoch19 (19398 in chips)=20
Seat 4: JJin91 (28045 in chips)=20
Seat 6: jimbo070985 (4190 in chips)=20
Seat 8: arizonagolf3 (19400 in chips)=20
Seat 9: lukystrike84 (28364 in chips)=20
sfarbs: posts the ante 60
jrollsup1: posts the ante 60
apoch19: posts the ante 60
JJin91: posts the ante 60
jimbo070985: posts the ante 60
arizonagolf3: posts the ante 60
lukystrike84: posts the ante 60
sfarbs: posts small blind 250
jrollsup1: posts big blind 500
*** HOLE CARDS ***
Dealt to JJin91 [Js 9c]
apoch19: folds=20
JJin91: folds=20
jimbo070985: folds=20
arizonagolf3: folds=20
lukystrike84: raises 1000 to 1500
sfarbs: folds=20
jrollsup1: folds=20
Uncalled bet (1000) returned to lukystrike84
lukystrike84 collected 1670 from pot
lukystrike84: doesn't show hand=20
*** SUMMARY ***
Total pot 1670 | Rake 0=20
Seat 1: sfarbs (small blind) folded before Flop
Seat 2: jrollsup1 (big blind) folded before Flop
Seat 3: apoch19 folded before Flop (didn't bet)
Seat 4: JJin91 folded before Flop (didn't bet)
Seat 6: jimbo070985 folded before Flop (didn't bet)
Seat 8: arizonagolf3 folded before Flop (didn't bet)
Seat 9: lukystrike84 (button) collected (1670)


*********** # 42 **************
PokerStars Hand #171441912917: Tournament #1648956582, $18.20+$1.80 USD=
 Hold'em No Limit - Level XI (250/500) - 2017/06/19 20:52:09 ET
Table '1648956582 5' 9-max Seat #1 is the button
Seat 1: sfarbs (36078 in chips)=20
Seat 2: jrollsup1 (25992 in chips)=20
Seat 3: apoch19 (19338 in chips)=20
Seat 4: JJin91 (27985 in chips)=20
Seat 5: Bsgwolfpack4 (10909 in chips)=20
Seat 6: jimbo070985 (4130 in chips)=20
Seat 8: arizonagolf3 (19340 in chips)=20
Seat 9: lukystrike84 (29474 in chips)=20
sfarbs: posts the ante 60
jrollsup1: posts the ante 60
apoch19: posts the ante 60
JJin91: posts the ante 60
Bsgwolfpack4: posts the ante 60
jimbo070985: posts the ante 60
arizonagolf3: posts the ante 60
lukystrike84: posts the ante 60
jrollsup1: posts small blind 250
apoch19: posts big blind 500
*** HOLE CARDS ***
Dealt to JJin91 [Ts 3h]
JJin91: folds=20
Bsgwolfpack4: folds=20
jimbo070985: folds=20
arizonagolf3: folds=20
lukystrike84: folds=20
sfarbs: folds=20
jrollsup1: raises 1000 to 1500
apoch19: calls 1000
*** FLOP *** [9h 7h Kc]
jrollsup1: checks=20
apoch19: bets 1740
jrollsup1: calls 1740
*** TURN *** [9h 7h Kc] [3d]
jrollsup1: checks=20
apoch19: bets 3480
jrollsup1: folds=20
Uncalled bet (3480) returned to apoch19
apoch19 collected 6960 from pot
apoch19: doesn't show hand=20
*** SUMMARY ***
Total pot 6960 | Rake 0=20
Board [9h 7h Kc 3d]
Seat 1: sfarbs (button) folded before Flop (didn't bet)
Seat 2: jrollsup1 (small blind) folded on the Turn
Seat 3: apoch19 (big blind) collected (6960)
Seat 4: JJin91 folded before Flop (didn't bet)
Seat 5: Bsgwolfpack4 folded before Flop (didn't bet)
Seat 6: jimbo070985 folded before Flop (didn't bet)
Seat 8: arizonagolf3 folded before Flop (didn't bet)
Seat 9: lukystrike84 folded before Flop (didn't bet)


*********** # 43 **************
PokerStars Hand #171441913116: Tournament #1648956582, $18.20+$1.80 USD=
 Hold'em No Limit - Level XI (250/500) - 2017/06/19 20:52:46 ET
Table '1648956582 5' 9-max Seat #2 is the button
Seat 1: sfarbs (36018 in chips)=20
Seat 2: jrollsup1 (22692 in chips)=20
Seat 3: apoch19 (22998 in chips)=20
Seat 4: JJin91 (27925 in chips)=20
Seat 5: Bsgwolfpack4 (10849 in chips)=20
Seat 6: jimbo070985 (4070 in chips)=20
Seat 8: arizonagolf3 (19280 in chips)=20
Seat 9: lukystrike84 (29414 in chips)=20
sfarbs: posts the ante 60
jrollsup1: posts the ante 60
apoch19: posts the ante 60
JJin91: posts the ante 60
Bsgwolfpack4: posts the ante 60
jimbo070985: posts the ante 60
arizonagolf3: posts the ante 60
lukystrike84: posts the ante 60
apoch19: posts small blind 250
JJin91: posts big blind 500
*** HOLE CARDS ***
Dealt to JJin91 [4c 7s]
Bsgwolfpack4: folds=20
jimbo070985: raises 3510 to 4010 and is all-in
arizonagolf3: calls 4010
lukystrike84: folds=20
sfarbs: raises 31948 to 35958 and is all-in
jrollsup1: folds=20
apoch19: folds=20
JJin91: folds=20
arizonagolf3: folds=20
Uncalled bet (31948) returned to sfarbs
*** FLOP *** [Qs 7h 6s]
*** TURN *** [Qs 7h 6s] [Qc]
*** RIVER *** [Qs 7h 6s Qc] [As]
*** SHOW DOWN ***
jimbo070985: shows [Ad 6h] (two pair, Aces and Queens)
sfarbs: shows [Kd Ah] (two pair, Aces and Queens - King kicker)
sfarbs collected 13260 from pot
jimbo070985 finished the tournament in 91st place
*** SUMMARY ***
Total pot 13260 | Rake 0=20
Board [Qs 7h 6s Qc As]
Seat 1: sfarbs showed [Kd Ah] and won (13260) with two pair, Aces and Q=
ueens
Seat 2: jrollsup1 (button) folded before Flop (didn't bet)
Seat 3: apoch19 (small blind) folded before Flop
Seat 4: JJin91 (big blind) folded before Flop
Seat 5: Bsgwolfpack4 folded before Flop (didn't bet)
Seat 6: jimbo070985 showed [Ad 6h] and lost with two pair, Aces and Que=
ens
Seat 8: arizonagolf3 folded before Flop
Seat 9: lukystrike84 folded before Flop (didn't bet)


*********** # 44 **************
PokerStars Hand #171441913342: Tournament #1648956582, $18.20+$1.80 USD=
 Hold'em No Limit - Level XI (250/500) - 2017/06/19 20:53:26 ET
Table '1648956582 5' 9-max Seat #3 is the button
Seat 1: sfarbs (45208 in chips)=20
Seat 2: jrollsup1 (22632 in chips)=20
Seat 3: apoch19 (22688 in chips)=20
Seat 4: JJin91 (27365 in chips)=20
Seat 7: millertime42 (10000 in chips)=20
Seat 8: arizonagolf3 (15210 in chips)=20
Seat 9: lukystrike84 (29354 in chips)=20
sfarbs: posts the ante 60
jrollsup1: posts the ante 60
apoch19: posts the ante 60
JJin91: posts the ante 60
millertime42: posts the ante 60
arizonagolf3: posts the ante 60
lukystrike84: posts the ante 60
JJin91: posts small blind 250
millertime42: posts big blind 500
*** HOLE CARDS ***
Dealt to JJin91 [4c 9c]
arizonagolf3: calls 500
lukystrike84: calls 500
sfarbs: folds=20
jrollsup1: folds=20
apoch19: folds=20
JJin91: calls 250
millertime42: checks=20
*** FLOP *** [6d 7h Ac]
JJin91: checks=20
millertime42: checks=20
arizonagolf3: checks=20
lukystrike84: checks=20
*** TURN *** [6d 7h Ac] [8c]
JJin91: checks=20
millertime42: bets 1000
arizonagolf3: folds=20
lukystrike84: folds=20
JJin91: raises 2441 to 3441
millertime42: calls 2441
*** RIVER *** [6d 7h Ac 8c] [Js]
JJin91: bets 6000
millertime42: folds=20
Uncalled bet (6000) returned to JJin91
JJin91 collected 9302 from pot
JJin91: doesn't show hand=20
*** SUMMARY ***
Total pot 9302 | Rake 0=20
Board [6d 7h Ac 8c Js]
Seat 1: sfarbs folded before Flop (didn't bet)
Seat 2: jrollsup1 folded before Flop (didn't bet)
Seat 3: apoch19 (button) folded before Flop (didn't bet)
Seat 4: JJin91 (small blind) collected (9302)
Seat 7: millertime42 (big blind) folded on the River
Seat 8: arizonagolf3 folded on the Turn
Seat 9: lukystrike84 folded on the Turn


*********** # 45 **************
PokerStars Hand #171441915520: Tournament #1648956582, $18.20+$1.80 USD=
 Hold'em No Limit - Level XI (250/500) - 2017/06/19 21:01:18 ET
Table '1648956582 5' 9-max Seat #4 is the button
Seat 1: sfarbs (45148 in chips)=20
Seat 2: jrollsup1 (22572 in chips)=20
Seat 3: apoch19 (22628 in chips)=20
Seat 4: JJin91 (32666 in chips)=20
Seat 5: FlopHitterNJ (6622 in chips) out of hand (moved from another ta=
ble into small blind)
Seat 6: ks1112 (10000 in chips) out of hand (moved from another table i=
nto small blind)
Seat 7: millertime42 (5999 in chips)=20
Seat 8: arizonagolf3 (14650 in chips)=20
Seat 9: lukystrike84 (28794 in chips)=20
sfarbs: posts the ante 60
jrollsup1: posts the ante 60
apoch19: posts the ante 60
JJin91: posts the ante 60
millertime42: posts the ante 60
arizonagolf3: posts the ante 60
lukystrike84: posts the ante 60
millertime42: posts small blind 250
arizonagolf3: posts big blind 500
*** HOLE CARDS ***
Dealt to JJin91 [Th 4h]
lukystrike84: calls 500
sfarbs: folds=20
jrollsup1: folds=20
apoch19: folds=20
JJin91: folds=20
millertime42: calls 250
arizonagolf3: checks=20
*** FLOP *** [Ks 7c Jd]
millertime42: checks=20
arizonagolf3: bets 1000
lukystrike84: folds=20
millertime42: folds=20
Uncalled bet (1000) returned to arizonagolf3
arizonagolf3 collected 1920 from pot
arizonagolf3: doesn't show hand=20
*** SUMMARY ***
Total pot 1920 | Rake 0=20
Board [Ks 7c Jd]
Seat 1: sfarbs folded before Flop (didn't bet)
Seat 2: jrollsup1 folded before Flop (didn't bet)
Seat 3: apoch19 folded before Flop (didn't bet)
Seat 4: JJin91 (button) folded before Flop (didn't bet)
Seat 7: millertime42 (small blind) folded on the Flop
Seat 8: arizonagolf3 (big blind) collected (1920)
Seat 9: lukystrike84 folded on the Flop


*********** # 46 **************
PokerStars Hand #171441915698: Tournament #1648956582, $18.20+$1.80 USD=
 Hold'em No Limit - Level XI (250/500) - 2017/06/19 21:01:50 ET
Table '1648956582 5' 9-max Seat #7 is the button
Seat 1: sfarbs (45088 in chips)=20
Seat 2: jrollsup1 (22512 in chips)=20
Seat 3: apoch19 (22568 in chips)=20
Seat 4: JJin91 (32606 in chips)=20
Seat 5: FlopHitterNJ (6622 in chips)=20
Seat 6: ks1112 (10000 in chips)=20
Seat 7: millertime42 (5439 in chips)=20
Seat 8: arizonagolf3 (16010 in chips)=20
Seat 9: lukystrike84 (28234 in chips)=20
sfarbs: posts the ante 60
jrollsup1: posts the ante 60
apoch19: posts the ante 60
JJin91: posts the ante 60
FlopHitterNJ: posts the ante 60
ks1112: posts the ante 60
millertime42: posts the ante 60
arizonagolf3: posts the ante 60
lukystrike84: posts the ante 60
arizonagolf3: posts small blind 250
lukystrike84: posts big blind 500
*** HOLE CARDS ***
Dealt to JJin91 [2c Qc]
sfarbs: raises 615 to 1115
jrollsup1: folds=20
apoch19: folds=20
JJin91: folds=20
FlopHitterNJ: raises 5447 to 6562 and is all-in
ks1112: folds=20
millertime42: folds=20
arizonagolf3: folds=20
lukystrike84: folds=20
sfarbs: calls 5447
*** FLOP *** [9h Qd 5d]
*** TURN *** [9h Qd 5d] [Ah]
*** RIVER *** [9h Qd 5d Ah] [9d]
*** SHOW DOWN ***
sfarbs: shows [Jd Jc] (two pair, Jacks and Nines)
FlopHitterNJ: shows [Ad Js] (two pair, Aces and Nines)
FlopHitterNJ collected 14414 from pot
*** SUMMARY ***
Total pot 14414 | Rake 0=20
Board [9h Qd 5d Ah 9d]
Seat 1: sfarbs showed [Jd Jc] and lost with two pair, Jacks and Nines
Seat 2: jrollsup1 folded before Flop (didn't bet)
Seat 3: apoch19 folded before Flop (didn't bet)
Seat 4: JJin91 folded before Flop (didn't bet)
Seat 5: FlopHitterNJ showed [Ad Js] and won (14414) with two pair, Aces=
 and Nines
Seat 6: ks1112 folded before Flop (didn't bet)
Seat 7: millertime42 (button) folded before Flop (didn't bet)
Seat 8: arizonagolf3 (small blind) folded before Flop
Seat 9: lukystrike84 (big blind) folded before Flop


*********** # 47 **************
PokerStars Hand #171441915939: Tournament #1648956582, $18.20+$1.80 USD=
 Hold'em No Limit - Level XII (300/600) - 2017/06/19 21:02:35 ET
Table '1648956582 5' 9-max Seat #8 is the button
Seat 1: sfarbs (38466 in chips)=20
Seat 2: jrollsup1 (22452 in chips)=20
Seat 3: apoch19 (22508 in chips)=20
Seat 4: JJin91 (32546 in chips)=20
Seat 5: FlopHitterNJ (14414 in chips)=20
Seat 6: ks1112 (9940 in chips)=20
Seat 7: millertime42 (5379 in chips)=20
Seat 8: arizonagolf3 (15700 in chips)=20
Seat 9: lukystrike84 (27674 in chips)=20
sfarbs: posts the ante 70
jrollsup1: posts the ante 70
apoch19: posts the ante 70
JJin91: posts the ante 70
FlopHitterNJ: posts the ante 70
ks1112: posts the ante 70
millertime42: posts the ante 70
arizonagolf3: posts the ante 70
lukystrike84: posts the ante 70
lukystrike84: posts small blind 300
sfarbs: posts big blind 600
*** HOLE CARDS ***
Dealt to JJin91 [Qh 7d]
jrollsup1: raises 600 to 1200
apoch19: calls 1200
JJin91: folds=20
FlopHitterNJ: folds=20
ks1112: folds=20
millertime42: folds=20
arizonagolf3: calls 1200
lukystrike84: calls 900
sfarbs: folds=20
*** FLOP *** [Kd 8s Qc]
lukystrike84: checks=20
jrollsup1: checks=20
apoch19: bets 2682
arizonagolf3: folds=20
lukystrike84: folds=20
jrollsup1: folds=20
Uncalled bet (2682) returned to apoch19
apoch19 collected 6030 from pot
apoch19: doesn't show hand=20
*** SUMMARY ***
Total pot 6030 | Rake 0=20
Board [Kd 8s Qc]
Seat 1: sfarbs (big blind) folded before Flop
Seat 2: jrollsup1 folded on the Flop
Seat 3: apoch19 collected (6030)
Seat 4: JJin91 folded before Flop (didn't bet)
Seat 5: FlopHitterNJ folded before Flop (didn't bet)
Seat 6: ks1112 folded before Flop (didn't bet)
Seat 7: millertime42 folded before Flop (didn't bet)
Seat 8: arizonagolf3 (button) folded on the Flop
Seat 9: lukystrike84 (small blind) folded on the Flop


*********** # 48 **************
PokerStars Hand #171441916228: Tournament #1648956582, $18.20+$1.80 USD=
 Hold'em No Limit - Level XII (300/600) - 2017/06/19 21:03:30 ET
Table '1648956582 5' 9-max Seat #9 is the button
Seat 1: sfarbs (37796 in chips)=20
Seat 2: jrollsup1 (21182 in chips)=20
Seat 3: apoch19 (27268 in chips)=20
Seat 4: JJin91 (32476 in chips)=20
Seat 5: FlopHitterNJ (14344 in chips)=20
Seat 6: ks1112 (9870 in chips)=20
Seat 7: millertime42 (5309 in chips)=20
Seat 8: arizonagolf3 (14430 in chips)=20
Seat 9: lukystrike84 (26404 in chips)=20
sfarbs: posts the ante 70
jrollsup1: posts the ante 70
apoch19: posts the ante 70
JJin91: posts the ante 70
FlopHitterNJ: posts the ante 70
ks1112: posts the ante 70
millertime42: posts the ante 70
arizonagolf3: posts the ante 70
lukystrike84: posts the ante 70
sfarbs: posts small blind 300
jrollsup1: posts big blind 600
*** HOLE CARDS ***
Dealt to JJin91 [2c 5s]
apoch19: folds=20
JJin91: folds=20
FlopHitterNJ: folds=20
ks1112: folds=20
millertime42: raises 4639 to 5239 and is all-in
arizonagolf3: folds=20
lukystrike84: folds=20
sfarbs: folds=20
jrollsup1: folds=20
Uncalled bet (4639) returned to millertime42
millertime42 collected 2130 from pot
millertime42: doesn't show hand=20
*** SUMMARY ***
Total pot 2130 | Rake 0=20
Seat 1: sfarbs (small blind) folded before Flop
Seat 2: jrollsup1 (big blind) folded before Flop
Seat 3: apoch19 folded before Flop (didn't bet)
Seat 4: JJin91 folded before Flop (didn't bet)
Seat 5: FlopHitterNJ folded before Flop (didn't bet)
Seat 6: ks1112 folded before Flop (didn't bet)
Seat 7: millertime42 collected (2130)
Seat 8: arizonagolf3 folded before Flop (didn't bet)
Seat 9: lukystrike84 (button) folded before Flop (didn't bet)


*********** # 49 **************
PokerStars Hand #171441916403: Tournament #1648956582, $18.20+$1.80 USD=
 Hold'em No Limit - Level XII (300/600) - 2017/06/19 21:04:01 ET
Table '1648956582 5' 9-max Seat #1 is the button
Seat 1: sfarbs (37426 in chips)=20
Seat 2: jrollsup1 (20512 in chips)=20
Seat 3: apoch19 (27198 in chips)=20
Seat 4: JJin91 (32406 in chips)=20
Seat 5: FlopHitterNJ (14274 in chips)=20
Seat 6: ks1112 (9800 in chips)=20
Seat 7: millertime42 (6769 in chips)=20
Seat 8: arizonagolf3 (14360 in chips)=20
Seat 9: lukystrike84 (26334 in chips)=20
sfarbs: posts the ante 70
jrollsup1: posts the ante 70
apoch19: posts the ante 70
JJin91: posts the ante 70
FlopHitterNJ: posts the ante 70
ks1112: posts the ante 70
millertime42: posts the ante 70
arizonagolf3: posts the ante 70
lukystrike84: posts the ante 70
jrollsup1: posts small blind 300
apoch19: posts big blind 600
*** HOLE CARDS ***
Dealt to JJin91 [6d 3s]
JJin91: folds=20
FlopHitterNJ: folds=20
ks1112: folds=20
millertime42: folds=20
arizonagolf3: calls 600
lukystrike84: folds=20
sfarbs: folds=20
jrollsup1: calls 300
apoch19: checks=20
*** FLOP *** [6h 9c Td]
jrollsup1: checks=20
apoch19: checks=20
arizonagolf3: bets 1200
jrollsup1: folds=20
apoch19: calls 1200
*** TURN *** [6h 9c Td] [Ts]
apoch19: checks=20
arizonagolf3: bets 1800
apoch19: calls 1800
*** RIVER *** [6h 9c Td Ts] [Ks]
apoch19: checks=20
arizonagolf3: bets 4200
apoch19: folds=20
Uncalled bet (4200) returned to arizonagolf3
arizonagolf3 collected 8430 from pot
arizonagolf3: doesn't show hand=20
*** SUMMARY ***
Total pot 8430 | Rake 0=20
Board [6h 9c Td Ts Ks]
Seat 1: sfarbs (button) folded before Flop (didn't bet)
Seat 2: jrollsup1 (small blind) folded on the Flop
Seat 3: apoch19 (big blind) folded on the River
Seat 4: JJin91 folded before Flop (didn't bet)
Seat 5: FlopHitterNJ folded before Flop (didn't bet)
Seat 6: ks1112 folded before Flop (didn't bet)
Seat 7: millertime42 folded before Flop (didn't bet)
Seat 8: arizonagolf3 collected (8430)
Seat 9: lukystrike84 folded before Flop (didn't bet)


*********** # 50 **************
PokerStars Hand #171441916830: Tournament #1648956582, $18.20+$1.80 USD=
 Hold'em No Limit - Level XII (300/600) - 2017/06/19 21:05:17 ET
Table '1648956582 5' 9-max Seat #2 is the button
Seat 1: sfarbs (37356 in chips)=20
Seat 2: jrollsup1 (19842 in chips)=20
Seat 3: apoch19 (23528 in chips)=20
Seat 4: JJin91 (32336 in chips)=20
Seat 5: FlopHitterNJ (14204 in chips)=20
Seat 6: ks1112 (9730 in chips)=20
Seat 7: millertime42 (6699 in chips)=20
Seat 8: arizonagolf3 (19120 in chips)=20
sfarbs: posts the ante 70
jrollsup1: posts the ante 70
apoch19: posts the ante 70
JJin91: posts the ante 70
FlopHitterNJ: posts the ante 70
ks1112: posts the ante 70
millertime42: posts the ante 70
arizonagolf3: posts the ante 70
apoch19: posts small blind 300
JJin91: posts big blind 600
*** HOLE CARDS ***
Dealt to JJin91 [9d 9c]
FlopHitterNJ: folds=20
ks1112: folds=20
millertime42: folds=20
arizonagolf3: raises 1800 to 2400
sfarbs: folds=20
jrollsup1: folds=20
apoch19: folds=20
JJin91: calls 1800
*** FLOP *** [2d As 5s]
JJin91: checks=20
arizonagolf3: checks=20
*** TURN *** [2d As 5s] [Kh]
JJin91: checks=20
arizonagolf3: checks=20
*** RIVER *** [2d As 5s Kh] [4c]
JJin91: bets 2094
arizonagolf3: calls 2094
*** SHOW DOWN ***
JJin91: shows [9d 9c] (a pair of Nines)
arizonagolf3: shows [Qh Qs] (a pair of Queens)
arizonagolf3 collected 9848 from pot
*** SUMMARY ***
Total pot 9848 | Rake 0=20
Board [2d As 5s Kh 4c]
Seat 1: sfarbs folded before Flop (didn't bet)
Seat 2: jrollsup1 (button) folded before Flop (didn't bet)
Seat 3: apoch19 (small blind) folded before Flop
Seat 4: JJin91 (big blind) showed [9d 9c] and lost with a pair of Nines
Seat 5: FlopHitterNJ folded before Flop (didn't bet)
Seat 6: ks1112 folded before Flop (didn't bet)
Seat 7: millertime42 folded before Flop (didn't bet)
Seat 8: arizonagolf3 showed [Qh Qs] and won (9848) with a pair of Queens


*********** # 51 **************
PokerStars Hand #171441917219: Tournament #1648956582, $18.20+$1.80 USD=
 Hold'em No Limit - Level XII (300/600) - 2017/06/19 21:06:31 ET
Table '1648956582 5' 9-max Seat #3 is the button
Seat 1: sfarbs (37286 in chips)=20
Seat 2: jrollsup1 (19772 in chips)=20
Seat 3: apoch19 (23158 in chips)=20
Seat 4: JJin91 (27772 in chips)=20
Seat 5: FlopHitterNJ (14134 in chips)=20
Seat 6: ks1112 (9660 in chips)=20
Seat 7: millertime42 (6629 in chips)=20
Seat 8: arizonagolf3 (24404 in chips)=20
sfarbs: posts the ante 70
jrollsup1: posts the ante 70
apoch19: posts the ante 70
JJin91: posts the ante 70
FlopHitterNJ: posts the ante 70
ks1112: posts the ante 70
millertime42: posts the ante 70
arizonagolf3: posts the ante 70
JJin91: posts small blind 300
FlopHitterNJ: posts big blind 600
*** HOLE CARDS ***
Dealt to JJin91 [8d 3d]
ks1112: folds=20
millertime42: raises 5959 to 6559 and is all-in
arizonagolf3: folds=20
sfarbs: folds=20
jrollsup1: folds=20
apoch19: folds=20
JJin91: folds=20
FlopHitterNJ: folds=20
Uncalled bet (5959) returned to millertime42
millertime42 collected 2060 from pot
millertime42: doesn't show hand=20
*** SUMMARY ***
Total pot 2060 | Rake 0=20
Seat 1: sfarbs folded before Flop (didn't bet)
Seat 2: jrollsup1 folded before Flop (didn't bet)
Seat 3: apoch19 (button) folded before Flop (didn't bet)
Seat 4: JJin91 (small blind) folded before Flop
Seat 5: FlopHitterNJ (big blind) folded before Flop
Seat 6: ks1112 folded before Flop (didn't bet)
Seat 7: millertime42 collected (2060)
Seat 8: arizonagolf3 folded before Flop (didn't bet)


*********** # 52 **************
PokerStars Hand #171441917373: Tournament #1648956582, $18.20+$1.80 USD=
 Hold'em No Limit - Level XII (300/600) - 2017/06/19 21:06:59 ET
Table '1648956582 5' 9-max Seat #4 is the button
Seat 1: sfarbs (37216 in chips)=20
Seat 2: jrollsup1 (19702 in chips)=20
Seat 3: apoch19 (23088 in chips)=20
Seat 4: JJin91 (27402 in chips)=20
Seat 5: FlopHitterNJ (13464 in chips)=20
Seat 6: ks1112 (9590 in chips)=20
Seat 7: millertime42 (8019 in chips)=20
Seat 8: arizonagolf3 (24334 in chips)=20
Seat 9: Going2Ship (8700 in chips)=20
sfarbs: posts the ante 70
jrollsup1: posts the ante 70
apoch19: posts the ante 70
JJin91: posts the ante 70
FlopHitterNJ: posts the ante 70
ks1112: posts the ante 70
millertime42: posts the ante 70
arizonagolf3: posts the ante 70
Going2Ship: posts the ante 70
FlopHitterNJ: posts small blind 300
ks1112: posts big blind 600
*** HOLE CARDS ***
Dealt to JJin91 [7c 8s]
millertime42: folds=20
arizonagolf3: calls 600
Going2Ship: folds=20
sfarbs: raises 1002 to 1602
jrollsup1: folds=20
apoch19: folds=20
JJin91: folds=20
FlopHitterNJ: folds=20
ks1112: folds=20
arizonagolf3: calls 1002
*** FLOP *** [9d 6d Ks]
arizonagolf3: checks=20
sfarbs: bets 2272
arizonagolf3: folds=20
Uncalled bet (2272) returned to sfarbs
sfarbs collected 4734 from pot
sfarbs: doesn't show hand=20
*** SUMMARY ***
Total pot 4734 | Rake 0=20
Board [9d 6d Ks]
Seat 1: sfarbs collected (4734)
Seat 2: jrollsup1 folded before Flop (didn't bet)
Seat 3: apoch19 folded before Flop (didn't bet)
Seat 4: JJin91 (button) folded before Flop (didn't bet)
Seat 5: FlopHitterNJ (small blind) folded before Flop
Seat 6: ks1112 (big blind) folded before Flop
Seat 7: millertime42 folded before Flop (didn't bet)
Seat 8: arizonagolf3 folded on the Flop
Seat 9: Going2Ship folded before Flop (didn't bet)


*********** # 53 **************
PokerStars Hand #171441917532: Tournament #1648956582, $18.20+$1.80 USD=
 Hold'em No Limit - Level XII (300/600) - 2017/06/19 21:07:31 ET
Table '1648956582 5' 9-max Seat #5 is the button
Seat 1: sfarbs (40278 in chips)=20
Seat 2: jrollsup1 (19632 in chips)=20
Seat 3: apoch19 (23018 in chips)=20
Seat 4: JJin91 (27332 in chips)=20
Seat 5: FlopHitterNJ (13094 in chips)=20
Seat 6: ks1112 (8920 in chips)=20
Seat 7: millertime42 (7949 in chips)=20
Seat 8: arizonagolf3 (22662 in chips)=20
Seat 9: Going2Ship (8630 in chips)=20
sfarbs: posts the ante 70
jrollsup1: posts the ante 70
apoch19: posts the ante 70
JJin91: posts the ante 70
FlopHitterNJ: posts the ante 70
ks1112: posts the ante 70
millertime42: posts the ante 70
arizonagolf3: posts the ante 70
Going2Ship: posts the ante 70
ks1112: posts small blind 300
millertime42: posts big blind 600
*** HOLE CARDS ***
Dealt to JJin91 [6h 6d]
arizonagolf3: calls 600
Going2Ship: folds=20
sfarbs: folds=20
jrollsup1: raises 900 to 1500
apoch19: folds=20
JJin91: calls 1500
FlopHitterNJ: calls 1500
ks1112: folds=20
millertime42: folds=20
arizonagolf3: calls 900
*** FLOP *** [4d 9s 4c]
arizonagolf3: checks=20
jrollsup1: checks=20
JJin91: bets 3441
FlopHitterNJ: folds=20
arizonagolf3: folds=20
jrollsup1: folds=20
Uncalled bet (3441) returned to JJin91
JJin91 collected 7530 from pot
*** SUMMARY ***
Total pot 7530 | Rake 0=20
Board [4d 9s 4c]
Seat 1: sfarbs folded before Flop (didn't bet)
Seat 2: jrollsup1 folded on the Flop
Seat 3: apoch19 folded before Flop (didn't bet)
Seat 4: JJin91 collected (7530)
Seat 5: FlopHitterNJ (button) folded on the Flop
Seat 6: ks1112 (small blind) folded before Flop
Seat 7: millertime42 (big blind) folded before Flop
Seat 8: arizonagolf3 folded on the Flop
Seat 9: Going2Ship folded before Flop (didn't bet)


*********** # 54 **************
PokerStars Hand #171441917947: Tournament #1648956582, $18.20+$1.80 USD=
 Hold'em No Limit - Level XII (300/600) - 2017/06/19 21:08:51 ET
Table '1648956582 7' 9-max Seat #8 is the button
Seat 1: JKupz27 (11560 in chips)=20
Seat 2: Maelish (50081 in chips)=20
Seat 3: MathMagiK (14462 in chips)=20
Seat 4: L8terGators (65223 in chips)=20
Seat 5: OceansO7 (18088 in chips)=20
Seat 6: JJin91 (33292 in chips)=20
Seat 8: Studsg (13520 in chips)=20
Seat 9: Big Chips79 (21483 in chips)=20
JKupz27: posts the ante 70
Maelish: posts the ante 70
MathMagiK: posts the ante 70
L8terGators: posts the ante 70
OceansO7: posts the ante 70
JJin91: posts the ante 70
Studsg: posts the ante 70
Big Chips79: posts the ante 70
Big Chips79: posts small blind 300
JKupz27: posts big blind 600
*** HOLE CARDS ***
Dealt to JJin91 [9c Kc]
Maelish: folds=20
MathMagiK: raises 13792 to 14392 and is all-in
L8terGators: folds=20
OceansO7: folds=20
JJin91: folds=20
Studsg: folds=20
Big Chips79: folds=20
JKupz27: folds=20
Uncalled bet (13792) returned to MathMagiK
MathMagiK collected 2060 from pot
MathMagiK: doesn't show hand=20
*** SUMMARY ***
Total pot 2060 | Rake 0=20
Seat 1: JKupz27 (big blind) folded before Flop
Seat 2: Maelish folded before Flop (didn't bet)
Seat 3: MathMagiK collected (2060)
Seat 4: L8terGators folded before Flop (didn't bet)
Seat 5: OceansO7 folded before Flop (didn't bet)
Seat 6: JJin91 folded before Flop (didn't bet)
Seat 8: Studsg (button) folded before Flop (didn't bet)
Seat 9: Big Chips79 (small blind) folded before Flop


*********** # 55 **************
PokerStars Hand #171441918103: Tournament #1648956582, $18.20+$1.80 USD=
 Hold'em No Limit - Level XII (300/600) - 2017/06/19 21:09:20 ET
Table '1648956582 7' 9-max Seat #9 is the button
Seat 1: JKupz27 (10890 in chips)=20
Seat 2: Maelish (50011 in chips)=20
Seat 3: MathMagiK (15852 in chips)=20
Seat 4: L8terGators (65153 in chips)=20
Seat 5: OceansO7 (18018 in chips)=20
Seat 6: JJin91 (33222 in chips)=20
Seat 8: Studsg (13450 in chips)=20
Seat 9: Big Chips79 (21113 in chips)=20
JKupz27: posts the ante 70
Maelish: posts the ante 70
MathMagiK: posts the ante 70
L8terGators: posts the ante 70
OceansO7: posts the ante 70
JJin91: posts the ante 70
Studsg: posts the ante 70
Big Chips79: posts the ante 70
JKupz27: posts small blind 300
Maelish: posts big blind 600
*** HOLE CARDS ***
Dealt to JJin91 [6d 2c]
MathMagiK: folds=20
L8terGators: raises 650 to 1250
OceansO7: folds=20
JJin91: folds=20
Studsg: folds=20
Big Chips79: calls 1250
JKupz27: folds=20
Maelish: folds=20
*** FLOP *** [3d Jc 9s]
L8terGators: bets 1700
Big Chips79: raises 1700 to 3400
L8terGators: calls 1700
*** TURN *** [3d Jc 9s] [4c]
L8terGators: checks=20
Big Chips79: bets 1800
L8terGators: raises 2400 to 4200
Big Chips79: calls 2400
*** RIVER *** [3d Jc 9s 4c] [Kc]
JJin91 is disconnected=20
L8terGators: checks=20
Big Chips79: checks=20
*** SHOW DOWN ***
L8terGators: shows [Jd As] (a pair of Jacks)
Big Chips79: mucks hand=20
L8terGators collected 19160 from pot
*** SUMMARY ***
Total pot 19160 | Rake 0=20
Board [3d Jc 9s 4c Kc]
Seat 1: JKupz27 (small blind) folded before Flop
Seat 2: Maelish (big blind) folded before Flop
Seat 3: MathMagiK folded before Flop (didn't bet)
Seat 4: L8terGators showed [Jd As] and won (19160) with a pair of Jacks
Seat 5: OceansO7 folded before Flop (didn't bet)
Seat 6: JJin91 folded before Flop (didn't bet)
Seat 8: Studsg folded before Flop (didn't bet)
Seat 9: Big Chips79 (button) mucked [Jh Th]


*********** # 56 **************
PokerStars Hand #171441918456: Tournament #1648956582, $18.20+$1.80 USD=
 Hold'em No Limit - Level XII (300/600) - 2017/06/19 21:10:25 ET
Table '1648956582 7' 9-max Seat #1 is the button
Seat 1: JKupz27 (10520 in chips)=20
Seat 2: Maelish (49341 in chips)=20
Seat 3: MathMagiK (15782 in chips)=20
Seat 4: L8terGators (75393 in chips)=20
Seat 5: OceansO7 (17948 in chips)=20
Seat 6: JJin91 (33152 in chips)=20
Seat 8: Studsg (13380 in chips)=20
Seat 9: Big Chips79 (12193 in chips)=20
JKupz27: posts the ante 70
Maelish: posts the ante 70
MathMagiK: posts the ante 70
L8terGators: posts the ante 70
OceansO7: posts the ante 70
JJin91: posts the ante 70
Studsg: posts the ante 70
Big Chips79: posts the ante 70
Maelish: posts small blind 300
MathMagiK: posts big blind 600
*** HOLE CARDS ***
Dealt to JJin91 [5s Ts]
L8terGators: folds=20
OceansO7: folds=20
JJin91 has timed out while disconnected
JJin91: folds=20
JJin91 is sitting out
Studsg: raises 650 to 1250
Big Chips79: raises 10873 to 12123 and is all-in
JKupz27: folds=20
Maelish: folds=20
MathMagiK: folds=20
Studsg: calls 10873
*** FLOP *** [6c 3s Jh]
*** TURN *** [6c 3s Jh] [Td]
*** RIVER *** [6c 3s Jh Td] [Qs]
*** SHOW DOWN ***
Studsg: shows [Qh Ad] (a pair of Queens)
Big Chips79: shows [Qd Ks] (a pair of Queens - lower kicker)
Studsg collected 25706 from pot
Big Chips79 finished the tournament in 73rd place
*** SUMMARY ***
Total pot 25706 | Rake 0=20
Board [6c 3s Jh Td Qs]
Seat 1: JKupz27 (button) folded before Flop (didn't bet)
Seat 2: Maelish (small blind) folded before Flop
Seat 3: MathMagiK (big blind) folded before Flop
Seat 4: L8terGators folded before Flop (didn't bet)
Seat 5: OceansO7 folded before Flop (didn't bet)
Seat 6: JJin91 folded before Flop (didn't bet)
Seat 8: Studsg showed [Qh Ad] and won (25706) with a pair of Queens
Seat 9: Big Chips79 showed [Qd Ks] and lost with a pair of Queens


*********** # 57 **************
PokerStars Hand #171441918995: Tournament #1648956582, $18.20+$1.80 USD=
 Hold'em No Limit - Level XII (300/600) - 2017/06/19 21:12:02 ET
Table '1648956582 10' 9-max Seat #4 is the button
Seat 1: Ch1no354 (16105 in chips)=20
Seat 2: Paceman2jr (27331 in chips)=20
Seat 3: akbongu1977 (18525 in chips)=20
Seat 4: gabagool5 (21294 in chips)=20
Seat 5: JSkelts (14790 in chips)=20
Seat 6: kendallf23 (41504 in chips)=20
Seat 7: Boney526 (28186 in chips)=20
Seat 8: JJin91 (33082 in chips) is sitting out
Seat 9: snapcallzzz (4154 in chips)=20
Ch1no354: posts the ante 70
Paceman2jr: posts the ante 70
akbongu1977: posts the ante 70
gabagool5: posts the ante 70
JSkelts: posts the ante 70
kendallf23: posts the ante 70
Boney526: posts the ante 70
JJin91: posts the ante 70
snapcallzzz: posts the ante 70
JSkelts: posts small blind 300
kendallf23: posts big blind 600
*** HOLE CARDS ***
Dealt to JJin91 [6s 5d]
Boney526: folds=20
JJin91: folds=20
snapcallzzz: folds=20
Ch1no354: raises 15435 to 16035 and is all-in
Paceman2jr: folds=20
akbongu1977: folds=20
gabagool5: calls 16035
JSkelts: folds=20
kendallf23: folds=20
*** FLOP *** [Ad Js 8d]
*** TURN *** [Ad Js 8d] [3c]
*** RIVER *** [Ad Js 8d 3c] [2c]
*** SHOW DOWN ***
Ch1no354: shows [Ac Qs] (a pair of Aces)
gabagool5: shows [Jc Jd] (three of a kind, Jacks)
gabagool5 collected 33600 from pot
Ch1no354 finished the tournament in 69th place
*** SUMMARY ***
Total pot 33600 | Rake 0=20
Board [Ad Js 8d 3c 2c]
Seat 1: Ch1no354 showed [Ac Qs] and lost with a pair of Aces
Seat 2: Paceman2jr folded before Flop (didn't bet)
Seat 3: akbongu1977 folded before Flop (didn't bet)
Seat 4: gabagool5 (button) showed [Jc Jd] and won (33600) with three of=
 a kind, Jacks
Seat 5: JSkelts (small blind) folded before Flop
Seat 6: kendallf23 (big blind) folded before Flop
Seat 7: Boney526 folded before Flop (didn't bet)
Seat 8: JJin91 folded before Flop (didn't bet)
Seat 9: snapcallzzz folded before Flop (didn't bet)


*********** # 58 **************
PokerStars Hand #171441919249: Tournament #1648956582, $18.20+$1.80 USD=
 Hold'em No Limit - Level XIII (350/700) - 2017/06/19 21:12:49 ET
Table '1648956582 10' 9-max Seat #5 is the button
Seat 2: Paceman2jr (27261 in chips)=20
Seat 3: akbongu1977 (18455 in chips)=20
Seat 4: gabagool5 (38789 in chips)=20
Seat 5: JSkelts (14420 in chips)=20
Seat 6: kendallf23 (40834 in chips)=20
Seat 7: Boney526 (28116 in chips)=20
Seat 8: JJin91 (33012 in chips) is sitting out
Seat 9: snapcallzzz (4084 in chips)=20
Paceman2jr: posts the ante 85
akbongu1977: posts the ante 85
gabagool5: posts the ante 85
JSkelts: posts the ante 85
kendallf23: posts the ante 85
Boney526: posts the ante 85
JJin91: posts the ante 85
snapcallzzz: posts the ante 85
kendallf23: posts small blind 350
Boney526: posts big blind 700
*** HOLE CARDS ***
Dealt to JJin91 [Js 9h]
JJin91: folds=20
snapcallzzz: raises 3299 to 3999 and is all-in
Paceman2jr: calls 3999
akbongu1977: folds=20
gabagool5: raises 6501 to 10500
JSkelts: folds=20
kendallf23: folds=20
Boney526: folds=20
Paceman2jr: folds=20
Uncalled bet (6501) returned to gabagool5
*** FLOP *** [6h 2s 5h]
*** TURN *** [6h 2s 5h] [4h]
*** RIVER *** [6h 2s 5h 4h] [3c]
*** SHOW DOWN ***
snapcallzzz: shows [5d 4d] (a straight, Deuce to Six)
gabagool5: shows [Kc Ks] (a straight, Deuce to Six)
snapcallzzz collected 6864 from pot
gabagool5 collected 6863 from pot
*** SUMMARY ***
Total pot 13727 | Rake 0=20
Board [6h 2s 5h 4h 3c]
Seat 2: Paceman2jr folded before Flop
Seat 3: akbongu1977 folded before Flop (didn't bet)
Seat 4: gabagool5 showed [Kc Ks] and won (6863) with a straight, Deuce =
to Six
Seat 5: JSkelts (button) folded before Flop (didn't bet)
Seat 6: kendallf23 (small blind) folded before Flop
Seat 7: Boney526 (big blind) folded before Flop
Seat 8: JJin91 folded before Flop (didn't bet)
Seat 9: snapcallzzz showed [5d 4d] and won (6864) with a straight, Deuc=
e to Six


*********** # 59 **************
PokerStars Hand #171441919462: Tournament #1648956582, $18.20+$1.80 USD=
 Hold'em No Limit - Level XIII (350/700) - 2017/06/19 21:13:31 ET
Table '1648956582 10' 9-max Seat #6 is the button
Seat 2: Paceman2jr (23177 in chips)=20
Seat 3: akbongu1977 (18370 in chips)=20
Seat 4: gabagool5 (41568 in chips)=20
Seat 5: JSkelts (14335 in chips)=20
Seat 6: kendallf23 (40399 in chips)=20
Seat 7: Boney526 (27331 in chips)=20
Seat 8: JJin91 (32927 in chips) is sitting out
Seat 9: snapcallzzz (6864 in chips)=20
Paceman2jr: posts the ante 85
akbongu1977: posts the ante 85
gabagool5: posts the ante 85
JSkelts: posts the ante 85
kendallf23: posts the ante 85
Boney526: posts the ante 85
JJin91: posts the ante 85
snapcallzzz: posts the ante 85
Boney526: posts small blind 350
JJin91: posts big blind 700
*** HOLE CARDS ***
Dealt to JJin91 [4c 8s]
snapcallzzz: folds=20
Paceman2jr: calls 700
akbongu1977: folds=20
gabagool5: calls 700
JSkelts: folds=20
kendallf23: calls 700
Boney526: folds=20
JJin91: folds=20
*** FLOP *** [6d Ts Js]
Paceman2jr: checks=20
gabagool5: bets 1400
JJin91 has returned
kendallf23: calls 1400
Paceman2jr: calls 1400
*** TURN *** [6d Ts Js] [8h]
Paceman2jr: checks=20
gabagool5: bets 4200
kendallf23: calls 4200
Paceman2jr: calls 4200
*** RIVER *** [6d Ts Js 8h] [3h]
Paceman2jr: checks=20
gabagool5: bets 7000
kendallf23: folds=20
Paceman2jr: folds=20
Uncalled bet (7000) returned to gabagool5
gabagool5 collected 20630 from pot
gabagool5: doesn't show hand=20
*** SUMMARY ***
Total pot 20630 | Rake 0=20
Board [6d Ts Js 8h 3h]
Seat 2: Paceman2jr folded on the River
Seat 3: akbongu1977 folded before Flop (didn't bet)
Seat 4: gabagool5 collected (20630)
Seat 5: JSkelts folded before Flop (didn't bet)
Seat 6: kendallf23 (button) folded on the River
Seat 7: Boney526 (small blind) folded before Flop
Seat 8: JJin91 (big blind) folded before Flop
Seat 9: snapcallzzz folded before Flop (didn't bet)


*********** # 60 **************
PokerStars Hand #171441919960: Tournament #1648956582, $18.20+$1.80 USD=
 Hold'em No Limit - Level XIII (350/700) - 2017/06/19 21:15:02 ET
Table '1648956582 10' 9-max Seat #7 is the button
Seat 2: Paceman2jr (16792 in chips)=20
Seat 3: akbongu1977 (18285 in chips)=20
Seat 4: gabagool5 (55813 in chips)=20
Seat 5: JSkelts (14250 in chips)=20
Seat 6: kendallf23 (34014 in chips)=20
Seat 7: Boney526 (26896 in chips)=20
Seat 8: JJin91 (32142 in chips)=20
Seat 9: snapcallzzz (6779 in chips)=20
Paceman2jr: posts the ante 85
akbongu1977: posts the ante 85
gabagool5: posts the ante 85
JSkelts: posts the ante 85
kendallf23: posts the ante 85
Boney526: posts the ante 85
JJin91: posts the ante 85
snapcallzzz: posts the ante 85
JJin91: posts small blind 350
snapcallzzz: posts big blind 700
*** HOLE CARDS ***
Dealt to JJin91 [Kh Js]
Paceman2jr: folds=20
akbongu1977: folds=20
gabagool5: folds=20
JSkelts: folds=20
kendallf23: folds=20
Boney526: folds=20
JJin91: raises 31357 to 32057 and is all-in
snapcallzzz: folds=20
Uncalled bet (31357) returned to JJin91
JJin91 collected 2080 from pot
JJin91: doesn't show hand=20
*** SUMMARY ***
Total pot 2080 | Rake 0=20
Seat 2: Paceman2jr folded before Flop (didn't bet)
Seat 3: akbongu1977 folded before Flop (didn't bet)
Seat 4: gabagool5 folded before Flop (didn't bet)
Seat 5: JSkelts folded before Flop (didn't bet)
Seat 6: kendallf23 folded before Flop (didn't bet)
Seat 7: Boney526 (button) folded before Flop (didn't bet)
Seat 8: JJin91 (small blind) collected (2080)
Seat 9: snapcallzzz (big blind) folded before Flop


*********** # 61 **************
PokerStars Hand #171443275096: Tournament #1648956582, $18.20+$1.80 USD=
 Hold'em No Limit - Level XIII (350/700) - 2017/06/19 21:15:24 ET
Table '1648956582 10' 9-max Seat #8 is the button
Seat 1: REALDEVIL (43431 in chips)=20
Seat 2: Paceman2jr (16707 in chips)=20
Seat 3: akbongu1977 (18200 in chips)=20
Seat 4: gabagool5 (55728 in chips)=20
Seat 5: JSkelts (14165 in chips)=20
Seat 6: kendallf23 (33929 in chips)=20
Seat 7: Boney526 (26811 in chips)=20
Seat 8: JJin91 (33437 in chips)=20
Seat 9: snapcallzzz (5994 in chips)=20
REALDEVIL: posts the ante 85
Paceman2jr: posts the ante 85
akbongu1977: posts the ante 85
gabagool5: posts the ante 85
JSkelts: posts the ante 85
kendallf23: posts the ante 85
Boney526: posts the ante 85
JJin91: posts the ante 85
snapcallzzz: posts the ante 85
snapcallzzz: posts small blind 350
REALDEVIL: posts big blind 700
*** HOLE CARDS ***
Dealt to JJin91 [Td 7d]
Paceman2jr: folds=20
akbongu1977: calls 700
gabagool5: folds=20
JSkelts: folds=20
kendallf23: folds=20
Boney526: folds=20
JJin91: folds=20
snapcallzzz: calls 350
REALDEVIL: checks=20
*** FLOP *** [9d 9s 8d]
snapcallzzz: checks=20
REALDEVIL: bets 1400
akbongu1977: folds=20
snapcallzzz: raises 3809 to 5209 and is all-in
REALDEVIL: calls 3809
*** TURN *** [9d 9s 8d] [5c]
*** RIVER *** [9d 9s 8d 5c] [3h]
*** SHOW DOWN ***
snapcallzzz: shows [9c Tc] (three of a kind, Nines)
REALDEVIL: shows [Ts 7s] (a pair of Nines)
snapcallzzz collected 13283 from pot
*** SUMMARY ***
Total pot 13283 | Rake 0=20
Board [9d 9s 8d 5c 3h]
Seat 1: REALDEVIL (big blind) showed [Ts 7s] and lost with a pair of Ni=
nes
Seat 2: Paceman2jr folded before Flop (didn't bet)
Seat 3: akbongu1977 folded on the Flop
Seat 4: gabagool5 folded before Flop (didn't bet)
Seat 5: JSkelts folded before Flop (didn't bet)
Seat 6: kendallf23 folded before Flop (didn't bet)
Seat 7: Boney526 folded before Flop (didn't bet)
Seat 8: JJin91 (button) folded before Flop (didn't bet)
Seat 9: snapcallzzz (small blind) showed [9c Tc] and won (13283) with t=
hree of a kind, Nines


*********** # 62 **************
PokerStars Hand #171443275485: Tournament #1648956582, $18.20+$1.80 USD=
 Hold'em No Limit - Level XIII (350/700) - 2017/06/19 21:16:33 ET
Table '1648956582 10' 9-max Seat #9 is the button
Seat 1: REALDEVIL (37437 in chips)=20
Seat 2: Paceman2jr (16622 in chips)=20
Seat 3: akbongu1977 (17415 in chips)=20
Seat 4: gabagool5 (55643 in chips)=20
Seat 5: JSkelts (14080 in chips)=20
Seat 6: kendallf23 (33844 in chips)=20
Seat 7: Boney526 (26726 in chips)=20
Seat 8: JJin91 (33352 in chips)=20
Seat 9: snapcallzzz (13283 in chips)=20
REALDEVIL: posts the ante 85
Paceman2jr: posts the ante 85
akbongu1977: posts the ante 85
gabagool5: posts the ante 85
JSkelts: posts the ante 85
kendallf23: posts the ante 85
Boney526: posts the ante 85
JJin91: posts the ante 85
snapcallzzz: posts the ante 85
REALDEVIL: posts small blind 350
Paceman2jr: posts big blind 700
*** HOLE CARDS ***
Dealt to JJin91 [Qs 5d]
akbongu1977: folds=20
gabagool5: folds=20
JSkelts: raises 13295 to 13995 and is all-in
kendallf23: folds=20
Boney526: folds=20
JJin91: folds=20
snapcallzzz: folds=20
REALDEVIL: folds=20
Paceman2jr: folds=20
Uncalled bet (13295) returned to JSkelts
JSkelts collected 2515 from pot
JSkelts: doesn't show hand=20
*** SUMMARY ***
Total pot 2515 | Rake 0=20
Seat 1: REALDEVIL (small blind) folded before Flop
Seat 2: Paceman2jr (big blind) folded before Flop
Seat 3: akbongu1977 folded before Flop (didn't bet)
Seat 4: gabagool5 folded before Flop (didn't bet)
Seat 5: JSkelts collected (2515)
Seat 6: kendallf23 folded before Flop (didn't bet)
Seat 7: Boney526 folded before Flop (didn't bet)
Seat 8: JJin91 folded before Flop (didn't bet)
Seat 9: snapcallzzz (button) folded before Flop (didn't bet)


*********** # 63 **************
PokerStars Hand #171443275751: Tournament #1648956582, $18.20+$1.80 USD=
 Hold'em No Limit - Level XIII (350/700) - 2017/06/19 21:17:19 ET
Table '1648956582 10' 9-max Seat #1 is the button
Seat 1: REALDEVIL (37002 in chips)=20
Seat 2: Paceman2jr (15837 in chips)=20
Seat 3: akbongu1977 (17330 in chips)=20
Seat 4: gabagool5 (55558 in chips)=20
Seat 5: JSkelts (15810 in chips)=20
Seat 6: kendallf23 (33759 in chips)=20
Seat 7: Boney526 (26641 in chips)=20
Seat 8: JJin91 (33267 in chips)=20
Seat 9: snapcallzzz (13198 in chips)=20
REALDEVIL: posts the ante 85
Paceman2jr: posts the ante 85
akbongu1977: posts the ante 85
gabagool5: posts the ante 85
JSkelts: posts the ante 85
kendallf23: posts the ante 85
Boney526: posts the ante 85
JJin91: posts the ante 85
snapcallzzz: posts the ante 85
Paceman2jr: posts small blind 350
akbongu1977: posts big blind 700
*** HOLE CARDS ***
Dealt to JJin91 [Qs 3h]
gabagool5: folds=20
JSkelts: folds=20
kendallf23: folds=20
Boney526: folds=20
JJin91: folds=20
snapcallzzz: raises 847 to 1547
REALDEVIL: folds=20
Paceman2jr: calls 1197
akbongu1977: calls 847
*** FLOP *** [Tc 5d 9h]
Paceman2jr: checks=20
akbongu1977: checks=20
snapcallzzz: checks=20
*** TURN *** [Tc 5d 9h] [Ks]
Paceman2jr: checks=20
akbongu1977: checks=20
snapcallzzz: checks=20
*** RIVER *** [Tc 5d 9h Ks] [8h]
Paceman2jr: checks=20
akbongu1977: checks=20
snapcallzzz: checks=20
*** SHOW DOWN ***
Paceman2jr: shows [Js Ad] (high card Ace)
akbongu1977: shows [9d Jc] (a pair of Nines)
snapcallzzz: mucks hand=20
akbongu1977 collected 5406 from pot
*** SUMMARY ***
Total pot 5406 | Rake 0=20
Board [Tc 5d 9h Ks 8h]
Seat 1: REALDEVIL (button) folded before Flop (didn't bet)
Seat 2: Paceman2jr (small blind) showed [Js Ad] and lost with high card=
 Ace
Seat 3: akbongu1977 (big blind) showed [9d Jc] and won (5406) with a pa=
ir of Nines
Seat 4: gabagool5 folded before Flop (didn't bet)
Seat 5: JSkelts folded before Flop (didn't bet)
Seat 6: kendallf23 folded before Flop (didn't bet)
Seat 7: Boney526 folded before Flop (didn't bet)
Seat 8: JJin91 folded before Flop (didn't bet)
Seat 9: snapcallzzz mucked [2s 2d]


*********** # 64 **************
PokerStars Hand #171443276051: Tournament #1648956582, $18.20+$1.80 USD=
 Hold'em No Limit - Level XIII (350/700) - 2017/06/19 21:18:14 ET
Table '1648956582 10' 9-max Seat #2 is the button
Seat 1: REALDEVIL (36917 in chips)=20
Seat 2: Paceman2jr (14205 in chips)=20
Seat 3: akbongu1977 (21104 in chips)=20
Seat 4: gabagool5 (55473 in chips)=20
Seat 5: JSkelts (15725 in chips)=20
Seat 6: kendallf23 (33674 in chips)=20
Seat 7: Boney526 (26556 in chips)=20
Seat 8: JJin91 (33182 in chips)=20
Seat 9: snapcallzzz (11566 in chips)=20
REALDEVIL: posts the ante 85
Paceman2jr: posts the ante 85
akbongu1977: posts the ante 85
gabagool5: posts the ante 85
JSkelts: posts the ante 85
kendallf23: posts the ante 85
Boney526: posts the ante 85
JJin91: posts the ante 85
snapcallzzz: posts the ante 85
akbongu1977: posts small blind 350
gabagool5: posts big blind 700
*** HOLE CARDS ***
Dealt to JJin91 [Kc 2s]
JSkelts: folds=20
kendallf23: folds=20
Boney526: folds=20
JJin91: folds=20
snapcallzzz: folds=20
REALDEVIL: raises 700 to 1400
Paceman2jr: folds=20
akbongu1977: calls 1050
gabagool5: calls 700
*** FLOP *** [Th 5d 7d]
akbongu1977: checks=20
gabagool5: checks=20
REALDEVIL: checks=20
*** TURN *** [Th 5d 7d] [Kh]
akbongu1977: checks=20
gabagool5: bets 3575
REALDEVIL: calls 3575
akbongu1977: calls 3575
*** RIVER *** [Th 5d 7d Kh] [6d]
akbongu1977: checks=20
gabagool5: bets 5021
REALDEVIL: raises 26836 to 31857 and is all-in
akbongu1977: folds=20
gabagool5: folds=20
Uncalled bet (26836) returned to REALDEVIL
REALDEVIL collected 25732 from pot
*** SUMMARY ***
Total pot 25732 | Rake 0=20
Board [Th 5d 7d Kh 6d]
Seat 1: REALDEVIL collected (25732)
Seat 2: Paceman2jr (button) folded before Flop (didn't bet)
Seat 3: akbongu1977 (small blind) folded on the River
Seat 4: gabagool5 (big blind) folded on the River
Seat 5: JSkelts folded before Flop (didn't bet)
Seat 6: kendallf23 folded before Flop (didn't bet)
Seat 7: Boney526 folded before Flop (didn't bet)
Seat 8: JJin91 folded before Flop (didn't bet)
Seat 9: snapcallzzz folded before Flop (didn't bet)


*********** # 65 **************
PokerStars Hand #171443276715: Tournament #1648956582, $18.20+$1.80 USD=
 Hold'em No Limit - Level XIII (350/700) - 2017/06/19 21:20:31 ET
Table '1648956582 10' 9-max Seat #3 is the button
Seat 1: REALDEVIL (52568 in chips)=20
Seat 2: Paceman2jr (14120 in chips)=20
Seat 3: akbongu1977 (16044 in chips)=20
Seat 4: gabagool5 (45392 in chips)=20
Seat 5: JSkelts (15640 in chips)=20
Seat 7: Boney526 (26471 in chips)=20
Seat 8: JJin91 (33097 in chips)=20
Seat 9: snapcallzzz (11481 in chips)=20
REALDEVIL: posts the ante 85
Paceman2jr: posts the ante 85
akbongu1977: posts the ante 85
gabagool5: posts the ante 85
JSkelts: posts the ante 85
Boney526: posts the ante 85
JJin91: posts the ante 85
snapcallzzz: posts the ante 85
gabagool5: posts small blind 350
JSkelts: posts big blind 700
*** HOLE CARDS ***
Dealt to JJin91 [8c 9h]
Boney526: folds=20
JJin91: folds=20
snapcallzzz: folds=20
REALDEVIL: folds=20
Paceman2jr: raises 1400 to 2100
akbongu1977: folds=20
gabagool5: raises 3689 to 5789
JSkelts: folds=20
Paceman2jr: calls 3689
*** FLOP *** [5c Qh 3h]
gabagool5: bets 9330
Paceman2jr: folds=20
Uncalled bet (9330) returned to gabagool5
gabagool5 collected 12958 from pot
gabagool5: doesn't show hand=20
*** SUMMARY ***
Total pot 12958 | Rake 0=20
Board [5c Qh 3h]
Seat 1: REALDEVIL folded before Flop (didn't bet)
Seat 2: Paceman2jr folded on the Flop
Seat 3: akbongu1977 (button) folded before Flop (didn't bet)
Seat 4: gabagool5 (small blind) collected (12958)
Seat 5: JSkelts (big blind) folded before Flop
Seat 7: Boney526 folded before Flop (didn't bet)
Seat 8: JJin91 folded before Flop (didn't bet)
Seat 9: snapcallzzz folded before Flop (didn't bet)


*********** # 66 **************
PokerStars Hand #171443276991: Tournament #1648956582, $18.20+$1.80 USD=
 Hold'em No Limit - Level XIII (350/700) - 2017/06/19 21:21:25 ET
Table '1648956582 10' 9-max Seat #4 is the button
Seat 1: REALDEVIL (52483 in chips)=20
Seat 2: Paceman2jr (8246 in chips)=20
Seat 3: akbongu1977 (15959 in chips)=20
Seat 4: gabagool5 (52476 in chips)=20
Seat 5: JSkelts (14855 in chips)=20
Seat 7: Boney526 (26386 in chips)=20
Seat 8: JJin91 (33012 in chips)=20
Seat 9: snapcallzzz (11396 in chips)=20
REALDEVIL: posts the ante 85
Paceman2jr: posts the ante 85
akbongu1977: posts the ante 85
gabagool5: posts the ante 85
JSkelts: posts the ante 85
Boney526: posts the ante 85
JJin91: posts the ante 85
snapcallzzz: posts the ante 85
JSkelts: posts small blind 350
Boney526: posts big blind 700
*** HOLE CARDS ***
Dealt to JJin91 [Kh Jh]
JJin91: raises 966 to 1666
snapcallzzz: folds=20
REALDEVIL: calls 1666
Paceman2jr: folds=20
akbongu1977: folds=20
gabagool5: calls 1666
JSkelts: folds=20
Boney526: calls 966
*** FLOP *** [3s Qd 8d]
Boney526: checks=20
JJin91: checks=20
REALDEVIL: bets 1400
akbongu1977 is sitting out
akbongu1977 has returned
gabagool5: folds=20
Boney526: calls 1400
JJin91: folds=20
*** TURN *** [3s Qd 8d] [9c]
Boney526: checks=20
REALDEVIL: checks=20
*** RIVER *** [3s Qd 8d 9c] [Tc]
Boney526: checks=20
REALDEVIL: bets 2100
Boney526: calls 2100
*** SHOW DOWN ***
REALDEVIL: shows [6h 6d] (a pair of Sixes)
Boney526: shows [8s 9h] (two pair, Nines and Eights)
Boney526 collected 14694 from pot
*** SUMMARY ***
Total pot 14694 | Rake 0=20
Board [3s Qd 8d 9c Tc]
Seat 1: REALDEVIL showed [6h 6d] and lost with a pair of Sixes
Seat 2: Paceman2jr folded before Flop (didn't bet)
Seat 3: akbongu1977 folded before Flop (didn't bet)
Seat 4: gabagool5 (button) folded on the Flop
Seat 5: JSkelts (small blind) folded before Flop
Seat 7: Boney526 (big blind) showed [8s 9h] and won (14694) with two pa=
ir, Nines and Eights
Seat 8: JJin91 folded on the Flop
Seat 9: snapcallzzz folded before Flop (didn't bet)


*********** # 67 **************
PokerStars Hand #171443277426: Tournament #1648956582, $18.20+$1.80 USD=
 Hold'em No Limit - Level XIV (400/800) - 2017/06/19 21:22:56 ET
Table '1648956582 10' 9-max Seat #5 is the button
Seat 1: REALDEVIL (47232 in chips)=20
Seat 2: Paceman2jr (8161 in chips)=20
Seat 3: akbongu1977 (15874 in chips)=20
Seat 4: gabagool5 (50725 in chips)=20
Seat 5: JSkelts (14420 in chips)=20
Seat 7: Boney526 (35829 in chips)=20
Seat 8: JJin91 (31261 in chips)=20
Seat 9: snapcallzzz (11311 in chips)=20
REALDEVIL: posts the ante 100
Paceman2jr: posts the ante 100
akbongu1977: posts the ante 100
gabagool5: posts the ante 100
JSkelts: posts the ante 100
Boney526: posts the ante 100
JJin91: posts the ante 100
snapcallzzz: posts the ante 100
Boney526: posts small blind 400
JJin91: posts big blind 800
*** HOLE CARDS ***
Dealt to JJin91 [Qh 2h]
snapcallzzz: folds=20
REALDEVIL: folds=20
Paceman2jr: calls 800
akbongu1977: calls 800
gabagool5: folds=20
JSkelts: folds=20
Boney526: calls 400
JJin91: checks=20
*** FLOP *** [6s Ad 6d]
Boney526: checks=20
JJin91: checks=20
Paceman2jr: bets 2000
akbongu1977: folds=20
Boney526: folds=20
JJin91: folds=20
Uncalled bet (2000) returned to Paceman2jr
Paceman2jr collected 4000 from pot
*** SUMMARY ***
Total pot 4000 | Rake 0=20
Board [6s Ad 6d]
Seat 1: REALDEVIL folded before Flop (didn't bet)
Seat 2: Paceman2jr collected (4000)
Seat 3: akbongu1977 folded on the Flop
Seat 4: gabagool5 folded before Flop (didn't bet)
Seat 5: JSkelts (button) folded before Flop (didn't bet)
Seat 7: Boney526 (small blind) folded on the Flop
Seat 8: JJin91 (big blind) folded on the Flop
Seat 9: snapcallzzz folded before Flop (didn't bet)


*********** # 68 **************
PokerStars Hand #171443277717: Tournament #1648956582, $18.20+$1.80 USD=
 Hold'em No Limit - Level XIV (400/800) - 2017/06/19 21:23:47 ET
Table '1648956582 10' 9-max Seat #7 is the button
Seat 1: REALDEVIL (47132 in chips)=20
Seat 2: Paceman2jr (11261 in chips)=20
Seat 3: akbongu1977 (14974 in chips)=20
Seat 4: gabagool5 (50625 in chips)=20
Seat 5: JSkelts (14320 in chips)=20
Seat 7: Boney526 (34929 in chips)=20
Seat 8: JJin91 (30361 in chips)=20
Seat 9: snapcallzzz (11211 in chips)=20
REALDEVIL: posts the ante 100
Paceman2jr: posts the ante 100
akbongu1977: posts the ante 100
gabagool5: posts the ante 100
JSkelts: posts the ante 100
Boney526: posts the ante 100
JJin91: posts the ante 100
snapcallzzz: posts the ante 100
JJin91: posts small blind 400
snapcallzzz: posts big blind 800
*** HOLE CARDS ***
Dealt to JJin91 [Qh 3s]
REALDEVIL: folds=20
Paceman2jr: folds=20
akbongu1977: folds=20
gabagool5: raises 800 to 1600
JSkelts: folds=20
Boney526: calls 1600
JJin91: folds=20
snapcallzzz: calls 800
*** FLOP *** [4c 9d 9s]
snapcallzzz: checks=20
gabagool5: checks=20
Boney526: bets 1740
snapcallzzz: folds=20
gabagool5: folds=20
Uncalled bet (1740) returned to Boney526
Boney526 collected 6000 from pot
Boney526: doesn't show hand=20
*** SUMMARY ***
Total pot 6000 | Rake 0=20
Board [4c 9d 9s]
Seat 1: REALDEVIL folded before Flop (didn't bet)
Seat 2: Paceman2jr folded before Flop (didn't bet)
Seat 3: akbongu1977 folded before Flop (didn't bet)
Seat 4: gabagool5 folded on the Flop
Seat 5: JSkelts folded before Flop (didn't bet)
Seat 7: Boney526 (button) collected (6000)
Seat 8: JJin91 (small blind) folded before Flop
Seat 9: snapcallzzz (big blind) folded on the Flop


*********** # 69 **************
PokerStars Hand #171443278061: Tournament #1648956582, $18.20+$1.80 USD=
 Hold'em No Limit - Level XIV (400/800) - 2017/06/19 21:24:51 ET
Table '1648956582 10' 9-max Seat #8 is the button
Seat 1: REALDEVIL (47032 in chips)=20
Seat 2: Paceman2jr (11161 in chips)=20
Seat 3: akbongu1977 (14874 in chips)=20
Seat 4: gabagool5 (48925 in chips)=20
Seat 5: JSkelts (14220 in chips)=20
Seat 7: Boney526 (39229 in chips)=20
Seat 8: JJin91 (29861 in chips)=20
Seat 9: snapcallzzz (9511 in chips)=20
REALDEVIL: posts the ante 100
Paceman2jr: posts the ante 100
akbongu1977: posts the ante 100
gabagool5: posts the ante 100
JSkelts: posts the ante 100
Boney526: posts the ante 100
JJin91: posts the ante 100
snapcallzzz: posts the ante 100
snapcallzzz: posts small blind 400
REALDEVIL: posts big blind 800
*** HOLE CARDS ***
Dealt to JJin91 [Tc 4h]
Paceman2jr: folds=20
akbongu1977: calls 800
gabagool5: folds=20
JSkelts: folds=20
Boney526: folds=20
JJin91: folds=20
snapcallzzz: calls 400
REALDEVIL: checks=20
*** FLOP *** [4d Jh Ah]
snapcallzzz: checks=20
REALDEVIL: checks=20
akbongu1977: bets 13974 and is all-in
snapcallzzz: folds=20
REALDEVIL has timed out
REALDEVIL: folds=20
Uncalled bet (13974) returned to akbongu1977
REALDEVIL is sitting out
akbongu1977 collected 3200 from pot
akbongu1977: doesn't show hand=20
REALDEVIL has returned
*** SUMMARY ***
Total pot 3200 | Rake 0=20
Board [4d Jh Ah]
Seat 1: REALDEVIL (big blind) folded on the Flop
Seat 2: Paceman2jr folded before Flop (didn't bet)
Seat 3: akbongu1977 collected (3200)
Seat 4: gabagool5 folded before Flop (didn't bet)
Seat 5: JSkelts folded before Flop (didn't bet)
Seat 7: Boney526 folded before Flop (didn't bet)
Seat 8: JJin91 (button) folded before Flop (didn't bet)
Seat 9: snapcallzzz (small blind) folded on the Flop


*********** # 70 **************
PokerStars Hand #171443278363: Tournament #1648956582, $18.20+$1.80 USD=
 Hold'em No Limit - Level XIV (400/800) - 2017/06/19 21:25:49 ET
Table '1648956582 10' 9-max Seat #9 is the button
Seat 1: REALDEVIL (46132 in chips)=20
Seat 2: Paceman2jr (11061 in chips)=20
Seat 3: akbongu1977 (17174 in chips)=20
Seat 4: gabagool5 (48825 in chips)=20
Seat 5: JSkelts (14120 in chips)=20
Seat 7: Boney526 (39129 in chips)=20
Seat 8: JJin91 (29761 in chips)=20
Seat 9: snapcallzzz (8611 in chips)=20
REALDEVIL: posts the ante 100
Paceman2jr: posts the ante 100
akbongu1977: posts the ante 100
gabagool5: posts the ante 100
JSkelts: posts the ante 100
Boney526: posts the ante 100
JJin91: posts the ante 100
snapcallzzz: posts the ante 100
REALDEVIL: posts small blind 400
Paceman2jr: posts big blind 800
*** HOLE CARDS ***
Dealt to JJin91 [9s Jd]
akbongu1977: folds=20
gabagool5: folds=20
JSkelts: raises 13220 to 14020 and is all-in
Boney526: folds=20
JJin91 has timed out while disconnected
JJin91: folds=20
JJin91 is sitting out
snapcallzzz: folds=20
REALDEVIL: folds=20
Paceman2jr: folds=20
Uncalled bet (13220) returned to JSkelts
JSkelts collected 2800 from pot
JSkelts: doesn't show hand=20
*** SUMMARY ***
Total pot 2800 | Rake 0=20
Seat 1: REALDEVIL (small blind) folded before Flop
Seat 2: Paceman2jr (big blind) folded before Flop
Seat 3: akbongu1977 folded before Flop (didn't bet)
Seat 4: gabagool5 folded before Flop (didn't bet)
Seat 5: JSkelts collected (2800)
Seat 7: Boney526 folded before Flop (didn't bet)
Seat 8: JJin91 folded before Flop (didn't bet)
Seat 9: snapcallzzz (button) folded before Flop (didn't bet)


*********** # 71 **************
PokerStars Hand #171443278608: Tournament #1648956582, $18.20+$1.80 USD=
 Hold'em No Limit - Level XIV (400/800) - 2017/06/19 21:26:32 ET
Table '1648956582 10' 9-max Seat #1 is the button
Seat 1: REALDEVIL (45632 in chips)=20
Seat 2: Paceman2jr (10161 in chips)=20
Seat 3: akbongu1977 (17074 in chips)=20
Seat 4: gabagool5 (48725 in chips)=20
Seat 5: JSkelts (16020 in chips)=20
Seat 7: Boney526 (39029 in chips)=20
Seat 8: JJin91 (29661 in chips) is sitting out
Seat 9: snapcallzzz (8511 in chips)=20
REALDEVIL: posts the ante 100
Paceman2jr: posts the ante 100
akbongu1977: posts the ante 100
gabagool5: posts the ante 100
JSkelts: posts the ante 100
Boney526: posts the ante 100
JJin91: posts the ante 100
snapcallzzz: posts the ante 100
Paceman2jr: posts small blind 400
akbongu1977: posts big blind 800
*** HOLE CARDS ***
Dealt to JJin91 [Kd 3c]
gabagool5: folds=20
JSkelts: folds=20
Boney526: folds=20
JJin91: folds=20
snapcallzzz: folds=20
REALDEVIL: folds=20
JJin91 has returned
Paceman2jr: raises 9261 to 10061 and is all-in
akbongu1977: folds=20
Uncalled bet (9261) returned to Paceman2jr
Paceman2jr collected 2400 from pot
*** SUMMARY ***
Total pot 2400 | Rake 0=20
Seat 1: REALDEVIL (button) folded before Flop (didn't bet)
Seat 2: Paceman2jr (small blind) collected (2400)
Seat 3: akbongu1977 (big blind) folded before Flop
Seat 4: gabagool5 folded before Flop (didn't bet)
Seat 5: JSkelts folded before Flop (didn't bet)
Seat 7: Boney526 folded before Flop (didn't bet)
Seat 8: JJin91 folded before Flop (didn't bet)
Seat 9: snapcallzzz folded before Flop (didn't bet)


*********** # 72 **************
PokerStars Hand #171443278724: Tournament #1648956582, $18.20+$1.80 USD=
 Hold'em No Limit - Level XIV (400/800) - 2017/06/19 21:26:54 ET
Table '1648956582 10' 9-max Seat #2 is the button
Seat 1: REALDEVIL (45532 in chips)=20
Seat 2: Paceman2jr (11661 in chips)=20
Seat 3: akbongu1977 (16174 in chips)=20
Seat 4: gabagool5 (48625 in chips)=20
Seat 5: JSkelts (15920 in chips)=20
Seat 7: Boney526 (38929 in chips)=20
Seat 8: JJin91 (29561 in chips)=20
Seat 9: snapcallzzz (8411 in chips)=20
REALDEVIL: posts the ante 100
Paceman2jr: posts the ante 100
akbongu1977: posts the ante 100
gabagool5: posts the ante 100
JSkelts: posts the ante 100
Boney526: posts the ante 100
JJin91: posts the ante 100
snapcallzzz: posts the ante 100
akbongu1977: posts small blind 400
gabagool5: posts big blind 800
*** HOLE CARDS ***
Dealt to JJin91 [Qh Jd]
JSkelts: folds=20
Boney526: raises 912 to 1712
JJin91: raises 2732 to 4444
snapcallzzz: folds=20
REALDEVIL: folds=20
Paceman2jr: folds=20
akbongu1977: folds=20
gabagool5: folds=20
Boney526: folds=20
Uncalled bet (2732) returned to JJin91
JJin91 collected 5424 from pot
JJin91: doesn't show hand=20
*** SUMMARY ***
Total pot 5424 | Rake 0=20
Seat 1: REALDEVIL folded before Flop (didn't bet)
Seat 2: Paceman2jr (button) folded before Flop (didn't bet)
Seat 3: akbongu1977 (small blind) folded before Flop
Seat 4: gabagool5 (big blind) folded before Flop
Seat 5: JSkelts folded before Flop (didn't bet)
Seat 7: Boney526 folded before Flop
Seat 8: JJin91 collected (5424)
Seat 9: snapcallzzz folded before Flop (didn't bet)


*********** # 73 **************
PokerStars Hand #171443278930: Tournament #1648956582, $18.20+$1.80 USD=
 Hold'em No Limit - Level XIV (400/800) - 2017/06/19 21:27:33 ET
Table '1648956582 10' 9-max Seat #3 is the button
Seat 1: REALDEVIL (45432 in chips)=20
Seat 2: Paceman2jr (11561 in chips)=20
Seat 3: akbongu1977 (15674 in chips)=20
Seat 4: gabagool5 (47725 in chips)=20
Seat 5: JSkelts (15820 in chips)=20
Seat 7: Boney526 (37117 in chips)=20
Seat 8: JJin91 (33173 in chips)=20
Seat 9: snapcallzzz (8311 in chips)=20
REALDEVIL: posts the ante 100
Paceman2jr: posts the ante 100
akbongu1977: posts the ante 100
gabagool5: posts the ante 100
JSkelts: posts the ante 100
Boney526: posts the ante 100
JJin91: posts the ante 100
snapcallzzz: posts the ante 100
gabagool5: posts small blind 400
JSkelts: posts big blind 800
*** HOLE CARDS ***
Dealt to JJin91 [6h 8d]
Boney526: folds=20
JJin91: folds=20
snapcallzzz: folds=20
REALDEVIL: folds=20
Paceman2jr: folds=20
akbongu1977: folds=20
gabagool5: folds=20
Uncalled bet (400) returned to JSkelts
JSkelts collected 1600 from pot
JSkelts: doesn't show hand=20
*** SUMMARY ***
Total pot 1600 | Rake 0=20
Seat 1: REALDEVIL folded before Flop (didn't bet)
Seat 2: Paceman2jr folded before Flop (didn't bet)
Seat 3: akbongu1977 (button) folded before Flop (didn't bet)
Seat 4: gabagool5 (small blind) folded before Flop
Seat 5: JSkelts (big blind) collected (1600)
Seat 7: Boney526 folded before Flop (didn't bet)
Seat 8: JJin91 folded before Flop (didn't bet)
Seat 9: snapcallzzz folded before Flop (didn't bet)


*********** # 74 **************
PokerStars Hand #171443279086: Tournament #1648956582, $18.20+$1.80 USD=
 Hold'em No Limit - Level XIV (400/800) - 2017/06/19 21:28:02 ET
Table '1648956582 10' 9-max Seat #4 is the button
Seat 1: REALDEVIL (45332 in chips)=20
Seat 2: Paceman2jr (11461 in chips)=20
Seat 3: akbongu1977 (15574 in chips)=20
Seat 4: gabagool5 (47225 in chips)=20
Seat 5: JSkelts (16920 in chips)=20
Seat 7: Boney526 (37017 in chips)=20
Seat 8: JJin91 (33073 in chips)=20
Seat 9: snapcallzzz (8211 in chips)=20
REALDEVIL: posts the ante 100
Paceman2jr: posts the ante 100
akbongu1977: posts the ante 100
gabagool5: posts the ante 100
JSkelts: posts the ante 100
Boney526: posts the ante 100
JJin91: posts the ante 100
snapcallzzz: posts the ante 100
JSkelts: posts small blind 400
Boney526: posts big blind 800
*** HOLE CARDS ***
Dealt to JJin91 [4d 7d]
JJin91: folds=20
snapcallzzz: raises 7311 to 8111 and is all-in
REALDEVIL: folds=20
Paceman2jr: folds=20
akbongu1977: folds=20
gabagool5: folds=20
JSkelts: folds=20
Boney526: calls 7311
*** FLOP *** [9d Kd Kh]
*** TURN *** [9d Kd Kh] [6h]
*** RIVER *** [9d Kd Kh 6h] [Th]
*** SHOW DOWN ***
Boney526: shows [As Jh] (a pair of Kings)
snapcallzzz: shows [Jc Kc] (three of a kind, Kings)
snapcallzzz collected 17422 from pot
*** SUMMARY ***
Total pot 17422 | Rake 0=20
Board [9d Kd Kh 6h Th]
Seat 1: REALDEVIL folded before Flop (didn't bet)
Seat 2: Paceman2jr folded before Flop (didn't bet)
Seat 3: akbongu1977 folded before Flop (didn't bet)
Seat 4: gabagool5 (button) folded before Flop (didn't bet)
Seat 5: JSkelts (small blind) folded before Flop
Seat 7: Boney526 (big blind) showed [As Jh] and lost with a pair of Kin=
gs
Seat 8: JJin91 folded before Flop (didn't bet)
Seat 9: snapcallzzz showed [Jc Kc] and won (17422) with three of a kind=
, Kings


*********** # 75 **************
PokerStars Hand #171443279305: Tournament #1648956582, $18.20+$1.80 USD=
 Hold'em No Limit - Level XIV (400/800) - 2017/06/19 21:28:43 ET
Table '1648956582 10' 9-max Seat #5 is the button
Seat 1: REALDEVIL (45232 in chips)=20
Seat 2: Paceman2jr (11361 in chips)=20
Seat 3: akbongu1977 (15474 in chips)=20
Seat 4: gabagool5 (47125 in chips)=20
Seat 5: JSkelts (16420 in chips)=20
Seat 6: gatorchapnj (19235 in chips) out of hand (moved from another ta=
ble into small blind)
Seat 7: Boney526 (28806 in chips)=20
Seat 8: JJin91 (32973 in chips)=20
Seat 9: snapcallzzz (17422 in chips)=20
REALDEVIL: posts the ante 100
Paceman2jr: posts the ante 100
akbongu1977: posts the ante 100
gabagool5: posts the ante 100
JSkelts: posts the ante 100
Boney526: posts the ante 100
JJin91: posts the ante 100
snapcallzzz: posts the ante 100
Boney526: posts small blind 400
JJin91: posts big blind 800
*** HOLE CARDS ***
Dealt to JJin91 [2s 9h]
snapcallzzz: folds=20
REALDEVIL: folds=20
Paceman2jr: folds=20
akbongu1977: folds=20
gabagool5: raises 960 to 1760
JSkelts: folds=20
Boney526: folds=20
JJin91: folds=20
Uncalled bet (960) returned to gabagool5
gabagool5 collected 2800 from pot
gabagool5: doesn't show hand=20
*** SUMMARY ***
Total pot 2800 | Rake 0=20
Seat 1: REALDEVIL folded before Flop (didn't bet)
Seat 2: Paceman2jr folded before Flop (didn't bet)
Seat 3: akbongu1977 folded before Flop (didn't bet)
Seat 4: gabagool5 collected (2800)
Seat 5: JSkelts (button) folded before Flop (didn't bet)
Seat 7: Boney526 (small blind) folded before Flop
Seat 8: JJin91 (big blind) folded before Flop
Seat 9: snapcallzzz folded before Flop (didn't bet)


*********** # 76 **************
PokerStars Hand #171443279401: Tournament #1648956582, $18.20+$1.80 USD=
 Hold'em No Limit - Level XIV (400/800) - 2017/06/19 21:29:00 ET
Table '1648956582 10' 9-max Seat #7 is the button
Seat 1: REALDEVIL (45132 in chips)=20
Seat 2: Paceman2jr (11261 in chips)=20
Seat 3: akbongu1977 (15374 in chips)=20
Seat 4: gabagool5 (49025 in chips)=20
Seat 5: JSkelts (16320 in chips)=20
Seat 6: gatorchapnj (19235 in chips)=20
Seat 7: Boney526 (28306 in chips)=20
Seat 8: JJin91 (32073 in chips)=20
Seat 9: snapcallzzz (17322 in chips)=20
REALDEVIL: posts the ante 100
Paceman2jr: posts the ante 100
akbongu1977: posts the ante 100
gabagool5: posts the ante 100
JSkelts: posts the ante 100
gatorchapnj: posts the ante 100
Boney526: posts the ante 100
JJin91: posts the ante 100
snapcallzzz: posts the ante 100
JJin91: posts small blind 400
snapcallzzz: posts big blind 800
*** HOLE CARDS ***
Dealt to JJin91 [6s 5h]
REALDEVIL: folds=20
Paceman2jr: folds=20
akbongu1977: folds=20
gabagool5: folds=20
JSkelts: folds=20
gatorchapnj: folds=20
Boney526: raises 912 to 1712
JJin91: folds=20
snapcallzzz: calls 912
*** FLOP *** [Qh 2h Td]
snapcallzzz: checks=20
Boney526: bets 1370
snapcallzzz: folds=20
Uncalled bet (1370) returned to Boney526
Boney526 collected 4724 from pot
Boney526: doesn't show hand=20
*** SUMMARY ***
Total pot 4724 | Rake 0=20
Board [Qh 2h Td]
Seat 1: REALDEVIL folded before Flop (didn't bet)
Seat 2: Paceman2jr folded before Flop (didn't bet)
Seat 3: akbongu1977 folded before Flop (didn't bet)
Seat 4: gabagool5 folded before Flop (didn't bet)
Seat 5: JSkelts folded before Flop (didn't bet)
Seat 6: gatorchapnj folded before Flop (didn't bet)
Seat 7: Boney526 (button) collected (4724)
Seat 8: JJin91 (small blind) folded before Flop
Seat 9: snapcallzzz (big blind) folded on the Flop


*********** # 77 **************
PokerStars Hand #171443279573: Tournament #1648956582, $18.20+$1.80 USD=
 Hold'em No Limit - Level XIV (400/800) - 2017/06/19 21:29:33 ET
Table '1648956582 10' 9-max Seat #8 is the button
Seat 1: REALDEVIL (45032 in chips)=20
Seat 2: Paceman2jr (11161 in chips)=20
Seat 3: akbongu1977 (15274 in chips)=20
Seat 4: gabagool5 (48925 in chips)=20
Seat 5: JSkelts (16220 in chips)=20
Seat 6: gatorchapnj (19135 in chips)=20
Seat 7: Boney526 (31218 in chips)=20
Seat 8: JJin91 (31573 in chips)=20
Seat 9: snapcallzzz (15510 in chips)=20
REALDEVIL: posts the ante 100
Paceman2jr: posts the ante 100
akbongu1977: posts the ante 100
gabagool5: posts the ante 100
JSkelts: posts the ante 100
gatorchapnj: posts the ante 100
Boney526: posts the ante 100
JJin91: posts the ante 100
snapcallzzz: posts the ante 100
snapcallzzz: posts small blind 400
REALDEVIL: posts big blind 800
*** HOLE CARDS ***
Dealt to JJin91 [2c 4h]
Paceman2jr: folds=20
akbongu1977: folds=20
gabagool5: folds=20
JSkelts: folds=20
gatorchapnj: folds=20
Boney526: raises 912 to 1712
JJin91: folds=20
snapcallzzz: folds=20
REALDEVIL: folds=20
Uncalled bet (912) returned to Boney526
Boney526 collected 2900 from pot
Boney526: doesn't show hand=20
*** SUMMARY ***
Total pot 2900 | Rake 0=20
Seat 1: REALDEVIL (big blind) folded before Flop
Seat 2: Paceman2jr folded before Flop (didn't bet)
Seat 3: akbongu1977 folded before Flop (didn't bet)
Seat 4: gabagool5 folded before Flop (didn't bet)
Seat 5: JSkelts folded before Flop (didn't bet)
Seat 6: gatorchapnj folded before Flop (didn't bet)
Seat 7: Boney526 collected (2900)
Seat 8: JJin91 (button) folded before Flop (didn't bet)
Seat 9: snapcallzzz (small blind) folded before Flop


*********** # 78 **************
PokerStars Hand #171443279698: Tournament #1648956582, $18.20+$1.80 USD=
 Hold'em No Limit - Level XIV (400/800) - 2017/06/19 21:29:56 ET
Table '1648956582 10' 9-max Seat #9 is the button
Seat 1: REALDEVIL (44132 in chips)=20
Seat 2: Paceman2jr (11061 in chips)=20
Seat 3: akbongu1977 (15174 in chips)=20
Seat 4: gabagool5 (48825 in chips)=20
Seat 5: JSkelts (16120 in chips)=20
Seat 6: gatorchapnj (19035 in chips)=20
Seat 7: Boney526 (33218 in chips)=20
Seat 8: JJin91 (31473 in chips)=20
Seat 9: snapcallzzz (15010 in chips)=20
REALDEVIL: posts the ante 100
Paceman2jr: posts the ante 100
akbongu1977: posts the ante 100
gabagool5: posts the ante 100
JSkelts: posts the ante 100
gatorchapnj: posts the ante 100
Boney526: posts the ante 100
JJin91: posts the ante 100
snapcallzzz: posts the ante 100
REALDEVIL: posts small blind 400
Paceman2jr: posts big blind 800
*** HOLE CARDS ***
Dealt to JJin91 [7h Qh]
akbongu1977: folds=20
gabagool5: folds=20
JSkelts: raises 960 to 1760
gatorchapnj: folds=20
Boney526: folds=20
JJin91: folds=20
snapcallzzz: folds=20
REALDEVIL: folds=20
Paceman2jr: folds=20
Uncalled bet (960) returned to JSkelts
JSkelts collected 2900 from pot
JSkelts: doesn't show hand=20
*** SUMMARY ***
Total pot 2900 | Rake 0=20
Seat 1: REALDEVIL (small blind) folded before Flop
Seat 2: Paceman2jr (big blind) folded before Flop
Seat 3: akbongu1977 folded before Flop (didn't bet)
Seat 4: gabagool5 folded before Flop (didn't bet)
Seat 5: JSkelts collected (2900)
Seat 6: gatorchapnj folded before Flop (didn't bet)
Seat 7: Boney526 folded before Flop (didn't bet)
Seat 8: JJin91 folded before Flop (didn't bet)
Seat 9: snapcallzzz (button) folded before Flop (didn't bet)


*********** # 79 **************
PokerStars Hand #171443279854: Tournament #1648956582, $18.20+$1.80 USD=
 Hold'em No Limit - Level XIV (400/800) - 2017/06/19 21:30:24 ET
Table '1648956582 10' 9-max Seat #1 is the button
Seat 1: REALDEVIL (43632 in chips)=20
Seat 2: Paceman2jr (10161 in chips)=20
Seat 3: akbongu1977 (15074 in chips)=20
Seat 4: gabagool5 (48725 in chips)=20
Seat 5: JSkelts (18120 in chips)=20
Seat 6: gatorchapnj (18935 in chips)=20
Seat 7: Boney526 (33118 in chips)=20
Seat 8: JJin91 (31373 in chips)=20
Seat 9: snapcallzzz (14910 in chips)=20
REALDEVIL: posts the ante 100
Paceman2jr: posts the ante 100
akbongu1977: posts the ante 100
gabagool5: posts the ante 100
JSkelts: posts the ante 100
gatorchapnj: posts the ante 100
Boney526: posts the ante 100
JJin91: posts the ante 100
snapcallzzz: posts the ante 100
Paceman2jr: posts small blind 400
akbongu1977: posts big blind 800
*** HOLE CARDS ***
Dealt to JJin91 [Ah 6d]
gabagool5: folds=20
JSkelts: folds=20
gatorchapnj: folds=20
Boney526: folds=20
JJin91: folds=20
snapcallzzz: folds=20
REALDEVIL: raises 800 to 1600
Paceman2jr: calls 1200
akbongu1977: calls 800
*** FLOP *** [3h 3d Qd]
Paceman2jr: checks=20
akbongu1977: checks=20
REALDEVIL: checks=20
*** TURN *** [3h 3d Qd] [7h]
Paceman2jr: checks=20
akbongu1977: checks=20
REALDEVIL: checks=20
*** RIVER *** [3h 3d Qd 7h] [7c]
Paceman2jr: checks=20
akbongu1977: checks=20
REALDEVIL: bets 5700
Paceman2jr: folds=20
akbongu1977: folds=20
Uncalled bet (5700) returned to REALDEVIL
REALDEVIL collected 5700 from pot
*** SUMMARY ***
Total pot 5700 | Rake 0=20
Board [3h 3d Qd 7h 7c]
Seat 1: REALDEVIL (button) collected (5700)
Seat 2: Paceman2jr (small blind) folded on the River
Seat 3: akbongu1977 (big blind) folded on the River
Seat 4: gabagool5 folded before Flop (didn't bet)
Seat 5: JSkelts folded before Flop (didn't bet)
Seat 6: gatorchapnj folded before Flop (didn't bet)
Seat 7: Boney526 folded before Flop (didn't bet)
Seat 8: JJin91 folded before Flop (didn't bet)
Seat 9: snapcallzzz folded before Flop (didn't bet)


*********** # 80 **************
PokerStars Hand #171443888422: Tournament #1648956582, $18.20+$1.80 USD=
 Hold'em No Limit - Level XIV (400/800) - 2017/06/19 21:31:15 ET
Table '1648956582 10' 9-max Seat #2 is the button
Seat 1: REALDEVIL (47632 in chips)=20
Seat 2: Paceman2jr (8461 in chips)=20
Seat 3: akbongu1977 (13374 in chips)=20
Seat 4: gabagool5 (48625 in chips)=20
Seat 5: JSkelts (18020 in chips)=20
Seat 6: gatorchapnj (18835 in chips)=20
Seat 7: Boney526 (33018 in chips)=20
Seat 8: JJin91 (31273 in chips)=20
Seat 9: snapcallzzz (14810 in chips)=20
REALDEVIL: posts the ante 100
Paceman2jr: posts the ante 100
akbongu1977: posts the ante 100
gabagool5: posts the ante 100
JSkelts: posts the ante 100
gatorchapnj: posts the ante 100
Boney526: posts the ante 100
JJin91: posts the ante 100
snapcallzzz: posts the ante 100
akbongu1977: posts small blind 400
gabagool5: posts big blind 800
*** HOLE CARDS ***
Dealt to JJin91 [9c 5h]
JSkelts: folds=20
gatorchapnj: folds=20
Boney526: folds=20
JJin91: folds=20
snapcallzzz: folds=20
REALDEVIL: folds=20
Paceman2jr: folds=20
akbongu1977: calls 400
gabagool5: raises 1600 to 2400
akbongu1977: folds=20
Uncalled bet (1600) returned to gabagool5
gabagool5 collected 2500 from pot
gabagool5: doesn't show hand=20
*** SUMMARY ***
Total pot 2500 | Rake 0=20
Seat 1: REALDEVIL folded before Flop (didn't bet)
Seat 2: Paceman2jr (button) folded before Flop (didn't bet)
Seat 3: akbongu1977 (small blind) folded before Flop
Seat 4: gabagool5 (big blind) collected (2500)
Seat 5: JSkelts folded before Flop (didn't bet)
Seat 6: gatorchapnj folded before Flop (didn't bet)
Seat 7: Boney526 folded before Flop (didn't bet)
Seat 8: JJin91 folded before Flop (didn't bet)
Seat 9: snapcallzzz folded before Flop (didn't bet)


*********** # 81 **************
PokerStars Hand #171443888619: Tournament #1648956582, $18.20+$1.80 USD=
 Hold'em No Limit - Level XIV (400/800) - 2017/06/19 21:31:48 ET
Table '1648956582 10' 9-max Seat #3 is the button
Seat 1: REALDEVIL (47532 in chips)=20
Seat 2: Paceman2jr (8361 in chips)=20
Seat 3: akbongu1977 (12474 in chips)=20
Seat 4: gabagool5 (50225 in chips)=20
Seat 5: JSkelts (17920 in chips)=20
Seat 6: gatorchapnj (18735 in chips)=20
Seat 7: Boney526 (32918 in chips)=20
Seat 8: JJin91 (31173 in chips)=20
Seat 9: snapcallzzz (14710 in chips)=20
REALDEVIL: posts the ante 100
Paceman2jr: posts the ante 100
akbongu1977: posts the ante 100
gabagool5: posts the ante 100
JSkelts: posts the ante 100
gatorchapnj: posts the ante 100
Boney526: posts the ante 100
JJin91: posts the ante 100
snapcallzzz: posts the ante 100
gabagool5: posts small blind 400
JSkelts: posts big blind 800
*** HOLE CARDS ***
Dealt to JJin91 [4s Jh]
gatorchapnj: folds=20
Boney526: folds=20
JJin91: folds=20
snapcallzzz: folds=20
REALDEVIL: folds=20
Paceman2jr: folds=20
akbongu1977: folds=20
gabagool5: raises 1600 to 2400
JSkelts: folds=20
Uncalled bet (1600) returned to gabagool5
gabagool5 collected 2500 from pot
gabagool5: doesn't show hand=20
*** SUMMARY ***
Total pot 2500 | Rake 0=20
Seat 1: REALDEVIL folded before Flop (didn't bet)
Seat 2: Paceman2jr folded before Flop (didn't bet)
Seat 3: akbongu1977 (button) folded before Flop (didn't bet)
Seat 4: gabagool5 (small blind) collected (2500)
Seat 5: JSkelts (big blind) folded before Flop
Seat 6: gatorchapnj folded before Flop (didn't bet)
Seat 7: Boney526 folded before Flop (didn't bet)
Seat 8: JJin91 folded before Flop (didn't bet)
Seat 9: snapcallzzz folded before Flop (didn't bet)


*********** # 82 **************
PokerStars Hand #171443888805: Tournament #1648956582, $18.20+$1.80 USD=
 Hold'em No Limit - Level XV (500/1000) - 2017/06/19 21:32:22 ET
Table '1648956582 10' 9-max Seat #4 is the button
Seat 1: REALDEVIL (47432 in chips)=20
Seat 2: Paceman2jr (8261 in chips)=20
Seat 3: akbongu1977 (12374 in chips)=20
Seat 4: gabagool5 (51825 in chips)=20
Seat 5: JSkelts (17020 in chips)=20
Seat 6: gatorchapnj (18635 in chips)=20
Seat 7: Boney526 (32818 in chips)=20
Seat 8: JJin91 (31073 in chips)=20
Seat 9: snapcallzzz (14610 in chips)=20
REALDEVIL: posts the ante 125
Paceman2jr: posts the ante 125
akbongu1977: posts the ante 125
gabagool5: posts the ante 125
JSkelts: posts the ante 125
gatorchapnj: posts the ante 125
Boney526: posts the ante 125
JJin91: posts the ante 125
snapcallzzz: posts the ante 125
JSkelts: posts small blind 500
gatorchapnj: posts big blind 1000
*** HOLE CARDS ***
Dealt to JJin91 [8h Ts]
Boney526: folds=20
JJin91: folds=20
snapcallzzz: folds=20
REALDEVIL: folds=20
Paceman2jr: folds=20
akbongu1977: raises 11249 to 12249 and is all-in
gabagool5: folds=20
JSkelts: folds=20
gatorchapnj: folds=20
Uncalled bet (11249) returned to akbongu1977
akbongu1977 collected 3625 from pot
akbongu1977: doesn't show hand=20
*** SUMMARY ***
Total pot 3625 | Rake 0=20
Seat 1: REALDEVIL folded before Flop (didn't bet)
Seat 2: Paceman2jr folded before Flop (didn't bet)
Seat 3: akbongu1977 collected (3625)
Seat 4: gabagool5 (button) folded before Flop (didn't bet)
Seat 5: JSkelts (small blind) folded before Flop
Seat 6: gatorchapnj (big blind) folded before Flop
Seat 7: Boney526 folded before Flop (didn't bet)
Seat 8: JJin91 folded before Flop (didn't bet)
Seat 9: snapcallzzz folded before Flop (didn't bet)


*********** # 83 **************
PokerStars Hand #171443888937: Tournament #1648956582, $18.20+$1.80 USD=
 Hold'em No Limit - Level XV (500/1000) - 2017/06/19 21:32:46 ET
Table '1648956582 10' 9-max Seat #5 is the button
Seat 1: REALDEVIL (47307 in chips)=20
Seat 2: Paceman2jr (8136 in chips)=20
Seat 3: akbongu1977 (14874 in chips)=20
Seat 4: gabagool5 (51700 in chips)=20
Seat 5: JSkelts (16395 in chips)=20
Seat 6: gatorchapnj (17510 in chips)=20
Seat 7: Boney526 (32693 in chips)=20
Seat 8: JJin91 (30948 in chips)=20
Seat 9: snapcallzzz (14485 in chips)=20
REALDEVIL: posts the ante 125
Paceman2jr: posts the ante 125
akbongu1977: posts the ante 125
gabagool5: posts the ante 125
JSkelts: posts the ante 125
gatorchapnj: posts the ante 125
Boney526: posts the ante 125
JJin91: posts the ante 125
snapcallzzz: posts the ante 125
gatorchapnj: posts small blind 500
Boney526: posts big blind 1000
*** HOLE CARDS ***
Dealt to JJin91 [3c Kh]
JJin91: folds=20
snapcallzzz: folds=20
REALDEVIL: folds=20
Paceman2jr: folds=20
akbongu1977: calls 1000
gabagool5: folds=20
JSkelts: folds=20
gatorchapnj: folds=20
Boney526: checks=20
*** FLOP *** [9d 2s 3h]
Boney526: checks=20
akbongu1977: bets 3625
Boney526: folds=20
Uncalled bet (3625) returned to akbongu1977
akbongu1977 collected 3625 from pot
akbongu1977: doesn't show hand=20
*** SUMMARY ***
Total pot 3625 | Rake 0=20
Board [9d 2s 3h]
Seat 1: REALDEVIL folded before Flop (didn't bet)
Seat 2: Paceman2jr folded before Flop (didn't bet)
Seat 3: akbongu1977 collected (3625)
Seat 4: gabagool5 folded before Flop (didn't bet)
Seat 5: JSkelts (button) folded before Flop (didn't bet)
Seat 6: gatorchapnj (small blind) folded before Flop
Seat 7: Boney526 (big blind) folded on the Flop
Seat 8: JJin91 folded before Flop (didn't bet)
Seat 9: snapcallzzz folded before Flop (didn't bet)


*********** # 84 **************
PokerStars Hand #171443889175: Tournament #1648956582, $18.20+$1.80 USD=
 Hold'em No Limit - Level XV (500/1000) - 2017/06/19 21:33:28 ET
Table '1648956582 10' 9-max Seat #6 is the button
Seat 1: REALDEVIL (47182 in chips)=20
Seat 3: akbongu1977 (17374 in chips)=20
Seat 4: gabagool5 (51575 in chips)=20
Seat 5: JSkelts (16270 in chips)=20
Seat 6: gatorchapnj (16885 in chips)=20
Seat 7: Boney526 (31568 in chips)=20
Seat 8: JJin91 (30823 in chips)=20
Seat 9: snapcallzzz (14360 in chips)=20
REALDEVIL: posts the ante 125
akbongu1977: posts the ante 125
gabagool5: posts the ante 125
JSkelts: posts the ante 125
gatorchapnj: posts the ante 125
Boney526: posts the ante 125
JJin91: posts the ante 125
snapcallzzz: posts the ante 125
Boney526: posts small blind 500
JJin91: posts big blind 1000
*** HOLE CARDS ***
Dealt to JJin91 [2h 8c]
snapcallzzz: raises 13235 to 14235 and is all-in
REALDEVIL: folds=20
akbongu1977: folds=20
gabagool5: folds=20
JSkelts: folds=20
gatorchapnj: folds=20
Boney526: folds=20
JJin91: folds=20
Uncalled bet (13235) returned to snapcallzzz
snapcallzzz collected 3500 from pot
snapcallzzz: doesn't show hand=20
*** SUMMARY ***
Total pot 3500 | Rake 0=20
Seat 1: REALDEVIL folded before Flop (didn't bet)
Seat 3: akbongu1977 folded before Flop (didn't bet)
Seat 4: gabagool5 folded before Flop (didn't bet)
Seat 5: JSkelts folded before Flop (didn't bet)
Seat 6: gatorchapnj (button) folded before Flop (didn't bet)
Seat 7: Boney526 (small blind) folded before Flop
Seat 8: JJin91 (big blind) folded before Flop
Seat 9: snapcallzzz collected (3500)


*********** # 85 **************
PokerStars Hand #171443889283: Tournament #1648956582, $18.20+$1.80 USD=
 Hold'em No Limit - Level XV (500/1000) - 2017/06/19 21:33:51 ET
Table '1648956582 10' 9-max Seat #7 is the button
Seat 1: REALDEVIL (47057 in chips)=20
Seat 3: akbongu1977 (17249 in chips)=20
Seat 4: gabagool5 (51450 in chips)=20
Seat 5: JSkelts (16145 in chips)=20
Seat 6: gatorchapnj (16760 in chips)=20
Seat 7: Boney526 (30943 in chips)=20
Seat 8: JJin91 (29698 in chips)=20
Seat 9: snapcallzzz (16735 in chips)=20
REALDEVIL: posts the ante 125
akbongu1977: posts the ante 125
gabagool5: posts the ante 125
JSkelts: posts the ante 125
gatorchapnj: posts the ante 125
Boney526: posts the ante 125
JJin91: posts the ante 125
snapcallzzz: posts the ante 125
JJin91: posts small blind 500
snapcallzzz: posts big blind 1000
*** HOLE CARDS ***
Dealt to JJin91 [Qd Jd]
REALDEVIL: raises 1000 to 2000
akbongu1977: folds=20
gabagool5: folds=20
JSkelts: folds=20
gatorchapnj: folds=20
Boney526: folds=20
JJin91: calls 1500
snapcallzzz: folds=20
*** FLOP *** [8c Ah 3d]
JJin91: checks=20
REALDEVIL: bets 3000
JJin91: folds=20
Uncalled bet (3000) returned to REALDEVIL
REALDEVIL collected 6000 from pot
*** SUMMARY ***
Total pot 6000 | Rake 0=20
Board [8c Ah 3d]
Seat 1: REALDEVIL collected (6000)
Seat 3: akbongu1977 folded before Flop (didn't bet)
Seat 4: gabagool5 folded before Flop (didn't bet)
Seat 5: JSkelts folded before Flop (didn't bet)
Seat 6: gatorchapnj folded before Flop (didn't bet)
Seat 7: Boney526 (button) folded before Flop (didn't bet)
Seat 8: JJin91 (small blind) folded on the Flop
Seat 9: snapcallzzz (big blind) folded before Flop


*********** # 86 **************
PokerStars Hand #171443889521: Tournament #1648956582, $18.20+$1.80 USD=
 Hold'em No Limit - Level XV (500/1000) - 2017/06/19 21:34:36 ET
Table '1648956582 10' 9-max Seat #8 is the button
Seat 1: REALDEVIL (50932 in chips)=20
Seat 3: akbongu1977 (17124 in chips)=20
Seat 4: gabagool5 (51325 in chips)=20
Seat 5: JSkelts (16020 in chips)=20
Seat 6: gatorchapnj (16635 in chips)=20
Seat 7: Boney526 (30818 in chips)=20
Seat 8: JJin91 (27573 in chips)=20
Seat 9: snapcallzzz (15610 in chips)=20
REALDEVIL: posts the ante 125
akbongu1977: posts the ante 125
gabagool5: posts the ante 125
JSkelts: posts the ante 125
gatorchapnj: posts the ante 125
Boney526: posts the ante 125
JJin91: posts the ante 125
snapcallzzz: posts the ante 125
snapcallzzz: posts small blind 500
REALDEVIL: posts big blind 1000
*** HOLE CARDS ***
Dealt to JJin91 [8h 7s]
akbongu1977: folds=20
gabagool5: folds=20
JSkelts: folds=20
gatorchapnj: folds=20
Boney526: folds=20
JJin91: raises 1570 to 2570
snapcallzzz: folds=20
REALDEVIL: folds=20
Uncalled bet (1570) returned to JJin91
JJin91 collected 3500 from pot
JJin91: doesn't show hand=20
*** SUMMARY ***
Total pot 3500 | Rake 0=20
Seat 1: REALDEVIL (big blind) folded before Flop
Seat 3: akbongu1977 folded before Flop (didn't bet)
Seat 4: gabagool5 folded before Flop (didn't bet)
Seat 5: JSkelts folded before Flop (didn't bet)
Seat 6: gatorchapnj folded before Flop (didn't bet)
Seat 7: Boney526 folded before Flop (didn't bet)
Seat 8: JJin91 (button) collected (3500)
Seat 9: snapcallzzz (small blind) folded before Flop


*********** # 87 **************
PokerStars Hand #171443889669: Tournament #1648956582, $18.20+$1.80 USD=
 Hold'em No Limit - Level XV (500/1000) - 2017/06/19 21:35:04 ET
Table '1648956582 10' 9-max Seat #9 is the button
Seat 1: REALDEVIL (49807 in chips)=20
Seat 3: akbongu1977 (16999 in chips)=20
Seat 4: gabagool5 (51200 in chips)=20
Seat 5: JSkelts (15895 in chips)=20
Seat 6: gatorchapnj (16510 in chips)=20
Seat 7: Boney526 (30693 in chips)=20
Seat 8: JJin91 (29948 in chips)=20
Seat 9: snapcallzzz (14985 in chips)=20
REALDEVIL: posts the ante 125
akbongu1977: posts the ante 125
gabagool5: posts the ante 125
JSkelts: posts the ante 125
gatorchapnj: posts the ante 125
Boney526: posts the ante 125
JJin91: posts the ante 125
snapcallzzz: posts the ante 125
REALDEVIL: posts small blind 500
akbongu1977: posts big blind 1000
*** HOLE CARDS ***
Dealt to JJin91 [Qd Kd]
gabagool5: folds=20
JSkelts: folds=20
gatorchapnj: folds=20
Boney526: folds=20
JJin91: raises 1190 to 2190
snapcallzzz: folds=20
REALDEVIL: folds=20
akbongu1977: folds=20
Uncalled bet (1190) returned to JJin91
JJin91 collected 3500 from pot
JJin91: doesn't show hand=20
*** SUMMARY ***
Total pot 3500 | Rake 0=20
Seat 1: REALDEVIL (small blind) folded before Flop
Seat 3: akbongu1977 (big blind) folded before Flop
Seat 4: gabagool5 folded before Flop (didn't bet)
Seat 5: JSkelts folded before Flop (didn't bet)
Seat 6: gatorchapnj folded before Flop (didn't bet)
Seat 7: Boney526 folded before Flop (didn't bet)
Seat 8: JJin91 collected (3500)
Seat 9: snapcallzzz (button) folded before Flop (didn't bet)


*********** # 88 **************
PokerStars Hand #171443889798: Tournament #1648956582, $18.20+$1.80 USD=
 Hold'em No Limit - Level XV (500/1000) - 2017/06/19 21:35:30 ET
Table '1648956582 10' 9-max Seat #1 is the button
Seat 1: REALDEVIL (49182 in chips)=20
Seat 3: akbongu1977 (15874 in chips)=20
Seat 4: gabagool5 (51075 in chips)=20
Seat 5: JSkelts (15770 in chips)=20
Seat 6: gatorchapnj (16385 in chips)=20
Seat 7: Boney526 (30568 in chips)=20
Seat 8: JJin91 (32323 in chips)=20
Seat 9: snapcallzzz (14860 in chips)=20
REALDEVIL: posts the ante 125
akbongu1977: posts the ante 125
gabagool5: posts the ante 125
JSkelts: posts the ante 125
gatorchapnj: posts the ante 125
Boney526: posts the ante 125
JJin91: posts the ante 125
snapcallzzz: posts the ante 125
akbongu1977: posts small blind 500
gabagool5: posts big blind 1000
*** HOLE CARDS ***
Dealt to JJin91 [Ks 9c]
JSkelts: folds=20
gatorchapnj: folds=20
Boney526: raises 1140 to 2140
JJin91: folds=20
snapcallzzz: folds=20
REALDEVIL: folds=20
akbongu1977: folds=20
gabagool5: calls 1140
*** FLOP *** [8c 7d 7h]
gabagool5: checks=20
Boney526: bets 1676
gabagool5: calls 1676
*** TURN *** [8c 7d 7h] [Qc]
gabagool5: checks=20
Boney526: checks=20
*** RIVER *** [8c 7d 7h Qc] [6h]
gabagool5: bets 4749
Boney526: folds=20
Uncalled bet (4749) returned to gabagool5
gabagool5 collected 9132 from pot
gabagool5: doesn't show hand=20
*** SUMMARY ***
Total pot 9132 | Rake 0=20
Board [8c 7d 7h Qc 6h]
Seat 1: REALDEVIL (button) folded before Flop (didn't bet)
Seat 3: akbongu1977 (small blind) folded before Flop
Seat 4: gabagool5 (big blind) collected (9132)
Seat 5: JSkelts folded before Flop (didn't bet)
Seat 6: gatorchapnj folded before Flop (didn't bet)
Seat 7: Boney526 folded on the River
Seat 8: JJin91 folded before Flop (didn't bet)
Seat 9: snapcallzzz folded before Flop (didn't bet)


*********** # 89 **************
PokerStars Hand #171444084057: Tournament #1648956582, $18.20+$1.80 USD=
 Hold'em No Limit - Level XV (500/1000) - 2017/06/19 21:36:35 ET
Table '1648956582 10' 9-max Seat #3 is the button
Seat 1: REALDEVIL (49057 in chips)=20
Seat 3: akbongu1977 (15249 in chips)=20
Seat 4: gabagool5 (56266 in chips)=20
Seat 5: JSkelts (15645 in chips)=20
Seat 6: gatorchapnj (16260 in chips)=20
Seat 7: Boney526 (26627 in chips)=20
Seat 8: JJin91 (32198 in chips)=20
Seat 9: snapcallzzz (14735 in chips)=20
REALDEVIL: posts the ante 125
akbongu1977: posts the ante 125
gabagool5: posts the ante 125
JSkelts: posts the ante 125
gatorchapnj: posts the ante 125
Boney526: posts the ante 125
JJin91: posts the ante 125
snapcallzzz: posts the ante 125
gabagool5: posts small blind 500
JSkelts: posts big blind 1000
*** HOLE CARDS ***
Dealt to JJin91 [7h Ts]
gatorchapnj: folds=20
Boney526: folds=20
JJin91: folds=20
snapcallzzz: folds=20
REALDEVIL: calls 1000
akbongu1977: raises 14124 to 15124 and is all-in
gabagool5: folds=20
JSkelts: raises 396 to 15520 and is all-in
REALDEVIL: folds=20
Uncalled bet (396) returned to JSkelts
*** FLOP *** [Qd 8h 7d]
*** TURN *** [Qd 8h 7d] [5c]
*** RIVER *** [Qd 8h 7d 5c] [6c]
*** SHOW DOWN ***
JSkelts: shows [9h 9s] (a straight, Five to Nine)
akbongu1977: shows [Ac Ks] (high card Ace)
JSkelts collected 32748 from pot
akbongu1977 finished the tournament in 48th place
*** SUMMARY ***
Total pot 32748 | Rake 0=20
Board [Qd 8h 7d 5c 6c]
Seat 1: REALDEVIL folded before Flop
Seat 3: akbongu1977 (button) showed [Ac Ks] and lost with high card Ace
Seat 4: gabagool5 (small blind) folded before Flop
Seat 5: JSkelts (big blind) showed [9h 9s] and won (32748) with a strai=
ght, Five to Nine
Seat 6: gatorchapnj folded before Flop (didn't bet)
Seat 7: Boney526 folded before Flop (didn't bet)
Seat 8: JJin91 folded before Flop (didn't bet)
Seat 9: snapcallzzz folded before Flop (didn't bet)


*********** # 90 **************
PokerStars Hand #171444084219: Tournament #1648956582, $18.20+$1.80 USD=
 Hold'em No Limit - Level XV (500/1000) - 2017/06/19 21:37:05 ET
Table '1648956582 10' 9-max Seat #4 is the button
Seat 1: REALDEVIL (47932 in chips)=20
Seat 4: gabagool5 (55641 in chips)=20
Seat 5: JSkelts (33144 in chips)=20
Seat 6: gatorchapnj (16135 in chips)=20
Seat 7: Boney526 (26502 in chips)=20
Seat 8: JJin91 (32073 in chips)=20
Seat 9: snapcallzzz (14610 in chips)=20
REALDEVIL: posts the ante 125
gabagool5: posts the ante 125
JSkelts: posts the ante 125
gatorchapnj: posts the ante 125
Boney526: posts the ante 125
JJin91: posts the ante 125
snapcallzzz: posts the ante 125
JSkelts: posts small blind 500
gatorchapnj: posts big blind 1000
*** HOLE CARDS ***
Dealt to JJin91 [7d 3c]
Boney526: folds=20
JJin91: folds=20
snapcallzzz: raises 13485 to 14485 and is all-in
REALDEVIL: calls 14485
gabagool5: folds=20
JSkelts: folds=20
gatorchapnj: folds=20
*** FLOP *** [Th 6s 9s]
*** TURN *** [Th 6s 9s] [6c]
*** RIVER *** [Th 6s 9s 6c] [4h]
*** SHOW DOWN ***
snapcallzzz: shows [Qd Jd] (a pair of Sixes)
REALDEVIL: shows [9d 9c] (a full house, Nines full of Sixes)
REALDEVIL collected 31345 from pot
snapcallzzz finished the tournament in 47th place
*** SUMMARY ***
Total pot 31345 | Rake 0=20
Board [Th 6s 9s 6c 4h]
Seat 1: REALDEVIL showed [9d 9c] and won (31345) with a full house, Nin=
es full of Sixes
Seat 4: gabagool5 (button) folded before Flop (didn't bet)
Seat 5: JSkelts (small blind) folded before Flop
Seat 6: gatorchapnj (big blind) folded before Flop
Seat 7: Boney526 folded before Flop (didn't bet)
Seat 8: JJin91 folded before Flop (didn't bet)
Seat 9: snapcallzzz showed [Qd Jd] and lost with a pair of Sixes


*********** # 91 **************
PokerStars Hand #171444084389: Tournament #1648956582, $18.20+$1.80 USD=
 Hold'em No Limit - Level XV (500/1000) - 2017/06/19 21:37:35 ET
Table '1648956582 10' 9-max Seat #5 is the button
Seat 1: REALDEVIL (64667 in chips)=20
Seat 4: gabagool5 (55516 in chips)=20
Seat 5: JSkelts (32519 in chips)=20
Seat 6: gatorchapnj (15010 in chips)=20
Seat 7: Boney526 (26377 in chips)=20
Seat 8: JJin91 (31948 in chips)=20
REALDEVIL: posts the ante 125
gabagool5: posts the ante 125
JSkelts: posts the ante 125
gatorchapnj: posts the ante 125
Boney526: posts the ante 125
JJin91: posts the ante 125
gatorchapnj: posts small blind 500
Boney526: posts big blind 1000
*** HOLE CARDS ***
Dealt to JJin91 [Kc 5c]
JJin91: folds=20
REALDEVIL: folds=20
gabagool5: folds=20
JSkelts: folds=20
gatorchapnj: calls 500
Boney526: raises 25252 to 26252 and is all-in
gatorchapnj: folds=20
Uncalled bet (25252) returned to Boney526
Boney526 collected 2750 from pot
Boney526: doesn't show hand=20
*** SUMMARY ***
Total pot 2750 | Rake 0=20
Seat 1: REALDEVIL folded before Flop (didn't bet)
Seat 4: gabagool5 folded before Flop (didn't bet)
Seat 5: JSkelts (button) folded before Flop (didn't bet)
Seat 6: gatorchapnj (small blind) folded before Flop
Seat 7: Boney526 (big blind) collected (2750)
Seat 8: JJin91 folded before Flop (didn't bet)


*********** # 92 **************
PokerStars Hand #171444084543: Tournament #1648956582, $18.20+$1.80 USD=
 Hold'em No Limit - Level XV (500/1000) - 2017/06/19 21:38:02 ET
Table '1648956582 10' 9-max Seat #6 is the button
Seat 1: REALDEVIL (64542 in chips)=20
Seat 2: PLOmaheezy (71360 in chips)=20
Seat 4: gabagool5 (55391 in chips)=20
Seat 5: JSkelts (32394 in chips)=20
Seat 6: gatorchapnj (13885 in chips)=20
Seat 7: Boney526 (28002 in chips)=20
Seat 8: JJin91 (31823 in chips)=20
REALDEVIL: posts the ante 125
PLOmaheezy: posts the ante 125
gabagool5: posts the ante 125
JSkelts: posts the ante 125
gatorchapnj: posts the ante 125
Boney526: posts the ante 125
JJin91: posts the ante 125
Boney526: posts small blind 500
JJin91: posts big blind 1000
*** HOLE CARDS ***
Dealt to JJin91 [Ad 2d]
REALDEVIL: raises 1000 to 2000
PLOmaheezy: folds=20
gabagool5: folds=20
JSkelts: folds=20
gatorchapnj: folds=20
Boney526: folds=20
JJin91: calls 1000
*** FLOP *** [6s Js 2c]
JJin91: bets 1989
REALDEVIL: calls 1989
*** TURN *** [6s Js 2c] [Jd]
JJin91: bets 3461
REALDEVIL: calls 3461
*** RIVER *** [6s Js 2c Jd] [8c]
JJin91: checks=20
REALDEVIL: bets 1000
JJin91: calls 1000
*** SHOW DOWN ***
REALDEVIL: shows [Qs Qc] (two pair, Queens and Jacks)
JJin91: mucks hand=20
REALDEVIL collected 18275 from pot
*** SUMMARY ***
Total pot 18275 | Rake 0=20
Board [6s Js 2c Jd 8c]
Seat 1: REALDEVIL showed [Qs Qc] and won (18275) with two pair, Queens =
and Jacks
Seat 2: PLOmaheezy folded before Flop (didn't bet)
Seat 4: gabagool5 folded before Flop (didn't bet)
Seat 5: JSkelts folded before Flop (didn't bet)
Seat 6: gatorchapnj (button) folded before Flop (didn't bet)
Seat 7: Boney526 (small blind) folded before Flop
Seat 8: JJin91 (big blind) mucked [Ad 2d]


*********** # 93 **************
PokerStars Hand #171444084956: Tournament #1648956582, $18.20+$1.80 USD=
 Hold'em No Limit - Level XV (500/1000) - 2017/06/19 21:39:14 ET
Table '1648956582 10' 9-max Seat #7 is the button
Seat 1: REALDEVIL (74242 in chips)=20
Seat 2: PLOmaheezy (71235 in chips)=20
Seat 4: gabagool5 (55266 in chips)=20
Seat 5: JSkelts (32269 in chips)=20
Seat 6: gatorchapnj (13760 in chips)=20
Seat 7: Boney526 (27377 in chips)=20
Seat 8: JJin91 (23248 in chips)=20
REALDEVIL: posts the ante 125
PLOmaheezy: posts the ante 125
gabagool5: posts the ante 125
JSkelts: posts the ante 125
gatorchapnj: posts the ante 125
Boney526: posts the ante 125
JJin91: posts the ante 125
JJin91: posts small blind 500
REALDEVIL: posts big blind 1000
*** HOLE CARDS ***
Dealt to JJin91 [Kc 8s]
PLOmaheezy: raises 1000 to 2000
gabagool5: folds=20
JSkelts: folds=20
gatorchapnj: calls 2000
Boney526: raises 25252 to 27252 and is all-in
JJin91: folds=20
REALDEVIL: folds=20
PLOmaheezy: folds=20
gatorchapnj: calls 11635 and is all-in
Uncalled bet (13617) returned to Boney526
*** FLOP *** [3h 7s 8c]
*** TURN *** [3h 7s 8c] [9c]
*** RIVER *** [3h 7s 8c 9c] [4c]
*** SHOW DOWN ***
gatorchapnj: shows [Qh Jd] (high card Queen)
Boney526: shows [Qc Ad] (high card Ace)
Boney526 collected 31645 from pot
gatorchapnj finished the tournament in 44th place
*** SUMMARY ***
Total pot 31645 | Rake 0=20
Board [3h 7s 8c 9c 4c]
Seat 1: REALDEVIL (big blind) folded before Flop
Seat 2: PLOmaheezy folded before Flop
Seat 4: gabagool5 folded before Flop (didn't bet)
Seat 5: JSkelts folded before Flop (didn't bet)
Seat 6: gatorchapnj showed [Qh Jd] and lost with high card Queen
Seat 7: Boney526 (button) showed [Qc Ad] and won (31645) with high card=
 Ace
Seat 8: JJin91 (small blind) folded before Flop


*********** # 94 **************
PokerStars Hand #171444085212: Tournament #1648956582, $18.20+$1.80 USD=
 Hold'em No Limit - Level XV (500/1000) - 2017/06/19 21:39:58 ET
Table '1648956582 10' 9-max Seat #8 is the button
Seat 1: REALDEVIL (73117 in chips)=20
Seat 2: PLOmaheezy (69110 in chips)=20
Seat 3: skonnybobo (56338 in chips)=20
Seat 4: gabagool5 (55141 in chips)=20
Seat 5: JSkelts (32144 in chips)=20
Seat 7: Boney526 (45262 in chips)=20
Seat 8: JJin91 (22623 in chips)=20
Seat 9: gatorgrinds (68078 in chips) out of hand (moved from another ta=
ble into small blind)
REALDEVIL: posts the ante 125
PLOmaheezy: posts the ante 125
skonnybobo: posts the ante 125
gabagool5: posts the ante 125
JSkelts: posts the ante 125
Boney526: posts the ante 125
JJin91: posts the ante 125
REALDEVIL: posts small blind 500
PLOmaheezy: posts big blind 1000
*** HOLE CARDS ***
Dealt to JJin91 [Ts 9d]
skonnybobo: folds=20
gabagool5: raises 1200 to 2200
JSkelts: folds=20
Boney526: folds=20
JJin91: folds=20
REALDEVIL: folds=20
PLOmaheezy: folds [3d]
Uncalled bet (1200) returned to gabagool5
gabagool5 collected 3375 from pot
gabagool5: doesn't show hand=20
*** SUMMARY ***
Total pot 3375 | Rake 0=20
Seat 1: REALDEVIL (small blind) folded before Flop
Seat 2: PLOmaheezy (big blind) folded before Flop
Seat 3: skonnybobo folded before Flop (didn't bet)
Seat 4: gabagool5 collected (3375)
Seat 5: JSkelts folded before Flop (didn't bet)
Seat 7: Boney526 folded before Flop (didn't bet)
Seat 8: JJin91 (button) folded before Flop (didn't bet)


*********** # 95 **************
PokerStars Hand #171444085373: Tournament #1648956582, $18.20+$1.80 USD=
 Hold'em No Limit - Level XV (500/1000) - 2017/06/19 21:40:22 ET
Table '1648956582 10' 9-max Seat #1 is the button
Seat 1: REALDEVIL (72492 in chips)=20
Seat 2: PLOmaheezy (67985 in chips)=20
Seat 3: skonnybobo (56213 in chips)=20
Seat 4: gabagool5 (57391 in chips)=20
Seat 5: JSkelts (32019 in chips)=20
Seat 7: Boney526 (45137 in chips)=20
Seat 8: JJin91 (22498 in chips)=20
Seat 9: gatorgrinds (68078 in chips)=20
REALDEVIL: posts the ante 125
PLOmaheezy: posts the ante 125
skonnybobo: posts the ante 125
gabagool5: posts the ante 125
JSkelts: posts the ante 125
Boney526: posts the ante 125
JJin91: posts the ante 125
gatorgrinds: posts the ante 125
PLOmaheezy: posts small blind 500
skonnybobo: posts big blind 1000
*** HOLE CARDS ***
Dealt to JJin91 [Jd 7d]
gabagool5: folds=20
JSkelts: folds=20
Boney526: folds=20
JJin91: folds=20
gatorgrinds: folds=20
REALDEVIL: folds=20
PLOmaheezy: folds=20
Uncalled bet (500) returned to skonnybobo
skonnybobo collected 2000 from pot
skonnybobo: doesn't show hand=20
*** SUMMARY ***
Total pot 2000 | Rake 0=20
Seat 1: REALDEVIL (button) folded before Flop (didn't bet)
Seat 2: PLOmaheezy (small blind) folded before Flop
Seat 3: skonnybobo (big blind) collected (2000)
Seat 4: gabagool5 folded before Flop (didn't bet)
Seat 5: JSkelts folded before Flop (didn't bet)
Seat 7: Boney526 folded before Flop (didn't bet)
Seat 8: JJin91 folded before Flop (didn't bet)
Seat 9: gatorgrinds folded before Flop (didn't bet)


*********** # 96 **************
PokerStars Hand #171444085494: Tournament #1648956582, $18.20+$1.80 USD=
 Hold'em No Limit - Level XV (500/1000) - 2017/06/19 21:40:45 ET
Table '1648956582 10' 9-max Seat #2 is the button
Seat 1: REALDEVIL (72367 in chips)=20
Seat 2: PLOmaheezy (67360 in chips)=20
Seat 3: skonnybobo (57588 in chips)=20
Seat 4: gabagool5 (57266 in chips)=20
Seat 5: JSkelts (31894 in chips)=20
Seat 7: Boney526 (45012 in chips)=20
Seat 8: JJin91 (22373 in chips)=20
Seat 9: gatorgrinds (67953 in chips)=20
REALDEVIL: posts the ante 125
PLOmaheezy: posts the ante 125
skonnybobo: posts the ante 125
gabagool5: posts the ante 125
JSkelts: posts the ante 125
Boney526: posts the ante 125
JJin91: posts the ante 125
gatorgrinds: posts the ante 125
skonnybobo: posts small blind 500
gabagool5: posts big blind 1000
*** HOLE CARDS ***
Dealt to JJin91 [7s Qs]
JSkelts: folds=20
Boney526: folds=20
JJin91: folds=20
gatorgrinds: folds=20
REALDEVIL: raises 1000 to 2000
PLOmaheezy: folds=20
skonnybobo: raises 4000 to 6000
gabagool5: folds=20
REALDEVIL: calls 4000
*** FLOP *** [4d 4h 6h]
skonnybobo: bets 8000
REALDEVIL: folds=20
Uncalled bet (8000) returned to skonnybobo
skonnybobo collected 14000 from pot
skonnybobo: doesn't show hand=20
*** SUMMARY ***
Total pot 14000 | Rake 0=20
Board [4d 4h 6h]
Seat 1: REALDEVIL folded on the Flop
Seat 2: PLOmaheezy (button) folded before Flop (didn't bet)
Seat 3: skonnybobo (small blind) collected (14000)
Seat 4: gabagool5 (big blind) folded before Flop
Seat 5: JSkelts folded before Flop (didn't bet)
Seat 7: Boney526 folded before Flop (didn't bet)
Seat 8: JJin91 folded before Flop (didn't bet)
Seat 9: gatorgrinds folded before Flop (didn't bet)


*********** # 97 **************
PokerStars Hand #171444085798: Tournament #1648956582, $18.20+$1.80 USD=
 Hold'em No Limit - Level XV (500/1000) - 2017/06/19 21:41:35 ET
Table '1648956582 10' 9-max Seat #3 is the button
Seat 1: REALDEVIL (66242 in chips)=20
Seat 2: PLOmaheezy (67235 in chips)=20
Seat 3: skonnybobo (65463 in chips)=20
Seat 4: gabagool5 (56141 in chips)=20
Seat 5: JSkelts (31769 in chips)=20
Seat 7: Boney526 (44887 in chips)=20
Seat 8: JJin91 (22248 in chips)=20
Seat 9: gatorgrinds (67828 in chips)=20
REALDEVIL: posts the ante 125
PLOmaheezy: posts the ante 125
skonnybobo: posts the ante 125
gabagool5: posts the ante 125
JSkelts: posts the ante 125
Boney526: posts the ante 125
JJin91: posts the ante 125
gatorgrinds: posts the ante 125
gabagool5: posts small blind 500
JSkelts: posts big blind 1000
*** HOLE CARDS ***
Dealt to JJin91 [6c 3c]
Boney526: folds=20
JJin91: folds=20
gatorgrinds: raises 1700 to 2700
REALDEVIL: folds=20
PLOmaheezy: folds=20
skonnybobo: folds=20
gabagool5: folds=20
JSkelts: folds=20
Uncalled bet (1700) returned to gatorgrinds
gatorgrinds collected 3500 from pot
gatorgrinds: doesn't show hand=20
*** SUMMARY ***
Total pot 3500 | Rake 0=20
Seat 1: REALDEVIL folded before Flop (didn't bet)
Seat 2: PLOmaheezy folded before Flop (didn't bet)
Seat 3: skonnybobo (button) folded before Flop (didn't bet)
Seat 4: gabagool5 (small blind) folded before Flop
Seat 5: JSkelts (big blind) folded before Flop
Seat 7: Boney526 folded before Flop (didn't bet)
Seat 8: JJin91 folded before Flop (didn't bet)
Seat 9: gatorgrinds collected (3500)


*********** # 98 **************
PokerStars Hand #171444085949: Tournament #1648956582, $18.20+$1.80 USD=
 Hold'em No Limit - Level XV (500/1000) - 2017/06/19 21:42:01 ET
Table '1648956582 10' 9-max Seat #4 is the button
Seat 1: REALDEVIL (66117 in chips)=20
Seat 2: PLOmaheezy (67110 in chips)=20
Seat 3: skonnybobo (65338 in chips)=20
Seat 4: gabagool5 (55516 in chips)=20
Seat 5: JSkelts (30644 in chips)=20
Seat 7: Boney526 (44762 in chips)=20
Seat 8: JJin91 (22123 in chips)=20
Seat 9: gatorgrinds (70203 in chips)=20
REALDEVIL: posts the ante 125
PLOmaheezy: posts the ante 125
skonnybobo: posts the ante 125
gabagool5: posts the ante 125
JSkelts: posts the ante 125
Boney526: posts the ante 125
JJin91: posts the ante 125
gatorgrinds: posts the ante 125
JSkelts: posts small blind 500
Boney526: posts big blind 1000
*** HOLE CARDS ***
Dealt to JJin91 [Qd Tc]
JJin91: folds=20
gatorgrinds: folds=20
REALDEVIL: folds=20
PLOmaheezy: folds=20
skonnybobo: folds=20
gabagool5: folds=20
JSkelts: raises 1500 to 2500
Boney526: calls 1500
*** FLOP *** [2c 8d 7s]
JSkelts: bets 2200
Boney526: calls 2200
*** TURN *** [2c 8d 7s] [Td]
JSkelts: checks=20
Boney526: bets 3619
JSkelts: calls 3619
*** RIVER *** [2c 8d 7s Td] [9d]
JSkelts: checks=20
Boney526: checks=20
*** SHOW DOWN ***
JSkelts: shows [7d 9s] (two pair, Nines and Sevens)
Boney526: shows [6h 5h] (a straight, Six to Ten)
Boney526 collected 17638 from pot
*** SUMMARY ***
Total pot 17638 | Rake 0=20
Board [2c 8d 7s Td 9d]
Seat 1: REALDEVIL folded before Flop (didn't bet)
Seat 2: PLOmaheezy folded before Flop (didn't bet)
Seat 3: skonnybobo folded before Flop (didn't bet)
Seat 4: gabagool5 (button) folded before Flop (didn't bet)
Seat 5: JSkelts (small blind) showed [7d 9s] and lost with two pair, Ni=
nes and Sevens
Seat 7: Boney526 (big blind) showed [6h 5h] and won (17638) with a stra=
ight, Six to Ten
Seat 8: JJin91 folded before Flop (didn't bet)
Seat 9: gatorgrinds folded before Flop (didn't bet)


*********** # 99 **************
PokerStars Hand #171444086266: Tournament #1648956582, $18.20+$1.80 USD=
 Hold'em No Limit - Level XVI (600/1200) - 2017/06/19 21:42:55 ET
Table '1648956582 10' 9-max Seat #5 is the button
Seat 1: REALDEVIL (65992 in chips)=20
Seat 2: PLOmaheezy (66985 in chips)=20
Seat 3: skonnybobo (65213 in chips)=20
Seat 4: gabagool5 (55391 in chips)=20
Seat 5: JSkelts (22200 in chips)=20
Seat 7: Boney526 (53956 in chips)=20
Seat 8: JJin91 (21998 in chips)=20
Seat 9: gatorgrinds (70078 in chips)=20
REALDEVIL: posts the ante 150
PLOmaheezy: posts the ante 150
skonnybobo: posts the ante 150
gabagool5: posts the ante 150
JSkelts: posts the ante 150
Boney526: posts the ante 150
JJin91: posts the ante 150
gatorgrinds: posts the ante 150
Boney526: posts small blind 600
JJin91: posts big blind 1200
*** HOLE CARDS ***
Dealt to JJin91 [9s 4c]
gatorgrinds: folds=20
REALDEVIL: calls 1200
PLOmaheezy: folds=20
skonnybobo: folds=20
gabagool5: raises 2675 to 3875
JSkelts: folds=20
Boney526: folds=20
JJin91: folds=20
REALDEVIL: calls 2675
*** FLOP *** [6c Qs Ad]
REALDEVIL: checks=20
gabagool5: bets 3999
REALDEVIL: folds=20
Uncalled bet (3999) returned to gabagool5
gabagool5 collected 10750 from pot
gabagool5: doesn't show hand=20
*** SUMMARY ***
Total pot 10750 | Rake 0=20
Board [6c Qs Ad]
Seat 1: REALDEVIL folded on the Flop
Seat 2: PLOmaheezy folded before Flop (didn't bet)
Seat 3: skonnybobo folded before Flop (didn't bet)
Seat 4: gabagool5 collected (10750)
Seat 5: JSkelts (button) folded before Flop (didn't bet)
Seat 7: Boney526 (small blind) folded before Flop
Seat 8: JJin91 (big blind) folded before Flop
Seat 9: gatorgrinds folded before Flop (didn't bet)


*********** # 100 **************
PokerStars Hand #171444086543: Tournament #1648956582, $18.20+$1.80 USD=
 Hold'em No Limit - Level XVI (600/1200) - 2017/06/19 21:43:41 ET
Table '1648956582 10' 9-max Seat #7 is the button
Seat 1: REALDEVIL (61967 in chips)=20
Seat 2: PLOmaheezy (66835 in chips)=20
Seat 3: skonnybobo (65063 in chips)=20
Seat 4: gabagool5 (62116 in chips)=20
Seat 5: JSkelts (22050 in chips)=20
Seat 7: Boney526 (53206 in chips)=20
Seat 8: JJin91 (20648 in chips)=20
Seat 9: gatorgrinds (69928 in chips)=20
REALDEVIL: posts the ante 150
PLOmaheezy: posts the ante 150
skonnybobo: posts the ante 150
gabagool5: posts the ante 150
JSkelts: posts the ante 150
Boney526: posts the ante 150
JJin91: posts the ante 150
gatorgrinds: posts the ante 150
JJin91: posts small blind 600
gatorgrinds: posts big blind 1200
*** HOLE CARDS ***
Dealt to JJin91 [5s Qc]
REALDEVIL: folds=20
PLOmaheezy: folds=20
skonnybobo: folds=20
gabagool5: folds=20
JSkelts: folds=20
Boney526: folds=20
JJin91: folds=20
Uncalled bet (600) returned to gatorgrinds
gatorgrinds collected 2400 from pot
gatorgrinds: doesn't show hand=20
*** SUMMARY ***
Total pot 2400 | Rake 0=20
Seat 1: REALDEVIL folded before Flop (didn't bet)
Seat 2: PLOmaheezy folded before Flop (didn't bet)
Seat 3: skonnybobo folded before Flop (didn't bet)
Seat 4: gabagool5 folded before Flop (didn't bet)
Seat 5: JSkelts folded before Flop (didn't bet)
Seat 7: Boney526 (button) folded before Flop (didn't bet)
Seat 8: JJin91 (small blind) folded before Flop
Seat 9: gatorgrinds (big blind) collected (2400)


*********** # 101 **************
PokerStars Hand #171444086638: Tournament #1648956582, $18.20+$1.80 USD=
 Hold'em No Limit - Level XVI (600/1200) - 2017/06/19 21:43:58 ET
Table '1648956582 10' 9-max Seat #8 is the button
Seat 1: REALDEVIL (61817 in chips)=20
Seat 2: PLOmaheezy (66685 in chips)=20
Seat 3: skonnybobo (64913 in chips)=20
Seat 4: gabagool5 (61966 in chips)=20
Seat 5: JSkelts (21900 in chips)=20
Seat 7: Boney526 (53056 in chips)=20
Seat 8: JJin91 (19898 in chips)=20
Seat 9: gatorgrinds (71578 in chips)=20
REALDEVIL: posts the ante 150
PLOmaheezy: posts the ante 150
skonnybobo: posts the ante 150
gabagool5: posts the ante 150
JSkelts: posts the ante 150
Boney526: posts the ante 150
JJin91: posts the ante 150
gatorgrinds: posts the ante 150
gatorgrinds: posts small blind 600
REALDEVIL: posts big blind 1200
*** HOLE CARDS ***
Dealt to JJin91 [5h 2s]
PLOmaheezy: folds=20
skonnybobo: folds=20
gabagool5: folds=20
JSkelts: folds=20
Boney526: folds=20
JJin91: folds=20
gatorgrinds: calls 600
REALDEVIL: checks=20
*** FLOP *** [4h 5c 8s]
gatorgrinds: bets 1800
REALDEVIL: calls 1800
*** TURN *** [4h 5c 8s] [6c]
gatorgrinds: checks=20
REALDEVIL: checks=20
*** RIVER *** [4h 5c 8s 6c] [6h]
gatorgrinds: checks=20
REALDEVIL: bets 7200
gatorgrinds: folds=20
Uncalled bet (7200) returned to REALDEVIL
REALDEVIL collected 7200 from pot
*** SUMMARY ***
Total pot 7200 | Rake 0=20
Board [4h 5c 8s 6c 6h]
Seat 1: REALDEVIL (big blind) collected (7200)
Seat 2: PLOmaheezy folded before Flop (didn't bet)
Seat 3: skonnybobo folded before Flop (didn't bet)
Seat 4: gabagool5 folded before Flop (didn't bet)
Seat 5: JSkelts folded before Flop (didn't bet)
Seat 7: Boney526 folded before Flop (didn't bet)
Seat 8: JJin91 (button) folded before Flop (didn't bet)
Seat 9: gatorgrinds (small blind) folded on the River


*********** # 102 **************
PokerStars Hand #171444087011: Tournament #1648956582, $18.20+$1.80 USD=
 Hold'em No Limit - Level XVI (600/1200) - 2017/06/19 21:45:04 ET
Table '1648956582 10' 9-max Seat #9 is the button
Seat 1: REALDEVIL (65867 in chips)=20
Seat 2: PLOmaheezy (66535 in chips)=20
Seat 3: skonnybobo (64763 in chips)=20
Seat 4: gabagool5 (61816 in chips)=20
Seat 5: JSkelts (21750 in chips)=20
Seat 7: Boney526 (52906 in chips)=20
Seat 8: JJin91 (19748 in chips)=20
Seat 9: gatorgrinds (68428 in chips)=20
REALDEVIL: posts the ante 150
PLOmaheezy: posts the ante 150
skonnybobo: posts the ante 150
gabagool5: posts the ante 150
JSkelts: posts the ante 150
Boney526: posts the ante 150
JJin91: posts the ante 150
gatorgrinds: posts the ante 150
REALDEVIL: posts small blind 600
PLOmaheezy: posts big blind 1200
*** HOLE CARDS ***
Dealt to JJin91 [2s 4h]
skonnybobo: folds=20
gabagool5: raises 1440 to 2640
JSkelts: folds=20
Boney526: folds=20
JJin91: folds=20
gatorgrinds: calls 2640
REALDEVIL: raises 8160 to 10800
PLOmaheezy: folds=20
gabagool5: folds=20
gatorgrinds: folds=20
Uncalled bet (8160) returned to REALDEVIL
REALDEVIL collected 10320 from pot
*** SUMMARY ***
Total pot 10320 | Rake 0=20
Seat 1: REALDEVIL (small blind) collected (10320)
Seat 2: PLOmaheezy (big blind) folded before Flop
Seat 3: skonnybobo folded before Flop (didn't bet)
Seat 4: gabagool5 folded before Flop
Seat 5: JSkelts folded before Flop (didn't bet)
Seat 7: Boney526 folded before Flop (didn't bet)
Seat 8: JJin91 folded before Flop (didn't bet)
Seat 9: gatorgrinds (button) folded before Flop


*********** # 103 **************
PokerStars Hand #171444087383: Tournament #1648956582, $18.20+$1.80 USD=
 Hold'em No Limit - Level XVI (600/1200) - 2017/06/19 21:46:11 ET
Table '1648956582 10' 9-max Seat #1 is the button
Seat 1: REALDEVIL (73397 in chips)=20
Seat 2: PLOmaheezy (65185 in chips)=20
Seat 3: skonnybobo (64613 in chips)=20
Seat 4: gabagool5 (59026 in chips)=20
Seat 5: JSkelts (21600 in chips)=20
Seat 7: Boney526 (52756 in chips)=20
Seat 8: JJin91 (19598 in chips)=20
Seat 9: gatorgrinds (65638 in chips)=20
REALDEVIL: posts the ante 150
PLOmaheezy: posts the ante 150
skonnybobo: posts the ante 150
gabagool5: posts the ante 150
JSkelts: posts the ante 150
Boney526: posts the ante 150
JJin91: posts the ante 150
gatorgrinds: posts the ante 150
PLOmaheezy: posts small blind 600
skonnybobo: posts big blind 1200
*** HOLE CARDS ***
Dealt to JJin91 [Kc 3c]
gabagool5: folds=20
JSkelts: folds=20
Boney526: folds=20
JJin91: raises 18248 to 19448 and is all-in
gatorgrinds: folds=20
REALDEVIL: folds=20
PLOmaheezy: folds=20
skonnybobo: folds=20
Uncalled bet (18248) returned to JJin91
JJin91 collected 4200 from pot
JJin91: doesn't show hand=20
*** SUMMARY ***
Total pot 4200 | Rake 0=20
Seat 1: REALDEVIL (button) folded before Flop (didn't bet)
Seat 2: PLOmaheezy (small blind) folded before Flop
Seat 3: skonnybobo (big blind) folded before Flop
Seat 4: gabagool5 folded before Flop (didn't bet)
Seat 5: JSkelts folded before Flop (didn't bet)
Seat 7: Boney526 folded before Flop (didn't bet)
Seat 8: JJin91 collected (4200)
Seat 9: gatorgrinds folded before Flop (didn't bet)


*********** # 104 **************
PokerStars Hand #171444087590: Tournament #1648956582, $18.20+$1.80 USD=
 Hold'em No Limit - Level XVI (600/1200) - 2017/06/19 21:46:48 ET
Table '1648956582 10' 9-max Seat #2 is the button
Seat 1: REALDEVIL (73247 in chips)=20
Seat 2: PLOmaheezy (64435 in chips)=20
Seat 3: skonnybobo (63263 in chips)=20
Seat 4: gabagool5 (58876 in chips)=20
Seat 5: JSkelts (21450 in chips)=20
Seat 7: Boney526 (52606 in chips)=20
Seat 8: JJin91 (22448 in chips)=20
Seat 9: gatorgrinds (65488 in chips)=20
REALDEVIL: posts the ante 150
PLOmaheezy: posts the ante 150
skonnybobo: posts the ante 150
gabagool5: posts the ante 150
JSkelts: posts the ante 150
Boney526: posts the ante 150
JJin91: posts the ante 150
gatorgrinds: posts the ante 150
skonnybobo: posts small blind 600
gabagool5: posts big blind 1200
*** HOLE CARDS ***
Dealt to JJin91 [7c 5s]
JSkelts: folds=20
Boney526: raises 1368 to 2568
JJin91: folds=20
gatorgrinds: folds=20
REALDEVIL: calls 2568
PLOmaheezy: folds=20
skonnybobo: folds=20
gabagool5: raises 8232 to 10800
Boney526: folds=20
REALDEVIL: folds=20
Uncalled bet (8232) returned to gabagool5
gabagool5 collected 9504 from pot
gabagool5: doesn't show hand=20
*** SUMMARY ***
Total pot 9504 | Rake 0=20
Seat 1: REALDEVIL folded before Flop
Seat 2: PLOmaheezy (button) folded before Flop (didn't bet)
Seat 3: skonnybobo (small blind) folded before Flop
Seat 4: gabagool5 (big blind) collected (9504)
Seat 5: JSkelts folded before Flop (didn't bet)
Seat 7: Boney526 folded before Flop
Seat 8: JJin91 folded before Flop (didn't bet)
Seat 9: gatorgrinds folded before Flop (didn't bet)


*********** # 105 **************
PokerStars Hand #171444087839: Tournament #1648956582, $18.20+$1.80 USD=
 Hold'em No Limit - Level XVI (600/1200) - 2017/06/19 21:47:32 ET
Table '1648956582 10' 9-max Seat #3 is the button
Seat 1: REALDEVIL (70529 in chips)=20
Seat 2: PLOmaheezy (64285 in chips)=20
Seat 3: skonnybobo (62513 in chips)=20
Seat 4: gabagool5 (65662 in chips)=20
Seat 5: JSkelts (21300 in chips)=20
Seat 7: Boney526 (49888 in chips)=20
Seat 8: JJin91 (22298 in chips)=20
Seat 9: gatorgrinds (65338 in chips)=20
REALDEVIL: posts the ante 150
PLOmaheezy: posts the ante 150
skonnybobo: posts the ante 150
gabagool5: posts the ante 150
JSkelts: posts the ante 150
Boney526: posts the ante 150
JJin91: posts the ante 150
gatorgrinds: posts the ante 150
gabagool5: posts small blind 600
JSkelts: posts big blind 1200
*** HOLE CARDS ***
Dealt to JJin91 [Ts Kd]
Boney526: folds=20
JJin91: folds=20
gatorgrinds: folds=20
REALDEVIL: folds=20
PLOmaheezy: raises 1200 to 2400
skonnybobo: folds=20
gabagool5: calls 1800
JSkelts: folds=20
*** FLOP *** [8d 4s 3c]
gabagool5: checks=20
PLOmaheezy: bets 3600
gabagool5: folds=20
Uncalled bet (3600) returned to PLOmaheezy
PLOmaheezy collected 7200 from pot
PLOmaheezy: doesn't show hand=20
*** SUMMARY ***
Total pot 7200 | Rake 0=20
Board [8d 4s 3c]
Seat 1: REALDEVIL folded before Flop (didn't bet)
Seat 2: PLOmaheezy collected (7200)
Seat 3: skonnybobo (button) folded before Flop (didn't bet)
Seat 4: gabagool5 (small blind) folded on the Flop
Seat 5: JSkelts (big blind) folded before Flop
Seat 7: Boney526 folded before Flop (didn't bet)
Seat 8: JJin91 folded before Flop (didn't bet)
Seat 9: gatorgrinds folded before Flop (didn't bet)


*********** # 106 **************
PokerStars Hand #171444088085: Tournament #1648956582, $18.20+$1.80 USD=
 Hold'em No Limit - Level XVI (600/1200) - 2017/06/19 21:48:16 ET
Table '1648956582 10' 9-max Seat #4 is the button
Seat 1: REALDEVIL (70379 in chips)=20
Seat 2: PLOmaheezy (68935 in chips)=20
Seat 3: skonnybobo (62363 in chips)=20
Seat 4: gabagool5 (63112 in chips)=20
Seat 5: JSkelts (19950 in chips)=20
Seat 7: Boney526 (49738 in chips)=20
Seat 8: JJin91 (22148 in chips)=20
Seat 9: gatorgrinds (65188 in chips)=20
REALDEVIL: posts the ante 150
PLOmaheezy: posts the ante 150
skonnybobo: posts the ante 150
gabagool5: posts the ante 150
JSkelts: posts the ante 150
Boney526: posts the ante 150
JJin91: posts the ante 150
gatorgrinds: posts the ante 150
JSkelts: posts small blind 600
Boney526: posts big blind 1200
*** HOLE CARDS ***
Dealt to JJin91 [4d 4c]
JJin91: folds=20
gatorgrinds: folds=20
REALDEVIL: folds=20
PLOmaheezy: folds=20
skonnybobo: raises 1200 to 2400
gabagool5: folds=20
JSkelts: folds=20
Boney526: calls 1200
*** FLOP *** [Ac 5c 7s]
Boney526: checks=20
skonnybobo: bets 3600
Boney526: raises 4002 to 7602
skonnybobo: folds=20
Uncalled bet (4002) returned to Boney526
Boney526 collected 13800 from pot
Boney526: doesn't show hand=20
*** SUMMARY ***
Total pot 13800 | Rake 0=20
Board [Ac 5c 7s]
Seat 1: REALDEVIL folded before Flop (didn't bet)
Seat 2: PLOmaheezy folded before Flop (didn't bet)
Seat 3: skonnybobo folded on the Flop
Seat 4: gabagool5 (button) folded before Flop (didn't bet)
Seat 5: JSkelts (small blind) folded before Flop
Seat 7: Boney526 (big blind) collected (13800)
Seat 8: JJin91 folded before Flop (didn't bet)
Seat 9: gatorgrinds folded before Flop (didn't bet)


*********** # 107 **************
PokerStars Hand #171444088521: Tournament #1648956582, $18.20+$1.80 USD=
 Hold'em No Limit - Level XVI (600/1200) - 2017/06/19 21:49:32 ET
Table '1648956582 10' 9-max Seat #5 is the button
Seat 1: REALDEVIL (70229 in chips)=20
Seat 2: PLOmaheezy (68785 in chips)=20
Seat 3: skonnybobo (56213 in chips)=20
Seat 4: gabagool5 (62962 in chips)=20
Seat 5: JSkelts (19200 in chips)=20
Seat 7: Boney526 (57388 in chips)=20
Seat 8: JJin91 (21998 in chips)=20
Seat 9: gatorgrinds (65038 in chips)=20
REALDEVIL: posts the ante 150
PLOmaheezy: posts the ante 150
skonnybobo: posts the ante 150
gabagool5: posts the ante 150
JSkelts: posts the ante 150
Boney526: posts the ante 150
JJin91: posts the ante 150
gatorgrinds: posts the ante 150
Boney526: posts small blind 600
JJin91: posts big blind 1200
*** HOLE CARDS ***
Dealt to JJin91 [Jd Kd]
gatorgrinds: folds=20
REALDEVIL: folds=20
PLOmaheezy: folds=20
skonnybobo: folds=20
gabagool5: folds=20
JSkelts: raises 17850 to 19050 and is all-in
Boney526: folds=20
JJin91: calls 17850
*** FLOP *** [2c Qs Kc]
*** TURN *** [2c Qs Kc] [4d]
*** RIVER *** [2c Qs Kc 4d] [6d]
*** SHOW DOWN ***
JJin91: shows [Jd Kd] (a pair of Kings)
JSkelts: shows [7h As] (high card Ace)
JJin91 collected 39900 from pot
JSkelts finished the tournament in 38th place
*** SUMMARY ***
Total pot 39900 | Rake 0=20
Board [2c Qs Kc 4d 6d]
Seat 1: REALDEVIL folded before Flop (didn't bet)
Seat 2: PLOmaheezy folded before Flop (didn't bet)
Seat 3: skonnybobo folded before Flop (didn't bet)
Seat 4: gabagool5 folded before Flop (didn't bet)
Seat 5: JSkelts (button) showed [7h As] and lost with high card Ace
Seat 7: Boney526 (small blind) folded before Flop
Seat 8: JJin91 (big blind) showed [Jd Kd] and won (39900) with a pair o=
f Kings
Seat 9: gatorgrinds folded before Flop (didn't bet)


*********** # 108 **************
PokerStars Hand #171444088712: Tournament #1648956582, $18.20+$1.80 USD=
 Hold'em No Limit - Level XVI (600/1200) - 2017/06/19 21:50:03 ET
Table '1648956582 10' 9-max Seat #7 is the button
Seat 1: REALDEVIL (70079 in chips)=20
Seat 2: PLOmaheezy (68635 in chips)=20
Seat 3: skonnybobo (56063 in chips)=20
Seat 4: gabagool5 (62812 in chips)=20
Seat 7: Boney526 (56638 in chips)=20
Seat 8: JJin91 (42698 in chips)=20
Seat 9: gatorgrinds (64888 in chips)=20
REALDEVIL: posts the ante 150
PLOmaheezy: posts the ante 150
skonnybobo: posts the ante 150
gabagool5: posts the ante 150
Boney526: posts the ante 150
JJin91: posts the ante 150
gatorgrinds: posts the ante 150
JJin91: posts small blind 600
gatorgrinds: posts big blind 1200
*** HOLE CARDS ***
Dealt to JJin91 [Qc Ks]
REALDEVIL: folds=20
PLOmaheezy: folds=20
skonnybobo: folds=20
gabagool5: raises 1440 to 2640
Boney526: folds=20
JJin91: calls 2040
gatorgrinds: calls 1440
*** FLOP *** [Ts Qd 5h]
JJin91: checks=20
gatorgrinds: checks=20
gabagool5: bets 2345
JJin91: calls 2345
gatorgrinds: folds=20
*** TURN *** [Ts Qd 5h] [4s]
JJin91: checks=20
gabagool5: bets 6789
JJin91: calls 6789
*** RIVER *** [Ts Qd 5h 4s] [Kh]
JJin91: checks=20
gabagool5: bets 12000
JJin91: calls 12000
*** SHOW DOWN ***
gabagool5: shows [Qh Kc] (two pair, Kings and Queens)
JJin91: shows [Qc Ks] (two pair, Kings and Queens)
JJin91 collected 25619 from pot
gabagool5 collected 25619 from pot
*** SUMMARY ***
Total pot 51238 | Rake 0=20
Board [Ts Qd 5h 4s Kh]
Seat 1: REALDEVIL folded before Flop (didn't bet)
Seat 2: PLOmaheezy folded before Flop (didn't bet)
Seat 3: skonnybobo folded before Flop (didn't bet)
Seat 4: gabagool5 showed [Qh Kc] and won (25619) with two pair, Kings a=
nd Queens
Seat 7: Boney526 (button) folded before Flop (didn't bet)
Seat 8: JJin91 (small blind) showed [Qc Ks] and won (25619) with two pa=
ir, Kings and Queens
Seat 9: gatorgrinds (big blind) folded on the Flop


*********** # 109 **************
PokerStars Hand #171444089347: Tournament #1648956582, $18.20+$1.80 USD=
 Hold'em No Limit - Level XVI (600/1200) - 2017/06/19 21:51:47 ET
Table '1648956582 10' 9-max Seat #8 is the button
Seat 1: REALDEVIL (69929 in chips)=20
Seat 2: PLOmaheezy (68485 in chips)=20
Seat 3: skonnybobo (55913 in chips)=20
Seat 4: gabagool5 (64507 in chips)=20
Seat 7: Boney526 (56488 in chips)=20
Seat 8: JJin91 (44393 in chips)=20
Seat 9: gatorgrinds (62098 in chips)=20
REALDEVIL: posts the ante 150
PLOmaheezy: posts the ante 150
skonnybobo: posts the ante 150
gabagool5: posts the ante 150
Boney526: posts the ante 150
JJin91: posts the ante 150
gatorgrinds: posts the ante 150
gatorgrinds: posts small blind 600
REALDEVIL: posts big blind 1200
*** HOLE CARDS ***
Dealt to JJin91 [3h 3s]
PLOmaheezy: raises 1200 to 2400
skonnybobo: folds=20
gabagool5: calls 2400
Boney526: folds=20
JJin91: calls 2400
gatorgrinds: folds=20
REALDEVIL: folds=20
*** FLOP *** [6h Ac 3d]
PLOmaheezy: bets 5025
gabagool5: calls 5025
JJin91: calls 5025
*** TURN *** [6h Ac 3d] [8c]
PLOmaheezy: checks=20
gabagool5: bets 10800
JJin91: calls 10800
PLOmaheezy: folds=20
*** RIVER *** [6h Ac 3d 8c] [6d]
gabagool5: bets 46132 and is all-in
JJin91: calls 26018 and is all-in
Uncalled bet (20114) returned to gabagool5
*** SHOW DOWN ***
gabagool5: shows [Ks Ad] (two pair, Aces and Sixes)
JJin91: shows [3h 3s] (a full house, Threes full of Sixes)
JJin91 collected 98761 from pot
*** SUMMARY ***
Total pot 98761 | Rake 0=20
Board [6h Ac 3d 8c 6d]
Seat 1: REALDEVIL (big blind) folded before Flop
Seat 2: PLOmaheezy folded on the Turn
Seat 3: skonnybobo folded before Flop (didn't bet)
Seat 4: gabagool5 showed [Ks Ad] and lost with two pair, Aces and Sixes
Seat 7: Boney526 folded before Flop (didn't bet)
Seat 8: JJin91 (button) showed [3h 3s] and won (98761) with a full hous=
e, Threes full of Sixes
Seat 9: gatorgrinds (small blind) folded before Flop


*********** # 110 **************
PokerStars Hand #171444733068: Tournament #1648956582, $18.20+$1.80 USD=
 Hold'em No Limit - Level XVII (700/1400) - 2017/06/19 21:53:51 ET
Table '1648956582 10' 9-max Seat #9 is the button
Seat 1: REALDEVIL (68579 in chips)=20
Seat 2: PLOmaheezy (60910 in chips)=20
Seat 3: skonnybobo (55763 in chips)=20
Seat 4: gabagool5 (20114 in chips)=20
Seat 7: Boney526 (56338 in chips)=20
Seat 8: JJin91 (98761 in chips)=20
Seat 9: gatorgrinds (61348 in chips)=20
REALDEVIL: posts the ante 175
PLOmaheezy: posts the ante 175
skonnybobo: posts the ante 175
gabagool5: posts the ante 175
Boney526: posts the ante 175
JJin91: posts the ante 175
gatorgrinds: posts the ante 175
REALDEVIL: posts small blind 700
PLOmaheezy: posts big blind 1400
*** HOLE CARDS ***
Dealt to JJin91 [8s 3s]
skonnybobo: raises 1400 to 2800
gabagool5: folds=20
Boney526: folds=20
JJin91: folds=20
gatorgrinds: folds=20
REALDEVIL: folds=20
PLOmaheezy: folds=20
Uncalled bet (1400) returned to skonnybobo
skonnybobo collected 4725 from pot
skonnybobo: doesn't show hand=20
*** SUMMARY ***
Total pot 4725 | Rake 0=20
Seat 1: REALDEVIL (small blind) folded before Flop
Seat 2: PLOmaheezy (big blind) folded before Flop
Seat 3: skonnybobo collected (4725)
Seat 4: gabagool5 folded before Flop (didn't bet)
Seat 7: Boney526 folded before Flop (didn't bet)
Seat 8: JJin91 folded before Flop (didn't bet)
Seat 9: gatorgrinds (button) folded before Flop (didn't bet)


*********** # 111 **************
PokerStars Hand #171444733202: Tournament #1648956582, $18.20+$1.80 USD=
 Hold'em No Limit - Level XVII (700/1400) - 2017/06/19 21:54:14 ET
Table '1648956582 10' 9-max Seat #1 is the button
Seat 1: REALDEVIL (67704 in chips)=20
Seat 2: PLOmaheezy (59335 in chips)=20
Seat 3: skonnybobo (58913 in chips)=20
Seat 4: gabagool5 (19939 in chips)=20
Seat 7: Boney526 (56163 in chips)=20
Seat 8: JJin91 (98586 in chips)=20
Seat 9: gatorgrinds (61173 in chips)=20
REALDEVIL: posts the ante 175
PLOmaheezy: posts the ante 175
skonnybobo: posts the ante 175
gabagool5: posts the ante 175
Boney526: posts the ante 175
JJin91: posts the ante 175
gatorgrinds: posts the ante 175
PLOmaheezy: posts small blind 700
skonnybobo: posts big blind 1400
*** HOLE CARDS ***
Dealt to JJin91 [Td 3d]
gabagool5 said, "were you honestly considering folding?"
gabagool5: folds=20
Boney526: folds=20
JJin91: folds=20
JJin91 said, "i woulve only called if i had anything better than Ax"
JJin91 said, "i thought u had quad 6 or something"
gatorgrinds: raises 1587 to 2987
gabagool5 said, "lol"
REALDEVIL: raises 2513 to 5500
PLOmaheezy: folds=20
JJin91 said, "u def didnt have 88s"
skonnybobo: folds=20
gatorgrinds: calls 2513
*** FLOP *** [Jh Ks 3h]
gatorgrinds: checks=20
REALDEVIL: checks=20
*** TURN *** [Jh Ks 3h] [7c]
gatorgrinds: bets 9886
REALDEVIL: raises 16714 to 26600
gatorgrinds: folds=20
Uncalled bet (16714) returned to REALDEVIL
REALDEVIL collected 34097 from pot
*** SUMMARY ***
Total pot 34097 | Rake 0=20
Board [Jh Ks 3h 7c]
Seat 1: REALDEVIL (button) collected (34097)
Seat 2: PLOmaheezy (small blind) folded before Flop
Seat 3: skonnybobo (big blind) folded before Flop
Seat 4: gabagool5 folded before Flop (didn't bet)
Seat 7: Boney526 folded before Flop (didn't bet)
Seat 8: JJin91 folded before Flop (didn't bet)
Seat 9: gatorgrinds folded on the Turn


*********** # 112 **************
PokerStars Hand #171444735187: Tournament #1648956582, $18.20+$1.80 USD=
 Hold'em No Limit - Level XVII (700/1400) - 2017/06/19 22:01:13 ET
Table '1648956582 10' 9-max Seat #2 is the button
Seat 1: REALDEVIL (86240 in chips)=20
Seat 2: PLOmaheezy (58460 in chips)=20
Seat 3: skonnybobo (57338 in chips)=20
Seat 4: gabagool5 (19764 in chips)=20
Seat 7: Boney526 (55988 in chips)=20
Seat 8: JJin91 (98411 in chips)=20
Seat 9: gatorgrinds (45612 in chips)=20
REALDEVIL: posts the ante 175
PLOmaheezy: posts the ante 175
skonnybobo: posts the ante 175
gabagool5: posts the ante 175
Boney526: posts the ante 175
JJin91: posts the ante 175
gatorgrinds: posts the ante 175
skonnybobo: posts small blind 700
gabagool5: posts big blind 1400
*** HOLE CARDS ***
Dealt to JJin91 [4s 3d]
Boney526: folds=20
JJin91: folds=20
gatorgrinds: folds=20
REALDEVIL: folds=20
PLOmaheezy: raises 1400 to 2800
skonnybobo: folds=20
gabagool5: raises 16789 to 19589 and is all-in
PLOmaheezy: folds [Jc]
Uncalled bet (16789) returned to gabagool5
gabagool5 collected 7525 from pot
gabagool5: doesn't show hand=20
*** SUMMARY ***
Total pot 7525 | Rake 0=20
Seat 1: REALDEVIL folded before Flop (didn't bet)
Seat 2: PLOmaheezy (button) folded before Flop
Seat 3: skonnybobo (small blind) folded before Flop
Seat 4: gabagool5 (big blind) collected (7525)
Seat 7: Boney526 folded before Flop (didn't bet)
Seat 8: JJin91 folded before Flop (didn't bet)
Seat 9: gatorgrinds folded before Flop (didn't bet)


*********** # 113 **************
PokerStars Hand #171444735415: Tournament #1648956582, $18.20+$1.80 USD=
 Hold'em No Limit - Level XVII (700/1400) - 2017/06/19 22:01:55 ET
Table '1648956582 10' 9-max Seat #3 is the button
Seat 1: REALDEVIL (86065 in chips)=20
Seat 2: PLOmaheezy (55485 in chips)=20
Seat 3: skonnybobo (56463 in chips)=20
Seat 4: gabagool5 (24314 in chips)=20
Seat 7: Boney526 (55813 in chips)=20
Seat 8: JJin91 (98236 in chips)=20
Seat 9: gatorgrinds (45437 in chips)=20
REALDEVIL: posts the ante 175
PLOmaheezy: posts the ante 175
skonnybobo: posts the ante 175
gabagool5: posts the ante 175
Boney526: posts the ante 175
JJin91: posts the ante 175
gatorgrinds: posts the ante 175
gabagool5: posts small blind 700
Boney526: posts big blind 1400
*** HOLE CARDS ***
Dealt to JJin91 [9s 3c]
JJin91: folds=20
gatorgrinds: raises 1400 to 2800
REALDEVIL: folds=20
PLOmaheezy: folds=20
skonnybobo: folds=20
gabagool5: folds=20
Boney526: folds=20
Uncalled bet (1400) returned to gatorgrinds
gatorgrinds collected 4725 from pot
gatorgrinds: doesn't show hand=20
*** SUMMARY ***
Total pot 4725 | Rake 0=20
Seat 1: REALDEVIL folded before Flop (didn't bet)
Seat 2: PLOmaheezy folded before Flop (didn't bet)
Seat 3: skonnybobo (button) folded before Flop (didn't bet)
Seat 4: gabagool5 (small blind) folded before Flop
Seat 7: Boney526 (big blind) folded before Flop
Seat 8: JJin91 folded before Flop (didn't bet)
Seat 9: gatorgrinds collected (4725)


*********** # 114 **************
PokerStars Hand #171444735531: Tournament #1648956582, $18.20+$1.80 USD=
 Hold'em No Limit - Level XVII (700/1400) - 2017/06/19 22:02:17 ET
Table '1648956582 10' 9-max Seat #4 is the button
Seat 1: REALDEVIL (85890 in chips)=20
Seat 2: PLOmaheezy (55310 in chips)=20
Seat 3: skonnybobo (56288 in chips)=20
Seat 4: gabagool5 (23439 in chips)=20
Seat 7: Boney526 (54238 in chips)=20
Seat 8: JJin91 (98061 in chips)=20
Seat 9: gatorgrinds (48587 in chips)=20
REALDEVIL: posts the ante 175
PLOmaheezy: posts the ante 175
skonnybobo: posts the ante 175
gabagool5: posts the ante 175
Boney526: posts the ante 175
JJin91: posts the ante 175
gatorgrinds: posts the ante 175
Boney526: posts small blind 700
JJin91: posts big blind 1400
*** HOLE CARDS ***
Dealt to JJin91 [6s Tc]
gatorgrinds: folds=20
REALDEVIL: calls 1400
PLOmaheezy: folds=20
skonnybobo: folds=20
gabagool5: folds=20
Boney526: calls 700
JJin91: checks=20
*** FLOP *** [2d 4s 2s]
Boney526: checks=20
JJin91: bets 3092
REALDEVIL: calls 3092
Boney526: folds=20
*** TURN *** [2d 4s 2s] [8c]
JJin91: checks=20
REALDEVIL: bets 2800
JJin91: folds=20
Uncalled bet (2800) returned to REALDEVIL
REALDEVIL collected 11609 from pot
*** SUMMARY ***
Total pot 11609 | Rake 0=20
Board [2d 4s 2s 8c]
Seat 1: REALDEVIL collected (11609)
Seat 2: PLOmaheezy folded before Flop (didn't bet)
Seat 3: skonnybobo folded before Flop (didn't bet)
Seat 4: gabagool5 (button) folded before Flop (didn't bet)
Seat 7: Boney526 (small blind) folded on the Flop
Seat 8: JJin91 (big blind) folded on the Turn
Seat 9: gatorgrinds folded before Flop (didn't bet)


*********** # 115 **************
PokerStars Hand #171444735956: Tournament #1648956582, $18.20+$1.80 USD=
 Hold'em No Limit - Level XVII (700/1400) - 2017/06/19 22:03:32 ET
Table '1648956582 10' 9-max Seat #7 is the button
Seat 1: REALDEVIL (92832 in chips)=20
Seat 2: PLOmaheezy (55135 in chips)=20
Seat 3: skonnybobo (56113 in chips)=20
Seat 4: gabagool5 (23264 in chips)=20
Seat 7: Boney526 (52663 in chips)=20
Seat 8: JJin91 (93394 in chips)=20
Seat 9: gatorgrinds (48412 in chips)=20
REALDEVIL: posts the ante 175
PLOmaheezy: posts the ante 175
skonnybobo: posts the ante 175
gabagool5: posts the ante 175
Boney526: posts the ante 175
JJin91: posts the ante 175
gatorgrinds: posts the ante 175
JJin91: posts small blind 700
gatorgrinds: posts big blind 1400
*** HOLE CARDS ***
Dealt to JJin91 [4c 4h]
REALDEVIL: folds=20
PLOmaheezy: folds=20
skonnybobo: raises 1400 to 2800
gabagool5: raises 20289 to 23089 and is all-in
Boney526: folds=20
JJin91: folds=20
gatorgrinds: folds=20
skonnybobo: folds=20
Uncalled bet (20289) returned to gabagool5
gabagool5 collected 8925 from pot
gabagool5: doesn't show hand=20
*** SUMMARY ***
Total pot 8925 | Rake 0=20
Seat 1: REALDEVIL folded before Flop (didn't bet)
Seat 2: PLOmaheezy folded before Flop (didn't bet)
Seat 3: skonnybobo folded before Flop
Seat 4: gabagool5 collected (8925)
Seat 7: Boney526 (button) folded before Flop (didn't bet)
Seat 8: JJin91 (small blind) folded before Flop
Seat 9: gatorgrinds (big blind) folded before Flop


*********** # 116 **************
PokerStars Hand #171444736247: Tournament #1648956582, $18.20+$1.80 USD=
 Hold'em No Limit - Level XVII (700/1400) - 2017/06/19 22:04:23 ET
Table '1648956582 10' 9-max Seat #8 is the button
Seat 1: REALDEVIL (92657 in chips)=20
Seat 2: PLOmaheezy (54960 in chips)=20
Seat 3: skonnybobo (53138 in chips)=20
Seat 4: gabagool5 (29214 in chips)=20
Seat 5: ChrisArvin (46939 in chips)=20
Seat 6: Decklyn71 (45763 in chips)=20
Seat 7: Boney526 (52488 in chips)=20
Seat 8: JJin91 (92519 in chips)=20
Seat 9: gatorgrinds (46837 in chips)=20
REALDEVIL: posts the ante 175
PLOmaheezy: posts the ante 175
skonnybobo: posts the ante 175
gabagool5: posts the ante 175
ChrisArvin: posts the ante 175
Decklyn71: posts the ante 175
Boney526: posts the ante 175
JJin91: posts the ante 175
gatorgrinds: posts the ante 175
gatorgrinds: posts small blind 700
REALDEVIL: posts big blind 1400
*** HOLE CARDS ***
Dealt to JJin91 [4c Tc]
PLOmaheezy: folds=20
skonnybobo: folds=20
gabagool5: folds=20
ChrisArvin: raises 1823 to 3223
Decklyn71: folds=20
Boney526: folds=20
JJin91: folds=20
gatorgrinds: folds=20
REALDEVIL: calls 1823
*** FLOP *** [5d 3d 2h]
REALDEVIL: checks=20
ChrisArvin: bets 4554
REALDEVIL: folds=20
Uncalled bet (4554) returned to ChrisArvin
ChrisArvin collected 8721 from pot
ChrisArvin: doesn't show hand=20
*** SUMMARY ***
Total pot 8721 | Rake 0=20
Board [5d 3d 2h]
Seat 1: REALDEVIL (big blind) folded on the Flop
Seat 2: PLOmaheezy folded before Flop (didn't bet)
Seat 3: skonnybobo folded before Flop (didn't bet)
Seat 4: gabagool5 folded before Flop (didn't bet)
Seat 5: ChrisArvin collected (8721)
Seat 6: Decklyn71 folded before Flop (didn't bet)
Seat 7: Boney526 folded before Flop (didn't bet)
Seat 8: JJin91 (button) folded before Flop (didn't bet)
Seat 9: gatorgrinds (small blind) folded before Flop


*********** # 117 **************
PokerStars Hand #171444736537: Tournament #1648956582, $18.20+$1.80 USD=
 Hold'em No Limit - Level XVII (700/1400) - 2017/06/19 22:05:08 ET
Table '1648956582 10' 9-max Seat #9 is the button
Seat 1: REALDEVIL (89259 in chips)=20
Seat 2: PLOmaheezy (54785 in chips)=20
Seat 3: skonnybobo (52963 in chips)=20
Seat 4: gabagool5 (29039 in chips)=20
Seat 5: ChrisArvin (52262 in chips)=20
Seat 6: Decklyn71 (45588 in chips)=20
Seat 7: Boney526 (52313 in chips)=20
Seat 8: JJin91 (92344 in chips)=20
Seat 9: gatorgrinds (45962 in chips)=20
REALDEVIL: posts the ante 175
PLOmaheezy: posts the ante 175
skonnybobo: posts the ante 175
gabagool5: posts the ante 175
ChrisArvin: posts the ante 175
Decklyn71: posts the ante 175
Boney526: posts the ante 175
JJin91: posts the ante 175
gatorgrinds: posts the ante 175
REALDEVIL: posts small blind 700
PLOmaheezy: posts big blind 1400
*** HOLE CARDS ***
Dealt to JJin91 [9c Ah]
skonnybobo: folds=20
gabagool5: folds=20
ChrisArvin: folds=20
Decklyn71: folds=20
Boney526: raises 1596 to 2996
JJin91: calls 2996
gatorgrinds: folds=20
REALDEVIL: folds=20
PLOmaheezy: calls 1596
*** FLOP *** [4s Qc Jc]
PLOmaheezy: checks=20
Boney526: bets 3266
JJin91: calls 3266
PLOmaheezy: folds=20
*** TURN *** [4s Qc Jc] [Js]
Boney526: checks=20
JJin91: bets 10143
Boney526: folds=20
Uncalled bet (10143) returned to JJin91
JJin91 collected 17795 from pot
JJin91: doesn't show hand=20
*** SUMMARY ***
Total pot 17795 | Rake 0=20
Board [4s Qc Jc Js]
Seat 1: REALDEVIL (small blind) folded before Flop
Seat 2: PLOmaheezy (big blind) folded on the Flop
Seat 3: skonnybobo folded before Flop (didn't bet)
Seat 4: gabagool5 folded before Flop (didn't bet)
Seat 5: ChrisArvin folded before Flop (didn't bet)
Seat 6: Decklyn71 folded before Flop (didn't bet)
Seat 7: Boney526 folded on the Turn
Seat 8: JJin91 collected (17795)
Seat 9: gatorgrinds (button) folded before Flop (didn't bet)


*********** # 118 **************
PokerStars Hand #171444736901: Tournament #1648956582, $18.20+$1.80 USD=
 Hold'em No Limit - Level XVII (700/1400) - 2017/06/19 22:06:08 ET
Table '1648956582 10' 9-max Seat #1 is the button
Seat 1: REALDEVIL (88384 in chips)=20
Seat 2: PLOmaheezy (51614 in chips)=20
Seat 3: skonnybobo (52788 in chips)=20
Seat 4: gabagool5 (28864 in chips)=20
Seat 5: ChrisArvin (52087 in chips)=20
Seat 6: Decklyn71 (45413 in chips)=20
Seat 7: Boney526 (45876 in chips)=20
Seat 8: JJin91 (103702 in chips)=20
Seat 9: gatorgrinds (45787 in chips)=20
REALDEVIL: posts the ante 175
PLOmaheezy: posts the ante 175
skonnybobo: posts the ante 175
gabagool5: posts the ante 175
ChrisArvin: posts the ante 175
Decklyn71: posts the ante 175
Boney526: posts the ante 175
JJin91: posts the ante 175
gatorgrinds: posts the ante 175
PLOmaheezy: posts small blind 700
skonnybobo: posts big blind 1400
*** HOLE CARDS ***
Dealt to JJin91 [Kc Ac]
gabagool5: folds=20
ChrisArvin: folds=20
Decklyn71: folds=20
Boney526: raises 1596 to 2996
JJin91: raises 5238 to 8234
gatorgrinds: raises 37378 to 45612 and is all-in
REALDEVIL: folds=20
PLOmaheezy: folds=20
skonnybobo: folds=20
Boney526: folds=20
JJin91: calls 37378
*** FLOP *** [Js 7h 9h]
*** TURN *** [Js 7h 9h] [2s]
*** RIVER *** [Js 7h 9h 2s] [5h]
*** SHOW DOWN ***
JJin91: shows [Kc Ac] (high card Ace)
gatorgrinds: shows [Ks Kd] (a pair of Kings)
gatorgrinds collected 97895 from pot
*** SUMMARY ***
Total pot 97895 | Rake 0=20
Board [Js 7h 9h 2s 5h]
Seat 1: REALDEVIL (button) folded before Flop (didn't bet)
Seat 2: PLOmaheezy (small blind) folded before Flop
Seat 3: skonnybobo (big blind) folded before Flop
Seat 4: gabagool5 folded before Flop (didn't bet)
Seat 5: ChrisArvin folded before Flop (didn't bet)
Seat 6: Decklyn71 folded before Flop (didn't bet)
Seat 7: Boney526 folded before Flop
Seat 8: JJin91 showed [Kc Ac] and lost with high card Ace
Seat 9: gatorgrinds showed [Ks Kd] and won (97895) with a pair of Kings


*********** # 119 **************
PokerStars Hand #171444737499: Tournament #1648956582, $18.20+$1.80 USD=
 Hold'em No Limit - Level XVII (700/1400) - 2017/06/19 22:07:57 ET
Table '1648956582 10' 9-max Seat #2 is the button
Seat 1: REALDEVIL (88209 in chips)=20
Seat 2: PLOmaheezy (50739 in chips)=20
Seat 3: skonnybobo (51213 in chips)=20
Seat 5: ChrisArvin (51912 in chips)=20
Seat 6: Decklyn71 (45238 in chips)=20
Seat 7: Boney526 (42705 in chips)=20
Seat 8: JJin91 (57915 in chips)=20
Seat 9: gatorgrinds (97895 in chips)=20
REALDEVIL: posts the ante 175
PLOmaheezy: posts the ante 175
skonnybobo: posts the ante 175
ChrisArvin: posts the ante 175
Decklyn71: posts the ante 175
Boney526: posts the ante 175
JJin91: posts the ante 175
gatorgrinds: posts the ante 175
skonnybobo: posts small blind 700
ChrisArvin: posts big blind 1400
*** HOLE CARDS ***
Dealt to JJin91 [5d Ad]
Decklyn71: folds=20
Boney526: raises 1596 to 2996
JJin91: folds=20
gatorgrinds: folds=20
REALDEVIL: folds=20
PLOmaheezy: raises 3579 to 6575
skonnybobo: folds=20
ChrisArvin: folds=20
Boney526: folds=20
Uncalled bet (3579) returned to PLOmaheezy
PLOmaheezy collected 9492 from pot
PLOmaheezy: doesn't show hand=20
*** SUMMARY ***
Total pot 9492 | Rake 0=20
Seat 1: REALDEVIL folded before Flop (didn't bet)
Seat 2: PLOmaheezy (button) collected (9492)
Seat 3: skonnybobo (small blind) folded before Flop
Seat 5: ChrisArvin (big blind) folded before Flop
Seat 6: Decklyn71 folded before Flop (didn't bet)
Seat 7: Boney526 folded before Flop
Seat 8: JJin91 folded before Flop (didn't bet)
Seat 9: gatorgrinds folded before Flop (didn't bet)


*********** # 120 **************
PokerStars Hand #171444737679: Tournament #1648956582, $18.20+$1.80 USD=
 Hold'em No Limit - Level XVIII (800/1600) - 2017/06/19 22:08:33 ET
Table '1648956582 10' 9-max Seat #3 is the button
Seat 1: REALDEVIL (88034 in chips)=20
Seat 2: PLOmaheezy (57060 in chips)=20
Seat 3: skonnybobo (50338 in chips)=20
Seat 5: ChrisArvin (50337 in chips)=20
Seat 6: Decklyn71 (45063 in chips)=20
Seat 7: Boney526 (39534 in chips)=20
Seat 8: JJin91 (57740 in chips)=20
Seat 9: gatorgrinds (97720 in chips)=20
REALDEVIL: posts the ante 200
PLOmaheezy: posts the ante 200
skonnybobo: posts the ante 200
ChrisArvin: posts the ante 200
Decklyn71: posts the ante 200
Boney526: posts the ante 200
JJin91: posts the ante 200
gatorgrinds: posts the ante 200
ChrisArvin: posts small blind 800
Decklyn71: posts big blind 1600
*** HOLE CARDS ***
Dealt to JJin91 [Tc 6c]
Boney526: raises 1824 to 3424
JJin91: folds=20
gatorgrinds: folds=20
REALDEVIL: folds=20
PLOmaheezy: calls 3424
skonnybobo: calls 3424
ChrisArvin: raises 46713 to 50137 and is all-in
Decklyn71: folds=20
Boney526: folds=20
PLOmaheezy: folds=20
skonnybobo: folds=20
Uncalled bet (46713) returned to ChrisArvin
ChrisArvin collected 16896 from pot
ChrisArvin: doesn't show hand=20
*** SUMMARY ***
Total pot 16896 | Rake 0=20
Seat 1: REALDEVIL folded before Flop (didn't bet)
Seat 2: PLOmaheezy folded before Flop
Seat 3: skonnybobo (button) folded before Flop
Seat 5: ChrisArvin (small blind) collected (16896)
Seat 6: Decklyn71 (big blind) folded before Flop
Seat 7: Boney526 folded before Flop
Seat 8: JJin91 folded before Flop (didn't bet)
Seat 9: gatorgrinds folded before Flop (didn't bet)


*********** # 121 **************
PokerStars Hand #171444738053: Tournament #1648956582, $18.20+$1.80 USD=
 Hold'em No Limit - Level XVIII (800/1600) - 2017/06/19 22:09:37 ET
Table '1648956582 10' 9-max Seat #5 is the button
Seat 1: REALDEVIL (87834 in chips)=20
Seat 2: PLOmaheezy (53436 in chips)=20
Seat 3: skonnybobo (46714 in chips)=20
Seat 5: ChrisArvin (63609 in chips)=20
Seat 6: Decklyn71 (43263 in chips)=20
Seat 7: Boney526 (35910 in chips)=20
Seat 8: JJin91 (57540 in chips)=20
Seat 9: gatorgrinds (97520 in chips)=20
REALDEVIL: posts the ante 200
PLOmaheezy: posts the ante 200
skonnybobo: posts the ante 200
ChrisArvin: posts the ante 200
Decklyn71: posts the ante 200
Boney526: posts the ante 200
JJin91: posts the ante 200
gatorgrinds: posts the ante 200
Decklyn71: posts small blind 800
Boney526: posts big blind 1600
*** HOLE CARDS ***
Dealt to JJin91 [9h Ah]
JJin91: raises 1904 to 3504
gatorgrinds: folds=20
REALDEVIL: folds=20
PLOmaheezy: calls 3504
skonnybobo: folds=20
ChrisArvin: folds=20
Decklyn71: folds=20
Boney526: calls 1904
*** FLOP *** [7h 7d As]
Boney526: checks=20
JJin91: checks=20
PLOmaheezy: bets 6456
Boney526: folds=20
JJin91: calls 6456
*** TURN *** [7h 7d As] [Jc]
JJin91: bets 7009
PLOmaheezy: raises 36267 to 43276 and is all-in
JJin91: calls 36267
*** RIVER *** [7h 7d As Jc] [Jd]
*** SHOW DOWN ***
JJin91: shows [9h Ah] (two pair, Aces and Jacks)
PLOmaheezy: shows [5c Ac] (two pair, Aces and Jacks - lower kicker)
JJin91 collected 112376 from pot
PLOmaheezy finished the tournament in 33rd place
*** SUMMARY ***
Total pot 112376 | Rake 0=20
Board [7h 7d As Jc Jd]
Seat 1: REALDEVIL folded before Flop (didn't bet)
Seat 2: PLOmaheezy showed [5c Ac] and lost with two pair, Aces and Jacks
Seat 3: skonnybobo folded before Flop (didn't bet)
Seat 5: ChrisArvin (button) folded before Flop (didn't bet)
Seat 6: Decklyn71 (small blind) folded before Flop
Seat 7: Boney526 (big blind) folded on the Flop
Seat 8: JJin91 showed [9h Ah] and won (112376) with two pair, Aces and =
Jacks
Seat 9: gatorgrinds folded before Flop (didn't bet)


*********** # 122 **************
PokerStars Hand #171444738806: Tournament #1648956582, $18.20+$1.80 USD=
 Hold'em No Limit - Level XVIII (800/1600) - 2017/06/19 22:11:52 ET
Table '1648956582 10' 9-max Seat #6 is the button
Seat 1: REALDEVIL (87634 in chips)=20
Seat 3: skonnybobo (46514 in chips)=20
Seat 5: ChrisArvin (63409 in chips)=20
Seat 6: Decklyn71 (42263 in chips)=20
Seat 7: Boney526 (32206 in chips)=20
Seat 8: JJin91 (116480 in chips)=20
Seat 9: gatorgrinds (97320 in chips)=20
REALDEVIL: posts the ante 200
skonnybobo: posts the ante 200
ChrisArvin: posts the ante 200
Decklyn71: posts the ante 200
Boney526: posts the ante 200
JJin91: posts the ante 200
gatorgrinds: posts the ante 200
Boney526: posts small blind 800
JJin91: posts big blind 1600
*** HOLE CARDS ***
Dealt to JJin91 [Jc 6d]
gatorgrinds: folds=20
REALDEVIL: folds=20
skonnybobo: raises 1600 to 3200
ChrisArvin: folds=20
Decklyn71: calls 3200
Boney526: folds=20
JJin91: calls 1600
*** FLOP *** [6s Th 2d]
JJin91: bets 6726
skonnybobo: folds=20
Decklyn71: folds=20
Uncalled bet (6726) returned to JJin91
JJin91 collected 11800 from pot
JJin91: doesn't show hand=20
*** SUMMARY ***
Total pot 11800 | Rake 0=20
Board [6s Th 2d]
Seat 1: REALDEVIL folded before Flop (didn't bet)
Seat 3: skonnybobo folded on the Flop
Seat 5: ChrisArvin folded before Flop (didn't bet)
Seat 6: Decklyn71 (button) folded on the Flop
Seat 7: Boney526 (small blind) folded before Flop
Seat 8: JJin91 (big blind) collected (11800)
Seat 9: gatorgrinds folded before Flop (didn't bet)


*********** # 123 **************
PokerStars Hand #171444739036: Tournament #1648956582, $18.20+$1.80 USD=
 Hold'em No Limit - Level XVIII (800/1600) - 2017/06/19 22:12:31 ET
Table '1648956582 10' 9-max Seat #7 is the button
Seat 1: REALDEVIL (87434 in chips)=20
Seat 2: iFoldN0T (76380 in chips)=20
Seat 3: skonnybobo (43114 in chips)=20
Seat 5: ChrisArvin (63209 in chips)=20
Seat 6: Decklyn71 (38863 in chips)=20
Seat 7: Boney526 (31206 in chips)=20
Seat 8: JJin91 (124880 in chips)=20
Seat 9: gatorgrinds (97120 in chips)=20
REALDEVIL: posts the ante 200
iFoldN0T: posts the ante 200
skonnybobo: posts the ante 200
ChrisArvin: posts the ante 200
Decklyn71: posts the ante 200
Boney526: posts the ante 200
JJin91: posts the ante 200
gatorgrinds: posts the ante 200
JJin91: posts small blind 800
gatorgrinds: posts big blind 1600
*** HOLE CARDS ***
Dealt to JJin91 [Kh Kd]
REALDEVIL: folds=20
iFoldN0T: folds=20
skonnybobo: folds=20
ChrisArvin: folds=20
Decklyn71: folds=20
Boney526: raises 1824 to 3424
JJin91: calls 2624
gatorgrinds: calls 1824
*** FLOP *** [Qh Jc 9h]
JJin91: checks=20
gatorgrinds: checks=20
Boney526: checks=20
*** TURN *** [Qh Jc 9h] [Qs]
JJin91: bets 4393
gatorgrinds: folds=20
Boney526: folds=20
Uncalled bet (4393) returned to JJin91
JJin91 collected 11872 from pot
JJin91: doesn't show hand=20
*** SUMMARY ***
Total pot 11872 | Rake 0=20
Board [Qh Jc 9h Qs]
Seat 1: REALDEVIL folded before Flop (didn't bet)
Seat 2: iFoldN0T folded before Flop (didn't bet)
Seat 3: skonnybobo folded before Flop (didn't bet)
Seat 5: ChrisArvin folded before Flop (didn't bet)
Seat 6: Decklyn71 folded before Flop (didn't bet)
Seat 7: Boney526 (button) folded on the Turn
Seat 8: JJin91 (small blind) collected (11872)
Seat 9: gatorgrinds (big blind) folded on the Turn


*********** # 124 **************
PokerStars Hand #171444739568: Tournament #1648956582, $18.20+$1.80 USD=
 Hold'em No Limit - Level XVIII (800/1600) - 2017/06/19 22:14:04 ET
Table '1648956582 10' 9-max Seat #8 is the button
Seat 1: REALDEVIL (87234 in chips)=20
Seat 2: iFoldN0T (76180 in chips)=20
Seat 3: skonnybobo (42914 in chips)=20
Seat 5: ChrisArvin (63009 in chips)=20
Seat 6: Decklyn71 (38663 in chips)=20
Seat 7: Boney526 (27582 in chips)=20
Seat 8: JJin91 (133128 in chips)=20
Seat 9: gatorgrinds (93496 in chips)=20
REALDEVIL: posts the ante 200
iFoldN0T: posts the ante 200
skonnybobo: posts the ante 200
ChrisArvin: posts the ante 200
Decklyn71: posts the ante 200
Boney526: posts the ante 200
JJin91: posts the ante 200
gatorgrinds: posts the ante 200
gatorgrinds: posts small blind 800
REALDEVIL: posts big blind 1600
*** HOLE CARDS ***
Dealt to JJin91 [3d 7d]
iFoldN0T: raises 1600 to 3200
skonnybobo: folds=20
ChrisArvin: folds=20
Decklyn71: folds=20
Boney526: folds=20
JJin91: folds=20
gatorgrinds: folds=20
REALDEVIL: folds=20
Uncalled bet (1600) returned to iFoldN0T
iFoldN0T collected 5600 from pot
iFoldN0T: doesn't show hand=20
*** SUMMARY ***
Total pot 5600 | Rake 0=20
Seat 1: REALDEVIL (big blind) folded before Flop
Seat 2: iFoldN0T collected (5600)
Seat 3: skonnybobo folded before Flop (didn't bet)
Seat 5: ChrisArvin folded before Flop (didn't bet)
Seat 6: Decklyn71 folded before Flop (didn't bet)
Seat 7: Boney526 folded before Flop (didn't bet)
Seat 8: JJin91 (button) folded before Flop (didn't bet)
Seat 9: gatorgrinds (small blind) folded before Flop


*********** # 125 **************
PokerStars Hand #171444739740: Tournament #1648956582, $18.20+$1.80 USD=
 Hold'em No Limit - Level XVIII (800/1600) - 2017/06/19 22:14:34 ET
Table '1648956582 10' 9-max Seat #9 is the button
Seat 1: REALDEVIL (85434 in chips)=20
Seat 2: iFoldN0T (79980 in chips)=20
Seat 3: skonnybobo (42714 in chips)=20
Seat 5: ChrisArvin (62809 in chips)=20
Seat 6: Decklyn71 (38463 in chips)=20
Seat 7: Boney526 (27382 in chips)=20
Seat 8: JJin91 (132928 in chips)=20
Seat 9: gatorgrinds (92496 in chips)=20
REALDEVIL: posts the ante 200
iFoldN0T: posts the ante 200
skonnybobo: posts the ante 200
ChrisArvin: posts the ante 200
Decklyn71: posts the ante 200
Boney526: posts the ante 200
JJin91: posts the ante 200
gatorgrinds: posts the ante 200
REALDEVIL: posts small blind 800
iFoldN0T: posts big blind 1600
*** HOLE CARDS ***
Dealt to JJin91 [Th 5s]
skonnybobo: folds=20
ChrisArvin: raises 1953 to 3553
Decklyn71: folds=20
Boney526: folds=20
JJin91: folds=20
gatorgrinds: folds=20
REALDEVIL: calls 2753
iFoldN0T: calls 1953
*** FLOP *** [Tc 2d 8s]
REALDEVIL: checks=20
iFoldN0T: checks=20
ChrisArvin: bets 4444
REALDEVIL: folds=20
iFoldN0T: calls 4444
*** TURN *** [Tc 2d 8s] [3h]
iFoldN0T: checks=20
ChrisArvin: bets 7227
iFoldN0T: folds=20
Uncalled bet (7227) returned to ChrisArvin
ChrisArvin collected 21147 from pot
ChrisArvin: doesn't show hand=20
*** SUMMARY ***
Total pot 21147 | Rake 0=20
Board [Tc 2d 8s 3h]
Seat 1: REALDEVIL (small blind) folded on the Flop
Seat 2: iFoldN0T (big blind) folded on the Turn
Seat 3: skonnybobo folded before Flop (didn't bet)
Seat 5: ChrisArvin collected (21147)
Seat 6: Decklyn71 folded before Flop (didn't bet)
Seat 7: Boney526 folded before Flop (didn't bet)
Seat 8: JJin91 folded before Flop (didn't bet)
Seat 9: gatorgrinds (button) folded before Flop (didn't bet)


*********** # 126 **************
PokerStars Hand #171445443563: Tournament #1648956582, $18.20+$1.80 USD=
 Hold'em No Limit - Level XVIII (800/1600) - 2017/06/19 22:16:11 ET
Table '1648956582 10' 9-max Seat #1 is the button
Seat 1: REALDEVIL (81681 in chips)=20
Seat 2: iFoldN0T (71783 in chips)=20
Seat 3: skonnybobo (42514 in chips)=20
Seat 5: ChrisArvin (75759 in chips)=20
Seat 6: Decklyn71 (38263 in chips)=20
Seat 7: Boney526 (27182 in chips)=20
Seat 8: JJin91 (132728 in chips)=20
Seat 9: gatorgrinds (92296 in chips)=20
REALDEVIL: posts the ante 200
iFoldN0T: posts the ante 200
skonnybobo: posts the ante 200
ChrisArvin: posts the ante 200
Decklyn71: posts the ante 200
Boney526: posts the ante 200
JJin91: posts the ante 200
gatorgrinds: posts the ante 200
iFoldN0T: posts small blind 800
skonnybobo: posts big blind 1600
*** HOLE CARDS ***
Dealt to JJin91 [2h 6h]
ChrisArvin: folds=20
Decklyn71: folds=20
Boney526: folds=20
JJin91: folds=20
gatorgrinds: folds=20
REALDEVIL: folds=20
iFoldN0T: calls 800
skonnybobo: raises 3200 to 4800
iFoldN0T: folds=20
Uncalled bet (3200) returned to skonnybobo
skonnybobo collected 4800 from pot
skonnybobo: doesn't show hand=20
*** SUMMARY ***
Total pot 4800 | Rake 0=20
Seat 1: REALDEVIL (button) folded before Flop (didn't bet)
Seat 2: iFoldN0T (small blind) folded before Flop
Seat 3: skonnybobo (big blind) collected (4800)
Seat 5: ChrisArvin folded before Flop (didn't bet)
Seat 6: Decklyn71 folded before Flop (didn't bet)
Seat 7: Boney526 folded before Flop (didn't bet)
Seat 8: JJin91 folded before Flop (didn't bet)
Seat 9: gatorgrinds folded before Flop (didn't bet)


*********** # 127 **************
PokerStars Hand #171445443849: Tournament #1648956582, $18.20+$1.80 USD=
 Hold'em No Limit - Level XVIII (800/1600) - 2017/06/19 22:17:00 ET
Table '1648956582 10' 9-max Seat #2 is the button
Seat 1: REALDEVIL (81481 in chips)=20
Seat 2: iFoldN0T (69983 in chips)=20
Seat 3: skonnybobo (45514 in chips)=20
Seat 5: ChrisArvin (75559 in chips)=20
Seat 6: Decklyn71 (38063 in chips)=20
Seat 7: Boney526 (26982 in chips)=20
Seat 8: JJin91 (132528 in chips)=20
Seat 9: gatorgrinds (92096 in chips)=20
REALDEVIL: posts the ante 200
iFoldN0T: posts the ante 200
skonnybobo: posts the ante 200
ChrisArvin: posts the ante 200
Decklyn71: posts the ante 200
Boney526: posts the ante 200
JJin91: posts the ante 200
gatorgrinds: posts the ante 200
skonnybobo: posts small blind 800
ChrisArvin: posts big blind 1600
*** HOLE CARDS ***
Dealt to JJin91 [8h Qh]
Decklyn71: folds=20
Boney526: folds=20
JJin91: raises 2512 to 4112
gatorgrinds: folds=20
REALDEVIL: folds=20
iFoldN0T: folds=20
skonnybobo: folds=20
ChrisArvin: folds=20
Uncalled bet (2512) returned to JJin91
JJin91 collected 5600 from pot
JJin91: doesn't show hand=20
*** SUMMARY ***
Total pot 5600 | Rake 0=20
Seat 1: REALDEVIL folded before Flop (didn't bet)
Seat 2: iFoldN0T (button) folded before Flop (didn't bet)
Seat 3: skonnybobo (small blind) folded before Flop
Seat 5: ChrisArvin (big blind) folded before Flop
Seat 6: Decklyn71 folded before Flop (didn't bet)
Seat 7: Boney526 folded before Flop (didn't bet)
Seat 8: JJin91 collected (5600)
Seat 9: gatorgrinds folded before Flop (didn't bet)


*********** # 128 **************
PokerStars Hand #171445443928: Tournament #1648956582, $18.20+$1.80 USD=
 Hold'em No Limit - Level XVIII (800/1600) - 2017/06/19 22:17:17 ET
Table '1648956582 10' 9-max Seat #3 is the button
Seat 1: REALDEVIL (81281 in chips)=20
Seat 2: iFoldN0T (69783 in chips)=20
Seat 3: skonnybobo (44514 in chips)=20
Seat 5: ChrisArvin (73759 in chips)=20
Seat 6: Decklyn71 (37863 in chips)=20
Seat 7: Boney526 (26782 in chips)=20
Seat 8: JJin91 (136328 in chips)=20
Seat 9: gatorgrinds (91896 in chips)=20
REALDEVIL: posts the ante 200
iFoldN0T: posts the ante 200
skonnybobo: posts the ante 200
ChrisArvin: posts the ante 200
Decklyn71: posts the ante 200
Boney526: posts the ante 200
JJin91: posts the ante 200
gatorgrinds: posts the ante 200
ChrisArvin: posts small blind 800
Decklyn71: posts big blind 1600
*** HOLE CARDS ***
Dealt to JJin91 [3h Ah]
Boney526: folds=20
JJin91: folds=20
gatorgrinds: folds=20
REALDEVIL: folds=20
iFoldN0T: folds=20
skonnybobo: raises 1600 to 3200
ChrisArvin: folds=20
Decklyn71: folds=20
Uncalled bet (1600) returned to skonnybobo
skonnybobo collected 5600 from pot
skonnybobo: doesn't show hand=20
*** SUMMARY ***
Total pot 5600 | Rake 0=20
Seat 1: REALDEVIL folded before Flop (didn't bet)
Seat 2: iFoldN0T folded before Flop (didn't bet)
Seat 3: skonnybobo (button) collected (5600)
Seat 5: ChrisArvin (small blind) folded before Flop
Seat 6: Decklyn71 (big blind) folded before Flop
Seat 7: Boney526 folded before Flop (didn't bet)
Seat 8: JJin91 folded before Flop (didn't bet)
Seat 9: gatorgrinds folded before Flop (didn't bet)


*********** # 129 **************
PokerStars Hand #171445444120: Tournament #1648956582, $18.20+$1.80 USD=
 Hold'em No Limit - Level XVIII (800/1600) - 2017/06/19 22:17:48 ET
Table '1648956582 10' 9-max Seat #5 is the button
Seat 1: REALDEVIL (81081 in chips)=20
Seat 2: iFoldN0T (69583 in chips)=20
Seat 3: skonnybobo (48314 in chips)=20
Seat 5: ChrisArvin (72759 in chips)=20
Seat 6: Decklyn71 (36063 in chips)=20
Seat 7: Boney526 (26582 in chips)=20
Seat 8: JJin91 (136128 in chips)=20
Seat 9: gatorgrinds (91696 in chips)=20
REALDEVIL: posts the ante 200
iFoldN0T: posts the ante 200
skonnybobo: posts the ante 200
ChrisArvin: posts the ante 200
Decklyn71: posts the ante 200
Boney526: posts the ante 200
JJin91: posts the ante 200
gatorgrinds: posts the ante 200
Decklyn71: posts small blind 800
Boney526: posts big blind 1600
*** HOLE CARDS ***
Dealt to JJin91 [6h 4h]
JJin91: folds=20
gatorgrinds: raises 1600 to 3200
REALDEVIL: folds=20
iFoldN0T: folds=20
skonnybobo: folds=20
ChrisArvin: folds=20
Decklyn71: folds=20
Boney526: folds=20
Uncalled bet (1600) returned to gatorgrinds
gatorgrinds collected 5600 from pot
gatorgrinds: doesn't show hand=20
*** SUMMARY ***
Total pot 5600 | Rake 0=20
Seat 1: REALDEVIL folded before Flop (didn't bet)
Seat 2: iFoldN0T folded before Flop (didn't bet)
Seat 3: skonnybobo folded before Flop (didn't bet)
Seat 5: ChrisArvin (button) folded before Flop (didn't bet)
Seat 6: Decklyn71 (small blind) folded before Flop
Seat 7: Boney526 (big blind) folded before Flop
Seat 8: JJin91 folded before Flop (didn't bet)
Seat 9: gatorgrinds collected (5600)


*********** # 130 **************
PokerStars Hand #171445444373: Tournament #1648956582, $18.20+$1.80 USD=
 Hold'em No Limit - Level XIX (1000/2000) - 2017/06/19 22:18:31 ET
Table '1648956582 10' 9-max Seat #6 is the button
Seat 1: REALDEVIL (80881 in chips)=20
Seat 2: iFoldN0T (69383 in chips)=20
Seat 3: skonnybobo (48114 in chips)=20
Seat 5: ChrisArvin (72559 in chips)=20
Seat 6: Decklyn71 (35063 in chips)=20
Seat 7: Boney526 (24782 in chips)=20
Seat 8: JJin91 (135928 in chips)=20
Seat 9: gatorgrinds (95496 in chips)=20
REALDEVIL: posts the ante 250
iFoldN0T: posts the ante 250
skonnybobo: posts the ante 250
ChrisArvin: posts the ante 250
Decklyn71: posts the ante 250
Boney526: posts the ante 250
JJin91: posts the ante 250
gatorgrinds: posts the ante 250
Boney526: posts small blind 1000
JJin91: posts big blind 2000
*** HOLE CARDS ***
Dealt to JJin91 [Th 6s]
gatorgrinds: folds=20
REALDEVIL: folds=20
iFoldN0T: raises 2000 to 4000
skonnybobo: folds=20
ChrisArvin: folds=20
Decklyn71: calls 4000
Boney526: folds=20
JJin91: folds=20
*** FLOP *** [2c Kd 3c]
iFoldN0T: bets 4111
Decklyn71: folds=20
Uncalled bet (4111) returned to iFoldN0T
iFoldN0T collected 13000 from pot
iFoldN0T: doesn't show hand=20
*** SUMMARY ***
Total pot 13000 | Rake 0=20
Board [2c Kd 3c]
Seat 1: REALDEVIL folded before Flop (didn't bet)
Seat 2: iFoldN0T collected (13000)
Seat 3: skonnybobo folded before Flop (didn't bet)
Seat 5: ChrisArvin folded before Flop (didn't bet)
Seat 6: Decklyn71 (button) folded on the Flop
Seat 7: Boney526 (small blind) folded before Flop
Seat 8: JJin91 (big blind) folded before Flop
Seat 9: gatorgrinds folded before Flop (didn't bet)


*********** # 131 **************
PokerStars Hand #171445444618: Tournament #1648956582, $18.20+$1.80 USD=
 Hold'em No Limit - Level XIX (1000/2000) - 2017/06/19 22:19:09 ET
Table '1648956582 10' 9-max Seat #7 is the button
Seat 1: REALDEVIL (80631 in chips)=20
Seat 2: iFoldN0T (78133 in chips)=20
Seat 3: skonnybobo (47864 in chips)=20
Seat 5: ChrisArvin (72309 in chips)=20
Seat 6: Decklyn71 (30813 in chips)=20
Seat 7: Boney526 (23532 in chips)=20
Seat 8: JJin91 (133678 in chips)=20
Seat 9: gatorgrinds (95246 in chips)=20
REALDEVIL: posts the ante 250
iFoldN0T: posts the ante 250
skonnybobo: posts the ante 250
ChrisArvin: posts the ante 250
Decklyn71: posts the ante 250
Boney526: posts the ante 250
JJin91: posts the ante 250
gatorgrinds: posts the ante 250
JJin91: posts small blind 1000
gatorgrinds: posts big blind 2000
*** HOLE CARDS ***
Dealt to JJin91 [Ad 8d]
REALDEVIL: raises 2500 to 4500
iFoldN0T: folds=20
skonnybobo: folds=20
ChrisArvin: folds=20
Decklyn71: folds=20
Boney526: folds=20
JJin91: calls 3500
gatorgrinds: calls 2500
*** FLOP *** [4c 4d Jd]
JJin91: checks=20
gatorgrinds: checks=20
REALDEVIL: bets 10000
JJin91: calls 10000
gatorgrinds: folds=20
*** TURN *** [4c 4d Jd] [As]
JJin91: checks=20
REALDEVIL: bets 65881 and is all-in
JJin91: folds=20
Uncalled bet (65881) returned to REALDEVIL
REALDEVIL collected 35500 from pot
REALDEVIL: shows [Th 7h] (a pair of Fours)
*** SUMMARY ***
Total pot 35500 | Rake 0=20
Board [4c 4d Jd As]
Seat 1: REALDEVIL collected (35500)
Seat 2: iFoldN0T folded before Flop (didn't bet)
Seat 3: skonnybobo folded before Flop (didn't bet)
Seat 5: ChrisArvin folded before Flop (didn't bet)
Seat 6: Decklyn71 folded before Flop (didn't bet)
Seat 7: Boney526 (button) folded before Flop (didn't bet)
Seat 8: JJin91 (small blind) folded on the Turn
Seat 9: gatorgrinds (big blind) folded on the Flop


*********** # 132 **************
PokerStars Hand #171445445258: Tournament #1648956582, $18.20+$1.80 USD=
 Hold'em No Limit - Level XIX (1000/2000) - 2017/06/19 22:20:56 ET
Table '1648956582 10' 9-max Seat #8 is the button
Seat 1: REALDEVIL (101381 in chips)=20
Seat 2: iFoldN0T (77883 in chips)=20
Seat 3: skonnybobo (47614 in chips)=20
Seat 5: ChrisArvin (72059 in chips)=20
Seat 7: Boney526 (23282 in chips)=20
Seat 8: JJin91 (118928 in chips)=20
Seat 9: gatorgrinds (90496 in chips)=20
REALDEVIL: posts the ante 250
iFoldN0T: posts the ante 250
skonnybobo: posts the ante 250
ChrisArvin: posts the ante 250
Boney526: posts the ante 250
JJin91: posts the ante 250
gatorgrinds: posts the ante 250
gatorgrinds: posts small blind 1000
REALDEVIL: posts big blind 2000
*** HOLE CARDS ***
Dealt to JJin91 [Jh 5c]
iFoldN0T: folds=20
skonnybobo: folds=20
ChrisArvin: folds=20
Boney526: folds=20
JJin91 said, "ad8d"
JJin91: folds=20
gatorgrinds: folds=20
Uncalled bet (1000) returned to REALDEVIL
REALDEVIL collected 3750 from pot
*** SUMMARY ***
Total pot 3750 | Rake 0=20
Seat 1: REALDEVIL (big blind) collected (3750)
Seat 2: iFoldN0T folded before Flop (didn't bet)
Seat 3: skonnybobo folded before Flop (didn't bet)
Seat 5: ChrisArvin folded before Flop (didn't bet)
Seat 7: Boney526 folded before Flop (didn't bet)
Seat 8: JJin91 (button) folded before Flop (didn't bet)
Seat 9: gatorgrinds (small blind) folded before Flop


*********** # 133 **************
PokerStars Hand #171445445591: Tournament #1648956582, $18.20+$1.80 USD=
 Hold'em No Limit - Level XIX (1000/2000) - 2017/06/19 22:21:56 ET
Table '1648956582 10' 9-max Seat #9 is the button
Seat 1: REALDEVIL (103881 in chips)=20
Seat 2: iFoldN0T (77633 in chips)=20
Seat 3: skonnybobo (47364 in chips)=20
Seat 5: ChrisArvin (71809 in chips)=20
Seat 7: Boney526 (23032 in chips)=20
Seat 8: JJin91 (118678 in chips)=20
Seat 9: gatorgrinds (89246 in chips)=20
REALDEVIL: posts the ante 250
iFoldN0T: posts the ante 250
skonnybobo: posts the ante 250
ChrisArvin: posts the ante 250
Boney526: posts the ante 250
JJin91: posts the ante 250
gatorgrinds: posts the ante 250
REALDEVIL: posts small blind 1000
iFoldN0T: posts big blind 2000
*** HOLE CARDS ***
Dealt to JJin91 [3d 8d]
skonnybobo: raises 2000 to 4000
ChrisArvin: folds=20
Boney526: folds=20
JJin91: folds=20
gatorgrinds: folds=20
REALDEVIL: folds=20
REALDEVIL is sitting out
iFoldN0T: calls 2000
*** FLOP *** [9h 7c 4h]
iFoldN0T: checks=20
skonnybobo: bets 6000
REALDEVIL has returned
iFoldN0T: calls 6000
*** TURN *** [9h 7c 4h] [2c]
iFoldN0T: checks=20
skonnybobo: bets 37114 and is all-in
iFoldN0T: calls 37114
*** RIVER *** [9h 7c 4h 2c] [Td]
*** SHOW DOWN ***
iFoldN0T: shows [Ts 9d] (two pair, Tens and Nines)
skonnybobo: shows [9s 8s] (a pair of Nines)
iFoldN0T collected 96978 from pot
skonnybobo finished the tournament in 28th place
*** SUMMARY ***
Total pot 96978 | Rake 0=20
Board [9h 7c 4h 2c Td]
Seat 1: REALDEVIL (small blind) folded before Flop
Seat 2: iFoldN0T (big blind) showed [Ts 9d] and won (96978) with two pa=
ir, Tens and Nines
Seat 3: skonnybobo showed [9s 8s] and lost with a pair of Nines
Seat 5: ChrisArvin folded before Flop (didn't bet)
Seat 7: Boney526 folded before Flop (didn't bet)
Seat 8: JJin91 folded before Flop (didn't bet)
Seat 9: gatorgrinds (button) folded before Flop (didn't bet)


*********** # 134 **************
PokerStars Hand #171445446066: Tournament #1648956582, $18.20+$1.80 USD=
 Hold'em No Limit - Level XIX (1000/2000) - 2017/06/19 22:23:27 ET
Table '1648956582 2' 9-max Seat #9 is the button
Seat 1: sfarbs (24136 in chips)=20
Seat 2: Road2daMoney (31494 in chips)=20
Seat 3: fkdtshtfkdts (53036 in chips)=20
Seat 4: LxuryBeatdwn (84181 in chips)=20
Seat 5: JJin91 (118428 in chips)=20
Seat 6: Paceman2jr (35430 in chips)=20
Seat 7: gatorgrinds (88996 in chips)=20
Seat 8: L8terGators (80364 in chips)=20
Seat 9: BCinNY (110727 in chips)=20
sfarbs: posts the ante 250
Road2daMoney: posts the ante 250
fkdtshtfkdts: posts the ante 250
LxuryBeatdwn: posts the ante 250
JJin91: posts the ante 250
Paceman2jr: posts the ante 250
gatorgrinds: posts the ante 250
L8terGators: posts the ante 250
BCinNY: posts the ante 250
sfarbs: posts small blind 1000
Road2daMoney: posts big blind 2000
*** HOLE CARDS ***
Dealt to JJin91 [Th Ks]
fkdtshtfkdts: folds=20
LxuryBeatdwn: folds=20
JJin91: folds=20
Paceman2jr: folds=20
gatorgrinds: folds=20
L8terGators: folds=20
BCinNY: folds=20
sfarbs: folds=20
Uncalled bet (1000) returned to Road2daMoney
Road2daMoney collected 4250 from pot
Road2daMoney: doesn't show hand=20
*** SUMMARY ***
Total pot 4250 | Rake 0=20
Seat 1: sfarbs (small blind) folded before Flop
Seat 2: Road2daMoney (big blind) collected (4250)
Seat 3: fkdtshtfkdts folded before Flop (didn't bet)
Seat 4: LxuryBeatdwn folded before Flop (didn't bet)
Seat 5: JJin91 folded before Flop (didn't bet)
Seat 6: Paceman2jr folded before Flop (didn't bet)
Seat 7: gatorgrinds folded before Flop (didn't bet)
Seat 8: L8terGators folded before Flop (didn't bet)
Seat 9: BCinNY (button) folded before Flop (didn't bet)


*********** # 135 **************
PokerStars Hand #171445446192: Tournament #1648956582, $18.20+$1.80 USD=
 Hold'em No Limit - Level XIX (1000/2000) - 2017/06/19 22:23:48 ET
Table '1648956582 2' 9-max Seat #1 is the button
Seat 1: sfarbs (22886 in chips)=20
Seat 2: Road2daMoney (34494 in chips)=20
Seat 3: fkdtshtfkdts (52786 in chips)=20
Seat 4: LxuryBeatdwn (83931 in chips)=20
Seat 5: JJin91 (118178 in chips)=20
Seat 6: Paceman2jr (35180 in chips)=20
Seat 7: gatorgrinds (88746 in chips)=20
Seat 8: L8terGators (80114 in chips)=20
Seat 9: BCinNY (110477 in chips)=20
sfarbs: posts the ante 250
Road2daMoney: posts the ante 250
fkdtshtfkdts: posts the ante 250
LxuryBeatdwn: posts the ante 250
JJin91: posts the ante 250
Paceman2jr: posts the ante 250
gatorgrinds: posts the ante 250
L8terGators: posts the ante 250
BCinNY: posts the ante 250
Road2daMoney: posts small blind 1000
fkdtshtfkdts: posts big blind 2000
*** HOLE CARDS ***
Dealt to JJin91 [9h Qc]
LxuryBeatdwn: folds=20
JJin91: folds=20
Paceman2jr: folds=20
gatorgrinds: folds=20
L8terGators: raises 2200 to 4200
BCinNY: folds=20
sfarbs: folds=20
Road2daMoney: raises 30044 to 34244 and is all-in
fkdtshtfkdts: folds=20
L8terGators: calls 30044
*** FLOP *** [7d 6c 6d]
*** TURN *** [7d 6c 6d] [2c]
*** RIVER *** [7d 6c 6d 2c] [Ah]
*** SHOW DOWN ***
Road2daMoney: shows [Kh Ks] (two pair, Kings and Sixes)
L8terGators: shows [Jh Jc] (two pair, Jacks and Sixes)
Road2daMoney collected 72738 from pot
*** SUMMARY ***
Total pot 72738 | Rake 0=20
Board [7d 6c 6d 2c Ah]
Seat 1: sfarbs (button) folded before Flop (didn't bet)
Seat 2: Road2daMoney (small blind) showed [Kh Ks] and won (72738) with =
two pair, Kings and Sixes
Seat 3: fkdtshtfkdts (big blind) folded before Flop
Seat 4: LxuryBeatdwn folded before Flop (didn't bet)
Seat 5: JJin91 folded before Flop (didn't bet)
Seat 6: Paceman2jr folded before Flop (didn't bet)
Seat 7: gatorgrinds folded before Flop (didn't bet)
Seat 8: L8terGators showed [Jh Jc] and lost with two pair, Jacks and Si=
xes
Seat 9: BCinNY folded before Flop (didn't bet)


*********** # 136 **************
PokerStars Hand #171445446507: Tournament #1648956582, $18.20+$1.80 USD=
 Hold'em No Limit - Level XIX (1000/2000) - 2017/06/19 22:24:45 ET
Table '1648956582 2' 9-max Seat #2 is the button
Seat 1: sfarbs (22636 in chips)=20
Seat 2: Road2daMoney (72738 in chips)=20
Seat 3: fkdtshtfkdts (50536 in chips)=20
Seat 4: LxuryBeatdwn (83681 in chips)=20
Seat 5: JJin91 (117928 in chips)=20
Seat 6: Paceman2jr (34930 in chips)=20
Seat 7: gatorgrinds (88496 in chips)=20
Seat 8: L8terGators (45620 in chips)=20
Seat 9: BCinNY (110227 in chips)=20
sfarbs: posts the ante 250
Road2daMoney: posts the ante 250
fkdtshtfkdts: posts the ante 250
LxuryBeatdwn: posts the ante 250
JJin91: posts the ante 250
Paceman2jr: posts the ante 250
gatorgrinds: posts the ante 250
L8terGators: posts the ante 250
BCinNY: posts the ante 250
fkdtshtfkdts: posts small blind 1000
LxuryBeatdwn: posts big blind 2000
*** HOLE CARDS ***
Dealt to JJin91 [Qc Jc]
JJin91: raises 2380 to 4380
Paceman2jr: folds=20
gatorgrinds: folds=20
L8terGators: folds=20
BCinNY: folds=20
sfarbs: calls 4380
Road2daMoney: folds=20
fkdtshtfkdts: folds=20
LxuryBeatdwn: calls 2380
*** FLOP *** [Jd Ad 4d]
LxuryBeatdwn: checks=20
JJin91: bets 9342
sfarbs: raises 8664 to 18006 and is all-in
LxuryBeatdwn: calls 18006
JJin91: calls 8664
*** TURN *** [Jd Ad 4d] [2h]
LxuryBeatdwn: checks=20
JJin91: checks=20
*** RIVER *** [Jd Ad 4d 2h] [Ah]
LxuryBeatdwn: checks=20
JJin91: checks=20
*** SHOW DOWN ***
LxuryBeatdwn: shows [Js Qd] (two pair, Aces and Jacks)
JJin91: shows [Qc Jc] (two pair, Aces and Jacks)
sfarbs: shows [Td 9d] (a flush, Ace high)
sfarbs collected 70408 from pot
*** SUMMARY ***
Total pot 70408 | Rake 0=20
Board [Jd Ad 4d 2h Ah]
Seat 1: sfarbs showed [Td 9d] and won (70408) with a flush, Ace high
Seat 2: Road2daMoney (button) folded before Flop (didn't bet)
Seat 3: fkdtshtfkdts (small blind) folded before Flop
Seat 4: LxuryBeatdwn (big blind) showed [Js Qd] and lost with two pair,=
 Aces and Jacks
Seat 5: JJin91 showed [Qc Jc] and lost with two pair, Aces and Jacks
Seat 6: Paceman2jr folded before Flop (didn't bet)
Seat 7: gatorgrinds folded before Flop (didn't bet)
Seat 8: L8terGators folded before Flop (didn't bet)
Seat 9: BCinNY folded before Flop (didn't bet)


*********** # 137 **************
PokerStars Hand #171445446883: Tournament #1648956582, $18.20+$1.80 USD=
 Hold'em No Limit - Level XIX (1000/2000) - 2017/06/19 22:25:59 ET
Table '1648956582 2' 9-max Seat #3 is the button
Seat 1: sfarbs (70408 in chips)=20
Seat 2: Road2daMoney (72488 in chips)=20
Seat 3: fkdtshtfkdts (49286 in chips)=20
Seat 4: LxuryBeatdwn (61045 in chips)=20
Seat 5: JJin91 (95292 in chips)=20
Seat 6: Paceman2jr (34680 in chips)=20
Seat 7: gatorgrinds (88246 in chips)=20
Seat 8: L8terGators (45370 in chips)=20
Seat 9: BCinNY (109977 in chips)=20
sfarbs: posts the ante 250
Road2daMoney: posts the ante 250
fkdtshtfkdts: posts the ante 250
LxuryBeatdwn: posts the ante 250
JJin91: posts the ante 250
Paceman2jr: posts the ante 250
gatorgrinds: posts the ante 250
L8terGators: posts the ante 250
BCinNY: posts the ante 250
LxuryBeatdwn: posts small blind 1000
JJin91: posts big blind 2000
*** HOLE CARDS ***
Dealt to JJin91 [5h Ah]
Paceman2jr: folds=20
gatorgrinds: folds=20
L8terGators: folds=20
BCinNY: folds=20
sfarbs: folds=20
Road2daMoney: raises 2000 to 4000
fkdtshtfkdts: folds=20
LxuryBeatdwn: folds=20
JJin91: calls 2000
*** FLOP *** [5s 9c Qd]
JJin91: checks=20
Road2daMoney: bets 5400
JJin91: folds=20
Uncalled bet (5400) returned to Road2daMoney
Road2daMoney collected 11250 from pot
Road2daMoney: doesn't show hand=20
*** SUMMARY ***
Total pot 11250 | Rake 0=20
Board [5s 9c Qd]
Seat 1: sfarbs folded before Flop (didn't bet)
Seat 2: Road2daMoney collected (11250)
Seat 3: fkdtshtfkdts (button) folded before Flop (didn't bet)
Seat 4: LxuryBeatdwn (small blind) folded before Flop
Seat 5: JJin91 (big blind) folded on the Flop
Seat 6: Paceman2jr folded before Flop (didn't bet)
Seat 7: gatorgrinds folded before Flop (didn't bet)
Seat 8: L8terGators folded before Flop (didn't bet)
Seat 9: BCinNY folded before Flop (didn't bet)


*********** # 138 **************
PokerStars Hand #171445447165: Tournament #1648956582, $18.20+$1.80 USD=
 Hold'em No Limit - Level XIX (1000/2000) - 2017/06/19 22:26:56 ET
Table '1648956582 2' 9-max Seat #4 is the button
Seat 1: sfarbs (70158 in chips)=20
Seat 2: Road2daMoney (79488 in chips)=20
Seat 3: fkdtshtfkdts (49036 in chips)=20
Seat 4: LxuryBeatdwn (59795 in chips)=20
Seat 5: JJin91 (91042 in chips)=20
Seat 6: Paceman2jr (34430 in chips)=20
Seat 7: gatorgrinds (87996 in chips)=20
Seat 8: L8terGators (45120 in chips)=20
Seat 9: BCinNY (109727 in chips)=20
sfarbs: posts the ante 250
Road2daMoney: posts the ante 250
fkdtshtfkdts: posts the ante 250
LxuryBeatdwn: posts the ante 250
JJin91: posts the ante 250
Paceman2jr: posts the ante 250
gatorgrinds: posts the ante 250
L8terGators: posts the ante 250
BCinNY: posts the ante 250
JJin91: posts small blind 1000
Paceman2jr: posts big blind 2000
*** HOLE CARDS ***
Dealt to JJin91 [9s 8h]
gatorgrinds: folds=20
L8terGators: folds=20
BCinNY: folds=20
sfarbs: folds=20
Road2daMoney: raises 2000 to 4000
fkdtshtfkdts: folds=20
LxuryBeatdwn: folds=20
JJin91: folds=20
Paceman2jr has timed out
Paceman2jr: folds=20
Uncalled bet (2000) returned to Road2daMoney
Paceman2jr is sitting out
Road2daMoney collected 7250 from pot
Road2daMoney: doesn't show hand=20
*** SUMMARY ***
Total pot 7250 | Rake 0=20
Seat 1: sfarbs folded before Flop (didn't bet)
Seat 2: Road2daMoney collected (7250)
Seat 3: fkdtshtfkdts folded before Flop (didn't bet)
Seat 4: LxuryBeatdwn (button) folded before Flop (didn't bet)
Seat 5: JJin91 (small blind) folded before Flop
Seat 6: Paceman2jr (big blind) folded before Flop
Seat 7: gatorgrinds folded before Flop (didn't bet)
Seat 8: L8terGators folded before Flop (didn't bet)
Seat 9: BCinNY folded before Flop (didn't bet)


*********** # 139 **************
PokerStars Hand #171445447402: Tournament #1648956582, $18.20+$1.80 USD=
 Hold'em No Limit - Level XIX (1000/2000) - 2017/06/19 22:27:43 ET
Table '1648956582 2' 9-max Seat #5 is the button
Seat 1: sfarbs (69908 in chips)=20
Seat 2: Road2daMoney (84488 in chips)=20
Seat 3: fkdtshtfkdts (48786 in chips)=20
Seat 4: LxuryBeatdwn (59545 in chips)=20
Seat 5: JJin91 (89792 in chips)=20
Seat 6: Paceman2jr (32180 in chips) is sitting out
Seat 7: gatorgrinds (87746 in chips)=20
Seat 8: L8terGators (44870 in chips)=20
Seat 9: BCinNY (109477 in chips)=20
sfarbs: posts the ante 250
Road2daMoney: posts the ante 250
fkdtshtfkdts: posts the ante 250
LxuryBeatdwn: posts the ante 250
JJin91: posts the ante 250
Paceman2jr: posts the ante 250
gatorgrinds: posts the ante 250
L8terGators: posts the ante 250
BCinNY: posts the ante 250
Paceman2jr: posts small blind 1000
gatorgrinds: posts big blind 2000
*** HOLE CARDS ***
Dealt to JJin91 [8d Th]
L8terGators: raises 2000 to 4000
BCinNY: folds=20
sfarbs: folds=20
Road2daMoney: folds=20
fkdtshtfkdts: raises 44536 to 48536 and is all-in
LxuryBeatdwn: folds=20
Paceman2jr has returned
JJin91: folds=20
Paceman2jr: folds=20
gatorgrinds: folds=20
L8terGators: calls 40620 and is all-in
Uncalled bet (3916) returned to fkdtshtfkdts
*** FLOP *** [Ts 3c 2h]
*** TURN *** [Ts 3c 2h] [6s]
*** RIVER *** [Ts 3c 2h 6s] [Qs]
*** SHOW DOWN ***
L8terGators: shows [6h 6d] (three of a kind, Sixes)
fkdtshtfkdts: shows [Kc As] (high card Ace)
L8terGators collected 94490 from pot
*** SUMMARY ***
Total pot 94490 | Rake 0=20
Board [Ts 3c 2h 6s Qs]
Seat 1: sfarbs folded before Flop (didn't bet)
Seat 2: Road2daMoney folded before Flop (didn't bet)
Seat 3: fkdtshtfkdts showed [Kc As] and lost with high card Ace
Seat 4: LxuryBeatdwn folded before Flop (didn't bet)
Seat 5: JJin91 (button) folded before Flop (didn't bet)
Seat 6: Paceman2jr (small blind) folded before Flop
Seat 7: gatorgrinds (big blind) folded before Flop
Seat 8: L8terGators showed [6h 6d] and won (94490) with three of a kind=
, Sixes
Seat 9: BCinNY folded before Flop (didn't bet)


*********** # 140 **************
PokerStars Hand #171445447667: Tournament #1648956582, $18.20+$1.80 USD=
 Hold'em No Limit - Level XX (1250/2500) - 2017/06/19 22:28:32 ET
Table '1648956582 2' 9-max Seat #6 is the button
Seat 1: sfarbs (69658 in chips)=20
Seat 2: Road2daMoney (84238 in chips)=20
Seat 3: fkdtshtfkdts (3916 in chips)=20
Seat 4: LxuryBeatdwn (59295 in chips)=20
Seat 5: JJin91 (89542 in chips)=20
Seat 6: Paceman2jr (30930 in chips)=20
Seat 7: gatorgrinds (85496 in chips)=20
Seat 8: L8terGators (94490 in chips)=20
Seat 9: BCinNY (109227 in chips)=20
sfarbs: posts the ante 325
Road2daMoney: posts the ante 325
fkdtshtfkdts: posts the ante 325
LxuryBeatdwn: posts the ante 325
JJin91: posts the ante 325
Paceman2jr: posts the ante 325
gatorgrinds: posts the ante 325
L8terGators: posts the ante 325
BCinNY: posts the ante 325
gatorgrinds: posts small blind 1250
L8terGators: posts big blind 2500
*** HOLE CARDS ***
Dealt to JJin91 [6c 5d]
BCinNY: raises 106402 to 108902 and is all-in
sfarbs: folds=20
Road2daMoney: folds=20
fkdtshtfkdts: folds=20
LxuryBeatdwn: folds=20
JJin91: folds=20
Paceman2jr: folds=20
gatorgrinds: folds=20
L8terGators: folds=20
Uncalled bet (106402) returned to BCinNY
BCinNY collected 9175 from pot
*** SUMMARY ***
Total pot 9175 | Rake 0=20
Seat 1: sfarbs folded before Flop (didn't bet)
Seat 2: Road2daMoney folded before Flop (didn't bet)
Seat 3: fkdtshtfkdts folded before Flop (didn't bet)
Seat 4: LxuryBeatdwn folded before Flop (didn't bet)
Seat 5: JJin91 folded before Flop (didn't bet)
Seat 6: Paceman2jr (button) folded before Flop (didn't bet)
Seat 7: gatorgrinds (small blind) folded before Flop
Seat 8: L8terGators (big blind) folded before Flop
Seat 9: BCinNY collected (9175)


*********** # 141 **************
PokerStars Hand #171445447802: Tournament #1648956582, $18.20+$1.80 USD=
 Hold'em No Limit - Level XX (1250/2500) - 2017/06/19 22:28:56 ET
Table '1648956582 2' 9-max Seat #7 is the button
Seat 1: sfarbs (69333 in chips)=20
Seat 2: Road2daMoney (83913 in chips)=20
Seat 3: fkdtshtfkdts (3591 in chips)=20
Seat 4: LxuryBeatdwn (58970 in chips)=20
Seat 5: JJin91 (89217 in chips)=20
Seat 6: Paceman2jr (30605 in chips)=20
Seat 7: gatorgrinds (83921 in chips)=20
Seat 8: L8terGators (91665 in chips)=20
Seat 9: BCinNY (115577 in chips)=20
sfarbs: posts the ante 325
Road2daMoney: posts the ante 325
fkdtshtfkdts: posts the ante 325
LxuryBeatdwn: posts the ante 325
JJin91: posts the ante 325
Paceman2jr: posts the ante 325
gatorgrinds: posts the ante 325
L8terGators: posts the ante 325
BCinNY: posts the ante 325
L8terGators: posts small blind 1250
BCinNY: posts big blind 2500
*** HOLE CARDS ***
Dealt to JJin91 [2s Ac]
sfarbs: folds=20
Road2daMoney: folds=20
fkdtshtfkdts: folds=20
LxuryBeatdwn: folds=20
JJin91: folds=20
Paceman2jr: folds=20
gatorgrinds: folds=20
L8terGators: raises 2600 to 5100
BCinNY: folds=20
Uncalled bet (2600) returned to L8terGators
L8terGators collected 7925 from pot
*** SUMMARY ***
Total pot 7925 | Rake 0=20
Seat 1: sfarbs folded before Flop (didn't bet)
Seat 2: Road2daMoney folded before Flop (didn't bet)
Seat 3: fkdtshtfkdts folded before Flop (didn't bet)
Seat 4: LxuryBeatdwn folded before Flop (didn't bet)
Seat 5: JJin91 folded before Flop (didn't bet)
Seat 6: Paceman2jr folded before Flop (didn't bet)
Seat 7: gatorgrinds (button) folded before Flop (didn't bet)
Seat 8: L8terGators (small blind) collected (7925)
Seat 9: BCinNY (big blind) folded before Flop


*********** # 142 **************
PokerStars Hand #171445447985: Tournament #1648956582, $18.20+$1.80 USD=
 Hold'em No Limit - Level XX (1250/2500) - 2017/06/19 22:29:30 ET
Table '1648956582 2' 9-max Seat #8 is the button
Seat 1: sfarbs (69008 in chips)=20
Seat 2: Road2daMoney (83588 in chips)=20
Seat 4: LxuryBeatdwn (58645 in chips)=20
Seat 5: JJin91 (88892 in chips)=20
Seat 6: Paceman2jr (30280 in chips)=20
Seat 7: gatorgrinds (83596 in chips)=20
Seat 8: L8terGators (96765 in chips)=20
Seat 9: BCinNY (112752 in chips)=20
sfarbs: posts the ante 325
Road2daMoney: posts the ante 325
LxuryBeatdwn: posts the ante 325
JJin91: posts the ante 325
Paceman2jr: posts the ante 325
gatorgrinds: posts the ante 325
L8terGators: posts the ante 325
BCinNY: posts the ante 325
BCinNY: posts small blind 1250
sfarbs: posts big blind 2500
*** HOLE CARDS ***
Dealt to JJin91 [8c Kc]
Road2daMoney: folds=20
LxuryBeatdwn: folds=20
JJin91: folds=20
Paceman2jr: folds=20
gatorgrinds: folds=20
L8terGators: raises 2600 to 5100
BCinNY: folds=20
sfarbs: calls 2600
*** FLOP *** [5d 3h 4s]
sfarbs: checks=20
L8terGators: bets 5905
sfarbs: calls 5905
*** TURN *** [5d 3h 4s] [2d]
sfarbs: checks=20
L8terGators: checks=20
*** RIVER *** [5d 3h 4s 2d] [Ks]
sfarbs: bets 11413
L8terGators: calls 11413
*** SHOW DOWN ***
sfarbs: shows [8d Ac] (a straight, Ace to Five)
L8terGators: mucks hand=20
sfarbs collected 48686 from pot
*** SUMMARY ***
Total pot 48686 | Rake 0=20
Board [5d 3h 4s 2d Ks]
Seat 1: sfarbs (big blind) showed [8d Ac] and won (48686) with a straig=
ht, Ace to Five
Seat 2: Road2daMoney folded before Flop (didn't bet)
Seat 4: LxuryBeatdwn folded before Flop (didn't bet)
Seat 5: JJin91 folded before Flop (didn't bet)
Seat 6: Paceman2jr folded before Flop (didn't bet)
Seat 7: gatorgrinds folded before Flop (didn't bet)
Seat 8: L8terGators (button) mucked [7h Kh]
Seat 9: BCinNY (small blind) folded before Flop


*********** # 143 **************
PokerStars Hand #171445448303: Tournament #1648956582, $18.20+$1.80 USD=
 Hold'em No Limit - Level XX (1250/2500) - 2017/06/19 22:30:27 ET
Table '1648956582 2' 9-max Seat #9 is the button
Seat 1: sfarbs (94951 in chips)=20
Seat 2: Road2daMoney (83263 in chips)=20
Seat 4: LxuryBeatdwn (58320 in chips)=20
Seat 5: JJin91 (88567 in chips)=20
Seat 6: Paceman2jr (29955 in chips)=20
Seat 7: gatorgrinds (83271 in chips)=20
Seat 8: L8terGators (74022 in chips)=20
Seat 9: BCinNY (111177 in chips)=20
sfarbs: posts the ante 325
Road2daMoney: posts the ante 325
LxuryBeatdwn: posts the ante 325
JJin91: posts the ante 325
Paceman2jr: posts the ante 325
gatorgrinds: posts the ante 325
L8terGators: posts the ante 325
BCinNY: posts the ante 325
sfarbs: posts small blind 1250
Road2daMoney: posts big blind 2500
*** HOLE CARDS ***
Dealt to JJin91 [2h Jd]
LxuryBeatdwn: folds=20
JJin91: folds=20
Paceman2jr: folds=20
gatorgrinds: folds=20
L8terGators: folds=20
BCinNY: folds=20
sfarbs: raises 3075 to 5575
Road2daMoney: calls 3075
*** FLOP *** [Ad Qc 6c]
sfarbs: bets 6600
Road2daMoney: calls 6600
*** TURN *** [Ad Qc 6c] [Tc]
sfarbs: checks=20
Road2daMoney: bets 12936
sfarbs: calls 12936
*** RIVER *** [Ad Qc 6c Tc] [Qs]
sfarbs: checks=20
Road2daMoney: bets 32500
sfarbs: calls 32500
*** SHOW DOWN ***
Road2daMoney: shows [Kc Jh] (a straight, Ten to Ace)
sfarbs: mucks hand=20
Road2daMoney collected 117822 from pot
fkdtshtfkdts [observer] said, "gator wen u bub remember its cuz u mb/ c=
all off 20 bigs utg w 66"
*** SUMMARY ***
Total pot 117822 | Rake 0=20
Board [Ad Qc 6c Tc Qs]
Seat 1: sfarbs (small blind) mucked [7h Qh]
Seat 2: Road2daMoney (big blind) showed [Kc Jh] and won (117822) with a=
 straight, Ten to Ace
Seat 4: LxuryBeatdwn folded before Flop (didn't bet)
Seat 5: JJin91 folded before Flop (didn't bet)
Seat 6: Paceman2jr folded before Flop (didn't bet)
Seat 7: gatorgrinds folded before Flop (didn't bet)
Seat 8: L8terGators folded before Flop (didn't bet)
Seat 9: BCinNY (button) folded before Flop (didn't bet)


*********** # 144 **************
PokerStars Hand #171445448672: Tournament #1648956582, $18.20+$1.80 USD=
 Hold'em No Limit - Level XX (1250/2500) - 2017/06/19 22:31:43 ET
Table '1648956582 2' 9-max Seat #1 is the button
Seat 1: sfarbs (37015 in chips)=20
Seat 2: Road2daMoney (143149 in chips)=20
Seat 5: JJin91 (88242 in chips)=20
Seat 6: Paceman2jr (29630 in chips)=20
Seat 7: gatorgrinds (82946 in chips)=20
Seat 8: L8terGators (73697 in chips)=20
Seat 9: BCinNY (110852 in chips)=20
sfarbs: posts the ante 325
Road2daMoney: posts the ante 325
JJin91: posts the ante 325
Paceman2jr: posts the ante 325
gatorgrinds: posts the ante 325
L8terGators: posts the ante 325
BCinNY: posts the ante 325
Road2daMoney: posts small blind 1250
JJin91: posts big blind 2500
*** HOLE CARDS ***
Dealt to JJin91 [5s Js]
Paceman2jr: folds=20
gatorgrinds: folds=20
L8terGators: folds=20
BCinNY: folds=20
sfarbs: raises 34190 to 36690 and is all-in
Road2daMoney: folds=20
JJin91: folds=20
Uncalled bet (34190) returned to sfarbs
sfarbs collected 8525 from pot
sfarbs: doesn't show hand=20
*** SUMMARY ***
Total pot 8525 | Rake 0=20
Seat 1: sfarbs (button) collected (8525)
Seat 2: Road2daMoney (small blind) folded before Flop
Seat 5: JJin91 (big blind) folded before Flop
Seat 6: Paceman2jr folded before Flop (didn't bet)
Seat 7: gatorgrinds folded before Flop (didn't bet)
Seat 8: L8terGators folded before Flop (didn't bet)
Seat 9: BCinNY folded before Flop (didn't bet)


*********** # 145 **************
PokerStars Hand #171445448822: Tournament #1648956582, $18.20+$1.80 USD=
 Hold'em No Limit - Level XX (1250/2500) - 2017/06/19 22:32:14 ET
Table '1648956582 2' 9-max Seat #2 is the button
Seat 1: sfarbs (42715 in chips)=20
Seat 2: Road2daMoney (141574 in chips)=20
Seat 5: JJin91 (85417 in chips)=20
Seat 6: Paceman2jr (29305 in chips)=20
Seat 7: gatorgrinds (82621 in chips)=20
Seat 8: L8terGators (73372 in chips)=20
Seat 9: BCinNY (110527 in chips)=20
sfarbs: posts the ante 325
Road2daMoney: posts the ante 325
JJin91: posts the ante 325
Paceman2jr: posts the ante 325
gatorgrinds: posts the ante 325
L8terGators: posts the ante 325
BCinNY: posts the ante 325
JJin91: posts small blind 1250
Paceman2jr: posts big blind 2500
*** HOLE CARDS ***
Dealt to JJin91 [5c 9s]
gatorgrinds: folds=20
L8terGators: raises 2600 to 5100
BCinNY: folds=20
sfarbs: folds=20
Road2daMoney: folds=20
JJin91: folds=20
Paceman2jr: calls 2600
*** FLOP *** [8s 3d Js]
Paceman2jr: checks=20
L8terGators: bets 5765
Paceman2jr: calls 5765
*** TURN *** [8s 3d Js] [Th]
Paceman2jr: checks=20
L8terGators: checks=20
*** RIVER *** [8s 3d Js Th] [3s]
Paceman2jr: bets 18115 and is all-in
L8terGators: calls 18115
*** SHOW DOWN ***
Paceman2jr: shows [Ts As] (a flush, Ace high)
L8terGators: shows [9h Qh] (a straight, Eight to Queen)
Paceman2jr collected 61485 from pot
*** SUMMARY ***
Total pot 61485 | Rake 0=20
Board [8s 3d Js Th 3s]
Seat 1: sfarbs folded before Flop (didn't bet)
Seat 2: Road2daMoney (button) folded before Flop (didn't bet)
Seat 5: JJin91 (small blind) folded before Flop
Seat 6: Paceman2jr (big blind) showed [Ts As] and won (61485) with a fl=
ush, Ace high
Seat 7: gatorgrinds folded before Flop (didn't bet)
Seat 8: L8terGators showed [9h Qh] and lost with a straight, Eight to Q=
ueen
Seat 9: BCinNY folded before Flop (didn't bet)


*********** # 146 **************
PokerStars Hand #171445448998: Tournament #1648956582, $18.20+$1.80 USD=
 Hold'em No Limit - Level XX (1250/2500) - 2017/06/19 22:32:47 ET
Table '1648956582 2' 9-max Seat #5 is the button
Seat 1: sfarbs (42390 in chips)=20
Seat 2: Road2daMoney (141249 in chips)=20
Seat 5: JJin91 (83842 in chips)=20
Seat 6: Paceman2jr (61485 in chips)=20
Seat 7: gatorgrinds (82296 in chips)=20
Seat 8: L8terGators (44067 in chips)=20
Seat 9: BCinNY (110202 in chips)=20
sfarbs: posts the ante 325
Road2daMoney: posts the ante 325
JJin91: posts the ante 325
Paceman2jr: posts the ante 325
gatorgrinds: posts the ante 325
L8terGators: posts the ante 325
BCinNY: posts the ante 325
Paceman2jr: posts small blind 1250
gatorgrinds: posts big blind 2500
*** HOLE CARDS ***
Dealt to JJin91 [Td Js]
L8terGators: folds=20
BCinNY: folds=20
sfarbs: folds=20
Road2daMoney: folds=20
JJin91: raises 3925 to 6425
Paceman2jr: folds=20
gatorgrinds: calls 3925
*** FLOP *** [3h Qh 6h]
gatorgrinds: checks=20
JJin91: checks=20
*** TURN *** [3h Qh 6h] [9c]
gatorgrinds: bets 8188
JJin91: calls 8188
*** RIVER *** [3h Qh 6h 9c] [Qc]
gatorgrinds: bets 15000
JJin91: folds=20
Uncalled bet (15000) returned to gatorgrinds
gatorgrinds collected 32751 from pot
gatorgrinds: doesn't show hand=20
*** SUMMARY ***
Total pot 32751 | Rake 0=20
Board [3h Qh 6h 9c Qc]
Seat 1: sfarbs folded before Flop (didn't bet)
Seat 2: Road2daMoney folded before Flop (didn't bet)
Seat 5: JJin91 (button) folded on the River
Seat 6: Paceman2jr (small blind) folded before Flop
Seat 7: gatorgrinds (big blind) collected (32751)
Seat 8: L8terGators folded before Flop (didn't bet)
Seat 9: BCinNY folded before Flop (didn't bet)


*********** # 147 **************
PokerStars Hand #171445449395: Tournament #1648956582, $18.20+$1.80 USD=
 Hold'em No Limit - Level XX (1250/2500) - 2017/06/19 22:34:09 ET
Table '1648956582 2' 9-max Seat #6 is the button
Seat 1: sfarbs (42065 in chips)=20
Seat 2: Road2daMoney (140924 in chips)=20
Seat 5: JJin91 (68904 in chips)=20
Seat 6: Paceman2jr (59910 in chips)=20
Seat 7: gatorgrinds (100109 in chips)=20
Seat 8: L8terGators (43742 in chips)=20
Seat 9: BCinNY (109877 in chips)=20
sfarbs: posts the ante 325
Road2daMoney: posts the ante 325
JJin91: posts the ante 325
Paceman2jr: posts the ante 325
gatorgrinds: posts the ante 325
L8terGators: posts the ante 325
BCinNY: posts the ante 325
gatorgrinds: posts small blind 1250
L8terGators: posts big blind 2500
*** HOLE CARDS ***
Dealt to JJin91 [6d 6h]
BCinNY: calls 2500
sfarbs: folds=20
Road2daMoney: folds=20
JJin91: raises 5277 to 7777
Paceman2jr: folds=20
gatorgrinds: folds=20
L8terGators: folds=20
BCinNY: calls 5277
*** FLOP *** [Ks Qh 6s]
BCinNY: checks=20
JJin91: bets 7984
BCinNY: folds=20
Uncalled bet (7984) returned to JJin91
JJin91 collected 21579 from pot
JJin91: doesn't show hand=20
*** SUMMARY ***
Total pot 21579 | Rake 0=20
Board [Ks Qh 6s]
Seat 1: sfarbs folded before Flop (didn't bet)
Seat 2: Road2daMoney folded before Flop (didn't bet)
Seat 5: JJin91 collected (21579)
Seat 6: Paceman2jr (button) folded before Flop (didn't bet)
Seat 7: gatorgrinds (small blind) folded before Flop
Seat 8: L8terGators (big blind) folded before Flop
Seat 9: BCinNY folded on the Flop


*********** # 148 **************
PokerStars Hand #171445449583: Tournament #1648956582, $18.20+$1.80 USD=
 Hold'em No Limit - Level XX (1250/2500) - 2017/06/19 22:34:46 ET
Table '1648956582 2' 9-max Seat #7 is the button
Seat 1: sfarbs (41740 in chips)=20
Seat 2: Road2daMoney (140599 in chips)=20
Seat 5: JJin91 (82381 in chips)=20
Seat 6: Paceman2jr (59585 in chips)=20
Seat 7: gatorgrinds (98534 in chips)=20
Seat 8: L8terGators (40917 in chips)=20
Seat 9: BCinNY (101775 in chips)=20
sfarbs: posts the ante 325
Road2daMoney: posts the ante 325
JJin91: posts the ante 325
Paceman2jr: posts the ante 325
gatorgrinds: posts the ante 325
L8terGators: posts the ante 325
BCinNY: posts the ante 325
L8terGators: posts small blind 1250
BCinNY: posts big blind 2500
*** HOLE CARDS ***
Dealt to JJin91 [Ks 3s]
sfarbs: folds=20
Road2daMoney: raises 2500 to 5000
JJin91: folds=20
Paceman2jr: folds=20
gatorgrinds: raises 10000 to 15000
L8terGators: folds=20
BCinNY: folds=20
Road2daMoney: folds=20
Uncalled bet (10000) returned to gatorgrinds
gatorgrinds collected 16025 from pot
gatorgrinds: doesn't show hand=20
*** SUMMARY ***
Total pot 16025 | Rake 0=20
Seat 1: sfarbs folded before Flop (didn't bet)
Seat 2: Road2daMoney folded before Flop
Seat 5: JJin91 folded before Flop (didn't bet)
Seat 6: Paceman2jr folded before Flop (didn't bet)
Seat 7: gatorgrinds (button) collected (16025)
Seat 8: L8terGators (small blind) folded before Flop
Seat 9: BCinNY (big blind) folded before Flop


*********** # 149 **************
PokerStars Hand #171445449720: Tournament #1648956582, $18.20+$1.80 USD=
 Hold'em No Limit - Level XX (1250/2500) - 2017/06/19 22:35:15 ET
Table '1648956582 2' 9-max Seat #8 is the button
Seat 1: sfarbs (41415 in chips)=20
Seat 2: Road2daMoney (135274 in chips)=20
Seat 5: JJin91 (82056 in chips)=20
Seat 6: Paceman2jr (59260 in chips)=20
Seat 7: gatorgrinds (109234 in chips)=20
Seat 8: L8terGators (39342 in chips)=20
Seat 9: BCinNY (98950 in chips)=20
sfarbs: posts the ante 325
Road2daMoney: posts the ante 325
JJin91: posts the ante 325
Paceman2jr: posts the ante 325
gatorgrinds: posts the ante 325
L8terGators: posts the ante 325
BCinNY: posts the ante 325
BCinNY: posts small blind 1250
sfarbs: posts big blind 2500
*** HOLE CARDS ***
Dealt to JJin91 [5s 4c]
Road2daMoney: folds=20
JJin91: folds=20
Paceman2jr: folds=20
gatorgrinds: folds=20
L8terGators: raises 36517 to 39017 and is all-in
BCinNY: folds=20
sfarbs: folds=20
Uncalled bet (36517) returned to L8terGators
L8terGators collected 8525 from pot
*** SUMMARY ***
Total pot 8525 | Rake 0=20
Seat 1: sfarbs (big blind) folded before Flop
Seat 2: Road2daMoney folded before Flop (didn't bet)
Seat 5: JJin91 folded before Flop (didn't bet)
Seat 6: Paceman2jr folded before Flop (didn't bet)
Seat 7: gatorgrinds folded before Flop (didn't bet)
Seat 8: L8terGators (button) collected (8525)
Seat 9: BCinNY (small blind) folded before Flop


*********** # 150 **************
PokerStars Hand #171445449788: Tournament #1648956582, $18.20+$1.80 USD=
 Hold'em No Limit - Level XX (1250/2500) - 2017/06/19 22:35:30 ET
Table '1648956582 2' 9-max Seat #9 is the button
Seat 1: sfarbs (38590 in chips)=20
Seat 2: Road2daMoney (134949 in chips)=20
Seat 5: JJin91 (81731 in chips)=20
Seat 6: Paceman2jr (58935 in chips)=20
Seat 7: gatorgrinds (108909 in chips)=20
Seat 8: L8terGators (45042 in chips)=20
Seat 9: BCinNY (97375 in chips)=20
sfarbs: posts the ante 325
Road2daMoney: posts the ante 325
JJin91: posts the ante 325
Paceman2jr: posts the ante 325
gatorgrinds: posts the ante 325
L8terGators: posts the ante 325
BCinNY: posts the ante 325
sfarbs: posts small blind 1250
Road2daMoney: posts big blind 2500
*** HOLE CARDS ***
Dealt to JJin91 [9h 4d]
JJin91: folds=20
Paceman2jr: folds=20
gatorgrinds: raises 3700 to 6200
L8terGators: folds=20
BCinNY: folds=20
sfarbs: folds=20
Road2daMoney: calls 3700
*** FLOP *** [Qd Td Kh]
Road2daMoney: checks=20
gatorgrinds: bets 9500
Road2daMoney: raises 15500 to 25000
gatorgrinds: folds=20
Uncalled bet (15500) returned to Road2daMoney
Road2daMoney collected 34925 from pot
Road2daMoney: doesn't show hand=20
*** SUMMARY ***
Total pot 34925 | Rake 0=20
Board [Qd Td Kh]
Seat 1: sfarbs (small blind) folded before Flop
Seat 2: Road2daMoney (big blind) collected (34925)
Seat 5: JJin91 folded before Flop (didn't bet)
Seat 6: Paceman2jr folded before Flop (didn't bet)
Seat 7: gatorgrinds folded on the Flop
Seat 8: L8terGators folded before Flop (didn't bet)
Seat 9: BCinNY (button) folded before Flop (didn't bet)


*********** # 151 **************
PokerStars Hand #171446029958: Tournament #1648956582, $18.20+$1.80 USD=
 Hold'em No Limit - Level XX (1250/2500) - 2017/06/19 22:36:39 ET
Table '1648956582 2' 9-max Seat #1 is the button
Seat 1: sfarbs (37015 in chips)=20
Seat 2: Road2daMoney (153849 in chips)=20
Seat 5: JJin91 (81406 in chips)=20
Seat 6: Paceman2jr (58610 in chips)=20
Seat 7: gatorgrinds (92884 in chips)=20
Seat 8: L8terGators (44717 in chips)=20
Seat 9: BCinNY (97050 in chips)=20
sfarbs: posts the ante 325
Road2daMoney: posts the ante 325
JJin91: posts the ante 325
Paceman2jr: posts the ante 325
gatorgrinds: posts the ante 325
L8terGators: posts the ante 325
BCinNY: posts the ante 325
Road2daMoney: posts small blind 1250
JJin91: posts big blind 2500
*** HOLE CARDS ***
Dealt to JJin91 [4h Td]
Paceman2jr: folds=20
gatorgrinds: folds=20
L8terGators: folds=20
BCinNY: folds=20
sfarbs: raises 34190 to 36690 and is all-in
Road2daMoney: folds=20
JJin91: folds=20
Uncalled bet (34190) returned to sfarbs
sfarbs collected 8525 from pot
sfarbs: doesn't show hand=20
*** SUMMARY ***
Total pot 8525 | Rake 0=20
Seat 1: sfarbs (button) collected (8525)
Seat 2: Road2daMoney (small blind) folded before Flop
Seat 5: JJin91 (big blind) folded before Flop
Seat 6: Paceman2jr folded before Flop (didn't bet)
Seat 7: gatorgrinds folded before Flop (didn't bet)
Seat 8: L8terGators folded before Flop (didn't bet)
Seat 9: BCinNY folded before Flop (didn't bet)


*********** # 152 **************
PokerStars Hand #171446050151: Tournament #1648956582, $18.20+$1.80 USD=
 Hold'em No Limit - Level XX (1250/2500) - 2017/06/19 22:36:56 ET
Table '1648956582 2' 9-max Seat #2 is the button
Seat 1: sfarbs (42715 in chips)=20
Seat 2: Road2daMoney (152274 in chips)=20
Seat 5: JJin91 (78581 in chips)=20
Seat 6: Paceman2jr (58285 in chips)=20
Seat 7: gatorgrinds (92559 in chips)=20
Seat 8: L8terGators (44392 in chips)=20
Seat 9: BCinNY (96725 in chips)=20
sfarbs: posts the ante 325
Road2daMoney: posts the ante 325
JJin91: posts the ante 325
Paceman2jr: posts the ante 325
gatorgrinds: posts the ante 325
L8terGators: posts the ante 325
BCinNY: posts the ante 325
JJin91: posts small blind 1250
Paceman2jr: posts big blind 2500
*** HOLE CARDS ***
Dealt to JJin91 [9h 5s]
gatorgrinds: folds=20
L8terGators: raises 2500 to 5000
BCinNY: folds=20
sfarbs: folds=20
Road2daMoney: folds=20
JJin91: folds=20
Paceman2jr: raises 13525 to 18525
L8terGators: folds=20
Uncalled bet (13525) returned to Paceman2jr
Paceman2jr collected 13525 from pot
*** SUMMARY ***
Total pot 13525 | Rake 0=20
Seat 1: sfarbs folded before Flop (didn't bet)
Seat 2: Road2daMoney (button) folded before Flop (didn't bet)
Seat 5: JJin91 (small blind) folded before Flop
Seat 6: Paceman2jr (big blind) collected (13525)
Seat 7: gatorgrinds folded before Flop (didn't bet)
Seat 8: L8terGators folded before Flop
Seat 9: BCinNY folded before Flop (didn't bet)


*********** # 153 **************
PokerStars Hand #171446050327: Tournament #1648956582, $18.20+$1.80 USD=
 Hold'em No Limit - Level XX (1250/2500) - 2017/06/19 22:37:30 ET
Table '1648956582 2' 9-max Seat #5 is the button
Seat 1: sfarbs (42390 in chips)=20
Seat 2: Road2daMoney (151949 in chips)=20
Seat 3: Decklyn71 (42930 in chips)=20
Seat 4: DebOCNJ (151012 in chips)=20
Seat 5: JJin91 (77006 in chips)=20
Seat 6: Paceman2jr (66485 in chips)=20
Seat 7: gatorgrinds (92234 in chips)=20
Seat 8: L8terGators (39067 in chips)=20
Seat 9: BCinNY (96400 in chips)=20
sfarbs: posts the ante 325
Road2daMoney: posts the ante 325
Decklyn71: posts the ante 325
DebOCNJ: posts the ante 325
JJin91: posts the ante 325
Paceman2jr: posts the ante 325
gatorgrinds: posts the ante 325
L8terGators: posts the ante 325
BCinNY: posts the ante 325
Paceman2jr: posts small blind 1250
gatorgrinds: posts big blind 2500
*** HOLE CARDS ***
Dealt to JJin91 [8s 6h]
L8terGators: raises 2500 to 5000
BCinNY: folds=20
sfarbs: folds=20
Road2daMoney: folds=20
Decklyn71: folds=20
DebOCNJ: folds=20
JJin91: folds=20
Paceman2jr: folds=20
gatorgrinds: calls 2500
*** FLOP *** [6s 2c 6c]
gatorgrinds: checks=20
L8terGators: bets 5900
gatorgrinds: folds=20
Uncalled bet (5900) returned to L8terGators
L8terGators collected 14175 from pot
L8terGators: doesn't show hand=20
*** SUMMARY ***
Total pot 14175 | Rake 0=20
Board [6s 2c 6c]
Seat 1: sfarbs folded before Flop (didn't bet)
Seat 2: Road2daMoney folded before Flop (didn't bet)
Seat 3: Decklyn71 folded before Flop (didn't bet)
Seat 4: DebOCNJ folded before Flop (didn't bet)
Seat 5: JJin91 (button) folded before Flop (didn't bet)
Seat 6: Paceman2jr (small blind) folded before Flop
Seat 7: gatorgrinds (big blind) folded on the Flop
Seat 8: L8terGators collected (14175)
Seat 9: BCinNY folded before Flop (didn't bet)


*********** # 154 **************
PokerStars Hand #171446050494: Tournament #1648956582, $18.20+$1.80 USD=
 Hold'em No Limit - Level XX (1250/2500) - 2017/06/19 22:38:09 ET
Table '1648956582 2' 9-max Seat #6 is the button
Seat 1: sfarbs (42065 in chips)=20
Seat 2: Road2daMoney (151624 in chips)=20
Seat 3: Decklyn71 (42605 in chips)=20
Seat 4: DebOCNJ (150687 in chips)=20
Seat 5: JJin91 (76681 in chips)=20
Seat 6: Paceman2jr (64910 in chips)=20
Seat 7: gatorgrinds (86909 in chips)=20
Seat 8: L8terGators (47917 in chips)=20
Seat 9: BCinNY (96075 in chips)=20
sfarbs: posts the ante 325
Road2daMoney: posts the ante 325
Decklyn71: posts the ante 325
DebOCNJ: posts the ante 325
JJin91: posts the ante 325
Paceman2jr: posts the ante 325
gatorgrinds: posts the ante 325
L8terGators: posts the ante 325
BCinNY: posts the ante 325
gatorgrinds: posts small blind 1250
L8terGators: posts big blind 2500
*** HOLE CARDS ***
Dealt to JJin91 [Ks 6c]
BCinNY: folds=20
sfarbs: raises 39240 to 41740 and is all-in
Road2daMoney: folds=20
Decklyn71: folds=20
DebOCNJ: folds=20
JJin91: folds=20
Paceman2jr: folds=20
gatorgrinds: folds=20
L8terGators: folds=20
Uncalled bet (39240) returned to sfarbs
sfarbs collected 9175 from pot
sfarbs: doesn't show hand=20
*** SUMMARY ***
Total pot 9175 | Rake 0=20
Seat 1: sfarbs collected (9175)
Seat 2: Road2daMoney folded before Flop (didn't bet)
Seat 3: Decklyn71 folded before Flop (didn't bet)
Seat 4: DebOCNJ folded before Flop (didn't bet)
Seat 5: JJin91 folded before Flop (didn't bet)
Seat 6: Paceman2jr (button) folded before Flop (didn't bet)
Seat 7: gatorgrinds (small blind) folded before Flop
Seat 8: L8terGators (big blind) folded before Flop
Seat 9: BCinNY folded before Flop (didn't bet)


*********** # 155 **************
PokerStars Hand #171446050591: Tournament #1648956582, $18.20+$1.80 USD=
 Hold'em No Limit - Level XXI (1500/3000) - 2017/06/19 22:38:31 ET
Table '1648956582 2' 9-max Seat #7 is the button
Seat 1: sfarbs (48415 in chips)=20
Seat 2: Road2daMoney (151299 in chips)=20
Seat 3: Decklyn71 (42280 in chips)=20
Seat 4: DebOCNJ (150362 in chips)=20
Seat 5: JJin91 (76356 in chips)=20
Seat 6: Paceman2jr (64585 in chips)=20
Seat 7: gatorgrinds (85334 in chips)=20
Seat 8: L8terGators (45092 in chips)=20
Seat 9: BCinNY (95750 in chips)=20
sfarbs: posts the ante 375
Road2daMoney: posts the ante 375
Decklyn71: posts the ante 375
DebOCNJ: posts the ante 375
JJin91: posts the ante 375
Paceman2jr: posts the ante 375
gatorgrinds: posts the ante 375
L8terGators: posts the ante 375
BCinNY: posts the ante 375
L8terGators: posts small blind 1500
BCinNY: posts big blind 3000
*** HOLE CARDS ***
Dealt to JJin91 [9s Kh]
sfarbs: folds=20
Road2daMoney: folds=20
Decklyn71: folds=20
DebOCNJ: folds=20
JJin91: folds=20
Paceman2jr: folds=20
gatorgrinds: folds=20
L8terGators: raises 41717 to 44717 and is all-in
BCinNY: folds=20
Uncalled bet (41717) returned to L8terGators
L8terGators collected 9375 from pot
L8terGators: doesn't show hand=20
*** SUMMARY ***
Total pot 9375 | Rake 0=20
Seat 1: sfarbs folded before Flop (didn't bet)
Seat 2: Road2daMoney folded before Flop (didn't bet)
Seat 3: Decklyn71 folded before Flop (didn't bet)
Seat 4: DebOCNJ folded before Flop (didn't bet)
Seat 5: JJin91 folded before Flop (didn't bet)
Seat 6: Paceman2jr folded before Flop (didn't bet)
Seat 7: gatorgrinds (button) folded before Flop (didn't bet)
Seat 8: L8terGators (small blind) collected (9375)
Seat 9: BCinNY (big blind) folded before Flop


*********** # 156 **************
PokerStars Hand #171446050677: Tournament #1648956582, $18.20+$1.80 USD=
 Hold'em No Limit - Level XXI (1500/3000) - 2017/06/19 22:38:49 ET
Table '1648956582 2' 9-max Seat #8 is the button
Seat 1: sfarbs (48040 in chips)=20
Seat 2: Road2daMoney (150924 in chips)=20
Seat 3: Decklyn71 (41905 in chips)=20
Seat 4: DebOCNJ (149987 in chips)=20
Seat 5: JJin91 (75981 in chips)=20
Seat 6: Paceman2jr (64210 in chips)=20
Seat 7: gatorgrinds (84959 in chips)=20
Seat 8: L8terGators (51092 in chips)=20
Seat 9: BCinNY (92375 in chips)=20
sfarbs: posts the ante 375
Road2daMoney: posts the ante 375
Decklyn71: posts the ante 375
DebOCNJ: posts the ante 375
JJin91: posts the ante 375
Paceman2jr: posts the ante 375
gatorgrinds: posts the ante 375
L8terGators: posts the ante 375
BCinNY: posts the ante 375
BCinNY: posts small blind 1500
sfarbs: posts big blind 3000
*** HOLE CARDS ***
Dealt to JJin91 [9c 3s]
Road2daMoney: raises 3000 to 6000
Decklyn71: folds=20
DebOCNJ: folds=20
JJin91: folds=20
Paceman2jr: folds=20
gatorgrinds: folds=20
L8terGators: folds=20
BCinNY: folds=20
sfarbs: calls 3000
*** FLOP *** [Qh Qd 2h]
sfarbs: checks=20
Road2daMoney: checks=20
*** TURN *** [Qh Qd 2h] [Js]
sfarbs: checks=20
Road2daMoney: bets 5738
sfarbs: folds=20
Uncalled bet (5738) returned to Road2daMoney
Road2daMoney collected 16875 from pot
Road2daMoney: doesn't show hand=20
*** SUMMARY ***
Total pot 16875 | Rake 0=20
Board [Qh Qd 2h Js]
Seat 1: sfarbs (big blind) folded on the Turn
Seat 2: Road2daMoney collected (16875)
Seat 3: Decklyn71 folded before Flop (didn't bet)
Seat 4: DebOCNJ folded before Flop (didn't bet)
Seat 5: JJin91 folded before Flop (didn't bet)
Seat 6: Paceman2jr folded before Flop (didn't bet)
Seat 7: gatorgrinds folded before Flop (didn't bet)
Seat 8: L8terGators (button) folded before Flop (didn't bet)
Seat 9: BCinNY (small blind) folded before Flop


*********** # 157 **************
PokerStars Hand #171446050853: Tournament #1648956582, $18.20+$1.80 USD=
 Hold'em No Limit - Level XXI (1500/3000) - 2017/06/19 22:39:28 ET
Table '1648956582 2' 9-max Seat #9 is the button
Seat 1: sfarbs (41665 in chips)=20
Seat 2: Road2daMoney (161424 in chips)=20
Seat 3: Decklyn71 (41530 in chips)=20
Seat 4: DebOCNJ (149612 in chips)=20
Seat 5: JJin91 (75606 in chips)=20
Seat 6: Paceman2jr (63835 in chips)=20
Seat 7: gatorgrinds (84584 in chips)=20
Seat 8: L8terGators (50717 in chips)=20
Seat 9: BCinNY (90500 in chips)=20
sfarbs: posts the ante 375
Road2daMoney: posts the ante 375
Decklyn71: posts the ante 375
DebOCNJ: posts the ante 375
JJin91: posts the ante 375
Paceman2jr: posts the ante 375
gatorgrinds: posts the ante 375
L8terGators: posts the ante 375
BCinNY: posts the ante 375
sfarbs: posts small blind 1500
Road2daMoney: posts big blind 3000
*** HOLE CARDS ***
Dealt to JJin91 [Ah As]
Decklyn71: folds=20
DebOCNJ: folds=20
JJin91: raises 3570 to 6570
Paceman2jr: folds=20
gatorgrinds: folds=20
L8terGators: folds=20
BCinNY: folds=20
sfarbs: folds=20
Road2daMoney: raises 11430 to 18000
JJin91: raises 19777 to 37777
Road2daMoney: raises 123272 to 161049 and is all-in
JJin91: calls 37454 and is all-in
Uncalled bet (85818) returned to Road2daMoney
*** FLOP *** [Tc 2s 5s]
*** TURN *** [Tc 2s 5s] [2c]
*** RIVER *** [Tc 2s 5s 2c] [4d]
*** SHOW DOWN ***
Road2daMoney: shows [Jh Jd] (two pair, Jacks and Deuces)
JJin91: shows [Ah As] (two pair, Aces and Deuces)
JJin91 collected 155337 from pot
*** SUMMARY ***
Total pot 155337 | Rake 0=20
Board [Tc 2s 5s 2c 4d]
Seat 1: sfarbs (small blind) folded before Flop
Seat 2: Road2daMoney (big blind) showed [Jh Jd] and lost with two pair,=
 Jacks and Deuces
Seat 3: Decklyn71 folded before Flop (didn't bet)
Seat 4: DebOCNJ folded before Flop (didn't bet)
Seat 5: JJin91 showed [Ah As] and won (155337) with two pair, Aces and =
Deuces
Seat 6: Paceman2jr folded before Flop (didn't bet)
Seat 7: gatorgrinds folded before Flop (didn't bet)
Seat 8: L8terGators folded before Flop (didn't bet)
Seat 9: BCinNY (button) folded before Flop (didn't bet)


*********** # 158 **************
PokerStars Hand #171446051392: Tournament #1648956582, $18.20+$1.80 USD=
 Hold'em No Limit - Level XXI (1500/3000) - 2017/06/19 22:41:25 ET
Table '1648956582 2' 9-max Seat #1 is the button
Seat 1: sfarbs (39790 in chips)=20
Seat 2: Road2daMoney (85818 in chips)=20
Seat 3: Decklyn71 (41155 in chips)=20
Seat 4: DebOCNJ (149237 in chips)=20
Seat 5: JJin91 (155337 in chips)=20
Seat 6: Paceman2jr (63460 in chips)=20
Seat 7: gatorgrinds (84209 in chips)=20
Seat 8: L8terGators (50342 in chips)=20
Seat 9: BCinNY (90125 in chips)=20
sfarbs: posts the ante 375
Road2daMoney: posts the ante 375
Decklyn71: posts the ante 375
DebOCNJ: posts the ante 375
JJin91: posts the ante 375
Paceman2jr: posts the ante 375
gatorgrinds: posts the ante 375
L8terGators: posts the ante 375
BCinNY: posts the ante 375
Road2daMoney: posts small blind 1500
Decklyn71: posts big blind 3000
*** HOLE CARDS ***
Dealt to JJin91 [4c Jd]
DebOCNJ: folds=20
JJin91: folds=20
Paceman2jr: calls 3000
gatorgrinds: calls 3000
L8terGators: folds=20
BCinNY: folds=20
sfarbs: raises 36415 to 39415 and is all-in
Road2daMoney: raises 46028 to 85443 and is all-in
Decklyn71: folds=20
Paceman2jr: folds=20
gatorgrinds: folds=20
Uncalled bet (46028) returned to Road2daMoney
*** FLOP *** [2d 7c 6d]
*** TURN *** [2d 7c 6d] [4d]
*** RIVER *** [2d 7c 6d 4d] [6s]
*** SHOW DOWN ***
Road2daMoney: shows [As Th] (a pair of Sixes)
sfarbs: shows [2h 2c] (a full house, Deuces full of Sixes)
sfarbs collected 91205 from pot
*** SUMMARY ***
Total pot 91205 | Rake 0=20
Board [2d 7c 6d 4d 6s]
Seat 1: sfarbs (button) showed [2h 2c] and won (91205) with a full hous=
e, Deuces full of Sixes
Seat 2: Road2daMoney (small blind) showed [As Th] and lost with a pair =
of Sixes
Seat 3: Decklyn71 (big blind) folded before Flop
Seat 4: DebOCNJ folded before Flop (didn't bet)
Seat 5: JJin91 folded before Flop (didn't bet)
Seat 6: Paceman2jr folded before Flop
Seat 7: gatorgrinds folded before Flop
Seat 8: L8terGators folded before Flop (didn't bet)
Seat 9: BCinNY folded before Flop (didn't bet)


*********** # 159 **************
PokerStars Hand #171446051729: Tournament #1648956582, $18.20+$1.80 USD=
 Hold'em No Limit - Level XXI (1500/3000) - 2017/06/19 22:42:38 ET
Table '1648956582 2' 9-max Seat #2 is the button
Seat 1: sfarbs (91205 in chips)=20
Seat 2: Road2daMoney (46028 in chips)=20
Seat 3: Decklyn71 (37780 in chips)=20
Seat 4: DebOCNJ (148862 in chips)=20
Seat 5: JJin91 (154962 in chips)=20
Seat 6: Paceman2jr (60085 in chips)=20
Seat 7: gatorgrinds (80834 in chips)=20
Seat 8: L8terGators (49967 in chips)=20
Seat 9: BCinNY (89750 in chips)=20
sfarbs: posts the ante 375
Road2daMoney: posts the ante 375
Decklyn71: posts the ante 375
DebOCNJ: posts the ante 375
JJin91: posts the ante 375
Paceman2jr: posts the ante 375
gatorgrinds: posts the ante 375
L8terGators: posts the ante 375
BCinNY: posts the ante 375
Decklyn71: posts small blind 1500
DebOCNJ: posts big blind 3000
*** HOLE CARDS ***
Dealt to JJin91 [Ks Td]
JJin91: folds=20
Paceman2jr: folds=20
gatorgrinds: folds=20
L8terGators: folds=20
BCinNY: folds=20
sfarbs: folds=20
Road2daMoney: raises 42653 to 45653 and is all-in
Decklyn71: folds=20
DebOCNJ: folds=20
Uncalled bet (42653) returned to Road2daMoney
Road2daMoney collected 10875 from pot
Road2daMoney: doesn't show hand=20
*** SUMMARY ***
Total pot 10875 | Rake 0=20
Seat 1: sfarbs folded before Flop (didn't bet)
Seat 2: Road2daMoney (button) collected (10875)
Seat 3: Decklyn71 (small blind) folded before Flop
Seat 4: DebOCNJ (big blind) folded before Flop
Seat 5: JJin91 folded before Flop (didn't bet)
Seat 6: Paceman2jr folded before Flop (didn't bet)
Seat 7: gatorgrinds folded before Flop (didn't bet)
Seat 8: L8terGators folded before Flop (didn't bet)
Seat 9: BCinNY folded before Flop (didn't bet)


*********** # 160 **************
PokerStars Hand #171446051848: Tournament #1648956582, $18.20+$1.80 USD=
 Hold'em No Limit - Level XXI (1500/3000) - 2017/06/19 22:43:06 ET
Table '1648956582 2' 9-max Seat #3 is the button
Seat 1: sfarbs (90830 in chips)=20
Seat 2: Road2daMoney (53528 in chips)=20
Seat 3: Decklyn71 (35905 in chips)=20
Seat 4: DebOCNJ (145487 in chips)=20
Seat 5: JJin91 (154587 in chips)=20
Seat 6: Paceman2jr (59710 in chips)=20
Seat 7: gatorgrinds (80459 in chips)=20
Seat 8: L8terGators (49592 in chips)=20
Seat 9: BCinNY (89375 in chips)=20
sfarbs: posts the ante 375
Road2daMoney: posts the ante 375
Decklyn71: posts the ante 375
DebOCNJ: posts the ante 375
JJin91: posts the ante 375
Paceman2jr: posts the ante 375
gatorgrinds: posts the ante 375
L8terGators: posts the ante 375
BCinNY: posts the ante 375
DebOCNJ: posts small blind 1500
JJin91: posts big blind 3000
*** HOLE CARDS ***
Dealt to JJin91 [8d 3s]
Paceman2jr: folds=20
gatorgrinds: folds=20
L8terGators: folds=20
BCinNY: folds=20
sfarbs: raises 3690 to 6690
Road2daMoney: folds=20
Decklyn71: folds=20
DebOCNJ: folds=20
JJin91: folds=20
Uncalled bet (3690) returned to sfarbs
sfarbs collected 10875 from pot
sfarbs: doesn't show hand=20
*** SUMMARY ***
Total pot 10875 | Rake 0=20
Seat 1: sfarbs collected (10875)
Seat 2: Road2daMoney folded before Flop (didn't bet)
Seat 3: Decklyn71 (button) folded before Flop (didn't bet)
Seat 4: DebOCNJ (small blind) folded before Flop
Seat 5: JJin91 (big blind) folded before Flop
Seat 6: Paceman2jr folded before Flop (didn't bet)
Seat 7: gatorgrinds folded before Flop (didn't bet)
Seat 8: L8terGators folded before Flop (didn't bet)
Seat 9: BCinNY folded before Flop (didn't bet)


*********** # 161 **************
PokerStars Hand #171446052044: Tournament #1648956582, $18.20+$1.80 USD=
 Hold'em No Limit - Level XXI (1500/3000) - 2017/06/19 22:43:51 ET
Table '1648956582 2' 9-max Seat #4 is the button
Seat 1: sfarbs (98330 in chips)=20
Seat 2: Road2daMoney (53153 in chips)=20
Seat 3: Decklyn71 (35530 in chips)=20
Seat 4: DebOCNJ (143612 in chips)=20
Seat 5: JJin91 (151212 in chips)=20
Seat 6: Paceman2jr (59335 in chips)=20
Seat 7: gatorgrinds (80084 in chips)=20
Seat 8: L8terGators (49217 in chips)=20
Seat 9: BCinNY (89000 in chips)=20
sfarbs: posts the ante 375
Road2daMoney: posts the ante 375
Decklyn71: posts the ante 375
DebOCNJ: posts the ante 375
JJin91: posts the ante 375
Paceman2jr: posts the ante 375
gatorgrinds: posts the ante 375
L8terGators: posts the ante 375
BCinNY: posts the ante 375
JJin91: posts small blind 1500
Paceman2jr: posts big blind 3000
*** HOLE CARDS ***
Dealt to JJin91 [Ad 4d]
gatorgrinds: folds=20
L8terGators: raises 3000 to 6000
BCinNY: folds=20
sfarbs: folds=20
Road2daMoney: folds=20
Decklyn71: folds=20
DebOCNJ: folds=20
JJin91: calls 4500
Paceman2jr: raises 52960 to 58960 and is all-in
L8terGators: folds=20
JJin91: folds=20
Uncalled bet (52960) returned to Paceman2jr
Paceman2jr collected 21375 from pot
*** SUMMARY ***
Total pot 21375 | Rake 0=20
Seat 1: sfarbs folded before Flop (didn't bet)
Seat 2: Road2daMoney folded before Flop (didn't bet)
Seat 3: Decklyn71 folded before Flop (didn't bet)
Seat 4: DebOCNJ (button) folded before Flop (didn't bet)
Seat 5: JJin91 (small blind) folded before Flop
Seat 6: Paceman2jr (big blind) collected (21375)
Seat 7: gatorgrinds folded before Flop (didn't bet)
Seat 8: L8terGators folded before Flop
Seat 9: BCinNY folded before Flop (didn't bet)


*********** # 162 **************
PokerStars Hand #171446052251: Tournament #1648956582, $18.20+$1.80 USD=
 Hold'em No Limit - Level XXI (1500/3000) - 2017/06/19 22:44:31 ET
Table '1648956582 2' 9-max Seat #5 is the button
Seat 1: sfarbs (97955 in chips)=20
Seat 2: Road2daMoney (52778 in chips)=20
Seat 3: Decklyn71 (35155 in chips)=20
Seat 4: DebOCNJ (143237 in chips)=20
Seat 5: JJin91 (144837 in chips)=20
Seat 6: Paceman2jr (74335 in chips)=20
Seat 7: gatorgrinds (79709 in chips)=20
Seat 8: L8terGators (42842 in chips)=20
Seat 9: BCinNY (88625 in chips)=20
sfarbs: posts the ante 375
Road2daMoney: posts the ante 375
Decklyn71: posts the ante 375
DebOCNJ: posts the ante 375
JJin91: posts the ante 375
Paceman2jr: posts the ante 375
gatorgrinds: posts the ante 375
L8terGators: posts the ante 375
BCinNY: posts the ante 375
Paceman2jr: posts small blind 1500
gatorgrinds: posts big blind 3000
*** HOLE CARDS ***
Dealt to JJin91 [Qd 8c]
L8terGators: folds=20
BCinNY: folds=20
sfarbs: folds=20
Road2daMoney: folds=20
Decklyn71: raises 31780 to 34780 and is all-in
DebOCNJ: folds=20
JJin91: folds=20
Paceman2jr: folds=20
gatorgrinds: folds=20
Uncalled bet (31780) returned to Decklyn71
Decklyn71 collected 10875 from pot
Decklyn71: doesn't show hand=20
*** SUMMARY ***
Total pot 10875 | Rake 0=20
Seat 1: sfarbs folded before Flop (didn't bet)
Seat 2: Road2daMoney folded before Flop (didn't bet)
Seat 3: Decklyn71 collected (10875)
Seat 4: DebOCNJ folded before Flop (didn't bet)
Seat 5: JJin91 (button) folded before Flop (didn't bet)
Seat 6: Paceman2jr (small blind) folded before Flop
Seat 7: gatorgrinds (big blind) folded before Flop
Seat 8: L8terGators folded before Flop (didn't bet)
Seat 9: BCinNY folded before Flop (didn't bet)


*********** # 163 **************
PokerStars Hand #171446052347: Tournament #1648956582, $18.20+$1.80 USD=
 Hold'em No Limit - Level XXI (1500/3000) - 2017/06/19 22:44:52 ET
Table '1648956582 2' 9-max Seat #6 is the button
Seat 1: sfarbs (97580 in chips)=20
Seat 2: Road2daMoney (52403 in chips)=20
Seat 3: Decklyn71 (42655 in chips)=20
Seat 4: DebOCNJ (142862 in chips)=20
Seat 5: JJin91 (144462 in chips)=20
Seat 6: Paceman2jr (72460 in chips)=20
Seat 7: gatorgrinds (76334 in chips)=20
Seat 8: L8terGators (42467 in chips)=20
Seat 9: BCinNY (88250 in chips)=20
sfarbs: posts the ante 375
Road2daMoney: posts the ante 375
Decklyn71: posts the ante 375
DebOCNJ: posts the ante 375
JJin91: posts the ante 375
Paceman2jr: posts the ante 375
gatorgrinds: posts the ante 375
L8terGators: posts the ante 375
BCinNY: posts the ante 375
gatorgrinds: posts small blind 1500
L8terGators: posts big blind 3000
*** HOLE CARDS ***
Dealt to JJin91 [6d Kc]
BCinNY: folds=20
sfarbs: folds=20
Road2daMoney: folds=20
Decklyn71: folds=20
DebOCNJ: folds=20
JJin91: folds=20
Paceman2jr: folds=20
gatorgrinds: folds=20
Uncalled bet (1500) returned to L8terGators
L8terGators collected 6375 from pot
*** SUMMARY ***
Total pot 6375 | Rake 0=20
Seat 1: sfarbs folded before Flop (didn't bet)
Seat 2: Road2daMoney folded before Flop (didn't bet)
Seat 3: Decklyn71 folded before Flop (didn't bet)
Seat 4: DebOCNJ folded before Flop (didn't bet)
Seat 5: JJin91 folded before Flop (didn't bet)
Seat 6: Paceman2jr (button) folded before Flop (didn't bet)
Seat 7: gatorgrinds (small blind) folded before Flop
Seat 8: L8terGators (big blind) collected (6375)
Seat 9: BCinNY folded before Flop (didn't bet)


*********** # 164 **************
PokerStars Hand #171446052454: Tournament #1648956582, $18.20+$1.80 USD=
 Hold'em No Limit - Level XXI (1500/3000) - 2017/06/19 22:45:19 ET
Table '1648956582 2' 9-max Seat #7 is the button
Seat 1: sfarbs (97205 in chips)=20
Seat 2: Road2daMoney (52028 in chips)=20
Seat 3: Decklyn71 (42280 in chips)=20
Seat 4: DebOCNJ (142487 in chips)=20
Seat 5: JJin91 (144087 in chips)=20
Seat 6: Paceman2jr (72085 in chips)=20
Seat 7: gatorgrinds (74459 in chips)=20
Seat 8: L8terGators (46967 in chips)=20
Seat 9: BCinNY (87875 in chips)=20
sfarbs: posts the ante 375
Road2daMoney: posts the ante 375
Decklyn71: posts the ante 375
DebOCNJ: posts the ante 375
JJin91: posts the ante 375
Paceman2jr: posts the ante 375
gatorgrinds: posts the ante 375
L8terGators: posts the ante 375
BCinNY: posts the ante 375
L8terGators: posts small blind 1500
BCinNY: posts big blind 3000
*** HOLE CARDS ***
Dealt to JJin91 [6d 3s]
sfarbs: folds=20
Road2daMoney: folds=20
Decklyn71: folds=20
DebOCNJ: calls 3000
JJin91: folds=20
Paceman2jr: calls 3000
gatorgrinds: folds=20
L8terGators: calls 1500
BCinNY: checks=20
*** FLOP *** [3d 5s 8s]
L8terGators: checks=20
BCinNY: checks=20
DebOCNJ: bets 7688
Paceman2jr: folds=20
L8terGators: folds=20
BCinNY: folds=20
Uncalled bet (7688) returned to DebOCNJ
DebOCNJ collected 15375 from pot
DebOCNJ: doesn't show hand=20
*** SUMMARY ***
Total pot 15375 | Rake 0=20
Board [3d 5s 8s]
Seat 1: sfarbs folded before Flop (didn't bet)
Seat 2: Road2daMoney folded before Flop (didn't bet)
Seat 3: Decklyn71 folded before Flop (didn't bet)
Seat 4: DebOCNJ collected (15375)
Seat 5: JJin91 folded before Flop (didn't bet)
Seat 6: Paceman2jr folded on the Flop
Seat 7: gatorgrinds (button) folded before Flop (didn't bet)
Seat 8: L8terGators (small blind) folded on the Flop
Seat 9: BCinNY (big blind) folded on the Flop


*********** # 165 **************
PokerStars Hand #171446052589: Tournament #1648956582, $18.20+$1.80 USD=
 Hold'em No Limit - Level XXI (1500/3000) - 2017/06/19 22:45:50 ET
Table '1648956582 2' 9-max Seat #8 is the button
Seat 1: sfarbs (96830 in chips)=20
Seat 2: Road2daMoney (51653 in chips)=20
Seat 3: Decklyn71 (41905 in chips)=20
Seat 4: DebOCNJ (154487 in chips)=20
Seat 5: JJin91 (143712 in chips)=20
Seat 6: Paceman2jr (68710 in chips)=20
Seat 7: gatorgrinds (74084 in chips)=20
Seat 8: L8terGators (43592 in chips)=20
Seat 9: BCinNY (84500 in chips)=20
sfarbs: posts the ante 375
Road2daMoney: posts the ante 375
Decklyn71: posts the ante 375
DebOCNJ: posts the ante 375
JJin91: posts the ante 375
Paceman2jr: posts the ante 375
gatorgrinds: posts the ante 375
L8terGators: posts the ante 375
BCinNY: posts the ante 375
BCinNY: posts small blind 1500
sfarbs: posts big blind 3000
*** HOLE CARDS ***
Dealt to JJin91 [Jd Js]
Road2daMoney: raises 48278 to 51278 and is all-in
Decklyn71: folds=20
DebOCNJ: folds=20
JJin91: calls 51278
Paceman2jr: folds=20
gatorgrinds: folds=20
L8terGators: folds=20
BCinNY: folds=20
sfarbs: folds=20
*** FLOP *** [4c Jh 7c]
*** TURN *** [4c Jh 7c] [4d]
*** RIVER *** [4c Jh 7c 4d] [2h]
*** SHOW DOWN ***
Road2daMoney: shows [Jc Ac] (two pair, Jacks and Fours)
JJin91: shows [Jd Js] (a full house, Jacks full of Fours)
JJin91 collected 110431 from pot
Road2daMoney finished the tournament in 18th place and received $35.94.
*** SUMMARY ***
Total pot 110431 | Rake 0=20
Board [4c Jh 7c 4d 2h]
Seat 1: sfarbs (big blind) folded before Flop
Seat 2: Road2daMoney showed [Jc Ac] and lost with two pair, Jacks and F=
ours
Seat 3: Decklyn71 folded before Flop (didn't bet)
Seat 4: DebOCNJ folded before Flop (didn't bet)
Seat 5: JJin91 showed [Jd Js] and won (110431) with a full house, Jacks=
 full of Fours
Seat 6: Paceman2jr folded before Flop (didn't bet)
Seat 7: gatorgrinds folded before Flop (didn't bet)
Seat 8: L8terGators (button) folded before Flop (didn't bet)
Seat 9: BCinNY (small blind) folded before Flop


*********** # 166 **************
PokerStars Hand #171446052713: Tournament #1648956582, $18.20+$1.80 USD=
 Hold'em No Limit - Level XXI (1500/3000) - 2017/06/19 22:46:16 ET
Table '1648956582 2' 9-max Seat #9 is the button
Seat 1: sfarbs (93455 in chips)=20
Seat 3: Decklyn71 (41530 in chips)=20
Seat 4: DebOCNJ (154112 in chips)=20
Seat 5: JJin91 (202490 in chips)=20
Seat 6: Paceman2jr (68335 in chips)=20
Seat 7: gatorgrinds (73709 in chips)=20
Seat 8: L8terGators (43217 in chips)=20
Seat 9: BCinNY (82625 in chips)=20
sfarbs: posts the ante 375
Decklyn71: posts the ante 375
DebOCNJ: posts the ante 375
JJin91: posts the ante 375
Paceman2jr: posts the ante 375
gatorgrinds: posts the ante 375
L8terGators: posts the ante 375
BCinNY: posts the ante 375
sfarbs: posts small blind 1500
Decklyn71: posts big blind 3000
*** HOLE CARDS ***
Dealt to JJin91 [8d Qc]
DebOCNJ: folds=20
JJin91: folds=20
Paceman2jr: folds=20
gatorgrinds: folds=20
L8terGators: folds=20
BCinNY: folds=20
sfarbs: folds=20
Uncalled bet (1500) returned to Decklyn71
Decklyn71 collected 6000 from pot
Decklyn71: doesn't show hand=20
*** SUMMARY ***
Total pot 6000 | Rake 0=20
Seat 1: sfarbs (small blind) folded before Flop
Seat 3: Decklyn71 (big blind) collected (6000)
Seat 4: DebOCNJ folded before Flop (didn't bet)
Seat 5: JJin91 folded before Flop (didn't bet)
Seat 6: Paceman2jr folded before Flop (didn't bet)
Seat 7: gatorgrinds folded before Flop (didn't bet)
Seat 8: L8terGators folded before Flop (didn't bet)
Seat 9: BCinNY (button) folded before Flop (didn't bet)


*********** # 167 **************
PokerStars Hand #171446052798: Tournament #1648956582, $18.20+$1.80 USD=
 Hold'em No Limit - Level XXI (1500/3000) - 2017/06/19 22:46:31 ET
Table '1648956582 2' 9-max Seat #1 is the button
Seat 1: sfarbs (91580 in chips)=20
Seat 3: Decklyn71 (45655 in chips)=20
Seat 4: DebOCNJ (153737 in chips)=20
Seat 5: JJin91 (202115 in chips)=20
Seat 6: Paceman2jr (67960 in chips)=20
Seat 7: gatorgrinds (73334 in chips)=20
Seat 8: L8terGators (42842 in chips)=20
Seat 9: BCinNY (82250 in chips)=20
sfarbs: posts the ante 375
Decklyn71: posts the ante 375
DebOCNJ: posts the ante 375
JJin91: posts the ante 375
Paceman2jr: posts the ante 375
gatorgrinds: posts the ante 375
L8terGators: posts the ante 375
BCinNY: posts the ante 375
Decklyn71: posts small blind 1500
DebOCNJ: posts big blind 3000
*** HOLE CARDS ***
Dealt to JJin91 [As Kd]
JJin91: raises 4710 to 7710
Paceman2jr: folds=20
gatorgrinds: folds=20
L8terGators: folds=20
BCinNY: folds=20
sfarbs: folds=20
Decklyn71: folds=20
DebOCNJ: folds=20
Uncalled bet (4710) returned to JJin91
JJin91 collected 10500 from pot
JJin91: doesn't show hand=20
*** SUMMARY ***
Total pot 10500 | Rake 0=20
Seat 1: sfarbs (button) folded before Flop (didn't bet)
Seat 3: Decklyn71 (small blind) folded before Flop
Seat 4: DebOCNJ (big blind) folded before Flop
Seat 5: JJin91 collected (10500)
Seat 6: Paceman2jr folded before Flop (didn't bet)
Seat 7: gatorgrinds folded before Flop (didn't bet)
Seat 8: L8terGators folded before Flop (didn't bet)
Seat 9: BCinNY folded before Flop (didn't bet)


*********** # 168 **************
PokerStars Hand #171446052947: Tournament #1648956582, $18.20+$1.80 USD=
 Hold'em No Limit - Level XXI (1500/3000) - 2017/06/19 22:47:03 ET
Table '1648956582 2' 9-max Seat #3 is the button
Seat 1: sfarbs (91205 in chips)=20
Seat 3: Decklyn71 (43780 in chips)=20
Seat 4: DebOCNJ (150362 in chips)=20
Seat 5: JJin91 (209240 in chips)=20
Seat 6: Paceman2jr (67585 in chips)=20
Seat 7: gatorgrinds (72959 in chips)=20
Seat 8: L8terGators (42467 in chips)=20
Seat 9: BCinNY (81875 in chips)=20
sfarbs: posts the ante 375
Decklyn71: posts the ante 375
DebOCNJ: posts the ante 375
JJin91: posts the ante 375
Paceman2jr: posts the ante 375
gatorgrinds: posts the ante 375
L8terGators: posts the ante 375
BCinNY: posts the ante 375
DebOCNJ: posts small blind 1500
JJin91: posts big blind 3000
*** HOLE CARDS ***
Dealt to JJin91 [3s 7d]
Paceman2jr: folds=20
gatorgrinds: folds=20
L8terGators: folds=20
BCinNY: folds=20
sfarbs: folds=20
Decklyn71: folds=20
DebOCNJ: calls 1500
JJin91: raises 7470 to 10470
DebOCNJ: folds=20
Uncalled bet (7470) returned to JJin91
JJin91 collected 9000 from pot
JJin91: doesn't show hand=20
*** SUMMARY ***
Total pot 9000 | Rake 0=20
Seat 1: sfarbs folded before Flop (didn't bet)
Seat 3: Decklyn71 (button) folded before Flop (didn't bet)
Seat 4: DebOCNJ (small blind) folded before Flop
Seat 5: JJin91 (big blind) collected (9000)
Seat 6: Paceman2jr folded before Flop (didn't bet)
Seat 7: gatorgrinds folded before Flop (didn't bet)
Seat 8: L8terGators folded before Flop (didn't bet)
Seat 9: BCinNY folded before Flop (didn't bet)


*********** # 169 **************
PokerStars Hand #171446053156: Tournament #1648956582, $18.20+$1.80 USD=
 Hold'em No Limit - Level XXI (1500/3000) - 2017/06/19 22:47:50 ET
Table '1648956582 2' 9-max Seat #4 is the button
Seat 1: sfarbs (90830 in chips)=20
Seat 3: Decklyn71 (43405 in chips)=20
Seat 4: DebOCNJ (146987 in chips)=20
Seat 5: JJin91 (214865 in chips)=20
Seat 6: Paceman2jr (67210 in chips)=20
Seat 7: gatorgrinds (72584 in chips)=20
Seat 8: L8terGators (42092 in chips)=20
Seat 9: BCinNY (81500 in chips)=20
sfarbs: posts the ante 375
Decklyn71: posts the ante 375
DebOCNJ: posts the ante 375
JJin91: posts the ante 375
Paceman2jr: posts the ante 375
gatorgrinds: posts the ante 375
L8terGators: posts the ante 375
BCinNY: posts the ante 375
JJin91: posts small blind 1500
Paceman2jr: posts big blind 3000
*** HOLE CARDS ***
Dealt to JJin91 [8d 3d]
gatorgrinds: folds=20
L8terGators: folds=20
BCinNY: folds=20
sfarbs: raises 3690 to 6690
Decklyn71: folds=20
DebOCNJ: folds=20
JJin91: folds=20
Paceman2jr: folds=20
Uncalled bet (3690) returned to sfarbs
sfarbs collected 10500 from pot
sfarbs: doesn't show hand=20
*** SUMMARY ***
Total pot 10500 | Rake 0=20
Seat 1: sfarbs collected (10500)
Seat 3: Decklyn71 folded before Flop (didn't bet)
Seat 4: DebOCNJ (button) folded before Flop (didn't bet)
Seat 5: JJin91 (small blind) folded before Flop
Seat 6: Paceman2jr (big blind) folded before Flop
Seat 7: gatorgrinds folded before Flop (didn't bet)
Seat 8: L8terGators folded before Flop (didn't bet)
Seat 9: BCinNY folded before Flop (didn't bet)


*********** # 170 **************
PokerStars Hand #171446053256: Tournament #1648956582, $18.20+$1.80 USD=
 Hold'em No Limit - Level XXI (1500/3000) - 2017/06/19 22:48:12 ET
Table '1648956582 2' 9-max Seat #5 is the button
Seat 1: sfarbs (97955 in chips)=20
Seat 3: Decklyn71 (43030 in chips)=20
Seat 4: DebOCNJ (146612 in chips)=20
Seat 5: JJin91 (212990 in chips)=20
Seat 6: Paceman2jr (63835 in chips)=20
Seat 7: gatorgrinds (72209 in chips)=20
Seat 8: L8terGators (41717 in chips)=20
Seat 9: BCinNY (81125 in chips)=20
sfarbs: posts the ante 375
Decklyn71: posts the ante 375
DebOCNJ: posts the ante 375
JJin91: posts the ante 375
Paceman2jr: posts the ante 375
gatorgrinds: posts the ante 375
L8terGators: posts the ante 375
BCinNY: posts the ante 375
Paceman2jr: posts small blind 1500
gatorgrinds: posts big blind 3000
*** HOLE CARDS ***
Dealt to JJin91 [5c 4h]
L8terGators: calls 3000
BCinNY: folds=20
sfarbs: folds=20
Decklyn71: raises 6000 to 9000
DebOCNJ: folds=20
JJin91: folds=20
Paceman2jr: folds=20
gatorgrinds: raises 62834 to 71834 and is all-in
L8terGators: folds=20
Decklyn71: calls 33655 and is all-in
Uncalled bet (29179) returned to gatorgrinds
*** FLOP *** [8s As 4c]
*** TURN *** [8s As 4c] [Qh]
*** RIVER *** [8s As 4c Qh] [5h]
*** SHOW DOWN ***
gatorgrinds: shows [Ad Kh] (a pair of Aces)
Decklyn71: shows [Qd Qs] (three of a kind, Queens)
Decklyn71 collected 92810 from pot
*** SUMMARY ***
Total pot 92810 | Rake 0=20
Board [8s As 4c Qh 5h]
Seat 1: sfarbs folded before Flop (didn't bet)
Seat 3: Decklyn71 showed [Qd Qs] and won (92810) with three of a kind, =
Queens
Seat 4: DebOCNJ folded before Flop (didn't bet)
Seat 5: JJin91 (button) folded before Flop (didn't bet)
Seat 6: Paceman2jr (small blind) folded before Flop
Seat 7: gatorgrinds (big blind) showed [Ad Kh] and lost with a pair of =
Aces
Seat 8: L8terGators folded before Flop
Seat 9: BCinNY folded before Flop (didn't bet)


*********** # 171 **************
PokerStars Hand #171446053458: Tournament #1648956582, $18.20+$1.80 USD=
 Hold'em No Limit - Level XXII (2000/4000) - 2017/06/19 22:48:57 ET
Table '1648956582 2' 9-max Seat #6 is the button
Seat 1: sfarbs (97580 in chips)=20
Seat 3: Decklyn71 (92810 in chips)=20
Seat 4: DebOCNJ (146237 in chips)=20
Seat 5: JJin91 (212615 in chips)=20
Seat 6: Paceman2jr (61960 in chips)=20
Seat 7: gatorgrinds (29179 in chips)=20
Seat 8: L8terGators (38342 in chips)=20
Seat 9: BCinNY (80750 in chips)=20
sfarbs: posts the ante 500
Decklyn71: posts the ante 500
DebOCNJ: posts the ante 500
JJin91: posts the ante 500
Paceman2jr: posts the ante 500
gatorgrinds: posts the ante 500
L8terGators: posts the ante 500
BCinNY: posts the ante 500
gatorgrinds: posts small blind 2000
L8terGators: posts big blind 4000
*** HOLE CARDS ***
Dealt to JJin91 [Th Qd]
BCinNY: folds=20
sfarbs: raises 4920 to 8920
Decklyn71: folds=20
DebOCNJ: folds=20
JJin91: folds=20
Paceman2jr: folds=20
gatorgrinds: folds=20
L8terGators: folds=20
Uncalled bet (4920) returned to sfarbs
sfarbs collected 14000 from pot
sfarbs: doesn't show hand=20
*** SUMMARY ***
Total pot 14000 | Rake 0=20
Seat 1: sfarbs collected (14000)
Seat 3: Decklyn71 folded before Flop (didn't bet)
Seat 4: DebOCNJ folded before Flop (didn't bet)
Seat 5: JJin91 folded before Flop (didn't bet)
Seat 6: Paceman2jr (button) folded before Flop (didn't bet)
Seat 7: gatorgrinds (small blind) folded before Flop
Seat 8: L8terGators (big blind) folded before Flop
Seat 9: BCinNY folded before Flop (didn't bet)


*********** # 172 **************
PokerStars Hand #171446053535: Tournament #1648956582, $18.20+$1.80 USD=
 Hold'em No Limit - Level XXII (2000/4000) - 2017/06/19 22:49:13 ET
Table '1648956582 2' 9-max Seat #7 is the button
Seat 1: sfarbs (107080 in chips)=20
Seat 3: Decklyn71 (92310 in chips)=20
Seat 4: DebOCNJ (145737 in chips)=20
Seat 5: JJin91 (212115 in chips)=20
Seat 6: Paceman2jr (61460 in chips)=20
Seat 7: gatorgrinds (26679 in chips)=20
Seat 8: L8terGators (33842 in chips)=20
Seat 9: BCinNY (80250 in chips)=20
sfarbs: posts the ante 500
Decklyn71: posts the ante 500
DebOCNJ: posts the ante 500
JJin91: posts the ante 500
Paceman2jr: posts the ante 500
gatorgrinds: posts the ante 500
L8terGators: posts the ante 500
BCinNY: posts the ante 500
L8terGators: posts small blind 2000
BCinNY: posts big blind 4000
*** HOLE CARDS ***
Dealt to JJin91 [9h Qh]
sfarbs: folds=20
Decklyn71: folds=20
DebOCNJ: calls 4000
JJin91: calls 4000
Paceman2jr: folds=20
gatorgrinds: folds=20
L8terGators: calls 2000
BCinNY: checks=20
*** FLOP *** [5h 2c 7d]
L8terGators: checks=20
BCinNY: checks=20
DebOCNJ: bets 10000
JJin91: folds=20
L8terGators: folds=20
BCinNY: folds=20
Uncalled bet (10000) returned to DebOCNJ
DebOCNJ collected 20000 from pot
DebOCNJ: doesn't show hand=20
*** SUMMARY ***
Total pot 20000 | Rake 0=20
Board [5h 2c 7d]
Seat 1: sfarbs folded before Flop (didn't bet)
Seat 3: Decklyn71 folded before Flop (didn't bet)
Seat 4: DebOCNJ collected (20000)
Seat 5: JJin91 folded on the Flop
Seat 6: Paceman2jr folded before Flop (didn't bet)
Seat 7: gatorgrinds (button) folded before Flop (didn't bet)
Seat 8: L8terGators (small blind) folded on the Flop
Seat 9: BCinNY (big blind) folded on the Flop


*********** # 173 **************
PokerStars Hand #171446053723: Tournament #1648956582, $18.20+$1.80 USD=
 Hold'em No Limit - Level XXII (2000/4000) - 2017/06/19 22:49:53 ET
Table '1648956582 2' 9-max Seat #8 is the button
Seat 1: sfarbs (106580 in chips)=20
Seat 3: Decklyn71 (91810 in chips)=20
Seat 4: DebOCNJ (161237 in chips)=20
Seat 5: JJin91 (207615 in chips)=20
Seat 6: Paceman2jr (60960 in chips)=20
Seat 7: gatorgrinds (26179 in chips)=20
Seat 8: L8terGators (29342 in chips)=20
Seat 9: BCinNY (75750 in chips)=20
sfarbs: posts the ante 500
Decklyn71: posts the ante 500
DebOCNJ: posts the ante 500
JJin91: posts the ante 500
Paceman2jr: posts the ante 500
gatorgrinds: posts the ante 500
L8terGators: posts the ante 500
BCinNY: posts the ante 500
BCinNY: posts small blind 2000
sfarbs: posts big blind 4000
*** HOLE CARDS ***
Dealt to JJin91 [Ks 7s]
Decklyn71: folds=20
DebOCNJ: folds=20
JJin91: folds=20
Paceman2jr: folds=20
gatorgrinds: folds=20
L8terGators: folds=20
BCinNY: folds=20
Uncalled bet (2000) returned to sfarbs
sfarbs collected 8000 from pot
sfarbs: doesn't show hand=20
*** SUMMARY ***
Total pot 8000 | Rake 0=20
Seat 1: sfarbs (big blind) collected (8000)
Seat 3: Decklyn71 folded before Flop (didn't bet)
Seat 4: DebOCNJ folded before Flop (didn't bet)
Seat 5: JJin91 folded before Flop (didn't bet)
Seat 6: Paceman2jr folded before Flop (didn't bet)
Seat 7: gatorgrinds folded before Flop (didn't bet)
Seat 8: L8terGators (button) folded before Flop (didn't bet)
Seat 9: BCinNY (small blind) folded before Flop


*********** # 174 **************
PokerStars Hand #171446053753: Tournament #1648956582, $18.20+$1.80 USD=
 Hold'em No Limit - Level XXII (2000/4000) - 2017/06/19 22:50:01 ET
Table '1648956582 2' 9-max Seat #9 is the button
Seat 1: sfarbs (112080 in chips)=20
Seat 3: Decklyn71 (91310 in chips)=20
Seat 4: DebOCNJ (160737 in chips)=20
Seat 5: JJin91 (207115 in chips)=20
Seat 6: Paceman2jr (60460 in chips)=20
Seat 7: gatorgrinds (25679 in chips)=20
Seat 8: L8terGators (28842 in chips)=20
Seat 9: BCinNY (73250 in chips)=20
sfarbs: posts the ante 500
Decklyn71: posts the ante 500
DebOCNJ: posts the ante 500
JJin91: posts the ante 500
Paceman2jr: posts the ante 500
gatorgrinds: posts the ante 500
L8terGators: posts the ante 500
BCinNY: posts the ante 500
sfarbs: posts small blind 2000
Decklyn71: posts big blind 4000
*** HOLE CARDS ***
Dealt to JJin91 [6s 7h]
DebOCNJ: raises 8000 to 12000
JJin91: folds=20
Paceman2jr: folds=20
gatorgrinds: folds=20
L8terGators: raises 16342 to 28342 and is all-in
BCinNY: folds=20
sfarbs: folds=20
Decklyn71: folds=20
DebOCNJ: calls 16342
*** FLOP *** [5d Td 7s]
*** TURN *** [5d Td 7s] [Jc]
*** RIVER *** [5d Td 7s Jc] [6d]
*** SHOW DOWN ***
DebOCNJ: shows [3h 3c] (a pair of Threes)
L8terGators: shows [Kd Ad] (a flush, Ace high)
L8terGators collected 66684 from pot
*** SUMMARY ***
Total pot 66684 | Rake 0=20
Board [5d Td 7s Jc 6d]
Seat 1: sfarbs (small blind) folded before Flop
Seat 3: Decklyn71 (big blind) folded before Flop
Seat 4: DebOCNJ showed [3h 3c] and lost with a pair of Threes
Seat 5: JJin91 folded before Flop (didn't bet)
Seat 6: Paceman2jr folded before Flop (didn't bet)
Seat 7: gatorgrinds folded before Flop (didn't bet)
Seat 8: L8terGators showed [Kd Ad] and won (66684) with a flush, Ace hi=
gh
Seat 9: BCinNY (button) folded before Flop (didn't bet)


*********** # 175 **************
PokerStars Hand #171446053860: Tournament #1648956582, $18.20+$1.80 USD=
 Hold'em No Limit - Level XXII (2000/4000) - 2017/06/19 22:50:26 ET
Table '1648956582 2' 9-max Seat #1 is the button
Seat 1: sfarbs (109580 in chips)=20
Seat 3: Decklyn71 (86810 in chips)=20
Seat 4: DebOCNJ (131895 in chips)=20
Seat 5: JJin91 (206615 in chips)=20
Seat 6: Paceman2jr (59960 in chips)=20
Seat 7: gatorgrinds (25179 in chips)=20
Seat 8: L8terGators (66684 in chips)=20
Seat 9: BCinNY (72750 in chips)=20
sfarbs: posts the ante 500
Decklyn71: posts the ante 500
DebOCNJ: posts the ante 500
JJin91: posts the ante 500
Paceman2jr: posts the ante 500
gatorgrinds: posts the ante 500
L8terGators: posts the ante 500
BCinNY: posts the ante 500
Decklyn71: posts small blind 2000
DebOCNJ: posts big blind 4000
*** HOLE CARDS ***
Dealt to JJin91 [Jh 2h]
JJin91: folds=20
Paceman2jr: folds=20
gatorgrinds: raises 20679 to 24679 and is all-in
L8terGators: folds=20
BCinNY: folds=20
sfarbs: raises 84401 to 109080 and is all-in
Decklyn71: folds=20
DebOCNJ: folds=20
Uncalled bet (84401) returned to sfarbs
*** FLOP *** [Ac 8s Jc]
*** TURN *** [Ac 8s Jc] [6d]
*** RIVER *** [Ac 8s Jc 6d] [Kh]
*** SHOW DOWN ***
gatorgrinds: shows [Ah 9h] (a pair of Aces)
sfarbs: shows [9s 9c] (a pair of Nines)
gatorgrinds collected 59358 from pot
*** SUMMARY ***
Total pot 59358 | Rake 0=20
Board [Ac 8s Jc 6d Kh]
Seat 1: sfarbs (button) showed [9s 9c] and lost with a pair of Nines
Seat 3: Decklyn71 (small blind) folded before Flop
Seat 4: DebOCNJ (big blind) folded before Flop
Seat 5: JJin91 folded before Flop (didn't bet)
Seat 6: Paceman2jr folded before Flop (didn't bet)
Seat 7: gatorgrinds showed [Ah 9h] and won (59358) with a pair of Aces
Seat 8: L8terGators folded before Flop (didn't bet)
Seat 9: BCinNY folded before Flop (didn't bet)


*********** # 176 **************
PokerStars Hand #171446053988: Tournament #1648956582, $18.20+$1.80 USD=
 Hold'em No Limit - Level XXII (2000/4000) - 2017/06/19 22:50:54 ET
Table '1648956582 2' 9-max Seat #3 is the button
Seat 1: sfarbs (84401 in chips)=20
Seat 3: Decklyn71 (84310 in chips)=20
Seat 4: DebOCNJ (127395 in chips)=20
Seat 5: JJin91 (206115 in chips)=20
Seat 6: Paceman2jr (59460 in chips)=20
Seat 7: gatorgrinds (59358 in chips)=20
Seat 8: L8terGators (66184 in chips)=20
Seat 9: BCinNY (72250 in chips)=20
sfarbs: posts the ante 500
Decklyn71: posts the ante 500
DebOCNJ: posts the ante 500
JJin91: posts the ante 500
Paceman2jr: posts the ante 500
gatorgrinds: posts the ante 500
L8terGators: posts the ante 500
BCinNY: posts the ante 500
DebOCNJ: posts small blind 2000
JJin91: posts big blind 4000
*** HOLE CARDS ***
Dealt to JJin91 [Td Qc]
Paceman2jr: folds=20
gatorgrinds: folds=20
L8terGators: folds=20
BCinNY: folds=20
sfarbs: folds=20
Decklyn71: folds=20
L8terGators is disconnected=20
DebOCNJ: folds=20
Uncalled bet (2000) returned to JJin91
JJin91 collected 8000 from pot
JJin91: doesn't show hand=20
*** SUMMARY ***
Total pot 8000 | Rake 0=20
Seat 1: sfarbs folded before Flop (didn't bet)
Seat 3: Decklyn71 (button) folded before Flop (didn't bet)
Seat 4: DebOCNJ (small blind) folded before Flop
Seat 5: JJin91 (big blind) collected (8000)
Seat 6: Paceman2jr folded before Flop (didn't bet)
Seat 7: gatorgrinds folded before Flop (didn't bet)
Seat 8: L8terGators folded before Flop (didn't bet)
Seat 9: BCinNY folded before Flop (didn't bet)


*********** # 177 **************
PokerStars Hand #171446054085: Tournament #1648956582, $18.20+$1.80 USD=
 Hold'em No Limit - Level XXII (2000/4000) - 2017/06/19 22:51:15 ET
Table '1648956582 2' 9-max Seat #4 is the button
Seat 1: sfarbs (83901 in chips)=20
Seat 3: Decklyn71 (83810 in chips)=20
Seat 4: DebOCNJ (124895 in chips)=20
Seat 5: JJin91 (211615 in chips)=20
Seat 6: Paceman2jr (58960 in chips)=20
Seat 7: gatorgrinds (58858 in chips)=20
Seat 8: L8terGators (65684 in chips)=20
Seat 9: BCinNY (71750 in chips)=20
sfarbs: posts the ante 500
Decklyn71: posts the ante 500
DebOCNJ: posts the ante 500
JJin91: posts the ante 500
Paceman2jr: posts the ante 500
gatorgrinds: posts the ante 500
L8terGators: posts the ante 500
BCinNY: posts the ante 500
JJin91: posts small blind 2000
Paceman2jr: posts big blind 4000
*** HOLE CARDS ***
Dealt to JJin91 [4h 5c]
gatorgrinds: raises 4000 to 8000
L8terGators is connected=20
L8terGators: folds=20
BCinNY: folds=20
sfarbs: folds=20
Decklyn71: calls 8000
DebOCNJ: folds=20
JJin91: folds=20
Paceman2jr: folds=20
*** FLOP *** [5h As 3h]
gatorgrinds: bets 9000
Decklyn71: folds=20
Uncalled bet (9000) returned to gatorgrinds
gatorgrinds collected 26000 from pot
gatorgrinds: doesn't show hand=20
*** SUMMARY ***
Total pot 26000 | Rake 0=20
Board [5h As 3h]
Seat 1: sfarbs folded before Flop (didn't bet)
Seat 3: Decklyn71 folded on the Flop
Seat 4: DebOCNJ (button) folded before Flop (didn't bet)
Seat 5: JJin91 (small blind) folded before Flop
Seat 6: Paceman2jr (big blind) folded before Flop
Seat 7: gatorgrinds collected (26000)
Seat 8: L8terGators folded before Flop (didn't bet)
Seat 9: BCinNY folded before Flop (didn't bet)


*********** # 178 **************
PokerStars Hand #171446054310: Tournament #1648956582, $18.20+$1.80 USD=
 Hold'em No Limit - Level XXII (2000/4000) - 2017/06/19 22:52:09 ET
Table '1648956582 2' 9-max Seat #5 is the button
Seat 1: sfarbs (83401 in chips)=20
Seat 3: Decklyn71 (75310 in chips)=20
Seat 4: DebOCNJ (124395 in chips)=20
Seat 5: JJin91 (209115 in chips)=20
Seat 6: Paceman2jr (54460 in chips)=20
Seat 7: gatorgrinds (76358 in chips)=20
Seat 8: L8terGators (65184 in chips)=20
Seat 9: BCinNY (71250 in chips)=20
sfarbs: posts the ante 500
Decklyn71: posts the ante 500
DebOCNJ: posts the ante 500
JJin91: posts the ante 500
Paceman2jr: posts the ante 500
gatorgrinds: posts the ante 500
L8terGators: posts the ante 500
BCinNY: posts the ante 500
Paceman2jr: posts small blind 2000
gatorgrinds: posts big blind 4000
*** HOLE CARDS ***
Dealt to JJin91 [Kd 4c]
L8terGators: folds=20
BCinNY: folds=20
sfarbs: folds=20
Decklyn71: folds=20
DebOCNJ: folds=20
JJin91: raises 6280 to 10280
Paceman2jr: folds=20
gatorgrinds: folds=20
Uncalled bet (6280) returned to JJin91
JJin91 collected 14000 from pot
JJin91: doesn't show hand=20
*** SUMMARY ***
Total pot 14000 | Rake 0=20
Seat 1: sfarbs folded before Flop (didn't bet)
Seat 3: Decklyn71 folded before Flop (didn't bet)
Seat 4: DebOCNJ folded before Flop (didn't bet)
Seat 5: JJin91 (button) collected (14000)
Seat 6: Paceman2jr (small blind) folded before Flop
Seat 7: gatorgrinds (big blind) folded before Flop
Seat 8: L8terGators folded before Flop (didn't bet)
Seat 9: BCinNY folded before Flop (didn't bet)


*********** # 179 **************
PokerStars Hand #171446054420: Tournament #1648956582, $18.20+$1.80 USD=
 Hold'em No Limit - Level XXII (2000/4000) - 2017/06/19 22:52:34 ET
Table '1648956582 2' 9-max Seat #6 is the button
Seat 1: sfarbs (82901 in chips)=20
Seat 3: Decklyn71 (74810 in chips)=20
Seat 4: DebOCNJ (123895 in chips)=20
Seat 5: JJin91 (218615 in chips)=20
Seat 6: Paceman2jr (51960 in chips)=20
Seat 7: gatorgrinds (71858 in chips)=20
Seat 8: L8terGators (64684 in chips)=20
Seat 9: BCinNY (70750 in chips)=20
sfarbs: posts the ante 500
Decklyn71: posts the ante 500
DebOCNJ: posts the ante 500
JJin91: posts the ante 500
Paceman2jr: posts the ante 500
gatorgrinds: posts the ante 500
L8terGators: posts the ante 500
BCinNY: posts the ante 500
gatorgrinds: posts small blind 2000
L8terGators: posts big blind 4000
*** HOLE CARDS ***
Dealt to JJin91 [Js Kh]
BCinNY: raises 66250 to 70250 and is all-in
sfarbs: folds=20
Decklyn71: folds=20
DebOCNJ: folds=20
JJin91: folds=20
Paceman2jr: folds=20
gatorgrinds: folds=20
L8terGators: calls 60184 and is all-in
Uncalled bet (6066) returned to BCinNY
*** FLOP *** [2d Ks As]
*** TURN *** [2d Ks As] [5d]
*** RIVER *** [2d Ks As 5d] [Qs]
*** SHOW DOWN ***
L8terGators: shows [Ac 6c] (a pair of Aces)
BCinNY: shows [Jc Jd] (a pair of Jacks)
L8terGators collected 134368 from pot
*** SUMMARY ***
Total pot 134368 | Rake 0=20
Board [2d Ks As 5d Qs]
Seat 1: sfarbs folded before Flop (didn't bet)
Seat 3: Decklyn71 folded before Flop (didn't bet)
Seat 4: DebOCNJ folded before Flop (didn't bet)
Seat 5: JJin91 folded before Flop (didn't bet)
Seat 6: Paceman2jr (button) folded before Flop (didn't bet)
Seat 7: gatorgrinds (small blind) folded before Flop
Seat 8: L8terGators (big blind) showed [Ac 6c] and won (134368) with a =
pair of Aces
Seat 9: BCinNY showed [Jc Jd] and lost with a pair of Jacks


*********** # 180 **************
PokerStars Hand #171446054552: Tournament #1648956582, $18.20+$1.80 USD=
 Hold'em No Limit - Level XXII (2000/4000) - 2017/06/19 22:53:05 ET
Table '1648956582 2' 9-max Seat #7 is the button
Seat 1: sfarbs (82401 in chips)=20
Seat 3: Decklyn71 (74310 in chips)=20
Seat 4: DebOCNJ (123395 in chips)=20
Seat 5: JJin91 (218115 in chips)=20
Seat 6: Paceman2jr (51460 in chips)=20
Seat 7: gatorgrinds (69358 in chips)=20
Seat 8: L8terGators (134368 in chips)=20
Seat 9: BCinNY (6066 in chips)=20
sfarbs: posts the ante 500
Decklyn71: posts the ante 500
DebOCNJ: posts the ante 500
JJin91: posts the ante 500
Paceman2jr: posts the ante 500
gatorgrinds: posts the ante 500
L8terGators: posts the ante 500
BCinNY: posts the ante 500
L8terGators: posts small blind 2000
BCinNY: posts big blind 4000
*** HOLE CARDS ***
Dealt to JJin91 [3c 7s]
sfarbs: folds=20
Decklyn71: raises 4000 to 8000
DebOCNJ: folds=20
JJin91: folds=20
Paceman2jr: folds=20
gatorgrinds: folds=20
L8terGators: calls 6000
BCinNY: calls 1566 and is all-in
*** FLOP *** [Qh Ad 7h]
L8terGators: checks=20
Decklyn71: checks=20
*** TURN *** [Qh Ad 7h] [Qc]
L8terGators: checks=20
Decklyn71: checks=20
*** RIVER *** [Qh Ad 7h Qc] [Ts]
L8terGators: checks=20
Decklyn71: checks=20
*** SHOW DOWN ***
L8terGators: shows [3h 3s] (two pair, Queens and Threes)
Decklyn71: shows [9s 9h] (two pair, Queens and Nines)
Decklyn71 collected 4868 from side pot
BCinNY: shows [Ac 9c] (two pair, Aces and Queens)
BCinNY collected 20698 from main pot
*** SUMMARY ***
Total pot 25566 Main pot 20698. Side pot 4868. | Rake 0=20
Board [Qh Ad 7h Qc Ts]
Seat 1: sfarbs folded before Flop (didn't bet)
Seat 3: Decklyn71 showed [9s 9h] and won (4868) with two pair, Queens a=
nd Nines
Seat 4: DebOCNJ folded before Flop (didn't bet)
Seat 5: JJin91 folded before Flop (didn't bet)
Seat 6: Paceman2jr folded before Flop (didn't bet)
Seat 7: gatorgrinds (button) folded before Flop (didn't bet)
Seat 8: L8terGators (small blind) showed [3h 3s] and lost with two pair=
, Queens and Threes
Seat 9: BCinNY (big blind) showed [Ac 9c] and won (20698) with two pair=
, Aces and Queens


*********** # 181 **************
PokerStars Hand #171446054676: Tournament #1648956582, $18.20+$1.80 USD=
 Hold'em No Limit - Level XXII (2000/4000) - 2017/06/19 22:53:33 ET
Table '1648956582 2' 9-max Seat #8 is the button
Seat 1: sfarbs (81901 in chips)=20
Seat 3: Decklyn71 (70678 in chips)=20
Seat 4: DebOCNJ (122895 in chips)=20
Seat 5: JJin91 (217615 in chips)=20
Seat 6: Paceman2jr (50960 in chips)=20
Seat 7: gatorgrinds (68858 in chips)=20
Seat 8: L8terGators (125868 in chips)=20
Seat 9: BCinNY (20698 in chips)=20
sfarbs: posts the ante 500
Decklyn71: posts the ante 500
DebOCNJ: posts the ante 500
JJin91: posts the ante 500
Paceman2jr: posts the ante 500
gatorgrinds: posts the ante 500
L8terGators: posts the ante 500
BCinNY: posts the ante 500
BCinNY: posts small blind 2000
sfarbs: posts big blind 4000
*** HOLE CARDS ***
Dealt to JJin91 [9d 9c]
Decklyn71: folds=20
DebOCNJ: folds=20
JJin91: raises 6280 to 10280
Paceman2jr: folds=20
gatorgrinds: folds=20
L8terGators: folds=20
BCinNY: folds=20
sfarbs: raises 71121 to 81401 and is all-in
JJin91: calls 71121
*** FLOP *** [6h 4d Jh]
*** TURN *** [6h 4d Jh] [Kh]
*** RIVER *** [6h 4d Jh Kh] [3c]
*** SHOW DOWN ***
sfarbs: shows [Qc Qh] (a pair of Queens)
JJin91: shows [9d 9c] (a pair of Nines)
sfarbs collected 168802 from pot
*** SUMMARY ***
Total pot 168802 | Rake 0=20
Board [6h 4d Jh Kh 3c]
Seat 1: sfarbs (big blind) showed [Qc Qh] and won (168802) with a pair =
of Queens
Seat 3: Decklyn71 folded before Flop (didn't bet)
Seat 4: DebOCNJ folded before Flop (didn't bet)
Seat 5: JJin91 showed [9d 9c] and lost with a pair of Nines
Seat 6: Paceman2jr folded before Flop (didn't bet)
Seat 7: gatorgrinds folded before Flop (didn't bet)
Seat 8: L8terGators (button) folded before Flop (didn't bet)
Seat 9: BCinNY (small blind) folded before Flop


*********** # 182 **************
PokerStars Hand #171446054859: Tournament #1648956582, $18.20+$1.80 USD=
 Hold'em No Limit - Level XXII (2000/4000) - 2017/06/19 22:54:14 ET
Table '1648956582 2' 9-max Seat #9 is the button
Seat 1: sfarbs (168802 in chips)=20
Seat 3: Decklyn71 (70178 in chips)=20
Seat 4: DebOCNJ (122395 in chips)=20
Seat 5: JJin91 (135714 in chips)=20
Seat 6: Paceman2jr (50460 in chips)=20
Seat 7: gatorgrinds (68358 in chips)=20
Seat 8: L8terGators (125368 in chips)=20
Seat 9: BCinNY (18198 in chips)=20
sfarbs: posts the ante 500
Decklyn71: posts the ante 500
DebOCNJ: posts the ante 500
JJin91: posts the ante 500
Paceman2jr: posts the ante 500
gatorgrinds: posts the ante 500
L8terGators: posts the ante 500
BCinNY: posts the ante 500
sfarbs: posts small blind 2000
Decklyn71: posts big blind 4000
*** HOLE CARDS ***
Dealt to JJin91 [8s 3h]
DebOCNJ: calls 4000
JJin91: folds=20
Paceman2jr: folds=20
gatorgrinds: folds=20
L8terGators: folds=20
L8terGators is sitting out
BCinNY: folds=20
sfarbs: raises 12680 to 16680
Decklyn71: folds=20
DebOCNJ: folds=20
Uncalled bet (12680) returned to sfarbs
sfarbs collected 16000 from pot
sfarbs: doesn't show hand=20
*** SUMMARY ***
Total pot 16000 | Rake 0=20
Seat 1: sfarbs (small blind) collected (16000)
Seat 3: Decklyn71 (big blind) folded before Flop
Seat 4: DebOCNJ folded before Flop
Seat 5: JJin91 folded before Flop (didn't bet)
Seat 6: Paceman2jr folded before Flop (didn't bet)
Seat 7: gatorgrinds folded before Flop (didn't bet)
Seat 8: L8terGators folded before Flop (didn't bet)
Seat 9: BCinNY (button) folded before Flop (didn't bet)


*********** # 183 **************
PokerStars Hand #171446055024: Tournament #1648956582, $18.20+$1.80 USD=
 Hold'em No Limit - Level XXII (2000/4000) - 2017/06/19 22:54:50 ET
Table '1648956582 2' 9-max Seat #1 is the button
Seat 1: sfarbs (180302 in chips)=20
Seat 3: Decklyn71 (65678 in chips)=20
Seat 4: DebOCNJ (117895 in chips)=20
Seat 5: JJin91 (135214 in chips)=20
Seat 6: Paceman2jr (49960 in chips)=20
Seat 7: gatorgrinds (67858 in chips)=20
Seat 8: L8terGators (124868 in chips) is sitting out
Seat 9: BCinNY (17698 in chips)=20
sfarbs: posts the ante 500
Decklyn71: posts the ante 500
DebOCNJ: posts the ante 500
JJin91: posts the ante 500
Paceman2jr: posts the ante 500
gatorgrinds: posts the ante 500
L8terGators: posts the ante 500
BCinNY: posts the ante 500
Decklyn71: posts small blind 2000
DebOCNJ: posts big blind 4000
*** HOLE CARDS ***
Dealt to JJin91 [Qd 7c]
JJin91: folds=20
Paceman2jr: folds=20
gatorgrinds: raises 4000 to 8000
L8terGators: folds=20
BCinNY: folds=20
sfarbs: folds=20
Decklyn71: folds=20
DebOCNJ: folds=20
Uncalled bet (4000) returned to gatorgrinds
gatorgrinds collected 14000 from pot
gatorgrinds: doesn't show hand=20
*** SUMMARY ***
Total pot 14000 | Rake 0=20
Seat 1: sfarbs (button) folded before Flop (didn't bet)
Seat 3: Decklyn71 (small blind) folded before Flop
Seat 4: DebOCNJ (big blind) folded before Flop
Seat 5: JJin91 folded before Flop (didn't bet)
Seat 6: Paceman2jr folded before Flop (didn't bet)
Seat 7: gatorgrinds collected (14000)
Seat 8: L8terGators folded before Flop (didn't bet)
Seat 9: BCinNY folded before Flop (didn't bet)


*********** # 184 **************
PokerStars Hand #171446056286: Tournament #1648956582, $18.20+$1.80 USD=
 Hold'em No Limit - Level XXII (2000/4000) - 2017/06/19 23:00:20 ET
Table '1648956582 2' 9-max Seat #3 is the button
Seat 1: sfarbs (179802 in chips)=20
Seat 3: Decklyn71 (63178 in chips)=20
Seat 4: DebOCNJ (113395 in chips)=20
Seat 5: JJin91 (134714 in chips)=20
Seat 6: Paceman2jr (49460 in chips)=20
Seat 7: gatorgrinds (77358 in chips)=20
Seat 8: L8terGators (124368 in chips) is sitting out
Seat 9: BCinNY (17198 in chips)=20
sfarbs: posts the ante 500
Decklyn71: posts the ante 500
DebOCNJ: posts the ante 500
JJin91: posts the ante 500
Paceman2jr: posts the ante 500
gatorgrinds: posts the ante 500
L8terGators: posts the ante 500
BCinNY: posts the ante 500
DebOCNJ: posts small blind 2000
JJin91: posts big blind 4000
*** HOLE CARDS ***
Dealt to JJin91 [Kc Ah]
Paceman2jr: folds=20
gatorgrinds: folds=20
L8terGators: folds=20
BCinNY: raises 12698 to 16698 and is all-in
sfarbs: folds=20
Decklyn71: folds=20
DebOCNJ: calls 14698
JJin91: calls 12698
*** FLOP *** [Ac 6d 2h]
DebOCNJ: checks=20
JJin91: bets 30834
DebOCNJ: raises 65363 to 96197 and is all-in
JJin91: calls 65363
*** TURN *** [Ac 6d 2h] [2c]
*** RIVER *** [Ac 6d 2h 2c] [7s]
*** SHOW DOWN ***
DebOCNJ: shows [6h 6c] (a full house, Sixes full of Deuces)
JJin91: shows [Kc Ah] (two pair, Aces and Deuces)
DebOCNJ collected 192394 from side pot
BCinNY: shows [3d As] (two pair, Aces and Deuces)
DebOCNJ collected 54094 from main pot
BCinNY finished the tournament in 15th place and received $43.13.
*** SUMMARY ***
Total pot 246488 Main pot 54094. Side pot 192394. | Rake 0=20
Board [Ac 6d 2h 2c 7s]
Seat 1: sfarbs folded before Flop (didn't bet)
Seat 3: Decklyn71 (button) folded before Flop (didn't bet)
Seat 4: DebOCNJ (small blind) showed [6h 6c] and won (246488) with a fu=
ll house, Sixes full of Deuces
Seat 5: JJin91 (big blind) showed [Kc Ah] and lost with two pair, Aces =
and Deuces
Seat 6: Paceman2jr folded before Flop (didn't bet)
Seat 7: gatorgrinds folded before Flop (didn't bet)
Seat 8: L8terGators folded before Flop (didn't bet)
Seat 9: BCinNY showed [3d As] and lost with two pair, Aces and Deuces


*********** # 185 **************
PokerStars Hand #171446056484: Tournament #1648956582, $18.20+$1.80 USD=
 Hold'em No Limit - Level XXII (2000/4000) - 2017/06/19 23:00:59 ET
Table '1648956582 2' 9-max Seat #4 is the button
Seat 1: sfarbs (179302 in chips)=20
Seat 3: Decklyn71 (62678 in chips)=20
Seat 4: DebOCNJ (246488 in chips)=20
Seat 5: JJin91 (21319 in chips)=20
Seat 6: Paceman2jr (48960 in chips)=20
Seat 7: gatorgrinds (76858 in chips)=20
Seat 8: L8terGators (123868 in chips) is sitting out
sfarbs: posts the ante 500
Decklyn71: posts the ante 500
DebOCNJ: posts the ante 500
JJin91: posts the ante 500
Paceman2jr: posts the ante 500
gatorgrinds: posts the ante 500
L8terGators: posts the ante 500
JJin91: posts small blind 2000
Paceman2jr: posts big blind 4000
*** HOLE CARDS ***
Dealt to JJin91 [5d 9h]
gatorgrinds: folds=20
L8terGators: folds=20
sfarbs: folds=20
Decklyn71: folds=20
DebOCNJ: folds=20
JJin91: raises 16819 to 20819 and is all-in
Paceman2jr: folds=20
Uncalled bet (16819) returned to JJin91
JJin91 collected 11500 from pot
JJin91: doesn't show hand=20
*** SUMMARY ***
Total pot 11500 | Rake 0=20
Seat 1: sfarbs folded before Flop (didn't bet)
Seat 3: Decklyn71 folded before Flop (didn't bet)
Seat 4: DebOCNJ (button) folded before Flop (didn't bet)
Seat 5: JJin91 (small blind) collected (11500)
Seat 6: Paceman2jr (big blind) folded before Flop
Seat 7: gatorgrinds folded before Flop (didn't bet)
Seat 8: L8terGators folded before Flop (didn't bet)


*********** # 186 **************
PokerStars Hand #171446056596: Tournament #1648956582, $18.20+$1.80 USD=
 Hold'em No Limit - Level XXII (2000/4000) - 2017/06/19 23:01:20 ET
Table '1648956582 2' 9-max Seat #5 is the button
Seat 1: sfarbs (178802 in chips)=20
Seat 3: Decklyn71 (62178 in chips)=20
Seat 4: DebOCNJ (245988 in chips)=20
Seat 5: JJin91 (28319 in chips)=20
Seat 6: Paceman2jr (44460 in chips)=20
Seat 7: gatorgrinds (76358 in chips)=20
Seat 8: L8terGators (123368 in chips) is sitting out
sfarbs: posts the ante 500
Decklyn71: posts the ante 500
DebOCNJ: posts the ante 500
JJin91: posts the ante 500
Paceman2jr: posts the ante 500
gatorgrinds: posts the ante 500
L8terGators: posts the ante 500
Paceman2jr: posts small blind 2000
gatorgrinds: posts big blind 4000
*** HOLE CARDS ***
Dealt to JJin91 [Tc 4d]
L8terGators: folds=20
sfarbs: raises 4920 to 8920
Decklyn71: folds=20
DebOCNJ: folds=20
JJin91: folds=20
Paceman2jr: folds=20
gatorgrinds: folds=20
Uncalled bet (4920) returned to sfarbs
sfarbs collected 13500 from pot
sfarbs: doesn't show hand=20
*** SUMMARY ***
Total pot 13500 | Rake 0=20
Seat 1: sfarbs collected (13500)
Seat 3: Decklyn71 folded before Flop (didn't bet)
Seat 4: DebOCNJ folded before Flop (didn't bet)
Seat 5: JJin91 (button) folded before Flop (didn't bet)
Seat 6: Paceman2jr (small blind) folded before Flop
Seat 7: gatorgrinds (big blind) folded before Flop
Seat 8: L8terGators folded before Flop (didn't bet)


*********** # 187 **************
PokerStars Hand #171446056692: Tournament #1648956582, $18.20+$1.80 USD=
 Hold'em No Limit - Level XXII (2000/4000) - 2017/06/19 23:01:44 ET
Table '1648956582 2' 9-max Seat #6 is the button
Seat 1: sfarbs (187802 in chips)=20
Seat 3: Decklyn71 (61678 in chips)=20
Seat 4: DebOCNJ (245488 in chips)=20
Seat 5: JJin91 (27819 in chips)=20
Seat 6: Paceman2jr (41960 in chips)=20
Seat 7: gatorgrinds (71858 in chips)=20
Seat 8: L8terGators (122868 in chips) is sitting out
sfarbs: posts the ante 500
Decklyn71: posts the ante 500
DebOCNJ: posts the ante 500
JJin91: posts the ante 500
Paceman2jr: posts the ante 500
gatorgrinds: posts the ante 500
L8terGators: posts the ante 500
gatorgrinds: posts small blind 2000
L8terGators: posts big blind 4000
*** HOLE CARDS ***
Dealt to JJin91 [8h Qs]
sfarbs: raises 4920 to 8920
Decklyn71: folds=20
DebOCNJ: folds=20
JJin91: folds=20
Paceman2jr: folds=20
gatorgrinds: folds=20
L8terGators: folds=20
Uncalled bet (4920) returned to sfarbs
sfarbs collected 13500 from pot
sfarbs: doesn't show hand=20
*** SUMMARY ***
Total pot 13500 | Rake 0=20
Seat 1: sfarbs collected (13500)
Seat 3: Decklyn71 folded before Flop (didn't bet)
Seat 4: DebOCNJ folded before Flop (didn't bet)
Seat 5: JJin91 folded before Flop (didn't bet)
Seat 6: Paceman2jr (button) folded before Flop (didn't bet)
Seat 7: gatorgrinds (small blind) folded before Flop
Seat 8: L8terGators (big blind) folded before Flop


*********** # 188 **************
PokerStars Hand #171446056791: Tournament #1648956582, $18.20+$1.80 USD=
 Hold'em No Limit - Level XXII (2000/4000) - 2017/06/19 23:02:04 ET
Table '1648956582 2' 9-max Seat #7 is the button
Seat 1: sfarbs (196802 in chips)=20
Seat 3: Decklyn71 (61178 in chips)=20
Seat 4: DebOCNJ (244988 in chips)=20
Seat 5: JJin91 (27319 in chips)=20
Seat 6: Paceman2jr (41460 in chips)=20
Seat 7: gatorgrinds (69358 in chips)=20
Seat 8: L8terGators (118368 in chips) is sitting out
sfarbs: posts the ante 500
Decklyn71: posts the ante 500
DebOCNJ: posts the ante 500
JJin91: posts the ante 500
Paceman2jr: posts the ante 500
gatorgrinds: posts the ante 500
L8terGators: posts the ante 500
L8terGators: posts small blind 2000
sfarbs: posts big blind 4000
*** HOLE CARDS ***
Dealt to JJin91 [8d 8s]
Decklyn71: folds=20
DebOCNJ: folds=20
JJin91: raises 22819 to 26819 and is all-in
Paceman2jr: folds=20
gatorgrinds: folds=20
L8terGators: folds=20
sfarbs: folds=20
Uncalled bet (22819) returned to JJin91
JJin91 collected 13500 from pot
JJin91: doesn't show hand=20
*** SUMMARY ***
Total pot 13500 | Rake 0=20
Seat 1: sfarbs (big blind) folded before Flop
Seat 3: Decklyn71 folded before Flop (didn't bet)
Seat 4: DebOCNJ folded before Flop (didn't bet)
Seat 5: JJin91 collected (13500)
Seat 6: Paceman2jr folded before Flop (didn't bet)
Seat 7: gatorgrinds (button) folded before Flop (didn't bet)
Seat 8: L8terGators (small blind) folded before Flop


*********** # 189 **************
PokerStars Hand #171446056912: Tournament #1648956582, $18.20+$1.80 USD=
 Hold'em No Limit - Level XXII (2000/4000) - 2017/06/19 23:02:30 ET
Table '1648956582 2' 9-max Seat #8 is the button
Seat 1: sfarbs (192302 in chips)=20
Seat 3: Decklyn71 (60678 in chips)=20
Seat 4: DebOCNJ (244488 in chips)=20
Seat 5: JJin91 (36319 in chips)=20
Seat 6: Paceman2jr (40960 in chips)=20
Seat 7: gatorgrinds (68858 in chips)=20
Seat 8: L8terGators (115868 in chips) is sitting out
sfarbs: posts the ante 500
Decklyn71: posts the ante 500
DebOCNJ: posts the ante 500
JJin91: posts the ante 500
Paceman2jr: posts the ante 500
gatorgrinds: posts the ante 500
L8terGators: posts the ante 500
sfarbs: posts small blind 2000
Decklyn71: posts big blind 4000
*** HOLE CARDS ***
Dealt to JJin91 [9c 5s]
DebOCNJ: folds=20
JJin91: folds=20
Paceman2jr: folds=20
gatorgrinds: raises 5000 to 9000
L8terGators: folds=20
sfarbs: folds=20
Decklyn71: folds=20
Uncalled bet (5000) returned to gatorgrinds
gatorgrinds collected 13500 from pot
gatorgrinds: doesn't show hand=20
*** SUMMARY ***
Total pot 13500 | Rake 0=20
Seat 1: sfarbs (small blind) folded before Flop
Seat 3: Decklyn71 (big blind) folded before Flop
Seat 4: DebOCNJ folded before Flop (didn't bet)
Seat 5: JJin91 folded before Flop (didn't bet)
Seat 6: Paceman2jr folded before Flop (didn't bet)
Seat 7: gatorgrinds collected (13500)
Seat 8: L8terGators (button) folded before Flop (didn't bet)


*********** # 190 **************
PokerStars Hand #171446057045: Tournament #1648956582, $18.20+$1.80 USD=
 Hold'em No Limit - Level XXII (2000/4000) - 2017/06/19 23:02:55 ET
Table '1648956582 2' 9-max Seat #1 is the button
Seat 1: sfarbs (189802 in chips)=20
Seat 3: Decklyn71 (56178 in chips)=20
Seat 4: DebOCNJ (243988 in chips)=20
Seat 5: JJin91 (35819 in chips)=20
Seat 6: Paceman2jr (40460 in chips)=20
Seat 7: gatorgrinds (77858 in chips)=20
Seat 8: L8terGators (115368 in chips) is sitting out
sfarbs: posts the ante 500
Decklyn71: posts the ante 500
DebOCNJ: posts the ante 500
JJin91: posts the ante 500
Paceman2jr: posts the ante 500
gatorgrinds: posts the ante 500
L8terGators: posts the ante 500
Decklyn71: posts small blind 2000
DebOCNJ: posts big blind 4000
*** HOLE CARDS ***
Dealt to JJin91 [6h Js]
JJin91: folds=20
Paceman2jr: folds=20
gatorgrinds: folds=20
L8terGators: folds=20
sfarbs: raises 4920 to 8920
Decklyn71: folds=20
DebOCNJ: folds=20
Uncalled bet (4920) returned to sfarbs
sfarbs collected 13500 from pot
sfarbs: doesn't show hand=20
*** SUMMARY ***
Total pot 13500 | Rake 0=20
Seat 1: sfarbs (button) collected (13500)
Seat 3: Decklyn71 (small blind) folded before Flop
Seat 4: DebOCNJ (big blind) folded before Flop
Seat 5: JJin91 folded before Flop (didn't bet)
Seat 6: Paceman2jr folded before Flop (didn't bet)
Seat 7: gatorgrinds folded before Flop (didn't bet)
Seat 8: L8terGators folded before Flop (didn't bet)


*********** # 191 **************
PokerStars Hand #171446057192: Tournament #1648956582, $18.20+$1.80 USD=
 Hold'em No Limit - Level XXII (2000/4000) - 2017/06/19 23:03:26 ET
Table '1648956582 2' 9-max Seat #3 is the button
Seat 1: sfarbs (198802 in chips)=20
Seat 3: Decklyn71 (53678 in chips)=20
Seat 4: DebOCNJ (239488 in chips)=20
Seat 5: JJin91 (35319 in chips)=20
Seat 6: Paceman2jr (39960 in chips)=20
Seat 7: gatorgrinds (77358 in chips)=20
Seat 8: L8terGators (114868 in chips) is sitting out
sfarbs: posts the ante 500
Decklyn71: posts the ante 500
DebOCNJ: posts the ante 500
JJin91: posts the ante 500
Paceman2jr: posts the ante 500
gatorgrinds: posts the ante 500
L8terGators: posts the ante 500
DebOCNJ: posts small blind 2000
JJin91: posts big blind 4000
*** HOLE CARDS ***
Dealt to JJin91 [As 7h]
Paceman2jr: raises 8000 to 12000
gatorgrinds: raises 64858 to 76858 and is all-in
L8terGators: folds=20
sfarbs: folds=20
Decklyn71: folds=20
DebOCNJ: folds=20
JJin91: folds=20
Paceman2jr: calls 27460 and is all-in
Uncalled bet (37398) returned to gatorgrinds
*** FLOP *** [Th Ac Tc]
*** TURN *** [Th Ac Tc] [3h]
*** RIVER *** [Th Ac Tc 3h] [9c]
*** SHOW DOWN ***
Paceman2jr: shows [Kd Ad] (two pair, Aces and Tens)
gatorgrinds: shows [Jd Jh] (two pair, Jacks and Tens)
Paceman2jr collected 88420 from pot
*** SUMMARY ***
Total pot 88420 | Rake 0=20
Board [Th Ac Tc 3h 9c]
Seat 1: sfarbs folded before Flop (didn't bet)
Seat 3: Decklyn71 (button) folded before Flop (didn't bet)
Seat 4: DebOCNJ (small blind) folded before Flop
Seat 5: JJin91 (big blind) folded before Flop
Seat 6: Paceman2jr showed [Kd Ad] and won (88420) with two pair, Aces a=
nd Tens
Seat 7: gatorgrinds showed [Jd Jh] and lost with two pair, Jacks and Te=
ns
Seat 8: L8terGators folded before Flop (didn't bet)


*********** # 192 **************
PokerStars Hand #171446057335: Tournament #1648956582, $18.20+$1.80 USD=
 Hold'em No Limit - Level XXIII (2500/5000) - 2017/06/19 23:03:56 ET
Table '1648956582 2' 9-max Seat #4 is the button
Seat 1: sfarbs (198302 in chips)=20
Seat 3: Decklyn71 (53178 in chips)=20
Seat 4: DebOCNJ (236988 in chips)=20
Seat 5: JJin91 (30819 in chips)=20
Seat 6: Paceman2jr (88420 in chips)=20
Seat 7: gatorgrinds (37398 in chips)=20
Seat 8: L8terGators (114368 in chips) is sitting out
sfarbs: posts the ante 625
Decklyn71: posts the ante 625
DebOCNJ: posts the ante 625
JJin91: posts the ante 625
Paceman2jr: posts the ante 625
gatorgrinds: posts the ante 625
L8terGators: posts the ante 625
JJin91: posts small blind 2500
Paceman2jr: posts big blind 5000
*** HOLE CARDS ***
Dealt to JJin91 [Qs 8h]
gatorgrinds: raises 31773 to 36773 and is all-in
L8terGators: folds=20
sfarbs: folds=20
Decklyn71: folds=20
DebOCNJ: folds=20
JJin91: folds=20
Paceman2jr: folds=20
Uncalled bet (31773) returned to gatorgrinds
gatorgrinds collected 16875 from pot
gatorgrinds: doesn't show hand=20
*** SUMMARY ***
Total pot 16875 | Rake 0=20
Seat 1: sfarbs folded before Flop (didn't bet)
Seat 3: Decklyn71 folded before Flop (didn't bet)
Seat 4: DebOCNJ (button) folded before Flop (didn't bet)
Seat 5: JJin91 (small blind) folded before Flop
Seat 6: Paceman2jr (big blind) folded before Flop
Seat 7: gatorgrinds collected (16875)
Seat 8: L8terGators folded before Flop (didn't bet)


*********** # 193 **************
PokerStars Hand #171446057416: Tournament #1648956582, $18.20+$1.80 USD=
 Hold'em No Limit - Level XXIII (2500/5000) - 2017/06/19 23:04:15 ET
Table '1648956582 2' 9-max Seat #5 is the button
Seat 1: sfarbs (197677 in chips)=20
Seat 3: Decklyn71 (52553 in chips)=20
Seat 4: DebOCNJ (236363 in chips)=20
Seat 5: JJin91 (27694 in chips)=20
Seat 6: Paceman2jr (82795 in chips)=20
Seat 7: gatorgrinds (48648 in chips)=20
Seat 8: L8terGators (113743 in chips) is sitting out
sfarbs: posts the ante 625
Decklyn71: posts the ante 625
DebOCNJ: posts the ante 625
JJin91: posts the ante 625
Paceman2jr: posts the ante 625
gatorgrinds: posts the ante 625
L8terGators: posts the ante 625
Paceman2jr: posts small blind 2500
gatorgrinds: posts big blind 5000
*** HOLE CARDS ***
Dealt to JJin91 [4c 4s]
L8terGators: folds=20
sfarbs: folds=20
Decklyn71: folds=20
DebOCNJ: raises 10000 to 15000
JJin91: raises 12069 to 27069 and is all-in
Paceman2jr: folds=20
gatorgrinds: folds=20
DebOCNJ: calls 12069
L8terGators is disconnected=20
*** FLOP *** [Th 8d Ts]
*** TURN *** [Th 8d Ts] [5h]
*** RIVER *** [Th 8d Ts 5h] [2c]
*** SHOW DOWN ***
DebOCNJ: shows [Ad Jd] (a pair of Tens)
JJin91: shows [4c 4s] (two pair, Tens and Fours)
JJin91 collected 66013 from pot
*** SUMMARY ***
Total pot 66013 | Rake 0=20
Board [Th 8d Ts 5h 2c]
Seat 1: sfarbs folded before Flop (didn't bet)
Seat 3: Decklyn71 folded before Flop (didn't bet)
Seat 4: DebOCNJ showed [Ad Jd] and lost with a pair of Tens
Seat 5: JJin91 (button) showed [4c 4s] and won (66013) with two pair, T=
ens and Fours
Seat 6: Paceman2jr (small blind) folded before Flop
Seat 7: gatorgrinds (big blind) folded before Flop
Seat 8: L8terGators folded before Flop (didn't bet)


*********** # 194 **************
PokerStars Hand #171446057555: Tournament #1648956582, $18.20+$1.80 USD=
 Hold'em No Limit - Level XXIII (2500/5000) - 2017/06/19 23:04:40 ET
Table '1648956582 2' 9-max Seat #6 is the button
Seat 1: sfarbs (197052 in chips)=20
Seat 3: Decklyn71 (51928 in chips)=20
Seat 4: DebOCNJ (208669 in chips)=20
Seat 5: JJin91 (66013 in chips)=20
Seat 6: Paceman2jr (79670 in chips)=20
Seat 7: gatorgrinds (43023 in chips)=20
Seat 8: L8terGators (113118 in chips) is sitting out
sfarbs: posts the ante 625
Decklyn71: posts the ante 625
DebOCNJ: posts the ante 625
JJin91: posts the ante 625
Paceman2jr: posts the ante 625
gatorgrinds: posts the ante 625
L8terGators: posts the ante 625
gatorgrinds: posts small blind 2500
L8terGators: posts big blind 5000
*** HOLE CARDS ***
Dealt to JJin91 [4h 3d]
sfarbs: raises 6150 to 11150
Decklyn71: folds=20
DebOCNJ: folds=20
JJin91: folds=20
Paceman2jr: folds=20
gatorgrinds: folds=20
L8terGators: folds=20
Uncalled bet (6150) returned to sfarbs
sfarbs collected 16875 from pot
sfarbs: doesn't show hand=20
*** SUMMARY ***
Total pot 16875 | Rake 0=20
Seat 1: sfarbs collected (16875)
Seat 3: Decklyn71 folded before Flop (didn't bet)
Seat 4: DebOCNJ folded before Flop (didn't bet)
Seat 5: JJin91 folded before Flop (didn't bet)
Seat 6: Paceman2jr (button) folded before Flop (didn't bet)
Seat 7: gatorgrinds (small blind) folded before Flop
Seat 8: L8terGators (big blind) folded before Flop


*********** # 195 **************
PokerStars Hand #171446057626: Tournament #1648956582, $18.20+$1.80 USD=
 Hold'em No Limit - Level XXIII (2500/5000) - 2017/06/19 23:04:55 ET
Table '1648956582 2' 9-max Seat #7 is the button
Seat 1: sfarbs (208302 in chips)=20
Seat 3: Decklyn71 (51303 in chips)=20
Seat 4: DebOCNJ (208044 in chips)=20
Seat 5: JJin91 (65388 in chips)=20
Seat 6: Paceman2jr (79045 in chips)=20
Seat 7: gatorgrinds (39898 in chips)=20
Seat 8: L8terGators (107493 in chips) is sitting out
sfarbs: posts the ante 625
Decklyn71: posts the ante 625
DebOCNJ: posts the ante 625
JJin91: posts the ante 625
Paceman2jr: posts the ante 625
gatorgrinds: posts the ante 625
L8terGators: posts the ante 625
L8terGators: posts small blind 2500
sfarbs: posts big blind 5000
*** HOLE CARDS ***
Dealt to JJin91 [Jc Ac]
Decklyn71: folds=20
DebOCNJ: calls 5000
JJin91: calls 5000
Paceman2jr: folds=20
gatorgrinds: folds=20
L8terGators: folds=20
sfarbs: checks=20
*** FLOP *** [4s Kh 9c]
sfarbs: checks=20
DebOCNJ: bets 10938
JJin91: calls 10938
sfarbs: folds=20
*** TURN *** [4s Kh 9c] [8d]
DebOCNJ: checks=20
JJin91: checks=20
*** RIVER *** [4s Kh 9c 8d] [2d]
L8terGators has returned
DebOCNJ: checks=20
JJin91: bets 18111
DebOCNJ: folds=20
Uncalled bet (18111) returned to JJin91
JJin91 collected 43751 from pot
JJin91: doesn't show hand=20
*** SUMMARY ***
Total pot 43751 | Rake 0=20
Board [4s Kh 9c 8d 2d]
Seat 1: sfarbs (big blind) folded on the Flop
Seat 3: Decklyn71 folded before Flop (didn't bet)
Seat 4: DebOCNJ folded on the River
Seat 5: JJin91 collected (43751)
Seat 6: Paceman2jr folded before Flop (didn't bet)
Seat 7: gatorgrinds (button) folded before Flop (didn't bet)
Seat 8: L8terGators (small blind) folded before Flop


*********** # 196 **************
PokerStars Hand #171446058012: Tournament #1648956582, $18.20+$1.80 USD=
 Hold'em No Limit - Level XXIII (2500/5000) - 2017/06/19 23:06:14 ET
Table '1648956582 2' 9-max Seat #8 is the button
Seat 1: sfarbs (202677 in chips)=20
Seat 3: Decklyn71 (50678 in chips)=20
Seat 4: DebOCNJ (191481 in chips)=20
Seat 5: JJin91 (92576 in chips)=20
Seat 6: Paceman2jr (78420 in chips)=20
Seat 7: gatorgrinds (39273 in chips)=20
Seat 8: L8terGators (104368 in chips)=20
sfarbs: posts the ante 625
Decklyn71: posts the ante 625
DebOCNJ: posts the ante 625
JJin91: posts the ante 625
Paceman2jr: posts the ante 625
gatorgrinds: posts the ante 625
L8terGators: posts the ante 625
sfarbs: posts small blind 2500
Decklyn71: posts big blind 5000
*** HOLE CARDS ***
Dealt to JJin91 [Qs 3d]
DebOCNJ: folds=20
JJin91: folds=20
Paceman2jr: folds=20
gatorgrinds: folds=20
L8terGators: folds=20
sfarbs: raises 197052 to 202052 and is all-in
Decklyn71: folds=20
Uncalled bet (197052) returned to sfarbs
sfarbs collected 14375 from pot
sfarbs: doesn't show hand=20
*** SUMMARY ***
Total pot 14375 | Rake 0=20
Seat 1: sfarbs (small blind) collected (14375)
Seat 3: Decklyn71 (big blind) folded before Flop
Seat 4: DebOCNJ folded before Flop (didn't bet)
Seat 5: JJin91 folded before Flop (didn't bet)
Seat 6: Paceman2jr folded before Flop (didn't bet)
Seat 7: gatorgrinds folded before Flop (didn't bet)
Seat 8: L8terGators (button) folded before Flop (didn't bet)


*********** # 197 **************
PokerStars Hand #171446058093: Tournament #1648956582, $18.20+$1.80 USD=
 Hold'em No Limit - Level XXIII (2500/5000) - 2017/06/19 23:06:33 ET
Table '1648956582 2' 9-max Seat #1 is the button
Seat 1: sfarbs (211427 in chips)=20
Seat 3: Decklyn71 (45053 in chips)=20
Seat 4: DebOCNJ (190856 in chips)=20
Seat 5: JJin91 (91951 in chips)=20
Seat 6: Paceman2jr (77795 in chips)=20
Seat 7: gatorgrinds (38648 in chips)=20
Seat 8: L8terGators (103743 in chips)=20
sfarbs: posts the ante 625
Decklyn71: posts the ante 625
DebOCNJ: posts the ante 625
JJin91: posts the ante 625
Paceman2jr: posts the ante 625
gatorgrinds: posts the ante 625
L8terGators: posts the ante 625
Decklyn71: posts small blind 2500
DebOCNJ: posts big blind 5000
*** HOLE CARDS ***
Dealt to JJin91 [Td 5c]
JJin91: folds=20
Paceman2jr: folds=20
gatorgrinds: folds=20
L8terGators: folds=20
sfarbs: raises 6150 to 11150
Decklyn71: raises 33278 to 44428 and is all-in
DebOCNJ: folds=20
sfarbs: calls 33278
*** FLOP *** [6d 8s Qs]
*** TURN *** [6d 8s Qs] [9c]
*** RIVER *** [6d 8s Qs 9c] [Jd]
*** SHOW DOWN ***
Decklyn71: shows [Kh Kc] (a pair of Kings)
sfarbs: shows [5s As] (high card Ace)
Decklyn71 collected 98231 from pot
*** SUMMARY ***
Total pot 98231 | Rake 0=20
Board [6d 8s Qs 9c Jd]
Seat 1: sfarbs (button) showed [5s As] and lost with high card Ace
Seat 3: Decklyn71 (small blind) showed [Kh Kc] and won (98231) with a p=
air of Kings
Seat 4: DebOCNJ (big blind) folded before Flop
Seat 5: JJin91 folded before Flop (didn't bet)
Seat 6: Paceman2jr folded before Flop (didn't bet)
Seat 7: gatorgrinds folded before Flop (didn't bet)
Seat 8: L8terGators folded before Flop (didn't bet)


*********** # 198 **************
PokerStars Hand #171446058237: Tournament #1648956582, $18.20+$1.80 USD=
 Hold'em No Limit - Level XXIII (2500/5000) - 2017/06/19 23:07:03 ET
Table '1648956582 2' 9-max Seat #3 is the button
Seat 1: sfarbs (166374 in chips)=20
Seat 3: Decklyn71 (98231 in chips)=20
Seat 4: DebOCNJ (185231 in chips)=20
Seat 5: JJin91 (91326 in chips)=20
Seat 6: Paceman2jr (77170 in chips)=20
Seat 7: gatorgrinds (38023 in chips)=20
Seat 8: L8terGators (103118 in chips)=20
sfarbs: posts the ante 625
Decklyn71: posts the ante 625
DebOCNJ: posts the ante 625
JJin91: posts the ante 625
Paceman2jr: posts the ante 625
gatorgrinds: posts the ante 625
L8terGators: posts the ante 625
DebOCNJ: posts small blind 2500
JJin91: posts big blind 5000
*** HOLE CARDS ***
Dealt to JJin91 [9c Kh]
Paceman2jr: folds=20
gatorgrinds: folds=20
L8terGators: folds=20
sfarbs: raises 6150 to 11150
Decklyn71: folds=20
DebOCNJ: folds=20
JJin91: calls 6150
*** FLOP *** [9s 2d 5h]
JJin91: checks=20
sfarbs: checks=20
*** TURN *** [9s 2d 5h] [5c]
JJin91: bets 16630
sfarbs: calls 16630
*** RIVER *** [9s 2d 5h 5c] [4s]
JJin91: checks=20
sfarbs: checks=20
*** SHOW DOWN ***
JJin91: shows [9c Kh] (two pair, Nines and Fives)
sfarbs: mucks hand=20
JJin91 collected 62435 from pot
*** SUMMARY ***
Total pot 62435 | Rake 0=20
Board [9s 2d 5h 5c 4s]
Seat 1: sfarbs mucked [Th Ah]
Seat 3: Decklyn71 (button) folded before Flop (didn't bet)
Seat 4: DebOCNJ (small blind) folded before Flop
Seat 5: JJin91 (big blind) showed [9c Kh] and won (62435) with two pair=
, Nines and Fives
Seat 6: Paceman2jr folded before Flop (didn't bet)
Seat 7: gatorgrinds folded before Flop (didn't bet)
Seat 8: L8terGators folded before Flop (didn't bet)


*********** # 199 **************
PokerStars Hand #171446058449: Tournament #1648956582, $18.20+$1.80 USD=
 Hold'em No Limit - Level XXIII (2500/5000) - 2017/06/19 23:07:51 ET
Table '1648956582 2' 9-max Seat #4 is the button
Seat 1: sfarbs (137969 in chips)=20
Seat 3: Decklyn71 (97606 in chips)=20
Seat 4: DebOCNJ (182106 in chips)=20
Seat 5: JJin91 (125356 in chips)=20
Seat 6: Paceman2jr (76545 in chips)=20
Seat 7: gatorgrinds (37398 in chips)=20
Seat 8: L8terGators (102493 in chips)=20
sfarbs: posts the ante 625
Decklyn71: posts the ante 625
DebOCNJ: posts the ante 625
JJin91: posts the ante 625
Paceman2jr: posts the ante 625
gatorgrinds: posts the ante 625
L8terGators: posts the ante 625
JJin91: posts small blind 2500
Paceman2jr: posts big blind 5000
*** HOLE CARDS ***
Dealt to JJin91 [Jd Jc]
gatorgrinds: folds=20
L8terGators: folds=20
sfarbs: raises 6150 to 11150
Decklyn71: folds=20
DebOCNJ: folds=20
JJin91: raises 11081 to 22231
Paceman2jr: folds=20
sfarbs: calls 11081
*** FLOP *** [7h 2s Kd]
JJin91: bets 13342
sfarbs: folds=20
Uncalled bet (13342) returned to JJin91
JJin91 collected 53837 from pot
JJin91: doesn't show hand=20
*** SUMMARY ***
Total pot 53837 | Rake 0=20
Board [7h 2s Kd]
Seat 1: sfarbs folded on the Flop
Seat 3: Decklyn71 folded before Flop (didn't bet)
Seat 4: DebOCNJ (button) folded before Flop (didn't bet)
Seat 5: JJin91 (small blind) collected (53837)
Seat 6: Paceman2jr (big blind) folded before Flop
Seat 7: gatorgrinds folded before Flop (didn't bet)
Seat 8: L8terGators folded before Flop (didn't bet)


*********** # 200 **************
PokerStars Hand #171446058748: Tournament #1648956582, $18.20+$1.80 USD=
 Hold'em No Limit - Level XXIII (2500/5000) - 2017/06/19 23:08:59 ET
Table '1648956582 2' 9-max Seat #5 is the button
Seat 1: sfarbs (115113 in chips)=20
Seat 3: Decklyn71 (96981 in chips)=20
Seat 4: DebOCNJ (181481 in chips)=20
Seat 5: JJin91 (156337 in chips)=20
Seat 6: Paceman2jr (70920 in chips)=20
Seat 7: gatorgrinds (36773 in chips)=20
Seat 8: L8terGators (101868 in chips)=20
sfarbs: posts the ante 625
Decklyn71: posts the ante 625
DebOCNJ: posts the ante 625
JJin91: posts the ante 625
Paceman2jr: posts the ante 625
gatorgrinds: posts the ante 625
L8terGators: posts the ante 625
Paceman2jr: posts small blind 2500
gatorgrinds: posts big blind 5000
*** HOLE CARDS ***
Dealt to JJin91 [2c 8d]
L8terGators: raises 5000 to 10000
sfarbs: folds=20
Decklyn71: folds=20
DebOCNJ: folds=20
JJin91: folds=20
Paceman2jr: folds=20
gatorgrinds: folds=20
Uncalled bet (5000) returned to L8terGators
L8terGators collected 16875 from pot
*** SUMMARY ***
Total pot 16875 | Rake 0=20
Seat 1: sfarbs folded before Flop (didn't bet)
Seat 3: Decklyn71 folded before Flop (didn't bet)
Seat 4: DebOCNJ folded before Flop (didn't bet)
Seat 5: JJin91 (button) folded before Flop (didn't bet)
Seat 6: Paceman2jr (small blind) folded before Flop
Seat 7: gatorgrinds (big blind) folded before Flop
Seat 8: L8terGators collected (16875)


*********** # 201 **************
PokerStars Hand #171446058866: Tournament #1648956582, $18.20+$1.80 USD=
 Hold'em No Limit - Level XXIII (2500/5000) - 2017/06/19 23:09:28 ET
Table '1648956582 2' 9-max Seat #6 is the button
Seat 1: sfarbs (114488 in chips)=20
Seat 3: Decklyn71 (96356 in chips)=20
Seat 4: DebOCNJ (180856 in chips)=20
Seat 5: JJin91 (155712 in chips)=20
Seat 6: Paceman2jr (67795 in chips)=20
Seat 7: gatorgrinds (31148 in chips)=20
Seat 8: L8terGators (113118 in chips)=20
sfarbs: posts the ante 625
Decklyn71: posts the ante 625
DebOCNJ: posts the ante 625
JJin91: posts the ante 625
Paceman2jr: posts the ante 625
gatorgrinds: posts the ante 625
L8terGators: posts the ante 625
gatorgrinds: posts small blind 2500
L8terGators: posts big blind 5000
*** HOLE CARDS ***
Dealt to JJin91 [Ah Ad]
sfarbs: folds=20
Decklyn71: folds=20
DebOCNJ: folds=20
JJin91: raises 7850 to 12850
Paceman2jr: folds=20
gatorgrinds: folds=20
L8terGators: folds=20
Uncalled bet (7850) returned to JJin91
JJin91 collected 16875 from pot
JJin91: doesn't show hand=20
*** SUMMARY ***
Total pot 16875 | Rake 0=20
Seat 1: sfarbs folded before Flop (didn't bet)
Seat 3: Decklyn71 folded before Flop (didn't bet)
Seat 4: DebOCNJ folded before Flop (didn't bet)
Seat 5: JJin91 collected (16875)
Seat 6: Paceman2jr (button) folded before Flop (didn't bet)
Seat 7: gatorgrinds (small blind) folded before Flop
Seat 8: L8terGators (big blind) folded before Flop


*********** # 202 **************
PokerStars Hand #171446058937: Tournament #1648956582, $18.20+$1.80 USD=
 Hold'em No Limit - Level XXIII (2500/5000) - 2017/06/19 23:09:44 ET
Table '1648956582 2' 9-max Seat #7 is the button
Seat 1: sfarbs (113863 in chips)=20
Seat 3: Decklyn71 (95731 in chips)=20
Seat 4: DebOCNJ (180231 in chips)=20
Seat 5: JJin91 (166962 in chips)=20
Seat 6: Paceman2jr (67170 in chips)=20
Seat 7: gatorgrinds (28023 in chips)=20
Seat 8: L8terGators (107493 in chips)=20
sfarbs: posts the ante 625
Decklyn71: posts the ante 625
DebOCNJ: posts the ante 625
JJin91: posts the ante 625
Paceman2jr: posts the ante 625
gatorgrinds: posts the ante 625
L8terGators: posts the ante 625
L8terGators: posts small blind 2500
sfarbs: posts big blind 5000
*** HOLE CARDS ***
Dealt to JJin91 [Jc 2d]
Decklyn71: folds=20
DebOCNJ: folds=20
JJin91: folds=20
Paceman2jr: folds=20
gatorgrinds: folds=20
L8terGators: raises 6205 to 11205
sfarbs: calls 6205
*** FLOP *** [Qh 5c 7s]
L8terGators: bets 11540
sfarbs: folds=20
Uncalled bet (11540) returned to L8terGators
L8terGators collected 26785 from pot
L8terGators: doesn't show hand=20
*** SUMMARY ***
Total pot 26785 | Rake 0=20
Board [Qh 5c 7s]
Seat 1: sfarbs (big blind) folded on the Flop
Seat 3: Decklyn71 folded before Flop (didn't bet)
Seat 4: DebOCNJ folded before Flop (didn't bet)
Seat 5: JJin91 folded before Flop (didn't bet)
Seat 6: Paceman2jr folded before Flop (didn't bet)
Seat 7: gatorgrinds (button) folded before Flop (didn't bet)
Seat 8: L8terGators (small blind) collected (26785)


*********** # 203 **************
PokerStars Hand #171446059104: Tournament #1648956582, $18.20+$1.80 USD=
 Hold'em No Limit - Level XXIII (2500/5000) - 2017/06/19 23:10:25 ET
Table '1648956582 2' 9-max Seat #8 is the button
Seat 1: sfarbs (102033 in chips)=20
Seat 3: Decklyn71 (95106 in chips)=20
Seat 4: DebOCNJ (179606 in chips)=20
Seat 5: JJin91 (166337 in chips)=20
Seat 6: Paceman2jr (66545 in chips)=20
Seat 7: gatorgrinds (27398 in chips)=20
Seat 8: L8terGators (122448 in chips)=20
sfarbs: posts the ante 625
Decklyn71: posts the ante 625
DebOCNJ: posts the ante 625
JJin91: posts the ante 625
Paceman2jr: posts the ante 625
gatorgrinds: posts the ante 625
L8terGators: posts the ante 625
sfarbs: posts small blind 2500
Decklyn71: posts big blind 5000
*** HOLE CARDS ***
Dealt to JJin91 [7d Tc]
DebOCNJ: folds=20
JJin91: folds=20
Paceman2jr: folds=20
gatorgrinds: raises 21773 to 26773 and is all-in
L8terGators: folds=20
sfarbs: folds=20
Decklyn71: folds=20
Uncalled bet (21773) returned to gatorgrinds
gatorgrinds collected 16875 from pot
gatorgrinds: doesn't show hand=20
*** SUMMARY ***
Total pot 16875 | Rake 0=20
Seat 1: sfarbs (small blind) folded before Flop
Seat 3: Decklyn71 (big blind) folded before Flop
Seat 4: DebOCNJ folded before Flop (didn't bet)
Seat 5: JJin91 folded before Flop (didn't bet)
Seat 6: Paceman2jr folded before Flop (didn't bet)
Seat 7: gatorgrinds collected (16875)
Seat 8: L8terGators (button) folded before Flop (didn't bet)


*********** # 204 **************
PokerStars Hand #171446059165: Tournament #1648956582, $18.20+$1.80 USD=
 Hold'em No Limit - Level XXIII (2500/5000) - 2017/06/19 23:10:40 ET
Table '1648956582 2' 9-max Seat #1 is the button
Seat 1: sfarbs (98908 in chips)=20
Seat 3: Decklyn71 (89481 in chips)=20
Seat 4: DebOCNJ (178981 in chips)=20
Seat 5: JJin91 (165712 in chips)=20
Seat 6: Paceman2jr (65920 in chips)=20
Seat 7: gatorgrinds (38648 in chips)=20
Seat 8: L8terGators (121823 in chips)=20
sfarbs: posts the ante 625
Decklyn71: posts the ante 625
DebOCNJ: posts the ante 625
JJin91: posts the ante 625
Paceman2jr: posts the ante 625
gatorgrinds: posts the ante 625
L8terGators: posts the ante 625
Decklyn71: posts small blind 2500
DebOCNJ: posts big blind 5000
*** HOLE CARDS ***
Dealt to JJin91 [4s Qh]
JJin91: folds=20
Paceman2jr: folds=20
gatorgrinds: raises 33023 to 38023 and is all-in
L8terGators: folds=20
sfarbs: folds=20
Decklyn71: folds=20
DebOCNJ: calls 33023
*** FLOP *** [9c Js Ks]
*** TURN *** [9c Js Ks] [Tc]
*** RIVER *** [9c Js Ks Tc] [9s]
*** SHOW DOWN ***
DebOCNJ: shows [As Jc] (two pair, Jacks and Nines)
gatorgrinds: shows [9h 8h] (three of a kind, Nines)
gatorgrinds collected 82921 from pot
*** SUMMARY ***
Total pot 82921 | Rake 0=20
Board [9c Js Ks Tc 9s]
Seat 1: sfarbs (button) folded before Flop (didn't bet)
Seat 3: Decklyn71 (small blind) folded before Flop
Seat 4: DebOCNJ (big blind) showed [As Jc] and lost with two pair, Jack=
s and Nines
Seat 5: JJin91 folded before Flop (didn't bet)
Seat 6: Paceman2jr folded before Flop (didn't bet)
Seat 7: gatorgrinds showed [9h 8h] and won (82921) with three of a kind=
, Nines
Seat 8: L8terGators folded before Flop (didn't bet)


*********** # 205 **************
PokerStars Hand #171446059247: Tournament #1648956582, $18.20+$1.80 USD=
 Hold'em No Limit - Level XXIII (2500/5000) - 2017/06/19 23:11:05 ET
Table '1648956582 2' 9-max Seat #3 is the button
Seat 1: sfarbs (98283 in chips)=20
Seat 3: Decklyn71 (86356 in chips)=20
Seat 4: DebOCNJ (140333 in chips)=20
Seat 5: JJin91 (165087 in chips)=20
Seat 6: Paceman2jr (65295 in chips)=20
Seat 7: gatorgrinds (82921 in chips)=20
Seat 8: L8terGators (121198 in chips)=20
sfarbs: posts the ante 625
Decklyn71: posts the ante 625
DebOCNJ: posts the ante 625
JJin91: posts the ante 625
Paceman2jr: posts the ante 625
gatorgrinds: posts the ante 625
L8terGators: posts the ante 625
DebOCNJ: posts small blind 2500
JJin91: posts big blind 5000
*** HOLE CARDS ***
Dealt to JJin91 [Qh Qs]
Paceman2jr: folds=20
gatorgrinds: folds=20
L8terGators: raises 5000 to 10000
sfarbs: folds=20
Decklyn71: folds=20
DebOCNJ: calls 7500
JJin91: raises 24567 to 34567
L8terGators: raises 86006 to 120573 and is all-in
DebOCNJ: folds=20
JJin91: calls 86006
*** FLOP *** [9s Jd 4d]
*** TURN *** [9s Jd 4d] [Td]
*** RIVER *** [9s Jd 4d Td] [6s]
*** SHOW DOWN ***
JJin91: shows [Qh Qs] (a pair of Queens)
L8terGators: shows [Ac As] (a pair of Aces)
L8terGators collected 255521 from pot
*** SUMMARY ***
Total pot 255521 | Rake 0=20
Board [9s Jd 4d Td 6s]
Seat 1: sfarbs folded before Flop (didn't bet)
Seat 3: Decklyn71 (button) folded before Flop (didn't bet)
Seat 4: DebOCNJ (small blind) folded before Flop
Seat 5: JJin91 (big blind) showed [Qh Qs] and lost with a pair of Queens
Seat 6: Paceman2jr folded before Flop (didn't bet)
Seat 7: gatorgrinds folded before Flop (didn't bet)
Seat 8: L8terGators showed [Ac As] and won (255521) with a pair of Aces


*********** # 206 **************
PokerStars Hand #171446059512: Tournament #1648956582, $18.20+$1.80 USD=
 Hold'em No Limit - Level XXIII (2500/5000) - 2017/06/19 23:12:09 ET
Table '1648956582 2' 9-max Seat #4 is the button
Seat 1: sfarbs (97658 in chips)=20
Seat 3: Decklyn71 (85731 in chips)=20
Seat 4: DebOCNJ (129708 in chips)=20
Seat 5: JJin91 (43889 in chips)=20
Seat 6: Paceman2jr (64670 in chips)=20
Seat 7: gatorgrinds (82296 in chips)=20
Seat 8: L8terGators (255521 in chips)=20
sfarbs: posts the ante 625
Decklyn71: posts the ante 625
DebOCNJ: posts the ante 625
JJin91: posts the ante 625
Paceman2jr: posts the ante 625
gatorgrinds: posts the ante 625
L8terGators: posts the ante 625
JJin91: posts small blind 2500
Paceman2jr: posts big blind 5000
*** HOLE CARDS ***
Dealt to JJin91 [6s Ks]
gatorgrinds: folds=20
L8terGators: folds=20
sfarbs: folds=20
Decklyn71: folds=20
DebOCNJ: folds=20
JJin91: raises 38264 to 43264 and is all-in
Paceman2jr: calls 38264
*** FLOP *** [4c 8h Jd]
*** TURN *** [4c 8h Jd] [9s]
*** RIVER *** [4c 8h Jd 9s] [9h]
*** SHOW DOWN ***
JJin91: shows [6s Ks] (a pair of Nines)
Paceman2jr: shows [As Jh] (two pair, Jacks and Nines)
Paceman2jr collected 90903 from pot
JJin91 finished the tournament in 13th place and received $43.13.
*** SUMMARY ***
Total pot 90903 | Rake 0=20
Board [4c 8h Jd 9s 9h]
Seat 1: sfarbs folded before Flop (didn't bet)
Seat 3: Decklyn71 folded before Flop (didn't bet)
Seat 4: DebOCNJ (button) folded before Flop (didn't bet)
Seat 5: JJin91 (small blind) showed [6s Ks] and lost with a pair of Nin=
es
Seat 6: Paceman2jr (big blind) showed [As Jh] and won (90903) with two =
pair, Jacks and Nines
Seat 7: gatorgrinds folded before Flop (didn't bet)
Seat 8: L8terGators folded before Flop (didn't bet)



If you have any questions, please contact us at "PokerStars Support" <s=
upport@pokerstarsnj.com>


