Delivered-To: jamiejin91@gmail.com
Received: by 10.100.183.33 with SMTP id u30csp1204749pjb;
        Sat, 23 Sep 2017 19:54:04 -0700 (PDT)
X-Google-Smtp-Source: AOwi7QAPb/E5G8dVFuneEEKeF7CYASVOZ5GbSvU6qBlN1PPs1LPp8vFDYDI1GLGzCPBhNoSMoFNe
X-Received: by 10.223.161.23 with SMTP id o23mr2991621wro.103.1506221644503;
        Sat, 23 Sep 2017 19:54:04 -0700 (PDT)
ARC-Seal: i=1; a=rsa-sha256; t=1506221644; cv=none;
        d=google.com; s=arc-20160816;
        b=Oa8xiPB3vy3q6obIRgbgxP12J6OYS0wzoINg20qclso9TwGc+gHILdS1NgKO4hciG5
         l01sJrA5NXPSpjTutpq16lAXLm+vj5Zk74q/DsF2ek+pJ/IwVZiBD1KePKsk9OERNP5i
         Qs2UObbJyQZBgxz9QHYYEERm+VpUnQL9WUQ/yfVKQk+vtSy6osA/WW3GA2CkhGr5eHUq
         TI+7QD/bi/wbdzsFp/QgFJMb6YceHIYioUZyctGiq4Hw1Zm8pvUUQq4Ztg2pv8atS0FU
         wZze+Sp/z8wz2d7yhHeoSHnAtvNQtD+UDLaB3NVD3IkKmC2X4xZ86oQF2jDqbxhmtuMB
         0NiQ==
ARC-Message-Signature: i=1; a=rsa-sha256; c=relaxed/relaxed; d=google.com; s=arc-20160816;
        h=content-transfer-encoding:mime-version:message-id:subject:to:from
         :date:list-unsubscribe:dkim-signature:arc-authentication-results;
        bh=YlaohEjWJsxuPxhpI2TeWLHchts28KTHJRoSRx2hkZE=;
        b=MUJSsYhOq2uk1Ln15p6lh1YMv0XmPpZtO/hrZmt1+3SCZnoj4RPoC5e6LmOG1CaKIA
         78h7hsr7BCf+vqzggQGXomrSThdBdQkALZoY2WqSfjHZtN9gAhCe9kT9cxJuR/ahnL3+
         Ahv4B97Gt/j/UZ2D3Wd+cLOIpDPXQYDm57Arqc10hIH5XjACrSNaLbLaQJKqta3EJydW
         w/4qdJnhxIc+++tSUVHsLYELWTJNy/kgBvBJGEA9dmgw111YklzmF+4Xk+5grt2454Xt
         ij6LCoG9uAmShF2i85BssSA2oyJgK8YXbc1WV2fVgncq7suJh5gLRMEvZTff9kCLtCvp
         m28Q==
ARC-Authentication-Results: i=1; mx.google.com;
       dkim=pass (test mode) header.i=@pokerstarsnj.com header.s=s1024 header.b=h8MKGzeH;
       spf=pass (google.com: domain of support@pokerstarsnj.com designates 77.87.179.125 as permitted sender) smtp.mailfrom=support@pokerstarsnj.com;
       dmarc=pass (p=QUARANTINE sp=QUARANTINE dis=NONE) header.from=pokerstarsnj.com
Return-Path: <support@pokerstarsnj.com>
Received: from mx13.pokerstars.eu (mx13.pokerstars.eu. [77.87.179.125])
        by mx.google.com with ESMTPS id a131si2303299wme.119.2017.09.23.19.54.04
        for <jamiejin91@gmail.com>
        (version=TLS1_2 cipher=ECDHE-RSA-AES128-GCM-SHA256 bits=128/128);
        Sat, 23 Sep 2017 19:54:04 -0700 (PDT)
Received-SPF: pass (google.com: domain of support@pokerstarsnj.com designates 77.87.179.125 as permitted sender) client-ip=77.87.179.125;
Authentication-Results: mx.google.com;
       dkim=pass (test mode) header.i=@pokerstarsnj.com header.s=s1024 header.b=h8MKGzeH;
       spf=pass (google.com: domain of support@pokerstarsnj.com designates 77.87.179.125 as permitted sender) smtp.mailfrom=support@pokerstarsnj.com;
       dmarc=pass (p=QUARANTINE sp=QUARANTINE dis=NONE) header.from=pokerstarsnj.com
Received: by mx13.pokerstars.eu (mailer, from userid 503)
	id C025E1FC7040; Sat, 23 Sep 2017 22:54:03 -0400 (EDT)
DKIM-Signature: v=1; a=rsa-sha1; c=relaxed; d=pokerstarsnj.com; h=
	list-unsubscribe:date:from:to:subject:message-id:mime-version
	:content-type:content-transfer-encoding; s=s1024; bh=357Ohi0xwFk
	bPgjtivlM1mFm2OM=; b=h8MKGzeHWdUCRHcXBzFL6OC6OoMkYkFwtjuhUxaSZhM
	yzJADRw0yrR/cOL/YkhSkwnVqYdDN6mvZDM7+JwdSHfW7oepj2IUsd9tL+90Z5F3
	i52YVUh4su6zDMpmcHzUJppVSgq/sVD6cVRgj8Bbn89Op4xCZg7KvwjcMRYSyNWM
	=
List-Unsubscribe: <mailto:support@pokerstarsnj.com?subject=_REMOVE>
X-PS-ID: amFtaWVqaW45MUBnbWFpbC5jb20=
Received: from mx12.nj.pokerstars.com (unknown [192.168.8.12])
	by mx13.pokerstars.eu (mailer) with ESMTP id ECBF91FC6C54
	for <jamiejin91@gmail.com>; Sat, 23 Sep 2017 22:54:02 -0400 (EDT)
Received: from pokerstarsnj.com (unknown [121.121.121.253])
	by mx12.nj.pokerstars.com (mailer) with SMTP id A0FADC48308
	for <jamiejin91@gmail.com>; Sat, 23 Sep 2017 22:54:02 -0400 (EDT)
Date: Sat, 23 Sep 2017 22:54:02 -0400
From: "PokerStars Support" <support@pokerstarsnj.com>
To: jamiejin91@gmail.com
Subject: PokerStars Hand History Request - Tournament 1701793956
Message-Id: <59C71E4A.DB84FC13186630@pokerstarsnj.com>
MIME-Version: 1.0
Content-Type: text/plain;
 charset="windows-1252"
Content-Transfer-Encoding: quoted-printable


Transcript for tournament #1701793956 requested by JJin91 (jamiejin91@g=
mail.com)

*********** # 1 **************
PokerStars Hand #175432049436: Tournament #1701793956, $18.20+$1.80 USD=
 Hold'em No Limit - Level VIII (125/250) - 2017/09/23 20:25:01 ET
Table '1701793956 2' 9-max Seat #8 is the button
Seat 2: mks24 (8300 in chips)=20
Seat 3: eliozica (12100 in chips)=20
Seat 4: cangri79 (10080 in chips)=20
Seat 5: JJin91 (10000 in chips)=20
Seat 6: @Bud_Fox0000 (6666 in chips)=20
Seat 7: PokerPayman (6530 in chips)=20
Seat 8: 1st.p1ace (13250 in chips)=20
Seat 9: Funkyphill99 (16275 in chips)=20
mks24: posts the ante 30
eliozica: posts the ante 30
cangri79: posts the ante 30
JJin91: posts the ante 30
@Bud_Fox0000: posts the ante 30
PokerPayman: posts the ante 30
1st.p1ace: posts the ante 30
Funkyphill99: posts the ante 30
Funkyphill99: posts small blind 125
mks24: posts big blind 250
*** HOLE CARDS ***
Dealt to JJin91 [9c Ks]
eliozica: folds=20
cangri79: calls 250
JJin91: folds=20
@Bud_Fox0000: folds=20
PokerPayman: raises 500 to 750
1st.p1ace: folds=20
Funkyphill99: folds=20
mks24: calls 500
cangri79: calls 500
*** FLOP *** [Qc 5h 4c]
mks24: checks=20
cangri79: checks=20
PokerPayman: bets 1000
mks24: folds=20
cangri79: folds=20
Uncalled bet (1000) returned to PokerPayman
PokerPayman collected 2615 from pot
PokerPayman: doesn't show hand=20
*** SUMMARY ***
Total pot 2615 | Rake 0=20
Board [Qc 5h 4c]
Seat 2: mks24 (big blind) folded on the Flop
Seat 3: eliozica folded before Flop (didn't bet)
Seat 4: cangri79 folded on the Flop
Seat 5: JJin91 folded before Flop (didn't bet)
Seat 6: @Bud_Fox0000 folded before Flop (didn't bet)
Seat 7: PokerPayman collected (2615)
Seat 8: 1st.p1ace (button) folded before Flop (didn't bet)
Seat 9: Funkyphill99 (small blind) folded before Flop


*********** # 2 **************
PokerStars Hand #175432049663: Tournament #1701793956, $18.20+$1.80 USD=
 Hold'em No Limit - Level IX (150/300) - 2017/09/23 20:26:07 ET
Table '1701793956 2' 9-max Seat #9 is the button
Seat 2: mks24 (7520 in chips)=20
Seat 3: eliozica (12070 in chips)=20
Seat 4: cangri79 (9300 in chips)=20
Seat 5: JJin91 (9970 in chips)=20
Seat 6: @Bud_Fox0000 (6636 in chips)=20
Seat 7: PokerPayman (8365 in chips)=20
Seat 8: 1st.p1ace (13220 in chips)=20
Seat 9: Funkyphill99 (16120 in chips)=20
mks24: posts the ante 40
eliozica: posts the ante 40
cangri79: posts the ante 40
JJin91: posts the ante 40
@Bud_Fox0000: posts the ante 40
PokerPayman: posts the ante 40
1st.p1ace: posts the ante 40
Funkyphill99: posts the ante 40
mks24: posts small blind 150
eliozica: posts big blind 300
*** HOLE CARDS ***
Dealt to JJin91 [3c 8d]
cangri79: folds=20
JJin91: folds=20
@Bud_Fox0000: folds=20
PokerPayman: folds=20
1st.p1ace: raises 450 to 750
Funkyphill99: folds=20
mks24: folds=20
eliozica: raises 1970 to 2720
1st.p1ace: folds=20
Uncalled bet (1970) returned to eliozica
eliozica collected 1970 from pot
eliozica: doesn't show hand=20
*** SUMMARY ***
Total pot 1970 | Rake 0=20
Seat 2: mks24 (small blind) folded before Flop
Seat 3: eliozica (big blind) collected (1970)
Seat 4: cangri79 folded before Flop (didn't bet)
Seat 5: JJin91 folded before Flop (didn't bet)
Seat 6: @Bud_Fox0000 folded before Flop (didn't bet)
Seat 7: PokerPayman folded before Flop (didn't bet)
Seat 8: 1st.p1ace folded before Flop
Seat 9: Funkyphill99 (button) folded before Flop (didn't bet)


*********** # 3 **************
PokerStars Hand #175432049819: Tournament #1701793956, $18.20+$1.80 USD=
 Hold'em No Limit - Level IX (150/300) - 2017/09/23 20:26:52 ET
Table '1701793956 2' 9-max Seat #2 is the button
Seat 2: mks24 (7330 in chips)=20
Seat 3: eliozica (13250 in chips)=20
Seat 4: cangri79 (9260 in chips)=20
Seat 5: JJin91 (9930 in chips)=20
Seat 6: @Bud_Fox0000 (6596 in chips)=20
Seat 7: PokerPayman (8325 in chips)=20
Seat 8: 1st.p1ace (12430 in chips)=20
Seat 9: Funkyphill99 (16080 in chips)=20
mks24: posts the ante 40
eliozica: posts the ante 40
cangri79: posts the ante 40
JJin91: posts the ante 40
@Bud_Fox0000: posts the ante 40
PokerPayman: posts the ante 40
1st.p1ace: posts the ante 40
Funkyphill99: posts the ante 40
eliozica: posts small blind 150
cangri79: posts big blind 300
*** HOLE CARDS ***
Dealt to JJin91 [Js Tc]
JJin91: folds=20
@Bud_Fox0000: folds=20
PokerPayman: calls 300
1st.p1ace: folds=20
Funkyphill99: raises 1285 to 1585
mks24: folds=20
eliozica: folds=20
cangri79: folds=20
PokerPayman: folds=20
Uncalled bet (1285) returned to Funkyphill99
Funkyphill99 collected 1370 from pot
Funkyphill99: doesn't show hand=20
*** SUMMARY ***
Total pot 1370 | Rake 0=20
Seat 2: mks24 (button) folded before Flop (didn't bet)
Seat 3: eliozica (small blind) folded before Flop
Seat 4: cangri79 (big blind) folded before Flop
Seat 5: JJin91 folded before Flop (didn't bet)
Seat 6: @Bud_Fox0000 folded before Flop (didn't bet)
Seat 7: PokerPayman folded before Flop
Seat 8: 1st.p1ace folded before Flop (didn't bet)
Seat 9: Funkyphill99 collected (1370)


*********** # 4 **************
PokerStars Hand #175432049956: Tournament #1701793956, $18.20+$1.80 USD=
 Hold'em No Limit - Level IX (150/300) - 2017/09/23 20:27:30 ET
Table '1701793956 2' 9-max Seat #3 is the button
Seat 2: mks24 (7290 in chips)=20
Seat 3: eliozica (13060 in chips)=20
Seat 4: cangri79 (8920 in chips)=20
Seat 5: JJin91 (9890 in chips)=20
Seat 6: @Bud_Fox0000 (6556 in chips)=20
Seat 7: PokerPayman (7985 in chips)=20
Seat 8: 1st.p1ace (12390 in chips)=20
Seat 9: Funkyphill99 (17110 in chips)=20
mks24: posts the ante 40
eliozica: posts the ante 40
cangri79: posts the ante 40
JJin91: posts the ante 40
@Bud_Fox0000: posts the ante 40
PokerPayman: posts the ante 40
1st.p1ace: posts the ante 40
Funkyphill99: posts the ante 40
cangri79: posts small blind 150
JJin91: posts big blind 300
*** HOLE CARDS ***
Dealt to JJin91 [Jh 7s]
@Bud_Fox0000: folds=20
PokerPayman: folds=20
1st.p1ace: folds=20
Funkyphill99: folds=20
mks24: folds=20
eliozica: raises 600 to 900
cangri79: raises 7980 to 8880 and is all-in
JJin91: folds=20
eliozica: folds=20
Uncalled bet (7980) returned to cangri79
cangri79 collected 2420 from pot
*** SUMMARY ***
Total pot 2420 | Rake 0=20
Seat 2: mks24 folded before Flop (didn't bet)
Seat 3: eliozica (button) folded before Flop
Seat 4: cangri79 (small blind) collected (2420)
Seat 5: JJin91 (big blind) folded before Flop
Seat 6: @Bud_Fox0000 folded before Flop (didn't bet)
Seat 7: PokerPayman folded before Flop (didn't bet)
Seat 8: 1st.p1ace folded before Flop (didn't bet)
Seat 9: Funkyphill99 folded before Flop (didn't bet)


*********** # 5 **************
PokerStars Hand #175432695418: Tournament #1701793956, $18.20+$1.80 USD=
 Hold'em No Limit - Level IX (150/300) - 2017/09/23 20:28:16 ET
Table '1701793956 2' 9-max Seat #4 is the button
Seat 2: mks24 (7250 in chips)=20
Seat 3: eliozica (12120 in chips)=20
Seat 4: cangri79 (10400 in chips)=20
Seat 5: JJin91 (9550 in chips)=20
Seat 6: @Bud_Fox0000 (6516 in chips)=20
Seat 7: PokerPayman (7945 in chips)=20
Seat 8: 1st.p1ace (12350 in chips)=20
Seat 9: Funkyphill99 (17070 in chips)=20
mks24: posts the ante 40
eliozica: posts the ante 40
cangri79: posts the ante 40
JJin91: posts the ante 40
@Bud_Fox0000: posts the ante 40
PokerPayman: posts the ante 40
1st.p1ace: posts the ante 40
Funkyphill99: posts the ante 40
JJin91: posts small blind 150
@Bud_Fox0000: posts big blind 300
*** HOLE CARDS ***
Dealt to JJin91 [Jh 2s]
PokerPayman: raises 300 to 600
1st.p1ace: folds=20
Funkyphill99: folds=20
mks24: folds=20
eliozica: folds=20
cangri79: raises 9760 to 10360 and is all-in
JJin91: folds=20
@Bud_Fox0000: folds=20
PokerPayman: folds=20
Uncalled bet (9760) returned to cangri79
cangri79 collected 1970 from pot
*** SUMMARY ***
Total pot 1970 | Rake 0=20
Seat 2: mks24 folded before Flop (didn't bet)
Seat 3: eliozica folded before Flop (didn't bet)
Seat 4: cangri79 (button) collected (1970)
Seat 5: JJin91 (small blind) folded before Flop
Seat 6: @Bud_Fox0000 (big blind) folded before Flop
Seat 7: PokerPayman folded before Flop
Seat 8: 1st.p1ace folded before Flop (didn't bet)
Seat 9: Funkyphill99 folded before Flop (didn't bet)


*********** # 6 **************
PokerStars Hand #175432695525: Tournament #1701793956, $18.20+$1.80 USD=
 Hold'em No Limit - Level IX (150/300) - 2017/09/23 20:28:43 ET
Table '1701793956 2' 9-max Seat #5 is the button
Seat 2: mks24 (7210 in chips)=20
Seat 3: eliozica (12080 in chips)=20
Seat 4: cangri79 (11730 in chips)=20
Seat 5: JJin91 (9360 in chips)=20
Seat 6: @Bud_Fox0000 (6176 in chips)=20
Seat 7: PokerPayman (7305 in chips)=20
Seat 8: 1st.p1ace (12310 in chips)=20
Seat 9: Funkyphill99 (17030 in chips)=20
mks24: posts the ante 40
eliozica: posts the ante 40
cangri79: posts the ante 40
JJin91: posts the ante 40
@Bud_Fox0000: posts the ante 40
PokerPayman: posts the ante 40
1st.p1ace: posts the ante 40
Funkyphill99: posts the ante 40
@Bud_Fox0000: posts small blind 150
PokerPayman: posts big blind 300
*** HOLE CARDS ***
Dealt to JJin91 [Js 6d]
1st.p1ace: folds=20
Funkyphill99: raises 325 to 625
mks24: folds=20
eliozica: folds=20
cangri79: calls 625
JJin91: folds=20
@Bud_Fox0000: folds=20
PokerPayman: calls 325
*** FLOP *** [4h 7h Ad]
PokerPayman: checks=20
Funkyphill99: checks=20
cangri79: checks=20
*** TURN *** [4h 7h Ad] [4s]
PokerPayman: checks=20
Funkyphill99: bets 945
cangri79: raises 945 to 1890
PokerPayman: folds=20
Funkyphill99: calls 945
*** RIVER *** [4h 7h Ad 4s] [Ts]
Funkyphill99: checks=20
cangri79: checks=20
*** SHOW DOWN ***
Funkyphill99: shows [Ks Ac] (two pair, Aces and Fours)
cangri79: mucks hand=20
Funkyphill99 collected 6125 from pot
*** SUMMARY ***
Total pot 6125 | Rake 0=20
Board [4h 7h Ad 4s Ts]
Seat 2: mks24 folded before Flop (didn't bet)
Seat 3: eliozica folded before Flop (didn't bet)
Seat 4: cangri79 mucked [Td Qh]
Seat 5: JJin91 (button) folded before Flop (didn't bet)
Seat 6: @Bud_Fox0000 (small blind) folded before Flop
Seat 7: PokerPayman (big blind) folded on the Turn
Seat 8: 1st.p1ace folded before Flop (didn't bet)
Seat 9: Funkyphill99 showed [Ks Ac] and won (6125) with two pair, Aces =
and Fours


*********** # 7 **************
PokerStars Hand #175432695802: Tournament #1701793956, $18.20+$1.80 USD=
 Hold'em No Limit - Level IX (150/300) - 2017/09/23 20:30:00 ET
Table '1701793956 2' 9-max Seat #6 is the button
Seat 2: mks24 (7170 in chips)=20
Seat 3: eliozica (12040 in chips)=20
Seat 4: cangri79 (9175 in chips)=20
Seat 5: JJin91 (9320 in chips)=20
Seat 6: @Bud_Fox0000 (5986 in chips)=20
Seat 7: PokerPayman (6640 in chips)=20
Seat 8: 1st.p1ace (12270 in chips)=20
Seat 9: Funkyphill99 (20600 in chips)=20
mks24: posts the ante 40
eliozica: posts the ante 40
cangri79: posts the ante 40
JJin91: posts the ante 40
@Bud_Fox0000: posts the ante 40
PokerPayman: posts the ante 40
1st.p1ace: posts the ante 40
Funkyphill99: posts the ante 40
PokerPayman: posts small blind 150
1st.p1ace: posts big blind 300
*** HOLE CARDS ***
Dealt to JJin91 [9h Js]
Funkyphill99: folds=20
mks24: folds=20
eliozica: folds=20
cangri79: calls 300
JJin91: folds=20
@Bud_Fox0000: folds=20
PokerPayman: calls 150
1st.p1ace: checks=20
*** FLOP *** [Ks 5s Kc]
PokerPayman: checks=20
1st.p1ace: checks=20
cangri79: bets 610
PokerPayman: calls 610
1st.p1ace: folds=20
*** TURN *** [Ks 5s Kc] [3d]
PokerPayman: checks=20
cangri79: checks=20
*** RIVER *** [Ks 5s Kc 3d] [4c]
PokerPayman: bets 1220
cangri79: raises 2080 to 3300
PokerPayman: folds=20
Uncalled bet (2080) returned to cangri79
cangri79 collected 4880 from pot
*** SUMMARY ***
Total pot 4880 | Rake 0=20
Board [Ks 5s Kc 3d 4c]
Seat 2: mks24 folded before Flop (didn't bet)
Seat 3: eliozica folded before Flop (didn't bet)
Seat 4: cangri79 collected (4880)
Seat 5: JJin91 folded before Flop (didn't bet)
Seat 6: @Bud_Fox0000 (button) folded before Flop (didn't bet)
Seat 7: PokerPayman (small blind) folded on the River
Seat 8: 1st.p1ace (big blind) folded on the Flop
Seat 9: Funkyphill99 folded before Flop (didn't bet)


*********** # 8 **************
PokerStars Hand #175432696176: Tournament #1701793956, $18.20+$1.80 USD=
 Hold'em No Limit - Level IX (150/300) - 2017/09/23 20:31:38 ET
Table '1701793956 2' 9-max Seat #7 is the button
Seat 2: mks24 (7130 in chips)=20
Seat 3: eliozica (12000 in chips)=20
Seat 4: cangri79 (11885 in chips)=20
Seat 5: JJin91 (9280 in chips)=20
Seat 6: @Bud_Fox0000 (5946 in chips)=20
Seat 7: PokerPayman (4470 in chips)=20
Seat 8: 1st.p1ace (11930 in chips)=20
Seat 9: Funkyphill99 (20560 in chips)=20
mks24: posts the ante 40
eliozica: posts the ante 40
cangri79: posts the ante 40
JJin91: posts the ante 40
@Bud_Fox0000: posts the ante 40
PokerPayman: posts the ante 40
1st.p1ace: posts the ante 40
Funkyphill99: posts the ante 40
1st.p1ace: posts small blind 150
Funkyphill99: posts big blind 300
*** HOLE CARDS ***
Dealt to JJin91 [9h 2c]
mks24: folds=20
eliozica: folds=20
cangri79: folds=20
JJin91: folds=20
@Bud_Fox0000: folds=20
PokerPayman: raises 600 to 900
1st.p1ace: folds=20
Funkyphill99: folds=20
Uncalled bet (600) returned to PokerPayman
PokerPayman collected 1070 from pot
PokerPayman: doesn't show hand=20
*** SUMMARY ***
Total pot 1070 | Rake 0=20
Seat 2: mks24 folded before Flop (didn't bet)
Seat 3: eliozica folded before Flop (didn't bet)
Seat 4: cangri79 folded before Flop (didn't bet)
Seat 5: JJin91 folded before Flop (didn't bet)
Seat 6: @Bud_Fox0000 folded before Flop (didn't bet)
Seat 7: PokerPayman (button) collected (1070)
Seat 8: 1st.p1ace (small blind) folded before Flop
Seat 9: Funkyphill99 (big blind) folded before Flop


*********** # 9 **************
PokerStars Hand #175432696251: Tournament #1701793956, $18.20+$1.80 USD=
 Hold'em No Limit - Level IX (150/300) - 2017/09/23 20:32:00 ET
Table '1701793956 2' 9-max Seat #8 is the button
Seat 2: mks24 (7090 in chips)=20
Seat 3: eliozica (11960 in chips)=20
Seat 4: cangri79 (11845 in chips)=20
Seat 5: JJin91 (9240 in chips)=20
Seat 6: @Bud_Fox0000 (5906 in chips)=20
Seat 7: PokerPayman (5200 in chips)=20
Seat 8: 1st.p1ace (11740 in chips)=20
Seat 9: Funkyphill99 (20220 in chips)=20
mks24: posts the ante 40
eliozica: posts the ante 40
cangri79: posts the ante 40
JJin91: posts the ante 40
@Bud_Fox0000: posts the ante 40
PokerPayman: posts the ante 40
1st.p1ace: posts the ante 40
Funkyphill99: posts the ante 40
Funkyphill99: posts small blind 150
mks24: posts big blind 300
*** HOLE CARDS ***
Dealt to JJin91 [Js 4s]
eliozica: calls 300
cangri79: folds=20
JJin91: folds=20
@Bud_Fox0000: folds=20
PokerPayman: calls 300
1st.p1ace: folds=20
Funkyphill99: folds=20
mks24: checks=20
*** FLOP *** [Tc 2c 7c]
mks24: checks=20
eliozica: bets 1500
PokerPayman: folds=20
mks24: calls 1500
*** TURN *** [Tc 2c 7c] [Ad]
mks24: checks=20
eliozica: bets 2100
mks24: calls 2100
*** RIVER *** [Tc 2c 7c Ad] [Qc]
mks24: bets 3150 and is all-in
eliozica: calls 3150
*** SHOW DOWN ***
mks24: shows [2d 5c] (a flush, Queen high)
eliozica: shows [Qh Qs] (three of a kind, Queens)
mks24 collected 14870 from pot
*** SUMMARY ***
Total pot 14870 | Rake 0=20
Board [Tc 2c 7c Ad Qc]
Seat 2: mks24 (big blind) showed [2d 5c] and won (14870) with a flush, =
Queen high
Seat 3: eliozica showed [Qh Qs] and lost with three of a kind, Queens
Seat 4: cangri79 folded before Flop (didn't bet)
Seat 5: JJin91 folded before Flop (didn't bet)
Seat 6: @Bud_Fox0000 folded before Flop (didn't bet)
Seat 7: PokerPayman folded on the Flop
Seat 8: 1st.p1ace (button) folded before Flop (didn't bet)
Seat 9: Funkyphill99 (small blind) folded before Flop


*********** # 10 **************
PokerStars Hand #175432696461: Tournament #1701793956, $18.20+$1.80 USD=
 Hold'em No Limit - Level IX (150/300) - 2017/09/23 20:32:57 ET
Table '1701793956 2' 9-max Seat #9 is the button
Seat 2: mks24 (14870 in chips)=20
Seat 3: eliozica (4870 in chips)=20
Seat 4: cangri79 (11805 in chips)=20
Seat 5: JJin91 (9200 in chips)=20
Seat 6: @Bud_Fox0000 (5866 in chips)=20
Seat 7: PokerPayman (4860 in chips)=20
Seat 8: 1st.p1ace (11700 in chips)=20
Seat 9: Funkyphill99 (20030 in chips)=20
mks24: posts the ante 40
eliozica: posts the ante 40
cangri79: posts the ante 40
JJin91: posts the ante 40
@Bud_Fox0000: posts the ante 40
PokerPayman: posts the ante 40
1st.p1ace: posts the ante 40
Funkyphill99: posts the ante 40
mks24: posts small blind 150
eliozica: posts big blind 300
*** HOLE CARDS ***
Dealt to JJin91 [9d Tc]
cangri79: calls 300
JJin91: folds=20
@Bud_Fox0000: folds=20
PokerPayman: folds=20
1st.p1ace: raises 660 to 960
Funkyphill99: folds=20
mks24: folds=20
eliozica: calls 660
cangri79: calls 660
*** FLOP *** [Kd As 5d]
eliozica: checks=20
cangri79: checks=20
1st.p1ace: bets 2546
eliozica: folds=20
cangri79: folds=20
Uncalled bet (2546) returned to 1st.p1ace
1st.p1ace collected 3350 from pot
1st.p1ace: doesn't show hand=20
*** SUMMARY ***
Total pot 3350 | Rake 0=20
Board [Kd As 5d]
Seat 2: mks24 (small blind) folded before Flop
Seat 3: eliozica (big blind) folded on the Flop
Seat 4: cangri79 folded on the Flop
Seat 5: JJin91 folded before Flop (didn't bet)
Seat 6: @Bud_Fox0000 folded before Flop (didn't bet)
Seat 7: PokerPayman folded before Flop (didn't bet)
Seat 8: 1st.p1ace collected (3350)
Seat 9: Funkyphill99 (button) folded before Flop (didn't bet)


*********** # 11 **************
PokerStars Hand #175432696644: Tournament #1701793956, $18.20+$1.80 USD=
 Hold'em No Limit - Level IX (150/300) - 2017/09/23 20:33:48 ET
Table '1701793956 2' 9-max Seat #2 is the button
Seat 2: mks24 (14680 in chips)=20
Seat 3: eliozica (3870 in chips)=20
Seat 4: cangri79 (10805 in chips)=20
Seat 5: JJin91 (9160 in chips)=20
Seat 6: @Bud_Fox0000 (5826 in chips)=20
Seat 7: PokerPayman (4820 in chips)=20
Seat 8: 1st.p1ace (14050 in chips)=20
Seat 9: Funkyphill99 (19990 in chips)=20
mks24: posts the ante 40
eliozica: posts the ante 40
cangri79: posts the ante 40
JJin91: posts the ante 40
@Bud_Fox0000: posts the ante 40
PokerPayman: posts the ante 40
1st.p1ace: posts the ante 40
Funkyphill99: posts the ante 40
eliozica: posts small blind 150
cangri79: posts big blind 300
*** HOLE CARDS ***
Dealt to JJin91 [6d Qd]
JJin91: folds=20
@Bud_Fox0000: folds=20
PokerPayman: folds=20
1st.p1ace: folds=20
Funkyphill99: folds=20
mks24: raises 300 to 600
eliozica: raises 3230 to 3830 and is all-in
cangri79: folds=20
mks24: calls 3230
*** FLOP *** [Td 2h Ts]
*** TURN *** [Td 2h Ts] [8h]
*** RIVER *** [Td 2h Ts 8h] [8c]
*** SHOW DOWN ***
eliozica: shows [Qc Ad] (two pair, Tens and Eights)
mks24: shows [9h Ah] (two pair, Tens and Eights)
eliozica collected 4140 from pot
mks24 collected 4140 from pot
*** SUMMARY ***
Total pot 8280 | Rake 0=20
Board [Td 2h Ts 8h 8c]
Seat 2: mks24 (button) showed [9h Ah] and won (4140) with two pair, Ten=
s and Eights
Seat 3: eliozica (small blind) showed [Qc Ad] and won (4140) with two p=
air, Tens and Eights
Seat 4: cangri79 (big blind) folded before Flop
Seat 5: JJin91 folded before Flop (didn't bet)
Seat 6: @Bud_Fox0000 folded before Flop (didn't bet)
Seat 7: PokerPayman folded before Flop (didn't bet)
Seat 8: 1st.p1ace folded before Flop (didn't bet)
Seat 9: Funkyphill99 folded before Flop (didn't bet)


*********** # 12 **************
PokerStars Hand #175432696822: Tournament #1701793956, $18.20+$1.80 USD=
 Hold'em No Limit - Level IX (150/300) - 2017/09/23 20:34:32 ET
Table '1701793956 2' 9-max Seat #3 is the button
Seat 2: mks24 (14950 in chips)=20
Seat 3: eliozica (4140 in chips)=20
Seat 4: cangri79 (10465 in chips)=20
Seat 5: JJin91 (9120 in chips)=20
Seat 6: @Bud_Fox0000 (5786 in chips)=20
Seat 7: PokerPayman (4780 in chips)=20
Seat 8: 1st.p1ace (14010 in chips)=20
Seat 9: Funkyphill99 (19950 in chips)=20
mks24: posts the ante 40
eliozica: posts the ante 40
cangri79: posts the ante 40
JJin91: posts the ante 40
@Bud_Fox0000: posts the ante 40
PokerPayman: posts the ante 40
1st.p1ace: posts the ante 40
Funkyphill99: posts the ante 40
cangri79: posts small blind 150
JJin91: posts big blind 300
*** HOLE CARDS ***
Dealt to JJin91 [Ks 7h]
@Bud_Fox0000: folds=20
PokerPayman: calls 300
1st.p1ace: folds=20
Funkyphill99: folds=20
mks24: folds=20
eliozica: folds=20
cangri79: raises 10125 to 10425 and is all-in
JJin91: folds=20
PokerPayman: folds=20
Uncalled bet (10125) returned to cangri79
cangri79 collected 1220 from pot
*** SUMMARY ***
Total pot 1220 | Rake 0=20
Seat 2: mks24 folded before Flop (didn't bet)
Seat 3: eliozica (button) folded before Flop (didn't bet)
Seat 4: cangri79 (small blind) collected (1220)
Seat 5: JJin91 (big blind) folded before Flop
Seat 6: @Bud_Fox0000 folded before Flop (didn't bet)
Seat 7: PokerPayman folded before Flop
Seat 8: 1st.p1ace folded before Flop (didn't bet)
Seat 9: Funkyphill99 folded before Flop (didn't bet)


*********** # 13 **************
PokerStars Hand #175432696971: Tournament #1701793956, $18.20+$1.80 USD=
 Hold'em No Limit - Level IX (150/300) - 2017/09/23 20:35:11 ET
Table '1701793956 2' 9-max Seat #4 is the button
Seat 2: mks24 (14910 in chips)=20
Seat 3: eliozica (4100 in chips)=20
Seat 4: cangri79 (11345 in chips)=20
Seat 5: JJin91 (8780 in chips)=20
Seat 6: @Bud_Fox0000 (5746 in chips)=20
Seat 7: PokerPayman (4440 in chips)=20
Seat 8: 1st.p1ace (13970 in chips)=20
Seat 9: Funkyphill99 (19910 in chips)=20
mks24: posts the ante 40
eliozica: posts the ante 40
cangri79: posts the ante 40
JJin91: posts the ante 40
@Bud_Fox0000: posts the ante 40
PokerPayman: posts the ante 40
1st.p1ace: posts the ante 40
Funkyphill99: posts the ante 40
JJin91: posts small blind 150
@Bud_Fox0000: posts big blind 300
*** HOLE CARDS ***
Dealt to JJin91 [4d Th]
PokerPayman: folds=20
1st.p1ace: folds=20
Funkyphill99: folds=20
mks24: raises 1070 to 1370
eliozica: folds=20
cangri79: folds=20
JJin91: folds=20
@Bud_Fox0000: folds=20
Uncalled bet (1070) returned to mks24
mks24 collected 1070 from pot
mks24: doesn't show hand=20
*** SUMMARY ***
Total pot 1070 | Rake 0=20
Seat 2: mks24 collected (1070)
Seat 3: eliozica folded before Flop (didn't bet)
Seat 4: cangri79 (button) folded before Flop (didn't bet)
Seat 5: JJin91 (small blind) folded before Flop
Seat 6: @Bud_Fox0000 (big blind) folded before Flop
Seat 7: PokerPayman folded before Flop (didn't bet)
Seat 8: 1st.p1ace folded before Flop (didn't bet)
Seat 9: Funkyphill99 folded before Flop (didn't bet)


*********** # 14 **************
PokerStars Hand #175432697119: Tournament #1701793956, $18.20+$1.80 USD=
 Hold'em No Limit - Level IX (150/300) - 2017/09/23 20:35:52 ET
Table '1701793956 2' 9-max Seat #5 is the button
Seat 2: mks24 (15640 in chips)=20
Seat 3: eliozica (4060 in chips)=20
Seat 4: cangri79 (11305 in chips)=20
Seat 5: JJin91 (8590 in chips)=20
Seat 6: @Bud_Fox0000 (5406 in chips)=20
Seat 7: PokerPayman (4400 in chips)=20
Seat 8: 1st.p1ace (13930 in chips)=20
Seat 9: Funkyphill99 (19870 in chips)=20
mks24: posts the ante 40
eliozica: posts the ante 40
cangri79: posts the ante 40
JJin91: posts the ante 40
@Bud_Fox0000: posts the ante 40
PokerPayman: posts the ante 40
1st.p1ace: posts the ante 40
Funkyphill99: posts the ante 40
@Bud_Fox0000: posts small blind 150
PokerPayman: posts big blind 300
*** HOLE CARDS ***
Dealt to JJin91 [7s 2s]
1st.p1ace: folds=20
Funkyphill99: raises 315 to 615
mks24: folds=20
eliozica: raises 3405 to 4020 and is all-in
cangri79: raises 7245 to 11265 and is all-in
JJin91: folds=20
@Bud_Fox0000: folds=20
PokerPayman: folds=20
Funkyphill99: folds=20
Uncalled bet (7245) returned to cangri79
*** FLOP *** [6d 5s 9d]
*** TURN *** [6d 5s 9d] [Ad]
*** RIVER *** [6d 5s 9d Ad] [9s]
*** SHOW DOWN ***
eliozica: shows [Ac Qs] (two pair, Aces and Nines)
cangri79: shows [Jh Js] (two pair, Jacks and Nines)
eliozica collected 9425 from pot
*** SUMMARY ***
Total pot 9425 | Rake 0=20
Board [6d 5s 9d Ad 9s]
Seat 2: mks24 folded before Flop (didn't bet)
Seat 3: eliozica showed [Ac Qs] and won (9425) with two pair, Aces and =
Nines
Seat 4: cangri79 showed [Jh Js] and lost with two pair, Jacks and Nines
Seat 5: JJin91 (button) folded before Flop (didn't bet)
Seat 6: @Bud_Fox0000 (small blind) folded before Flop
Seat 7: PokerPayman (big blind) folded before Flop
Seat 8: 1st.p1ace folded before Flop (didn't bet)
Seat 9: Funkyphill99 folded before Flop


*********** # 15 **************
PokerStars Hand #175432697326: Tournament #1701793956, $18.20+$1.80 USD=
 Hold'em No Limit - Level X (200/400) - 2017/09/23 20:36:46 ET
Table '1701793956 2' 9-max Seat #6 is the button
Seat 2: mks24 (15600 in chips)=20
Seat 3: eliozica (9425 in chips)=20
Seat 4: cangri79 (7245 in chips)=20
Seat 5: JJin91 (8550 in chips)=20
Seat 6: @Bud_Fox0000 (5216 in chips)=20
Seat 7: PokerPayman (4060 in chips)=20
Seat 8: 1st.p1ace (13890 in chips)=20
Seat 9: Funkyphill99 (19215 in chips)=20
mks24: posts the ante 50
eliozica: posts the ante 50
cangri79: posts the ante 50
JJin91: posts the ante 50
@Bud_Fox0000: posts the ante 50
PokerPayman: posts the ante 50
1st.p1ace: posts the ante 50
Funkyphill99: posts the ante 50
PokerPayman: posts small blind 200
1st.p1ace: posts big blind 400
*** HOLE CARDS ***
Dealt to JJin91 [Ks 5c]
Funkyphill99: folds=20
mks24: folds=20
eliozica: raises 400 to 800
cangri79: raises 6395 to 7195 and is all-in
JJin91: folds=20
@Bud_Fox0000: folds=20
PokerPayman: folds=20
1st.p1ace: folds=20
eliozica: folds=20
Uncalled bet (6395) returned to cangri79
cangri79 collected 2600 from pot
*** SUMMARY ***
Total pot 2600 | Rake 0=20
Seat 2: mks24 folded before Flop (didn't bet)
Seat 3: eliozica folded before Flop
Seat 4: cangri79 collected (2600)
Seat 5: JJin91 folded before Flop (didn't bet)
Seat 6: @Bud_Fox0000 (button) folded before Flop (didn't bet)
Seat 7: PokerPayman (small blind) folded before Flop
Seat 8: 1st.p1ace (big blind) folded before Flop
Seat 9: Funkyphill99 folded before Flop (didn't bet)


*********** # 16 **************
PokerStars Hand #175432697415: Tournament #1701793956, $18.20+$1.80 USD=
 Hold'em No Limit - Level X (200/400) - 2017/09/23 20:37:06 ET
Table '1701793956 2' 9-max Seat #7 is the button
Seat 2: mks24 (15550 in chips)=20
Seat 3: eliozica (8575 in chips)=20
Seat 4: cangri79 (8995 in chips)=20
Seat 5: JJin91 (8500 in chips)=20
Seat 6: @Bud_Fox0000 (5166 in chips)=20
Seat 7: PokerPayman (3810 in chips)=20
Seat 8: 1st.p1ace (13440 in chips)=20
Seat 9: Funkyphill99 (19165 in chips)=20
mks24: posts the ante 50
eliozica: posts the ante 50
cangri79: posts the ante 50
JJin91: posts the ante 50
@Bud_Fox0000: posts the ante 50
PokerPayman: posts the ante 50
1st.p1ace: posts the ante 50
Funkyphill99: posts the ante 50
1st.p1ace: posts small blind 200
Funkyphill99: posts big blind 400
*** HOLE CARDS ***
Dealt to JJin91 [5h As]
mks24: folds=20
eliozica: calls 400
cangri79: raises 8545 to 8945 and is all-in
JJin91: folds=20
@Bud_Fox0000: folds=20
PokerPayman: folds=20
1st.p1ace: folds=20
Funkyphill99: folds=20
eliozica: calls 8125 and is all-in
Uncalled bet (420) returned to cangri79
*** FLOP *** [3d Kh Qc]
*** TURN *** [3d Kh Qc] [4h]
*** RIVER *** [3d Kh Qc 4h] [2s]
*** SHOW DOWN ***
eliozica: shows [Th Tc] (a pair of Tens)
cangri79: shows [9s 9d] (a pair of Nines)
eliozica collected 18050 from pot
*** SUMMARY ***
Total pot 18050 | Rake 0=20
Board [3d Kh Qc 4h 2s]
Seat 2: mks24 folded before Flop (didn't bet)
Seat 3: eliozica showed [Th Tc] and won (18050) with a pair of Tens
Seat 4: cangri79 showed [9s 9d] and lost with a pair of Nines
Seat 5: JJin91 folded before Flop (didn't bet)
Seat 6: @Bud_Fox0000 folded before Flop (didn't bet)
Seat 7: PokerPayman (button) folded before Flop (didn't bet)
Seat 8: 1st.p1ace (small blind) folded before Flop
Seat 9: Funkyphill99 (big blind) folded before Flop


*********** # 17 **************
PokerStars Hand #175432697538: Tournament #1701793956, $18.20+$1.80 USD=
 Hold'em No Limit - Level X (200/400) - 2017/09/23 20:37:37 ET
Table '1701793956 2' 9-max Seat #8 is the button
Seat 2: mks24 (15500 in chips)=20
Seat 3: eliozica (18050 in chips)=20
Seat 4: cangri79 (420 in chips)=20
Seat 5: JJin91 (8450 in chips)=20
Seat 6: @Bud_Fox0000 (5116 in chips)=20
Seat 7: PokerPayman (3760 in chips)=20
Seat 8: 1st.p1ace (13190 in chips)=20
Seat 9: Funkyphill99 (18715 in chips)=20
mks24: posts the ante 50
eliozica: posts the ante 50
cangri79: posts the ante 50
JJin91: posts the ante 50
@Bud_Fox0000: posts the ante 50
PokerPayman: posts the ante 50
1st.p1ace: posts the ante 50
Funkyphill99: posts the ante 50
Funkyphill99: posts small blind 200
mks24: posts big blind 400
*** HOLE CARDS ***
Dealt to JJin91 [4s 5s]
eliozica: folds=20
cangri79: calls 370 and is all-in
JJin91: folds=20
@Bud_Fox0000: folds=20
PokerPayman: folds=20
1st.p1ace: raises 600 to 1000
Funkyphill99: folds=20
mks24: calls 600
*** FLOP *** [7h 8c Jd]
mks24: checks=20
1st.p1ace: bets 1693
mks24: folds=20
Uncalled bet (1693) returned to 1st.p1ace
*** TURN *** [7h 8c Jd] [7c]
*** RIVER *** [7h 8c Jd 7c] [Ac]
*** SHOW DOWN ***
1st.p1ace: shows [Ts Jh] (two pair, Jacks and Sevens)
1st.p1ace collected 1260 from side pot
cangri79: shows [3c 9h] (a pair of Sevens)
1st.p1ace collected 1710 from main pot
cangri79 finished the tournament in 89th place
*** SUMMARY ***
Total pot 2970 Main pot 1710. Side pot 1260. | Rake 0=20
Board [7h 8c Jd 7c Ac]
Seat 2: mks24 (big blind) folded on the Flop
Seat 3: eliozica folded before Flop (didn't bet)
Seat 4: cangri79 showed [3c 9h] and lost with a pair of Sevens
Seat 5: JJin91 folded before Flop (didn't bet)
Seat 6: @Bud_Fox0000 folded before Flop (didn't bet)
Seat 7: PokerPayman folded before Flop (didn't bet)
Seat 8: 1st.p1ace (button) showed [Ts Jh] and won (2970) with two pair,=
 Jacks and Sevens
Seat 9: Funkyphill99 (small blind) folded before Flop


*********** # 18 **************
PokerStars Hand #175432697750: Tournament #1701793956, $18.20+$1.80 USD=
 Hold'em No Limit - Level X (200/400) - 2017/09/23 20:38:32 ET
Table '1701793956 2' 9-max Seat #9 is the button
Seat 2: mks24 (14450 in chips)=20
Seat 3: eliozica (18000 in chips)=20
Seat 5: JJin91 (8400 in chips)=20
Seat 6: @Bud_Fox0000 (5066 in chips)=20
Seat 7: PokerPayman (3710 in chips)=20
Seat 8: 1st.p1ace (15110 in chips)=20
Seat 9: Funkyphill99 (18465 in chips)=20
mks24: posts the ante 50
eliozica: posts the ante 50
JJin91: posts the ante 50
@Bud_Fox0000: posts the ante 50
PokerPayman: posts the ante 50
1st.p1ace: posts the ante 50
Funkyphill99: posts the ante 50
mks24: posts small blind 200
eliozica: posts big blind 400
*** HOLE CARDS ***
Dealt to JJin91 [8s Ah]
JJin91: raises 7950 to 8350 and is all-in
@Bud_Fox0000: folds=20
PokerPayman: folds=20
1st.p1ace: folds=20
Funkyphill99: folds=20
mks24: folds=20
eliozica: folds=20
Uncalled bet (7950) returned to JJin91
JJin91 collected 1350 from pot
JJin91: doesn't show hand=20
*** SUMMARY ***
Total pot 1350 | Rake 0=20
Seat 2: mks24 (small blind) folded before Flop
Seat 3: eliozica (big blind) folded before Flop
Seat 5: JJin91 collected (1350)
Seat 6: @Bud_Fox0000 folded before Flop (didn't bet)
Seat 7: PokerPayman folded before Flop (didn't bet)
Seat 8: 1st.p1ace folded before Flop (didn't bet)
Seat 9: Funkyphill99 (button) folded before Flop (didn't bet)


*********** # 19 **************
PokerStars Hand #175432697818: Tournament #1701793956, $18.20+$1.80 USD=
 Hold'em No Limit - Level X (200/400) - 2017/09/23 20:38:47 ET
Table '1701793956 2' 9-max Seat #2 is the button
Seat 2: mks24 (14200 in chips)=20
Seat 3: eliozica (17550 in chips)=20
Seat 4: singlearity (10000 in chips)=20
Seat 5: JJin91 (9300 in chips)=20
Seat 6: @Bud_Fox0000 (5016 in chips)=20
Seat 7: PokerPayman (3660 in chips)=20
Seat 8: 1st.p1ace (15060 in chips)=20
Seat 9: Funkyphill99 (18415 in chips)=20
mks24: posts the ante 50
eliozica: posts the ante 50
singlearity: posts the ante 50
JJin91: posts the ante 50
@Bud_Fox0000: posts the ante 50
PokerPayman: posts the ante 50
1st.p1ace: posts the ante 50
Funkyphill99: posts the ante 50
eliozica: posts small blind 200
singlearity: posts big blind 400
*** HOLE CARDS ***
Dealt to JJin91 [Td Jc]
JJin91: folds=20
@Bud_Fox0000: folds=20
PokerPayman: folds=20
1st.p1ace: raises 484 to 884
Funkyphill99: folds=20
mks24: folds=20
eliozica: calls 684
singlearity: calls 484
*** FLOP *** [2s 9s 6c]
eliozica: checks=20
singlearity: checks=20
1st.p1ace: checks=20
*** TURN *** [2s 9s 6c] [As]
eliozica: bets 400
singlearity: folds=20
1st.p1ace: folds=20
Uncalled bet (400) returned to eliozica
eliozica collected 3052 from pot
eliozica: doesn't show hand=20
*** SUMMARY ***
Total pot 3052 | Rake 0=20
Board [2s 9s 6c As]
Seat 2: mks24 (button) folded before Flop (didn't bet)
Seat 3: eliozica (small blind) collected (3052)
Seat 4: singlearity (big blind) folded on the Turn
Seat 5: JJin91 folded before Flop (didn't bet)
Seat 6: @Bud_Fox0000 folded before Flop (didn't bet)
Seat 7: PokerPayman folded before Flop (didn't bet)
Seat 8: 1st.p1ace folded on the Turn
Seat 9: Funkyphill99 folded before Flop (didn't bet)


*********** # 20 **************
PokerStars Hand #175432698071: Tournament #1701793956, $18.20+$1.80 USD=
 Hold'em No Limit - Level X (200/400) - 2017/09/23 20:39:50 ET
Table '1701793956 2' 9-max Seat #3 is the button
Seat 2: mks24 (14150 in chips)=20
Seat 3: eliozica (19668 in chips)=20
Seat 4: singlearity (9066 in chips)=20
Seat 5: JJin91 (9250 in chips)=20
Seat 6: @Bud_Fox0000 (4966 in chips)=20
Seat 7: PokerPayman (3610 in chips)=20
Seat 8: 1st.p1ace (14126 in chips)=20
Seat 9: Funkyphill99 (18365 in chips)=20
mks24: posts the ante 50
eliozica: posts the ante 50
singlearity: posts the ante 50
JJin91: posts the ante 50
@Bud_Fox0000: posts the ante 50
PokerPayman: posts the ante 50
1st.p1ace: posts the ante 50
Funkyphill99: posts the ante 50
singlearity: posts small blind 200
JJin91: posts big blind 400
*** HOLE CARDS ***
Dealt to JJin91 [4h 7d]
@Bud_Fox0000: calls 400
PokerPayman: raises 3160 to 3560 and is all-in
1st.p1ace: folds=20
Funkyphill99: folds=20
mks24: folds=20
eliozica: folds=20
singlearity: folds=20
JJin91: folds=20
@Bud_Fox0000: calls 3160
*** FLOP *** [6h 2h 5d]
*** TURN *** [6h 2h 5d] [7c]
*** RIVER *** [6h 2h 5d 7c] [5c]
*** SHOW DOWN ***
@Bud_Fox0000: shows [Js Qs] (a pair of Fives)
PokerPayman: shows [Qh Ad] (a pair of Fives - Ace kicker)
PokerPayman collected 8120 from pot
*** SUMMARY ***
Total pot 8120 | Rake 0=20
Board [6h 2h 5d 7c 5c]
Seat 2: mks24 folded before Flop (didn't bet)
Seat 3: eliozica (button) folded before Flop (didn't bet)
Seat 4: singlearity (small blind) folded before Flop
Seat 5: JJin91 (big blind) folded before Flop
Seat 6: @Bud_Fox0000 showed [Js Qs] and lost with a pair of Fives
Seat 7: PokerPayman showed [Qh Ad] and won (8120) with a pair of Fives
Seat 8: 1st.p1ace folded before Flop (didn't bet)
Seat 9: Funkyphill99 folded before Flop (didn't bet)


*********** # 21 **************
PokerStars Hand #175432698234: Tournament #1701793956, $18.20+$1.80 USD=
 Hold'em No Limit - Level X (200/400) - 2017/09/23 20:40:31 ET
Table '1701793956 2' 9-max Seat #4 is the button
Seat 2: mks24 (14100 in chips)=20
Seat 3: eliozica (19618 in chips)=20
Seat 4: singlearity (8816 in chips)=20
Seat 5: JJin91 (8800 in chips)=20
Seat 6: @Bud_Fox0000 (1356 in chips)=20
Seat 7: PokerPayman (8120 in chips)=20
Seat 8: 1st.p1ace (14076 in chips)=20
Seat 9: Funkyphill99 (18315 in chips)=20
mks24: posts the ante 50
eliozica: posts the ante 50
singlearity: posts the ante 50
JJin91: posts the ante 50
@Bud_Fox0000: posts the ante 50
PokerPayman: posts the ante 50
1st.p1ace: posts the ante 50
Funkyphill99: posts the ante 50
JJin91: posts small blind 200
@Bud_Fox0000: posts big blind 400
*** HOLE CARDS ***
Dealt to JJin91 [9c Jd]
PokerPayman: calls 400
1st.p1ace: folds=20
Funkyphill99: raises 975 to 1375
mks24: folds=20
eliozica: folds=20
singlearity: folds=20
JJin91: folds=20
@Bud_Fox0000: calls 906 and is all-in
PokerPayman: raises 6695 to 8070 and is all-in
Funkyphill99: folds=20
Uncalled bet (6695) returned to PokerPayman
*** FLOP *** [As Ah 4h]
*** TURN *** [As Ah 4h] [4d]
*** RIVER *** [As Ah 4h 4d] [Ts]
*** SHOW DOWN ***
PokerPayman: shows [Qc Qh] (two pair, Aces and Queens)
PokerPayman collected 138 from side pot
@Bud_Fox0000: shows [5h Td] (two pair, Aces and Tens)
PokerPayman collected 4518 from main pot
@Bud_Fox0000 finished the tournament in 86th place
*** SUMMARY ***
Total pot 4656 Main pot 4518. Side pot 138. | Rake 0=20
Board [As Ah 4h 4d Ts]
Seat 2: mks24 folded before Flop (didn't bet)
Seat 3: eliozica folded before Flop (didn't bet)
Seat 4: singlearity (button) folded before Flop (didn't bet)
Seat 5: JJin91 (small blind) folded before Flop
Seat 6: @Bud_Fox0000 (big blind) showed [5h Td] and lost with two pair,=
 Aces and Tens
Seat 7: PokerPayman showed [Qc Qh] and won (4656) with two pair, Aces a=
nd Queens
Seat 8: 1st.p1ace folded before Flop (didn't bet)
Seat 9: Funkyphill99 folded before Flop


*********** # 22 **************
PokerStars Hand #175432698483: Tournament #1701793956, $18.20+$1.80 USD=
 Hold'em No Limit - Level X (200/400) - 2017/09/23 20:41:34 ET
Table '1701793956 2' 9-max Seat #5 is the button
Seat 2: mks24 (14050 in chips)=20
Seat 3: eliozica (19568 in chips)=20
Seat 4: singlearity (8766 in chips)=20
Seat 5: JJin91 (8550 in chips)=20
Seat 7: PokerPayman (11351 in chips)=20
Seat 8: 1st.p1ace (14026 in chips)=20
Seat 9: Funkyphill99 (16890 in chips)=20
mks24: posts the ante 50
eliozica: posts the ante 50
singlearity: posts the ante 50
JJin91: posts the ante 50
PokerPayman: posts the ante 50
1st.p1ace: posts the ante 50
Funkyphill99: posts the ante 50
PokerPayman: posts small blind 200
1st.p1ace: posts big blind 400
*** HOLE CARDS ***
Dealt to JJin91 [Th 9h]
Funkyphill99: folds=20
mks24: folds=20
eliozica: folds=20
singlearity: folds=20
JJin91: raises 8100 to 8500 and is all-in
PokerPayman: folds=20
1st.p1ace: folds=20
Uncalled bet (8100) returned to JJin91
JJin91 collected 1350 from pot
JJin91: doesn't show hand=20
*** SUMMARY ***
Total pot 1350 | Rake 0=20
Seat 2: mks24 folded before Flop (didn't bet)
Seat 3: eliozica folded before Flop (didn't bet)
Seat 4: singlearity folded before Flop (didn't bet)
Seat 5: JJin91 (button) collected (1350)
Seat 7: PokerPayman (small blind) folded before Flop
Seat 8: 1st.p1ace (big blind) folded before Flop
Seat 9: Funkyphill99 folded before Flop (didn't bet)


*********** # 23 **************
PokerStars Hand #175432698561: Tournament #1701793956, $18.20+$1.80 USD=
 Hold'em No Limit - Level X (200/400) - 2017/09/23 20:41:52 ET
Table '1701793956 2' 9-max Seat #7 is the button
Seat 2: mks24 (14000 in chips)=20
Seat 3: eliozica (19518 in chips)=20
Seat 4: singlearity (8716 in chips)=20
Seat 5: JJin91 (9450 in chips)=20
Seat 7: PokerPayman (11101 in chips)=20
Seat 8: 1st.p1ace (13576 in chips)=20
Seat 9: Funkyphill99 (16840 in chips)=20
mks24: posts the ante 50
eliozica: posts the ante 50
singlearity: posts the ante 50
JJin91: posts the ante 50
PokerPayman: posts the ante 50
1st.p1ace: posts the ante 50
Funkyphill99: posts the ante 50
1st.p1ace: posts small blind 200
Funkyphill99: posts big blind 400
*** HOLE CARDS ***
Dealt to JJin91 [Ac 8c]
mks24: folds=20
eliozica: folds=20
singlearity: raises 488 to 888
JJin91: calls 888
PokerPayman: folds=20
1st.p1ace: folds=20
Funkyphill99: folds=20
*** FLOP *** [9s 7h 6c]
singlearity: bets 1234
JJin91: raises 5194 to 6428
singlearity: folds=20
Uncalled bet (5194) returned to JJin91
JJin91 collected 5194 from pot
JJin91: doesn't show hand=20
*** SUMMARY ***
Total pot 5194 | Rake 0=20
Board [9s 7h 6c]
Seat 2: mks24 folded before Flop (didn't bet)
Seat 3: eliozica folded before Flop (didn't bet)
Seat 4: singlearity folded on the Flop
Seat 5: JJin91 collected (5194)
Seat 7: PokerPayman (button) folded before Flop (didn't bet)
Seat 8: 1st.p1ace (small blind) folded before Flop
Seat 9: Funkyphill99 (big blind) folded before Flop


*********** # 24 **************
PokerStars Hand #175432698788: Tournament #1701793956, $18.20+$1.80 USD=
 Hold'em No Limit - Level X (200/400) - 2017/09/23 20:42:51 ET
Table '1701793956 2' 9-max Seat #8 is the button
Seat 2: mks24 (13950 in chips)=20
Seat 3: eliozica (19468 in chips)=20
Seat 4: singlearity (6544 in chips)=20
Seat 5: JJin91 (12472 in chips)=20
Seat 6: JRoop029 (10000 in chips)=20
Seat 7: PokerPayman (11051 in chips)=20
Seat 8: 1st.p1ace (13326 in chips)=20
Seat 9: Funkyphill99 (16390 in chips)=20
mks24: posts the ante 50
eliozica: posts the ante 50
singlearity: posts the ante 50
JJin91: posts the ante 50
JRoop029: posts the ante 50
PokerPayman: posts the ante 50
1st.p1ace: posts the ante 50
Funkyphill99: posts the ante 50
Funkyphill99: posts small blind 200
mks24: posts big blind 400
*** HOLE CARDS ***
Dealt to JJin91 [Tc Th]
eliozica: folds=20
singlearity: folds=20
JJin91: raises 468 to 868
JRoop029: folds=20
PokerPayman: calls 868
1st.p1ace: folds=20
Funkyphill99: folds=20
mks24: folds=20
*** FLOP *** [6c Js 5d]
JJin91: checks=20
PokerPayman: bets 1368
JJin91: calls 1368
*** TURN *** [6c Js 5d] [Jh]
JJin91: checks=20
PokerPayman: bets 2400
JJin91: calls 2400
*** RIVER *** [6c Js 5d Jh] [Ts]
JJin91: bets 7786 and is all-in
PokerPayman: folds=20
Uncalled bet (7786) returned to JJin91
JJin91 collected 10272 from pot
JJin91: doesn't show hand=20
*** SUMMARY ***
Total pot 10272 | Rake 0=20
Board [6c Js 5d Jh Ts]
Seat 2: mks24 (big blind) folded before Flop
Seat 3: eliozica folded before Flop (didn't bet)
Seat 4: singlearity folded before Flop (didn't bet)
Seat 5: JJin91 collected (10272)
Seat 6: JRoop029 folded before Flop (didn't bet)
Seat 7: PokerPayman folded on the River
Seat 8: 1st.p1ace (button) folded before Flop (didn't bet)
Seat 9: Funkyphill99 (small blind) folded before Flop


*********** # 25 **************
PokerStars Hand #175432699356: Tournament #1701793956, $18.20+$1.80 USD=
 Hold'em No Limit - Level X (200/400) - 2017/09/23 20:45:00 ET
Table '1701793956 2' 9-max Seat #9 is the button
Seat 1: @Bud_Fox0000 (10000 in chips) out of hand (moved from another t=
able into small blind)
Seat 2: mks24 (13500 in chips)=20
Seat 3: eliozica (19418 in chips)=20
Seat 4: singlearity (6494 in chips)=20
Seat 5: JJin91 (18058 in chips)=20
Seat 6: JRoop029 (9950 in chips)=20
Seat 7: PokerPayman (6365 in chips)=20
Seat 8: 1st.p1ace (13276 in chips)=20
Seat 9: Funkyphill99 (16140 in chips)=20
mks24: posts the ante 50
eliozica: posts the ante 50
singlearity: posts the ante 50
JJin91: posts the ante 50
JRoop029: posts the ante 50
PokerPayman: posts the ante 50
1st.p1ace: posts the ante 50
Funkyphill99: posts the ante 50
mks24: posts small blind 200
eliozica: posts big blind 400
*** HOLE CARDS ***
Dealt to JJin91 [7c 9s]
singlearity: folds=20
JJin91: folds=20
JRoop029: folds=20
PokerPayman: folds=20
1st.p1ace: raises 484 to 884
Funkyphill99: folds=20
mks24: folds=20
eliozica: calls 484
*** FLOP *** [Qc Td Kd]
eliozica: checks=20
1st.p1ace: checks=20
*** TURN *** [Qc Td Kd] [Jh]
eliozica: checks=20
1st.p1ace: bets 1150
eliozica: folds=20
Uncalled bet (1150) returned to 1st.p1ace
1st.p1ace collected 2368 from pot
1st.p1ace: doesn't show hand=20
*** SUMMARY ***
Total pot 2368 | Rake 0=20
Board [Qc Td Kd Jh]
Seat 2: mks24 (small blind) folded before Flop
Seat 3: eliozica (big blind) folded on the Turn
Seat 4: singlearity folded before Flop (didn't bet)
Seat 5: JJin91 folded before Flop (didn't bet)
Seat 6: JRoop029 folded before Flop (didn't bet)
Seat 7: PokerPayman folded before Flop (didn't bet)
Seat 8: 1st.p1ace collected (2368)
Seat 9: Funkyphill99 (button) folded before Flop (didn't bet)


*********** # 26 **************
PokerStars Hand #175432699565: Tournament #1701793956, $18.20+$1.80 USD=
 Hold'em No Limit - Level X (200/400) - 2017/09/23 20:45:44 ET
Table '1701793956 2' 9-max Seat #2 is the button
Seat 1: @Bud_Fox0000 (10000 in chips)=20
Seat 2: mks24 (13250 in chips)=20
Seat 3: eliozica (18484 in chips)=20
Seat 4: singlearity (6444 in chips)=20
Seat 5: JJin91 (18008 in chips)=20
Seat 6: JRoop029 (9900 in chips)=20
Seat 7: PokerPayman (6315 in chips)=20
Seat 8: 1st.p1ace (14710 in chips)=20
Seat 9: Funkyphill99 (16090 in chips)=20
@Bud_Fox0000: posts the ante 50
mks24: posts the ante 50
eliozica: posts the ante 50
singlearity: posts the ante 50
JJin91: posts the ante 50
JRoop029: posts the ante 50
PokerPayman: posts the ante 50
1st.p1ace: posts the ante 50
Funkyphill99: posts the ante 50
eliozica: posts small blind 200
singlearity: posts big blind 400
*** HOLE CARDS ***
Dealt to JJin91 [7d Tc]
JJin91: folds=20
JRoop029: folds=20
PokerPayman: folds=20
1st.p1ace: folds=20
Funkyphill99: folds=20
@Bud_Fox0000: raises 800 to 1200
mks24: folds=20
eliozica: folds=20
singlearity: folds=20
Uncalled bet (800) returned to @Bud_Fox0000
@Bud_Fox0000 collected 1450 from pot
*** SUMMARY ***
Total pot 1450 | Rake 0=20
Seat 1: @Bud_Fox0000 collected (1450)
Seat 2: mks24 (button) folded before Flop (didn't bet)
Seat 3: eliozica (small blind) folded before Flop
Seat 4: singlearity (big blind) folded before Flop
Seat 5: JJin91 folded before Flop (didn't bet)
Seat 6: JRoop029 folded before Flop (didn't bet)
Seat 7: PokerPayman folded before Flop (didn't bet)
Seat 8: 1st.p1ace folded before Flop (didn't bet)
Seat 9: Funkyphill99 folded before Flop (didn't bet)


*********** # 27 **************
PokerStars Hand #175432699636: Tournament #1701793956, $18.20+$1.80 USD=
 Hold'em No Limit - Level X (200/400) - 2017/09/23 20:46:01 ET
Table '1701793956 2' 9-max Seat #3 is the button
Seat 1: @Bud_Fox0000 (11000 in chips)=20
Seat 2: mks24 (13200 in chips)=20
Seat 3: eliozica (18234 in chips)=20
Seat 4: singlearity (5994 in chips)=20
Seat 5: JJin91 (17958 in chips)=20
Seat 6: JRoop029 (9850 in chips)=20
Seat 7: PokerPayman (6265 in chips)=20
Seat 8: 1st.p1ace (14660 in chips)=20
Seat 9: Funkyphill99 (16040 in chips)=20
@Bud_Fox0000: posts the ante 50
mks24: posts the ante 50
eliozica: posts the ante 50
singlearity: posts the ante 50
JJin91: posts the ante 50
JRoop029: posts the ante 50
PokerPayman: posts the ante 50
1st.p1ace: posts the ante 50
Funkyphill99: posts the ante 50
singlearity: posts small blind 200
JJin91: posts big blind 400
*** HOLE CARDS ***
Dealt to JJin91 [5h 4h]
JRoop029: folds=20
PokerPayman: folds=20
1st.p1ace: folds=20
Funkyphill99: folds=20
@Bud_Fox0000: folds=20
mks24: calls 400
eliozica: raises 400 to 800
singlearity: raises 5144 to 5944 and is all-in
JJin91: folds=20
mks24: folds=20
eliozica: calls 5144
*** FLOP *** [Qs 6d Jd]
*** TURN *** [Qs 6d Jd] [9c]
*** RIVER *** [Qs 6d Jd 9c] [Qc]
*** SHOW DOWN ***
singlearity: shows [Ad Kh] (a pair of Queens)
eliozica: shows [9d Kd] (two pair, Queens and Nines)
eliozica collected 13138 from pot
singlearity finished the tournament in 82nd place
*** SUMMARY ***
Total pot 13138 | Rake 0=20
Board [Qs 6d Jd 9c Qc]
Seat 1: @Bud_Fox0000 folded before Flop (didn't bet)
Seat 2: mks24 folded before Flop
Seat 3: eliozica (button) showed [9d Kd] and won (13138) with two pair,=
 Queens and Nines
Seat 4: singlearity (small blind) showed [Ad Kh] and lost with a pair o=
f Queens
Seat 5: JJin91 (big blind) folded before Flop
Seat 6: JRoop029 folded before Flop (didn't bet)
Seat 7: PokerPayman folded before Flop (didn't bet)
Seat 8: 1st.p1ace folded before Flop (didn't bet)
Seat 9: Funkyphill99 folded before Flop (didn't bet)


*********** # 28 **************
PokerStars Hand #175432699863: Tournament #1701793956, $18.20+$1.80 USD=
 Hold'em No Limit - Level XI (250/500) - 2017/09/23 20:46:53 ET
Table '1701793956 2' 9-max Seat #5 is the button
Seat 1: @Bud_Fox0000 (10950 in chips)=20
Seat 2: mks24 (12750 in chips)=20
Seat 3: eliozica (25378 in chips)=20
Seat 5: JJin91 (17508 in chips)=20
Seat 6: JRoop029 (9800 in chips)=20
Seat 7: PokerPayman (6215 in chips)=20
Seat 8: 1st.p1ace (14610 in chips)=20
Seat 9: Funkyphill99 (15990 in chips)=20
@Bud_Fox0000: posts the ante 60
mks24: posts the ante 60
eliozica: posts the ante 60
JJin91: posts the ante 60
JRoop029: posts the ante 60
PokerPayman: posts the ante 60
1st.p1ace: posts the ante 60
Funkyphill99: posts the ante 60
JRoop029: posts small blind 250
PokerPayman: posts big blind 500
*** HOLE CARDS ***
Dealt to JJin91 [Ks 7s]
1st.p1ace: folds=20
Funkyphill99: raises 505 to 1005
@Bud_Fox0000: folds=20
mks24: folds=20
eliozica: folds=20
JJin91: folds=20
JRoop029: folds=20
PokerPayman: folds=20
Uncalled bet (505) returned to Funkyphill99
Funkyphill99 collected 1730 from pot
*** SUMMARY ***
Total pot 1730 | Rake 0=20
Seat 1: @Bud_Fox0000 folded before Flop (didn't bet)
Seat 2: mks24 folded before Flop (didn't bet)
Seat 3: eliozica folded before Flop (didn't bet)
Seat 5: JJin91 (button) folded before Flop (didn't bet)
Seat 6: JRoop029 (small blind) folded before Flop
Seat 7: PokerPayman (big blind) folded before Flop
Seat 8: 1st.p1ace folded before Flop (didn't bet)
Seat 9: Funkyphill99 collected (1730)


*********** # 29 **************
PokerStars Hand #175432699981: Tournament #1701793956, $18.20+$1.80 USD=
 Hold'em No Limit - Level XI (250/500) - 2017/09/23 20:47:24 ET
Table '1701793956 2' 9-max Seat #6 is the button
Seat 1: @Bud_Fox0000 (10890 in chips)=20
Seat 2: mks24 (12690 in chips)=20
Seat 3: eliozica (25318 in chips)=20
Seat 4: Cassin'Clay (10000 in chips)=20
Seat 5: JJin91 (17448 in chips)=20
Seat 6: JRoop029 (9490 in chips)=20
Seat 7: PokerPayman (5655 in chips)=20
Seat 8: 1st.p1ace (14550 in chips)=20
Seat 9: Funkyphill99 (17160 in chips)=20
@Bud_Fox0000: posts the ante 60
mks24: posts the ante 60
eliozica: posts the ante 60
Cassin'Clay: posts the ante 60
JJin91: posts the ante 60
JRoop029: posts the ante 60
PokerPayman: posts the ante 60
1st.p1ace: posts the ante 60
Funkyphill99: posts the ante 60
PokerPayman: posts small blind 250
1st.p1ace: posts big blind 500
*** HOLE CARDS ***
Dealt to JJin91 [2c 3d]
Funkyphill99: folds=20
@Bud_Fox0000: folds=20
mks24: folds=20
eliozica: folds=20
Cassin'Clay: folds=20
JJin91: folds=20
JRoop029: raises 500 to 1000
PokerPayman: folds=20
1st.p1ace: calls 500
*** FLOP *** [Qd 3c 5h]
1st.p1ace: checks=20
JRoop029: bets 1395
1st.p1ace: folds=20
Uncalled bet (1395) returned to JRoop029
JRoop029 collected 2790 from pot
JRoop029: doesn't show hand=20
*** SUMMARY ***
Total pot 2790 | Rake 0=20
Board [Qd 3c 5h]
Seat 1: @Bud_Fox0000 folded before Flop (didn't bet)
Seat 2: mks24 folded before Flop (didn't bet)
Seat 3: eliozica folded before Flop (didn't bet)
Seat 4: Cassin'Clay folded before Flop (didn't bet)
Seat 5: JJin91 folded before Flop (didn't bet)
Seat 6: JRoop029 (button) collected (2790)
Seat 7: PokerPayman (small blind) folded before Flop
Seat 8: 1st.p1ace (big blind) folded on the Flop
Seat 9: Funkyphill99 folded before Flop (didn't bet)


*********** # 30 **************
PokerStars Hand #175433958527: Tournament #1701793956, $18.20+$1.80 USD=
 Hold'em No Limit - Level XI (250/500) - 2017/09/23 20:47:59 ET
Table '1701793956 2' 9-max Seat #7 is the button
Seat 1: @Bud_Fox0000 (10830 in chips)=20
Seat 2: mks24 (12630 in chips)=20
Seat 3: eliozica (25258 in chips)=20
Seat 4: Cassin'Clay (9940 in chips)=20
Seat 5: JJin91 (17388 in chips)=20
Seat 6: JRoop029 (11220 in chips)=20
Seat 7: PokerPayman (5345 in chips)=20
Seat 8: 1st.p1ace (13490 in chips)=20
Seat 9: Funkyphill99 (17100 in chips)=20
@Bud_Fox0000: posts the ante 60
mks24: posts the ante 60
eliozica: posts the ante 60
Cassin'Clay: posts the ante 60
JJin91: posts the ante 60
JRoop029: posts the ante 60
PokerPayman: posts the ante 60
1st.p1ace: posts the ante 60
Funkyphill99: posts the ante 60
1st.p1ace: posts small blind 250
Funkyphill99: posts big blind 500
*** HOLE CARDS ***
Dealt to JJin91 [3s 7d]
@Bud_Fox0000: folds=20
mks24: folds=20
eliozica: calls 500
Cassin'Clay: calls 500
JJin91: folds=20
JRoop029: folds=20
PokerPayman: calls 500
1st.p1ace: calls 250
Funkyphill99: raises 16540 to 17040 and is all-in
eliozica: folds=20
Cassin'Clay: calls 9380 and is all-in
PokerPayman: folds=20
1st.p1ace: folds=20
Uncalled bet (7160) returned to Funkyphill99
*** FLOP *** [9c Kc 9d]
*** TURN *** [9c Kc 9d] [6d]
*** RIVER *** [9c Kc 9d 6d] [9h]
*** SHOW DOWN ***
Funkyphill99: shows [8s 8h] (a full house, Nines full of Eights)
Cassin'Clay: shows [Qs Qd] (a full house, Nines full of Queens)
Cassin'Clay collected 21800 from pot
*** SUMMARY ***
Total pot 21800 | Rake 0=20
Board [9c Kc 9d 6d 9h]
Seat 1: @Bud_Fox0000 folded before Flop (didn't bet)
Seat 2: mks24 folded before Flop (didn't bet)
Seat 3: eliozica folded before Flop
Seat 4: Cassin'Clay showed [Qs Qd] and won (21800) with a full house, N=
ines full of Queens
Seat 5: JJin91 folded before Flop (didn't bet)
Seat 6: JRoop029 folded before Flop (didn't bet)
Seat 7: PokerPayman (button) folded before Flop
Seat 8: 1st.p1ace (small blind) folded before Flop
Seat 9: Funkyphill99 (big blind) showed [8s 8h] and lost with a full ho=
use, Nines full of Eights


*********** # 31 **************
PokerStars Hand #175433958737: Tournament #1701793956, $18.20+$1.80 USD=
 Hold'em No Limit - Level XI (250/500) - 2017/09/23 20:48:51 ET
Table '1701793956 2' 9-max Seat #8 is the button
Seat 1: @Bud_Fox0000 (10770 in chips)=20
Seat 2: mks24 (12570 in chips)=20
Seat 3: eliozica (24698 in chips)=20
Seat 4: Cassin'Clay (21800 in chips)=20
Seat 5: JJin91 (17328 in chips)=20
Seat 6: JRoop029 (11160 in chips)=20
Seat 7: PokerPayman (4785 in chips)=20
Seat 8: 1st.p1ace (12930 in chips)=20
Seat 9: Funkyphill99 (7160 in chips)=20
@Bud_Fox0000: posts the ante 60
mks24: posts the ante 60
eliozica: posts the ante 60
Cassin'Clay: posts the ante 60
JJin91: posts the ante 60
JRoop029: posts the ante 60
PokerPayman: posts the ante 60
1st.p1ace: posts the ante 60
Funkyphill99: posts the ante 60
Funkyphill99: posts small blind 250
@Bud_Fox0000: posts big blind 500
*** HOLE CARDS ***
Dealt to JJin91 [Ah Kc]
mks24: folds=20
eliozica: folds=20
Cassin'Clay: calls 500
JJin91: raises 1115 to 1615
JRoop029: folds=20
PokerPayman: folds=20
1st.p1ace: calls 1615
Funkyphill99: raises 5485 to 7100 and is all-in
@Bud_Fox0000: folds=20
Cassin'Clay: raises 14640 to 21740 and is all-in
JJin91: folds=20
1st.p1ace: folds=20
Uncalled bet (14640) returned to Cassin'Clay
*** FLOP *** [2s 3d 5s]
*** TURN *** [2s 3d 5s] [Tc]
*** RIVER *** [2s 3d 5s Tc] [6d]
*** SHOW DOWN ***
Funkyphill99: shows [Jd Ks] (high card King)
Cassin'Clay: shows [Kh Kd] (a pair of Kings)
Cassin'Clay collected 18470 from pot
Funkyphill99 finished the tournament in 74th place
*** SUMMARY ***
Total pot 18470 | Rake 0=20
Board [2s 3d 5s Tc 6d]
Seat 1: @Bud_Fox0000 (big blind) folded before Flop
Seat 2: mks24 folded before Flop (didn't bet)
Seat 3: eliozica folded before Flop (didn't bet)
Seat 4: Cassin'Clay showed [Kh Kd] and won (18470) with a pair of Kings
Seat 5: JJin91 folded before Flop
Seat 6: JRoop029 folded before Flop (didn't bet)
Seat 7: PokerPayman folded before Flop (didn't bet)
Seat 8: 1st.p1ace (button) folded before Flop
Seat 9: Funkyphill99 (small blind) showed [Jd Ks] and lost with high ca=
rd King


*********** # 32 **************
PokerStars Hand #175433959074: Tournament #1701793956, $18.20+$1.80 USD=
 Hold'em No Limit - Level XI (250/500) - 2017/09/23 20:50:10 ET
Table '1701793956 2' 9-max Seat #1 is the button
Seat 1: @Bud_Fox0000 (10210 in chips)=20
Seat 2: mks24 (12510 in chips)=20
Seat 3: eliozica (24638 in chips)=20
Seat 4: Cassin'Clay (33110 in chips)=20
Seat 5: JJin91 (15653 in chips)=20
Seat 6: JRoop029 (11100 in chips)=20
Seat 7: PokerPayman (4725 in chips)=20
Seat 8: 1st.p1ace (11255 in chips)=20
@Bud_Fox0000: posts the ante 60
mks24: posts the ante 60
eliozica: posts the ante 60
Cassin'Clay: posts the ante 60
JJin91: posts the ante 60
JRoop029: posts the ante 60
PokerPayman: posts the ante 60
1st.p1ace: posts the ante 60
mks24: posts small blind 250
eliozica: posts big blind 500
*** HOLE CARDS ***
Dealt to JJin91 [As 5c]
Cassin'Clay: folds=20
JJin91: folds=20
JRoop029: raises 1000 to 1500
PokerPayman: folds=20
1st.p1ace: folds=20
@Bud_Fox0000: folds=20
mks24: folds=20
eliozica: folds=20
Uncalled bet (1000) returned to JRoop029
JRoop029 collected 1730 from pot
JRoop029: doesn't show hand=20
*** SUMMARY ***
Total pot 1730 | Rake 0=20
Seat 1: @Bud_Fox0000 (button) folded before Flop (didn't bet)
Seat 2: mks24 (small blind) folded before Flop
Seat 3: eliozica (big blind) folded before Flop
Seat 4: Cassin'Clay folded before Flop (didn't bet)
Seat 5: JJin91 folded before Flop (didn't bet)
Seat 6: JRoop029 collected (1730)
Seat 7: PokerPayman folded before Flop (didn't bet)
Seat 8: 1st.p1ace folded before Flop (didn't bet)


*********** # 33 **************
PokerStars Hand #175433959173: Tournament #1701793956, $18.20+$1.80 USD=
 Hold'em No Limit - Level XI (250/500) - 2017/09/23 20:50:35 ET
Table '1701793956 2' 9-max Seat #2 is the button
Seat 1: @Bud_Fox0000 (10150 in chips)=20
Seat 2: mks24 (12200 in chips)=20
Seat 3: eliozica (24078 in chips)=20
Seat 4: Cassin'Clay (33050 in chips)=20
Seat 5: JJin91 (15593 in chips)=20
Seat 6: JRoop029 (12270 in chips)=20
Seat 7: PokerPayman (4665 in chips)=20
Seat 8: 1st.p1ace (11195 in chips)=20
@Bud_Fox0000: posts the ante 60
mks24: posts the ante 60
eliozica: posts the ante 60
Cassin'Clay: posts the ante 60
JJin91: posts the ante 60
JRoop029: posts the ante 60
PokerPayman: posts the ante 60
1st.p1ace: posts the ante 60
eliozica: posts small blind 250
Cassin'Clay: posts big blind 500
*** HOLE CARDS ***
Dealt to JJin91 [5c Td]
JJin91: folds=20
JRoop029: folds=20
PokerPayman: folds=20
1st.p1ace: folds=20
@Bud_Fox0000: folds=20
mks24: folds=20
eliozica: calls 250
Cassin'Clay: checks=20
*** FLOP *** [2d Jh Qd]
eliozica: bets 500
Cassin'Clay: folds=20
Uncalled bet (500) returned to eliozica
eliozica collected 1480 from pot
eliozica: doesn't show hand=20
*** SUMMARY ***
Total pot 1480 | Rake 0=20
Board [2d Jh Qd]
Seat 1: @Bud_Fox0000 folded before Flop (didn't bet)
Seat 2: mks24 (button) folded before Flop (didn't bet)
Seat 3: eliozica (small blind) collected (1480)
Seat 4: Cassin'Clay (big blind) folded on the Flop
Seat 5: JJin91 folded before Flop (didn't bet)
Seat 6: JRoop029 folded before Flop (didn't bet)
Seat 7: PokerPayman folded before Flop (didn't bet)
Seat 8: 1st.p1ace folded before Flop (didn't bet)


*********** # 34 **************
PokerStars Hand #175433959321: Tournament #1701793956, $18.20+$1.80 USD=
 Hold'em No Limit - Level XI (250/500) - 2017/09/23 20:51:09 ET
Table '1701793956 2' 9-max Seat #3 is the button
Seat 1: @Bud_Fox0000 (10090 in chips)=20
Seat 2: mks24 (12140 in chips)=20
Seat 3: eliozica (24998 in chips)=20
Seat 4: Cassin'Clay (32490 in chips)=20
Seat 5: JJin91 (15533 in chips)=20
Seat 6: JRoop029 (12210 in chips)=20
Seat 7: PokerPayman (4605 in chips)=20
Seat 8: 1st.p1ace (11135 in chips)=20
@Bud_Fox0000: posts the ante 60
mks24: posts the ante 60
eliozica: posts the ante 60
Cassin'Clay: posts the ante 60
JJin91: posts the ante 60
JRoop029: posts the ante 60
PokerPayman: posts the ante 60
1st.p1ace: posts the ante 60
Cassin'Clay: posts small blind 250
JJin91: posts big blind 500
*** HOLE CARDS ***
Dealt to JJin91 [3s Jc]
JRoop029: raises 1000 to 1500
PokerPayman: raises 3045 to 4545 and is all-in
1st.p1ace: folds=20
@Bud_Fox0000: folds=20
mks24: folds=20
eliozica: folds=20
Cassin'Clay: folds=20
JJin91: folds=20
JRoop029: calls 3045
*** FLOP *** [7d Ks 7h]
*** TURN *** [7d Ks 7h] [As]
*** RIVER *** [7d Ks 7h As] [9c]
*** SHOW DOWN ***
JRoop029: shows [Kc Tc] (two pair, Kings and Sevens)
PokerPayman: shows [Qd Ad] (two pair, Aces and Sevens)
PokerPayman collected 10320 from pot
*** SUMMARY ***
Total pot 10320 | Rake 0=20
Board [7d Ks 7h As 9c]
Seat 1: @Bud_Fox0000 folded before Flop (didn't bet)
Seat 2: mks24 folded before Flop (didn't bet)
Seat 3: eliozica (button) folded before Flop (didn't bet)
Seat 4: Cassin'Clay (small blind) folded before Flop
Seat 5: JJin91 (big blind) folded before Flop
Seat 6: JRoop029 showed [Kc Tc] and lost with two pair, Kings and Sevens
Seat 7: PokerPayman showed [Qd Ad] and won (10320) with two pair, Aces =
and Sevens
Seat 8: 1st.p1ace folded before Flop (didn't bet)


*********** # 35 **************
PokerStars Hand #175433959443: Tournament #1701793956, $18.20+$1.80 USD=
 Hold'em No Limit - Level XI (250/500) - 2017/09/23 20:51:39 ET
Table '1701793956 2' 9-max Seat #4 is the button
Seat 1: @Bud_Fox0000 (10030 in chips)=20
Seat 2: mks24 (12080 in chips)=20
Seat 3: eliozica (24938 in chips)=20
Seat 4: Cassin'Clay (32180 in chips)=20
Seat 5: JJin91 (14973 in chips)=20
Seat 6: JRoop029 (7605 in chips)=20
Seat 7: PokerPayman (10320 in chips)=20
Seat 8: 1st.p1ace (11075 in chips)=20
@Bud_Fox0000: posts the ante 60
mks24: posts the ante 60
eliozica: posts the ante 60
Cassin'Clay: posts the ante 60
JJin91: posts the ante 60
JRoop029: posts the ante 60
PokerPayman: posts the ante 60
1st.p1ace: posts the ante 60
JJin91: posts small blind 250
JRoop029: posts big blind 500
*** HOLE CARDS ***
Dealt to JJin91 [7c Js]
PokerPayman: calls 500
1st.p1ace: folds=20
@Bud_Fox0000: folds=20
mks24: raises 2230 to 2730
eliozica: folds=20
Cassin'Clay: folds=20
JJin91: folds=20
JRoop029 is disconnected=20
JRoop029 is connected=20
JRoop029: folds=20
PokerPayman: folds=20
Uncalled bet (2230) returned to mks24
mks24 collected 2230 from pot
mks24: doesn't show hand=20
*** SUMMARY ***
Total pot 2230 | Rake 0=20
Seat 1: @Bud_Fox0000 folded before Flop (didn't bet)
Seat 2: mks24 collected (2230)
Seat 3: eliozica folded before Flop (didn't bet)
Seat 4: Cassin'Clay (button) folded before Flop (didn't bet)
Seat 5: JJin91 (small blind) folded before Flop
Seat 6: JRoop029 (big blind) folded before Flop
Seat 7: PokerPayman folded before Flop
Seat 8: 1st.p1ace folded before Flop (didn't bet)


*********** # 36 **************
PokerStars Hand #175433959662: Tournament #1701793956, $18.20+$1.80 USD=
 Hold'em No Limit - Level XI (250/500) - 2017/09/23 20:52:28 ET
Table '1701793956 2' 9-max Seat #5 is the button
Seat 1: @Bud_Fox0000 (9970 in chips)=20
Seat 2: mks24 (13750 in chips)=20
Seat 3: eliozica (24878 in chips)=20
Seat 4: Cassin'Clay (32120 in chips)=20
Seat 5: JJin91 (14663 in chips)=20
Seat 6: JRoop029 (7045 in chips)=20
Seat 7: PokerPayman (9760 in chips)=20
Seat 8: 1st.p1ace (11015 in chips)=20
@Bud_Fox0000: posts the ante 60
mks24: posts the ante 60
eliozica: posts the ante 60
Cassin'Clay: posts the ante 60
JJin91: posts the ante 60
JRoop029: posts the ante 60
PokerPayman: posts the ante 60
1st.p1ace: posts the ante 60
JRoop029: posts small blind 250
PokerPayman: posts big blind 500
*** HOLE CARDS ***
Dealt to JJin91 [9h Ac]
1st.p1ace: raises 605 to 1105
@Bud_Fox0000: calls 1105
mks24: folds=20
eliozica: folds=20
Cassin'Clay: folds=20
JJin91: folds=20
JRoop029: folds=20
PokerPayman: folds=20
*** FLOP *** [Qd 5c Kc]
1st.p1ace: checks=20
@Bud_Fox0000: checks=20
*** TURN *** [Qd 5c Kc] [2s]
1st.p1ace: bets 2015
@Bud_Fox0000: folds=20
Uncalled bet (2015) returned to 1st.p1ace
1st.p1ace collected 3440 from pot
1st.p1ace: doesn't show hand=20
*** SUMMARY ***
Total pot 3440 | Rake 0=20
Board [Qd 5c Kc 2s]
Seat 1: @Bud_Fox0000 folded on the Turn
Seat 2: mks24 folded before Flop (didn't bet)
Seat 3: eliozica folded before Flop (didn't bet)
Seat 4: Cassin'Clay folded before Flop (didn't bet)
Seat 5: JJin91 (button) folded before Flop (didn't bet)
Seat 6: JRoop029 (small blind) folded before Flop
Seat 7: PokerPayman (big blind) folded before Flop
Seat 8: 1st.p1ace collected (3440)


*********** # 37 **************
PokerStars Hand #175433959866: Tournament #1701793956, $18.20+$1.80 USD=
 Hold'em No Limit - Level XI (250/500) - 2017/09/23 20:53:15 ET
Table '1701793956 2' 9-max Seat #6 is the button
Seat 1: @Bud_Fox0000 (8805 in chips)=20
Seat 2: mks24 (13690 in chips)=20
Seat 3: eliozica (24818 in chips)=20
Seat 4: Cassin'Clay (32060 in chips)=20
Seat 5: JJin91 (14603 in chips)=20
Seat 6: JRoop029 (6735 in chips)=20
Seat 7: PokerPayman (9200 in chips)=20
Seat 8: 1st.p1ace (13290 in chips)=20
@Bud_Fox0000: posts the ante 60
mks24: posts the ante 60
eliozica: posts the ante 60
Cassin'Clay: posts the ante 60
JJin91: posts the ante 60
JRoop029: posts the ante 60
PokerPayman: posts the ante 60
1st.p1ace: posts the ante 60
PokerPayman: posts small blind 250
1st.p1ace: posts big blind 500
*** HOLE CARDS ***
Dealt to JJin91 [7c 3c]
@Bud_Fox0000: folds=20
mks24: folds=20
eliozica: raises 500 to 1000
Cassin'Clay: folds=20
JJin91: folds=20
JRoop029: folds=20
PokerPayman: folds=20
1st.p1ace: folds=20
Uncalled bet (500) returned to eliozica
eliozica collected 1730 from pot
eliozica: doesn't show hand=20
*** SUMMARY ***
Total pot 1730 | Rake 0=20
Seat 1: @Bud_Fox0000 folded before Flop (didn't bet)
Seat 2: mks24 folded before Flop (didn't bet)
Seat 3: eliozica collected (1730)
Seat 4: Cassin'Clay folded before Flop (didn't bet)
Seat 5: JJin91 folded before Flop (didn't bet)
Seat 6: JRoop029 (button) folded before Flop (didn't bet)
Seat 7: PokerPayman (small blind) folded before Flop
Seat 8: 1st.p1ace (big blind) folded before Flop


*********** # 38 **************
PokerStars Hand #175433959928: Tournament #1701793956, $18.20+$1.80 USD=
 Hold'em No Limit - Level XI (250/500) - 2017/09/23 20:53:30 ET
Table '1701793956 2' 9-max Seat #7 is the button
Seat 1: @Bud_Fox0000 (8745 in chips)=20
Seat 2: mks24 (13630 in chips)=20
Seat 3: eliozica (25988 in chips)=20
Seat 4: Cassin'Clay (32000 in chips)=20
Seat 5: JJin91 (14543 in chips)=20
Seat 6: JRoop029 (6675 in chips)=20
Seat 7: PokerPayman (8890 in chips)=20
Seat 8: 1st.p1ace (12730 in chips)=20
@Bud_Fox0000: posts the ante 60
mks24: posts the ante 60
eliozica: posts the ante 60
Cassin'Clay: posts the ante 60
JJin91: posts the ante 60
JRoop029: posts the ante 60
PokerPayman: posts the ante 60
1st.p1ace: posts the ante 60
1st.p1ace: posts small blind 250
@Bud_Fox0000: posts big blind 500
*** HOLE CARDS ***
Dealt to JJin91 [6c Jh]
mks24: folds=20
eliozica: folds=20
Cassin'Clay: folds=20
JJin91: folds=20
JRoop029: folds=20
PokerPayman: folds=20
1st.p1ace: folds=20
Uncalled bet (250) returned to @Bud_Fox0000
@Bud_Fox0000 collected 980 from pot
*** SUMMARY ***
Total pot 980 | Rake 0=20
Seat 1: @Bud_Fox0000 (big blind) collected (980)
Seat 2: mks24 folded before Flop (didn't bet)
Seat 3: eliozica folded before Flop (didn't bet)
Seat 4: Cassin'Clay folded before Flop (didn't bet)
Seat 5: JJin91 folded before Flop (didn't bet)
Seat 6: JRoop029 folded before Flop (didn't bet)
Seat 7: PokerPayman (button) folded before Flop (didn't bet)
Seat 8: 1st.p1ace (small blind) folded before Flop


*********** # 39 **************
PokerStars Hand #175433959982: Tournament #1701793956, $18.20+$1.80 USD=
 Hold'em No Limit - Level XI (250/500) - 2017/09/23 20:53:43 ET
Table '1701793956 2' 9-max Seat #8 is the button
Seat 1: @Bud_Fox0000 (9415 in chips)=20
Seat 2: mks24 (13570 in chips)=20
Seat 3: eliozica (25928 in chips)=20
Seat 4: Cassin'Clay (31940 in chips)=20
Seat 5: JJin91 (14483 in chips)=20
Seat 6: JRoop029 (6615 in chips)=20
Seat 7: PokerPayman (8830 in chips)=20
Seat 8: 1st.p1ace (12420 in chips)=20
@Bud_Fox0000: posts the ante 60
mks24: posts the ante 60
eliozica: posts the ante 60
Cassin'Clay: posts the ante 60
JJin91: posts the ante 60
JRoop029: posts the ante 60
PokerPayman: posts the ante 60
1st.p1ace: posts the ante 60
@Bud_Fox0000: posts small blind 250
mks24: posts big blind 500
*** HOLE CARDS ***
Dealt to JJin91 [Qs Qd]
eliozica: folds=20
Cassin'Clay: folds=20
JJin91: raises 585 to 1085
JRoop029: folds=20
PokerPayman: folds=20
1st.p1ace: folds=20
@Bud_Fox0000: folds=20
mks24: calls 585
*** FLOP *** [Tc As 7s]
mks24: checks=20
JJin91: checks=20
*** TURN *** [Tc As 7s] [3c]
mks24: checks=20
JJin91: bets 1222
mks24: folds=20
Uncalled bet (1222) returned to JJin91
JJin91 collected 2900 from pot
JJin91: doesn't show hand=20
*** SUMMARY ***
Total pot 2900 | Rake 0=20
Board [Tc As 7s 3c]
Seat 1: @Bud_Fox0000 (small blind) folded before Flop
Seat 2: mks24 (big blind) folded on the Turn
Seat 3: eliozica folded before Flop (didn't bet)
Seat 4: Cassin'Clay folded before Flop (didn't bet)
Seat 5: JJin91 collected (2900)
Seat 6: JRoop029 folded before Flop (didn't bet)
Seat 7: PokerPayman folded before Flop (didn't bet)
Seat 8: 1st.p1ace (button) folded before Flop (didn't bet)


*********** # 40 **************
PokerStars Hand #175434365759: Tournament #1701793956, $18.20+$1.80 USD=
 Hold'em No Limit - Level XI (250/500) - 2017/09/23 20:54:27 ET
Table '1701793956 2' 9-max Seat #2 is the button
Seat 2: mks24 (12425 in chips)=20
Seat 3: eliozica (25868 in chips)=20
Seat 4: Cassin'Clay (31880 in chips)=20
Seat 5: JJin91 (16238 in chips)=20
Seat 6: JRoop029 (6555 in chips)=20
Seat 7: PokerPayman (8770 in chips)=20
Seat 8: 1st.p1ace (12360 in chips)=20
Seat 9: fingers911 (10000 in chips)=20
mks24: posts the ante 60
eliozica: posts the ante 60
Cassin'Clay: posts the ante 60
JJin91: posts the ante 60
JRoop029: posts the ante 60
PokerPayman: posts the ante 60
1st.p1ace: posts the ante 60
fingers911: posts the ante 60
eliozica: posts small blind 250
Cassin'Clay: posts big blind 500
*** HOLE CARDS ***
Dealt to JJin91 [4d Jc]
JJin91: folds=20
JRoop029: folds=20
PokerPayman: folds=20
1st.p1ace: folds=20
fingers911: raises 500 to 1000
mks24: folds=20
eliozica: folds=20
Cassin'Clay: calls 500
*** FLOP *** [9d 4c Kh]
Cassin'Clay: checks=20
fingers911: checks=20
*** TURN *** [9d 4c Kh] [Ks]
Cassin'Clay: checks=20
fingers911: checks=20
*** RIVER *** [9d 4c Kh Ks] [Kc]
Cassin'Clay: checks=20
fingers911: checks=20
*** SHOW DOWN ***
Cassin'Clay: shows [Qh Th] (three of a kind, Kings)
fingers911: mucks hand=20
Cassin'Clay collected 2730 from pot
*** SUMMARY ***
Total pot 2730 | Rake 0=20
Board [9d 4c Kh Ks Kc]
Seat 2: mks24 (button) folded before Flop (didn't bet)
Seat 3: eliozica (small blind) folded before Flop
Seat 4: Cassin'Clay (big blind) showed [Qh Th] and won (2730) with thre=
e of a kind, Kings
Seat 5: JJin91 folded before Flop (didn't bet)
Seat 6: JRoop029 folded before Flop (didn't bet)
Seat 7: PokerPayman folded before Flop (didn't bet)
Seat 8: 1st.p1ace folded before Flop (didn't bet)
Seat 9: fingers911 mucked [Ts Jh]


*********** # 41 **************
PokerStars Hand #175434365902: Tournament #1701793956, $18.20+$1.80 USD=
 Hold'em No Limit - Level XI (250/500) - 2017/09/23 20:55:00 ET
Table '1701793956 2' 9-max Seat #3 is the button
Seat 2: mks24 (12365 in chips)=20
Seat 3: eliozica (25558 in chips)=20
Seat 4: Cassin'Clay (33550 in chips)=20
Seat 5: JJin91 (16178 in chips)=20
Seat 6: JRoop029 (6495 in chips)=20
Seat 7: PokerPayman (8710 in chips)=20
Seat 8: 1st.p1ace (12300 in chips)=20
Seat 9: fingers911 (8940 in chips)=20
mks24: posts the ante 60
eliozica: posts the ante 60
Cassin'Clay: posts the ante 60
JJin91: posts the ante 60
JRoop029: posts the ante 60
PokerPayman: posts the ante 60
1st.p1ace: posts the ante 60
fingers911: posts the ante 60
Cassin'Clay: posts small blind 250
JJin91: posts big blind 500
*** HOLE CARDS ***
Dealt to JJin91 [Qh 6s]
JRoop029: folds=20
PokerPayman: folds=20
1st.p1ace: folds=20
fingers911: folds=20
mks24: raises 1730 to 2230
eliozica: folds=20
Cassin'Clay: folds=20
JJin91: folds=20
Uncalled bet (1730) returned to mks24
mks24 collected 1730 from pot
mks24: doesn't show hand=20
*** SUMMARY ***
Total pot 1730 | Rake 0=20
Seat 2: mks24 collected (1730)
Seat 3: eliozica (button) folded before Flop (didn't bet)
Seat 4: Cassin'Clay (small blind) folded before Flop
Seat 5: JJin91 (big blind) folded before Flop
Seat 6: JRoop029 folded before Flop (didn't bet)
Seat 7: PokerPayman folded before Flop (didn't bet)
Seat 8: 1st.p1ace folded before Flop (didn't bet)
Seat 9: fingers911 folded before Flop (didn't bet)


*********** # 42 **************
PokerStars Hand #175434367177: Tournament #1701793956, $18.20+$1.80 USD=
 Hold'em No Limit - Level XI (250/500) - 2017/09/23 21:01:31 ET
Table '1701793956 2' 9-max Seat #5 is the button
Seat 1: inthahole (10000 in chips)=20
Seat 2: mks24 (13535 in chips)=20
Seat 3: eliozica (25498 in chips)=20
Seat 4: datuxguy (10000 in chips)=20
Seat 5: JJin91 (15618 in chips)=20
Seat 6: JRoop029 (6435 in chips)=20
Seat 7: PokerPayman (8650 in chips)=20
Seat 8: 1st.p1ace (12240 in chips)=20
inthahole: posts the ante 60
mks24: posts the ante 60
eliozica: posts the ante 60
datuxguy: posts the ante 60
JJin91: posts the ante 60
JRoop029: posts the ante 60
PokerPayman: posts the ante 60
1st.p1ace: posts the ante 60
JRoop029: posts small blind 250
PokerPayman: posts big blind 500
*** HOLE CARDS ***
Dealt to JJin91 [3d Jh]
1st.p1ace: raises 605 to 1105
inthahole: folds=20
mks24: folds=20
eliozica: folds=20
datuxguy: folds=20
JJin91: folds=20
JRoop029: folds=20
PokerPayman: calls 605
*** FLOP *** [9d Qs 7c]
PokerPayman: checks=20
1st.p1ace: bets 1676
PokerPayman: calls 1676
*** TURN *** [9d Qs 7c] [9s]
PokerPayman: checks=20
1st.p1ace: bets 2013
PokerPayman: calls 2013
*** RIVER *** [9d Qs 7c 9s] [5h]
datuxguy said, "speed it up donkeys"
PokerPayman: checks=20
1st.p1ace: bets 5881
PokerPayman: folds=20
Uncalled bet (5881) returned to 1st.p1ace
1st.p1ace collected 10318 from pot
1st.p1ace: doesn't show hand=20
*** SUMMARY ***
Total pot 10318 | Rake 0=20
Board [9d Qs 7c 9s 5h]
Seat 1: inthahole folded before Flop (didn't bet)
Seat 2: mks24 folded before Flop (didn't bet)
Seat 3: eliozica folded before Flop (didn't bet)
Seat 4: datuxguy folded before Flop (didn't bet)
Seat 5: JJin91 (button) folded before Flop (didn't bet)
Seat 6: JRoop029 (small blind) folded before Flop
Seat 7: PokerPayman (big blind) folded on the River
Seat 8: 1st.p1ace collected (10318)


*********** # 43 **************
PokerStars Hand #175434367524: Tournament #1701793956, $18.20+$1.80 USD=
 Hold'em No Limit - Level XII (300/600) - 2017/09/23 21:03:06 ET
Table '1701793956 2' 9-max Seat #6 is the button
Seat 1: inthahole (9940 in chips)=20
Seat 2: mks24 (13475 in chips)=20
Seat 3: eliozica (25438 in chips)=20
Seat 4: datuxguy (9940 in chips)=20
Seat 5: JJin91 (15558 in chips)=20
Seat 6: JRoop029 (6125 in chips)=20
Seat 7: PokerPayman (3796 in chips)=20
Seat 8: 1st.p1ace (17704 in chips)=20
inthahole: posts the ante 70
mks24: posts the ante 70
eliozica: posts the ante 70
datuxguy: posts the ante 70
JJin91: posts the ante 70
JRoop029: posts the ante 70
PokerPayman: posts the ante 70
1st.p1ace: posts the ante 70
PokerPayman: posts small blind 300
1st.p1ace: posts big blind 600
*** HOLE CARDS ***
Dealt to JJin91 [Ks Td]
inthahole: folds=20
mks24: folds=20
eliozica: folds=20
datuxguy: calls 600
JJin91: calls 600
JRoop029: folds=20
PokerPayman: calls 300
1st.p1ace: checks=20
*** FLOP *** [7d Kh 3s]
PokerPayman: checks=20
1st.p1ace: checks=20
datuxguy: bets 600
JJin91: raises 1539 to 2139
PokerPayman: raises 987 to 3126 and is all-in
1st.p1ace: folds=20
datuxguy: folds=20
JJin91: calls 987
*** TURN *** [7d Kh 3s] [5d]
*** RIVER *** [7d Kh 3s 5d] [Kc]
*** SHOW DOWN ***
PokerPayman: shows [Kd Jc] (three of a kind, Kings)
JJin91: shows [Ks Td] (three of a kind, Kings - lower kicker)
PokerPayman collected 9812 from pot
*** SUMMARY ***
Total pot 9812 | Rake 0=20
Board [7d Kh 3s 5d Kc]
Seat 1: inthahole folded before Flop (didn't bet)
Seat 2: mks24 folded before Flop (didn't bet)
Seat 3: eliozica folded before Flop (didn't bet)
Seat 4: datuxguy folded on the Flop
Seat 5: JJin91 showed [Ks Td] and lost with three of a kind, Kings
Seat 6: JRoop029 (button) folded before Flop (didn't bet)
Seat 7: PokerPayman (small blind) showed [Kd Jc] and won (9812) with th=
ree of a kind, Kings
Seat 8: 1st.p1ace (big blind) folded on the Flop


*********** # 44 **************
PokerStars Hand #175434367843: Tournament #1701793956, $18.20+$1.80 USD=
 Hold'em No Limit - Level XII (300/600) - 2017/09/23 21:04:24 ET
Table '1701793956 2' 9-max Seat #7 is the button
Seat 1: inthahole (9870 in chips)=20
Seat 2: mks24 (13405 in chips)=20
Seat 3: eliozica (25368 in chips)=20
Seat 4: datuxguy (8670 in chips)=20
Seat 5: JJin91 (11762 in chips)=20
Seat 6: JRoop029 (6055 in chips)=20
Seat 7: PokerPayman (9812 in chips)=20
Seat 8: 1st.p1ace (17034 in chips)=20
Seat 9: mmenz08816 (21190 in chips)=20
inthahole: posts the ante 70
mks24: posts the ante 70
eliozica: posts the ante 70
datuxguy: posts the ante 70
JJin91: posts the ante 70
JRoop029: posts the ante 70
PokerPayman: posts the ante 70
1st.p1ace: posts the ante 70
mmenz08816: posts the ante 70
1st.p1ace: posts small blind 300
mmenz08816: posts big blind 600
*** HOLE CARDS ***
Dealt to JJin91 [Qc Jh]
inthahole: folds=20
mks24: folds=20
eliozica: folds=20
datuxguy: folds=20
JJin91: raises 11092 to 11692 and is all-in
JRoop029: folds=20
PokerPayman: folds=20
1st.p1ace: folds=20
mmenz08816: folds=20
Uncalled bet (11092) returned to JJin91
JJin91 collected 2130 from pot
JJin91: doesn't show hand=20
*** SUMMARY ***
Total pot 2130 | Rake 0=20
Seat 1: inthahole folded before Flop (didn't bet)
Seat 2: mks24 folded before Flop (didn't bet)
Seat 3: eliozica folded before Flop (didn't bet)
Seat 4: datuxguy folded before Flop (didn't bet)
Seat 5: JJin91 collected (2130)
Seat 6: JRoop029 folded before Flop (didn't bet)
Seat 7: PokerPayman (button) folded before Flop (didn't bet)
Seat 8: 1st.p1ace (small blind) folded before Flop
Seat 9: mmenz08816 (big blind) folded before Flop


*********** # 45 **************
PokerStars Hand #175434367975: Tournament #1701793956, $18.20+$1.80 USD=
 Hold'em No Limit - Level XII (300/600) - 2017/09/23 21:04:58 ET
Table '1701793956 2' 9-max Seat #8 is the button
Seat 1: inthahole (9800 in chips)=20
Seat 2: mks24 (13335 in chips)=20
Seat 3: eliozica (25298 in chips)=20
Seat 4: datuxguy (8600 in chips)=20
Seat 5: JJin91 (13222 in chips)=20
Seat 6: JRoop029 (5985 in chips)=20
Seat 7: PokerPayman (9742 in chips)=20
Seat 8: 1st.p1ace (16664 in chips)=20
Seat 9: mmenz08816 (20520 in chips)=20
inthahole: posts the ante 70
mks24: posts the ante 70
eliozica: posts the ante 70
datuxguy: posts the ante 70
JJin91: posts the ante 70
JRoop029: posts the ante 70
PokerPayman: posts the ante 70
1st.p1ace: posts the ante 70
mmenz08816: posts the ante 70
mmenz08816: posts small blind 300
inthahole: posts big blind 600
*** HOLE CARDS ***
Dealt to JJin91 [5d Qd]
mks24: folds=20
eliozica: folds=20
datuxguy: folds=20
JJin91: folds=20
JRoop029: folds=20
PokerPayman: raises 600 to 1200
1st.p1ace: folds=20
mmenz08816: folds=20
inthahole: calls 600
*** FLOP *** [Jh Js 8h]
inthahole: checks=20
PokerPayman: bets 1800
inthahole: raises 6730 to 8530 and is all-in
PokerPayman: folds=20
Uncalled bet (6730) returned to inthahole
inthahole collected 6930 from pot
inthahole: doesn't show hand=20
*** SUMMARY ***
Total pot 6930 | Rake 0=20
Board [Jh Js 8h]
Seat 1: inthahole (big blind) collected (6930)
Seat 2: mks24 folded before Flop (didn't bet)
Seat 3: eliozica folded before Flop (didn't bet)
Seat 4: datuxguy folded before Flop (didn't bet)
Seat 5: JJin91 folded before Flop (didn't bet)
Seat 6: JRoop029 folded before Flop (didn't bet)
Seat 7: PokerPayman folded on the Flop
Seat 8: 1st.p1ace (button) folded before Flop (didn't bet)
Seat 9: mmenz08816 (small blind) folded before Flop


*********** # 46 **************
PokerStars Hand #175434368407: Tournament #1701793956, $18.20+$1.80 USD=
 Hold'em No Limit - Level XII (300/600) - 2017/09/23 21:06:44 ET
Table '1701793956 2' 9-max Seat #9 is the button
Seat 1: inthahole (13660 in chips)=20
Seat 2: mks24 (13265 in chips)=20
Seat 3: eliozica (25228 in chips)=20
Seat 4: datuxguy (8530 in chips)=20
Seat 5: JJin91 (13152 in chips)=20
Seat 6: JRoop029 (5915 in chips)=20
Seat 7: PokerPayman (6672 in chips)=20
Seat 8: 1st.p1ace (16594 in chips)=20
Seat 9: mmenz08816 (20150 in chips)=20
inthahole: posts the ante 70
mks24: posts the ante 70
eliozica: posts the ante 70
datuxguy: posts the ante 70
JJin91: posts the ante 70
JRoop029: posts the ante 70
PokerPayman: posts the ante 70
1st.p1ace: posts the ante 70
mmenz08816: posts the ante 70
inthahole: posts small blind 300
mks24: posts big blind 600
*** HOLE CARDS ***
Dealt to JJin91 [5d 7c]
eliozica: folds=20
datuxguy: folds=20
JJin91: folds=20
JRoop029: raises 5245 to 5845 and is all-in
PokerPayman: folds=20
1st.p1ace: folds=20
mmenz08816: folds=20
inthahole: folds=20
mks24: folds=20
Uncalled bet (5245) returned to JRoop029
JRoop029 collected 2130 from pot
JRoop029: doesn't show hand=20
*** SUMMARY ***
Total pot 2130 | Rake 0=20
Seat 1: inthahole (small blind) folded before Flop
Seat 2: mks24 (big blind) folded before Flop
Seat 3: eliozica folded before Flop (didn't bet)
Seat 4: datuxguy folded before Flop (didn't bet)
Seat 5: JJin91 folded before Flop (didn't bet)
Seat 6: JRoop029 collected (2130)
Seat 7: PokerPayman folded before Flop (didn't bet)
Seat 8: 1st.p1ace folded before Flop (didn't bet)
Seat 9: mmenz08816 (button) folded before Flop (didn't bet)


*********** # 47 **************
PokerStars Hand #175434368510: Tournament #1701793956, $18.20+$1.80 USD=
 Hold'em No Limit - Level XII (300/600) - 2017/09/23 21:07:07 ET
Table '1701793956 2' 9-max Seat #1 is the button
Seat 1: inthahole (13290 in chips)=20
Seat 2: mks24 (12595 in chips)=20
Seat 3: eliozica (25158 in chips)=20
Seat 4: datuxguy (8460 in chips)=20
Seat 5: JJin91 (13082 in chips)=20
Seat 6: JRoop029 (7375 in chips)=20
Seat 7: PokerPayman (6602 in chips)=20
Seat 8: 1st.p1ace (16524 in chips)=20
Seat 9: mmenz08816 (20080 in chips)=20
inthahole: posts the ante 70
mks24: posts the ante 70
eliozica: posts the ante 70
datuxguy: posts the ante 70
JJin91: posts the ante 70
JRoop029: posts the ante 70
PokerPayman: posts the ante 70
1st.p1ace: posts the ante 70
mmenz08816: posts the ante 70
mks24: posts small blind 300
eliozica: posts big blind 600
*** HOLE CARDS ***
Dealt to JJin91 [3h 8c]
datuxguy has timed out
datuxguy: folds=20
datuxguy is sitting out
JJin91: folds=20
JRoop029: folds=20
PokerPayman: calls 600
1st.p1ace: folds=20
mmenz08816: folds=20
datuxguy has returned
inthahole: calls 600
mks24: calls 300
eliozica: checks=20
*** FLOP *** [6d Td 4d]
mks24: bets 600
eliozica: calls 600
PokerPayman: folds=20
inthahole: calls 600
*** TURN *** [6d Td 4d] [Ad]
mks24: bets 600
eliozica: folds=20
inthahole: calls 600
*** RIVER *** [6d Td 4d Ad] [Jh]
mks24: bets 600
inthahole: raises 2650 to 3250
mks24: calls 2650
*** SHOW DOWN ***
inthahole: shows [Qd 5d] (a flush, Ace high)
mks24: mucks hand=20
inthahole collected 12530 from pot
*** SUMMARY ***
Total pot 12530 | Rake 0=20
Board [6d Td 4d Ad Jh]
Seat 1: inthahole (button) showed [Qd 5d] and won (12530) with a flush,=
 Ace high
Seat 2: mks24 (small blind) mucked [As Ts]
Seat 3: eliozica (big blind) folded on the Turn
Seat 4: datuxguy folded before Flop (didn't bet)
Seat 5: JJin91 folded before Flop (didn't bet)
Seat 6: JRoop029 folded before Flop (didn't bet)
Seat 7: PokerPayman folded on the Flop
Seat 8: 1st.p1ace folded before Flop (didn't bet)
Seat 9: mmenz08816 folded before Flop (didn't bet)


*********** # 48 **************
PokerStars Hand #175434368887: Tournament #1701793956, $18.20+$1.80 USD=
 Hold'em No Limit - Level XII (300/600) - 2017/09/23 21:08:37 ET
Table '1701793956 2' 9-max Seat #2 is the button
Seat 1: inthahole (20700 in chips)=20
Seat 2: mks24 (7475 in chips)=20
Seat 3: eliozica (23888 in chips)=20
Seat 4: datuxguy (8390 in chips)=20
Seat 5: JJin91 (13012 in chips)=20
Seat 6: JRoop029 (7305 in chips)=20
Seat 7: PokerPayman (5932 in chips)=20
Seat 8: 1st.p1ace (16454 in chips)=20
Seat 9: mmenz08816 (20010 in chips)=20
inthahole: posts the ante 70
mks24: posts the ante 70
eliozica: posts the ante 70
datuxguy: posts the ante 70
JJin91: posts the ante 70
JRoop029: posts the ante 70
PokerPayman: posts the ante 70
1st.p1ace: posts the ante 70
mmenz08816: posts the ante 70
eliozica: posts small blind 300
datuxguy: posts big blind 600
*** HOLE CARDS ***
Dealt to JJin91 [As Ad]
JJin91: raises 702 to 1302
JRoop029: folds=20
PokerPayman: folds=20
1st.p1ace: folds=20
mmenz08816: folds=20
inthahole: folds=20
mks24: calls 1302
eliozica: folds=20
datuxguy: folds=20
*** FLOP *** [4c Kc Ah]
JJin91: bets 1530
mks24: folds=20
Uncalled bet (1530) returned to JJin91
JJin91 collected 4134 from pot
JJin91: doesn't show hand=20
*** SUMMARY ***
Total pot 4134 | Rake 0=20
Board [4c Kc Ah]
Seat 1: inthahole folded before Flop (didn't bet)
Seat 2: mks24 (button) folded on the Flop
Seat 3: eliozica (small blind) folded before Flop
Seat 4: datuxguy (big blind) folded before Flop
Seat 5: JJin91 collected (4134)
Seat 6: JRoop029 folded before Flop (didn't bet)
Seat 7: PokerPayman folded before Flop (didn't bet)
Seat 8: 1st.p1ace folded before Flop (didn't bet)
Seat 9: mmenz08816 folded before Flop (didn't bet)


*********** # 49 **************
PokerStars Hand #175434369124: Tournament #1701793956, $18.20+$1.80 USD=
 Hold'em No Limit - Level XII (300/600) - 2017/09/23 21:09:32 ET
Table '1701793956 2' 9-max Seat #3 is the button
Seat 1: inthahole (20630 in chips)=20
Seat 2: mks24 (6103 in chips)=20
Seat 3: eliozica (23518 in chips)=20
Seat 4: datuxguy (7720 in chips)=20
Seat 5: JJin91 (15774 in chips)=20
Seat 6: JRoop029 (7235 in chips)=20
Seat 7: PokerPayman (5862 in chips)=20
Seat 9: mmenz08816 (19940 in chips)=20
inthahole: posts the ante 70
mks24: posts the ante 70
eliozica: posts the ante 70
datuxguy: posts the ante 70
JJin91: posts the ante 70
JRoop029: posts the ante 70
PokerPayman: posts the ante 70
mmenz08816: posts the ante 70
datuxguy: posts small blind 300
JJin91: posts big blind 600
*** HOLE CARDS ***
Dealt to JJin91 [5c 3h]
JRoop029: folds=20
PokerPayman: raises 600 to 1200
mmenz08816: folds=20
inthahole: folds=20
mks24: calls 1200
eliozica: folds=20
datuxguy: raises 6450 to 7650 and is all-in
JJin91: folds=20
PokerPayman: folds=20
mks24: calls 4833 and is all-in
Uncalled bet (1617) returned to datuxguy
*** FLOP *** [As 8h 5s]
*** TURN *** [As 8h 5s] [6s]
*** RIVER *** [As 8h 5s 6s] [5d]
*** SHOW DOWN ***
datuxguy: shows [4s 4c] (two pair, Fives and Fours)
mks24: shows [9d 8d] (two pair, Eights and Fives)
mks24 collected 14426 from pot
*** SUMMARY ***
Total pot 14426 | Rake 0=20
Board [As 8h 5s 6s 5d]
Seat 1: inthahole folded before Flop (didn't bet)
Seat 2: mks24 showed [9d 8d] and won (14426) with two pair, Eights and =
Fives
Seat 3: eliozica (button) folded before Flop (didn't bet)
Seat 4: datuxguy (small blind) showed [4s 4c] and lost with two pair, F=
ives and Fours
Seat 5: JJin91 (big blind) folded before Flop
Seat 6: JRoop029 folded before Flop (didn't bet)
Seat 7: PokerPayman folded before Flop
Seat 9: mmenz08816 folded before Flop (didn't bet)


*********** # 50 **************
PokerStars Hand #175434369327: Tournament #1701793956, $18.20+$1.80 USD=
 Hold'em No Limit - Level XII (300/600) - 2017/09/23 21:10:21 ET
Table '1701793956 2' 9-max Seat #4 is the button
Seat 1: inthahole (20560 in chips)=20
Seat 2: mks24 (14426 in chips)=20
Seat 3: eliozica (23448 in chips)=20
Seat 4: datuxguy (1617 in chips)=20
Seat 5: JJin91 (15104 in chips)=20
Seat 6: JRoop029 (7165 in chips)=20
Seat 7: PokerPayman (4592 in chips)=20
Seat 9: mmenz08816 (19870 in chips)=20
inthahole: posts the ante 70
mks24: posts the ante 70
eliozica: posts the ante 70
datuxguy: posts the ante 70
JJin91: posts the ante 70
JRoop029: posts the ante 70
PokerPayman: posts the ante 70
mmenz08816: posts the ante 70
JJin91: posts small blind 300
JRoop029: posts big blind 600
*** HOLE CARDS ***
Dealt to JJin91 [5d 8d]
PokerPayman: folds=20
datuxguy said, "wht bssssss fkn moron"
mmenz08816: folds=20
inthahole: folds=20
mks24: folds=20
eliozica: calls 600
datuxguy: folds=20
JJin91: folds=20
JRoop029: checks=20
*** FLOP *** [Tc Ad Kh]
JRoop029: checks=20
eliozica: bets 600
JRoop029: folds=20
Uncalled bet (600) returned to eliozica
eliozica collected 2060 from pot
eliozica: doesn't show hand=20
*** SUMMARY ***
Total pot 2060 | Rake 0=20
Board [Tc Ad Kh]
Seat 1: inthahole folded before Flop (didn't bet)
Seat 2: mks24 folded before Flop (didn't bet)
Seat 3: eliozica collected (2060)
Seat 4: datuxguy (button) folded before Flop (didn't bet)
Seat 5: JJin91 (small blind) folded before Flop
Seat 6: JRoop029 (big blind) folded on the Flop
Seat 7: PokerPayman folded before Flop (didn't bet)
Seat 9: mmenz08816 folded before Flop (didn't bet)


*********** # 51 **************
PokerStars Hand #175434369449: Tournament #1701793956, $18.20+$1.80 USD=
 Hold'em No Limit - Level XII (300/600) - 2017/09/23 21:10:48 ET
Table '1701793956 2' 9-max Seat #5 is the button
Seat 1: inthahole (20490 in chips)=20
Seat 2: mks24 (14356 in chips)=20
Seat 3: eliozica (24838 in chips)=20
Seat 4: datuxguy (1547 in chips)=20
Seat 5: JJin91 (14734 in chips)=20
Seat 6: JRoop029 (6495 in chips)=20
Seat 7: PokerPayman (4522 in chips)=20
Seat 8: Exomoon (27221 in chips)=20
Seat 9: mmenz08816 (19800 in chips)=20
inthahole: posts the ante 70
mks24: posts the ante 70
eliozica: posts the ante 70
datuxguy: posts the ante 70
JJin91: posts the ante 70
JRoop029: posts the ante 70
PokerPayman: posts the ante 70
Exomoon: posts the ante 70
mmenz08816: posts the ante 70
JRoop029: posts small blind 300
PokerPayman: posts big blind 600
*** HOLE CARDS ***
Dealt to JJin91 [6d Kc]
Exomoon: calls 600
mmenz08816: folds=20
inthahole: folds=20
mks24: folds=20
eliozica: folds=20
datuxguy: raises 877 to 1477 and is all-in
JJin91: folds=20
JRoop029: folds=20
PokerPayman: calls 877
Exomoon: calls 877
*** FLOP *** [Tc 3h Kd]
PokerPayman: checks=20
Exomoon: checks=20
*** TURN *** [Tc 3h Kd] [5d]
PokerPayman: checks=20
Exomoon: checks=20
*** RIVER *** [Tc 3h Kd 5d] [8h]
PokerPayman: checks=20
Exomoon: checks=20
*** SHOW DOWN ***
PokerPayman: shows [9s Qs] (high card King)
Exomoon: shows [7h Ad] (high card Ace)
datuxguy: shows [8d Kh] (two pair, Kings and Eights)
datuxguy collected 5361 from pot
*** SUMMARY ***
Total pot 5361 | Rake 0=20
Board [Tc 3h Kd 5d 8h]
Seat 1: inthahole folded before Flop (didn't bet)
Seat 2: mks24 folded before Flop (didn't bet)
Seat 3: eliozica folded before Flop (didn't bet)
Seat 4: datuxguy showed [8d Kh] and won (5361) with two pair, Kings and=
 Eights
Seat 5: JJin91 (button) folded before Flop (didn't bet)
Seat 6: JRoop029 (small blind) folded before Flop
Seat 7: PokerPayman (big blind) showed [9s Qs] and lost with high card =
King
Seat 8: Exomoon showed [7h Ad] and lost with high card Ace
Seat 9: mmenz08816 folded before Flop (didn't bet)


*********** # 52 **************
PokerStars Hand #175434369675: Tournament #1701793956, $18.20+$1.80 USD=
 Hold'em No Limit - Level XII (300/600) - 2017/09/23 21:11:48 ET
Table '1701793956 2' 9-max Seat #6 is the button
Seat 1: inthahole (20420 in chips)=20
Seat 2: mks24 (14286 in chips)=20
Seat 3: eliozica (24768 in chips)=20
Seat 4: datuxguy (5361 in chips)=20
Seat 5: JJin91 (14664 in chips)=20
Seat 6: JRoop029 (6125 in chips)=20
Seat 7: PokerPayman (2975 in chips)=20
Seat 8: Exomoon (25674 in chips)=20
Seat 9: mmenz08816 (19730 in chips)=20
inthahole: posts the ante 70
mks24: posts the ante 70
eliozica: posts the ante 70
datuxguy: posts the ante 70
JJin91: posts the ante 70
JRoop029: posts the ante 70
PokerPayman: posts the ante 70
Exomoon: posts the ante 70
mmenz08816: posts the ante 70
PokerPayman: posts small blind 300
Exomoon: posts big blind 600
*** HOLE CARDS ***
Dealt to JJin91 [Qc Ts]
mmenz08816: folds=20
inthahole: folds=20
mks24: folds=20
eliozica: folds=20
datuxguy: folds=20
JJin91: folds=20
JRoop029: folds=20
PokerPayman: calls 300
Exomoon: raises 1830 to 2430
PokerPayman: raises 475 to 2905 and is all-in
Exomoon: calls 475
*** FLOP *** [5s 7s 3c]
*** TURN *** [5s 7s 3c] [8c]
*** RIVER *** [5s 7s 3c 8c] [5c]
*** SHOW DOWN ***
PokerPayman: shows [9s Jd] (a pair of Fives)
Exomoon: shows [Qh Ad] (a pair of Fives - Ace kicker)
Exomoon collected 6440 from pot
PokerPayman finished the tournament in 51st place
*** SUMMARY ***
Total pot 6440 | Rake 0=20
Board [5s 7s 3c 8c 5c]
Seat 1: inthahole folded before Flop (didn't bet)
Seat 2: mks24 folded before Flop (didn't bet)
Seat 3: eliozica folded before Flop (didn't bet)
Seat 4: datuxguy folded before Flop (didn't bet)
Seat 5: JJin91 folded before Flop (didn't bet)
Seat 6: JRoop029 (button) folded before Flop (didn't bet)
Seat 7: PokerPayman (small blind) showed [9s Jd] and lost with a pair o=
f Fives
Seat 8: Exomoon (big blind) showed [Qh Ad] and won (6440) with a pair o=
f Fives
Seat 9: mmenz08816 folded before Flop (didn't bet)


*********** # 53 **************
PokerStars Hand #175434369885: Tournament #1701793956, $18.20+$1.80 USD=
 Hold'em No Limit - Level XIII (350/700) - 2017/09/23 21:12:37 ET
Table '1701793956 2' 9-max Seat #8 is the button
Seat 1: inthahole (20350 in chips)=20
Seat 2: mks24 (14216 in chips)=20
Seat 3: eliozica (24698 in chips)=20
Seat 4: datuxguy (5291 in chips)=20
Seat 5: JJin91 (14594 in chips)=20
Seat 6: JRoop029 (6055 in chips)=20
Seat 8: Exomoon (29139 in chips)=20
Seat 9: mmenz08816 (19660 in chips)=20
inthahole: posts the ante 85
mks24: posts the ante 85
eliozica: posts the ante 85
datuxguy: posts the ante 85
JJin91: posts the ante 85
JRoop029: posts the ante 85
Exomoon: posts the ante 85
mmenz08816: posts the ante 85
mmenz08816: posts small blind 350
inthahole: posts big blind 700
*** HOLE CARDS ***
Dealt to JJin91 [Qs Ah]
mks24: folds=20
eliozica: raises 1400 to 2100
datuxguy: folds=20
JJin91: calls 2100
JRoop029: folds=20
Exomoon: calls 2100
mmenz08816: folds=20
inthahole: folds=20
*** FLOP *** [Ad 2c Th]
eliozica: checks=20
JJin91: bets 2971
Exomoon: calls 2971
eliozica: folds=20
*** TURN *** [Ad 2c Th] [8h]
JJin91: checks=20
Exomoon: checks=20
*** RIVER *** [Ad 2c Th 8h] [6d]
JJin91: checks=20
Exomoon: checks=20
*** SHOW DOWN ***
JJin91: shows [Qs Ah] (a pair of Aces)
Exomoon: mucks hand=20
JJin91 collected 13972 from pot
*** SUMMARY ***
Total pot 13972 | Rake 0=20
Board [Ad 2c Th 8h 6d]
Seat 1: inthahole (big blind) folded before Flop
Seat 2: mks24 folded before Flop (didn't bet)
Seat 3: eliozica folded on the Flop
Seat 4: datuxguy folded before Flop (didn't bet)
Seat 5: JJin91 showed [Qs Ah] and won (13972) with a pair of Aces
Seat 6: JRoop029 folded before Flop (didn't bet)
Seat 8: Exomoon (button) mucked [Jc Qc]
Seat 9: mmenz08816 (small blind) folded before Flop


*********** # 54 **************
PokerStars Hand #175435306392: Tournament #1701793956, $18.20+$1.80 USD=
 Hold'em No Limit - Level XIII (350/700) - 2017/09/23 21:14:17 ET
Table '1701793956 2' 9-max Seat #9 is the button
Seat 1: inthahole (19565 in chips)=20
Seat 2: mks24 (14131 in chips)=20
Seat 3: eliozica (22513 in chips)=20
Seat 4: datuxguy (5206 in chips)=20
Seat 5: JJin91 (23410 in chips)=20
Seat 6: JRoop029 (5970 in chips)=20
Seat 8: Exomoon (23983 in chips)=20
Seat 9: mmenz08816 (19225 in chips)=20
inthahole: posts the ante 85
mks24: posts the ante 85
eliozica: posts the ante 85
datuxguy: posts the ante 85
JJin91: posts the ante 85
JRoop029: posts the ante 85
Exomoon: posts the ante 85
mmenz08816: posts the ante 85
inthahole: posts small blind 350
mks24: posts big blind 700
*** HOLE CARDS ***
Dealt to JJin91 [Qs 4h]
eliozica: folds=20
datuxguy: raises 4421 to 5121 and is all-in
JJin91: folds=20
JRoop029: folds=20
Exomoon: folds=20
mmenz08816: folds=20
inthahole: folds=20
mks24: folds=20
Uncalled bet (4421) returned to datuxguy
datuxguy collected 2430 from pot
datuxguy: shows [3s 2s] (high card Three)
*** SUMMARY ***
Total pot 2430 | Rake 0=20
Seat 1: inthahole (small blind) folded before Flop
Seat 2: mks24 (big blind) folded before Flop
Seat 3: eliozica folded before Flop (didn't bet)
Seat 4: datuxguy collected (2430)
Seat 5: JJin91 folded before Flop (didn't bet)
Seat 6: JRoop029 folded before Flop (didn't bet)
Seat 8: Exomoon folded before Flop (didn't bet)
Seat 9: mmenz08816 (button) folded before Flop (didn't bet)


*********** # 55 **************
PokerStars Hand #175435306465: Tournament #1701793956, $18.20+$1.80 USD=
 Hold'em No Limit - Level XIII (350/700) - 2017/09/23 21:14:35 ET
Table '1701793956 2' 9-max Seat #1 is the button
Seat 1: inthahole (19130 in chips)=20
Seat 2: mks24 (13346 in chips)=20
Seat 3: eliozica (22428 in chips)=20
Seat 4: datuxguy (6851 in chips)=20
Seat 5: JJin91 (23325 in chips)=20
Seat 6: JRoop029 (5885 in chips)=20
Seat 8: Exomoon (23898 in chips)=20
Seat 9: mmenz08816 (19140 in chips)=20
inthahole: posts the ante 85
mks24: posts the ante 85
eliozica: posts the ante 85
datuxguy: posts the ante 85
JJin91: posts the ante 85
JRoop029: posts the ante 85
Exomoon: posts the ante 85
mmenz08816: posts the ante 85
mks24: posts small blind 350
eliozica: posts big blind 700
*** HOLE CARDS ***
Dealt to JJin91 [5h 2d]
datuxguy: folds=20
JJin91: folds=20
JRoop029: folds=20
Exomoon: folds=20
mmenz08816: raises 1050 to 1750
inthahole: folds=20
mks24: folds=20
eliozica: calls 1050
*** FLOP *** [6c 9d 4c]
eliozica: bets 4200
mmenz08816: folds=20
Uncalled bet (4200) returned to eliozica
eliozica collected 4530 from pot
eliozica: doesn't show hand=20
*** SUMMARY ***
Total pot 4530 | Rake 0=20
Board [6c 9d 4c]
Seat 1: inthahole (button) folded before Flop (didn't bet)
Seat 2: mks24 (small blind) folded before Flop
Seat 3: eliozica (big blind) collected (4530)
Seat 4: datuxguy folded before Flop (didn't bet)
Seat 5: JJin91 folded before Flop (didn't bet)
Seat 6: JRoop029 folded before Flop (didn't bet)
Seat 8: Exomoon folded before Flop (didn't bet)
Seat 9: mmenz08816 folded on the Flop


*********** # 56 **************
PokerStars Hand #175435306597: Tournament #1701793956, $18.20+$1.80 USD=
 Hold'em No Limit - Level XIII (350/700) - 2017/09/23 21:15:04 ET
Table '1701793956 2' 9-max Seat #2 is the button
Seat 1: inthahole (19045 in chips)=20
Seat 2: mks24 (12911 in chips)=20
Seat 3: eliozica (25123 in chips)=20
Seat 4: datuxguy (6766 in chips)=20
Seat 5: JJin91 (23240 in chips)=20
Seat 6: JRoop029 (5800 in chips)=20
Seat 8: Exomoon (23813 in chips)=20
Seat 9: mmenz08816 (17305 in chips)=20
inthahole: posts the ante 85
mks24: posts the ante 85
eliozica: posts the ante 85
datuxguy: posts the ante 85
JJin91: posts the ante 85
JRoop029: posts the ante 85
Exomoon: posts the ante 85
mmenz08816: posts the ante 85
eliozica: posts small blind 350
datuxguy: posts big blind 700
*** HOLE CARDS ***
Dealt to JJin91 [8d Ac]
JJin91: folds=20
JRoop029: folds=20
Exomoon: calls 700
mmenz08816: folds=20
inthahole: calls 700
mks24: folds=20
eliozica: calls 350
datuxguy: checks=20
*** FLOP *** [4d 2s Jd]
eliozica: checks=20
datuxguy: bets 700
Exomoon: raises 2100 to 2800
inthahole: folds=20
eliozica: folds=20
datuxguy: folds=20
Uncalled bet (2100) returned to Exomoon
Exomoon collected 4880 from pot
Exomoon: doesn't show hand=20
*** SUMMARY ***
Total pot 4880 | Rake 0=20
Board [4d 2s Jd]
Seat 1: inthahole folded on the Flop
Seat 2: mks24 (button) folded before Flop (didn't bet)
Seat 3: eliozica (small blind) folded on the Flop
Seat 4: datuxguy (big blind) folded on the Flop
Seat 5: JJin91 folded before Flop (didn't bet)
Seat 6: JRoop029 folded before Flop (didn't bet)
Seat 8: Exomoon collected (4880)
Seat 9: mmenz08816 folded before Flop (didn't bet)


*********** # 57 **************
PokerStars Hand #175435306738: Tournament #1701793956, $18.20+$1.80 USD=
 Hold'em No Limit - Level XIII (350/700) - 2017/09/23 21:15:41 ET
Table '1701793956 2' 9-max Seat #3 is the button
Seat 1: inthahole (18260 in chips)=20
Seat 2: mks24 (12826 in chips)=20
Seat 3: eliozica (24338 in chips)=20
Seat 4: datuxguy (5281 in chips)=20
Seat 5: JJin91 (23155 in chips)=20
Seat 6: JRoop029 (5715 in chips)=20
Seat 8: Exomoon (27208 in chips)=20
Seat 9: mmenz08816 (17220 in chips)=20
inthahole: posts the ante 85
mks24: posts the ante 85
eliozica: posts the ante 85
datuxguy: posts the ante 85
JJin91: posts the ante 85
JRoop029: posts the ante 85
Exomoon: posts the ante 85
mmenz08816: posts the ante 85
datuxguy: posts small blind 350
JJin91: posts big blind 700
*** HOLE CARDS ***
Dealt to JJin91 [5c Qh]
JRoop029: folds=20
Exomoon: folds=20
mmenz08816: raises 700 to 1400
inthahole: calls 1400
mks24: folds=20
eliozica: folds=20
datuxguy: folds=20
JJin91: calls 700
*** FLOP *** [6c 9s Qc]
JJin91: checks=20
mmenz08816: bets 2092
inthahole: folds=20
JJin91: calls 2092
*** TURN *** [6c 9s Qc] [8c]
JJin91: checks=20
mmenz08816: bets 3500
JJin91: calls 3500
*** RIVER *** [6c 9s Qc 8c] [9h]
JJin91: checks=20
mmenz08816: bets 10143 and is all-in
JJin91: folds=20
Uncalled bet (10143) returned to mmenz08816
mmenz08816 collected 16414 from pot
mmenz08816: doesn't show hand=20
*** SUMMARY ***
Total pot 16414 | Rake 0=20
Board [6c 9s Qc 8c 9h]
Seat 1: inthahole folded on the Flop
Seat 2: mks24 folded before Flop (didn't bet)
Seat 3: eliozica (button) folded before Flop (didn't bet)
Seat 4: datuxguy (small blind) folded before Flop
Seat 5: JJin91 (big blind) folded on the River
Seat 6: JRoop029 folded before Flop (didn't bet)
Seat 8: Exomoon folded before Flop (didn't bet)
Seat 9: mmenz08816 collected (16414)


*********** # 58 **************
PokerStars Hand #175435307089: Tournament #1701793956, $18.20+$1.80 USD=
 Hold'em No Limit - Level XIII (350/700) - 2017/09/23 21:17:10 ET
Table '1701793956 2' 9-max Seat #4 is the button
Seat 1: inthahole (16775 in chips)=20
Seat 2: mks24 (12741 in chips)=20
Seat 3: eliozica (24253 in chips)=20
Seat 4: datuxguy (4846 in chips)=20
Seat 5: JJin91 (16078 in chips)=20
Seat 6: JRoop029 (5630 in chips)=20
Seat 7: Scooby-D0O (93507 in chips)=20
Seat 8: Exomoon (27123 in chips)=20
Seat 9: mmenz08816 (26557 in chips)=20
inthahole: posts the ante 85
mks24: posts the ante 85
eliozica: posts the ante 85
datuxguy: posts the ante 85
JJin91: posts the ante 85
JRoop029: posts the ante 85
Scooby-D0O: posts the ante 85
Exomoon: posts the ante 85
mmenz08816: posts the ante 85
JJin91: posts small blind 350
JRoop029: posts big blind 700
*** HOLE CARDS ***
Dealt to JJin91 [5h 8s]
Scooby-D0O: folds=20
Exomoon: raises 700 to 1400
mmenz08816: folds=20
inthahole: folds=20
mks24: folds=20
eliozica: folds=20
datuxguy: folds=20
JJin91: folds=20
JRoop029: folds=20
Uncalled bet (700) returned to Exomoon
Exomoon collected 2515 from pot
Exomoon: doesn't show hand=20
*** SUMMARY ***
Total pot 2515 | Rake 0=20
Seat 1: inthahole folded before Flop (didn't bet)
Seat 2: mks24 folded before Flop (didn't bet)
Seat 3: eliozica folded before Flop (didn't bet)
Seat 4: datuxguy (button) folded before Flop (didn't bet)
Seat 5: JJin91 (small blind) folded before Flop
Seat 6: JRoop029 (big blind) folded before Flop
Seat 7: Scooby-D0O folded before Flop (didn't bet)
Seat 8: Exomoon collected (2515)
Seat 9: mmenz08816 folded before Flop (didn't bet)


*********** # 59 **************
PokerStars Hand #175435307204: Tournament #1701793956, $18.20+$1.80 USD=
 Hold'em No Limit - Level XIII (350/700) - 2017/09/23 21:17:36 ET
Table '1701793956 2' 9-max Seat #5 is the button
Seat 1: inthahole (16690 in chips)=20
Seat 2: mks24 (12656 in chips)=20
Seat 3: eliozica (24168 in chips)=20
Seat 4: datuxguy (4761 in chips)=20
Seat 5: JJin91 (15643 in chips)=20
Seat 6: JRoop029 (4845 in chips)=20
Seat 7: Scooby-D0O (93422 in chips)=20
Seat 8: Exomoon (28853 in chips)=20
Seat 9: mmenz08816 (26472 in chips)=20
inthahole: posts the ante 85
mks24: posts the ante 85
eliozica: posts the ante 85
datuxguy: posts the ante 85
JJin91: posts the ante 85
JRoop029: posts the ante 85
Scooby-D0O: posts the ante 85
Exomoon: posts the ante 85
mmenz08816: posts the ante 85
JRoop029: posts small blind 350
Scooby-D0O: posts big blind 700
*** HOLE CARDS ***
Dealt to JJin91 [Th 6h]
Exomoon: raises 700 to 1400
mmenz08816: folds=20
inthahole: folds=20
mks24: folds=20
eliozica: folds=20
datuxguy: folds=20
JJin91: folds=20
JRoop029: folds=20
Scooby-D0O: calls 700
*** FLOP *** [9h Ah 4d]
Scooby-D0O: checks=20
Exomoon: bets 1958
Scooby-D0O: folds=20
Uncalled bet (1958) returned to Exomoon
Exomoon collected 3915 from pot
Exomoon: doesn't show hand=20
*** SUMMARY ***
Total pot 3915 | Rake 0=20
Board [9h Ah 4d]
Seat 1: inthahole folded before Flop (didn't bet)
Seat 2: mks24 folded before Flop (didn't bet)
Seat 3: eliozica folded before Flop (didn't bet)
Seat 4: datuxguy folded before Flop (didn't bet)
Seat 5: JJin91 (button) folded before Flop (didn't bet)
Seat 6: JRoop029 (small blind) folded before Flop
Seat 7: Scooby-D0O (big blind) folded on the Flop
Seat 8: Exomoon collected (3915)
Seat 9: mmenz08816 folded before Flop (didn't bet)


*********** # 60 **************
PokerStars Hand #175435307313: Tournament #1701793956, $18.20+$1.80 USD=
 Hold'em No Limit - Level XIII (350/700) - 2017/09/23 21:18:04 ET
Table '1701793956 2' 9-max Seat #6 is the button
Seat 1: inthahole (16605 in chips)=20
Seat 2: mks24 (12571 in chips)=20
Seat 3: eliozica (24083 in chips)=20
Seat 4: datuxguy (4676 in chips)=20
Seat 5: JJin91 (15558 in chips)=20
Seat 6: JRoop029 (4410 in chips)=20
Seat 7: Scooby-D0O (91937 in chips)=20
Seat 8: Exomoon (31283 in chips)=20
Seat 9: mmenz08816 (26387 in chips)=20
inthahole: posts the ante 85
mks24: posts the ante 85
eliozica: posts the ante 85
datuxguy: posts the ante 85
JJin91: posts the ante 85
JRoop029: posts the ante 85
Scooby-D0O: posts the ante 85
Exomoon: posts the ante 85
mmenz08816: posts the ante 85
Scooby-D0O: posts small blind 350
Exomoon: posts big blind 700
*** HOLE CARDS ***
Dealt to JJin91 [9c 5d]
mmenz08816: folds=20
inthahole: folds=20
mks24: folds=20
eliozica: folds=20
datuxguy: raises 3891 to 4591 and is all-in
JJin91: folds=20
JRoop029: folds=20
Scooby-D0O: folds=20
Exomoon: folds=20
Uncalled bet (3891) returned to datuxguy
datuxguy collected 2515 from pot
*** SUMMARY ***
Total pot 2515 | Rake 0=20
Seat 1: inthahole folded before Flop (didn't bet)
Seat 2: mks24 folded before Flop (didn't bet)
Seat 3: eliozica folded before Flop (didn't bet)
Seat 4: datuxguy collected (2515)
Seat 5: JJin91 folded before Flop (didn't bet)
Seat 6: JRoop029 (button) folded before Flop (didn't bet)
Seat 7: Scooby-D0O (small blind) folded before Flop
Seat 8: Exomoon (big blind) folded before Flop
Seat 9: mmenz08816 folded before Flop (didn't bet)


*********** # 61 **************
PokerStars Hand #175435307486: Tournament #1701793956, $18.20+$1.80 USD=
 Hold'em No Limit - Level XIII (350/700) - 2017/09/23 21:18:46 ET
Table '1701793956 2' 9-max Seat #7 is the button
Seat 1: inthahole (16520 in chips)=20
Seat 2: mks24 (12486 in chips)=20
Seat 3: eliozica (23998 in chips)=20
Seat 4: datuxguy (6406 in chips)=20
Seat 5: JJin91 (15473 in chips)=20
Seat 6: JRoop029 (4325 in chips)=20
Seat 7: Scooby-D0O (91502 in chips)=20
Seat 8: Exomoon (30498 in chips)=20
Seat 9: mmenz08816 (26302 in chips)=20
inthahole: posts the ante 85
mks24: posts the ante 85
eliozica: posts the ante 85
datuxguy: posts the ante 85
JJin91: posts the ante 85
JRoop029: posts the ante 85
Scooby-D0O: posts the ante 85
Exomoon: posts the ante 85
mmenz08816: posts the ante 85
Exomoon: posts small blind 350
mmenz08816: posts big blind 700
*** HOLE CARDS ***
Dealt to JJin91 [2h 9c]
inthahole: folds=20
mks24: folds=20
eliozica: folds=20
datuxguy: raises 5621 to 6321 and is all-in
JJin91: folds=20
JRoop029: folds=20
Scooby-D0O: folds=20
Exomoon: folds=20
mmenz08816: calls 5621
*** FLOP *** [As 6s 8s]
*** TURN *** [As 6s 8s] [8c]
*** RIVER *** [As 6s 8s 8c] [5c]
*** SHOW DOWN ***
mmenz08816: shows [3d 3s] (two pair, Eights and Threes)
datuxguy: shows [Ac 7c] (two pair, Aces and Eights)
datuxguy collected 13757 from pot
*** SUMMARY ***
Total pot 13757 | Rake 0=20
Board [As 6s 8s 8c 5c]
Seat 1: inthahole folded before Flop (didn't bet)
Seat 2: mks24 folded before Flop (didn't bet)
Seat 3: eliozica folded before Flop (didn't bet)
Seat 4: datuxguy showed [Ac 7c] and won (13757) with two pair, Aces and=
 Eights
Seat 5: JJin91 folded before Flop (didn't bet)
Seat 6: JRoop029 folded before Flop (didn't bet)
Seat 7: Scooby-D0O (button) folded before Flop (didn't bet)
Seat 8: Exomoon (small blind) folded before Flop
Seat 9: mmenz08816 (big blind) showed [3d 3s] and lost with two pair, E=
ights and Threes


*********** # 62 **************
PokerStars Hand #175435307589: Tournament #1701793956, $18.20+$1.80 USD=
 Hold'em No Limit - Level XIII (350/700) - 2017/09/23 21:19:10 ET
Table '1701793956 2' 9-max Seat #8 is the button
Seat 1: inthahole (16435 in chips)=20
Seat 2: mks24 (12401 in chips)=20
Seat 3: eliozica (23913 in chips)=20
Seat 4: datuxguy (13757 in chips)=20
Seat 5: JJin91 (15388 in chips)=20
Seat 6: JRoop029 (4240 in chips)=20
Seat 7: Scooby-D0O (91417 in chips)=20
Seat 8: Exomoon (30063 in chips)=20
Seat 9: mmenz08816 (19896 in chips)=20
inthahole: posts the ante 85
mks24: posts the ante 85
eliozica: posts the ante 85
datuxguy: posts the ante 85
JJin91: posts the ante 85
JRoop029: posts the ante 85
Scooby-D0O: posts the ante 85
Exomoon: posts the ante 85
mmenz08816: posts the ante 85
mmenz08816: posts small blind 350
inthahole: posts big blind 700
*** HOLE CARDS ***
Dealt to JJin91 [Ts Td]
mks24: folds=20
eliozica: folds=20
datuxguy: folds=20
JJin91: raises 819 to 1519
JRoop029: folds=20
datuxguy said, "3s what a joker"
Scooby-D0O: folds=20
Exomoon has timed out
Exomoon: folds=20
Exomoon is sitting out
mmenz08816: folds=20
inthahole: raises 14831 to 16350 and is all-in
JJin91: calls 13784 and is all-in
Uncalled bet (1047) returned to inthahole
*** FLOP *** [Jh 6h 4s]
*** TURN *** [Jh 6h 4s] [6s]
*** RIVER *** [Jh 6h 4s 6s] [3s]
*** SHOW DOWN ***
inthahole: shows [As 9d] (a pair of Sixes)
JJin91: shows [Ts Td] (two pair, Tens and Sixes)
JJin91 collected 31721 from pot
*** SUMMARY ***
Total pot 31721 | Rake 0=20
Board [Jh 6h 4s 6s 3s]
Seat 1: inthahole (big blind) showed [As 9d] and lost with a pair of Si=
xes
Seat 2: mks24 folded before Flop (didn't bet)
Seat 3: eliozica folded before Flop (didn't bet)
Seat 4: datuxguy folded before Flop (didn't bet)
Seat 5: JJin91 showed [Ts Td] and won (31721) with two pair, Tens and S=
ixes
Seat 6: JRoop029 folded before Flop (didn't bet)
Seat 7: Scooby-D0O folded before Flop (didn't bet)
Seat 8: Exomoon (button) folded before Flop (didn't bet)
Seat 9: mmenz08816 (small blind) folded before Flop


*********** # 63 **************
PokerStars Hand #175435307909: Tournament #1701793956, $18.20+$1.80 USD=
 Hold'em No Limit - Level XIII (350/700) - 2017/09/23 21:20:25 ET
Table '1701793956 2' 9-max Seat #9 is the button
Seat 1: inthahole (1047 in chips)=20
Seat 2: mks24 (12316 in chips)=20
Seat 3: eliozica (23828 in chips)=20
Seat 4: datuxguy (13672 in chips)=20
Seat 5: JJin91 (31721 in chips)=20
Seat 6: JRoop029 (4155 in chips)=20
Seat 7: Scooby-D0O (91332 in chips)=20
Seat 8: Exomoon (29978 in chips) is sitting out
Seat 9: mmenz08816 (19461 in chips)=20
inthahole: posts the ante 85
mks24: posts the ante 85
eliozica: posts the ante 85
datuxguy: posts the ante 85
JJin91: posts the ante 85
JRoop029: posts the ante 85
Scooby-D0O: posts the ante 85
Exomoon: posts the ante 85
mmenz08816: posts the ante 85
inthahole: posts small blind 350
mks24: posts big blind 700
*** HOLE CARDS ***
Dealt to JJin91 [3d 4h]
eliozica: folds=20
Exomoon has returned
datuxguy has timed out
datuxguy: folds=20
datuxguy is sitting out
JJin91: folds=20
datuxguy has returned
JRoop029: raises 3370 to 4070 and is all-in
Scooby-D0O: folds=20
Exomoon: folds=20
mmenz08816: folds=20
inthahole: calls 612 and is all-in
mks24: calls 3370
*** FLOP *** [4c Jh Qc]
*** TURN *** [4c Jh Qc] [2c]
*** RIVER *** [4c Jh Qc 2c] [Td]
*** SHOW DOWN ***
mks24: shows [9s As] (high card Ace)
JRoop029: shows [Qd Ah] (a pair of Queens)
JRoop029 collected 6216 from side pot
inthahole: shows [9d 6s] (high card Queen)
JRoop029 collected 3651 from main pot
inthahole finished the tournament in 44th place
*** SUMMARY ***
Total pot 9867 Main pot 3651. Side pot 6216. | Rake 0=20
Board [4c Jh Qc 2c Td]
Seat 1: inthahole (small blind) showed [9d 6s] and lost with high card =
Queen
Seat 2: mks24 (big blind) showed [9s As] and lost with high card Ace
Seat 3: eliozica folded before Flop (didn't bet)
Seat 4: datuxguy folded before Flop (didn't bet)
Seat 5: JJin91 folded before Flop (didn't bet)
Seat 6: JRoop029 showed [Qd Ah] and won (9867) with a pair of Queens
Seat 7: Scooby-D0O folded before Flop (didn't bet)
Seat 8: Exomoon folded before Flop (didn't bet)
Seat 9: mmenz08816 (button) folded before Flop (didn't bet)


*********** # 64 **************
PokerStars Hand #175435308085: Tournament #1701793956, $18.20+$1.80 USD=
 Hold'em No Limit - Level XIII (350/700) - 2017/09/23 21:21:11 ET
Table '1701793956 2' 9-max Seat #2 is the button
Seat 2: mks24 (8161 in chips)=20
Seat 3: eliozica (23743 in chips)=20
Seat 4: datuxguy (13587 in chips)=20
Seat 5: JJin91 (31636 in chips)=20
Seat 6: JRoop029 (9867 in chips)=20
Seat 7: Scooby-D0O (91247 in chips)=20
Seat 8: Exomoon (29893 in chips)=20
Seat 9: mmenz08816 (19376 in chips)=20
mks24: posts the ante 85
eliozica: posts the ante 85
datuxguy: posts the ante 85
JJin91: posts the ante 85
JRoop029: posts the ante 85
Scooby-D0O: posts the ante 85
Exomoon: posts the ante 85
mmenz08816: posts the ante 85
eliozica: posts small blind 350
datuxguy: posts big blind 700
*** HOLE CARDS ***
Dealt to JJin91 [9c 9h]
JJin91: raises 819 to 1519
JRoop029: folds=20
Scooby-D0O: folds=20
Exomoon: folds=20
mmenz08816: folds=20
mks24: folds=20
eliozica: folds=20
datuxguy: folds=20
Uncalled bet (819) returned to JJin91
JJin91 collected 2430 from pot
JJin91: doesn't show hand=20
*** SUMMARY ***
Total pot 2430 | Rake 0=20
Seat 2: mks24 (button) folded before Flop (didn't bet)
Seat 3: eliozica (small blind) folded before Flop
Seat 4: datuxguy (big blind) folded before Flop
Seat 5: JJin91 collected (2430)
Seat 6: JRoop029 folded before Flop (didn't bet)
Seat 7: Scooby-D0O folded before Flop (didn't bet)
Seat 8: Exomoon folded before Flop (didn't bet)
Seat 9: mmenz08816 folded before Flop (didn't bet)


*********** # 65 **************
PokerStars Hand #175435308187: Tournament #1701793956, $18.20+$1.80 USD=
 Hold'em No Limit - Level XIII (350/700) - 2017/09/23 21:21:33 ET
Table '1701793956 2' 9-max Seat #3 is the button
Seat 2: mks24 (8076 in chips)=20
Seat 3: eliozica (23308 in chips)=20
Seat 4: datuxguy (12802 in chips)=20
Seat 5: JJin91 (33281 in chips)=20
Seat 6: JRoop029 (9782 in chips)=20
Seat 7: Scooby-D0O (91162 in chips)=20
Seat 8: Exomoon (29808 in chips)=20
Seat 9: mmenz08816 (19291 in chips)=20
mks24: posts the ante 85
eliozica: posts the ante 85
datuxguy: posts the ante 85
JJin91: posts the ante 85
JRoop029: posts the ante 85
Scooby-D0O: posts the ante 85
Exomoon: posts the ante 85
mmenz08816: posts the ante 85
datuxguy: posts small blind 350
JJin91: posts big blind 700
*** HOLE CARDS ***
Dealt to JJin91 [7s Ad]
JRoop029: folds=20
Scooby-D0O: folds=20
Exomoon: calls 700
mmenz08816: folds=20
mks24: folds=20
eliozica: folds=20
datuxguy: folds=20
JJin91: checks=20
*** FLOP *** [Ks 8d 5h]
JJin91: checks=20
Exomoon: checks=20
*** TURN *** [Ks 8d 5h] [Jd]
JJin91: bets 1103
Exomoon: calls 1103
*** RIVER *** [Ks 8d 5h Jd] [Qh]
JJin91: checks=20
Exomoon: checks=20
*** SHOW DOWN ***
JJin91: shows [7s Ad] (high card Ace)
Exomoon: shows [2s 2h] (a pair of Deuces)
Exomoon collected 4636 from pot
*** SUMMARY ***
Total pot 4636 | Rake 0=20
Board [Ks 8d 5h Jd Qh]
Seat 2: mks24 folded before Flop (didn't bet)
Seat 3: eliozica (button) folded before Flop (didn't bet)
Seat 4: datuxguy (small blind) folded before Flop
Seat 5: JJin91 (big blind) showed [7s Ad] and lost with high card Ace
Seat 6: JRoop029 folded before Flop (didn't bet)
Seat 7: Scooby-D0O folded before Flop (didn't bet)
Seat 8: Exomoon showed [2s 2h] and won (4636) with a pair of Deuces
Seat 9: mmenz08816 folded before Flop (didn't bet)


*********** # 66 **************
PokerStars Hand #175435308515: Tournament #1701793956, $18.20+$1.80 USD=
 Hold'em No Limit - Level XIV (400/800) - 2017/09/23 21:22:46 ET
Table '1701793956 2' 9-max Seat #4 is the button
Seat 2: mks24 (7991 in chips)=20
Seat 3: eliozica (23223 in chips)=20
Seat 4: datuxguy (12367 in chips)=20
Seat 5: JJin91 (31393 in chips)=20
Seat 6: JRoop029 (9697 in chips)=20
Seat 7: Scooby-D0O (91077 in chips)=20
Seat 8: Exomoon (32556 in chips)=20
Seat 9: mmenz08816 (19206 in chips)=20
mks24: posts the ante 100
eliozica: posts the ante 100
datuxguy: posts the ante 100
JJin91: posts the ante 100
JRoop029: posts the ante 100
Scooby-D0O: posts the ante 100
Exomoon: posts the ante 100
mmenz08816: posts the ante 100
JJin91: posts small blind 400
JRoop029: posts big blind 800
*** HOLE CARDS ***
Dealt to JJin91 [Js Ts]
Scooby-D0O: folds=20
Exomoon: folds=20
mmenz08816: folds=20
mks24: raises 7091 to 7891 and is all-in
eliozica: folds=20
datuxguy: folds=20
JJin91: folds=20
JRoop029: folds=20
Uncalled bet (7091) returned to mks24
mks24 collected 2800 from pot
mks24: doesn't show hand=20
*** SUMMARY ***
Total pot 2800 | Rake 0=20
Seat 2: mks24 collected (2800)
Seat 3: eliozica folded before Flop (didn't bet)
Seat 4: datuxguy (button) folded before Flop (didn't bet)
Seat 5: JJin91 (small blind) folded before Flop
Seat 6: JRoop029 (big blind) folded before Flop
Seat 7: Scooby-D0O folded before Flop (didn't bet)
Seat 8: Exomoon folded before Flop (didn't bet)
Seat 9: mmenz08816 folded before Flop (didn't bet)


*********** # 67 **************
PokerStars Hand #175435308660: Tournament #1701793956, $18.20+$1.80 USD=
 Hold'em No Limit - Level XIV (400/800) - 2017/09/23 21:23:20 ET
Table '1701793956 2' 9-max Seat #5 is the button
Seat 2: mks24 (9891 in chips)=20
Seat 3: eliozica (23123 in chips)=20
Seat 4: datuxguy (12267 in chips)=20
Seat 5: JJin91 (30893 in chips)=20
Seat 6: JRoop029 (8797 in chips)=20
Seat 7: Scooby-D0O (90977 in chips)=20
Seat 8: Exomoon (32456 in chips)=20
Seat 9: mmenz08816 (19106 in chips)=20
mks24: posts the ante 100
eliozica: posts the ante 100
datuxguy: posts the ante 100
JJin91: posts the ante 100
JRoop029: posts the ante 100
Scooby-D0O: posts the ante 100
Exomoon: posts the ante 100
mmenz08816: posts the ante 100
JRoop029: posts small blind 400
Scooby-D0O: posts big blind 800
*** HOLE CARDS ***
Dealt to JJin91 [7c Kh]
Exomoon: folds=20
mmenz08816: folds=20
mks24: folds=20
eliozica: folds=20
datuxguy: raises 11367 to 12167 and is all-in
JJin91: folds=20
JRoop029: folds=20
Scooby-D0O: folds=20
Uncalled bet (11367) returned to datuxguy
datuxguy collected 2800 from pot
*** SUMMARY ***
Total pot 2800 | Rake 0=20
Seat 2: mks24 folded before Flop (didn't bet)
Seat 3: eliozica folded before Flop (didn't bet)
Seat 4: datuxguy collected (2800)
Seat 5: JJin91 (button) folded before Flop (didn't bet)
Seat 6: JRoop029 (small blind) folded before Flop
Seat 7: Scooby-D0O (big blind) folded before Flop
Seat 8: Exomoon folded before Flop (didn't bet)
Seat 9: mmenz08816 folded before Flop (didn't bet)


*********** # 68 **************
PokerStars Hand #175435308753: Tournament #1701793956, $18.20+$1.80 USD=
 Hold'em No Limit - Level XIV (400/800) - 2017/09/23 21:23:41 ET
Table '1701793956 2' 9-max Seat #6 is the button
Seat 2: mks24 (9791 in chips)=20
Seat 3: eliozica (23023 in chips)=20
Seat 4: datuxguy (14167 in chips)=20
Seat 5: JJin91 (30793 in chips)=20
Seat 6: JRoop029 (8297 in chips)=20
Seat 7: Scooby-D0O (90077 in chips)=20
Seat 8: Exomoon (32356 in chips)=20
Seat 9: mmenz08816 (19006 in chips)=20
mks24: posts the ante 100
eliozica: posts the ante 100
datuxguy: posts the ante 100
JJin91: posts the ante 100
JRoop029: posts the ante 100
Scooby-D0O: posts the ante 100
Exomoon: posts the ante 100
mmenz08816: posts the ante 100
Scooby-D0O: posts small blind 400
Exomoon: posts big blind 800
*** HOLE CARDS ***
Dealt to JJin91 [5h Ad]
mmenz08816: folds=20
mks24: folds=20
eliozica: folds=20
datuxguy: folds=20
JJin91: raises 936 to 1736
JRoop029: folds=20
Scooby-D0O: folds=20
Exomoon: folds=20
Uncalled bet (936) returned to JJin91
JJin91 collected 2800 from pot
JJin91: doesn't show hand=20
*** SUMMARY ***
Total pot 2800 | Rake 0=20
Seat 2: mks24 folded before Flop (didn't bet)
Seat 3: eliozica folded before Flop (didn't bet)
Seat 4: datuxguy folded before Flop (didn't bet)
Seat 5: JJin91 collected (2800)
Seat 6: JRoop029 (button) folded before Flop (didn't bet)
Seat 7: Scooby-D0O (small blind) folded before Flop
Seat 8: Exomoon (big blind) folded before Flop
Seat 9: mmenz08816 folded before Flop (didn't bet)


*********** # 69 **************
PokerStars Hand #175435308864: Tournament #1701793956, $18.20+$1.80 USD=
 Hold'em No Limit - Level XIV (400/800) - 2017/09/23 21:24:11 ET
Table '1701793956 2' 9-max Seat #7 is the button
Seat 2: mks24 (9691 in chips)=20
Seat 3: eliozica (22923 in chips)=20
Seat 4: datuxguy (14067 in chips)=20
Seat 5: JJin91 (32693 in chips)=20
Seat 6: JRoop029 (8197 in chips)=20
Seat 7: Scooby-D0O (89577 in chips)=20
Seat 8: Exomoon (31456 in chips)=20
Seat 9: mmenz08816 (18906 in chips)=20
mks24: posts the ante 100
eliozica: posts the ante 100
datuxguy: posts the ante 100
JJin91: posts the ante 100
JRoop029: posts the ante 100
Scooby-D0O: posts the ante 100
Exomoon: posts the ante 100
mmenz08816: posts the ante 100
Exomoon: posts small blind 400
mmenz08816: posts big blind 800
*** HOLE CARDS ***
Dealt to JJin91 [2c Qc]
mks24: folds=20
eliozica: folds=20
datuxguy: folds=20
JJin91: folds=20
JRoop029: folds=20
Scooby-D0O: raises 960 to 1760
Exomoon: folds=20
mmenz08816: folds=20
Uncalled bet (960) returned to Scooby-D0O
Scooby-D0O collected 2800 from pot
*** SUMMARY ***
Total pot 2800 | Rake 0=20
Seat 2: mks24 folded before Flop (didn't bet)
Seat 3: eliozica folded before Flop (didn't bet)
Seat 4: datuxguy folded before Flop (didn't bet)
Seat 5: JJin91 folded before Flop (didn't bet)
Seat 6: JRoop029 folded before Flop (didn't bet)
Seat 7: Scooby-D0O (button) collected (2800)
Seat 8: Exomoon (small blind) folded before Flop
Seat 9: mmenz08816 (big blind) folded before Flop


*********** # 70 **************
PokerStars Hand #175435308991: Tournament #1701793956, $18.20+$1.80 USD=
 Hold'em No Limit - Level XIV (400/800) - 2017/09/23 21:24:40 ET
Table '1701793956 2' 9-max Seat #8 is the button
Seat 2: mks24 (9591 in chips)=20
Seat 3: eliozica (22823 in chips)=20
Seat 4: datuxguy (13967 in chips)=20
Seat 5: JJin91 (32593 in chips)=20
Seat 6: JRoop029 (8097 in chips)=20
Seat 7: Scooby-D0O (91477 in chips)=20
Seat 8: Exomoon (30956 in chips)=20
Seat 9: mmenz08816 (18006 in chips)=20
mks24: posts the ante 100
eliozica: posts the ante 100
datuxguy: posts the ante 100
JJin91: posts the ante 100
JRoop029: posts the ante 100
Scooby-D0O: posts the ante 100
Exomoon: posts the ante 100
mmenz08816: posts the ante 100
mmenz08816: posts small blind 400
mks24: posts big blind 800
*** HOLE CARDS ***
Dealt to JJin91 [Ad Qd]
eliozica: folds=20
datuxguy: folds=20
JJin91: raises 936 to 1736
JRoop029: folds=20
Scooby-D0O: folds=20
Exomoon: calls 1736
mmenz08816: calls 1336
mks24: folds=20
*** FLOP *** [Jc Ac 6d]
mmenz08816: checks=20
JJin91: bets 2519
Exomoon: folds=20
mmenz08816: folds=20
Uncalled bet (2519) returned to JJin91
JJin91 collected 6808 from pot
JJin91: doesn't show hand=20
*** SUMMARY ***
Total pot 6808 | Rake 0=20
Board [Jc Ac 6d]
Seat 2: mks24 (big blind) folded before Flop
Seat 3: eliozica folded before Flop (didn't bet)
Seat 4: datuxguy folded before Flop (didn't bet)
Seat 5: JJin91 collected (6808)
Seat 6: JRoop029 folded before Flop (didn't bet)
Seat 7: Scooby-D0O folded before Flop (didn't bet)
Seat 8: Exomoon (button) folded on the Flop
Seat 9: mmenz08816 (small blind) folded on the Flop


*********** # 71 **************
PokerStars Hand #175435309236: Tournament #1701793956, $18.20+$1.80 USD=
 Hold'em No Limit - Level XIV (400/800) - 2017/09/23 21:25:44 ET
Table '1701793956 2' 9-max Seat #9 is the button
Seat 2: mks24 (8691 in chips)=20
Seat 3: eliozica (22723 in chips)=20
Seat 4: datuxguy (13867 in chips)=20
Seat 5: JJin91 (37565 in chips)=20
Seat 6: JRoop029 (7997 in chips)=20
Seat 7: Scooby-D0O (91377 in chips)=20
Seat 8: Exomoon (29120 in chips)=20
Seat 9: mmenz08816 (16170 in chips)=20
mks24: posts the ante 100
eliozica: posts the ante 100
datuxguy: posts the ante 100
JJin91: posts the ante 100
JRoop029: posts the ante 100
Scooby-D0O: posts the ante 100
Exomoon: posts the ante 100
mmenz08816: posts the ante 100
mks24: posts small blind 400
eliozica: posts big blind 800
*** HOLE CARDS ***
Dealt to JJin91 [6s 9c]
datuxguy: folds=20
JJin91: folds=20
JRoop029: raises 7097 to 7897 and is all-in
Scooby-D0O: folds=20
Exomoon: folds=20
mmenz08816: folds=20
mks24: folds=20
eliozica: calls 7097
*** FLOP *** [5s Ks Ad]
*** TURN *** [5s Ks Ad] [Th]
*** RIVER *** [5s Ks Ad Th] [3d]
*** SHOW DOWN ***
eliozica: shows [Ac 3c] (two pair, Aces and Threes)
JRoop029: shows [Kc Kd] (three of a kind, Kings)
JRoop029 collected 16994 from pot
*** SUMMARY ***
Total pot 16994 | Rake 0=20
Board [5s Ks Ad Th 3d]
Seat 2: mks24 (small blind) folded before Flop
Seat 3: eliozica (big blind) showed [Ac 3c] and lost with two pair, Ace=
s and Threes
Seat 4: datuxguy folded before Flop (didn't bet)
Seat 5: JJin91 folded before Flop (didn't bet)
Seat 6: JRoop029 showed [Kc Kd] and won (16994) with three of a kind, K=
ings
Seat 7: Scooby-D0O folded before Flop (didn't bet)
Seat 8: Exomoon folded before Flop (didn't bet)
Seat 9: mmenz08816 (button) folded before Flop (didn't bet)


*********** # 72 **************
PokerStars Hand #175435309414: Tournament #1701793956, $18.20+$1.80 USD=
 Hold'em No Limit - Level XIV (400/800) - 2017/09/23 21:26:28 ET
Table '1701793956 2' 9-max Seat #2 is the button
Seat 2: mks24 (8191 in chips)=20
Seat 3: eliozica (14726 in chips)=20
Seat 4: datuxguy (13767 in chips)=20
Seat 5: JJin91 (37465 in chips)=20
Seat 6: JRoop029 (16994 in chips)=20
Seat 7: Scooby-D0O (91277 in chips)=20
Seat 8: Exomoon (29020 in chips)=20
Seat 9: mmenz08816 (16070 in chips)=20
mks24: posts the ante 100
eliozica: posts the ante 100
datuxguy: posts the ante 100
JJin91: posts the ante 100
JRoop029: posts the ante 100
Scooby-D0O: posts the ante 100
Exomoon: posts the ante 100
mmenz08816: posts the ante 100
eliozica: posts small blind 400
datuxguy: posts big blind 800
*** HOLE CARDS ***
Dealt to JJin91 [4c 2c]
JJin91: folds=20
JRoop029: raises 800 to 1600
Scooby-D0O: folds=20
Exomoon: calls 1600
mmenz08816: folds=20
mks24: folds=20
eliozica: folds=20
datuxguy: calls 800
*** FLOP *** [Ad Kd 5h]
datuxguy: checks=20
JRoop029: checks=20
Exomoon: bets 6000
datuxguy: folds=20
JRoop029: folds=20
Uncalled bet (6000) returned to Exomoon
Exomoon collected 6000 from pot
Exomoon: doesn't show hand=20
*** SUMMARY ***
Total pot 6000 | Rake 0=20
Board [Ad Kd 5h]
Seat 2: mks24 (button) folded before Flop (didn't bet)
Seat 3: eliozica (small blind) folded before Flop
Seat 4: datuxguy (big blind) folded on the Flop
Seat 5: JJin91 folded before Flop (didn't bet)
Seat 6: JRoop029 folded on the Flop
Seat 7: Scooby-D0O folded before Flop (didn't bet)
Seat 8: Exomoon collected (6000)
Seat 9: mmenz08816 folded before Flop (didn't bet)


*********** # 73 **************
PokerStars Hand #175435309615: Tournament #1701793956, $18.20+$1.80 USD=
 Hold'em No Limit - Level XIV (400/800) - 2017/09/23 21:27:14 ET
Table '1701793956 2' 9-max Seat #3 is the button
Seat 1: WINNER'circl (20992 in chips)=20
Seat 2: mks24 (8091 in chips)=20
Seat 3: eliozica (14226 in chips)=20
Seat 4: datuxguy (12067 in chips)=20
Seat 5: JJin91 (37365 in chips)=20
Seat 6: JRoop029 (15294 in chips)=20
Seat 7: Scooby-D0O (91177 in chips)=20
Seat 8: Exomoon (33320 in chips)=20
Seat 9: mmenz08816 (15970 in chips)=20
WINNER'circl: posts the ante 100
mks24: posts the ante 100
eliozica: posts the ante 100
datuxguy: posts the ante 100
JJin91: posts the ante 100
JRoop029: posts the ante 100
Scooby-D0O: posts the ante 100
Exomoon: posts the ante 100
mmenz08816: posts the ante 100
datuxguy: posts small blind 400
JJin91: posts big blind 800
*** HOLE CARDS ***
Dealt to JJin91 [8c 7s]
JRoop029: folds=20
Scooby-D0O: folds=20
Exomoon: folds=20
mmenz08816: raises 1200 to 2000
WINNER'circl: calls 2000
mks24: folds=20
eliozica: folds=20
datuxguy: folds=20
JJin91: folds=20
*** FLOP *** [2c 2d 2s]
mmenz08816: bets 2400
WINNER'circl: raises 3200 to 5600
mmenz08816: raises 8270 to 13870 and is all-in
WINNER'circl: calls 8270
*** TURN *** [2c 2d 2s] [5d]
*** RIVER *** [2c 2d 2s 5d] [Tc]
*** SHOW DOWN ***
mmenz08816: shows [Jh Js] (a full house, Deuces full of Jacks)
WINNER'circl: shows [8d 8h] (a full house, Deuces full of Eights)
mmenz08816 collected 33840 from pot
*** SUMMARY ***
Total pot 33840 | Rake 0=20
Board [2c 2d 2s 5d Tc]
Seat 1: WINNER'circl showed [8d 8h] and lost with a full house, Deuces =
full of Eights
Seat 2: mks24 folded before Flop (didn't bet)
Seat 3: eliozica (button) folded before Flop (didn't bet)
Seat 4: datuxguy (small blind) folded before Flop
Seat 5: JJin91 (big blind) folded before Flop
Seat 6: JRoop029 folded before Flop (didn't bet)
Seat 7: Scooby-D0O folded before Flop (didn't bet)
Seat 8: Exomoon folded before Flop (didn't bet)
Seat 9: mmenz08816 showed [Jh Js] and won (33840) with a full house, De=
uces full of Jacks


*********** # 74 **************
PokerStars Hand #175435309854: Tournament #1701793956, $18.20+$1.80 USD=
 Hold'em No Limit - Level XIV (400/800) - 2017/09/23 21:28:10 ET
Table '1701793956 2' 9-max Seat #4 is the button
Seat 1: WINNER'circl (5022 in chips)=20
Seat 2: mks24 (7991 in chips)=20
Seat 3: eliozica (14126 in chips)=20
Seat 4: datuxguy (11567 in chips)=20
Seat 5: JJin91 (36465 in chips)=20
Seat 6: JRoop029 (15194 in chips)=20
Seat 7: Scooby-D0O (91077 in chips)=20
Seat 8: Exomoon (33220 in chips)=20
Seat 9: mmenz08816 (33840 in chips)=20
WINNER'circl: posts the ante 100
mks24: posts the ante 100
eliozica: posts the ante 100
datuxguy: posts the ante 100
JJin91: posts the ante 100
JRoop029: posts the ante 100
Scooby-D0O: posts the ante 100
Exomoon: posts the ante 100
mmenz08816: posts the ante 100
JJin91: posts small blind 400
JRoop029: posts big blind 800
*** HOLE CARDS ***
Dealt to JJin91 [Ks 9s]
Scooby-D0O: folds=20
Exomoon: folds=20
mmenz08816: folds=20
WINNER'circl: raises 4122 to 4922 and is all-in
mks24: folds=20
eliozica: raises 4122 to 9044
datuxguy: folds=20
JJin91: folds=20
JRoop029: folds=20
Uncalled bet (4122) returned to eliozica
datuxguy said, "I have 8s I better go all in"
*** FLOP *** [4c 8c Qs]
*** TURN *** [4c 8c Qs] [Jh]
datuxguy said, "donk"
*** RIVER *** [4c 8c Qs Jh] [Kc]
*** SHOW DOWN ***
WINNER'circl: shows [Ah 7d] (high card Ace)
eliozica: shows [5s 5h] (a pair of Fives)
eliozica collected 11944 from pot
WINNER'circl finished the tournament in 36th place
*** SUMMARY ***
Total pot 11944 | Rake 0=20
Board [4c 8c Qs Jh Kc]
Seat 1: WINNER'circl showed [Ah 7d] and lost with high card Ace
Seat 2: mks24 folded before Flop (didn't bet)
Seat 3: eliozica showed [5s 5h] and won (11944) with a pair of Fives
Seat 4: datuxguy (button) folded before Flop (didn't bet)
Seat 5: JJin91 (small blind) folded before Flop
Seat 6: JRoop029 (big blind) folded before Flop
Seat 7: Scooby-D0O folded before Flop (didn't bet)
Seat 8: Exomoon folded before Flop (didn't bet)
Seat 9: mmenz08816 folded before Flop (didn't bet)


*********** # 75 **************
PokerStars Hand #175436222712: Tournament #1701793956, $18.20+$1.80 USD=
 Hold'em No Limit - Level XIV (400/800) - 2017/09/23 21:28:46 ET
Table '1701793956 2' 9-max Seat #5 is the button
Seat 2: mks24 (7891 in chips)=20
Seat 3: eliozica (21048 in chips)=20
Seat 4: datuxguy (11467 in chips)=20
Seat 5: JJin91 (35965 in chips)=20
Seat 6: JRoop029 (14294 in chips)=20
Seat 7: Scooby-D0O (90977 in chips)=20
Seat 8: Exomoon (33120 in chips)=20
Seat 9: mmenz08816 (33740 in chips)=20
mks24: posts the ante 100
eliozica: posts the ante 100
datuxguy: posts the ante 100
JJin91: posts the ante 100
JRoop029: posts the ante 100
Scooby-D0O: posts the ante 100
Exomoon: posts the ante 100
mmenz08816: posts the ante 100
JRoop029: posts small blind 400
Scooby-D0O: posts big blind 800
*** HOLE CARDS ***
Dealt to JJin91 [Kh Qh]
Exomoon: folds=20
mmenz08816: folds=20
mks24: calls 800
eliozica: folds=20
datuxguy: calls 800
JJin91: calls 800
JRoop029: calls 400
Scooby-D0O: checks=20
*** FLOP *** [5s 5c Qd]
JRoop029: bets 800
Scooby-D0O: folds=20
mks24: folds=20
datuxguy: folds=20
JJin91: raises 6400 to 7200
JRoop029: folds=20
Uncalled bet (6400) returned to JJin91
JJin91 collected 6400 from pot
JJin91: doesn't show hand=20
*** SUMMARY ***
Total pot 6400 | Rake 0=20
Board [5s 5c Qd]
Seat 2: mks24 folded on the Flop
Seat 3: eliozica folded before Flop (didn't bet)
Seat 4: datuxguy folded on the Flop
Seat 5: JJin91 (button) collected (6400)
Seat 6: JRoop029 (small blind) folded on the Flop
Seat 7: Scooby-D0O (big blind) folded on the Flop
Seat 8: Exomoon folded before Flop (didn't bet)
Seat 9: mmenz08816 folded before Flop (didn't bet)


*********** # 76 **************
PokerStars Hand #175436222957: Tournament #1701793956, $18.20+$1.80 USD=
 Hold'em No Limit - Level XIV (400/800) - 2017/09/23 21:29:48 ET
Table '1701793956 2' 9-max Seat #6 is the button
Seat 2: mks24 (6991 in chips)=20
Seat 3: eliozica (20948 in chips)=20
Seat 4: datuxguy (10567 in chips)=20
Seat 5: JJin91 (40665 in chips)=20
Seat 6: JRoop029 (12594 in chips)=20
Seat 7: Scooby-D0O (90077 in chips)=20
Seat 8: Exomoon (33020 in chips)=20
Seat 9: mmenz08816 (33640 in chips)=20
mks24: posts the ante 100
eliozica: posts the ante 100
datuxguy: posts the ante 100
JJin91: posts the ante 100
JRoop029: posts the ante 100
Scooby-D0O: posts the ante 100
Exomoon: posts the ante 100
mmenz08816: posts the ante 100
Scooby-D0O: posts small blind 400
Exomoon: posts big blind 800
*** HOLE CARDS ***
Dealt to JJin91 [5c 4d]
datuxguy said, "smells like a slopstars 5"
mmenz08816: raises 800 to 1600
mks24: folds=20
eliozica: folds=20
datuxguy: folds=20
JJin91: folds=20
JRoop029: folds=20
Scooby-D0O: folds=20
Exomoon: calls 800
*** FLOP *** [8s Qh 7d]
Exomoon: checks=20
mmenz08816: bets 1760
Exomoon: folds=20
Uncalled bet (1760) returned to mmenz08816
mmenz08816 collected 4400 from pot
mmenz08816: doesn't show hand=20
*** SUMMARY ***
Total pot 4400 | Rake 0=20
Board [8s Qh 7d]
Seat 2: mks24 folded before Flop (didn't bet)
Seat 3: eliozica folded before Flop (didn't bet)
Seat 4: datuxguy folded before Flop (didn't bet)
Seat 5: JJin91 folded before Flop (didn't bet)
Seat 6: JRoop029 (button) folded before Flop (didn't bet)
Seat 7: Scooby-D0O (small blind) folded before Flop
Seat 8: Exomoon (big blind) folded on the Flop
Seat 9: mmenz08816 collected (4400)


*********** # 77 **************
PokerStars Hand #175436223151: Tournament #1701793956, $18.20+$1.80 USD=
 Hold'em No Limit - Level XIV (400/800) - 2017/09/23 21:30:31 ET
Table '1701793956 2' 9-max Seat #7 is the button
Seat 2: mks24 (6891 in chips)=20
Seat 3: eliozica (20848 in chips)=20
Seat 4: datuxguy (10467 in chips)=20
Seat 5: JJin91 (40565 in chips)=20
Seat 6: JRoop029 (12494 in chips)=20
Seat 7: Scooby-D0O (89577 in chips)=20
Seat 8: Exomoon (31320 in chips)=20
Seat 9: mmenz08816 (36340 in chips)=20
mks24: posts the ante 100
eliozica: posts the ante 100
datuxguy: posts the ante 100
JJin91: posts the ante 100
JRoop029: posts the ante 100
Scooby-D0O: posts the ante 100
Exomoon: posts the ante 100
mmenz08816: posts the ante 100
Exomoon: posts small blind 400
mmenz08816: posts big blind 800
*** HOLE CARDS ***
Dealt to JJin91 [Ks Qs]
mks24: folds=20
eliozica: folds=20
datuxguy: folds=20
JJin91: raises 936 to 1736
JRoop029: folds=20
Scooby-D0O: raises 2264 to 4000
Exomoon: folds=20
mmenz08816: folds=20
JJin91: calls 2264
*** FLOP *** [Js 7c Ad]
mmenz08816 is sitting out
JJin91: checks=20
Scooby-D0O: bets 3000
JJin91: folds=20
Uncalled bet (3000) returned to Scooby-D0O
Scooby-D0O collected 10000 from pot
*** SUMMARY ***
Total pot 10000 | Rake 0=20
Board [Js 7c Ad]
Seat 2: mks24 folded before Flop (didn't bet)
Seat 3: eliozica folded before Flop (didn't bet)
Seat 4: datuxguy folded before Flop (didn't bet)
Seat 5: JJin91 folded on the Flop
Seat 6: JRoop029 folded before Flop (didn't bet)
Seat 7: Scooby-D0O (button) collected (10000)
Seat 8: Exomoon (small blind) folded before Flop
Seat 9: mmenz08816 (big blind) folded before Flop


*********** # 78 **************
PokerStars Hand #175436223392: Tournament #1701793956, $18.20+$1.80 USD=
 Hold'em No Limit - Level XIV (400/800) - 2017/09/23 21:31:29 ET
Table '1701793956 2' 9-max Seat #8 is the button
Seat 2: mks24 (6791 in chips)=20
Seat 3: eliozica (20748 in chips)=20
Seat 4: datuxguy (10367 in chips)=20
Seat 5: JJin91 (36465 in chips)=20
Seat 6: JRoop029 (12394 in chips)=20
Seat 7: Scooby-D0O (95477 in chips)=20
Seat 8: Exomoon (30820 in chips)=20
Seat 9: mmenz08816 (35440 in chips) is sitting out
mks24: posts the ante 100
eliozica: posts the ante 100
datuxguy: posts the ante 100
JJin91: posts the ante 100
JRoop029: posts the ante 100
Scooby-D0O: posts the ante 100
Exomoon: posts the ante 100
mmenz08816: posts the ante 100
mmenz08816: posts small blind 400
mks24: posts big blind 800
*** HOLE CARDS ***
Dealt to JJin91 [9c Qc]
eliozica: raises 1600 to 2400
datuxguy: folds=20
JJin91: folds=20
JRoop029: raises 9894 to 12294 and is all-in
Scooby-D0O: folds=20
Exomoon: folds=20
mmenz08816: folds=20
mks24: folds=20
eliozica: calls 9894
*** FLOP *** [3c Kh Kd]
*** TURN *** [3c Kh Kd] [7c]
*** RIVER *** [3c Kh Kd 7c] [4c]
*** SHOW DOWN ***
eliozica: shows [Ad Qd] (a pair of Kings)
JRoop029: shows [Ts Tc] (two pair, Kings and Tens)
JRoop029 collected 26588 from pot
*** SUMMARY ***
Total pot 26588 | Rake 0=20
Board [3c Kh Kd 7c 4c]
Seat 2: mks24 (big blind) folded before Flop
Seat 3: eliozica showed [Ad Qd] and lost with a pair of Kings
Seat 4: datuxguy folded before Flop (didn't bet)
Seat 5: JJin91 folded before Flop (didn't bet)
Seat 6: JRoop029 showed [Ts Tc] and won (26588) with two pair, Kings an=
d Tens
Seat 7: Scooby-D0O folded before Flop (didn't bet)
Seat 8: Exomoon (button) folded before Flop (didn't bet)
Seat 9: mmenz08816 (small blind) folded before Flop


*********** # 79 **************
PokerStars Hand #175436223561: Tournament #1701793956, $18.20+$1.80 USD=
 Hold'em No Limit - Level XIV (400/800) - 2017/09/23 21:32:08 ET
Table '1701793956 2' 9-max Seat #9 is the button
Seat 2: mks24 (5891 in chips)=20
Seat 3: eliozica (8354 in chips)=20
Seat 4: datuxguy (10267 in chips)=20
Seat 5: JJin91 (36365 in chips)=20
Seat 6: JRoop029 (26588 in chips)=20
Seat 7: Scooby-D0O (95377 in chips)=20
Seat 8: Exomoon (30720 in chips)=20
Seat 9: mmenz08816 (34940 in chips) is sitting out
mks24: posts the ante 100
eliozica: posts the ante 100
datuxguy: posts the ante 100
JJin91: posts the ante 100
JRoop029: posts the ante 100
Scooby-D0O: posts the ante 100
Exomoon: posts the ante 100
mmenz08816: posts the ante 100
mks24: posts small blind 400
eliozica: posts big blind 800
*** HOLE CARDS ***
Dealt to JJin91 [7d Kh]
datuxguy: folds=20
JJin91: folds=20
JRoop029: folds=20
Scooby-D0O: folds=20
Exomoon: folds=20
mmenz08816: folds=20
mks24: raises 4991 to 5791 and is all-in
eliozica: calls 4991
*** FLOP *** [Th 6h 8c]
*** TURN *** [Th 6h 8c] [Kd]
*** RIVER *** [Th 6h 8c Kd] [9s]
*** SHOW DOWN ***
mks24: shows [Ah Qs] (high card Ace)
eliozica: shows [5c Qd] (high card King)
mks24 collected 12382 from pot
*** SUMMARY ***
Total pot 12382 | Rake 0=20
Board [Th 6h 8c Kd 9s]
Seat 2: mks24 (small blind) showed [Ah Qs] and won (12382) with high ca=
rd Ace
Seat 3: eliozica (big blind) showed [5c Qd] and lost with high card King
Seat 4: datuxguy folded before Flop (didn't bet)
Seat 5: JJin91 folded before Flop (didn't bet)
Seat 6: JRoop029 folded before Flop (didn't bet)
Seat 7: Scooby-D0O folded before Flop (didn't bet)
Seat 8: Exomoon folded before Flop (didn't bet)
Seat 9: mmenz08816 (button) folded before Flop (didn't bet)


*********** # 80 **************
PokerStars Hand #175436223753: Tournament #1701793956, $18.20+$1.80 USD=
 Hold'em No Limit - Level XV (500/1000) - 2017/09/23 21:32:53 ET
Table '1701793956 2' 9-max Seat #2 is the button
Seat 2: mks24 (12382 in chips)=20
Seat 3: eliozica (2463 in chips)=20
Seat 4: datuxguy (10167 in chips)=20
Seat 5: JJin91 (36265 in chips)=20
Seat 6: JRoop029 (26488 in chips)=20
Seat 7: Scooby-D0O (95277 in chips)=20
Seat 8: Exomoon (30620 in chips)=20
Seat 9: mmenz08816 (34840 in chips) is sitting out
mks24: posts the ante 125
eliozica: posts the ante 125
datuxguy: posts the ante 125
JJin91: posts the ante 125
JRoop029: posts the ante 125
Scooby-D0O: posts the ante 125
Exomoon: posts the ante 125
mmenz08816: posts the ante 125
eliozica: posts small blind 500
datuxguy: posts big blind 1000
*** HOLE CARDS ***
Dealt to JJin91 [Kh 6c]
JJin91: folds=20
JRoop029: raises 2000 to 3000
Scooby-D0O: folds=20
Exomoon: calls 3000
mmenz08816: folds=20
mks24: folds=20
eliozica: folds=20
datuxguy: calls 2000
*** FLOP *** [4d Jh 6s]
datuxguy: bets 7042 and is all-in
JRoop029: folds=20
Exomoon: calls 7042
*** TURN *** [4d Jh 6s] [5s]
*** RIVER *** [4d Jh 6s 5s] [5h]
*** SHOW DOWN ***
datuxguy: shows [6h As] (two pair, Sixes and Fives)
Exomoon: shows [Jc Kd] (two pair, Jacks and Fives)
Exomoon collected 24584 from pot
datuxguy finished the tournament in 33rd place
*** SUMMARY ***
Total pot 24584 | Rake 0=20
Board [4d Jh 6s 5s 5h]
Seat 2: mks24 (button) folded before Flop (didn't bet)
Seat 3: eliozica (small blind) folded before Flop
Seat 4: datuxguy (big blind) showed [6h As] and lost with two pair, Six=
es and Fives
Seat 5: JJin91 folded before Flop (didn't bet)
Seat 6: JRoop029 folded on the Flop
Seat 7: Scooby-D0O folded before Flop (didn't bet)
Seat 8: Exomoon showed [Jc Kd] and won (24584) with two pair, Jacks and=
 Fives
Seat 9: mmenz08816 folded before Flop (didn't bet)


*********** # 81 **************
PokerStars Hand #175436223907: Tournament #1701793956, $18.20+$1.80 USD=
 Hold'em No Limit - Level XV (500/1000) - 2017/09/23 21:33:31 ET
Table '1701793956 2' 9-max Seat #3 is the button
Seat 2: mks24 (12257 in chips)=20
Seat 3: eliozica (1838 in chips)=20
Seat 5: JJin91 (36140 in chips)=20
Seat 6: JRoop029 (23363 in chips)=20
Seat 7: Scooby-D0O (95152 in chips)=20
Seat 8: Exomoon (45037 in chips)=20
Seat 9: mmenz08816 (34715 in chips) is sitting out
mks24: posts the ante 125
eliozica: posts the ante 125
JJin91: posts the ante 125
JRoop029: posts the ante 125
Scooby-D0O: posts the ante 125
Exomoon: posts the ante 125
mmenz08816: posts the ante 125
JJin91: posts small blind 500
JRoop029: posts big blind 1000
*** HOLE CARDS ***
Dealt to JJin91 [Ks 2s]
datuxguy [observer] said, "what fkn bsssssss"
Scooby-D0O: folds=20
Exomoon: folds=20
mmenz08816: folds=20
mks24: folds=20
eliozica: raises 713 to 1713 and is all-in
JJin91: calls 1213
JRoop029: calls 713
*** FLOP *** [Qd Kh Kd]
JJin91: checks=20
JRoop029: checks=20
*** TURN *** [Qd Kh Kd] [8s]
JJin91: bets 3067
JRoop029: folds=20
Uncalled bet (3067) returned to JJin91
*** RIVER *** [Qd Kh Kd 8s] [2h]
*** SHOW DOWN ***
JJin91: shows [Ks 2s] (a full house, Kings full of Deuces)
eliozica: shows [Td 9d] (a pair of Kings)
JJin91 collected 6014 from pot
eliozica finished the tournament in 32nd place
*** SUMMARY ***
Total pot 6014 | Rake 0=20
Board [Qd Kh Kd 8s 2h]
Seat 2: mks24 folded before Flop (didn't bet)
Seat 3: eliozica (button) showed [Td 9d] and lost with a pair of Kings
Seat 5: JJin91 (small blind) showed [Ks 2s] and won (6014) with a full =
house, Kings full of Deuces
Seat 6: JRoop029 (big blind) folded on the Turn
Seat 7: Scooby-D0O folded before Flop (didn't bet)
Seat 8: Exomoon folded before Flop (didn't bet)
Seat 9: mmenz08816 folded before Flop (didn't bet)


*********** # 82 **************
PokerStars Hand #175436224187: Tournament #1701793956, $18.20+$1.80 USD=
 Hold'em No Limit - Level XV (500/1000) - 2017/09/23 21:34:35 ET
Table '1701793956 2' 9-max Seat #5 is the button
Seat 2: mks24 (12132 in chips)=20
Seat 4: uncleyuri71 (15575 in chips)=20
Seat 5: JJin91 (40316 in chips)=20
Seat 6: JRoop029 (21525 in chips)=20
Seat 7: Scooby-D0O (95027 in chips)=20
Seat 8: Exomoon (44912 in chips)=20
Seat 9: mmenz08816 (34590 in chips) is sitting out
mks24: posts the ante 125
uncleyuri71: posts the ante 125
JJin91: posts the ante 125
JRoop029: posts the ante 125
Scooby-D0O: posts the ante 125
Exomoon: posts the ante 125
mmenz08816: posts the ante 125
JRoop029: posts small blind 500
Scooby-D0O: posts big blind 1000
*** HOLE CARDS ***
Dealt to JJin91 [Js 9d]
Exomoon: calls 1000
mmenz08816: folds=20
mks24: folds=20
uncleyuri71: folds=20
JJin91: folds=20
JRoop029: calls 500
Scooby-D0O: checks=20
*** FLOP *** [7c Td Jc]
JRoop029: checks=20
Scooby-D0O: checks=20
Exomoon: checks=20
*** TURN *** [7c Td Jc] [9h]
JRoop029: bets 3875
Scooby-D0O: folds=20
Exomoon: calls 3875
*** RIVER *** [7c Td Jc 9h] [8c]
JRoop029: checks=20
Exomoon: checks=20
*** SHOW DOWN ***
JRoop029: shows [8d 5c] (a straight, Seven to Jack)
Exomoon: shows [Kd 9s] (a straight, Seven to Jack)
JRoop029 collected 5813 from pot
Exomoon collected 5812 from pot
*** SUMMARY ***
Total pot 11625 | Rake 0=20
Board [7c Td Jc 9h 8c]
Seat 2: mks24 folded before Flop (didn't bet)
Seat 4: uncleyuri71 folded before Flop (didn't bet)
Seat 5: JJin91 (button) folded before Flop (didn't bet)
Seat 6: JRoop029 (small blind) showed [8d 5c] and won (5813) with a str=
aight, Seven to Jack
Seat 7: Scooby-D0O (big blind) folded on the Turn
Seat 8: Exomoon showed [Kd 9s] and won (5812) with a straight, Seven to=
 Jack
Seat 9: mmenz08816 folded before Flop (didn't bet)


*********** # 83 **************
PokerStars Hand #175436224372: Tournament #1701793956, $18.20+$1.80 USD=
 Hold'em No Limit - Level XV (500/1000) - 2017/09/23 21:35:17 ET
Table '1701793956 2' 9-max Seat #6 is the button
Seat 2: mks24 (12007 in chips)=20
Seat 4: uncleyuri71 (15450 in chips)=20
Seat 5: JJin91 (40191 in chips)=20
Seat 6: JRoop029 (22338 in chips)=20
Seat 7: Scooby-D0O (93902 in chips)=20
Seat 8: Exomoon (45724 in chips)=20
Seat 9: mmenz08816 (34465 in chips) is sitting out
mks24: posts the ante 125
uncleyuri71: posts the ante 125
JJin91: posts the ante 125
JRoop029: posts the ante 125
Scooby-D0O: posts the ante 125
Exomoon: posts the ante 125
mmenz08816: posts the ante 125
Scooby-D0O: posts small blind 500
Exomoon: posts big blind 1000
*** HOLE CARDS ***
Dealt to JJin91 [Kh 9c]
mmenz08816: folds=20
mks24: raises 3375 to 4375
mmenz08816 has returned
uncleyuri71: folds=20
JJin91: folds=20
JRoop029: folds=20
Exomoon said, "nice bet"
Scooby-D0O: folds=20
Exomoon: folds=20
Uncalled bet (3375) returned to mks24
mks24 collected 3375 from pot
mks24: doesn't show hand=20
Exomoon said, "good play"
*** SUMMARY ***
Total pot 3375 | Rake 0=20
Seat 2: mks24 collected (3375)
Seat 4: uncleyuri71 folded before Flop (didn't bet)
Seat 5: JJin91 folded before Flop (didn't bet)
Seat 6: JRoop029 (button) folded before Flop (didn't bet)
Seat 7: Scooby-D0O (small blind) folded before Flop
Seat 8: Exomoon (big blind) folded before Flop
Seat 9: mmenz08816 folded before Flop (didn't bet)


*********** # 84 **************
PokerStars Hand #175436224462: Tournament #1701793956, $18.20+$1.80 USD=
 Hold'em No Limit - Level XV (500/1000) - 2017/09/23 21:35:40 ET
Table '1701793956 2' 9-max Seat #7 is the button
Seat 2: mks24 (14257 in chips)=20
Seat 4: uncleyuri71 (15325 in chips)=20
Seat 5: JJin91 (40066 in chips)=20
Seat 6: JRoop029 (22213 in chips)=20
Seat 7: Scooby-D0O (93277 in chips)=20
Seat 8: Exomoon (44599 in chips)=20
Seat 9: mmenz08816 (34340 in chips)=20
mks24: posts the ante 125
uncleyuri71: posts the ante 125
JJin91: posts the ante 125
JRoop029: posts the ante 125
Scooby-D0O: posts the ante 125
Exomoon: posts the ante 125
mmenz08816: posts the ante 125
Exomoon: posts small blind 500
mmenz08816: posts big blind 1000
*** HOLE CARDS ***
Dealt to JJin91 [6d Qc]
mks24: calls 1000
uncleyuri71: folds=20
JJin91: folds=20
JRoop029: folds=20
Scooby-D0O: folds=20
Exomoon: calls 500
mmenz08816: checks=20
*** FLOP *** [6h 4c Ks]
Exomoon: checks=20
mmenz08816: checks=20
mks24: bets 1938
Exomoon: calls 1938
mmenz08816: folds=20
*** TURN *** [6h 4c Ks] [Qd]
Exomoon: checks=20
mks24: checks=20
*** RIVER *** [6h 4c Ks Qd] [Tc]
Exomoon: checks=20
mks24: checks=20
*** SHOW DOWN ***
Exomoon: shows [5d 4s] (a pair of Fours)
mks24: shows [Ad Th] (a pair of Tens)
mks24 collected 7751 from pot
*** SUMMARY ***
Total pot 7751 | Rake 0=20
Board [6h 4c Ks Qd Tc]
Seat 2: mks24 showed [Ad Th] and won (7751) with a pair of Tens
Seat 4: uncleyuri71 folded before Flop (didn't bet)
Seat 5: JJin91 folded before Flop (didn't bet)
Seat 6: JRoop029 folded before Flop (didn't bet)
Seat 7: Scooby-D0O (button) folded before Flop (didn't bet)
Seat 8: Exomoon (small blind) showed [5d 4s] and lost with a pair of Fo=
urs
Seat 9: mmenz08816 (big blind) folded on the Flop


*********** # 85 **************
PokerStars Hand #175436224731: Tournament #1701793956, $18.20+$1.80 USD=
 Hold'em No Limit - Level XV (500/1000) - 2017/09/23 21:36:44 ET
Table '1701793956 2' 9-max Seat #8 is the button
Seat 2: mks24 (18945 in chips)=20
Seat 4: uncleyuri71 (15200 in chips)=20
Seat 5: JJin91 (39941 in chips)=20
Seat 6: JRoop029 (22088 in chips)=20
Seat 7: Scooby-D0O (93152 in chips)=20
Seat 8: Exomoon (41536 in chips)=20
Seat 9: mmenz08816 (33215 in chips)=20
mks24: posts the ante 125
uncleyuri71: posts the ante 125
JJin91: posts the ante 125
JRoop029: posts the ante 125
Scooby-D0O: posts the ante 125
Exomoon: posts the ante 125
mmenz08816: posts the ante 125
mmenz08816: posts small blind 500
mks24: posts big blind 1000
*** HOLE CARDS ***
Dealt to JJin91 [Qh 8s]
uncleyuri71: folds=20
JJin91: folds=20
JRoop029: folds=20
Scooby-D0O: folds=20
Exomoon: folds=20
mmenz08816: raises 1500 to 2500
mks24: folds=20
Uncalled bet (1500) returned to mmenz08816
mmenz08816 collected 2875 from pot
mmenz08816: doesn't show hand=20
*** SUMMARY ***
Total pot 2875 | Rake 0=20
Seat 2: mks24 (big blind) folded before Flop
Seat 4: uncleyuri71 folded before Flop (didn't bet)
Seat 5: JJin91 folded before Flop (didn't bet)
Seat 6: JRoop029 folded before Flop (didn't bet)
Seat 7: Scooby-D0O folded before Flop (didn't bet)
Seat 8: Exomoon (button) folded before Flop (didn't bet)
Seat 9: mmenz08816 (small blind) collected (2875)


*********** # 86 **************
PokerStars Hand #175436224834: Tournament #1701793956, $18.20+$1.80 USD=
 Hold'em No Limit - Level XV (500/1000) - 2017/09/23 21:37:08 ET
Table '1701793956 2' 9-max Seat #9 is the button
Seat 2: mks24 (17820 in chips)=20
Seat 4: uncleyuri71 (15075 in chips)=20
Seat 5: JJin91 (39816 in chips)=20
Seat 6: JRoop029 (21963 in chips)=20
Seat 7: Scooby-D0O (93027 in chips)=20
Seat 8: Exomoon (41411 in chips)=20
Seat 9: mmenz08816 (34965 in chips)=20
mks24: posts the ante 125
uncleyuri71: posts the ante 125
JJin91: posts the ante 125
JRoop029: posts the ante 125
Scooby-D0O: posts the ante 125
Exomoon: posts the ante 125
mmenz08816: posts the ante 125
mks24: posts small blind 500
uncleyuri71: posts big blind 1000
*** HOLE CARDS ***
Dealt to JJin91 [6h Kc]
JJin91: folds=20
JRoop029: raises 2000 to 3000
Scooby-D0O: folds=20
Exomoon: folds=20
mmenz08816: folds=20
mks24: calls 2500
uncleyuri71: folds=20
*** FLOP *** [Ac 2d Th]
mks24: bets 1000
JRoop029: raises 17838 to 18838 and is all-in
mks24: folds=20
Uncalled bet (17838) returned to JRoop029
JRoop029 collected 9875 from pot
*** SUMMARY ***
Total pot 9875 | Rake 0=20
Board [Ac 2d Th]
Seat 2: mks24 (small blind) folded on the Flop
Seat 4: uncleyuri71 (big blind) folded before Flop
Seat 5: JJin91 folded before Flop (didn't bet)
Seat 6: JRoop029 collected (9875)
Seat 7: Scooby-D0O folded before Flop (didn't bet)
Seat 8: Exomoon folded before Flop (didn't bet)
Seat 9: mmenz08816 (button) folded before Flop (didn't bet)


*********** # 87 **************
PokerStars Hand #175436224979: Tournament #1701793956, $18.20+$1.80 USD=
 Hold'em No Limit - Level XV (500/1000) - 2017/09/23 21:37:47 ET
Table '1701793956 2' 9-max Seat #2 is the button
Seat 2: mks24 (13695 in chips)=20
Seat 4: uncleyuri71 (13950 in chips)=20
Seat 5: JJin91 (39691 in chips)=20
Seat 6: JRoop029 (27713 in chips)=20
Seat 7: Scooby-D0O (92902 in chips)=20
Seat 8: Exomoon (41286 in chips)=20
Seat 9: mmenz08816 (34840 in chips)=20
mks24: posts the ante 125
uncleyuri71: posts the ante 125
JJin91: posts the ante 125
JRoop029: posts the ante 125
Scooby-D0O: posts the ante 125
Exomoon: posts the ante 125
mmenz08816: posts the ante 125
uncleyuri71: posts small blind 500
JJin91: posts big blind 1000
*** HOLE CARDS ***
Dealt to JJin91 [8s 9h]
JRoop029: folds=20
Scooby-D0O: folds=20
Exomoon: folds=20
mmenz08816: raises 1500 to 2500
mks24: folds=20
uncleyuri71: folds=20
JJin91: folds=20
Uncalled bet (1500) returned to mmenz08816
mmenz08816 collected 3375 from pot
mmenz08816: doesn't show hand=20
*** SUMMARY ***
Total pot 3375 | Rake 0=20
Seat 2: mks24 (button) folded before Flop (didn't bet)
Seat 4: uncleyuri71 (small blind) folded before Flop
Seat 5: JJin91 (big blind) folded before Flop
Seat 6: JRoop029 folded before Flop (didn't bet)
Seat 7: Scooby-D0O folded before Flop (didn't bet)
Seat 8: Exomoon folded before Flop (didn't bet)
Seat 9: mmenz08816 collected (3375)


*********** # 88 **************
PokerStars Hand #175436225064: Tournament #1701793956, $18.20+$1.80 USD=
 Hold'em No Limit - Level XV (500/1000) - 2017/09/23 21:38:11 ET
Table '1701793956 2' 9-max Seat #4 is the button
Seat 2: mks24 (13570 in chips)=20
Seat 4: uncleyuri71 (13325 in chips)=20
Seat 5: JJin91 (38566 in chips)=20
Seat 6: JRoop029 (27588 in chips)=20
Seat 7: Scooby-D0O (92777 in chips)=20
Seat 8: Exomoon (41161 in chips)=20
Seat 9: mmenz08816 (37090 in chips)=20
mks24: posts the ante 125
uncleyuri71: posts the ante 125
JJin91: posts the ante 125
JRoop029: posts the ante 125
Scooby-D0O: posts the ante 125
Exomoon: posts the ante 125
mmenz08816: posts the ante 125
JJin91: posts small blind 500
JRoop029: posts big blind 1000
*** HOLE CARDS ***
Dealt to JJin91 [2h As]
Scooby-D0O: folds=20
Exomoon: raises 1000 to 2000
mmenz08816: folds=20
mks24: folds=20
uncleyuri71: folds=20
JJin91: folds=20
JRoop029: folds=20
Uncalled bet (1000) returned to Exomoon
Exomoon collected 3375 from pot
Exomoon: doesn't show hand=20
*** SUMMARY ***
Total pot 3375 | Rake 0=20
Seat 2: mks24 folded before Flop (didn't bet)
Seat 4: uncleyuri71 (button) folded before Flop (didn't bet)
Seat 5: JJin91 (small blind) folded before Flop
Seat 6: JRoop029 (big blind) folded before Flop
Seat 7: Scooby-D0O folded before Flop (didn't bet)
Seat 8: Exomoon collected (3375)
Seat 9: mmenz08816 folded before Flop (didn't bet)


*********** # 89 **************
PokerStars Hand #175436225169: Tournament #1701793956, $18.20+$1.80 USD=
 Hold'em No Limit - Level XV (500/1000) - 2017/09/23 21:38:39 ET
Table '1701793956 2' 9-max Seat #5 is the button
Seat 2: mks24 (13445 in chips)=20
Seat 4: uncleyuri71 (13200 in chips)=20
Seat 5: JJin91 (37941 in chips)=20
Seat 6: JRoop029 (26463 in chips)=20
Seat 7: Scooby-D0O (92652 in chips)=20
Seat 8: Exomoon (43411 in chips)=20
Seat 9: mmenz08816 (36965 in chips)=20
mks24: posts the ante 125
uncleyuri71: posts the ante 125
JJin91: posts the ante 125
JRoop029: posts the ante 125
Scooby-D0O: posts the ante 125
Exomoon: posts the ante 125
mmenz08816: posts the ante 125
JRoop029: posts small blind 500
Scooby-D0O: posts big blind 1000
*** HOLE CARDS ***
Dealt to JJin91 [Ac As]
Exomoon: folds=20
mmenz08816: folds=20
mks24: folds=20
uncleyuri71: raises 1250 to 2250
JJin91: raises 3305 to 5555
JRoop029: folds=20
Scooby-D0O: folds=20
uncleyuri71: folds=20
Uncalled bet (3305) returned to JJin91
JJin91 collected 6875 from pot
JJin91: doesn't show hand=20
*** SUMMARY ***
Total pot 6875 | Rake 0=20
Seat 2: mks24 folded before Flop (didn't bet)
Seat 4: uncleyuri71 folded before Flop
Seat 5: JJin91 (button) collected (6875)
Seat 6: JRoop029 (small blind) folded before Flop
Seat 7: Scooby-D0O (big blind) folded before Flop
Seat 8: Exomoon folded before Flop (didn't bet)
Seat 9: mmenz08816 folded before Flop (didn't bet)


*********** # 90 **************
PokerStars Hand #175436225475: Tournament #1701793956, $18.20+$1.80 USD=
 Hold'em No Limit - Level XV (500/1000) - 2017/09/23 21:39:55 ET
Table '1701793956 2' 9-max Seat #6 is the button
Seat 2: mks24 (13320 in chips)=20
Seat 4: uncleyuri71 (10825 in chips)=20
Seat 5: JJin91 (42441 in chips)=20
Seat 6: JRoop029 (25838 in chips)=20
Seat 7: Scooby-D0O (91527 in chips)=20
Seat 8: Exomoon (43286 in chips)=20
Seat 9: mmenz08816 (36840 in chips)=20
mks24: posts the ante 125
uncleyuri71: posts the ante 125
JJin91: posts the ante 125
JRoop029: posts the ante 125
Scooby-D0O: posts the ante 125
Exomoon: posts the ante 125
mmenz08816: posts the ante 125
Scooby-D0O: posts small blind 500
Exomoon: posts big blind 1000
*** HOLE CARDS ***
Dealt to JJin91 [8c Tc]
mmenz08816: folds=20
mks24: folds=20
uncleyuri71: folds=20
JJin91: raises 1170 to 2170
JRoop029: folds=20
Scooby-D0O: folds=20
Exomoon: folds=20
Uncalled bet (1170) returned to JJin91
JJin91 collected 3375 from pot
JJin91: doesn't show hand=20
*** SUMMARY ***
Total pot 3375 | Rake 0=20
Seat 2: mks24 folded before Flop (didn't bet)
Seat 4: uncleyuri71 folded before Flop (didn't bet)
Seat 5: JJin91 collected (3375)
Seat 6: JRoop029 (button) folded before Flop (didn't bet)
Seat 7: Scooby-D0O (small blind) folded before Flop
Seat 8: Exomoon (big blind) folded before Flop
Seat 9: mmenz08816 folded before Flop (didn't bet)


*********** # 91 **************
PokerStars Hand #175436225567: Tournament #1701793956, $18.20+$1.80 USD=
 Hold'em No Limit - Level XV (500/1000) - 2017/09/23 21:40:18 ET
Table '1701793956 2' 9-max Seat #7 is the button
Seat 2: mks24 (13195 in chips)=20
Seat 4: uncleyuri71 (10700 in chips)=20
Seat 5: JJin91 (44691 in chips)=20
Seat 6: JRoop029 (25713 in chips)=20
Seat 7: Scooby-D0O (90902 in chips)=20
Seat 8: Exomoon (42161 in chips)=20
Seat 9: mmenz08816 (36715 in chips)=20
mks24: posts the ante 125
uncleyuri71: posts the ante 125
JJin91: posts the ante 125
JRoop029: posts the ante 125
Scooby-D0O: posts the ante 125
Exomoon: posts the ante 125
mmenz08816: posts the ante 125
Exomoon: posts small blind 500
mmenz08816: posts big blind 1000
*** HOLE CARDS ***
Dealt to JJin91 [Ac 6d]
mks24: folds=20
uncleyuri71: folds=20
JJin91: folds=20
JRoop029: raises 2000 to 3000
Scooby-D0O: raises 6000 to 9000
Exomoon: folds=20
mmenz08816: folds=20
JRoop029: folds=20
Uncalled bet (6000) returned to Scooby-D0O
Scooby-D0O collected 8375 from pot
*** SUMMARY ***
Total pot 8375 | Rake 0=20
Seat 2: mks24 folded before Flop (didn't bet)
Seat 4: uncleyuri71 folded before Flop (didn't bet)
Seat 5: JJin91 folded before Flop (didn't bet)
Seat 6: JRoop029 folded before Flop
Seat 7: Scooby-D0O (button) collected (8375)
Seat 8: Exomoon (small blind) folded before Flop
Seat 9: mmenz08816 (big blind) folded before Flop


*********** # 92 **************
PokerStars Hand #175436225697: Tournament #1701793956, $18.20+$1.80 USD=
 Hold'em No Limit - Level XV (500/1000) - 2017/09/23 21:40:56 ET
Table '1701793956 2' 9-max Seat #8 is the button
Seat 2: mks24 (13070 in chips)=20
Seat 4: uncleyuri71 (10575 in chips)=20
Seat 5: JJin91 (44566 in chips)=20
Seat 6: JRoop029 (22588 in chips)=20
Seat 7: Scooby-D0O (96152 in chips)=20
Seat 8: Exomoon (41536 in chips)=20
Seat 9: mmenz08816 (35590 in chips)=20
mks24: posts the ante 125
uncleyuri71: posts the ante 125
JJin91: posts the ante 125
JRoop029: posts the ante 125
Scooby-D0O: posts the ante 125
Exomoon: posts the ante 125
mmenz08816: posts the ante 125
mmenz08816: posts small blind 500
mks24: posts big blind 1000
*** HOLE CARDS ***
Dealt to JJin91 [8d 5s]
uncleyuri71: folds=20
JJin91: folds=20
JRoop029: folds=20
Scooby-D0O: raises 1500 to 2500
Exomoon: folds=20
mmenz08816: folds=20
mks24: folds=20
Uncalled bet (1500) returned to Scooby-D0O
Scooby-D0O collected 3375 from pot
*** SUMMARY ***
Total pot 3375 | Rake 0=20
Seat 2: mks24 (big blind) folded before Flop
Seat 4: uncleyuri71 folded before Flop (didn't bet)
Seat 5: JJin91 folded before Flop (didn't bet)
Seat 6: JRoop029 folded before Flop (didn't bet)
Seat 7: Scooby-D0O collected (3375)
Seat 8: Exomoon (button) folded before Flop (didn't bet)
Seat 9: mmenz08816 (small blind) folded before Flop


*********** # 93 **************
PokerStars Hand #175436225793: Tournament #1701793956, $18.20+$1.80 USD=
 Hold'em No Limit - Level XV (500/1000) - 2017/09/23 21:41:20 ET
Table '1701793956 2' 9-max Seat #9 is the button
Seat 2: mks24 (11945 in chips)=20
Seat 4: uncleyuri71 (10450 in chips)=20
Seat 5: JJin91 (44441 in chips)=20
Seat 6: JRoop029 (22463 in chips)=20
Seat 7: Scooby-D0O (98402 in chips)=20
Seat 8: Exomoon (41411 in chips)=20
Seat 9: mmenz08816 (34965 in chips)=20
mks24: posts the ante 125
uncleyuri71: posts the ante 125
JJin91: posts the ante 125
JRoop029: posts the ante 125
Scooby-D0O: posts the ante 125
Exomoon: posts the ante 125
mmenz08816: posts the ante 125
mks24: posts small blind 500
uncleyuri71: posts big blind 1000
*** HOLE CARDS ***
Dealt to JJin91 [7c 8h]
JJin91: folds=20
JRoop029: folds=20
Scooby-D0O: raises 1500 to 2500
Exomoon: calls 2500
mmenz08816: calls 2500
mks24: folds=20
uncleyuri71: calls 1500
*** FLOP *** [4s 9d Ad]
uncleyuri71: checks=20
Scooby-D0O: checks=20
Exomoon: bets 5000
mmenz08816: folds=20
uncleyuri71: folds=20
Scooby-D0O: folds=20
Uncalled bet (5000) returned to Exomoon
Exomoon collected 11375 from pot
*** SUMMARY ***
Total pot 11375 | Rake 0=20
Board [4s 9d Ad]
Seat 2: mks24 (small blind) folded before Flop
Seat 4: uncleyuri71 (big blind) folded on the Flop
Seat 5: JJin91 folded before Flop (didn't bet)
Seat 6: JRoop029 folded before Flop (didn't bet)
Seat 7: Scooby-D0O folded on the Flop
Seat 8: Exomoon collected (11375)
Seat 9: mmenz08816 (button) folded on the Flop


*********** # 94 **************
PokerStars Hand #175436226088: Tournament #1701793956, $18.20+$1.80 USD=
 Hold'em No Limit - Level XVI (600/1200) - 2017/09/23 21:42:39 ET
Table '1701793956 2' 9-max Seat #2 is the button
Seat 2: mks24 (11320 in chips)=20
Seat 4: uncleyuri71 (7825 in chips)=20
Seat 5: JJin91 (44316 in chips)=20
Seat 6: JRoop029 (22338 in chips)=20
Seat 7: Scooby-D0O (95777 in chips)=20
Seat 8: Exomoon (50161 in chips)=20
Seat 9: mmenz08816 (32340 in chips)=20
mks24: posts the ante 150
uncleyuri71: posts the ante 150
JJin91: posts the ante 150
JRoop029: posts the ante 150
Scooby-D0O: posts the ante 150
Exomoon: posts the ante 150
mmenz08816: posts the ante 150
uncleyuri71: posts small blind 600
JJin91: posts big blind 1200
*** HOLE CARDS ***
Dealt to JJin91 [Ah Jh]
JRoop029: folds=20
Scooby-D0O: raises 1440 to 2640
Exomoon: calls 2640
mmenz08816: folds=20
mks24: folds=20
uncleyuri71: folds=20
JJin91: calls 1440
*** FLOP *** [2h 6s Js]
JJin91: checks=20
Scooby-D0O: checks=20
Exomoon: bets 4785
JJin91: raises 8549 to 13334
Scooby-D0O: folds=20
Exomoon: calls 8549
*** TURN *** [2h 6s Js] [9c]
JJin91: checks=20
Exomoon: checks=20
*** RIVER *** [2h 6s Js 9c] [2d]
JJin91: bets 11192
Exomoon: calls 11192
*** SHOW DOWN ***
JJin91: shows [Ah Jh] (two pair, Jacks and Deuces)
Exomoon: mucks hand=20
JJin91 collected 58622 from pot
*** SUMMARY ***
Total pot 58622 | Rake 0=20
Board [2h 6s Js 9c 2d]
Seat 2: mks24 (button) folded before Flop (didn't bet)
Seat 4: uncleyuri71 (small blind) folded before Flop
Seat 5: JJin91 (big blind) showed [Ah Jh] and won (58622) with two pair=
, Jacks and Deuces
Seat 6: JRoop029 folded before Flop (didn't bet)
Seat 7: Scooby-D0O folded on the Flop
Seat 8: Exomoon mucked [Kh Jc]
Seat 9: mmenz08816 folded before Flop (didn't bet)


*********** # 95 **************
PokerStars Hand #175436226527: Tournament #1701793956, $18.20+$1.80 USD=
 Hold'em No Limit - Level XVI (600/1200) - 2017/09/23 21:44:38 ET
Table '1701793956 2' 9-max Seat #4 is the button
Seat 1: LargeFarva99 (98793 in chips)=20
Seat 2: mks24 (11170 in chips)=20
Seat 3: inthebut (59994 in chips)=20
Seat 4: uncleyuri71 (7075 in chips)=20
Seat 5: JJin91 (75622 in chips)=20
Seat 6: JRoop029 (22188 in chips)=20
Seat 7: Scooby-D0O (92987 in chips)=20
Seat 8: Exomoon (22845 in chips)=20
Seat 9: mmenz08816 (32190 in chips)=20
LargeFarva99: posts the ante 150
mks24: posts the ante 150
inthebut: posts the ante 150
uncleyuri71: posts the ante 150
JJin91: posts the ante 150
JRoop029: posts the ante 150
Scooby-D0O: posts the ante 150
Exomoon: posts the ante 150
mmenz08816: posts the ante 150
JJin91: posts small blind 600
JRoop029: posts big blind 1200
*** HOLE CARDS ***
Dealt to JJin91 [Qd 4c]
Exomoon said, "kicker"
Scooby-D0O: raises 1440 to 2640
Exomoon said, "kj"
Exomoon: folds=20
mmenz08816: folds=20
LargeFarva99: folds=20
Exomoon said, "nh"
mks24: folds=20
inthebut: folds=20
uncleyuri71: folds=20
JJin91: folds=20
JRoop029: calls 1440
*** FLOP *** [7s 9d 8d]
JRoop029: checks=20
Scooby-D0O: bets 2169
JRoop029: folds=20
Uncalled bet (2169) returned to Scooby-D0O
Scooby-D0O collected 7230 from pot
*** SUMMARY ***
Total pot 7230 | Rake 0=20
Board [7s 9d 8d]
Seat 1: LargeFarva99 folded before Flop (didn't bet)
Seat 2: mks24 folded before Flop (didn't bet)
Seat 3: inthebut folded before Flop (didn't bet)
Seat 4: uncleyuri71 (button) folded before Flop (didn't bet)
Seat 5: JJin91 (small blind) folded before Flop
Seat 6: JRoop029 (big blind) folded on the Flop
Seat 7: Scooby-D0O collected (7230)
Seat 8: Exomoon folded before Flop (didn't bet)
Seat 9: mmenz08816 folded before Flop (didn't bet)


*********** # 96 **************
PokerStars Hand #175436226700: Tournament #1701793956, $18.20+$1.80 USD=
 Hold'em No Limit - Level XVI (600/1200) - 2017/09/23 21:45:19 ET
Table '1701793956 2' 9-max Seat #5 is the button
Seat 1: LargeFarva99 (98643 in chips)=20
Seat 2: mks24 (11020 in chips)=20
Seat 3: inthebut (59844 in chips)=20
Seat 4: uncleyuri71 (6925 in chips)=20
Seat 5: JJin91 (74872 in chips)=20
Seat 6: JRoop029 (19398 in chips)=20
Seat 7: Scooby-D0O (97427 in chips)=20
Seat 8: Exomoon (22695 in chips)=20
Seat 9: mmenz08816 (32040 in chips)=20
LargeFarva99: posts the ante 150
mks24: posts the ante 150
inthebut: posts the ante 150
uncleyuri71: posts the ante 150
JJin91: posts the ante 150
JRoop029: posts the ante 150
Scooby-D0O: posts the ante 150
Exomoon: posts the ante 150
mmenz08816: posts the ante 150
JRoop029: posts small blind 600
Scooby-D0O: posts big blind 1200
*** HOLE CARDS ***
Dealt to JJin91 [2c 5h]
Exomoon: folds=20
mmenz08816: folds=20
LargeFarva99: folds=20
mks24: folds=20
inthebut: folds=20
uncleyuri71: raises 1400 to 2600
JJin91: folds=20
JRoop029: folds=20
Scooby-D0O: calls 1400
*** FLOP *** [Qh 9d Tc]
Scooby-D0O: checks=20
uncleyuri71: checks=20
*** TURN *** [Qh 9d Tc] [4c]
Scooby-D0O: checks=20
uncleyuri71: checks=20
*** RIVER *** [Qh 9d Tc 4c] [2d]
Scooby-D0O: bets 5363
uncleyuri71: folds=20
Uncalled bet (5363) returned to Scooby-D0O
Scooby-D0O collected 7150 from pot
*** SUMMARY ***
Total pot 7150 | Rake 0=20
Board [Qh 9d Tc 4c 2d]
Seat 1: LargeFarva99 folded before Flop (didn't bet)
Seat 2: mks24 folded before Flop (didn't bet)
Seat 3: inthebut folded before Flop (didn't bet)
Seat 4: uncleyuri71 folded on the River
Seat 5: JJin91 (button) folded before Flop (didn't bet)
Seat 6: JRoop029 (small blind) folded before Flop
Seat 7: Scooby-D0O (big blind) collected (7150)
Seat 8: Exomoon folded before Flop (didn't bet)
Seat 9: mmenz08816 folded before Flop (didn't bet)


*********** # 97 **************
PokerStars Hand #175436226930: Tournament #1701793956, $18.20+$1.80 USD=
 Hold'em No Limit - Level XVI (600/1200) - 2017/09/23 21:46:15 ET
Table '1701793956 2' 9-max Seat #6 is the button
Seat 1: LargeFarva99 (98493 in chips)=20
Seat 2: mks24 (10870 in chips)=20
Seat 3: inthebut (59694 in chips)=20
Seat 4: uncleyuri71 (4175 in chips)=20
Seat 5: JJin91 (74722 in chips)=20
Seat 6: JRoop029 (18648 in chips)=20
Seat 7: Scooby-D0O (101827 in chips)=20
Seat 8: Exomoon (22545 in chips)=20
Seat 9: mmenz08816 (31890 in chips)=20
LargeFarva99: posts the ante 150
mks24: posts the ante 150
inthebut: posts the ante 150
uncleyuri71: posts the ante 150
JJin91: posts the ante 150
JRoop029: posts the ante 150
Scooby-D0O: posts the ante 150
Exomoon: posts the ante 150
mmenz08816: posts the ante 150
Scooby-D0O: posts small blind 600
Exomoon: posts big blind 1200
*** HOLE CARDS ***
Dealt to JJin91 [8s 3d]
mmenz08816: folds=20
LargeFarva99: folds=20
mks24: raises 4350 to 5550
inthebut: folds=20
uncleyuri71: calls 4025 and is all-in
JJin91: folds=20
JRoop029: folds=20
Scooby-D0O: folds=20
Exomoon: raises 16845 to 22395 and is all-in
mks24: calls 5170 and is all-in
Uncalled bet (11675) returned to Exomoon
*** FLOP *** [9d Th 3h]
*** TURN *** [9d Th 3h] [Qs]
*** RIVER *** [9d Th 3h Qs] [9s]
*** SHOW DOWN ***
Exomoon: shows [Kh Kc] (two pair, Kings and Nines)
mks24: shows [Qd Ad] (two pair, Queens and Nines)
Exomoon collected 13390 from side pot
uncleyuri71: shows [5h 5c] (two pair, Nines and Fives)
Exomoon collected 14025 from main pot
mks24 finished the tournament in 25th place
uncleyuri71 finished the tournament in 26th place
*** SUMMARY ***
Total pot 27415 Main pot 14025. Side pot 13390. | Rake 0=20
Board [9d Th 3h Qs 9s]
Seat 1: LargeFarva99 folded before Flop (didn't bet)
Seat 2: mks24 showed [Qd Ad] and lost with two pair, Queens and Nines
Seat 3: inthebut folded before Flop (didn't bet)
Seat 4: uncleyuri71 showed [5h 5c] and lost with two pair, Nines and Fi=
ves
Seat 5: JJin91 folded before Flop (didn't bet)
Seat 6: JRoop029 (button) folded before Flop (didn't bet)
Seat 7: Scooby-D0O (small blind) folded before Flop
Seat 8: Exomoon (big blind) showed [Kh Kc] and won (27415) with two pai=
r, Kings and Nines
Seat 9: mmenz08816 folded before Flop (didn't bet)


*********** # 98 **************
PokerStars Hand #175436227148: Tournament #1701793956, $18.20+$1.80 USD=
 Hold'em No Limit - Level XVI (600/1200) - 2017/09/23 21:47:08 ET
Table '1701793956 2' 9-max Seat #7 is the button
Seat 1: LargeFarva99 (98343 in chips)=20
Seat 3: inthebut (59544 in chips)=20
Seat 5: JJin91 (74572 in chips)=20
Seat 6: JRoop029 (18498 in chips)=20
Seat 7: Scooby-D0O (101077 in chips)=20
Seat 8: Exomoon (39090 in chips)=20
Seat 9: mmenz08816 (31740 in chips)=20
LargeFarva99: posts the ante 150
inthebut: posts the ante 150
JJin91: posts the ante 150
JRoop029: posts the ante 150
Scooby-D0O: posts the ante 150
Exomoon: posts the ante 150
mmenz08816: posts the ante 150
Exomoon: posts small blind 600
mmenz08816: posts big blind 1200
*** HOLE CARDS ***
Dealt to JJin91 [2c Th]
LargeFarva99: raises 1200 to 2400
inthebut: folds=20
JJin91: folds=20
JRoop029: folds=20
Scooby-D0O: folds=20
Exomoon: folds=20
mmenz08816: folds=20
Uncalled bet (1200) returned to LargeFarva99
LargeFarva99 collected 4050 from pot
LargeFarva99: doesn't show hand=20
*** SUMMARY ***
Total pot 4050 | Rake 0=20
Seat 1: LargeFarva99 collected (4050)
Seat 3: inthebut folded before Flop (didn't bet)
Seat 5: JJin91 folded before Flop (didn't bet)
Seat 6: JRoop029 folded before Flop (didn't bet)
Seat 7: Scooby-D0O (button) folded before Flop (didn't bet)
Seat 8: Exomoon (small blind) folded before Flop
Seat 9: mmenz08816 (big blind) folded before Flop


*********** # 99 **************
PokerStars Hand #175436227232: Tournament #1701793956, $18.20+$1.80 USD=
 Hold'em No Limit - Level XVI (600/1200) - 2017/09/23 21:47:29 ET
Table '1701793956 2' 9-max Seat #8 is the button
Seat 1: LargeFarva99 (101043 in chips)=20
Seat 3: inthebut (59394 in chips)=20
Seat 5: JJin91 (74422 in chips)=20
Seat 6: JRoop029 (18348 in chips)=20
Seat 7: Scooby-D0O (100927 in chips)=20
Seat 8: Exomoon (38340 in chips)=20
Seat 9: mmenz08816 (30390 in chips)=20
LargeFarva99: posts the ante 150
inthebut: posts the ante 150
JJin91: posts the ante 150
JRoop029: posts the ante 150
Scooby-D0O: posts the ante 150
Exomoon: posts the ante 150
mmenz08816: posts the ante 150
mmenz08816: posts small blind 600
LargeFarva99: posts big blind 1200
*** HOLE CARDS ***
Dealt to JJin91 [5h 8d]
inthebut: folds=20
JJin91: folds=20
JRoop029: folds=20
Scooby-D0O: folds=20
Exomoon: folds=20
mmenz08816: folds=20
Uncalled bet (600) returned to LargeFarva99
LargeFarva99 collected 2250 from pot
LargeFarva99: doesn't show hand=20
*** SUMMARY ***
Total pot 2250 | Rake 0=20
Seat 1: LargeFarva99 (big blind) collected (2250)
Seat 3: inthebut folded before Flop (didn't bet)
Seat 5: JJin91 folded before Flop (didn't bet)
Seat 6: JRoop029 folded before Flop (didn't bet)
Seat 7: Scooby-D0O folded before Flop (didn't bet)
Seat 8: Exomoon (button) folded before Flop (didn't bet)
Seat 9: mmenz08816 (small blind) folded before Flop


*********** # 100 **************
PokerStars Hand #175436227300: Tournament #1701793956, $18.20+$1.80 USD=
 Hold'em No Limit - Level XVI (600/1200) - 2017/09/23 21:47:44 ET
Table '1701793956 2' 9-max Seat #9 is the button
Seat 1: LargeFarva99 (102543 in chips)=20
Seat 3: inthebut (59244 in chips)=20
Seat 5: JJin91 (74272 in chips)=20
Seat 6: JRoop029 (18198 in chips)=20
Seat 7: Scooby-D0O (100777 in chips)=20
Seat 8: Exomoon (38190 in chips)=20
Seat 9: mmenz08816 (29640 in chips)=20
LargeFarva99: posts the ante 150
inthebut: posts the ante 150
JJin91: posts the ante 150
JRoop029: posts the ante 150
Scooby-D0O: posts the ante 150
Exomoon: posts the ante 150
mmenz08816: posts the ante 150
LargeFarva99: posts small blind 600
inthebut: posts big blind 1200
*** HOLE CARDS ***
Dealt to JJin91 [7d 8c]
JJin91: folds=20
JRoop029: folds=20
Scooby-D0O: raises 1440 to 2640
Exomoon: calls 2640
mmenz08816: folds=20
LargeFarva99: calls 2040
inthebut: calls 1440
*** FLOP *** [7h 3c 7s]
LargeFarva99: checks=20
inthebut: bets 3600
Scooby-D0O: calls 3600
Exomoon: folds=20
LargeFarva99: calls 3600
*** TURN *** [7h 3c 7s] [5d]
LargeFarva99: checks=20
inthebut: checks=20
Scooby-D0O: bets 16808
inthebut said, "bliff"
inthebut said, "ak"
LargeFarva99: raises 26392 to 43200
inthebut: folds=20
Scooby-D0O: folds=20
Uncalled bet (26392) returned to LargeFarva99
LargeFarva99 collected 56026 from pot
LargeFarva99: doesn't show hand=20
*** SUMMARY ***
Total pot 56026 | Rake 0=20
Board [7h 3c 7s 5d]
Seat 1: LargeFarva99 (small blind) collected (56026)
Seat 3: inthebut (big blind) folded on the Turn
Seat 5: JJin91 folded before Flop (didn't bet)
Seat 6: JRoop029 folded before Flop (didn't bet)
Seat 7: Scooby-D0O folded on the Turn
Seat 8: Exomoon folded on the Flop
Seat 9: mmenz08816 (button) folded before Flop (didn't bet)


*********** # 101 **************
PokerStars Hand #175436227800: Tournament #1701793956, $18.20+$1.80 USD=
 Hold'em No Limit - Level XVI (600/1200) - 2017/09/23 21:49:46 ET
Table '1701793956 2' 9-max Seat #1 is the button
Seat 1: LargeFarva99 (135371 in chips)=20
Seat 3: inthebut (52854 in chips)=20
Seat 5: JJin91 (74122 in chips)=20
Seat 6: JRoop029 (18048 in chips)=20
Seat 7: Scooby-D0O (77579 in chips)=20
Seat 8: Exomoon (35400 in chips)=20
Seat 9: mmenz08816 (29490 in chips)=20
LargeFarva99: posts the ante 150
inthebut: posts the ante 150
JJin91: posts the ante 150
JRoop029: posts the ante 150
Scooby-D0O: posts the ante 150
Exomoon: posts the ante 150
mmenz08816: posts the ante 150
inthebut: posts small blind 600
JJin91: posts big blind 1200
*** HOLE CARDS ***
Dealt to JJin91 [Qc Ts]
JRoop029: folds=20
inthebut said, "lol"
Scooby-D0O: folds=20
Exomoon: folds=20
mmenz08816: folds=20
LargeFarva99: folds=20
inthebut: folds=20
Uncalled bet (600) returned to JJin91
JJin91 collected 2250 from pot
JJin91: doesn't show hand=20
Exomoon said, "folded a 7"
*** SUMMARY ***
Total pot 2250 | Rake 0=20
Seat 1: LargeFarva99 (button) folded before Flop (didn't bet)
Seat 3: inthebut (small blind) folded before Flop
Seat 5: JJin91 (big blind) collected (2250)
Seat 6: JRoop029 folded before Flop (didn't bet)
Seat 7: Scooby-D0O folded before Flop (didn't bet)
Seat 8: Exomoon folded before Flop (didn't bet)
Seat 9: mmenz08816 folded before Flop (didn't bet)


*********** # 102 **************
PokerStars Hand #175436227853: Tournament #1701793956, $18.20+$1.80 USD=
 Hold'em No Limit - Level XVI (600/1200) - 2017/09/23 21:50:01 ET
Table '1701793956 2' 9-max Seat #3 is the button
Seat 1: LargeFarva99 (135221 in chips)=20
Seat 3: inthebut (52104 in chips)=20
Seat 5: JJin91 (75622 in chips)=20
Seat 6: JRoop029 (17898 in chips)=20
Seat 7: Scooby-D0O (77429 in chips)=20
Seat 8: Exomoon (35250 in chips)=20
Seat 9: mmenz08816 (29340 in chips)=20
LargeFarva99: posts the ante 150
inthebut: posts the ante 150
JJin91: posts the ante 150
JRoop029: posts the ante 150
Scooby-D0O: posts the ante 150
Exomoon: posts the ante 150
mmenz08816: posts the ante 150
JJin91: posts small blind 600
JRoop029: posts big blind 1200
*** HOLE CARDS ***
Dealt to JJin91 [8h Qs]
Exomoon said, ":)"
Scooby-D0O: folds=20
Exomoon: calls 1200
mmenz08816: calls 1200
LargeFarva99: folds=20
inthebut: calls 1200
JJin91: folds=20
JRoop029: checks=20
*** FLOP *** [8s 7c 3c]
JRoop029: checks=20
Exomoon: checks=20
mmenz08816: checks=20
inthebut: checks=20
*** TURN *** [8s 7c 3c] [2s]
JRoop029: checks=20
Exomoon: bets 3225
mmenz08816: folds=20
inthebut: folds=20
JRoop029: folds=20
Uncalled bet (3225) returned to Exomoon
Exomoon collected 6450 from pot
*** SUMMARY ***
Total pot 6450 | Rake 0=20
Board [8s 7c 3c 2s]
Seat 1: LargeFarva99 folded before Flop (didn't bet)
Seat 3: inthebut (button) folded on the Turn
Seat 5: JJin91 (small blind) folded before Flop
Seat 6: JRoop029 (big blind) folded on the Turn
Seat 7: Scooby-D0O folded before Flop (didn't bet)
Seat 8: Exomoon collected (6450)
Seat 9: mmenz08816 folded on the Turn


*********** # 103 **************
PokerStars Hand #175436228208: Tournament #1701793956, $18.20+$1.80 USD=
 Hold'em No Limit - Level XVI (600/1200) - 2017/09/23 21:51:28 ET
Table '1701793956 2' 9-max Seat #5 is the button
Seat 1: LargeFarva99 (135071 in chips)=20
Seat 3: inthebut (50754 in chips)=20
Seat 5: JJin91 (74872 in chips)=20
Seat 6: JRoop029 (16548 in chips)=20
Seat 7: Scooby-D0O (77279 in chips)=20
Seat 8: Exomoon (40350 in chips)=20
Seat 9: mmenz08816 (27990 in chips)=20
LargeFarva99: posts the ante 150
inthebut: posts the ante 150
JJin91: posts the ante 150
JRoop029: posts the ante 150
Scooby-D0O: posts the ante 150
Exomoon: posts the ante 150
mmenz08816: posts the ante 150
JRoop029: posts small blind 600
Scooby-D0O: posts big blind 1200
*** HOLE CARDS ***
Dealt to JJin91 [Ks 9h]
Exomoon: folds=20
mmenz08816: folds=20
LargeFarva99: folds=20
inthebut: raises 1200 to 2400
JJin91: calls 2400
JRoop029: folds=20
Scooby-D0O: folds=20
*** FLOP *** [4d 6c 5c]
inthebut: bets 6000
JJin91: calls 6000
*** TURN *** [4d 6c 5c] [9c]
inthebut: bets 42204 and is all-in
JJin91: folds=20
Uncalled bet (42204) returned to inthebut
inthebut collected 19650 from pot
inthebut: doesn't show hand=20
*** SUMMARY ***
Total pot 19650 | Rake 0=20
Board [4d 6c 5c 9c]
Seat 1: LargeFarva99 folded before Flop (didn't bet)
Seat 3: inthebut collected (19650)
Seat 5: JJin91 (button) folded on the Turn
Seat 6: JRoop029 (small blind) folded before Flop
Seat 7: Scooby-D0O (big blind) folded before Flop
Seat 8: Exomoon folded before Flop (didn't bet)
Seat 9: mmenz08816 folded before Flop (didn't bet)


*********** # 104 **************
PokerStars Hand #175436228542: Tournament #1701793956, $18.20+$1.80 USD=
 Hold'em No Limit - Level XVII (700/1400) - 2017/09/23 21:52:51 ET
Table '1701793956 2' 9-max Seat #6 is the button
Seat 1: LargeFarva99 (134921 in chips)=20
Seat 3: inthebut (61854 in chips)=20
Seat 5: JJin91 (66322 in chips)=20
Seat 6: JRoop029 (15798 in chips)=20
Seat 7: Scooby-D0O (75929 in chips)=20
Seat 8: Exomoon (40200 in chips)=20
Seat 9: mmenz08816 (27840 in chips)=20
LargeFarva99: posts the ante 175
inthebut: posts the ante 175
JJin91: posts the ante 175
JRoop029: posts the ante 175
Scooby-D0O: posts the ante 175
Exomoon: posts the ante 175
mmenz08816: posts the ante 175
Scooby-D0O: posts small blind 700
Exomoon: posts big blind 1400
*** HOLE CARDS ***
Dealt to JJin91 [5c 7d]
mmenz08816: folds=20
LargeFarva99: folds=20
inthebut: calls 1400
JJin91: folds=20
JRoop029: folds=20
Scooby-D0O: calls 700
Exomoon: checks=20
*** FLOP *** [Td Qd Tc]
Scooby-D0O: checks=20
Exomoon: checks=20
inthebut: bets 1400
Scooby-D0O: folds=20
Exomoon: folds=20
Uncalled bet (1400) returned to inthebut
inthebut collected 5425 from pot
inthebut: doesn't show hand=20
*** SUMMARY ***
Total pot 5425 | Rake 0=20
Board [Td Qd Tc]
Seat 1: LargeFarva99 folded before Flop (didn't bet)
Seat 3: inthebut collected (5425)
Seat 5: JJin91 folded before Flop (didn't bet)
Seat 6: JRoop029 (button) folded before Flop (didn't bet)
Seat 7: Scooby-D0O (small blind) folded on the Flop
Seat 8: Exomoon (big blind) folded on the Flop
Seat 9: mmenz08816 folded before Flop (didn't bet)


*********** # 105 **************
PokerStars Hand #175436228779: Tournament #1701793956, $18.20+$1.80 USD=
 Hold'em No Limit - Level XVII (700/1400) - 2017/09/23 21:53:54 ET
Table '1701793956 2' 9-max Seat #7 is the button
Seat 1: LargeFarva99 (134746 in chips)=20
Seat 3: inthebut (65704 in chips)=20
Seat 5: JJin91 (66147 in chips)=20
Seat 6: JRoop029 (15623 in chips)=20
Seat 7: Scooby-D0O (74354 in chips)=20
Seat 8: Exomoon (38625 in chips)=20
Seat 9: mmenz08816 (27665 in chips)=20
LargeFarva99: posts the ante 175
inthebut: posts the ante 175
JJin91: posts the ante 175
JRoop029: posts the ante 175
Scooby-D0O: posts the ante 175
Exomoon: posts the ante 175
mmenz08816: posts the ante 175
Exomoon: posts small blind 700
mmenz08816: posts big blind 1400
*** HOLE CARDS ***
Dealt to JJin91 [Kh Td]
LargeFarva99: raises 1400 to 2800
inthebut: folds=20
JJin91: folds=20
JRoop029: folds=20
Scooby-D0O: folds=20
Exomoon: folds=20
mmenz08816: folds=20
Uncalled bet (1400) returned to LargeFarva99
mmenz08816 is sitting out
LargeFarva99 collected 4725 from pot
LargeFarva99: doesn't show hand=20
*** SUMMARY ***
Total pot 4725 | Rake 0=20
Seat 1: LargeFarva99 collected (4725)
Seat 3: inthebut folded before Flop (didn't bet)
Seat 5: JJin91 folded before Flop (didn't bet)
Seat 6: JRoop029 folded before Flop (didn't bet)
Seat 7: Scooby-D0O (button) folded before Flop (didn't bet)
Seat 8: Exomoon (small blind) folded before Flop
Seat 9: mmenz08816 (big blind) folded before Flop


*********** # 106 **************
PokerStars Hand #175436228851: Tournament #1701793956, $18.20+$1.80 USD=
 Hold'em No Limit - Level XVII (700/1400) - 2017/09/23 21:54:15 ET
Table '1701793956 2' 9-max Seat #8 is the button
Seat 1: LargeFarva99 (137896 in chips)=20
Seat 3: inthebut (65529 in chips)=20
Seat 5: JJin91 (65972 in chips)=20
Seat 6: JRoop029 (15448 in chips)=20
Seat 7: Scooby-D0O (74179 in chips)=20
Seat 8: Exomoon (37750 in chips)=20
Seat 9: mmenz08816 (26090 in chips) is sitting out
LargeFarva99: posts the ante 175
inthebut: posts the ante 175
JJin91: posts the ante 175
JRoop029: posts the ante 175
Scooby-D0O: posts the ante 175
Exomoon: posts the ante 175
mmenz08816: posts the ante 175
mmenz08816: posts small blind 700
LargeFarva99: posts big blind 1400
*** HOLE CARDS ***
Dealt to JJin91 [As 6c]
inthebut: raises 1400 to 2800
JJin91: folds=20
JRoop029: folds=20
Scooby-D0O: folds=20
Exomoon: folds=20
mmenz08816: folds=20
LargeFarva99: folds=20
Uncalled bet (1400) returned to inthebut
inthebut collected 4725 from pot
inthebut: doesn't show hand=20
*** SUMMARY ***
Total pot 4725 | Rake 0=20
Seat 1: LargeFarva99 (big blind) folded before Flop
Seat 3: inthebut collected (4725)
Seat 5: JJin91 folded before Flop (didn't bet)
Seat 6: JRoop029 folded before Flop (didn't bet)
Seat 7: Scooby-D0O folded before Flop (didn't bet)
Seat 8: Exomoon (button) folded before Flop (didn't bet)
Seat 9: mmenz08816 (small blind) folded before Flop


*********** # 107 **************
PokerStars Hand #175436229030: Tournament #1701793956, $18.20+$1.80 USD=
 Hold'em No Limit - Level XVII (700/1400) - 2017/09/23 21:54:58 ET
Table '1701793956 2' 9-max Seat #9 is the button
Seat 1: LargeFarva99 (136321 in chips)=20
Seat 3: inthebut (68679 in chips)=20
Seat 5: JJin91 (65797 in chips)=20
Seat 6: JRoop029 (15273 in chips)=20
Seat 7: Scooby-D0O (74004 in chips)=20
Seat 8: Exomoon (37575 in chips)=20
Seat 9: mmenz08816 (25215 in chips) is sitting out
LargeFarva99: posts the ante 175
inthebut: posts the ante 175
JJin91: posts the ante 175
JRoop029: posts the ante 175
Scooby-D0O: posts the ante 175
Exomoon: posts the ante 175
mmenz08816: posts the ante 175
LargeFarva99: posts small blind 700
inthebut: posts big blind 1400
*** HOLE CARDS ***
Dealt to JJin91 [2c 5h]
JJin91: folds=20
JRoop029: folds=20
Scooby-D0O: raises 1680 to 3080
Exomoon: folds=20
mmenz08816: folds=20
LargeFarva99: folds=20
inthebut: folds=20
Uncalled bet (1680) returned to Scooby-D0O
Scooby-D0O collected 4725 from pot
*** SUMMARY ***
Total pot 4725 | Rake 0=20
Seat 1: LargeFarva99 (small blind) folded before Flop
Seat 3: inthebut (big blind) folded before Flop
Seat 5: JJin91 folded before Flop (didn't bet)
Seat 6: JRoop029 folded before Flop (didn't bet)
Seat 7: Scooby-D0O collected (4725)
Seat 8: Exomoon folded before Flop (didn't bet)
Seat 9: mmenz08816 (button) folded before Flop (didn't bet)


*********** # 108 **************
PokerStars Hand #175437544539: Tournament #1701793956, $18.20+$1.80 USD=
 Hold'em No Limit - Level XVII (700/1400) - 2017/09/23 22:00:44 ET
Table '1701793956 2' 9-max Seat #1 is the button
Seat 1: LargeFarva99 (135446 in chips)=20
Seat 3: inthebut (67104 in chips)=20
Seat 5: JJin91 (65622 in chips)=20
Seat 6: JRoop029 (15098 in chips)=20
Seat 7: Scooby-D0O (77154 in chips)=20
Seat 8: Exomoon (37400 in chips)=20
Seat 9: mmenz08816 (25040 in chips)=20
LargeFarva99: posts the ante 175
inthebut: posts the ante 175
JJin91: posts the ante 175
JRoop029: posts the ante 175
Scooby-D0O: posts the ante 175
Exomoon: posts the ante 175
mmenz08816: posts the ante 175
inthebut: posts small blind 700
JJin91: posts big blind 1400
*** HOLE CARDS ***
Dealt to JJin91 [Ts Jh]
JRoop029: folds=20
inthebut is disconnected=20
Scooby-D0O: raises 1680 to 3080
Exomoon: folds=20
mmenz08816: folds=20
LargeFarva99: folds=20
inthebut is connected=20
inthebut: folds=20
JJin91: folds=20
Uncalled bet (1680) returned to Scooby-D0O
Scooby-D0O collected 4725 from pot
*** SUMMARY ***
Total pot 4725 | Rake 0=20
Seat 1: LargeFarva99 (button) folded before Flop (didn't bet)
Seat 3: inthebut (small blind) folded before Flop
Seat 5: JJin91 (big blind) folded before Flop
Seat 6: JRoop029 folded before Flop (didn't bet)
Seat 7: Scooby-D0O collected (4725)
Seat 8: Exomoon folded before Flop (didn't bet)
Seat 9: mmenz08816 folded before Flop (didn't bet)


*********** # 109 **************
PokerStars Hand #175437544700: Tournament #1701793956, $18.20+$1.80 USD=
 Hold'em No Limit - Level XVII (700/1400) - 2017/09/23 22:01:21 ET
Table '1701793956 2' 9-max Seat #3 is the button
Seat 1: LargeFarva99 (135271 in chips)=20
Seat 3: inthebut (66229 in chips)=20
Seat 5: JJin91 (64047 in chips)=20
Seat 6: JRoop029 (14923 in chips)=20
Seat 7: Scooby-D0O (80304 in chips)=20
Seat 8: Exomoon (37225 in chips)=20
Seat 9: mmenz08816 (24865 in chips)=20
LargeFarva99: posts the ante 175
inthebut: posts the ante 175
JJin91: posts the ante 175
JRoop029: posts the ante 175
Scooby-D0O: posts the ante 175
Exomoon: posts the ante 175
mmenz08816: posts the ante 175
JJin91: posts small blind 700
JRoop029: posts big blind 1400
*** HOLE CARDS ***
Dealt to JJin91 [Jc Qh]
Scooby-D0O: raises 1680 to 3080
Exomoon is disconnected=20
Exomoon is connected=20
Exomoon: folds=20
mmenz08816: folds=20
LargeFarva99: folds=20
inthebut: calls 3080
JJin91: folds=20
JRoop029: folds=20
*** FLOP *** [Js 3c 5d]
Scooby-D0O: bets 2846
inthebut: calls 2846
*** TURN *** [Js 3c 5d] [6h]
Scooby-D0O: checks=20
inthebut: bets 8400
Scooby-D0O: folds=20
Uncalled bet (8400) returned to inthebut
inthebut collected 15177 from pot
inthebut: doesn't show hand=20
*** SUMMARY ***
Total pot 15177 | Rake 0=20
Board [Js 3c 5d 6h]
Seat 1: LargeFarva99 folded before Flop (didn't bet)
Seat 3: inthebut (button) collected (15177)
Seat 5: JJin91 (small blind) folded before Flop
Seat 6: JRoop029 (big blind) folded before Flop
Seat 7: Scooby-D0O folded on the Turn
Seat 8: Exomoon folded before Flop (didn't bet)
Seat 9: mmenz08816 folded before Flop (didn't bet)


*********** # 110 **************
PokerStars Hand #175437544920: Tournament #1701793956, $18.20+$1.80 USD=
 Hold'em No Limit - Level XVII (700/1400) - 2017/09/23 22:02:17 ET
Table '1701793956 2' 9-max Seat #5 is the button
Seat 1: LargeFarva99 (135096 in chips)=20
Seat 3: inthebut (75305 in chips)=20
Seat 5: JJin91 (63172 in chips)=20
Seat 6: JRoop029 (13348 in chips)=20
Seat 7: Scooby-D0O (74203 in chips)=20
Seat 8: Exomoon (37050 in chips)=20
Seat 9: mmenz08816 (24690 in chips)=20
LargeFarva99: posts the ante 175
inthebut: posts the ante 175
JJin91: posts the ante 175
JRoop029: posts the ante 175
Scooby-D0O: posts the ante 175
Exomoon: posts the ante 175
mmenz08816: posts the ante 175
JRoop029: posts small blind 700
Scooby-D0O: posts big blind 1400
*** HOLE CARDS ***
Dealt to JJin91 [6h 3d]
Exomoon: folds=20
mmenz08816: folds=20
LargeFarva99: folds=20
inthebut: folds=20
JJin91: folds=20
JRoop029: raises 11773 to 13173 and is all-in
Scooby-D0O: calls 11773
*** FLOP *** [Jh Qs 3c]
*** TURN *** [Jh Qs 3c] [4d]
*** RIVER *** [Jh Qs 3c 4d] [Qc]
*** SHOW DOWN ***
JRoop029: shows [Kc Js] (two pair, Queens and Jacks)
Scooby-D0O: shows [6c Ks] (a pair of Queens)
JRoop029 collected 27571 from pot
*** SUMMARY ***
Total pot 27571 | Rake 0=20
Board [Jh Qs 3c 4d Qc]
Seat 1: LargeFarva99 folded before Flop (didn't bet)
Seat 3: inthebut folded before Flop (didn't bet)
Seat 5: JJin91 (button) folded before Flop (didn't bet)
Seat 6: JRoop029 (small blind) showed [Kc Js] and won (27571) with two =
pair, Queens and Jacks
Seat 7: Scooby-D0O (big blind) showed [6c Ks] and lost with a pair of Q=
ueens
Seat 8: Exomoon folded before Flop (didn't bet)
Seat 9: mmenz08816 folded before Flop (didn't bet)


*********** # 111 **************
PokerStars Hand #175437545000: Tournament #1701793956, $18.20+$1.80 USD=
 Hold'em No Limit - Level XVII (700/1400) - 2017/09/23 22:02:37 ET
Table '1701793956 2' 9-max Seat #6 is the button
Seat 1: LargeFarva99 (134921 in chips)=20
Seat 3: inthebut (75130 in chips)=20
Seat 5: JJin91 (62997 in chips)=20
Seat 6: JRoop029 (27571 in chips)=20
Seat 7: Scooby-D0O (60855 in chips)=20
Seat 8: Exomoon (36875 in chips)=20
Seat 9: mmenz08816 (24515 in chips)=20
LargeFarva99: posts the ante 175
inthebut: posts the ante 175
JJin91: posts the ante 175
JRoop029: posts the ante 175
Scooby-D0O: posts the ante 175
Exomoon: posts the ante 175
mmenz08816: posts the ante 175
Scooby-D0O: posts small blind 700
Exomoon: posts big blind 1400
*** HOLE CARDS ***
Dealt to JJin91 [2h Qh]
mmenz08816: folds=20
LargeFarva99: folds=20
inthebut: folds=20
JJin91: folds=20
JRoop029: folds=20
Scooby-D0O: raises 2800 to 4200
Exomoon: folds=20
Uncalled bet (2800) returned to Scooby-D0O
Scooby-D0O collected 4025 from pot
*** SUMMARY ***
Total pot 4025 | Rake 0=20
Seat 1: LargeFarva99 folded before Flop (didn't bet)
Seat 3: inthebut folded before Flop (didn't bet)
Seat 5: JJin91 folded before Flop (didn't bet)
Seat 6: JRoop029 (button) folded before Flop (didn't bet)
Seat 7: Scooby-D0O (small blind) collected (4025)
Seat 8: Exomoon (big blind) folded before Flop
Seat 9: mmenz08816 folded before Flop (didn't bet)


*********** # 112 **************
PokerStars Hand #175437545077: Tournament #1701793956, $18.20+$1.80 USD=
 Hold'em No Limit - Level XVII (700/1400) - 2017/09/23 22:02:58 ET
Table '1701793956 2' 9-max Seat #7 is the button
Seat 1: LargeFarva99 (134746 in chips)=20
Seat 3: inthebut (74955 in chips)=20
Seat 5: JJin91 (62822 in chips)=20
Seat 6: JRoop029 (27396 in chips)=20
Seat 7: Scooby-D0O (63305 in chips)=20
Seat 8: Exomoon (35300 in chips)=20
Seat 9: mmenz08816 (24340 in chips)=20
LargeFarva99: posts the ante 175
inthebut: posts the ante 175
JJin91: posts the ante 175
JRoop029: posts the ante 175
Scooby-D0O: posts the ante 175
Exomoon: posts the ante 175
mmenz08816: posts the ante 175
Exomoon: posts small blind 700
mmenz08816: posts big blind 1400
*** HOLE CARDS ***
Dealt to JJin91 [3d Qh]
LargeFarva99: folds=20
inthebut: calls 1400
JJin91: folds=20
JRoop029: folds=20
Scooby-D0O: folds=20
Exomoon: calls 700
mmenz08816: checks=20
*** FLOP *** [7d 4c Jd]
Exomoon: checks=20
mmenz08816: checks=20
inthebut: checks=20
*** TURN *** [7d 4c Jd] [7h]
Exomoon: checks=20
mmenz08816: bets 2800
inthebut: folds=20
Exomoon: folds=20
Uncalled bet (2800) returned to mmenz08816
mmenz08816 collected 5425 from pot
mmenz08816: doesn't show hand=20
*** SUMMARY ***
Total pot 5425 | Rake 0=20
Board [7d 4c Jd 7h]
Seat 1: LargeFarva99 folded before Flop (didn't bet)
Seat 3: inthebut folded on the Turn
Seat 5: JJin91 folded before Flop (didn't bet)
Seat 6: JRoop029 folded before Flop (didn't bet)
Seat 7: Scooby-D0O (button) folded before Flop (didn't bet)
Seat 8: Exomoon (small blind) folded on the Turn
Seat 9: mmenz08816 (big blind) collected (5425)


*********** # 113 **************
PokerStars Hand #175437545376: Tournament #1701793956, $18.20+$1.80 USD=
 Hold'em No Limit - Level XVII (700/1400) - 2017/09/23 22:04:15 ET
Table '1701793956 2' 9-max Seat #8 is the button
Seat 1: LargeFarva99 (134571 in chips)=20
Seat 3: inthebut (73380 in chips)=20
Seat 5: JJin91 (62647 in chips)=20
Seat 6: JRoop029 (27221 in chips)=20
Seat 7: Scooby-D0O (63130 in chips)=20
Seat 8: Exomoon (33725 in chips)=20
Seat 9: mmenz08816 (28190 in chips)=20
LargeFarva99: posts the ante 175
inthebut: posts the ante 175
JJin91: posts the ante 175
JRoop029: posts the ante 175
Scooby-D0O: posts the ante 175
Exomoon: posts the ante 175
mmenz08816: posts the ante 175
mmenz08816: posts small blind 700
LargeFarva99: posts big blind 1400
*** HOLE CARDS ***
Dealt to JJin91 [7h 7s]
inthebut: folds=20
JJin91: raises 1638 to 3038
JRoop029: calls 3038
Scooby-D0O: folds=20
Exomoon: folds=20
mmenz08816: folds=20
LargeFarva99: calls 1638
*** FLOP *** [5c 5h Ac]
LargeFarva99: checks=20
JJin91: checks=20
JRoop029: bets 24008 and is all-in
LargeFarva99: folds=20
JJin91: folds=20
Uncalled bet (24008) returned to JRoop029
JRoop029 collected 11039 from pot
JRoop029: doesn't show hand=20
*** SUMMARY ***
Total pot 11039 | Rake 0=20
Board [5c 5h Ac]
Seat 1: LargeFarva99 (big blind) folded on the Flop
Seat 3: inthebut folded before Flop (didn't bet)
Seat 5: JJin91 folded on the Flop
Seat 6: JRoop029 collected (11039)
Seat 7: Scooby-D0O folded before Flop (didn't bet)
Seat 8: Exomoon (button) folded before Flop (didn't bet)
Seat 9: mmenz08816 (small blind) folded before Flop


*********** # 114 **************
PokerStars Hand #175437545589: Tournament #1701793956, $18.20+$1.80 USD=
 Hold'em No Limit - Level XVII (700/1400) - 2017/09/23 22:05:08 ET
Table '1701793956 2' 9-max Seat #9 is the button
Seat 1: LargeFarva99 (131358 in chips)=20
Seat 3: inthebut (73205 in chips)=20
Seat 5: JJin91 (59434 in chips)=20
Seat 6: JRoop029 (35047 in chips)=20
Seat 7: Scooby-D0O (62955 in chips)=20
Seat 8: Exomoon (33550 in chips)=20
Seat 9: mmenz08816 (27315 in chips)=20
LargeFarva99: posts the ante 175
inthebut: posts the ante 175
JJin91: posts the ante 175
JRoop029: posts the ante 175
Scooby-D0O: posts the ante 175
Exomoon: posts the ante 175
mmenz08816: posts the ante 175
LargeFarva99: posts small blind 700
inthebut: posts big blind 1400
*** HOLE CARDS ***
Dealt to JJin91 [6d Js]
JJin91: folds=20
JRoop029: folds=20
Scooby-D0O: folds=20
Exomoon: raises 1400 to 2800
mmenz08816: folds=20
LargeFarva99: calls 2100
inthebut: calls 1400
*** FLOP *** [9d 9s 9h]
inthebut said, "I have a nine"
LargeFarva99: checks=20
inthebut: checks=20
Exomoon: checks=20
*** TURN *** [9d 9s 9h] [7s]
LargeFarva99: checks=20
inthebut: bets 1400
Exomoon said, "in your butt?"
Exomoon: calls 1400
LargeFarva99: folds=20
*** RIVER *** [9d 9s 9h 7s] [4d]
Exomoon said, ":)"
inthebut: checks=20
Exomoon: checks=20
*** SHOW DOWN ***
inthebut: shows [2h Ac] (three of a kind, Nines)
Exomoon: shows [Ah 7c] (a full house, Nines full of Sevens)
Exomoon collected 12425 from pot
inthebut said, "yes"
*** SUMMARY ***
Total pot 12425 | Rake 0=20
Board [9d 9s 9h 7s 4d]
Seat 1: LargeFarva99 (small blind) folded on the Turn
Seat 3: inthebut (big blind) showed [2h Ac] and lost with three of a ki=
nd, Nines
Seat 5: JJin91 folded before Flop (didn't bet)
Seat 6: JRoop029 folded before Flop (didn't bet)
Seat 7: Scooby-D0O folded before Flop (didn't bet)
Seat 8: Exomoon showed [Ah 7c] and won (12425) with a full house, Nines=
 full of Sevens
Seat 9: mmenz08816 (button) folded before Flop (didn't bet)


*********** # 115 **************
PokerStars Hand #175437545852: Tournament #1701793956, $18.20+$1.80 USD=
 Hold'em No Limit - Level XVII (700/1400) - 2017/09/23 22:06:15 ET
Table '1701793956 2' 9-max Seat #1 is the button
Seat 1: LargeFarva99 (128383 in chips)=20
Seat 3: inthebut (68830 in chips)=20
Seat 5: JJin91 (59259 in chips)=20
Seat 6: JRoop029 (34872 in chips)=20
Seat 7: Scooby-D0O (62780 in chips)=20
Seat 8: Exomoon (41600 in chips)=20
Seat 9: mmenz08816 (27140 in chips)=20
LargeFarva99: posts the ante 175
inthebut: posts the ante 175
JJin91: posts the ante 175
JRoop029: posts the ante 175
Scooby-D0O: posts the ante 175
Exomoon: posts the ante 175
mmenz08816: posts the ante 175
inthebut: posts small blind 700
JJin91: posts big blind 1400
*** HOLE CARDS ***
Dealt to JJin91 [5d Ts]
JRoop029: folds=20
Scooby-D0O: folds=20
Exomoon: folds=20
mmenz08816: folds=20
LargeFarva99: raises 1400 to 2800
inthebut: folds=20
JJin91: folds=20
Uncalled bet (1400) returned to LargeFarva99
LargeFarva99 collected 4725 from pot
LargeFarva99: doesn't show hand=20
*** SUMMARY ***
Total pot 4725 | Rake 0=20
Seat 1: LargeFarva99 (button) collected (4725)
Seat 3: inthebut (small blind) folded before Flop
Seat 5: JJin91 (big blind) folded before Flop
Seat 6: JRoop029 folded before Flop (didn't bet)
Seat 7: Scooby-D0O folded before Flop (didn't bet)
Seat 8: Exomoon folded before Flop (didn't bet)
Seat 9: mmenz08816 folded before Flop (didn't bet)


*********** # 116 **************
PokerStars Hand #175437545974: Tournament #1701793956, $18.20+$1.80 USD=
 Hold'em No Limit - Level XVII (700/1400) - 2017/09/23 22:06:43 ET
Table '1701793956 2' 9-max Seat #3 is the button
Seat 1: LargeFarva99 (131533 in chips)=20
Seat 3: inthebut (67955 in chips)=20
Seat 5: JJin91 (57684 in chips)=20
Seat 6: JRoop029 (34697 in chips)=20
Seat 7: Scooby-D0O (62605 in chips)=20
Seat 8: Exomoon (41425 in chips)=20
Seat 9: mmenz08816 (26965 in chips)=20
LargeFarva99: posts the ante 175
inthebut: posts the ante 175
JJin91: posts the ante 175
JRoop029: posts the ante 175
Scooby-D0O: posts the ante 175
Exomoon: posts the ante 175
mmenz08816: posts the ante 175
JJin91: posts small blind 700
JRoop029: posts big blind 1400
*** HOLE CARDS ***
Dealt to JJin91 [2d 4s]
Scooby-D0O: raises 2100 to 3500
Exomoon: folds=20
mmenz08816: folds=20
LargeFarva99: folds=20
inthebut: folds=20
JJin91: folds=20
JRoop029: calls 2100
*** FLOP *** [Ts Qd Ac]
JRoop029: checks=20
Scooby-D0O: bets 2678
JRoop029: folds=20
Uncalled bet (2678) returned to Scooby-D0O
Scooby-D0O collected 8925 from pot
*** SUMMARY ***
Total pot 8925 | Rake 0=20
Board [Ts Qd Ac]
Seat 1: LargeFarva99 folded before Flop (didn't bet)
Seat 3: inthebut (button) folded before Flop (didn't bet)
Seat 5: JJin91 (small blind) folded before Flop
Seat 6: JRoop029 (big blind) folded on the Flop
Seat 7: Scooby-D0O collected (8925)
Seat 8: Exomoon folded before Flop (didn't bet)
Seat 9: mmenz08816 folded before Flop (didn't bet)


*********** # 117 **************
PokerStars Hand #175437546128: Tournament #1701793956, $18.20+$1.80 USD=
 Hold'em No Limit - Level XVII (700/1400) - 2017/09/23 22:07:19 ET
Table '1701793956 2' 9-max Seat #5 is the button
Seat 1: LargeFarva99 (131358 in chips)=20
Seat 3: inthebut (67780 in chips)=20
Seat 5: JJin91 (56809 in chips)=20
Seat 6: JRoop029 (31022 in chips)=20
Seat 7: Scooby-D0O (67855 in chips)=20
Seat 8: Exomoon (41250 in chips)=20
Seat 9: mmenz08816 (26790 in chips)=20
LargeFarva99: posts the ante 175
inthebut: posts the ante 175
JJin91: posts the ante 175
JRoop029: posts the ante 175
Scooby-D0O: posts the ante 175
Exomoon: posts the ante 175
mmenz08816: posts the ante 175
JRoop029: posts small blind 700
Scooby-D0O: posts big blind 1400
*** HOLE CARDS ***
Dealt to JJin91 [5d 2d]
Exomoon: folds=20
mmenz08816: folds=20
LargeFarva99: folds=20
inthebut: calls 1400
JJin91: folds=20
JRoop029: calls 700
Scooby-D0O: checks=20
*** FLOP *** [Kc Qs 6s]
JRoop029: checks=20
Scooby-D0O: checks=20
inthebut: bets 1400
JRoop029: folds=20
Scooby-D0O: calls 1400
*** TURN *** [Kc Qs 6s] [Ad]
Scooby-D0O: checks=20
inthebut: bets 2800
Scooby-D0O: calls 2800
*** RIVER *** [Kc Qs 6s Ad] [Kd]
Scooby-D0O: checks=20
inthebut: checks=20
*** SHOW DOWN ***
Scooby-D0O: shows [4c Ac] (two pair, Aces and Kings)
inthebut: mucks hand=20
Scooby-D0O collected 13825 from pot
*** SUMMARY ***
Total pot 13825 | Rake 0=20
Board [Kc Qs 6s Ad Kd]
Seat 1: LargeFarva99 folded before Flop (didn't bet)
Seat 3: inthebut mucked [7d Jd]
Seat 5: JJin91 (button) folded before Flop (didn't bet)
Seat 6: JRoop029 (small blind) folded on the Flop
Seat 7: Scooby-D0O (big blind) showed [4c Ac] and won (13825) with two =
pair, Aces and Kings
Seat 8: Exomoon folded before Flop (didn't bet)
Seat 9: mmenz08816 folded before Flop (didn't bet)


*********** # 118 **************
PokerStars Hand #175437546353: Tournament #1701793956, $18.20+$1.80 USD=
 Hold'em No Limit - Level XVIII (800/1600) - 2017/09/23 22:08:10 ET
Table '1701793956 2' 9-max Seat #6 is the button
Seat 1: LargeFarva99 (131183 in chips)=20
Seat 3: inthebut (62005 in chips)=20
Seat 5: JJin91 (56634 in chips)=20
Seat 6: JRoop029 (29447 in chips)=20
Seat 7: Scooby-D0O (75905 in chips)=20
Seat 8: Exomoon (41075 in chips)=20
Seat 9: mmenz08816 (26615 in chips)=20
LargeFarva99: posts the ante 200
inthebut: posts the ante 200
JJin91: posts the ante 200
JRoop029: posts the ante 200
Scooby-D0O: posts the ante 200
Exomoon: posts the ante 200
mmenz08816: posts the ante 200
Scooby-D0O: posts small blind 800
Exomoon: posts big blind 1600
*** HOLE CARDS ***
Dealt to JJin91 [Qd 5s]
mmenz08816: folds=20
LargeFarva99: folds=20
inthebut: folds=20
JJin91: folds=20
JRoop029: folds=20
Scooby-D0O: raises 3200 to 4800
Exomoon: calls 3200
*** FLOP *** [Th Kd Ah]
Scooby-D0O: bets 3300
Exomoon: calls 3300
*** TURN *** [Th Kd Ah] [2c]
Scooby-D0O: checks=20
Exomoon: checks=20
*** RIVER *** [Th Kd Ah 2c] [5h]
Scooby-D0O: checks=20
Exomoon: checks=20
*** SHOW DOWN ***
Scooby-D0O: shows [Jd Jh] (a pair of Jacks)
Exomoon: mucks hand=20
Scooby-D0O collected 17600 from pot
*** SUMMARY ***
Total pot 17600 | Rake 0=20
Board [Th Kd Ah 2c 5h]
Seat 1: LargeFarva99 folded before Flop (didn't bet)
Seat 3: inthebut folded before Flop (didn't bet)
Seat 5: JJin91 folded before Flop (didn't bet)
Seat 6: JRoop029 (button) folded before Flop (didn't bet)
Seat 7: Scooby-D0O (small blind) showed [Jd Jh] and won (17600) with a =
pair of Jacks
Seat 8: Exomoon (big blind) mucked [9c 9s]
Seat 9: mmenz08816 folded before Flop (didn't bet)


*********** # 119 **************
PokerStars Hand #175437546481: Tournament #1701793956, $18.20+$1.80 USD=
 Hold'em No Limit - Level XVIII (800/1600) - 2017/09/23 22:08:42 ET
Table '1701793956 2' 9-max Seat #7 is the button
Seat 1: LargeFarva99 (130983 in chips)=20
Seat 3: inthebut (61805 in chips)=20
Seat 5: JJin91 (56434 in chips)=20
Seat 6: JRoop029 (29247 in chips)=20
Seat 7: Scooby-D0O (85205 in chips)=20
Seat 8: Exomoon (32775 in chips)=20
Seat 9: mmenz08816 (26415 in chips)=20
LargeFarva99: posts the ante 200
inthebut: posts the ante 200
JJin91: posts the ante 200
JRoop029: posts the ante 200
Scooby-D0O: posts the ante 200
Exomoon: posts the ante 200
mmenz08816: posts the ante 200
Exomoon: posts small blind 800
mmenz08816: posts big blind 1600
*** HOLE CARDS ***
Dealt to JJin91 [8d Ac]
LargeFarva99: folds=20
inthebut: folds=20
JJin91: raises 1872 to 3472
JRoop029: folds=20
Scooby-D0O: folds=20
Exomoon: folds=20
mmenz08816: calls 1872
*** FLOP *** [Qs As 8s]
mmenz08816: checks=20
JJin91: bets 4663
mmenz08816: calls 4663
*** TURN *** [Qs As 8s] [3c]
mmenz08816: checks=20
JJin91: bets 18470
mmenz08816: folds=20
Uncalled bet (18470) returned to JJin91
JJin91 collected 18470 from pot
JJin91: doesn't show hand=20
*** SUMMARY ***
Total pot 18470 | Rake 0=20
Board [Qs As 8s 3c]
Seat 1: LargeFarva99 folded before Flop (didn't bet)
Seat 3: inthebut folded before Flop (didn't bet)
Seat 5: JJin91 collected (18470)
Seat 6: JRoop029 folded before Flop (didn't bet)
Seat 7: Scooby-D0O (button) folded before Flop (didn't bet)
Seat 8: Exomoon (small blind) folded before Flop
Seat 9: mmenz08816 (big blind) folded on the Turn


*********** # 120 **************
PokerStars Hand #175437546697: Tournament #1701793956, $18.20+$1.80 USD=
 Hold'em No Limit - Level XVIII (800/1600) - 2017/09/23 22:09:37 ET
Table '1701793956 2' 9-max Seat #8 is the button
Seat 1: LargeFarva99 (130783 in chips)=20
Seat 3: inthebut (61605 in chips)=20
Seat 5: JJin91 (66569 in chips)=20
Seat 6: JRoop029 (29047 in chips)=20
Seat 7: Scooby-D0O (85005 in chips)=20
Seat 8: Exomoon (31775 in chips)=20
Seat 9: mmenz08816 (18080 in chips)=20
LargeFarva99: posts the ante 200
inthebut: posts the ante 200
JJin91: posts the ante 200
JRoop029: posts the ante 200
Scooby-D0O: posts the ante 200
Exomoon: posts the ante 200
mmenz08816: posts the ante 200
mmenz08816: posts small blind 800
LargeFarva99: posts big blind 1600
*** HOLE CARDS ***
Dealt to JJin91 [Js 6s]
inthebut: folds=20
JJin91: folds=20
JRoop029: folds=20
Scooby-D0O: folds=20
Exomoon: calls 1600
mmenz08816: calls 800
LargeFarva99: checks=20
*** FLOP *** [Qh 5h 5s]
mmenz08816: checks=20
LargeFarva99: checks=20
Exomoon: checks=20
*** TURN *** [Qh 5h 5s] [8d]
mmenz08816: checks=20
LargeFarva99: bets 3200
Exomoon: folds=20
mmenz08816: folds=20
Uncalled bet (3200) returned to LargeFarva99
LargeFarva99 collected 6200 from pot
LargeFarva99: doesn't show hand=20
*** SUMMARY ***
Total pot 6200 | Rake 0=20
Board [Qh 5h 5s 8d]
Seat 1: LargeFarva99 (big blind) collected (6200)
Seat 3: inthebut folded before Flop (didn't bet)
Seat 5: JJin91 folded before Flop (didn't bet)
Seat 6: JRoop029 folded before Flop (didn't bet)
Seat 7: Scooby-D0O folded before Flop (didn't bet)
Seat 8: Exomoon (button) folded on the Turn
Seat 9: mmenz08816 (small blind) folded on the Turn


*********** # 121 **************
PokerStars Hand #175437546857: Tournament #1701793956, $18.20+$1.80 USD=
 Hold'em No Limit - Level XVIII (800/1600) - 2017/09/23 22:10:15 ET
Table '1701793956 2' 9-max Seat #9 is the button
Seat 1: LargeFarva99 (135183 in chips)=20
Seat 3: inthebut (61405 in chips)=20
Seat 5: JJin91 (66369 in chips)=20
Seat 6: JRoop029 (28847 in chips)=20
Seat 7: Scooby-D0O (84805 in chips)=20
Seat 8: Exomoon (29975 in chips)=20
Seat 9: mmenz08816 (16280 in chips)=20
LargeFarva99: posts the ante 200
inthebut: posts the ante 200
JJin91: posts the ante 200
JRoop029: posts the ante 200
Scooby-D0O: posts the ante 200
Exomoon: posts the ante 200
mmenz08816: posts the ante 200
LargeFarva99: posts small blind 800
inthebut: posts big blind 1600
*** HOLE CARDS ***
Dealt to JJin91 [7s 6h]
JJin91: folds=20
JRoop029: folds=20
Scooby-D0O: raises 1920 to 3520
Exomoon: folds=20
mmenz08816: folds=20
LargeFarva99: folds=20
inthebut: calls 1920
*** FLOP *** [4s 2h 5d]
inthebut: bets 1600
Scooby-D0O: raises 3732 to 5332
inthebut: folds=20
Uncalled bet (3732) returned to Scooby-D0O
Scooby-D0O collected 12440 from pot
*** SUMMARY ***
Total pot 12440 | Rake 0=20
Board [4s 2h 5d]
Seat 1: LargeFarva99 (small blind) folded before Flop
Seat 3: inthebut (big blind) folded on the Flop
Seat 5: JJin91 folded before Flop (didn't bet)
Seat 6: JRoop029 folded before Flop (didn't bet)
Seat 7: Scooby-D0O collected (12440)
Seat 8: Exomoon folded before Flop (didn't bet)
Seat 9: mmenz08816 (button) folded before Flop (didn't bet)


*********** # 122 **************
PokerStars Hand #175437546976: Tournament #1701793956, $18.20+$1.80 USD=
 Hold'em No Limit - Level XVIII (800/1600) - 2017/09/23 22:10:47 ET
Table '1701793956 2' 9-max Seat #1 is the button
Seat 1: LargeFarva99 (134183 in chips)=20
Seat 3: inthebut (56085 in chips)=20
Seat 5: JJin91 (66169 in chips)=20
Seat 6: JRoop029 (28647 in chips)=20
Seat 7: Scooby-D0O (91925 in chips)=20
Seat 8: Exomoon (29775 in chips)=20
Seat 9: mmenz08816 (16080 in chips)=20
LargeFarva99: posts the ante 200
inthebut: posts the ante 200
JJin91: posts the ante 200
JRoop029: posts the ante 200
Scooby-D0O: posts the ante 200
Exomoon: posts the ante 200
mmenz08816: posts the ante 200
inthebut: posts small blind 800
JJin91: posts big blind 1600
*** HOLE CARDS ***
Dealt to JJin91 [4c 5h]
JRoop029: folds=20
Scooby-D0O: raises 1920 to 3520
Exomoon: folds=20
mmenz08816: raises 12360 to 15880 and is all-in
LargeFarva99: folds=20
inthebut: folds=20
JJin91: folds=20
Scooby-D0O: calls 12360
*** FLOP *** [9c Kd 2c]
*** TURN *** [9c Kd 2c] [Kc]
*** RIVER *** [9c Kd 2c Kc] [7d]
*** SHOW DOWN ***
Scooby-D0O: shows [Ah Qd] (a pair of Kings)
mmenz08816: shows [Ks As] (three of a kind, Kings)
mmenz08816 collected 35560 from pot
*** SUMMARY ***
Total pot 35560 | Rake 0=20
Board [9c Kd 2c Kc 7d]
Seat 1: LargeFarva99 (button) folded before Flop (didn't bet)
Seat 3: inthebut (small blind) folded before Flop
Seat 5: JJin91 (big blind) folded before Flop
Seat 6: JRoop029 folded before Flop (didn't bet)
Seat 7: Scooby-D0O showed [Ah Qd] and lost with a pair of Kings
Seat 8: Exomoon folded before Flop (didn't bet)
Seat 9: mmenz08816 showed [Ks As] and won (35560) with three of a kind,=
 Kings


*********** # 123 **************
PokerStars Hand #175437547083: Tournament #1701793956, $18.20+$1.80 USD=
 Hold'em No Limit - Level XVIII (800/1600) - 2017/09/23 22:11:13 ET
Table '1701793956 2' 9-max Seat #3 is the button
Seat 1: LargeFarva99 (133983 in chips)=20
Seat 3: inthebut (55085 in chips)=20
Seat 5: JJin91 (64369 in chips)=20
Seat 6: JRoop029 (28447 in chips)=20
Seat 7: Scooby-D0O (75845 in chips)=20
Seat 8: Exomoon (29575 in chips)=20
Seat 9: mmenz08816 (35560 in chips)=20
LargeFarva99: posts the ante 200
inthebut: posts the ante 200
JJin91: posts the ante 200
JRoop029: posts the ante 200
Scooby-D0O: posts the ante 200
Exomoon: posts the ante 200
mmenz08816: posts the ante 200
JJin91: posts small blind 800
JRoop029: posts big blind 1600
*** HOLE CARDS ***
Dealt to JJin91 [6h 3d]
Scooby-D0O: raises 1920 to 3520
Exomoon: folds=20
mmenz08816: folds=20
LargeFarva99: calls 3520
inthebut: folds=20
JJin91: folds=20
JRoop029: folds=20
*** FLOP *** [7d Kc Kh]
Scooby-D0O: bets 3252
LargeFarva99: calls 3252
*** TURN *** [7d Kc Kh] [2h]
Scooby-D0O: checks=20
LargeFarva99: checks=20
*** RIVER *** [7d Kc Kh 2h] [9s]
Scooby-D0O: checks=20
LargeFarva99: bets 8000
Scooby-D0O: calls 8000
*** SHOW DOWN ***
LargeFarva99: shows [6s 6d] (two pair, Kings and Sixes)
Scooby-D0O: shows [8h 8c] (two pair, Kings and Eights)
Scooby-D0O collected 33344 from pot
*** SUMMARY ***
Total pot 33344 | Rake 0=20
Board [7d Kc Kh 2h 9s]
Seat 1: LargeFarva99 showed [6s 6d] and lost with two pair, Kings and S=
ixes
Seat 3: inthebut (button) folded before Flop (didn't bet)
Seat 5: JJin91 (small blind) folded before Flop
Seat 6: JRoop029 (big blind) folded before Flop
Seat 7: Scooby-D0O showed [8h 8c] and won (33344) with two pair, Kings =
and Eights
Seat 8: Exomoon folded before Flop (didn't bet)
Seat 9: mmenz08816 folded before Flop (didn't bet)


*********** # 124 **************
PokerStars Hand #175437547288: Tournament #1701793956, $18.20+$1.80 USD=
 Hold'em No Limit - Level XVIII (800/1600) - 2017/09/23 22:12:02 ET
Table '1701793956 2' 9-max Seat #5 is the button
Seat 1: LargeFarva99 (119011 in chips)=20
Seat 3: inthebut (54885 in chips)=20
Seat 5: JJin91 (63369 in chips)=20
Seat 6: JRoop029 (26647 in chips)=20
Seat 7: Scooby-D0O (94217 in chips)=20
Seat 8: Exomoon (29375 in chips)=20
Seat 9: mmenz08816 (35360 in chips)=20
LargeFarva99: posts the ante 200
inthebut: posts the ante 200
JJin91: posts the ante 200
JRoop029: posts the ante 200
Scooby-D0O: posts the ante 200
Exomoon: posts the ante 200
mmenz08816: posts the ante 200
JRoop029: posts small blind 800
Scooby-D0O: posts big blind 1600
*** HOLE CARDS ***
Dealt to JJin91 [3d As]
Exomoon: folds=20
mmenz08816: folds=20
LargeFarva99: folds=20
inthebut: folds=20
JJin91: raises 1872 to 3472
JRoop029: folds=20
Scooby-D0O: calls 1872
*** FLOP *** [Qs Js Ad]
Scooby-D0O: checks=20
JJin91: bets 4663
Scooby-D0O: folds=20
Uncalled bet (4663) returned to JJin91
JJin91 collected 9144 from pot
JJin91: doesn't show hand=20
*** SUMMARY ***
Total pot 9144 | Rake 0=20
Board [Qs Js Ad]
Seat 1: LargeFarva99 folded before Flop (didn't bet)
Seat 3: inthebut folded before Flop (didn't bet)
Seat 5: JJin91 (button) collected (9144)
Seat 6: JRoop029 (small blind) folded before Flop
Seat 7: Scooby-D0O (big blind) folded on the Flop
Seat 8: Exomoon folded before Flop (didn't bet)
Seat 9: mmenz08816 folded before Flop (didn't bet)


*********** # 125 **************
PokerStars Hand #175437547419: Tournament #1701793956, $18.20+$1.80 USD=
 Hold'em No Limit - Level XVIII (800/1600) - 2017/09/23 22:12:35 ET
Table '1701793956 2' 9-max Seat #6 is the button
Seat 1: LargeFarva99 (118811 in chips)=20
Seat 3: inthebut (54685 in chips)=20
Seat 5: JJin91 (68841 in chips)=20
Seat 6: JRoop029 (25647 in chips)=20
Seat 7: Scooby-D0O (90545 in chips)=20
Seat 8: Exomoon (29175 in chips)=20
Seat 9: mmenz08816 (35160 in chips)=20
LargeFarva99: posts the ante 200
inthebut: posts the ante 200
JJin91: posts the ante 200
JRoop029: posts the ante 200
Scooby-D0O: posts the ante 200
Exomoon: posts the ante 200
mmenz08816: posts the ante 200
Scooby-D0O: posts small blind 800
Exomoon: posts big blind 1600
*** HOLE CARDS ***
Dealt to JJin91 [4h 9s]
mmenz08816: folds=20
LargeFarva99: folds=20
inthebut: raises 1600 to 3200
JJin91: folds=20
JRoop029: folds=20
Scooby-D0O: folds=20
Exomoon: calls 1600
*** FLOP *** [As 7s Qc]
Exomoon: checks=20
inthebut: bets 3200
Exomoon: folds=20
Uncalled bet (3200) returned to inthebut
inthebut collected 8600 from pot
inthebut: doesn't show hand=20
*** SUMMARY ***
Total pot 8600 | Rake 0=20
Board [As 7s Qc]
Seat 1: LargeFarva99 folded before Flop (didn't bet)
Seat 3: inthebut collected (8600)
Seat 5: JJin91 folded before Flop (didn't bet)
Seat 6: JRoop029 (button) folded before Flop (didn't bet)
Seat 7: Scooby-D0O (small blind) folded before Flop
Seat 8: Exomoon (big blind) folded on the Flop
Seat 9: mmenz08816 folded before Flop (didn't bet)


*********** # 126 **************
PokerStars Hand #175437547520: Tournament #1701793956, $18.20+$1.80 USD=
 Hold'em No Limit - Level XVIII (800/1600) - 2017/09/23 22:13:00 ET
Table '1701793956 2' 9-max Seat #7 is the button
Seat 1: LargeFarva99 (118611 in chips)=20
Seat 3: inthebut (59885 in chips)=20
Seat 5: JJin91 (68641 in chips)=20
Seat 6: JRoop029 (25447 in chips)=20
Seat 7: Scooby-D0O (89545 in chips)=20
Seat 8: Exomoon (25775 in chips)=20
Seat 9: mmenz08816 (34960 in chips)=20
LargeFarva99: posts the ante 200
inthebut: posts the ante 200
JJin91: posts the ante 200
JRoop029: posts the ante 200
Scooby-D0O: posts the ante 200
Exomoon: posts the ante 200
mmenz08816: posts the ante 200
Exomoon: posts small blind 800
mmenz08816: posts big blind 1600
*** HOLE CARDS ***
Dealt to JJin91 [4d 9d]
LargeFarva99: folds=20
inthebut: raises 1600 to 3200
JJin91: folds=20
JRoop029: folds=20
Scooby-D0O: folds=20
Exomoon: folds=20
mmenz08816: calls 1600
*** FLOP *** [5c 9s 5h]
mmenz08816: checks=20
inthebut: checks=20
*** TURN *** [5c 9s 5h] [Ad]
mmenz08816: checks=20
inthebut: bets 1600
mmenz08816: calls 1600
*** RIVER *** [5c 9s 5h Ad] [9h]
mmenz08816: checks=20
inthebut: bets 4800
mmenz08816: calls 4800
*** SHOW DOWN ***
inthebut: shows [As 8s] (two pair, Aces and Nines)
mmenz08816: mucks hand=20
inthebut collected 21400 from pot
*** SUMMARY ***
Total pot 21400 | Rake 0=20
Board [5c 9s 5h Ad 9h]
Seat 1: LargeFarva99 folded before Flop (didn't bet)
Seat 3: inthebut showed [As 8s] and won (21400) with two pair, Aces and=
 Nines
Seat 5: JJin91 folded before Flop (didn't bet)
Seat 6: JRoop029 folded before Flop (didn't bet)
Seat 7: Scooby-D0O (button) folded before Flop (didn't bet)
Seat 8: Exomoon (small blind) folded before Flop
Seat 9: mmenz08816 (big blind) mucked [Ah 6s]


*********** # 127 **************
PokerStars Hand #175437547642: Tournament #1701793956, $18.20+$1.80 USD=
 Hold'em No Limit - Level XVIII (800/1600) - 2017/09/23 22:13:28 ET
Table '1701793956 2' 9-max Seat #8 is the button
Seat 1: LargeFarva99 (118411 in chips)=20
Seat 3: inthebut (71485 in chips)=20
Seat 5: JJin91 (68441 in chips)=20
Seat 6: JRoop029 (25247 in chips)=20
Seat 7: Scooby-D0O (89345 in chips)=20
Seat 8: Exomoon (24775 in chips)=20
Seat 9: mmenz08816 (25160 in chips)=20
LargeFarva99: posts the ante 200
inthebut: posts the ante 200
JJin91: posts the ante 200
JRoop029: posts the ante 200
Scooby-D0O: posts the ante 200
Exomoon: posts the ante 200
mmenz08816: posts the ante 200
mmenz08816: posts small blind 800
LargeFarva99: posts big blind 1600
*** HOLE CARDS ***
Dealt to JJin91 [Kd 5c]
inthebut: raises 1600 to 3200
JJin91: folds=20
JRoop029: folds=20
Scooby-D0O: folds=20
Exomoon: calls 3200
mmenz08816: folds=20
LargeFarva99: calls 1600
*** FLOP *** [Jh 9d 3s]
LargeFarva99: checks=20
inthebut: bets 1600
Exomoon: calls 1600
LargeFarva99: calls 1600
*** TURN *** [Jh 9d 3s] [2h]
LargeFarva99: checks=20
inthebut: bets 3200
Exomoon: folds=20
LargeFarva99: calls 3200
*** RIVER *** [Jh 9d 3s 2h] [4d]
LargeFarva99: checks=20
inthebut: bets 1600
LargeFarva99: folds=20
Uncalled bet (1600) returned to inthebut
inthebut collected 23000 from pot
inthebut: doesn't show hand=20
*** SUMMARY ***
Total pot 23000 | Rake 0=20
Board [Jh 9d 3s 2h 4d]
Seat 1: LargeFarva99 (big blind) folded on the River
Seat 3: inthebut collected (23000)
Seat 5: JJin91 folded before Flop (didn't bet)
Seat 6: JRoop029 folded before Flop (didn't bet)
Seat 7: Scooby-D0O folded before Flop (didn't bet)
Seat 8: Exomoon (button) folded on the Turn
Seat 9: mmenz08816 (small blind) folded before Flop


*********** # 128 **************
PokerStars Hand #175437547886: Tournament #1701793956, $18.20+$1.80 USD=
 Hold'em No Limit - Level XVIII (800/1600) - 2017/09/23 22:14:33 ET
Table '1701793956 2' 9-max Seat #9 is the button
Seat 1: LargeFarva99 (110211 in chips)=20
Seat 3: inthebut (86285 in chips)=20
Seat 5: JJin91 (68241 in chips)=20
Seat 6: JRoop029 (25047 in chips)=20
Seat 7: Scooby-D0O (89145 in chips)=20
Seat 8: Exomoon (19775 in chips)=20
Seat 9: mmenz08816 (24160 in chips)=20
LargeFarva99: posts the ante 200
inthebut: posts the ante 200
JJin91: posts the ante 200
JRoop029: posts the ante 200
Scooby-D0O: posts the ante 200
Exomoon: posts the ante 200
mmenz08816: posts the ante 200
LargeFarva99: posts small blind 800
inthebut: posts big blind 1600
*** HOLE CARDS ***
Dealt to JJin91 [7h 9h]
JJin91: raises 1872 to 3472
JRoop029: folds=20
Scooby-D0O: folds=20
Exomoon: folds=20
mmenz08816: folds=20
LargeFarva99: folds=20
inthebut: folds=20
Uncalled bet (1872) returned to JJin91
JJin91 collected 5400 from pot
JJin91: doesn't show hand=20
*** SUMMARY ***
Total pot 5400 | Rake 0=20
Seat 1: LargeFarva99 (small blind) folded before Flop
Seat 3: inthebut (big blind) folded before Flop
Seat 5: JJin91 collected (5400)
Seat 6: JRoop029 folded before Flop (didn't bet)
Seat 7: Scooby-D0O folded before Flop (didn't bet)
Seat 8: Exomoon folded before Flop (didn't bet)
Seat 9: mmenz08816 (button) folded before Flop (didn't bet)


*********** # 129 **************
PokerStars Hand #175437547972: Tournament #1701793956, $18.20+$1.80 USD=
 Hold'em No Limit - Level XVIII (800/1600) - 2017/09/23 22:14:56 ET
Table '1701793956 2' 9-max Seat #1 is the button
Seat 1: LargeFarva99 (109211 in chips)=20
Seat 3: inthebut (84485 in chips)=20
Seat 5: JJin91 (71841 in chips)=20
Seat 6: JRoop029 (24847 in chips)=20
Seat 7: Scooby-D0O (88945 in chips)=20
Seat 8: Exomoon (19575 in chips)=20
Seat 9: mmenz08816 (23960 in chips)=20
LargeFarva99: posts the ante 200
inthebut: posts the ante 200
JJin91: posts the ante 200
JRoop029: posts the ante 200
Scooby-D0O: posts the ante 200
Exomoon: posts the ante 200
mmenz08816: posts the ante 200
inthebut: posts small blind 800
JJin91: posts big blind 1600
*** HOLE CARDS ***
Dealt to JJin91 [8d 6h]
JRoop029: raises 1600 to 3200
Scooby-D0O: calls 3200
Exomoon: folds=20
mmenz08816: folds=20
LargeFarva99: folds=20
inthebut: folds=20
JJin91: folds=20
*** FLOP *** [5h Qd 5c]
JRoop029: checks=20
Scooby-D0O: bets 3060
JRoop029: folds=20
Uncalled bet (3060) returned to Scooby-D0O
Scooby-D0O collected 10200 from pot
*** SUMMARY ***
Total pot 10200 | Rake 0=20
Board [5h Qd 5c]
Seat 1: LargeFarva99 (button) folded before Flop (didn't bet)
Seat 3: inthebut (small blind) folded before Flop
Seat 5: JJin91 (big blind) folded before Flop
Seat 6: JRoop029 folded on the Flop
Seat 7: Scooby-D0O collected (10200)
Seat 8: Exomoon folded before Flop (didn't bet)
Seat 9: mmenz08816 folded before Flop (didn't bet)


*********** # 130 **************
PokerStars Hand #175437548133: Tournament #1701793956, $18.20+$1.80 USD=
 Hold'em No Limit - Level XVIII (800/1600) - 2017/09/23 22:15:38 ET
Table '1701793956 2' 9-max Seat #3 is the button
Seat 1: LargeFarva99 (109011 in chips)=20
Seat 3: inthebut (83485 in chips)=20
Seat 5: JJin91 (70041 in chips)=20
Seat 7: Scooby-D0O (95745 in chips)=20
Seat 8: Exomoon (19375 in chips)=20
Seat 9: mmenz08816 (23760 in chips)=20
LargeFarva99: posts the ante 200
inthebut: posts the ante 200
JJin91: posts the ante 200
Scooby-D0O: posts the ante 200
Exomoon: posts the ante 200
mmenz08816: posts the ante 200
JJin91: posts small blind 800
Scooby-D0O: posts big blind 1600
*** HOLE CARDS ***
Dealt to JJin91 [7h Kc]
Exomoon: folds=20
mmenz08816: folds=20
LargeFarva99: folds=20
inthebut is connected=20
inthebut: raises 1600 to 3200
JJin91: raises 7034 to 10234
Scooby-D0O: folds=20
inthebut has timed out
inthebut: folds=20
Uncalled bet (7034) returned to JJin91
inthebut is sitting out
JJin91 collected 9200 from pot
JJin91: doesn't show hand=20
*** SUMMARY ***
Total pot 9200 | Rake 0=20
Seat 1: LargeFarva99 folded before Flop (didn't bet)
Seat 3: inthebut (button) folded before Flop
Seat 5: JJin91 (small blind) collected (9200)
Seat 7: Scooby-D0O (big blind) folded before Flop
Seat 8: Exomoon folded before Flop (didn't bet)
Seat 9: mmenz08816 folded before Flop (didn't bet)


*********** # 131 **************
PokerStars Hand #175437548367: Tournament #1701793956, $18.20+$1.80 USD=
 Hold'em No Limit - Level XVIII (800/1600) - 2017/09/23 22:16:42 ET
Table '1701793956 2' 9-max Seat #5 is the button
Seat 1: LargeFarva99 (108811 in chips)=20
Seat 2: cosm15 (68099 in chips)=20
Seat 3: inthebut (80085 in chips)=20
Seat 4: JRoop029 (19647 in chips)=20
Seat 5: JJin91 (75841 in chips)=20
Seat 6: Maelish (55930 in chips) out of hand (moved from another table =
into small blind)
Seat 7: Scooby-D0O (93945 in chips)=20
Seat 8: Exomoon (19175 in chips)=20
Seat 9: mmenz08816 (23560 in chips)=20
LargeFarva99: posts the ante 200
cosm15: posts the ante 200
inthebut: posts the ante 200
JRoop029: posts the ante 200
JJin91: posts the ante 200
Scooby-D0O: posts the ante 200
Exomoon: posts the ante 200
mmenz08816: posts the ante 200
Scooby-D0O: posts small blind 800
Exomoon: posts big blind 1600
*** HOLE CARDS ***
Dealt to JJin91 [6h Th]
mmenz08816: folds=20
LargeFarva99: folds=20
cosm15: folds=20
inthebut: folds=20
JRoop029: folds=20
JJin91: folds=20
Scooby-D0O: raises 92145 to 93745 and is all-in
Exomoon is disconnected=20
Exomoon has timed out while disconnected
Exomoon: folds=20
Uncalled bet (92145) returned to Scooby-D0O
Exomoon is sitting out
Scooby-D0O collected 4800 from pot
*** SUMMARY ***
Total pot 4800 | Rake 0=20
Seat 1: LargeFarva99 folded before Flop (didn't bet)
Seat 2: cosm15 folded before Flop (didn't bet)
Seat 3: inthebut folded before Flop (didn't bet)
Seat 4: JRoop029 folded before Flop (didn't bet)
Seat 5: JJin91 (button) folded before Flop (didn't bet)
Seat 7: Scooby-D0O (small blind) collected (4800)
Seat 8: Exomoon (big blind) folded before Flop
Seat 9: mmenz08816 folded before Flop (didn't bet)


*********** # 132 **************
PokerStars Hand #175437548629: Tournament #1701793956, $18.20+$1.80 USD=
 Hold'em No Limit - Level XVIII (800/1600) - 2017/09/23 22:17:50 ET
Table '1701793956 2' 9-max Seat #7 is the button
Seat 1: LargeFarva99 (108611 in chips)=20
Seat 2: cosm15 (67899 in chips)=20
Seat 3: inthebut (79885 in chips)=20
Seat 4: JRoop029 (19447 in chips)=20
Seat 5: JJin91 (75641 in chips)=20
Seat 6: Maelish (55930 in chips)=20
Seat 7: Scooby-D0O (96945 in chips)=20
Seat 8: Exomoon (17375 in chips) is sitting out
Seat 9: mmenz08816 (23360 in chips)=20
LargeFarva99: posts the ante 200
cosm15: posts the ante 200
inthebut: posts the ante 200
JRoop029: posts the ante 200
JJin91: posts the ante 200
Maelish: posts the ante 200
Scooby-D0O: posts the ante 200
Exomoon: posts the ante 200
mmenz08816: posts the ante 200
Exomoon: posts small blind 800
mmenz08816: posts big blind 1600
*** HOLE CARDS ***
Dealt to JJin91 [Tc Qs]
LargeFarva99: folds=20
cosm15: folds=20
inthebut: raises 3200 to 4800
JRoop029: folds=20
JJin91: folds=20
Maelish: folds=20
Scooby-D0O: folds=20
Exomoon: folds=20
mmenz08816: folds=20
Uncalled bet (3200) returned to inthebut
inthebut collected 5800 from pot
inthebut: doesn't show hand=20
*** SUMMARY ***
Total pot 5800 | Rake 0=20
Seat 1: LargeFarva99 folded before Flop (didn't bet)
Seat 2: cosm15 folded before Flop (didn't bet)
Seat 3: inthebut collected (5800)
Seat 4: JRoop029 folded before Flop (didn't bet)
Seat 5: JJin91 folded before Flop (didn't bet)
Seat 6: Maelish folded before Flop (didn't bet)
Seat 7: Scooby-D0O (button) folded before Flop (didn't bet)
Seat 8: Exomoon (small blind) folded before Flop
Seat 9: mmenz08816 (big blind) folded before Flop


*********** # 133 **************
PokerStars Hand #175437548716: Tournament #1701793956, $18.20+$1.80 USD=
 Hold'em No Limit - Level XIX (1000/2000) - 2017/09/23 22:18:18 ET
Table '1701793956 2' 9-max Seat #8 is the button
Seat 1: LargeFarva99 (108411 in chips)=20
Seat 2: cosm15 (67699 in chips)=20
Seat 3: inthebut (83885 in chips)=20
Seat 4: JRoop029 (19247 in chips)=20
Seat 5: JJin91 (75441 in chips)=20
Seat 6: Maelish (55730 in chips)=20
Seat 7: Scooby-D0O (96745 in chips)=20
Seat 8: Exomoon (16375 in chips) is sitting out
Seat 9: mmenz08816 (21560 in chips)=20
LargeFarva99: posts the ante 250
cosm15: posts the ante 250
inthebut: posts the ante 250
JRoop029: posts the ante 250
JJin91: posts the ante 250
Maelish: posts the ante 250
Scooby-D0O: posts the ante 250
Exomoon: posts the ante 250
mmenz08816: posts the ante 250
mmenz08816: posts small blind 1000
LargeFarva99: posts big blind 2000
*** HOLE CARDS ***
Dealt to JJin91 [2s 5s]
cosm15: folds=20
inthebut: folds=20
JRoop029: folds=20
JJin91: folds=20
Maelish: folds=20
Scooby-D0O: raises 3000 to 5000
Exomoon: folds=20
mmenz08816: folds=20
LargeFarva99: calls 3000
*** FLOP *** [8c 8h Kh]
LargeFarva99: checks=20
Scooby-D0O: bets 3975
LargeFarva99: folds=20
Uncalled bet (3975) returned to Scooby-D0O
Scooby-D0O collected 13250 from pot
Scooby-D0O: doesn't show hand=20
*** SUMMARY ***
Total pot 13250 | Rake 0=20
Board [8c 8h Kh]
Seat 1: LargeFarva99 (big blind) folded on the Flop
Seat 2: cosm15 folded before Flop (didn't bet)
Seat 3: inthebut folded before Flop (didn't bet)
Seat 4: JRoop029 folded before Flop (didn't bet)
Seat 5: JJin91 folded before Flop (didn't bet)
Seat 6: Maelish folded before Flop (didn't bet)
Seat 7: Scooby-D0O collected (13250)
Seat 8: Exomoon (button) folded before Flop (didn't bet)
Seat 9: mmenz08816 (small blind) folded before Flop


*********** # 134 **************
PokerStars Hand #175437548833: Tournament #1701793956, $18.20+$1.80 USD=
 Hold'em No Limit - Level XIX (1000/2000) - 2017/09/23 22:18:48 ET
Table '1701793956 2' 9-max Seat #9 is the button
Seat 1: LargeFarva99 (103161 in chips)=20
Seat 2: cosm15 (67449 in chips)=20
Seat 3: inthebut (83635 in chips)=20
Seat 4: JRoop029 (18997 in chips)=20
Seat 5: JJin91 (75191 in chips)=20
Seat 6: Maelish (55480 in chips)=20
Seat 7: Scooby-D0O (104745 in chips)=20
Seat 8: Exomoon (16125 in chips) is sitting out
Seat 9: mmenz08816 (20310 in chips)=20
LargeFarva99: posts the ante 250
cosm15: posts the ante 250
inthebut: posts the ante 250
JRoop029: posts the ante 250
JJin91: posts the ante 250
Maelish: posts the ante 250
Scooby-D0O: posts the ante 250
Exomoon: posts the ante 250
mmenz08816: posts the ante 250
LargeFarva99: posts small blind 1000
cosm15: posts big blind 2000
*** HOLE CARDS ***
Dealt to JJin91 [2s 3h]
inthebut: raises 4000 to 6000
JRoop029: folds=20
JJin91: folds=20
Maelish: folds=20
Scooby-D0O: folds=20
Exomoon: folds=20
mmenz08816: folds=20
LargeFarva99: folds=20
cosm15: folds=20
Uncalled bet (4000) returned to inthebut
inthebut collected 7250 from pot
inthebut: doesn't show hand=20
*** SUMMARY ***
Total pot 7250 | Rake 0=20
Seat 1: LargeFarva99 (small blind) folded before Flop
Seat 2: cosm15 (big blind) folded before Flop
Seat 3: inthebut collected (7250)
Seat 4: JRoop029 folded before Flop (didn't bet)
Seat 5: JJin91 folded before Flop (didn't bet)
Seat 6: Maelish folded before Flop (didn't bet)
Seat 7: Scooby-D0O folded before Flop (didn't bet)
Seat 8: Exomoon folded before Flop (didn't bet)
Seat 9: mmenz08816 (button) folded before Flop (didn't bet)


*********** # 135 **************
PokerStars Hand #175437548923: Tournament #1701793956, $18.20+$1.80 USD=
 Hold'em No Limit - Level XIX (1000/2000) - 2017/09/23 22:19:15 ET
Table '1701793956 2' 9-max Seat #1 is the button
Seat 1: LargeFarva99 (101911 in chips)=20
Seat 2: cosm15 (65199 in chips)=20
Seat 3: inthebut (88635 in chips)=20
Seat 4: JRoop029 (18747 in chips)=20
Seat 5: JJin91 (74941 in chips)=20
Seat 6: Maelish (55230 in chips)=20
Seat 7: Scooby-D0O (104495 in chips)=20
Seat 8: Exomoon (15875 in chips) is sitting out
Seat 9: mmenz08816 (20060 in chips)=20
LargeFarva99: posts the ante 250
cosm15: posts the ante 250
inthebut: posts the ante 250
JRoop029: posts the ante 250
JJin91: posts the ante 250
Maelish: posts the ante 250
Scooby-D0O: posts the ante 250
Exomoon: posts the ante 250
mmenz08816: posts the ante 250
cosm15: posts small blind 1000
inthebut: posts big blind 2000
*** HOLE CARDS ***
Dealt to JJin91 [Qc 3d]
JRoop029: folds=20
JJin91: folds=20
Maelish: folds=20
Scooby-D0O: folds=20
Exomoon: folds=20
mmenz08816: raises 17810 to 19810 and is all-in
LargeFarva99: folds=20
cosm15: folds=20
inthebut: calls 17810
*** FLOP *** [7h Tc 4d]
*** TURN *** [7h Tc 4d] [7c]
*** RIVER *** [7h Tc 4d 7c] [4h]
*** SHOW DOWN ***
inthebut: shows [9s 9h] (two pair, Nines and Sevens)
mmenz08816: shows [8s 7s] (a full house, Sevens full of Fours)
mmenz08816 collected 42870 from pot
*** SUMMARY ***
Total pot 42870 | Rake 0=20
Board [7h Tc 4d 7c 4h]
Seat 1: LargeFarva99 (button) folded before Flop (didn't bet)
Seat 2: cosm15 (small blind) folded before Flop
Seat 3: inthebut (big blind) showed [9s 9h] and lost with two pair, Nin=
es and Sevens
Seat 4: JRoop029 folded before Flop (didn't bet)
Seat 5: JJin91 folded before Flop (didn't bet)
Seat 6: Maelish folded before Flop (didn't bet)
Seat 7: Scooby-D0O folded before Flop (didn't bet)
Seat 8: Exomoon folded before Flop (didn't bet)
Seat 9: mmenz08816 showed [8s 7s] and won (42870) with a full house, Se=
vens full of Fours


*********** # 136 **************
PokerStars Hand #175437549025: Tournament #1701793956, $18.20+$1.80 USD=
 Hold'em No Limit - Level XIX (1000/2000) - 2017/09/23 22:19:40 ET
Table '1701793956 2' 9-max Seat #2 is the button
Seat 1: LargeFarva99 (101661 in chips)=20
Seat 2: cosm15 (63949 in chips)=20
Seat 3: inthebut (68575 in chips)=20
Seat 4: JRoop029 (18497 in chips)=20
Seat 5: JJin91 (74691 in chips)=20
Seat 6: Maelish (54980 in chips)=20
Seat 7: Scooby-D0O (104245 in chips)=20
Seat 8: Exomoon (15625 in chips) is sitting out
Seat 9: mmenz08816 (42870 in chips)=20
LargeFarva99: posts the ante 250
cosm15: posts the ante 250
inthebut: posts the ante 250
JRoop029: posts the ante 250
JJin91: posts the ante 250
Maelish: posts the ante 250
Scooby-D0O: posts the ante 250
Exomoon: posts the ante 250
mmenz08816: posts the ante 250
inthebut: posts small blind 1000
JRoop029: posts big blind 2000
*** HOLE CARDS ***
Dealt to JJin91 [Ts 7h]
inthebut said, "bs"
JJin91: folds=20
Maelish: folds=20
Scooby-D0O: folds=20
Exomoon: folds=20
mmenz08816: raises 2400 to 4400
LargeFarva99: calls 4400
cosm15: folds=20
inthebut: raises 2400 to 6800
JRoop029: folds=20
mmenz08816: calls 2400
LargeFarva99: raises 37200 to 44000
inthebut: folds=20
mmenz08816: folds=20
Uncalled bet (37200) returned to LargeFarva99
LargeFarva99 collected 24650 from pot
LargeFarva99: doesn't show hand=20
*** SUMMARY ***
Total pot 24650 | Rake 0=20
Seat 1: LargeFarva99 collected (24650)
Seat 2: cosm15 (button) folded before Flop (didn't bet)
Seat 3: inthebut (small blind) folded before Flop
Seat 4: JRoop029 (big blind) folded before Flop
Seat 5: JJin91 folded before Flop (didn't bet)
Seat 6: Maelish folded before Flop (didn't bet)
Seat 7: Scooby-D0O folded before Flop (didn't bet)
Seat 8: Exomoon folded before Flop (didn't bet)
Seat 9: mmenz08816 folded before Flop


*********** # 137 **************
PokerStars Hand #175437549187: Tournament #1701793956, $18.20+$1.80 USD=
 Hold'em No Limit - Level XIX (1000/2000) - 2017/09/23 22:20:28 ET
Table '1701793956 2' 9-max Seat #3 is the button
Seat 1: LargeFarva99 (119261 in chips)=20
Seat 2: cosm15 (63699 in chips)=20
Seat 3: inthebut (61525 in chips)=20
Seat 4: JRoop029 (16247 in chips)=20
Seat 5: JJin91 (74441 in chips)=20
Seat 6: Maelish (54730 in chips)=20
Seat 7: Scooby-D0O (103995 in chips)=20
Seat 8: Exomoon (15375 in chips) is sitting out
Seat 9: mmenz08816 (35820 in chips)=20
LargeFarva99: posts the ante 250
cosm15: posts the ante 250
inthebut: posts the ante 250
JRoop029: posts the ante 250
JJin91: posts the ante 250
Maelish: posts the ante 250
Scooby-D0O: posts the ante 250
Exomoon: posts the ante 250
mmenz08816: posts the ante 250
JRoop029: posts small blind 1000
JJin91: posts big blind 2000
*** HOLE CARDS ***
Dealt to JJin91 [3h 8d]
Maelish: raises 2400 to 4400
Scooby-D0O: calls 4400
Exomoon: folds=20
mmenz08816: folds=20
LargeFarva99: folds=20
cosm15: folds=20
inthebut has timed out while being disconnected
inthebut: folds=20
inthebut is sitting out
JRoop029: folds=20
inthebut is disconnected=20
JJin91: calls 2400
*** FLOP *** [2d 9c Kh]
JJin91: checks=20
Maelish: checks=20
Scooby-D0O: bets 7238
JJin91: folds=20
inthebut has returned
Maelish: folds=20
Uncalled bet (7238) returned to Scooby-D0O
Scooby-D0O collected 16450 from pot
*** SUMMARY ***
Total pot 16450 | Rake 0=20
Board [2d 9c Kh]
Seat 1: LargeFarva99 folded before Flop (didn't bet)
Seat 2: cosm15 folded before Flop (didn't bet)
Seat 3: inthebut (button) folded before Flop (didn't bet)
Seat 4: JRoop029 (small blind) folded before Flop
Seat 5: JJin91 (big blind) folded on the Flop
Seat 6: Maelish folded on the Flop
Seat 7: Scooby-D0O collected (16450)
Seat 8: Exomoon folded before Flop (didn't bet)
Seat 9: mmenz08816 folded before Flop (didn't bet)


*********** # 138 **************
PokerStars Hand #175437549459: Tournament #1701793956, $18.20+$1.80 USD=
 Hold'em No Limit - Level XIX (1000/2000) - 2017/09/23 22:21:42 ET
Table '1701793956 2' 9-max Seat #4 is the button
Seat 1: LargeFarva99 (119011 in chips)=20
Seat 2: cosm15 (63449 in chips)=20
Seat 3: inthebut (61275 in chips)=20
Seat 4: JRoop029 (14997 in chips)=20
Seat 5: JJin91 (69791 in chips)=20
Seat 6: Maelish (50080 in chips)=20
Seat 7: Scooby-D0O (115795 in chips)=20
Seat 9: mmenz08816 (35570 in chips)=20
LargeFarva99: posts the ante 250
cosm15: posts the ante 250
inthebut: posts the ante 250
JRoop029: posts the ante 250
JJin91: posts the ante 250
Maelish: posts the ante 250
Scooby-D0O: posts the ante 250
mmenz08816: posts the ante 250
JJin91: posts small blind 1000
Maelish: posts big blind 2000
*** HOLE CARDS ***
Dealt to JJin91 [Th Ah]
Scooby-D0O: folds=20
mmenz08816: folds=20
LargeFarva99: raises 2000 to 4000
cosm15: raises 6000 to 10000
inthebut: folds=20
JRoop029: folds=20
JJin91: folds=20
Maelish: folds=20
LargeFarva99: folds=20
Uncalled bet (6000) returned to cosm15
cosm15 collected 13000 from pot
cosm15: doesn't show hand=20
*** SUMMARY ***
Total pot 13000 | Rake 0=20
Seat 1: LargeFarva99 folded before Flop
Seat 2: cosm15 collected (13000)
Seat 3: inthebut folded before Flop (didn't bet)
Seat 4: JRoop029 (button) folded before Flop (didn't bet)
Seat 5: JJin91 (small blind) folded before Flop
Seat 6: Maelish (big blind) folded before Flop
Seat 7: Scooby-D0O folded before Flop (didn't bet)
Seat 9: mmenz08816 folded before Flop (didn't bet)


*********** # 139 **************
PokerStars Hand #175437549625: Tournament #1701793956, $18.20+$1.80 USD=
 Hold'em No Limit - Level XIX (1000/2000) - 2017/09/23 22:22:25 ET
Table '1701793956 2' 9-max Seat #5 is the button
Seat 1: LargeFarva99 (114761 in chips)=20
Seat 2: cosm15 (72199 in chips)=20
Seat 3: inthebut (61025 in chips)=20
Seat 4: JRoop029 (14747 in chips)=20
Seat 5: JJin91 (68541 in chips)=20
Seat 6: Maelish (47830 in chips)=20
Seat 7: Scooby-D0O (115545 in chips)=20
Seat 9: mmenz08816 (35320 in chips)=20
LargeFarva99: posts the ante 250
cosm15: posts the ante 250
inthebut: posts the ante 250
JRoop029: posts the ante 250
JJin91: posts the ante 250
Maelish: posts the ante 250
Scooby-D0O: posts the ante 250
mmenz08816: posts the ante 250
Maelish: posts small blind 1000
Scooby-D0O: posts big blind 2000
*** HOLE CARDS ***
Dealt to JJin91 [Qc Td]
mmenz08816: folds=20
LargeFarva99: folds=20
cosm15: folds=20
inthebut: folds=20
JRoop029: folds=20
JJin91: raises 2340 to 4340
Maelish: folds=20
Scooby-D0O: calls 2340
*** FLOP *** [9h 2c 9d]
Scooby-D0O: checks=20
JJin91: checks=20
*** TURN *** [9h 2c 9d] [8d]
Scooby-D0O: bets 3504
JJin91: calls 3504
*** RIVER *** [9h 2c 9d 8d] [Qs]
Scooby-D0O: checks=20
JJin91: bets 8888
Scooby-D0O: calls 8888
*** SHOW DOWN ***
JJin91: shows [Qc Td] (two pair, Queens and Nines)
Scooby-D0O: mucks hand=20
JJin91 collected 36464 from pot
*** SUMMARY ***
Total pot 36464 | Rake 0=20
Board [9h 2c 9d 8d Qs]
Seat 1: LargeFarva99 folded before Flop (didn't bet)
Seat 2: cosm15 folded before Flop (didn't bet)
Seat 3: inthebut folded before Flop (didn't bet)
Seat 4: JRoop029 folded before Flop (didn't bet)
Seat 5: JJin91 (button) showed [Qc Td] and won (36464) with two pair, Q=
ueens and Nines
Seat 6: Maelish (small blind) folded before Flop
Seat 7: Scooby-D0O (big blind) mucked [8c 5c]
Seat 9: mmenz08816 folded before Flop (didn't bet)


*********** # 140 **************
PokerStars Hand #175437549910: Tournament #1701793956, $18.20+$1.80 USD=
 Hold'em No Limit - Level XIX (1000/2000) - 2017/09/23 22:23:37 ET
Table '1701793956 2' 9-max Seat #6 is the button
Seat 1: LargeFarva99 (114511 in chips)=20
Seat 2: cosm15 (71949 in chips)=20
Seat 3: inthebut (60775 in chips)=20
Seat 4: JRoop029 (14497 in chips)=20
Seat 5: JJin91 (88023 in chips)=20
Seat 6: Maelish (46580 in chips)=20
Seat 7: Scooby-D0O (98563 in chips)=20
Seat 9: mmenz08816 (35070 in chips)=20
LargeFarva99: posts the ante 250
cosm15: posts the ante 250
inthebut: posts the ante 250
JRoop029: posts the ante 250
JJin91: posts the ante 250
Maelish: posts the ante 250
Scooby-D0O: posts the ante 250
mmenz08816: posts the ante 250
Scooby-D0O: posts small blind 1000
mmenz08816: posts big blind 2000
*** HOLE CARDS ***
Dealt to JJin91 [Ac 5h]
LargeFarva99: calls 2000
cosm15: folds=20
inthebut: folds=20
JRoop029: folds=20
JJin91: folds=20
Maelish: folds=20
Scooby-D0O: calls 1000
mmenz08816: checks=20
*** FLOP *** [3s 9c Th]
Scooby-D0O: checks=20
mmenz08816: checks=20
LargeFarva99: bets 4000
Scooby-D0O: folds=20
mmenz08816: folds=20
Uncalled bet (4000) returned to LargeFarva99
LargeFarva99 collected 8000 from pot
LargeFarva99: doesn't show hand=20
*** SUMMARY ***
Total pot 8000 | Rake 0=20
Board [3s 9c Th]
Seat 1: LargeFarva99 collected (8000)
Seat 2: cosm15 folded before Flop (didn't bet)
Seat 3: inthebut folded before Flop (didn't bet)
Seat 4: JRoop029 folded before Flop (didn't bet)
Seat 5: JJin91 folded before Flop (didn't bet)
Seat 6: Maelish (button) folded before Flop (didn't bet)
Seat 7: Scooby-D0O (small blind) folded on the Flop
Seat 9: mmenz08816 (big blind) folded on the Flop


*********** # 141 **************
PokerStars Hand #175438316770: Tournament #1701793956, $18.20+$1.80 USD=
 Hold'em No Limit - Level XIX (1000/2000) - 2017/09/23 22:24:22 ET
Table '1701793956 2' 9-max Seat #7 is the button
Seat 1: LargeFarva99 (120261 in chips)=20
Seat 2: cosm15 (71699 in chips)=20
Seat 3: inthebut (60525 in chips)=20
Seat 4: JRoop029 (14247 in chips)=20
Seat 5: JJin91 (87773 in chips)=20
Seat 6: Maelish (46330 in chips)=20
Seat 7: Scooby-D0O (96313 in chips)=20
Seat 9: mmenz08816 (32820 in chips)=20
LargeFarva99: posts the ante 250
cosm15: posts the ante 250
inthebut: posts the ante 250
JRoop029: posts the ante 250
JJin91: posts the ante 250
Maelish: posts the ante 250
Scooby-D0O: posts the ante 250
mmenz08816: posts the ante 250
mmenz08816: posts small blind 1000
LargeFarva99: posts big blind 2000
*** HOLE CARDS ***
Dealt to JJin91 [Ks Qs]
cosm15: folds=20
inthebut: raises 2000 to 4000
JRoop029: folds=20
JJin91: calls 4000
Maelish: folds=20
Scooby-D0O: folds=20
mmenz08816: folds=20
LargeFarva99: calls 2000
*** FLOP *** [Ad Qd Th]
LargeFarva99: checks=20
inthebut: bets 56275 and is all-in
JJin91: folds=20
LargeFarva99: folds=20
Uncalled bet (56275) returned to inthebut
inthebut collected 15000 from pot
inthebut: doesn't show hand=20
*** SUMMARY ***
Total pot 15000 | Rake 0=20
Board [Ad Qd Th]
Seat 1: LargeFarva99 (big blind) folded on the Flop
Seat 2: cosm15 folded before Flop (didn't bet)
Seat 3: inthebut collected (15000)
Seat 4: JRoop029 folded before Flop (didn't bet)
Seat 5: JJin91 folded on the Flop
Seat 6: Maelish folded before Flop (didn't bet)
Seat 7: Scooby-D0O (button) folded before Flop (didn't bet)
Seat 9: mmenz08816 (small blind) folded before Flop


*********** # 142 **************
PokerStars Hand #175438316919: Tournament #1701793956, $18.20+$1.80 USD=
 Hold'em No Limit - Level XIX (1000/2000) - 2017/09/23 22:25:03 ET
Table '1701793956 2' 9-max Seat #9 is the button
Seat 1: LargeFarva99 (116011 in chips)=20
Seat 2: cosm15 (71449 in chips)=20
Seat 3: inthebut (71275 in chips)=20
Seat 4: JRoop029 (13997 in chips)=20
Seat 5: JJin91 (83523 in chips)=20
Seat 6: Maelish (46080 in chips)=20
Seat 7: Scooby-D0O (96063 in chips)=20
Seat 9: mmenz08816 (31570 in chips)=20
LargeFarva99: posts the ante 250
cosm15: posts the ante 250
inthebut: posts the ante 250
JRoop029: posts the ante 250
JJin91: posts the ante 250
Maelish: posts the ante 250
Scooby-D0O: posts the ante 250
mmenz08816: posts the ante 250
LargeFarva99: posts small blind 1000
cosm15: posts big blind 2000
*** HOLE CARDS ***
Dealt to JJin91 [2h 2s]
inthebut: calls 2000
JRoop029: raises 11747 to 13747 and is all-in
JJin91: folds=20
Maelish: folds=20
Scooby-D0O: folds=20
mmenz08816: folds=20
LargeFarva99: folds=20
cosm15: folds=20
inthebut: calls 11747
*** FLOP *** [Qd 5d Qs]
*** TURN *** [Qd 5d Qs] [3h]
*** RIVER *** [Qd 5d Qs 3h] [Jc]
*** SHOW DOWN ***
inthebut: shows [Kd Qh] (three of a kind, Queens)
JRoop029: shows [Ac 8c] (a pair of Queens)
inthebut collected 32494 from pot
JRoop029 finished the tournament in 16th place and received $42.16.
*** SUMMARY ***
Total pot 32494 | Rake 0=20
Board [Qd 5d Qs 3h Jc]
Seat 1: LargeFarva99 (small blind) folded before Flop
Seat 2: cosm15 (big blind) folded before Flop
Seat 3: inthebut showed [Kd Qh] and won (32494) with three of a kind, Q=
ueens
Seat 4: JRoop029 showed [Ac 8c] and lost with a pair of Queens
Seat 5: JJin91 folded before Flop (didn't bet)
Seat 6: Maelish folded before Flop (didn't bet)
Seat 7: Scooby-D0O folded before Flop (didn't bet)
Seat 9: mmenz08816 (button) folded before Flop (didn't bet)


*********** # 143 **************
PokerStars Hand #175438317073: Tournament #1701793956, $18.20+$1.80 USD=
 Hold'em No Limit - Level XIX (1000/2000) - 2017/09/23 22:25:40 ET
Table '1701793956 2' 9-max Seat #1 is the button
Seat 1: LargeFarva99 (114761 in chips)=20
Seat 2: cosm15 (69199 in chips)=20
Seat 3: inthebut (89772 in chips)=20
Seat 5: JJin91 (83273 in chips)=20
Seat 6: Maelish (45830 in chips)=20
Seat 7: Scooby-D0O (95813 in chips)=20
Seat 9: mmenz08816 (31320 in chips)=20
LargeFarva99: posts the ante 250
cosm15: posts the ante 250
inthebut: posts the ante 250
JJin91: posts the ante 250
Maelish: posts the ante 250
Scooby-D0O: posts the ante 250
mmenz08816: posts the ante 250
cosm15: posts small blind 1000
inthebut: posts big blind 2000
*** HOLE CARDS ***
Dealt to JJin91 [Kc 8h]
JJin91: folds=20
Maelish: folds=20
Scooby-D0O: folds=20
mmenz08816: folds=20
LargeFarva99: raises 2000 to 4000
cosm15: calls 3000
inthebut: folds=20
*** FLOP *** [8c As 6h]
cosm15: checks=20
LargeFarva99: checks=20
*** TURN *** [8c As 6h] [8s]
cosm15: bets 4000
LargeFarva99: calls 4000
*** RIVER *** [8c As 6h 8s] [Jd]
cosm15: checks=20
LargeFarva99: bets 10000
cosm15: folds=20
Uncalled bet (10000) returned to LargeFarva99
LargeFarva99 collected 19750 from pot
LargeFarva99: doesn't show hand=20
*** SUMMARY ***
Total pot 19750 | Rake 0=20
Board [8c As 6h 8s Jd]
Seat 1: LargeFarva99 (button) collected (19750)
Seat 2: cosm15 (small blind) folded on the River
Seat 3: inthebut (big blind) folded before Flop
Seat 5: JJin91 folded before Flop (didn't bet)
Seat 6: Maelish folded before Flop (didn't bet)
Seat 7: Scooby-D0O folded before Flop (didn't bet)
Seat 9: mmenz08816 folded before Flop (didn't bet)


*********** # 144 **************
PokerStars Hand #175438317308: Tournament #1701793956, $18.20+$1.80 USD=
 Hold'em No Limit - Level XIX (1000/2000) - 2017/09/23 22:26:39 ET
Table '1701793956 2' 9-max Seat #2 is the button
Seat 1: LargeFarva99 (126261 in chips)=20
Seat 2: cosm15 (60949 in chips)=20
Seat 3: inthebut (87522 in chips)=20
Seat 5: JJin91 (83023 in chips)=20
Seat 6: Maelish (45580 in chips)=20
Seat 7: Scooby-D0O (95563 in chips)=20
Seat 9: mmenz08816 (31070 in chips)=20
LargeFarva99: posts the ante 250
cosm15: posts the ante 250
inthebut: posts the ante 250
JJin91: posts the ante 250
Maelish: posts the ante 250
Scooby-D0O: posts the ante 250
mmenz08816: posts the ante 250
inthebut: posts small blind 1000
JJin91: posts big blind 2000
*** HOLE CARDS ***
Dealt to JJin91 [Js 2h]
Maelish: folds=20
Scooby-D0O: folds=20
mmenz08816: folds=20
LargeFarva99: calls 2000
cosm15: folds=20
inthebut: raises 4000 to 6000
JJin91: folds=20
LargeFarva99: calls 4000
*** FLOP *** [7s Ks Ah]
inthebut: checks=20
LargeFarva99: checks=20
*** TURN *** [7s Ks Ah] [8c]
inthebut: bets 2000
LargeFarva99: calls 2000
*** RIVER *** [7s Ks Ah 8c] [2d]
inthebut: bets 4000
LargeFarva99: raises 6000 to 10000
inthebut: calls 6000
*** SHOW DOWN ***
LargeFarva99: shows [9s 8d] (a pair of Eights)
inthebut: shows [Jd Jc] (a pair of Jacks)
inthebut collected 39750 from pot
*** SUMMARY ***
Total pot 39750 | Rake 0=20
Board [7s Ks Ah 8c 2d]
Seat 1: LargeFarva99 showed [9s 8d] and lost with a pair of Eights
Seat 2: cosm15 (button) folded before Flop (didn't bet)
Seat 3: inthebut (small blind) showed [Jd Jc] and won (39750) with a pa=
ir of Jacks
Seat 5: JJin91 (big blind) folded before Flop
Seat 6: Maelish folded before Flop (didn't bet)
Seat 7: Scooby-D0O folded before Flop (didn't bet)
Seat 9: mmenz08816 folded before Flop (didn't bet)


*********** # 145 **************
PokerStars Hand #175438317511: Tournament #1701793956, $18.20+$1.80 USD=
 Hold'em No Limit - Level XIX (1000/2000) - 2017/09/23 22:27:29 ET
Table '1701793956 2' 9-max Seat #3 is the button
Seat 1: LargeFarva99 (108011 in chips)=20
Seat 2: cosm15 (60699 in chips)=20
Seat 3: inthebut (109022 in chips)=20
Seat 5: JJin91 (80773 in chips)=20
Seat 6: Maelish (45330 in chips)=20
Seat 7: Scooby-D0O (95313 in chips)=20
Seat 9: mmenz08816 (30820 in chips)=20
LargeFarva99: posts the ante 250
cosm15: posts the ante 250
inthebut: posts the ante 250
JJin91: posts the ante 250
Maelish: posts the ante 250
Scooby-D0O: posts the ante 250
mmenz08816: posts the ante 250
JJin91: posts small blind 1000
Maelish: posts big blind 2000
*** HOLE CARDS ***
Dealt to JJin91 [Qc 3c]
Scooby-D0O: folds=20
mmenz08816: folds=20
LargeFarva99: folds=20
cosm15: folds=20
inthebut: calls 2000
JJin91: folds=20
Maelish: checks=20
*** FLOP *** [Tc Jh 2d]
Maelish: checks=20
inthebut: checks=20
*** TURN *** [Tc Jh 2d] [6h]
Maelish: bets 3375
inthebut: raises 3375 to 6750
Maelish: calls 3375
*** RIVER *** [Tc Jh 2d 6h] [8d]
Maelish: checks=20
inthebut: bets 8000
Maelish: calls 8000
*** SHOW DOWN ***
inthebut: shows [Ah 2c] (a pair of Deuces)
Maelish: shows [7h Jc] (a pair of Jacks)
Maelish collected 36250 from pot
*** SUMMARY ***
Total pot 36250 | Rake 0=20
Board [Tc Jh 2d 6h 8d]
Seat 1: LargeFarva99 folded before Flop (didn't bet)
Seat 2: cosm15 folded before Flop (didn't bet)
Seat 3: inthebut (button) showed [Ah 2c] and lost with a pair of Deuces
Seat 5: JJin91 (small blind) folded before Flop
Seat 6: Maelish (big blind) showed [7h Jc] and won (36250) with a pair =
of Jacks
Seat 7: Scooby-D0O folded before Flop (didn't bet)
Seat 9: mmenz08816 folded before Flop (didn't bet)


*********** # 146 **************
PokerStars Hand #175438317809: Tournament #1701793956, $18.20+$1.80 USD=
 Hold'em No Limit - Level XX (1250/2500) - 2017/09/23 22:28:45 ET
Table '1701793956 2' 9-max Seat #5 is the button
Seat 1: LargeFarva99 (107761 in chips)=20
Seat 2: cosm15 (60449 in chips)=20
Seat 3: inthebut (92022 in chips)=20
Seat 5: JJin91 (79523 in chips)=20
Seat 6: Maelish (64580 in chips)=20
Seat 7: Scooby-D0O (95063 in chips)=20
Seat 9: mmenz08816 (30570 in chips)=20
LargeFarva99: posts the ante 325
cosm15: posts the ante 325
inthebut: posts the ante 325
JJin91: posts the ante 325
Maelish: posts the ante 325
Scooby-D0O: posts the ante 325
mmenz08816: posts the ante 325
Maelish: posts small blind 1250
Scooby-D0O: posts big blind 2500
*** HOLE CARDS ***
Dealt to JJin91 [Js 7d]
mmenz08816: folds=20
LargeFarva99: folds=20
cosm15: folds=20
inthebut: folds=20
inthebut said, "nh"
JJin91: raises 2925 to 5425
Maelish: folds=20
Scooby-D0O: calls 2925
*** FLOP *** [Ks 3h 2h]
Scooby-D0O: checks=20
JJin91: bets 8876
Scooby-D0O: calls 8876
*** TURN *** [Ks 3h 2h] [Qc]
Scooby-D0O: checks=20
JJin91: checks=20
*** RIVER *** [Ks 3h 2h Qc] [4d]
Scooby-D0O: bets 24095
JJin91: folds=20
Uncalled bet (24095) returned to Scooby-D0O
Scooby-D0O collected 32127 from pot
*** SUMMARY ***
Total pot 32127 | Rake 0=20
Board [Ks 3h 2h Qc 4d]
Seat 1: LargeFarva99 folded before Flop (didn't bet)
Seat 2: cosm15 folded before Flop (didn't bet)
Seat 3: inthebut folded before Flop (didn't bet)
Seat 5: JJin91 (button) folded on the River
Seat 6: Maelish (small blind) folded before Flop
Seat 7: Scooby-D0O (big blind) collected (32127)
Seat 9: mmenz08816 folded before Flop (didn't bet)


*********** # 147 **************
PokerStars Hand #175438318058: Tournament #1701793956, $18.20+$1.80 USD=
 Hold'em No Limit - Level XX (1250/2500) - 2017/09/23 22:29:42 ET
Table '1701793956 2' 9-max Seat #6 is the button
Seat 1: LargeFarva99 (107436 in chips)=20
Seat 2: cosm15 (60124 in chips)=20
Seat 3: inthebut (91697 in chips)=20
Seat 5: JJin91 (64897 in chips)=20
Seat 6: Maelish (63005 in chips)=20
Seat 7: Scooby-D0O (112564 in chips)=20
Seat 9: mmenz08816 (30245 in chips)=20
LargeFarva99: posts the ante 325
cosm15: posts the ante 325
inthebut: posts the ante 325
JJin91: posts the ante 325
Maelish: posts the ante 325
Scooby-D0O: posts the ante 325
mmenz08816: posts the ante 325
Scooby-D0O: posts small blind 1250
mmenz08816: posts big blind 2500
*** HOLE CARDS ***
Dealt to JJin91 [Kd 5h]
LargeFarva99: folds=20
cosm15: folds=20
inthebut: folds=20
JJin91: folds=20
Maelish: raises 3000 to 5500
Scooby-D0O: calls 4250
mmenz08816: raises 24420 to 29920 and is all-in
Maelish: folds=20
Scooby-D0O: folds=20
Uncalled bet (24420) returned to mmenz08816
mmenz08816 collected 18775 from pot
mmenz08816: doesn't show hand=20
*** SUMMARY ***
Total pot 18775 | Rake 0=20
Seat 1: LargeFarva99 folded before Flop (didn't bet)
Seat 2: cosm15 folded before Flop (didn't bet)
Seat 3: inthebut folded before Flop (didn't bet)
Seat 5: JJin91 folded before Flop (didn't bet)
Seat 6: Maelish (button) folded before Flop
Seat 7: Scooby-D0O (small blind) folded before Flop
Seat 9: mmenz08816 (big blind) collected (18775)


*********** # 148 **************
PokerStars Hand #175438318221: Tournament #1701793956, $18.20+$1.80 USD=
 Hold'em No Limit - Level XX (1250/2500) - 2017/09/23 22:30:19 ET
Table '1701793956 2' 9-max Seat #7 is the button
Seat 1: LargeFarva99 (107111 in chips)=20
Seat 2: cosm15 (59799 in chips)=20
Seat 3: inthebut (91372 in chips)=20
Seat 5: JJin91 (64572 in chips)=20
Seat 6: Maelish (57180 in chips)=20
Seat 7: Scooby-D0O (106739 in chips)=20
Seat 9: mmenz08816 (43195 in chips)=20
LargeFarva99: posts the ante 325
cosm15: posts the ante 325
inthebut: posts the ante 325
JJin91: posts the ante 325
Maelish: posts the ante 325
Scooby-D0O: posts the ante 325
mmenz08816: posts the ante 325
mmenz08816: posts small blind 1250
LargeFarva99: posts big blind 2500
*** HOLE CARDS ***
Dealt to JJin91 [Qs Qh]
cosm15: folds=20
inthebut: folds=20
JJin91: raises 2925 to 5425
Maelish: folds=20
Scooby-D0O: raises 9575 to 15000
mmenz08816: folds=20
LargeFarva99: folds=20
JJin91: raises 49247 to 64247 and is all-in
Scooby-D0O: folds=20
Uncalled bet (49247) returned to JJin91
JJin91 collected 36025 from pot
JJin91: doesn't show hand=20
*** SUMMARY ***
Total pot 36025 | Rake 0=20
Seat 1: LargeFarva99 (big blind) folded before Flop
Seat 2: cosm15 folded before Flop (didn't bet)
Seat 3: inthebut folded before Flop (didn't bet)
Seat 5: JJin91 collected (36025)
Seat 6: Maelish folded before Flop (didn't bet)
Seat 7: Scooby-D0O (button) folded before Flop
Seat 9: mmenz08816 (small blind) folded before Flop


*********** # 149 **************
PokerStars Hand #175438318380: Tournament #1701793956, $18.20+$1.80 USD=
 Hold'em No Limit - Level XX (1250/2500) - 2017/09/23 22:30:52 ET
Table '1701793956 2' 9-max Seat #9 is the button
Seat 1: LargeFarva99 (104286 in chips)=20
Seat 2: cosm15 (59474 in chips)=20
Seat 3: inthebut (91047 in chips)=20
Seat 5: JJin91 (85272 in chips)=20
Seat 6: Maelish (56855 in chips)=20
Seat 7: Scooby-D0O (91414 in chips)=20
Seat 9: mmenz08816 (41620 in chips)=20
LargeFarva99: posts the ante 325
cosm15: posts the ante 325
inthebut: posts the ante 325
JJin91: posts the ante 325
Maelish: posts the ante 325
Scooby-D0O: posts the ante 325
mmenz08816: posts the ante 325
LargeFarva99: posts small blind 1250
cosm15: posts big blind 2500
*** HOLE CARDS ***
Dealt to JJin91 [3s 3d]
inthebut: folds=20
JJin91: raises 2925 to 5425
Maelish: folds=20
Scooby-D0O: folds=20
mmenz08816: folds=20
LargeFarva99: folds=20
cosm15: calls 2925
*** FLOP *** [Kc 7d 5c]
cosm15: checks=20
JJin91: checks=20
*** TURN *** [Kc 7d 5c] [5d]
cosm15: checks=20
JJin91: checks=20
*** RIVER *** [Kc 7d 5c 5d] [9c]
cosm15: checks=20
JJin91: checks=20
*** SHOW DOWN ***
cosm15: shows [Qd Jh] (a pair of Fives)
JJin91: shows [3s 3d] (two pair, Fives and Threes)
JJin91 collected 14375 from pot
*** SUMMARY ***
Total pot 14375 | Rake 0=20
Board [Kc 7d 5c 5d 9c]
Seat 1: LargeFarva99 (small blind) folded before Flop
Seat 2: cosm15 (big blind) showed [Qd Jh] and lost with a pair of Fives
Seat 3: inthebut folded before Flop (didn't bet)
Seat 5: JJin91 showed [3s 3d] and won (14375) with two pair, Fives and =
Threes
Seat 6: Maelish folded before Flop (didn't bet)
Seat 7: Scooby-D0O folded before Flop (didn't bet)
Seat 9: mmenz08816 (button) folded before Flop (didn't bet)


*********** # 150 **************
PokerStars Hand #175438318590: Tournament #1701793956, $18.20+$1.80 USD=
 Hold'em No Limit - Level XX (1250/2500) - 2017/09/23 22:31:45 ET
Table '1701793956 2' 9-max Seat #1 is the button
Seat 1: LargeFarva99 (102711 in chips)=20
Seat 2: cosm15 (53724 in chips)=20
Seat 3: inthebut (90722 in chips)=20
Seat 5: JJin91 (93897 in chips)=20
Seat 6: Maelish (56530 in chips)=20
Seat 7: Scooby-D0O (91089 in chips)=20
Seat 9: mmenz08816 (41295 in chips)=20
LargeFarva99: posts the ante 325
cosm15: posts the ante 325
inthebut: posts the ante 325
JJin91: posts the ante 325
Maelish: posts the ante 325
Scooby-D0O: posts the ante 325
mmenz08816: posts the ante 325
cosm15: posts small blind 1250
inthebut: posts big blind 2500
*** HOLE CARDS ***
Dealt to JJin91 [5c Tc]
JJin91: folds=20
Maelish: folds=20
Scooby-D0O: folds=20
mmenz08816: folds=20
LargeFarva99: calls 2500
cosm15: calls 1250
inthebut: checks=20
*** FLOP *** [Jh Ac 2d]
cosm15: checks=20
inthebut: bets 2500
LargeFarva99: raises 2500 to 5000
cosm15: calls 5000
inthebut: raises 2500 to 7500
LargeFarva99: calls 2500
cosm15: calls 2500
*** TURN *** [Jh Ac 2d] [9d]
cosm15: checks=20
inthebut: bets 7500
LargeFarva99: calls 7500
cosm15: raises 12500 to 20000
inthebut: calls 12500
LargeFarva99: folds=20
*** RIVER *** [Jh Ac 2d 9d] [Ts]
cosm15: bets 23399 and is all-in
inthebut: calls 23399
*** SHOW DOWN ***
cosm15: shows [9c Ah] (two pair, Aces and Nines)
inthebut: shows [5s As] (a pair of Aces)
cosm15 collected 126573 from pot
*** SUMMARY ***
Total pot 126573 | Rake 0=20
Board [Jh Ac 2d 9d Ts]
Seat 1: LargeFarva99 (button) folded on the Turn
Seat 2: cosm15 (small blind) showed [9c Ah] and won (126573) with two p=
air, Aces and Nines
Seat 3: inthebut (big blind) showed [5s As] and lost with a pair of Aces
Seat 5: JJin91 folded before Flop (didn't bet)
Seat 6: Maelish folded before Flop (didn't bet)
Seat 7: Scooby-D0O folded before Flop (didn't bet)
Seat 9: mmenz08816 folded before Flop (didn't bet)


*********** # 151 **************
PokerStars Hand #175438319032: Tournament #1701793956, $18.20+$1.80 USD=
 Hold'em No Limit - Level XX (1250/2500) - 2017/09/23 22:33:29 ET
Table '1701793956 2' 9-max Seat #2 is the button
Seat 1: LargeFarva99 (84886 in chips)=20
Seat 2: cosm15 (126573 in chips)=20
Seat 3: inthebut (36998 in chips)=20
Seat 5: JJin91 (93572 in chips)=20
Seat 6: Maelish (56205 in chips)=20
Seat 7: Scooby-D0O (90764 in chips)=20
Seat 9: mmenz08816 (40970 in chips)=20
LargeFarva99: posts the ante 325
cosm15: posts the ante 325
inthebut: posts the ante 325
JJin91: posts the ante 325
Maelish: posts the ante 325
Scooby-D0O: posts the ante 325
mmenz08816: posts the ante 325
inthebut: posts small blind 1250
JJin91: posts big blind 2500
*** HOLE CARDS ***
Dealt to JJin91 [3h 5h]
Maelish: folds=20
Scooby-D0O: raises 3000 to 5500
mmenz08816: folds=20
LargeFarva99: calls 5500
cosm15: calls 5500
inthebut: folds=20
JJin91: calls 3000
*** FLOP *** [4h Jc Kd]
JJin91: checks=20
Scooby-D0O: bets 19144
LargeFarva99: folds=20
cosm15: folds=20
JJin91: folds=20
Uncalled bet (19144) returned to Scooby-D0O
Scooby-D0O collected 25525 from pot
*** SUMMARY ***
Total pot 25525 | Rake 0=20
Board [4h Jc Kd]
Seat 1: LargeFarva99 folded on the Flop
Seat 2: cosm15 (button) folded on the Flop
Seat 3: inthebut (small blind) folded before Flop
Seat 5: JJin91 (big blind) folded on the Flop
Seat 6: Maelish folded before Flop (didn't bet)
Seat 7: Scooby-D0O collected (25525)
Seat 9: mmenz08816 folded before Flop (didn't bet)


*********** # 152 **************
PokerStars Hand #175438319237: Tournament #1701793956, $18.20+$1.80 USD=
 Hold'em No Limit - Level XX (1250/2500) - 2017/09/23 22:34:15 ET
Table '1701793956 2' 9-max Seat #3 is the button
Seat 1: LargeFarva99 (79061 in chips)=20
Seat 2: cosm15 (120748 in chips)=20
Seat 3: inthebut (35423 in chips)=20
Seat 5: JJin91 (87747 in chips)=20
Seat 6: Maelish (55880 in chips)=20
Seat 7: Scooby-D0O (110464 in chips)=20
Seat 9: mmenz08816 (40645 in chips)=20
LargeFarva99: posts the ante 325
cosm15: posts the ante 325
inthebut: posts the ante 325
JJin91: posts the ante 325
Maelish: posts the ante 325
Scooby-D0O: posts the ante 325
mmenz08816: posts the ante 325
JJin91: posts small blind 1250
Maelish: posts big blind 2500
*** HOLE CARDS ***
Dealt to JJin91 [6h 4c]
Scooby-D0O: folds=20
mmenz08816: folds=20
LargeFarva99: folds=20
cosm15: folds=20
inthebut: raises 32598 to 35098 and is all-in
JJin91: folds=20
Maelish: folds=20
Uncalled bet (32598) returned to inthebut
inthebut collected 8525 from pot
inthebut: doesn't show hand=20
*** SUMMARY ***
Total pot 8525 | Rake 0=20
Seat 1: LargeFarva99 folded before Flop (didn't bet)
Seat 2: cosm15 folded before Flop (didn't bet)
Seat 3: inthebut (button) collected (8525)
Seat 5: JJin91 (small blind) folded before Flop
Seat 6: Maelish (big blind) folded before Flop
Seat 7: Scooby-D0O folded before Flop (didn't bet)
Seat 9: mmenz08816 folded before Flop (didn't bet)


*********** # 153 **************
PokerStars Hand #175438319325: Tournament #1701793956, $18.20+$1.80 USD=
 Hold'em No Limit - Level XX (1250/2500) - 2017/09/23 22:34:37 ET
Table '1701793956 2' 9-max Seat #5 is the button
Seat 1: LargeFarva99 (78736 in chips)=20
Seat 2: cosm15 (120423 in chips)=20
Seat 3: inthebut (41123 in chips)=20
Seat 5: JJin91 (86172 in chips)=20
Seat 6: Maelish (53055 in chips)=20
Seat 7: Scooby-D0O (110139 in chips)=20
Seat 9: mmenz08816 (40320 in chips)=20
LargeFarva99: posts the ante 325
cosm15: posts the ante 325
inthebut: posts the ante 325
JJin91: posts the ante 325
Maelish: posts the ante 325
Scooby-D0O: posts the ante 325
mmenz08816: posts the ante 325
Maelish: posts small blind 1250
Scooby-D0O: posts big blind 2500
*** HOLE CARDS ***
Dealt to JJin91 [3d 2c]
mmenz08816: raises 2500 to 5000
LargeFarva99: folds=20
cosm15: folds=20
inthebut: raises 35000 to 40000
JJin91: folds=20
Maelish: folds=20
Scooby-D0O: folds=20
mmenz08816: folds=20
Uncalled bet (35000) returned to inthebut
inthebut collected 16025 from pot
inthebut: doesn't show hand=20
*** SUMMARY ***
Total pot 16025 | Rake 0=20
Seat 1: LargeFarva99 folded before Flop (didn't bet)
Seat 2: cosm15 folded before Flop (didn't bet)
Seat 3: inthebut collected (16025)
Seat 5: JJin91 (button) folded before Flop (didn't bet)
Seat 6: Maelish (small blind) folded before Flop
Seat 7: Scooby-D0O (big blind) folded before Flop
Seat 9: mmenz08816 folded before Flop


*********** # 154 **************
PokerStars Hand #175438319509: Tournament #1701793956, $18.20+$1.80 USD=
 Hold'em No Limit - Level XX (1250/2500) - 2017/09/23 22:35:19 ET
Table '1701793956 2' 9-max Seat #6 is the button
Seat 1: LargeFarva99 (78411 in chips)=20
Seat 2: cosm15 (120098 in chips)=20
Seat 3: inthebut (51823 in chips)=20
Seat 5: JJin91 (85847 in chips)=20
Seat 6: Maelish (51480 in chips)=20
Seat 7: Scooby-D0O (107314 in chips)=20
Seat 9: mmenz08816 (34995 in chips)=20
LargeFarva99: posts the ante 325
cosm15: posts the ante 325
inthebut: posts the ante 325
JJin91: posts the ante 325
Maelish: posts the ante 325
Scooby-D0O: posts the ante 325
mmenz08816: posts the ante 325
Scooby-D0O: posts small blind 1250
mmenz08816: posts big blind 2500
*** HOLE CARDS ***
Dealt to JJin91 [Jd 8c]
LargeFarva99: folds=20
cosm15: folds=20
inthebut: raises 48998 to 51498 and is all-in
JJin91: folds=20
Maelish: folds=20
Scooby-D0O: folds=20
mmenz08816: folds=20
Uncalled bet (48998) returned to inthebut
inthebut collected 8525 from pot
inthebut: doesn't show hand=20
*** SUMMARY ***
Total pot 8525 | Rake 0=20
Seat 1: LargeFarva99 folded before Flop (didn't bet)
Seat 2: cosm15 folded before Flop (didn't bet)
Seat 3: inthebut collected (8525)
Seat 5: JJin91 folded before Flop (didn't bet)
Seat 6: Maelish (button) folded before Flop (didn't bet)
Seat 7: Scooby-D0O (small blind) folded before Flop
Seat 9: mmenz08816 (big blind) folded before Flop


*********** # 155 **************
PokerStars Hand #175438319618: Tournament #1701793956, $18.20+$1.80 USD=
 Hold'em No Limit - Level XX (1250/2500) - 2017/09/23 22:35:43 ET
Table '1701793956 2' 9-max Seat #7 is the button
Seat 1: LargeFarva99 (78086 in chips)=20
Seat 2: cosm15 (119773 in chips)=20
Seat 3: inthebut (57523 in chips)=20
Seat 5: JJin91 (85522 in chips)=20
Seat 6: Maelish (51155 in chips)=20
Seat 7: Scooby-D0O (105739 in chips)=20
Seat 9: mmenz08816 (32170 in chips)=20
LargeFarva99: posts the ante 325
cosm15: posts the ante 325
inthebut: posts the ante 325
JJin91: posts the ante 325
Maelish: posts the ante 325
Scooby-D0O: posts the ante 325
mmenz08816: posts the ante 325
mmenz08816: posts small blind 1250
LargeFarva99: posts big blind 2500
*** HOLE CARDS ***
Dealt to JJin91 [Ts 5d]
cosm15: folds=20
inthebut: folds=20
JJin91: folds=20
Maelish: folds=20
Scooby-D0O: raises 3000 to 5500
mmenz08816: folds=20
LargeFarva99: calls 3000
*** FLOP *** [3h 4c Qs]
LargeFarva99: checks=20
Scooby-D0O: bets 4358
LargeFarva99: folds=20
Uncalled bet (4358) returned to Scooby-D0O
Scooby-D0O collected 14525 from pot
*** SUMMARY ***
Total pot 14525 | Rake 0=20
Board [3h 4c Qs]
Seat 1: LargeFarva99 (big blind) folded on the Flop
Seat 2: cosm15 folded before Flop (didn't bet)
Seat 3: inthebut folded before Flop (didn't bet)
Seat 5: JJin91 folded before Flop (didn't bet)
Seat 6: Maelish folded before Flop (didn't bet)
Seat 7: Scooby-D0O (button) collected (14525)
Seat 9: mmenz08816 (small blind) folded before Flop


*********** # 156 **************
PokerStars Hand #175438319724: Tournament #1701793956, $18.20+$1.80 USD=
 Hold'em No Limit - Level XX (1250/2500) - 2017/09/23 22:36:07 ET
Table '1701793956 2' 9-max Seat #9 is the button
Seat 1: LargeFarva99 (72261 in chips)=20
Seat 2: cosm15 (119448 in chips)=20
Seat 3: inthebut (57198 in chips)=20
Seat 5: JJin91 (85197 in chips)=20
Seat 6: Maelish (50830 in chips)=20
Seat 7: Scooby-D0O (114439 in chips)=20
Seat 9: mmenz08816 (30595 in chips)=20
LargeFarva99: posts the ante 325
cosm15: posts the ante 325
inthebut: posts the ante 325
JJin91: posts the ante 325
Maelish: posts the ante 325
Scooby-D0O: posts the ante 325
mmenz08816: posts the ante 325
LargeFarva99: posts small blind 1250
cosm15: posts big blind 2500
*** HOLE CARDS ***
Dealt to JJin91 [Qc Ts]
inthebut has timed out while being disconnected
inthebut: folds=20
inthebut is sitting out
JJin91: folds=20
inthebut has returned
Maelish: folds=20
Scooby-D0O: folds=20
mmenz08816: raises 27770 to 30270 and is all-in
LargeFarva99: raises 41666 to 71936 and is all-in
cosm15: folds=20
Uncalled bet (41666) returned to LargeFarva99
*** FLOP *** [7s 9d Jd]
*** TURN *** [7s 9d Jd] [Jc]
*** RIVER *** [7s 9d Jd Jc] [9s]
*** SHOW DOWN ***
LargeFarva99: shows [8s 8d] (two pair, Jacks and Nines)
mmenz08816: shows [Ks Ah] (two pair, Jacks and Nines - Ace kicker)
mmenz08816 collected 65315 from pot
*** SUMMARY ***
Total pot 65315 | Rake 0=20
Board [7s 9d Jd Jc 9s]
Seat 1: LargeFarva99 (small blind) showed [8s 8d] and lost with two pai=
r, Jacks and Nines
Seat 2: cosm15 (big blind) folded before Flop
Seat 3: inthebut folded before Flop (didn't bet)
Seat 5: JJin91 folded before Flop (didn't bet)
Seat 6: Maelish folded before Flop (didn't bet)
Seat 7: Scooby-D0O folded before Flop (didn't bet)
Seat 9: mmenz08816 (button) showed [Ks Ah] and won (65315) with two pai=
r, Jacks and Nines


*********** # 157 **************
PokerStars Hand #175438319997: Tournament #1701793956, $18.20+$1.80 USD=
 Hold'em No Limit - Level XX (1250/2500) - 2017/09/23 22:37:13 ET
Table '1701793956 2' 9-max Seat #1 is the button
Seat 1: LargeFarva99 (41666 in chips)=20
Seat 2: cosm15 (116623 in chips)=20
Seat 3: inthebut (56873 in chips)=20
Seat 5: JJin91 (84872 in chips)=20
Seat 6: Maelish (50505 in chips)=20
Seat 7: Scooby-D0O (114114 in chips)=20
Seat 9: mmenz08816 (65315 in chips)=20
LargeFarva99: posts the ante 325
cosm15: posts the ante 325
inthebut: posts the ante 325
JJin91: posts the ante 325
Maelish: posts the ante 325
Scooby-D0O: posts the ante 325
mmenz08816: posts the ante 325
cosm15: posts small blind 1250
inthebut: posts big blind 2500
*** HOLE CARDS ***
Dealt to JJin91 [Qd 4s]
JJin91: folds=20
Maelish: raises 2500 to 5000
Scooby-D0O: folds=20
mmenz08816: calls 5000
LargeFarva99: folds=20
cosm15: folds=20
inthebut: folds=20
*** FLOP *** [Kc 2d Qh]
Maelish: bets 4808
mmenz08816: calls 4808
*** TURN *** [Kc 2d Qh] [5h]
Maelish: checks=20
mmenz08816: bets 12500
Maelish: folds=20
Uncalled bet (12500) returned to mmenz08816
mmenz08816 collected 25641 from pot
mmenz08816: doesn't show hand=20
*** SUMMARY ***
Total pot 25641 | Rake 0=20
Board [Kc 2d Qh 5h]
Seat 1: LargeFarva99 (button) folded before Flop (didn't bet)
Seat 2: cosm15 (small blind) folded before Flop
Seat 3: inthebut (big blind) folded before Flop
Seat 5: JJin91 folded before Flop (didn't bet)
Seat 6: Maelish folded on the Turn
Seat 7: Scooby-D0O folded before Flop (didn't bet)
Seat 9: mmenz08816 collected (25641)


*********** # 158 **************
PokerStars Hand #175438730893: Tournament #1701793956, $18.20+$1.80 USD=
 Hold'em No Limit - Level XXI (1500/3000) - 2017/09/23 22:37:59 ET
Table '1701793956 2' 9-max Seat #2 is the button
Seat 1: LargeFarva99 (41341 in chips)=20
Seat 2: cosm15 (115048 in chips)=20
Seat 3: inthebut (54048 in chips)=20
Seat 5: JJin91 (84547 in chips)=20
Seat 6: Maelish (40372 in chips)=20
Seat 7: Scooby-D0O (113789 in chips)=20
Seat 9: mmenz08816 (80823 in chips)=20
LargeFarva99: posts the ante 375
cosm15: posts the ante 375
inthebut: posts the ante 375
JJin91: posts the ante 375
Maelish: posts the ante 375
Scooby-D0O: posts the ante 375
mmenz08816: posts the ante 375
inthebut: posts small blind 1500
JJin91: posts big blind 3000
*** HOLE CARDS ***
Dealt to JJin91 [As Jd]
Maelish: folds=20
Scooby-D0O: raises 3600 to 6600
mmenz08816: folds=20
LargeFarva99: folds=20
cosm15: folds=20
inthebut: folds=20
JJin91: raises 9063 to 15663
Scooby-D0O: calls 9063
*** FLOP *** [2h 5h 6d]
JJin91: checks=20
Scooby-D0O: checks=20
*** TURN *** [2h 5h 6d] [6h]
JJin91: checks=20
Scooby-D0O: checks=20
*** RIVER *** [2h 5h 6d 6h] [2s]
JJin91: checks=20
Scooby-D0O: checks=20
*** SHOW DOWN ***
JJin91: shows [As Jd] (two pair, Sixes and Deuces)
Scooby-D0O: mucks hand=20
JJin91 collected 35451 from pot
*** SUMMARY ***
Total pot 35451 | Rake 0=20
Board [2h 5h 6d 6h 2s]
Seat 1: LargeFarva99 folded before Flop (didn't bet)
Seat 2: cosm15 (button) folded before Flop (didn't bet)
Seat 3: inthebut (small blind) folded before Flop
Seat 5: JJin91 (big blind) showed [As Jd] and won (35451) with two pair=
, Sixes and Deuces
Seat 6: Maelish folded before Flop (didn't bet)
Seat 7: Scooby-D0O mucked [Kc Qh]
Seat 9: mmenz08816 folded before Flop (didn't bet)


*********** # 159 **************
PokerStars Hand #175438731149: Tournament #1701793956, $18.20+$1.80 USD=
 Hold'em No Limit - Level XXI (1500/3000) - 2017/09/23 22:38:58 ET
Table '1701793956 2' 9-max Seat #3 is the button
Seat 1: LargeFarva99 (40966 in chips)=20
Seat 2: cosm15 (114673 in chips)=20
Seat 3: inthebut (52173 in chips)=20
Seat 5: JJin91 (103960 in chips)=20
Seat 6: Maelish (39997 in chips)=20
Seat 7: Scooby-D0O (97751 in chips)=20
Seat 9: mmenz08816 (80448 in chips)=20
LargeFarva99: posts the ante 375
cosm15: posts the ante 375
inthebut: posts the ante 375
JJin91: posts the ante 375
Maelish: posts the ante 375
Scooby-D0O: posts the ante 375
mmenz08816: posts the ante 375
JJin91: posts small blind 1500
Maelish: posts big blind 3000
*** HOLE CARDS ***
Dealt to JJin91 [5d 8c]
Scooby-D0O: folds=20
mmenz08816: folds=20
LargeFarva99: raises 3000 to 6000
cosm15: folds=20
inthebut: folds=20
JJin91: folds=20
Maelish: folds=20
Uncalled bet (3000) returned to LargeFarva99
LargeFarva99 collected 10125 from pot
*** SUMMARY ***
Total pot 10125 | Rake 0=20
Seat 1: LargeFarva99 collected (10125)
Seat 2: cosm15 folded before Flop (didn't bet)
Seat 3: inthebut (button) folded before Flop (didn't bet)
Seat 5: JJin91 (small blind) folded before Flop
Seat 6: Maelish (big blind) folded before Flop
Seat 7: Scooby-D0O folded before Flop (didn't bet)
Seat 9: mmenz08816 folded before Flop (didn't bet)


*********** # 160 **************
PokerStars Hand #175438731238: Tournament #1701793956, $18.20+$1.80 USD=
 Hold'em No Limit - Level XXI (1500/3000) - 2017/09/23 22:39:19 ET
Table '1701793956 2' 9-max Seat #5 is the button
Seat 1: LargeFarva99 (47716 in chips)=20
Seat 2: cosm15 (114298 in chips)=20
Seat 3: inthebut (51798 in chips)=20
Seat 5: JJin91 (102085 in chips)=20
Seat 6: Maelish (36622 in chips)=20
Seat 7: Scooby-D0O (97376 in chips)=20
Seat 9: mmenz08816 (80073 in chips)=20
LargeFarva99: posts the ante 375
cosm15: posts the ante 375
inthebut: posts the ante 375
JJin91: posts the ante 375
Maelish: posts the ante 375
Scooby-D0O: posts the ante 375
mmenz08816: posts the ante 375
Maelish: posts small blind 1500
Scooby-D0O: posts big blind 3000
*** HOLE CARDS ***
Dealt to JJin91 [Kd Qh]
mmenz08816: raises 3000 to 6000
LargeFarva99: folds=20
cosm15: folds=20
inthebut: folds=20
JJin91: calls 6000
Maelish: folds=20
Scooby-D0O: raises 15000 to 21000
mmenz08816: calls 15000
JJin91: folds=20
*** FLOP *** [Qc Jc 6s]
Scooby-D0O: bets 15638
mmenz08816: folds=20
Uncalled bet (15638) returned to Scooby-D0O
Scooby-D0O collected 52125 from pot
Scooby-D0O: doesn't show hand=20
*** SUMMARY ***
Total pot 52125 | Rake 0=20
Board [Qc Jc 6s]
Seat 1: LargeFarva99 folded before Flop (didn't bet)
Seat 2: cosm15 folded before Flop (didn't bet)
Seat 3: inthebut folded before Flop (didn't bet)
Seat 5: JJin91 (button) folded before Flop
Seat 6: Maelish (small blind) folded before Flop
Seat 7: Scooby-D0O (big blind) collected (52125)
Seat 9: mmenz08816 folded on the Flop


*********** # 161 **************
PokerStars Hand #175438731391: Tournament #1701793956, $18.20+$1.80 USD=
 Hold'em No Limit - Level XXI (1500/3000) - 2017/09/23 22:39:58 ET
Table '1701793956 2' 9-max Seat #6 is the button
Seat 1: LargeFarva99 (47341 in chips)=20
Seat 2: cosm15 (113923 in chips)=20
Seat 3: inthebut (51423 in chips)=20
Seat 5: JJin91 (95710 in chips)=20
Seat 6: Maelish (34747 in chips)=20
Seat 7: Scooby-D0O (128126 in chips)=20
Seat 9: mmenz08816 (58698 in chips)=20
LargeFarva99: posts the ante 375
cosm15: posts the ante 375
inthebut: posts the ante 375
JJin91: posts the ante 375
Maelish: posts the ante 375
Scooby-D0O: posts the ante 375
mmenz08816: posts the ante 375
Scooby-D0O: posts small blind 1500
mmenz08816: posts big blind 3000
*** HOLE CARDS ***
Dealt to JJin91 [2s 4d]
LargeFarva99: raises 3000 to 6000
cosm15: folds=20
inthebut: raises 3000 to 9000
JJin91: folds=20
Maelish: folds=20
Scooby-D0O: folds=20
mmenz08816: folds=20
LargeFarva99: raises 37966 to 46966 and is all-in
inthebut: calls 37966
*** FLOP *** [Th 5d 7s]
*** TURN *** [Th 5d 7s] [5c]
*** RIVER *** [Th 5d 7s 5c] [6h]
*** SHOW DOWN ***
LargeFarva99: shows [Kh Ad] (a pair of Fives)
inthebut: shows [9c Ks] (a pair of Fives - lower kicker)
LargeFarva99 collected 101057 from pot
*** SUMMARY ***
Total pot 101057 | Rake 0=20
Board [Th 5d 7s 5c 6h]
Seat 1: LargeFarva99 showed [Kh Ad] and won (101057) with a pair of Fiv=
es
Seat 2: cosm15 folded before Flop (didn't bet)
Seat 3: inthebut showed [9c Ks] and lost with a pair of Fives
Seat 5: JJin91 folded before Flop (didn't bet)
Seat 6: Maelish (button) folded before Flop (didn't bet)
Seat 7: Scooby-D0O (small blind) folded before Flop
Seat 9: mmenz08816 (big blind) folded before Flop


*********** # 162 **************
PokerStars Hand #175438731556: Tournament #1701793956, $18.20+$1.80 USD=
 Hold'em No Limit - Level XXI (1500/3000) - 2017/09/23 22:40:39 ET
Table '1701793956 2' 9-max Seat #7 is the button
Seat 1: LargeFarva99 (101057 in chips)=20
Seat 2: cosm15 (113548 in chips)=20
Seat 3: inthebut (4082 in chips)=20
Seat 5: JJin91 (95335 in chips)=20
Seat 6: Maelish (34372 in chips)=20
Seat 7: Scooby-D0O (126251 in chips)=20
Seat 9: mmenz08816 (55323 in chips)=20
LargeFarva99: posts the ante 375
cosm15: posts the ante 375
inthebut: posts the ante 375
JJin91: posts the ante 375
Maelish: posts the ante 375
Scooby-D0O: posts the ante 375
mmenz08816: posts the ante 375
mmenz08816: posts small blind 1500
LargeFarva99: posts big blind 3000
*** HOLE CARDS ***
Dealt to JJin91 [Ah 2s]
cosm15: folds=20
inthebut: raises 707 to 3707 and is all-in
JJin91: folds=20
Maelish: raises 30290 to 33997 and is all-in
Scooby-D0O: folds=20
mmenz08816: folds=20
LargeFarva99: folds=20
Uncalled bet (30290) returned to Maelish
*** FLOP *** [4d Ac 4c]
*** TURN *** [4d Ac 4c] [3c]
*** RIVER *** [4d Ac 4c 3c] [3h]
*** SHOW DOWN ***
inthebut: shows [3d 9d] (a full house, Threes full of Fours)
Maelish: shows [Qc Jd] (two pair, Fours and Threes)
inthebut collected 14539 from pot
*** SUMMARY ***
Total pot 14539 | Rake 0=20
Board [4d Ac 4c 3c 3h]
Seat 1: LargeFarva99 (big blind) folded before Flop
Seat 2: cosm15 folded before Flop (didn't bet)
Seat 3: inthebut showed [3d 9d] and won (14539) with a full house, Thre=
es full of Fours
Seat 5: JJin91 folded before Flop (didn't bet)
Seat 6: Maelish showed [Qc Jd] and lost with two pair, Fours and Threes
Seat 7: Scooby-D0O (button) folded before Flop (didn't bet)
Seat 9: mmenz08816 (small blind) folded before Flop


*********** # 163 **************
PokerStars Hand #175438731656: Tournament #1701793956, $18.20+$1.80 USD=
 Hold'em No Limit - Level XXI (1500/3000) - 2017/09/23 22:41:04 ET
Table '1701793956 2' 9-max Seat #9 is the button
Seat 1: LargeFarva99 (97682 in chips)=20
Seat 2: cosm15 (113173 in chips)=20
Seat 3: inthebut (14539 in chips)=20
Seat 5: JJin91 (94960 in chips)=20
Seat 6: Maelish (30290 in chips)=20
Seat 7: Scooby-D0O (125876 in chips)=20
Seat 9: mmenz08816 (53448 in chips)=20
LargeFarva99: posts the ante 375
cosm15: posts the ante 375
inthebut: posts the ante 375
JJin91: posts the ante 375
Maelish: posts the ante 375
Scooby-D0O: posts the ante 375
mmenz08816: posts the ante 375
LargeFarva99: posts small blind 1500
cosm15: posts big blind 3000
*** HOLE CARDS ***
Dealt to JJin91 [2s 6c]
inthebut: folds=20
JJin91: folds=20
Maelish: folds=20
Scooby-D0O: folds=20
mmenz08816: folds=20
LargeFarva99: calls 1500
cosm15: checks=20
*** FLOP *** [3h 3d 9h]
LargeFarva99: checks=20
cosm15: checks=20
*** TURN *** [3h 3d 9h] [5c]
LargeFarva99: checks=20
cosm15: checks=20
*** RIVER *** [3h 3d 9h 5c] [4d]
LargeFarva99: bets 27000
cosm15: folds=20
Uncalled bet (27000) returned to LargeFarva99
LargeFarva99 collected 8625 from pot
LargeFarva99: doesn't show hand=20
*** SUMMARY ***
Total pot 8625 | Rake 0=20
Board [3h 3d 9h 5c 4d]
Seat 1: LargeFarva99 (small blind) collected (8625)
Seat 2: cosm15 (big blind) folded on the River
Seat 3: inthebut folded before Flop (didn't bet)
Seat 5: JJin91 folded before Flop (didn't bet)
Seat 6: Maelish folded before Flop (didn't bet)
Seat 7: Scooby-D0O folded before Flop (didn't bet)
Seat 9: mmenz08816 (button) folded before Flop (didn't bet)


*********** # 164 **************
PokerStars Hand #175438731814: Tournament #1701793956, $18.20+$1.80 USD=
 Hold'em No Limit - Level XXI (1500/3000) - 2017/09/23 22:41:49 ET
Table '1701793956 2' 9-max Seat #1 is the button
Seat 1: LargeFarva99 (102932 in chips)=20
Seat 2: cosm15 (109798 in chips)=20
Seat 3: inthebut (14164 in chips)=20
Seat 5: JJin91 (94585 in chips)=20
Seat 6: Maelish (29915 in chips)=20
Seat 7: Scooby-D0O (125501 in chips)=20
Seat 9: mmenz08816 (53073 in chips)=20
LargeFarva99: posts the ante 375
cosm15: posts the ante 375
inthebut: posts the ante 375
JJin91: posts the ante 375
Maelish: posts the ante 375
Scooby-D0O: posts the ante 375
mmenz08816: posts the ante 375
cosm15: posts small blind 1500
inthebut: posts big blind 3000
*** HOLE CARDS ***
Dealt to JJin91 [7h 7s]
JJin91: raises 3510 to 6510
Maelish: raises 23030 to 29540 and is all-in
Scooby-D0O: folds=20
mmenz08816: folds=20
LargeFarva99: folds=20
cosm15: folds=20
inthebut: folds=20
JJin91: calls 23030
*** FLOP *** [3d Kc 7d]
*** TURN *** [3d Kc 7d] [Qc]
*** RIVER *** [3d Kc 7d Qc] [2s]
*** SHOW DOWN ***
JJin91: shows [7h 7s] (three of a kind, Sevens)
Maelish: shows [Js Jc] (a pair of Jacks)
JJin91 collected 66205 from pot
Maelish finished the tournament in 14th place and received $44.21.
*** SUMMARY ***
Total pot 66205 | Rake 0=20
Board [3d Kc 7d Qc 2s]
Seat 1: LargeFarva99 (button) folded before Flop (didn't bet)
Seat 2: cosm15 (small blind) folded before Flop
Seat 3: inthebut (big blind) folded before Flop
Seat 5: JJin91 showed [7h 7s] and won (66205) with three of a kind, Sev=
ens
Seat 6: Maelish showed [Js Jc] and lost with a pair of Jacks
Seat 7: Scooby-D0O folded before Flop (didn't bet)
Seat 9: mmenz08816 folded before Flop (didn't bet)


*********** # 165 **************
PokerStars Hand #175438731899: Tournament #1701793956, $18.20+$1.80 USD=
 Hold'em No Limit - Level XXI (1500/3000) - 2017/09/23 22:42:10 ET
Table '1701793956 2' 9-max Seat #2 is the button
Seat 1: LargeFarva99 (102557 in chips)=20
Seat 2: cosm15 (107923 in chips)=20
Seat 3: inthebut (10789 in chips)=20
Seat 5: JJin91 (130875 in chips)=20
Seat 7: Scooby-D0O (125126 in chips)=20
Seat 9: mmenz08816 (52698 in chips)=20
LargeFarva99: posts the ante 375
cosm15: posts the ante 375
inthebut: posts the ante 375
JJin91: posts the ante 375
Scooby-D0O: posts the ante 375
mmenz08816: posts the ante 375
inthebut: posts small blind 1500
JJin91: posts big blind 3000
*** HOLE CARDS ***
Dealt to JJin91 [8h Ah]
Scooby-D0O: folds=20
mmenz08816: raises 3000 to 6000
LargeFarva99: folds=20
cosm15: raises 3000 to 9000
inthebut: folds=20
JJin91: calls 6000
mmenz08816: calls 3000
*** FLOP *** [5d Qs 8s]
JJin91: checks=20
mmenz08816: checks=20
cosm15: bets 13366
JJin91: calls 13366
mmenz08816: folds=20
*** TURN *** [5d Qs 8s] [Jc]
JJin91: checks=20
cosm15: bets 24446
JJin91: folds=20
Uncalled bet (24446) returned to cosm15
cosm15 collected 57482 from pot
cosm15: doesn't show hand=20
*** SUMMARY ***
Total pot 57482 | Rake 0=20
Board [5d Qs 8s Jc]
Seat 1: LargeFarva99 folded before Flop (didn't bet)
Seat 2: cosm15 (button) collected (57482)
Seat 3: inthebut (small blind) folded before Flop
Seat 5: JJin91 (big blind) folded on the Turn
Seat 7: Scooby-D0O folded before Flop (didn't bet)
Seat 9: mmenz08816 folded on the Flop


*********** # 166 **************
PokerStars Hand #175438732198: Tournament #1701793956, $18.20+$1.80 USD=
 Hold'em No Limit - Level XXI (1500/3000) - 2017/09/23 22:43:25 ET
Table '1701793956 2' 9-max Seat #3 is the button
Seat 1: LargeFarva99 (102182 in chips)=20
Seat 2: cosm15 (142664 in chips)=20
Seat 3: inthebut (8914 in chips)=20
Seat 5: JJin91 (108134 in chips)=20
Seat 7: Scooby-D0O (124751 in chips)=20
Seat 9: mmenz08816 (43323 in chips)=20
LargeFarva99: posts the ante 375
cosm15: posts the ante 375
inthebut: posts the ante 375
JJin91: posts the ante 375
Scooby-D0O: posts the ante 375
mmenz08816: posts the ante 375
JJin91: posts small blind 1500
Scooby-D0O: posts big blind 3000
*** HOLE CARDS ***
Dealt to JJin91 [Kh 5d]
mmenz08816: folds=20
LargeFarva99: folds=20
cosm15: folds=20
inthebut: folds=20
JJin91: calls 1500
Scooby-D0O: raises 6000 to 9000
JJin91: folds=20
Uncalled bet (6000) returned to Scooby-D0O
Scooby-D0O collected 8250 from pot
*** SUMMARY ***
Total pot 8250 | Rake 0=20
Seat 1: LargeFarva99 folded before Flop (didn't bet)
Seat 2: cosm15 folded before Flop (didn't bet)
Seat 3: inthebut (button) folded before Flop (didn't bet)
Seat 5: JJin91 (small blind) folded before Flop
Seat 7: Scooby-D0O (big blind) collected (8250)
Seat 9: mmenz08816 folded before Flop (didn't bet)


*********** # 167 **************
PokerStars Hand #175438732282: Tournament #1701793956, $18.20+$1.80 USD=
 Hold'em No Limit - Level XXI (1500/3000) - 2017/09/23 22:43:45 ET
Table '1701793956 2' 9-max Seat #5 is the button
Seat 1: LargeFarva99 (101807 in chips)=20
Seat 2: cosm15 (142289 in chips)=20
Seat 3: inthebut (8539 in chips)=20
Seat 5: JJin91 (104759 in chips)=20
Seat 7: Scooby-D0O (129626 in chips)=20
Seat 9: mmenz08816 (42948 in chips)=20
LargeFarva99: posts the ante 375
cosm15: posts the ante 375
inthebut: posts the ante 375
JJin91: posts the ante 375
Scooby-D0O: posts the ante 375
mmenz08816: posts the ante 375
Scooby-D0O: posts small blind 1500
mmenz08816: posts big blind 3000
*** HOLE CARDS ***
Dealt to JJin91 [7s 7h]
LargeFarva99: folds=20
cosm15: folds=20
inthebut: raises 5164 to 8164 and is all-in
JJin91: calls 8164
Scooby-D0O: folds=20
mmenz08816: folds=20
*** FLOP *** [9c Ad 4c]
*** TURN *** [9c Ad 4c] [Ks]
*** RIVER *** [9c Ad 4c Ks] [6c]
*** SHOW DOWN ***
inthebut: shows [Jd Td] (high card Ace)
JJin91: shows [7s 7h] (a pair of Sevens)
JJin91 collected 23078 from pot
inthebut finished the tournament in 13th place and received $44.21.
*** SUMMARY ***
Total pot 23078 | Rake 0=20
Board [9c Ad 4c Ks 6c]
Seat 1: LargeFarva99 folded before Flop (didn't bet)
Seat 2: cosm15 folded before Flop (didn't bet)
Seat 3: inthebut showed [Jd Td] and lost with high card Ace
Seat 5: JJin91 (button) showed [7s 7h] and won (23078) with a pair of S=
evens
Seat 7: Scooby-D0O (small blind) folded before Flop
Seat 9: mmenz08816 (big blind) folded before Flop


*********** # 168 **************
PokerStars Hand #175438732387: Tournament #1701793956, $18.20+$1.80 USD=
 Hold'em No Limit - Level XXI (1500/3000) - 2017/09/23 22:44:08 ET
Table '1701793956 2' 9-max Seat #7 is the button
Seat 1: LargeFarva99 (101432 in chips)=20
Seat 2: cosm15 (141914 in chips)=20
Seat 3: Sheeesh271 (60457 in chips)=20
Seat 5: JJin91 (119298 in chips)=20
Seat 7: Scooby-D0O (127751 in chips)=20
Seat 9: mmenz08816 (39573 in chips)=20
LargeFarva99: posts the ante 375
cosm15: posts the ante 375
Sheeesh271: posts the ante 375
JJin91: posts the ante 375
Scooby-D0O: posts the ante 375
mmenz08816: posts the ante 375
mmenz08816: posts small blind 1500
LargeFarva99: posts big blind 3000
*** HOLE CARDS ***
Dealt to JJin91 [Jh 2s]
cosm15: folds=20
Sheeesh271: folds=20
JJin91: folds=20
Scooby-D0O: raises 4500 to 7500
mmenz08816: folds=20
LargeFarva99: calls 4500
*** FLOP *** [5c 3s 3h]
LargeFarva99: checks=20
Scooby-D0O: bets 14063
LargeFarva99: folds=20
Uncalled bet (14063) returned to Scooby-D0O
Scooby-D0O collected 18750 from pot
Scooby-D0O: doesn't show hand=20
*** SUMMARY ***
Total pot 18750 | Rake 0=20
Board [5c 3s 3h]
Seat 1: LargeFarva99 (big blind) folded on the Flop
Seat 2: cosm15 folded before Flop (didn't bet)
Seat 3: Sheeesh271 folded before Flop (didn't bet)
Seat 5: JJin91 folded before Flop (didn't bet)
Seat 7: Scooby-D0O (button) collected (18750)
Seat 9: mmenz08816 (small blind) folded before Flop


*********** # 169 **************
PokerStars Hand #175438732461: Tournament #1701793956, $18.20+$1.80 USD=
 Hold'em No Limit - Level XXI (1500/3000) - 2017/09/23 22:44:27 ET
Table '1701793956 2' 9-max Seat #9 is the button
Seat 1: LargeFarva99 (93557 in chips)=20
Seat 2: cosm15 (141539 in chips)=20
Seat 3: Sheeesh271 (60082 in chips)=20
Seat 5: JJin91 (118923 in chips)=20
Seat 7: Scooby-D0O (138626 in chips)=20
Seat 9: mmenz08816 (37698 in chips)=20
LargeFarva99: posts the ante 375
cosm15: posts the ante 375
Sheeesh271: posts the ante 375
JJin91: posts the ante 375
Scooby-D0O: posts the ante 375
mmenz08816: posts the ante 375
LargeFarva99: posts small blind 1500
cosm15: posts big blind 3000
*** HOLE CARDS ***
Dealt to JJin91 [3c 6d]
Sheeesh271: folds=20
JJin91: folds=20
Scooby-D0O: raises 3600 to 6600
mmenz08816: folds=20
LargeFarva99: raises 14400 to 21000
cosm15: folds=20
Scooby-D0O: folds=20
Uncalled bet (14400) returned to LargeFarva99
LargeFarva99 collected 18450 from pot
LargeFarva99: doesn't show hand=20
*** SUMMARY ***
Total pot 18450 | Rake 0=20
Seat 1: LargeFarva99 (small blind) collected (18450)
Seat 2: cosm15 (big blind) folded before Flop
Seat 3: Sheeesh271 folded before Flop (didn't bet)
Seat 5: JJin91 folded before Flop (didn't bet)
Seat 7: Scooby-D0O folded before Flop
Seat 9: mmenz08816 (button) folded before Flop (didn't bet)


*********** # 170 **************
PokerStars Hand #175438732588: Tournament #1701793956, $18.20+$1.80 USD=
 Hold'em No Limit - Level XXI (1500/3000) - 2017/09/23 22:44:55 ET
Table '1701793956 2' 9-max Seat #1 is the button
Seat 1: LargeFarva99 (105032 in chips)=20
Seat 2: cosm15 (138164 in chips)=20
Seat 3: Sheeesh271 (59707 in chips)=20
Seat 5: JJin91 (118548 in chips)=20
Seat 7: Scooby-D0O (131651 in chips)=20
Seat 9: mmenz08816 (37323 in chips)=20
LargeFarva99: posts the ante 375
cosm15: posts the ante 375
Sheeesh271: posts the ante 375
JJin91: posts the ante 375
Scooby-D0O: posts the ante 375
mmenz08816: posts the ante 375
cosm15: posts small blind 1500
Sheeesh271: posts big blind 3000
*** HOLE CARDS ***
Dealt to JJin91 [Tc 6c]
JJin91: folds=20
Scooby-D0O: folds=20
mmenz08816: raises 33948 to 36948 and is all-in
LargeFarva99: raises 67709 to 104657 and is all-in
cosm15: folds=20
Sheeesh271: folds=20
Uncalled bet (67709) returned to LargeFarva99
*** FLOP *** [Td Ts Jd]
*** TURN *** [Td Ts Jd] [Jh]
*** RIVER *** [Td Ts Jd Jh] [Ah]
*** SHOW DOWN ***
mmenz08816: shows [Ks 3s] (two pair, Jacks and Tens)
LargeFarva99: shows [Kh As] (two pair, Aces and Jacks)
LargeFarva99 collected 80646 from pot
mmenz08816 finished the tournament in 12th place and received $46.27.
*** SUMMARY ***
Total pot 80646 | Rake 0=20
Board [Td Ts Jd Jh Ah]
Seat 1: LargeFarva99 (button) showed [Kh As] and won (80646) with two p=
air, Aces and Jacks
Seat 2: cosm15 (small blind) folded before Flop
Seat 3: Sheeesh271 (big blind) folded before Flop
Seat 5: JJin91 folded before Flop (didn't bet)
Seat 7: Scooby-D0O folded before Flop (didn't bet)
Seat 9: mmenz08816 showed [Ks 3s] and lost with two pair, Jacks and Tens


*********** # 171 **************
PokerStars Hand #175438732688: Tournament #1701793956, $18.20+$1.80 USD=
 Hold'em No Limit - Level XXI (1500/3000) - 2017/09/23 22:45:20 ET
Table '1701793956 2' 9-max Seat #2 is the button
Seat 1: LargeFarva99 (148355 in chips)=20
Seat 2: cosm15 (136289 in chips)=20
Seat 3: Sheeesh271 (56332 in chips)=20
Seat 5: JJin91 (118173 in chips)=20
Seat 7: Scooby-D0O (131276 in chips)=20
LargeFarva99: posts the ante 375
cosm15: posts the ante 375
Sheeesh271: posts the ante 375
JJin91: posts the ante 375
Scooby-D0O: posts the ante 375
Sheeesh271: posts small blind 1500
JJin91: posts big blind 3000
*** HOLE CARDS ***
Dealt to JJin91 [Kh 5s]
Scooby-D0O: folds=20
LargeFarva99: raises 3000 to 6000
cosm15: calls 6000
Sheeesh271: folds=20
JJin91: calls 3000
*** FLOP *** [4s 6h Qs]
JJin91: checks=20
LargeFarva99: checks=20
cosm15: checks=20
*** TURN *** [4s 6h Qs] [Ks]
JJin91: checks=20
LargeFarva99: bets 12000
cosm15: calls 12000
JJin91: folds=20
*** RIVER *** [4s 6h Qs Ks] [Js]
LargeFarva99: checks=20
cosm15: bets 18899
LargeFarva99: folds=20
Uncalled bet (18899) returned to cosm15
cosm15 collected 45375 from pot
cosm15: doesn't show hand=20
*** SUMMARY ***
Total pot 45375 | Rake 0=20
Board [4s 6h Qs Ks Js]
Seat 1: LargeFarva99 folded on the River
Seat 2: cosm15 (button) collected (45375)
Seat 3: Sheeesh271 (small blind) folded before Flop
Seat 5: JJin91 (big blind) folded on the Turn
Seat 7: Scooby-D0O folded before Flop (didn't bet)


*********** # 172 **************
PokerStars Hand #175438733036: Tournament #1701793956, $18.20+$1.80 USD=
 Hold'em No Limit - Level XXI (1500/3000) - 2017/09/23 22:46:43 ET
Table '1701793956 2' 9-max Seat #3 is the button
Seat 1: LargeFarva99 (129980 in chips)=20
Seat 2: cosm15 (163289 in chips)=20
Seat 3: Sheeesh271 (54457 in chips)=20
Seat 5: JJin91 (111798 in chips)=20
Seat 7: Scooby-D0O (130901 in chips)=20
LargeFarva99: posts the ante 375
cosm15: posts the ante 375
Sheeesh271: posts the ante 375
JJin91: posts the ante 375
Scooby-D0O: posts the ante 375
JJin91: posts small blind 1500
Scooby-D0O: posts big blind 3000
*** HOLE CARDS ***
Dealt to JJin91 [2h As]
LargeFarva99: folds=20
cosm15: folds=20
Sheeesh271: folds=20
JJin91: calls 1500
Scooby-D0O: raises 9000 to 12000
JJin91: folds=20
Uncalled bet (9000) returned to Scooby-D0O
Scooby-D0O collected 7875 from pot
Scooby-D0O: doesn't show hand=20
*** SUMMARY ***
Total pot 7875 | Rake 0=20
Seat 1: LargeFarva99 folded before Flop (didn't bet)
Seat 2: cosm15 folded before Flop (didn't bet)
Seat 3: Sheeesh271 (button) folded before Flop (didn't bet)
Seat 5: JJin91 (small blind) folded before Flop
Seat 7: Scooby-D0O (big blind) collected (7875)


*********** # 173 **************
PokerStars Hand #175438733477: Tournament #1701793956, $18.20+$1.80 USD=
 Hold'em No Limit - Level XXII (2000/4000) - 2017/09/23 22:48:28 ET
Table '1701793956 2' 9-max Seat #5 is the button
Seat 1: LargeFarva99 (129605 in chips)=20
Seat 2: cosm15 (162914 in chips)=20
Seat 3: Sheeesh271 (54082 in chips)=20
Seat 5: JJin91 (108423 in chips)=20
Seat 7: Scooby-D0O (135401 in chips)=20
LargeFarva99: posts the ante 500
cosm15: posts the ante 500
Sheeesh271: posts the ante 500
JJin91: posts the ante 500
Scooby-D0O: posts the ante 500
Scooby-D0O: posts small blind 2000
LargeFarva99: posts big blind 4000
*** HOLE CARDS ***
Dealt to JJin91 [6d 7s]
cosm15: raises 4999 to 8999
Sheeesh271: folds=20
JJin91: folds=20
Scooby-D0O: folds=20
LargeFarva99: calls 4999
*** FLOP *** [7c Th 4h]
LargeFarva99: checks=20
cosm15: bets 10999
LargeFarva99: calls 10999
*** TURN *** [7c Th 4h] [Jd]
LargeFarva99: checks=20
cosm15: checks=20
*** RIVER *** [7c Th 4h Jd] [Qc]
LargeFarva99: bets 16000
cosm15: raises 20999 to 36999
LargeFarva99: folds=20
Uncalled bet (20999) returned to cosm15
cosm15 collected 76496 from pot
cosm15: doesn't show hand=20
*** SUMMARY ***
Total pot 76496 | Rake 0=20
Board [7c Th 4h Jd Qc]
Seat 1: LargeFarva99 (big blind) folded on the River
Seat 2: cosm15 collected (76496)
Seat 3: Sheeesh271 folded before Flop (didn't bet)
Seat 5: JJin91 (button) folded before Flop (didn't bet)
Seat 7: Scooby-D0O (small blind) folded before Flop


*********** # 174 **************
PokerStars Hand #175438733826: Tournament #1701793956, $18.20+$1.80 USD=
 Hold'em No Limit - Level XXII (2000/4000) - 2017/09/23 22:49:56 ET
Table '1701793956 2' 9-max Seat #7 is the button
Seat 1: LargeFarva99 (93107 in chips)=20
Seat 2: cosm15 (202912 in chips)=20
Seat 3: Sheeesh271 (53582 in chips)=20
Seat 5: JJin91 (107923 in chips)=20
Seat 7: Scooby-D0O (132901 in chips)=20
LargeFarva99: posts the ante 500
cosm15: posts the ante 500
Sheeesh271: posts the ante 500
JJin91: posts the ante 500
Scooby-D0O: posts the ante 500
LargeFarva99: posts small blind 2000
cosm15: posts big blind 4000
*** HOLE CARDS ***
Dealt to JJin91 [Jd 2d]
Sheeesh271: folds=20
JJin91: raises 4680 to 8680
Scooby-D0O: calls 8680
LargeFarva99: folds=20
cosm15: folds=20
*** FLOP *** [4d 6d 7c]
JJin91: bets 8888
Scooby-D0O: raises 10999 to 19887
JJin91: calls 10999
*** TURN *** [4d 6d 7c] [4c]
JJin91: checks=20
Scooby-D0O: bets 31889
JJin91: folds=20
Uncalled bet (31889) returned to Scooby-D0O
Scooby-D0O collected 65634 from pot
Scooby-D0O: doesn't show hand=20
*** SUMMARY ***
Total pot 65634 | Rake 0=20
Board [4d 6d 7c 4c]
Seat 1: LargeFarva99 (small blind) folded before Flop
Seat 2: cosm15 (big blind) folded before Flop
Seat 3: Sheeesh271 folded before Flop (didn't bet)
Seat 5: JJin91 folded on the Turn
Seat 7: Scooby-D0O (button) collected (65634)


*********** # 175 **************
PokerStars Hand #175438734010: Tournament #1701793956, $18.20+$1.80 USD=
 Hold'em No Limit - Level XXII (2000/4000) - 2017/09/23 22:50:44 ET
Table '1701793956 2' 9-max Seat #1 is the button
Seat 1: LargeFarva99 (90607 in chips)=20
Seat 2: cosm15 (198412 in chips)=20
Seat 3: Sheeesh271 (53082 in chips)=20
Seat 5: JJin91 (78856 in chips)=20
Seat 7: Scooby-D0O (169468 in chips)=20
LargeFarva99: posts the ante 500
cosm15: posts the ante 500
Sheeesh271: posts the ante 500
JJin91: posts the ante 500
Scooby-D0O: posts the ante 500
cosm15: posts small blind 2000
Sheeesh271: posts big blind 4000
*** HOLE CARDS ***
Dealt to JJin91 [9h Qh]
JJin91: raises 4680 to 8680
Scooby-D0O: calls 8680
LargeFarva99: folds=20
cosm15: folds=20
Sheeesh271: folds=20
*** FLOP *** [Ac Ad Qd]
JJin91: bets 8888
Scooby-D0O: calls 8888
*** TURN *** [Ac Ad Qd] [6h]
JJin91: bets 16145
Scooby-D0O: calls 16145
*** RIVER *** [Ac Ad Qd 6h] [Ah]
JJin91: bets 44643 and is all-in
Scooby-D0O: calls 44643
*** SHOW DOWN ***
JJin91: shows [9h Qh] (a full house, Aces full of Queens)
Scooby-D0O: shows [As 9c] (four of a kind, Aces)
Scooby-D0O collected 165212 from pot
JJin91 finished the tournament in 10th place and received $46.27.
*** SUMMARY ***
Total pot 165212 | Rake 0=20
Board [Ac Ad Qd 6h Ah]
Seat 1: LargeFarva99 (button) folded before Flop (didn't bet)
Seat 2: cosm15 (small blind) folded before Flop
Seat 3: Sheeesh271 (big blind) folded before Flop
Seat 5: JJin91 showed [9h Qh] and lost with a full house, Aces full of =
Queens
Seat 7: Scooby-D0O showed [As 9c] and won (165212) with four of a kind,=
 Aces



If you have any questions, please contact us at "PokerStars Support" <s=
upport@pokerstarsnj.com>


