Transcript for tournament #1701843149 requested by JJin91 (jamiejin91@g=
mail.com)

*********** # 1 **************
PokerStars Hand #176116728828: Tournament #1701843149, $18.20+$1.80 USD=
 Hold'em No Limit - Level III (40/80) - 2017/10/09 19:22:58 ET
Table '1701843149 1' 9-max Seat #2 is the button
Seat 1: Drsnap31 (7750 in chips)=20
Seat 2: braheemin (10625 in chips)=20
Seat 3: TobogganM.D. (12480 in chips)=20
Seat 4: asremb (10240 in chips)=20
Seat 5: failboat1231 (10030 in chips)=20
Seat 6: Bsgwolfpack4 (10120 in chips)=20
Seat 7: JJin91 (10000 in chips)=20
Seat 8: Stack Jacken (9745 in chips)=20
Seat 9: BENN DOVERR (9160 in chips)=20
TobogganM.D.: posts small blind 40
asremb: posts big blind 80
*** HOLE CARDS ***
Dealt to JJin91 [9c Ks]
failboat1231: raises 100 to 180
Bsgwolfpack4: calls 180
JJin91: folds=20
Stack Jacken: folds=20
BENN DOVERR: folds=20
Drsnap31: folds=20
braheemin: folds=20
TobogganM.D.: folds=20
asremb: folds=20
*** FLOP *** [7c 5d 9h]
failboat1231: bets 320
Bsgwolfpack4: calls 320
*** TURN *** [7c 5d 9h] [3s]
failboat1231: checks=20
Bsgwolfpack4: bets 620
failboat1231: calls 620
*** RIVER *** [7c 5d 9h 3s] [Ac]
failboat1231: checks=20
Bsgwolfpack4: checks=20
*** SHOW DOWN ***
failboat1231: shows [6s 6d] (a pair of Sixes)
Bsgwolfpack4: shows [8s 8c] (a pair of Eights)
Bsgwolfpack4 collected 2360 from pot
*** SUMMARY ***
Total pot 2360 | Rake 0=20
Board [7c 5d 9h 3s Ac]
Seat 1: Drsnap31 folded before Flop (didn't bet)
Seat 2: braheemin (button) folded before Flop (didn't bet)
Seat 3: TobogganM.D. (small blind) folded before Flop
Seat 4: asremb (big blind) folded before Flop
Seat 5: failboat1231 showed [6s 6d] and lost with a pair of Sixes
Seat 6: Bsgwolfpack4 showed [8s 8c] and won (2360) with a pair of Eights
Seat 7: JJin91 folded before Flop (didn't bet)
Seat 8: Stack Jacken folded before Flop (didn't bet)
Seat 9: BENN DOVERR folded before Flop (didn't bet)


*********** # 2 **************
PokerStars Hand #176116728952: Tournament #1701843149, $18.20+$1.80 USD=
 Hold'em No Limit - Level III (40/80) - 2017/10/09 19:23:36 ET
Table '1701843149 1' 9-max Seat #3 is the button
Seat 1: Drsnap31 (7750 in chips)=20
Seat 2: braheemin (10625 in chips)=20
Seat 3: TobogganM.D. (12440 in chips)=20
Seat 4: asremb (10160 in chips)=20
Seat 5: failboat1231 (8910 in chips)=20
Seat 6: Bsgwolfpack4 (11360 in chips)=20
Seat 7: JJin91 (10000 in chips)=20
Seat 8: Stack Jacken (9745 in chips)=20
Seat 9: BENN DOVERR (9160 in chips)=20
asremb: posts small blind 40
failboat1231: posts big blind 80
*** HOLE CARDS ***
Dealt to JJin91 [8d 9c]
Bsgwolfpack4: folds=20
JJin91: folds=20
Stack Jacken: folds=20
BENN DOVERR: folds=20
Drsnap31 has timed out
Drsnap31: folds=20
Drsnap31 is sitting out
braheemin: folds=20
TobogganM.D.: folds=20
asremb: raises 160 to 240
failboat1231: raises 480 to 720
asremb: raises 9440 to 10160 and is all-in
Drsnap31 has returned
failboat1231: calls 8190 and is all-in
Uncalled bet (1250) returned to asremb
*** FLOP *** [3s 5d Kd]
*** TURN *** [3s 5d Kd] [7s]
*** RIVER *** [3s 5d Kd 7s] [3h]
*** SHOW DOWN ***
asremb: shows [8h 8c] (two pair, Eights and Threes)
failboat1231: shows [Ah Ac] (two pair, Aces and Threes)
failboat1231 collected 17820 from pot
*** SUMMARY ***
Total pot 17820 | Rake 0=20
Board [3s 5d Kd 7s 3h]
Seat 1: Drsnap31 folded before Flop (didn't bet)
Seat 2: braheemin folded before Flop (didn't bet)
Seat 3: TobogganM.D. (button) folded before Flop (didn't bet)
Seat 4: asremb (small blind) showed [8h 8c] and lost with two pair, Eig=
hts and Threes
Seat 5: failboat1231 (big blind) showed [Ah Ac] and won (17820) with tw=
o pair, Aces and Threes
Seat 6: Bsgwolfpack4 folded before Flop (didn't bet)
Seat 7: JJin91 folded before Flop (didn't bet)
Seat 8: Stack Jacken folded before Flop (didn't bet)
Seat 9: BENN DOVERR folded before Flop (didn't bet)


*********** # 3 **************
PokerStars Hand #176116729115: Tournament #1701843149, $18.20+$1.80 USD=
 Hold'em No Limit - Level III (40/80) - 2017/10/09 19:24:23 ET
Table '1701843149 1' 9-max Seat #4 is the button
Seat 1: Drsnap31 (7750 in chips)=20
Seat 2: braheemin (10625 in chips)=20
Seat 3: TobogganM.D. (12440 in chips)=20
Seat 4: asremb (1250 in chips)=20
Seat 5: failboat1231 (17820 in chips)=20
Seat 6: Bsgwolfpack4 (11360 in chips)=20
Seat 7: JJin91 (10000 in chips)=20
Seat 8: Stack Jacken (9745 in chips)=20
Seat 9: BENN DOVERR (9160 in chips)=20
failboat1231: posts small blind 40
Bsgwolfpack4: posts big blind 80
*** HOLE CARDS ***
Dealt to JJin91 [4h Th]
JJin91: folds=20
Stack Jacken: folds=20
BENN DOVERR: folds=20
Drsnap31: folds=20
braheemin: raises 120 to 200
TobogganM.D.: folds=20
asremb: folds=20
failboat1231: calls 160
Bsgwolfpack4: folds=20
*** FLOP *** [2s Jh 8h]
failboat1231: checks=20
braheemin: bets 325
failboat1231: calls 325
*** TURN *** [2s Jh 8h] [Td]
failboat1231: checks=20
braheemin: bets 900
failboat1231: calls 900
*** RIVER *** [2s Jh 8h Td] [Ks]
failboat1231: checks=20
braheemin: checks=20
*** SHOW DOWN ***
failboat1231: shows [Ad 8d] (a pair of Eights)
braheemin: shows [9s 9c] (a pair of Nines)
braheemin collected 2930 from pot
*** SUMMARY ***
Total pot 2930 | Rake 0=20
Board [2s Jh 8h Td Ks]
Seat 1: Drsnap31 folded before Flop (didn't bet)
Seat 2: braheemin showed [9s 9c] and won (2930) with a pair of Nines
Seat 3: TobogganM.D. folded before Flop (didn't bet)
Seat 4: asremb (button) folded before Flop (didn't bet)
Seat 5: failboat1231 (small blind) showed [Ad 8d] and lost with a pair =
of Eights
Seat 6: Bsgwolfpack4 (big blind) folded before Flop
Seat 7: JJin91 folded before Flop (didn't bet)
Seat 8: Stack Jacken folded before Flop (didn't bet)
Seat 9: BENN DOVERR folded before Flop (didn't bet)


*********** # 4 **************
PokerStars Hand #176116729278: Tournament #1701843149, $18.20+$1.80 USD=
 Hold'em No Limit - Level III (40/80) - 2017/10/09 19:25:07 ET
Table '1701843149 1' 9-max Seat #5 is the button
Seat 1: Drsnap31 (7750 in chips)=20
Seat 2: braheemin (12130 in chips)=20
Seat 3: TobogganM.D. (12440 in chips)=20
Seat 4: asremb (1250 in chips)=20
Seat 5: failboat1231 (16395 in chips)=20
Seat 6: Bsgwolfpack4 (11280 in chips)=20
Seat 7: JJin91 (10000 in chips)=20
Seat 8: Stack Jacken (9745 in chips)=20
Seat 9: BENN DOVERR (9160 in chips)=20
Bsgwolfpack4: posts small blind 40
JJin91: posts big blind 80
*** HOLE CARDS ***
Dealt to JJin91 [5h Kh]
Stack Jacken: calls 80
BENN DOVERR: folds=20
Drsnap31: folds=20
braheemin: folds=20
TobogganM.D.: folds=20
asremb: folds=20
failboat1231: folds=20
Bsgwolfpack4: calls 40
JJin91: checks=20
*** FLOP *** [8h Qd 9c]
Bsgwolfpack4: bets 120
JJin91: folds=20
Stack Jacken: folds=20
Uncalled bet (120) returned to Bsgwolfpack4
Bsgwolfpack4 collected 240 from pot
*** SUMMARY ***
Total pot 240 | Rake 0=20
Board [8h Qd 9c]
Seat 1: Drsnap31 folded before Flop (didn't bet)
Seat 2: braheemin folded before Flop (didn't bet)
Seat 3: TobogganM.D. folded before Flop (didn't bet)
Seat 4: asremb folded before Flop (didn't bet)
Seat 5: failboat1231 (button) folded before Flop (didn't bet)
Seat 6: Bsgwolfpack4 (small blind) collected (240)
Seat 7: JJin91 (big blind) folded on the Flop
Seat 8: Stack Jacken folded on the Flop
Seat 9: BENN DOVERR folded before Flop (didn't bet)


*********** # 5 **************
PokerStars Hand #176116729429: Tournament #1701843149, $18.20+$1.80 USD=
 Hold'em No Limit - Level III (40/80) - 2017/10/09 19:25:51 ET
Table '1701843149 1' 9-max Seat #6 is the button
Seat 1: Drsnap31 (7750 in chips)=20
Seat 2: braheemin (12130 in chips)=20
Seat 3: TobogganM.D. (12440 in chips)=20
Seat 4: asremb (1250 in chips)=20
Seat 5: failboat1231 (16395 in chips)=20
Seat 6: Bsgwolfpack4 (11440 in chips)=20
Seat 7: JJin91 (9920 in chips)=20
Seat 9: BENN DOVERR (9160 in chips)=20
JJin91: posts small blind 40
BENN DOVERR: posts big blind 80
*** HOLE CARDS ***
Dealt to JJin91 [8c Ks]
Drsnap31 has timed out
Drsnap31: folds=20
Drsnap31 is sitting out
braheemin: folds=20
TobogganM.D.: folds=20
asremb has timed out
asremb: folds=20
asremb is sitting out
failboat1231: folds=20
Bsgwolfpack4: folds=20
Drsnap31 has returned
asremb has returned
JJin91: raises 93 to 173
BENN DOVERR: folds=20
Uncalled bet (93) returned to JJin91
JJin91 collected 160 from pot
JJin91: doesn't show hand=20
*** SUMMARY ***
Total pot 160 | Rake 0=20
Seat 1: Drsnap31 folded before Flop (didn't bet)
Seat 2: braheemin folded before Flop (didn't bet)
Seat 3: TobogganM.D. folded before Flop (didn't bet)
Seat 4: asremb folded before Flop (didn't bet)
Seat 5: failboat1231 folded before Flop (didn't bet)
Seat 6: Bsgwolfpack4 (button) folded before Flop (didn't bet)
Seat 7: JJin91 (small blind) collected (160)
Seat 9: BENN DOVERR (big blind) folded before Flop


*********** # 6 **************
PokerStars Hand #176116729621: Tournament #1701843149, $18.20+$1.80 USD=
 Hold'em No Limit - Level III (40/80) - 2017/10/09 19:26:51 ET
Table '1701843149 1' 9-max Seat #7 is the button
Seat 1: Drsnap31 (7750 in chips)=20
Seat 2: braheemin (12130 in chips)=20
Seat 3: TobogganM.D. (12440 in chips)=20
Seat 4: asremb (1250 in chips)=20
Seat 5: failboat1231 (16395 in chips)=20
Seat 6: Bsgwolfpack4 (11440 in chips)=20
Seat 7: JJin91 (10000 in chips)=20
Seat 9: BENN DOVERR (9080 in chips)=20
BENN DOVERR: posts small blind 40
Drsnap31: posts big blind 80
*** HOLE CARDS ***
Dealt to JJin91 [Ts Jd]
braheemin: raises 80 to 160
TobogganM.D.: folds=20
asremb: folds=20
failboat1231: folds=20
Bsgwolfpack4: calls 160
JJin91: folds=20
BENN DOVERR: folds=20
Drsnap31: folds=20
*** FLOP *** [7d Qs Js]
braheemin: bets 275
Bsgwolfpack4: raises 495 to 770
braheemin: raises 1230 to 2000
Bsgwolfpack4: calls 1230
*** TURN *** [7d Qs Js] [Kd]
braheemin: bets 2250
Bsgwolfpack4: raises 7030 to 9280 and is all-in
braheemin: folds=20
Uncalled bet (7030) returned to Bsgwolfpack4
Bsgwolfpack4 collected 8940 from pot
*** SUMMARY ***
Total pot 8940 | Rake 0=20
Board [7d Qs Js Kd]
Seat 1: Drsnap31 (big blind) folded before Flop
Seat 2: braheemin folded on the Turn
Seat 3: TobogganM.D. folded before Flop (didn't bet)
Seat 4: asremb folded before Flop (didn't bet)
Seat 5: failboat1231 folded before Flop (didn't bet)
Seat 6: Bsgwolfpack4 collected (8940)
Seat 7: JJin91 (button) folded before Flop (didn't bet)
Seat 9: BENN DOVERR (small blind) folded before Flop


*********** # 7 **************
PokerStars Hand #176116729859: Tournament #1701843149, $18.20+$1.80 USD=
 Hold'em No Limit - Level III (40/80) - 2017/10/09 19:28:02 ET
Table '1701843149 1' 9-max Seat #9 is the button
Seat 1: Drsnap31 (7670 in chips)=20
Seat 2: braheemin (7720 in chips)=20
Seat 3: TobogganM.D. (12440 in chips)=20
Seat 4: asremb (1250 in chips)=20
Seat 5: failboat1231 (16395 in chips)=20
Seat 6: Bsgwolfpack4 (15970 in chips)=20
Seat 7: JJin91 (10000 in chips)=20
Seat 9: BENN DOVERR (9040 in chips)=20
Drsnap31: posts small blind 40
braheemin: posts big blind 80
*** HOLE CARDS ***
Dealt to JJin91 [Ah 6h]
TobogganM.D.: folds=20
asremb: raises 80 to 160
failboat1231: folds=20
Bsgwolfpack4: folds=20
JJin91: calls 160
BENN DOVERR: folds=20
Drsnap31: folds=20
braheemin: calls 80
*** FLOP *** [3s 5d Jh]
braheemin: checks=20
asremb: bets 520
JJin91: folds=20
braheemin: raises 7040 to 7560 and is all-in
asremb: calls 570 and is all-in
Uncalled bet (6470) returned to braheemin
*** TURN *** [3s 5d Jh] [3h]
*** RIVER *** [3s 5d Jh 3h] [2c]
*** SHOW DOWN ***
braheemin: shows [4s Ad] (a straight, Ace to Five)
asremb: shows [Qd Jc] (two pair, Jacks and Threes)
braheemin collected 2700 from pot
asremb finished the tournament in 113th place
*** SUMMARY ***
Total pot 2700 | Rake 0=20
Board [3s 5d Jh 3h 2c]
Seat 1: Drsnap31 (small blind) folded before Flop
Seat 2: braheemin (big blind) showed [4s Ad] and won (2700) with a stra=
ight, Ace to Five
Seat 3: TobogganM.D. folded before Flop (didn't bet)
Seat 4: asremb showed [Qd Jc] and lost with two pair, Jacks and Threes
Seat 5: failboat1231 folded before Flop (didn't bet)
Seat 6: Bsgwolfpack4 folded before Flop (didn't bet)
Seat 7: JJin91 folded on the Flop
Seat 9: BENN DOVERR (button) folded before Flop (didn't bet)


*********** # 8 **************
PokerStars Hand #176118937015: Tournament #1701843149, $18.20+$1.80 USD=
 Hold'em No Limit - Level III (40/80) - 2017/10/09 19:29:11 ET
Table '1701843149 1' 9-max Seat #1 is the button
Seat 1: Drsnap31 (7630 in chips)=20
Seat 2: braheemin (9170 in chips)=20
Seat 3: TobogganM.D. (12440 in chips)=20
Seat 5: failboat1231 (16395 in chips)=20
Seat 6: Bsgwolfpack4 (15970 in chips)=20
Seat 7: JJin91 (9840 in chips)=20
Seat 9: BENN DOVERR (9040 in chips)=20
braheemin: posts small blind 40
TobogganM.D.: posts big blind 80
*** HOLE CARDS ***
Dealt to JJin91 [Td 4c]
failboat1231: folds=20
Bsgwolfpack4: folds=20
JJin91: folds=20
BENN DOVERR: folds=20
Drsnap31: folds=20
braheemin: calls 40
TobogganM.D.: raises 160 to 240
braheemin: folds=20
Uncalled bet (160) returned to TobogganM.D.
TobogganM.D. collected 160 from pot
TobogganM.D.: doesn't show hand=20
*** SUMMARY ***
Total pot 160 | Rake 0=20
Seat 1: Drsnap31 (button) folded before Flop (didn't bet)
Seat 2: braheemin (small blind) folded before Flop
Seat 3: TobogganM.D. (big blind) collected (160)
Seat 5: failboat1231 folded before Flop (didn't bet)
Seat 6: Bsgwolfpack4 folded before Flop (didn't bet)
Seat 7: JJin91 folded before Flop (didn't bet)
Seat 9: BENN DOVERR folded before Flop (didn't bet)


*********** # 9 **************
PokerStars Hand #176118937149: Tournament #1701843149, $18.20+$1.80 USD=
 Hold'em No Limit - Level III (40/80) - 2017/10/09 19:29:53 ET
Table '1701843149 1' 9-max Seat #2 is the button
Seat 1: Drsnap31 (7630 in chips)=20
Seat 2: braheemin (9090 in chips)=20
Seat 3: TobogganM.D. (12520 in chips)=20
Seat 5: failboat1231 (16395 in chips)=20
Seat 6: Bsgwolfpack4 (15970 in chips)=20
Seat 7: JJin91 (9840 in chips)=20
Seat 9: BENN DOVERR (9040 in chips)=20
TobogganM.D.: posts small blind 40
failboat1231: posts big blind 80
*** HOLE CARDS ***
Dealt to JJin91 [Ts 3h]
Bsgwolfpack4: folds=20
JJin91: folds=20
BENN DOVERR: folds=20
Drsnap31: folds=20
braheemin: raises 80 to 160
TobogganM.D.: folds=20
failboat1231: raises 400 to 560
braheemin: calls 400
*** FLOP *** [3c 9c Td]
failboat1231: bets 720
braheemin: folds=20
Uncalled bet (720) returned to failboat1231
failboat1231 collected 1160 from pot
failboat1231: doesn't show hand=20
*** SUMMARY ***
Total pot 1160 | Rake 0=20
Board [3c 9c Td]
Seat 1: Drsnap31 folded before Flop (didn't bet)
Seat 2: braheemin (button) folded on the Flop
Seat 3: TobogganM.D. (small blind) folded before Flop
Seat 5: failboat1231 (big blind) collected (1160)
Seat 6: Bsgwolfpack4 folded before Flop (didn't bet)
Seat 7: JJin91 folded before Flop (didn't bet)
Seat 9: BENN DOVERR folded before Flop (didn't bet)


*********** # 10 **************
PokerStars Hand #176118937378: Tournament #1701843149, $18.20+$1.80 USD=
 Hold'em No Limit - Level IV (50/100) - 2017/10/09 19:30:54 ET
Table '1701843149 1' 9-max Seat #3 is the button
Seat 1: Drsnap31 (7630 in chips)=20
Seat 2: braheemin (8530 in chips)=20
Seat 3: TobogganM.D. (12480 in chips)=20
Seat 5: failboat1231 (16995 in chips)=20
Seat 6: Bsgwolfpack4 (15970 in chips)=20
Seat 7: JJin91 (9840 in chips)=20
Seat 8: YourRobotDad (10000 in chips)=20
Seat 9: BENN DOVERR (9040 in chips)=20
Drsnap31: posts the ante 10
braheemin: posts the ante 10
TobogganM.D.: posts the ante 10
failboat1231: posts the ante 10
Bsgwolfpack4: posts the ante 10
JJin91: posts the ante 10
YourRobotDad: posts the ante 10
BENN DOVERR: posts the ante 10
failboat1231: posts small blind 50
Bsgwolfpack4: posts big blind 100
*** HOLE CARDS ***
Dealt to JJin91 [Ah Qd]
JJin91: raises 117 to 217
YourRobotDad: raises 317 to 534
BENN DOVERR: folds=20
Drsnap31: folds=20
braheemin: folds=20
TobogganM.D.: folds=20
failboat1231: folds=20
Bsgwolfpack4: folds=20
JJin91: calls 317
*** FLOP *** [4d 6d 2s]
JJin91: checks=20
YourRobotDad: bets 700
JJin91: calls 700
*** TURN *** [4d 6d 2s] [As]
JJin91: checks=20
YourRobotDad: bets 1300
JJin91: calls 1300
*** RIVER *** [4d 6d 2s As] [4s]
JJin91: bets 3455
YourRobotDad: calls 3455
*** SHOW DOWN ***
JJin91: shows [Ah Qd] (two pair, Aces and Fours)
YourRobotDad: shows [Kh Ad] (two pair, Aces and Fours - King kicker)
YourRobotDad collected 12208 from pot
*** SUMMARY ***
Total pot 12208 | Rake 0=20
Board [4d 6d 2s As 4s]
Seat 1: Drsnap31 folded before Flop (didn't bet)
Seat 2: braheemin folded before Flop (didn't bet)
Seat 3: TobogganM.D. (button) folded before Flop (didn't bet)
Seat 5: failboat1231 (small blind) folded before Flop
Seat 6: Bsgwolfpack4 (big blind) folded before Flop
Seat 7: JJin91 showed [Ah Qd] and lost with two pair, Aces and Fours
Seat 8: YourRobotDad showed [Kh Ad] and won (12208) with two pair, Aces=
 and Fours
Seat 9: BENN DOVERR folded before Flop (didn't bet)


*********** # 11 **************
PokerStars Hand #176118937569: Tournament #1701843149, $18.20+$1.80 USD=
 Hold'em No Limit - Level IV (50/100) - 2017/10/09 19:31:49 ET
Table '1701843149 1' 9-max Seat #5 is the button
Seat 1: Drsnap31 (7620 in chips)=20
Seat 2: braheemin (8520 in chips)=20
Seat 3: TobogganM.D. (12470 in chips)=20
Seat 5: failboat1231 (16935 in chips)=20
Seat 6: Bsgwolfpack4 (15860 in chips)=20
Seat 7: JJin91 (3841 in chips)=20
Seat 8: YourRobotDad (16209 in chips)=20
Seat 9: BENN DOVERR (9030 in chips)=20
Drsnap31: posts the ante 10
braheemin: posts the ante 10
TobogganM.D.: posts the ante 10
failboat1231: posts the ante 10
Bsgwolfpack4: posts the ante 10
JJin91: posts the ante 10
YourRobotDad: posts the ante 10
BENN DOVERR: posts the ante 10
Bsgwolfpack4: posts small blind 50
JJin91: posts big blind 100
*** HOLE CARDS ***
Dealt to JJin91 [7d 2s]
YourRobotDad: calls 100
BENN DOVERR: folds=20
Drsnap31: folds=20
braheemin: calls 100
TobogganM.D.: calls 100
failboat1231: folds=20
Bsgwolfpack4: raises 425 to 525
JJin91: folds=20
YourRobotDad: calls 425
braheemin: folds=20
TobogganM.D.: calls 425
*** FLOP *** [3h Ts 7h]
Bsgwolfpack4: bets 114
YourRobotDad: calls 114
TobogganM.D.: calls 114
*** TURN *** [3h Ts 7h] [Qc]
Bsgwolfpack4: bets 1545
YourRobotDad: folds=20
TobogganM.D.: folds=20
Uncalled bet (1545) returned to Bsgwolfpack4
Bsgwolfpack4 collected 2197 from pot
*** SUMMARY ***
Total pot 2197 | Rake 0=20
Board [3h Ts 7h Qc]
Seat 1: Drsnap31 folded before Flop (didn't bet)
Seat 2: braheemin folded before Flop
Seat 3: TobogganM.D. folded on the Turn
Seat 5: failboat1231 (button) folded before Flop (didn't bet)
Seat 6: Bsgwolfpack4 (small blind) collected (2197)
Seat 7: JJin91 (big blind) folded before Flop
Seat 8: YourRobotDad folded on the Turn
Seat 9: BENN DOVERR folded before Flop (didn't bet)


*********** # 12 **************
PokerStars Hand #176118937811: Tournament #1701843149, $18.20+$1.80 USD=
 Hold'em No Limit - Level IV (50/100) - 2017/10/09 19:32:58 ET
Table '1701843149 1' 9-max Seat #6 is the button
Seat 1: Drsnap31 (7610 in chips)=20
Seat 2: braheemin (8410 in chips)=20
Seat 3: TobogganM.D. (11821 in chips)=20
Seat 5: failboat1231 (16925 in chips)=20
Seat 6: Bsgwolfpack4 (17408 in chips)=20
Seat 7: JJin91 (3731 in chips)=20
Seat 8: YourRobotDad (15560 in chips)=20
Seat 9: BENN DOVERR (9020 in chips)=20
Drsnap31: posts the ante 10
braheemin: posts the ante 10
TobogganM.D.: posts the ante 10
failboat1231: posts the ante 10
Bsgwolfpack4: posts the ante 10
JJin91: posts the ante 10
YourRobotDad: posts the ante 10
BENN DOVERR: posts the ante 10
JJin91: posts small blind 50
YourRobotDad: posts big blind 100
*** HOLE CARDS ***
Dealt to JJin91 [Ah Ad]
BENN DOVERR: folds=20
Drsnap31: folds=20
braheemin: folds=20
TobogganM.D.: folds=20
failboat1231: raises 150 to 250
Bsgwolfpack4: calls 250
JJin91: raises 3471 to 3721 and is all-in
YourRobotDad: folds=20
failboat1231: raises 13194 to 16915 and is all-in
Bsgwolfpack4: folds=20
Uncalled bet (13194) returned to failboat1231
*** FLOP *** [8d 7c 3h]
*** TURN *** [8d 7c 3h] [2c]
*** RIVER *** [8d 7c 3h 2c] [7s]
*** SHOW DOWN ***
JJin91: shows [Ah Ad] (two pair, Aces and Sevens)
failboat1231: shows [Kh Kc] (two pair, Kings and Sevens)
JJin91 collected 7872 from pot
*** SUMMARY ***
Total pot 7872 | Rake 0=20
Board [8d 7c 3h 2c 7s]
Seat 1: Drsnap31 folded before Flop (didn't bet)
Seat 2: braheemin folded before Flop (didn't bet)
Seat 3: TobogganM.D. folded before Flop (didn't bet)
Seat 5: failboat1231 showed [Kh Kc] and lost with two pair, Kings and S=
evens
Seat 6: Bsgwolfpack4 (button) folded before Flop
Seat 7: JJin91 (small blind) showed [Ah Ad] and won (7872) with two pai=
r, Aces and Sevens
Seat 8: YourRobotDad (big blind) folded before Flop
Seat 9: BENN DOVERR folded before Flop (didn't bet)


*********** # 13 **************
PokerStars Hand #176118937933: Tournament #1701843149, $18.20+$1.80 USD=
 Hold'em No Limit - Level IV (50/100) - 2017/10/09 19:33:29 ET
Table '1701843149 1' 9-max Seat #7 is the button
Seat 1: Drsnap31 (7600 in chips)=20
Seat 2: braheemin (8400 in chips)=20
Seat 3: TobogganM.D. (11811 in chips)=20
Seat 5: failboat1231 (13194 in chips)=20
Seat 6: Bsgwolfpack4 (17148 in chips)=20
Seat 7: JJin91 (7872 in chips)=20
Seat 8: YourRobotDad (15450 in chips)=20
Seat 9: BENN DOVERR (9010 in chips)=20
Drsnap31: posts the ante 10
braheemin: posts the ante 10
TobogganM.D.: posts the ante 10
failboat1231: posts the ante 10
Bsgwolfpack4: posts the ante 10
JJin91: posts the ante 10
YourRobotDad: posts the ante 10
BENN DOVERR: posts the ante 10
YourRobotDad: posts small blind 50
BENN DOVERR: posts big blind 100
*** HOLE CARDS ***
Dealt to JJin91 [5d 7h]
Drsnap31: raises 200 to 300
braheemin: folds=20
TobogganM.D.: calls 300
failboat1231: folds=20
Bsgwolfpack4: folds=20
JJin91: folds=20
YourRobotDad: folds=20
BENN DOVERR: folds=20
*** FLOP *** [7s As 2h]
Drsnap31: checks=20
TobogganM.D.: bets 380
Drsnap31: raises 620 to 1000
TobogganM.D.: calls 620
*** TURN *** [7s As 2h] [7c]
Drsnap31: checks=20
TobogganM.D.: checks=20
*** RIVER *** [7s As 2h 7c] [9h]
Drsnap31: checks=20
TobogganM.D.: bets 1660
Drsnap31: folds=20
Uncalled bet (1660) returned to TobogganM.D.
TobogganM.D. collected 2830 from pot
TobogganM.D.: doesn't show hand=20
*** SUMMARY ***
Total pot 2830 | Rake 0=20
Board [7s As 2h 7c 9h]
Seat 1: Drsnap31 folded on the River
Seat 2: braheemin folded before Flop (didn't bet)
Seat 3: TobogganM.D. collected (2830)
Seat 5: failboat1231 folded before Flop (didn't bet)
Seat 6: Bsgwolfpack4 folded before Flop (didn't bet)
Seat 7: JJin91 (button) folded before Flop (didn't bet)
Seat 8: YourRobotDad (small blind) folded before Flop
Seat 9: BENN DOVERR (big blind) folded before Flop


*********** # 14 **************
PokerStars Hand #176118938232: Tournament #1701843149, $18.20+$1.80 USD=
 Hold'em No Limit - Level IV (50/100) - 2017/10/09 19:34:49 ET
Table '1701843149 1' 9-max Seat #8 is the button
Seat 1: Drsnap31 (6290 in chips)=20
Seat 2: braheemin (8390 in chips)=20
Seat 3: TobogganM.D. (13331 in chips)=20
Seat 5: failboat1231 (13184 in chips)=20
Seat 6: Bsgwolfpack4 (17138 in chips)=20
Seat 7: JJin91 (7862 in chips)=20
Seat 8: YourRobotDad (15390 in chips)=20
Seat 9: BENN DOVERR (8900 in chips)=20
Drsnap31: posts the ante 10
braheemin: posts the ante 10
TobogganM.D.: posts the ante 10
failboat1231: posts the ante 10
Bsgwolfpack4: posts the ante 10
JJin91: posts the ante 10
YourRobotDad: posts the ante 10
BENN DOVERR: posts the ante 10
BENN DOVERR: posts small blind 50
Drsnap31: posts big blind 100
*** HOLE CARDS ***
Dealt to JJin91 [3h Qd]
braheemin: folds=20
TobogganM.D.: folds=20
failboat1231: raises 125 to 225
Bsgwolfpack4: calls 225
JJin91: folds=20
YourRobotDad: calls 225
BENN DOVERR: folds=20
Drsnap31: calls 125
*** FLOP *** [5h Kc 6s]
Drsnap31: checks=20
failboat1231: checks=20
Bsgwolfpack4: checks=20
YourRobotDad: bets 500
Drsnap31: folds=20
failboat1231: folds=20
Bsgwolfpack4: calls 500
*** TURN *** [5h Kc 6s] [8h]
Bsgwolfpack4: checks=20
YourRobotDad: bets 1000
Bsgwolfpack4: folds=20
Uncalled bet (1000) returned to YourRobotDad
YourRobotDad collected 2030 from pot
*** SUMMARY ***
Total pot 2030 | Rake 0=20
Board [5h Kc 6s 8h]
Seat 1: Drsnap31 (big blind) folded on the Flop
Seat 2: braheemin folded before Flop (didn't bet)
Seat 3: TobogganM.D. folded before Flop (didn't bet)
Seat 5: failboat1231 folded on the Flop
Seat 6: Bsgwolfpack4 folded on the Turn
Seat 7: JJin91 folded before Flop (didn't bet)
Seat 8: YourRobotDad (button) collected (2030)
Seat 9: BENN DOVERR (small blind) folded before Flop


*********** # 15 **************
PokerStars Hand #176118938453: Tournament #1701843149, $18.20+$1.80 USD=
 Hold'em No Limit - Level IV (50/100) - 2017/10/09 19:35:51 ET
Table '1701843149 1' 9-max Seat #9 is the button
Seat 1: Drsnap31 (6055 in chips)=20
Seat 2: braheemin (8380 in chips)=20
Seat 3: TobogganM.D. (13321 in chips)=20
Seat 5: failboat1231 (12949 in chips)=20
Seat 6: Bsgwolfpack4 (16403 in chips)=20
Seat 7: JJin91 (7852 in chips)=20
Seat 8: YourRobotDad (16685 in chips)=20
Seat 9: BENN DOVERR (8840 in chips)=20
Drsnap31: posts the ante 10
braheemin: posts the ante 10
TobogganM.D.: posts the ante 10
failboat1231: posts the ante 10
Bsgwolfpack4: posts the ante 10
JJin91: posts the ante 10
YourRobotDad: posts the ante 10
BENN DOVERR: posts the ante 10
Drsnap31: posts small blind 50
braheemin: posts big blind 100
*** HOLE CARDS ***
Dealt to JJin91 [7h 6c]
TobogganM.D.: folds=20
failboat1231: folds=20
Bsgwolfpack4: raises 330 to 430
JJin91: folds=20
YourRobotDad: folds=20
BENN DOVERR: raises 670 to 1100
Drsnap31: folds=20
braheemin: folds=20
Bsgwolfpack4: folds=20
Uncalled bet (670) returned to BENN DOVERR
BENN DOVERR collected 1090 from pot
*** SUMMARY ***
Total pot 1090 | Rake 0=20
Seat 1: Drsnap31 (small blind) folded before Flop
Seat 2: braheemin (big blind) folded before Flop
Seat 3: TobogganM.D. folded before Flop (didn't bet)
Seat 5: failboat1231 folded before Flop (didn't bet)
Seat 6: Bsgwolfpack4 folded before Flop
Seat 7: JJin91 folded before Flop (didn't bet)
Seat 8: YourRobotDad folded before Flop (didn't bet)
Seat 9: BENN DOVERR (button) collected (1090)


*********** # 16 **************
PokerStars Hand #176118938597: Tournament #1701843149, $18.20+$1.80 USD=
 Hold'em No Limit - Level IV (50/100) - 2017/10/09 19:36:29 ET
Table '1701843149 1' 9-max Seat #1 is the button
Seat 1: Drsnap31 (5995 in chips)=20
Seat 2: braheemin (8270 in chips)=20
Seat 3: TobogganM.D. (13311 in chips)=20
Seat 4: bethere1923 (10000 in chips)=20
Seat 5: failboat1231 (12939 in chips)=20
Seat 6: Bsgwolfpack4 (15963 in chips)=20
Seat 7: JJin91 (7842 in chips)=20
Seat 8: YourRobotDad (16675 in chips)=20
Seat 9: BENN DOVERR (9490 in chips)=20
Drsnap31: posts the ante 10
braheemin: posts the ante 10
TobogganM.D.: posts the ante 10
bethere1923: posts the ante 10
failboat1231: posts the ante 10
Bsgwolfpack4: posts the ante 10
JJin91: posts the ante 10
YourRobotDad: posts the ante 10
BENN DOVERR: posts the ante 10
braheemin: posts small blind 50
TobogganM.D.: posts big blind 100
*** HOLE CARDS ***
Dealt to JJin91 [Qd 8h]
bethere1923: folds=20
failboat1231: folds=20
Bsgwolfpack4: folds=20
JJin91: folds=20
YourRobotDad: folds=20
BENN DOVERR: folds=20
Drsnap31: folds=20
braheemin: calls 50
TobogganM.D.: checks=20
*** FLOP *** [6h Qs Ac]
braheemin: bets 100
TobogganM.D.: calls 100
*** TURN *** [6h Qs Ac] [9h]
braheemin: checks=20
TobogganM.D.: bets 245
braheemin: folds=20
Uncalled bet (245) returned to TobogganM.D.
TobogganM.D. collected 490 from pot
TobogganM.D.: doesn't show hand=20
*** SUMMARY ***
Total pot 490 | Rake 0=20
Board [6h Qs Ac 9h]
Seat 1: Drsnap31 (button) folded before Flop (didn't bet)
Seat 2: braheemin (small blind) folded on the Turn
Seat 3: TobogganM.D. (big blind) collected (490)
Seat 4: bethere1923 folded before Flop (didn't bet)
Seat 5: failboat1231 folded before Flop (didn't bet)
Seat 6: Bsgwolfpack4 folded before Flop (didn't bet)
Seat 7: JJin91 folded before Flop (didn't bet)
Seat 8: YourRobotDad folded before Flop (didn't bet)
Seat 9: BENN DOVERR folded before Flop (didn't bet)


*********** # 17 **************
PokerStars Hand #176118938830: Tournament #1701843149, $18.20+$1.80 USD=
 Hold'em No Limit - Level IV (50/100) - 2017/10/09 19:37:32 ET
Table '1701843149 1' 9-max Seat #2 is the button
Seat 1: Drsnap31 (5985 in chips)=20
Seat 2: braheemin (8060 in chips)=20
Seat 3: TobogganM.D. (13591 in chips)=20
Seat 4: bethere1923 (9990 in chips)=20
Seat 5: failboat1231 (12929 in chips)=20
Seat 6: Bsgwolfpack4 (15953 in chips)=20
Seat 7: JJin91 (7832 in chips)=20
Seat 8: YourRobotDad (16665 in chips)=20
Seat 9: BENN DOVERR (9480 in chips)=20
Drsnap31: posts the ante 10
braheemin: posts the ante 10
TobogganM.D.: posts the ante 10
bethere1923: posts the ante 10
failboat1231: posts the ante 10
Bsgwolfpack4: posts the ante 10
JJin91: posts the ante 10
YourRobotDad: posts the ante 10
BENN DOVERR: posts the ante 10
TobogganM.D.: posts small blind 50
bethere1923: posts big blind 100
*** HOLE CARDS ***
Dealt to JJin91 [8c Jc]
failboat1231: folds=20
Bsgwolfpack4: folds=20
JJin91: raises 117 to 217
YourRobotDad: folds=20
BENN DOVERR: folds=20
Drsnap31: folds=20
braheemin: folds=20
TobogganM.D.: raises 533 to 750
bethere1923: folds=20
JJin91: folds=20
Uncalled bet (533) returned to TobogganM.D.
TobogganM.D. collected 624 from pot
TobogganM.D.: doesn't show hand=20
*** SUMMARY ***
Total pot 624 | Rake 0=20
Seat 1: Drsnap31 folded before Flop (didn't bet)
Seat 2: braheemin (button) folded before Flop (didn't bet)
Seat 3: TobogganM.D. (small blind) collected (624)
Seat 4: bethere1923 (big blind) folded before Flop
Seat 5: failboat1231 folded before Flop (didn't bet)
Seat 6: Bsgwolfpack4 folded before Flop (didn't bet)
Seat 7: JJin91 folded before Flop
Seat 8: YourRobotDad folded before Flop (didn't bet)
Seat 9: BENN DOVERR folded before Flop (didn't bet)


*********** # 18 **************
PokerStars Hand #176118938996: Tournament #1701843149, $18.20+$1.80 USD=
 Hold'em No Limit - Level IV (50/100) - 2017/10/09 19:38:13 ET
Table '1701843149 1' 9-max Seat #3 is the button
Seat 1: Drsnap31 (5975 in chips)=20
Seat 2: braheemin (8050 in chips)=20
Seat 3: TobogganM.D. (13988 in chips)=20
Seat 4: bethere1923 (9880 in chips)=20
Seat 5: failboat1231 (12919 in chips)=20
Seat 6: Bsgwolfpack4 (15943 in chips)=20
Seat 7: JJin91 (7605 in chips)=20
Seat 8: YourRobotDad (16655 in chips)=20
Seat 9: BENN DOVERR (9470 in chips)=20
Drsnap31: posts the ante 10
braheemin: posts the ante 10
TobogganM.D.: posts the ante 10
bethere1923: posts the ante 10
failboat1231: posts the ante 10
Bsgwolfpack4: posts the ante 10
JJin91: posts the ante 10
YourRobotDad: posts the ante 10
BENN DOVERR: posts the ante 10
bethere1923: posts small blind 50
failboat1231: posts big blind 100
*** HOLE CARDS ***
Dealt to JJin91 [6c 7c]
Bsgwolfpack4: folds=20
JJin91: folds=20
YourRobotDad: raises 100 to 200
BENN DOVERR: folds=20
Drsnap31: calls 200
braheemin: calls 200
TobogganM.D.: folds=20
bethere1923: folds=20
failboat1231: calls 100
*** FLOP *** [8s 4h Ac]
failboat1231: checks=20
YourRobotDad: bets 400
Drsnap31: calls 400
braheemin: folds=20
failboat1231: folds=20
*** TURN *** [8s 4h Ac] [Qc]
YourRobotDad: checks=20
Drsnap31: checks=20
*** RIVER *** [8s 4h Ac Qc] [Tc]
YourRobotDad: checks=20
Drsnap31: checks=20
*** SHOW DOWN ***
YourRobotDad: shows [Qs Jd] (a pair of Queens)
Drsnap31: shows [9h Ah] (a pair of Aces)
Drsnap31 collected 1740 from pot
*** SUMMARY ***
Total pot 1740 | Rake 0=20
Board [8s 4h Ac Qc Tc]
Seat 1: Drsnap31 showed [9h Ah] and won (1740) with a pair of Aces
Seat 2: braheemin folded on the Flop
Seat 3: TobogganM.D. (button) folded before Flop (didn't bet)
Seat 4: bethere1923 (small blind) folded before Flop
Seat 5: failboat1231 (big blind) folded on the Flop
Seat 6: Bsgwolfpack4 folded before Flop (didn't bet)
Seat 7: JJin91 folded before Flop (didn't bet)
Seat 8: YourRobotDad showed [Qs Jd] and lost with a pair of Queens
Seat 9: BENN DOVERR folded before Flop (didn't bet)


*********** # 19 **************
PokerStars Hand #176118939190: Tournament #1701843149, $18.20+$1.80 USD=
 Hold'em No Limit - Level IV (50/100) - 2017/10/09 19:39:06 ET
Table '1701843149 1' 9-max Seat #4 is the button
Seat 1: Drsnap31 (7105 in chips)=20
Seat 2: braheemin (7840 in chips)=20
Seat 3: TobogganM.D. (13978 in chips)=20
Seat 4: bethere1923 (9820 in chips)=20
Seat 5: failboat1231 (12709 in chips)=20
Seat 7: JJin91 (7595 in chips)=20
Seat 8: YourRobotDad (16045 in chips)=20
Seat 9: BENN DOVERR (9460 in chips)=20
Drsnap31: posts the ante 10
braheemin: posts the ante 10
TobogganM.D.: posts the ante 10
bethere1923: posts the ante 10
failboat1231: posts the ante 10
JJin91: posts the ante 10
YourRobotDad: posts the ante 10
BENN DOVERR: posts the ante 10
failboat1231: posts small blind 50
JJin91: posts big blind 100
*** HOLE CARDS ***
Dealt to JJin91 [Ad 5h]
YourRobotDad: folds=20
BENN DOVERR: folds=20
Drsnap31: folds=20
braheemin: raises 100 to 200
TobogganM.D.: folds=20
bethere1923: folds=20
failboat1231: folds=20
JJin91: calls 100
*** FLOP *** [7h 3c 6h]
JJin91: checks=20
braheemin: bets 420
JJin91: raises 1024 to 1444
braheemin: folds=20
Uncalled bet (1024) returned to JJin91
JJin91 collected 1370 from pot
JJin91: doesn't show hand=20
*** SUMMARY ***
Total pot 1370 | Rake 0=20
Board [7h 3c 6h]
Seat 1: Drsnap31 folded before Flop (didn't bet)
Seat 2: braheemin folded on the Flop
Seat 3: TobogganM.D. folded before Flop (didn't bet)
Seat 4: bethere1923 (button) folded before Flop (didn't bet)
Seat 5: failboat1231 (small blind) folded before Flop
Seat 7: JJin91 (big blind) collected (1370)
Seat 8: YourRobotDad folded before Flop (didn't bet)
Seat 9: BENN DOVERR folded before Flop (didn't bet)


*********** # 20 **************
PokerStars Hand #176118939468: Tournament #1701843149, $18.20+$1.80 USD=
 Hold'em No Limit - Level V (60/120) - 2017/10/09 19:40:21 ET
Table '1701843149 1' 9-max Seat #5 is the button
Seat 1: Drsnap31 (7095 in chips)=20
Seat 2: braheemin (7210 in chips)=20
Seat 3: TobogganM.D. (13968 in chips)=20
Seat 4: bethere1923 (9810 in chips)=20
Seat 5: failboat1231 (12649 in chips)=20
Seat 7: JJin91 (8335 in chips)=20
Seat 8: YourRobotDad (16035 in chips)=20
Seat 9: BENN DOVERR (9450 in chips)=20
Drsnap31: posts the ante 15
braheemin: posts the ante 15
TobogganM.D.: posts the ante 15
bethere1923: posts the ante 15
failboat1231: posts the ante 15
JJin91: posts the ante 15
YourRobotDad: posts the ante 15
BENN DOVERR: posts the ante 15
JJin91: posts small blind 60
YourRobotDad: posts big blind 120
*** HOLE CARDS ***
Dealt to JJin91 [3c 3s]
BENN DOVERR: folds=20
Drsnap31: folds=20
braheemin: folds=20
TobogganM.D.: folds=20
bethere1923: raises 144 to 264
failboat1231: folds=20
JJin91: raises 512 to 776
YourRobotDad: folds=20
bethere1923: calls 512
*** FLOP *** [Ah Ac 5s]
JJin91: bets 1244
bethere1923: folds=20
Uncalled bet (1244) returned to JJin91
JJin91 collected 1792 from pot
JJin91: doesn't show hand=20
*** SUMMARY ***
Total pot 1792 | Rake 0=20
Board [Ah Ac 5s]
Seat 1: Drsnap31 folded before Flop (didn't bet)
Seat 2: braheemin folded before Flop (didn't bet)
Seat 3: TobogganM.D. folded before Flop (didn't bet)
Seat 4: bethere1923 folded on the Flop
Seat 5: failboat1231 (button) folded before Flop (didn't bet)
Seat 7: JJin91 (small blind) collected (1792)
Seat 8: YourRobotDad (big blind) folded before Flop
Seat 9: BENN DOVERR folded before Flop (didn't bet)


*********** # 21 **************
PokerStars Hand #176118939773: Tournament #1701843149, $18.20+$1.80 USD=
 Hold'em No Limit - Level V (60/120) - 2017/10/09 19:41:43 ET
Table '1701843149 1' 9-max Seat #7 is the button
Seat 1: Drsnap31 (7080 in chips)=20
Seat 2: braheemin (7195 in chips)=20
Seat 3: TobogganM.D. (13953 in chips)=20
Seat 4: bethere1923 (9019 in chips)=20
Seat 5: failboat1231 (12634 in chips)=20
Seat 7: JJin91 (9336 in chips)=20
Seat 8: YourRobotDad (15900 in chips)=20
Seat 9: BENN DOVERR (9435 in chips)=20
Drsnap31: posts the ante 15
braheemin: posts the ante 15
TobogganM.D.: posts the ante 15
bethere1923: posts the ante 15
failboat1231: posts the ante 15
JJin91: posts the ante 15
YourRobotDad: posts the ante 15
BENN DOVERR: posts the ante 15
YourRobotDad: posts small blind 60
BENN DOVERR: posts big blind 120
*** HOLE CARDS ***
Dealt to JJin91 [8d 9c]
Drsnap31: folds=20
braheemin: raises 180 to 300
TobogganM.D.: calls 300
bethere1923: folds=20
failboat1231: folds=20
JJin91: folds=20
YourRobotDad: folds=20
BENN DOVERR: folds=20
*** FLOP *** [9h 3d 9d]
braheemin: checks=20
TobogganM.D.: bets 450
braheemin: folds=20
Uncalled bet (450) returned to TobogganM.D.
TobogganM.D. collected 900 from pot
TobogganM.D.: doesn't show hand=20
*** SUMMARY ***
Total pot 900 | Rake 0=20
Board [9h 3d 9d]
Seat 1: Drsnap31 folded before Flop (didn't bet)
Seat 2: braheemin folded on the Flop
Seat 3: TobogganM.D. collected (900)
Seat 4: bethere1923 folded before Flop (didn't bet)
Seat 5: failboat1231 folded before Flop (didn't bet)
Seat 7: JJin91 (button) folded before Flop (didn't bet)
Seat 8: YourRobotDad (small blind) folded before Flop
Seat 9: BENN DOVERR (big blind) folded before Flop


*********** # 22 **************
PokerStars Hand #176118939920: Tournament #1701843149, $18.20+$1.80 USD=
 Hold'em No Limit - Level V (60/120) - 2017/10/09 19:42:23 ET
Table '1701843149 1' 9-max Seat #8 is the button
Seat 1: Drsnap31 (7065 in chips)=20
Seat 2: braheemin (6880 in chips)=20
Seat 3: TobogganM.D. (14538 in chips)=20
Seat 4: bethere1923 (9004 in chips)=20
Seat 5: failboat1231 (12619 in chips)=20
Seat 7: JJin91 (9321 in chips)=20
Seat 8: YourRobotDad (15825 in chips)=20
Seat 9: BENN DOVERR (9300 in chips)=20
Drsnap31: posts the ante 15
braheemin: posts the ante 15
TobogganM.D.: posts the ante 15
bethere1923: posts the ante 15
failboat1231: posts the ante 15
JJin91: posts the ante 15
YourRobotDad: posts the ante 15
BENN DOVERR: posts the ante 15
BENN DOVERR: posts small blind 60
Drsnap31: posts big blind 120
*** HOLE CARDS ***
Dealt to JJin91 [Qc 6d]
braheemin: calls 120
TobogganM.D.: folds=20
bethere1923: folds=20
failboat1231: folds=20
JJin91: folds=20
YourRobotDad: folds=20
BENN DOVERR: raises 360 to 480
Drsnap31: folds=20
braheemin: calls 360
*** FLOP *** [5h 6c 7d]
BENN DOVERR: bets 528
braheemin: raises 1072 to 1600
BENN DOVERR: calls 1072
*** TURN *** [5h 6c 7d] [Jc]
BENN DOVERR: checks=20
braheemin: bets 4785 and is all-in
BENN DOVERR: folds=20
Uncalled bet (4785) returned to braheemin
braheemin collected 4400 from pot
braheemin: doesn't show hand=20
*** SUMMARY ***
Total pot 4400 | Rake 0=20
Board [5h 6c 7d Jc]
Seat 1: Drsnap31 (big blind) folded before Flop
Seat 2: braheemin collected (4400)
Seat 3: TobogganM.D. folded before Flop (didn't bet)
Seat 4: bethere1923 folded before Flop (didn't bet)
Seat 5: failboat1231 folded before Flop (didn't bet)
Seat 7: JJin91 folded before Flop (didn't bet)
Seat 8: YourRobotDad (button) folded before Flop (didn't bet)
Seat 9: BENN DOVERR (small blind) folded on the Turn


*********** # 23 **************
PokerStars Hand #176120104377: Tournament #1701843149, $18.20+$1.80 USD=
 Hold'em No Limit - Level V (60/120) - 2017/10/09 19:43:29 ET
Table '1701843149 1' 9-max Seat #9 is the button
Seat 1: Drsnap31 (6930 in chips)=20
Seat 2: braheemin (9185 in chips)=20
Seat 3: TobogganM.D. (14523 in chips)=20
Seat 4: bethere1923 (8989 in chips)=20
Seat 5: failboat1231 (12604 in chips)=20
Seat 7: JJin91 (9306 in chips)=20
Seat 8: YourRobotDad (15810 in chips)=20
Seat 9: BENN DOVERR (7205 in chips)=20
Drsnap31: posts the ante 15
braheemin: posts the ante 15
TobogganM.D.: posts the ante 15
bethere1923: posts the ante 15
failboat1231: posts the ante 15
JJin91: posts the ante 15
YourRobotDad: posts the ante 15
BENN DOVERR: posts the ante 15
Drsnap31: posts small blind 60
braheemin: posts big blind 120
*** HOLE CARDS ***
Dealt to JJin91 [Jh Kd]
TobogganM.D.: folds=20
bethere1923: folds=20
failboat1231: folds=20
JJin91: raises 140 to 260
YourRobotDad: folds=20
BENN DOVERR: folds=20
Drsnap31: folds=20
braheemin: folds=20
Uncalled bet (140) returned to JJin91
JJin91 collected 420 from pot
JJin91: doesn't show hand=20
*** SUMMARY ***
Total pot 420 | Rake 0=20
Seat 1: Drsnap31 (small blind) folded before Flop
Seat 2: braheemin (big blind) folded before Flop
Seat 3: TobogganM.D. folded before Flop (didn't bet)
Seat 4: bethere1923 folded before Flop (didn't bet)
Seat 5: failboat1231 folded before Flop (didn't bet)
Seat 7: JJin91 collected (420)
Seat 8: YourRobotDad folded before Flop (didn't bet)
Seat 9: BENN DOVERR (button) folded before Flop (didn't bet)


*********** # 24 **************
PokerStars Hand #176120104506: Tournament #1701843149, $18.20+$1.80 USD=
 Hold'em No Limit - Level V (60/120) - 2017/10/09 19:44:00 ET
Table '1701843149 1' 9-max Seat #1 is the button
Seat 1: Drsnap31 (6855 in chips)=20
Seat 2: braheemin (9050 in chips)=20
Seat 3: TobogganM.D. (14508 in chips)=20
Seat 4: bethere1923 (8974 in chips)=20
Seat 5: failboat1231 (12589 in chips)=20
Seat 7: JJin91 (9591 in chips)=20
Seat 8: YourRobotDad (15795 in chips)=20
Seat 9: BENN DOVERR (7190 in chips)=20
Drsnap31: posts the ante 15
braheemin: posts the ante 15
TobogganM.D.: posts the ante 15
bethere1923: posts the ante 15
failboat1231: posts the ante 15
JJin91: posts the ante 15
YourRobotDad: posts the ante 15
BENN DOVERR: posts the ante 15
braheemin: posts small blind 60
TobogganM.D.: posts big blind 120
*** HOLE CARDS ***
Dealt to JJin91 [As 9h]
bethere1923: folds=20
failboat1231: folds=20
JJin91: folds=20
YourRobotDad: calls 120
BENN DOVERR: folds=20
Drsnap31: folds=20
braheemin: folds=20
TobogganM.D.: checks=20
*** FLOP *** [8c 2d Ah]
TobogganM.D.: checks=20
YourRobotDad: bets 240
TobogganM.D.: calls 240
*** TURN *** [8c 2d Ah] [7d]
TobogganM.D.: checks=20
YourRobotDad: bets 480
TobogganM.D.: calls 480
*** RIVER *** [8c 2d Ah 7d] [5d]
TobogganM.D.: checks=20
YourRobotDad: bets 840
TobogganM.D.: folds=20
Uncalled bet (840) returned to YourRobotDad
YourRobotDad collected 1860 from pot
*** SUMMARY ***
Total pot 1860 | Rake 0=20
Board [8c 2d Ah 7d 5d]
Seat 1: Drsnap31 (button) folded before Flop (didn't bet)
Seat 2: braheemin (small blind) folded before Flop
Seat 3: TobogganM.D. (big blind) folded on the River
Seat 4: bethere1923 folded before Flop (didn't bet)
Seat 5: failboat1231 folded before Flop (didn't bet)
Seat 7: JJin91 folded before Flop (didn't bet)
Seat 8: YourRobotDad collected (1860)
Seat 9: BENN DOVERR folded before Flop (didn't bet)


*********** # 25 **************
PokerStars Hand #176120104816: Tournament #1701843149, $18.20+$1.80 USD=
 Hold'em No Limit - Level V (60/120) - 2017/10/09 19:45:14 ET
Table '1701843149 1' 9-max Seat #2 is the button
Seat 1: Drsnap31 (6840 in chips)=20
Seat 2: braheemin (8975 in chips)=20
Seat 3: TobogganM.D. (13653 in chips)=20
Seat 4: bethere1923 (8959 in chips)=20
Seat 5: failboat1231 (12574 in chips)=20
Seat 7: JJin91 (9576 in chips)=20
Seat 8: YourRobotDad (16800 in chips)=20
Seat 9: BENN DOVERR (7175 in chips)=20
Drsnap31: posts the ante 15
braheemin: posts the ante 15
TobogganM.D.: posts the ante 15
bethere1923: posts the ante 15
failboat1231: posts the ante 15
JJin91: posts the ante 15
YourRobotDad: posts the ante 15
BENN DOVERR: posts the ante 15
TobogganM.D.: posts small blind 60
bethere1923: posts big blind 120
*** HOLE CARDS ***
Dealt to JJin91 [5s Qh]
failboat1231: raises 150 to 270
JJin91: folds=20
YourRobotDad: folds=20
BENN DOVERR: folds=20
Drsnap31: folds=20
braheemin: folds=20
TobogganM.D.: folds=20
bethere1923: calls 150
*** FLOP *** [7h 5c 8c]
bethere1923: checks=20
failboat1231: bets 360
bethere1923: calls 360
*** TURN *** [7h 5c 8c] [6h]
bethere1923: bets 755
failboat1231: folds=20
Uncalled bet (755) returned to bethere1923
bethere1923 collected 1440 from pot
bethere1923: doesn't show hand=20
*** SUMMARY ***
Total pot 1440 | Rake 0=20
Board [7h 5c 8c 6h]
Seat 1: Drsnap31 folded before Flop (didn't bet)
Seat 2: braheemin (button) folded before Flop (didn't bet)
Seat 3: TobogganM.D. (small blind) folded before Flop
Seat 4: bethere1923 (big blind) collected (1440)
Seat 5: failboat1231 folded on the Turn
Seat 7: JJin91 folded before Flop (didn't bet)
Seat 8: YourRobotDad folded before Flop (didn't bet)
Seat 9: BENN DOVERR folded before Flop (didn't bet)


*********** # 26 **************
PokerStars Hand #176120105007: Tournament #1701843149, $18.20+$1.80 USD=
 Hold'em No Limit - Level V (60/120) - 2017/10/09 19:46:01 ET
Table '1701843149 1' 9-max Seat #3 is the button
Seat 1: Drsnap31 (6825 in chips)=20
Seat 2: braheemin (8960 in chips)=20
Seat 3: TobogganM.D. (13578 in chips)=20
Seat 4: bethere1923 (9754 in chips)=20
Seat 5: failboat1231 (11929 in chips)=20
Seat 7: JJin91 (9561 in chips)=20
Seat 8: YourRobotDad (16785 in chips)=20
Seat 9: BENN DOVERR (7160 in chips)=20
Drsnap31: posts the ante 15
braheemin: posts the ante 15
TobogganM.D.: posts the ante 15
bethere1923: posts the ante 15
failboat1231: posts the ante 15
JJin91: posts the ante 15
YourRobotDad: posts the ante 15
BENN DOVERR: posts the ante 15
bethere1923: posts small blind 60
failboat1231: posts big blind 120
*** HOLE CARDS ***
Dealt to JJin91 [Kc Ks]
JJin91: raises 140 to 260
YourRobotDad: folds=20
BENN DOVERR: folds=20
Drsnap31: folds=20
braheemin: folds=20
TobogganM.D.: folds=20
bethere1923: folds=20
failboat1231: folds=20
Uncalled bet (140) returned to JJin91
JJin91 collected 420 from pot
JJin91: doesn't show hand=20
*** SUMMARY ***
Total pot 420 | Rake 0=20
Seat 1: Drsnap31 folded before Flop (didn't bet)
Seat 2: braheemin folded before Flop (didn't bet)
Seat 3: TobogganM.D. (button) folded before Flop (didn't bet)
Seat 4: bethere1923 (small blind) folded before Flop
Seat 5: failboat1231 (big blind) folded before Flop
Seat 7: JJin91 collected (420)
Seat 8: YourRobotDad folded before Flop (didn't bet)
Seat 9: BENN DOVERR folded before Flop (didn't bet)


*********** # 27 **************
PokerStars Hand #176120105093: Tournament #1701843149, $18.20+$1.80 USD=
 Hold'em No Limit - Level V (60/120) - 2017/10/09 19:46:22 ET
Table '1701843149 1' 9-max Seat #4 is the button
Seat 1: Drsnap31 (6810 in chips)=20
Seat 2: braheemin (8945 in chips)=20
Seat 3: TobogganM.D. (13563 in chips)=20
Seat 4: bethere1923 (9679 in chips)=20
Seat 5: failboat1231 (11794 in chips)=20
Seat 7: JJin91 (9846 in chips)=20
Seat 8: YourRobotDad (16770 in chips)=20
Seat 9: BENN DOVERR (7145 in chips)=20
Drsnap31: posts the ante 15
braheemin: posts the ante 15
TobogganM.D.: posts the ante 15
bethere1923: posts the ante 15
failboat1231: posts the ante 15
JJin91: posts the ante 15
YourRobotDad: posts the ante 15
BENN DOVERR: posts the ante 15
failboat1231: posts small blind 60
JJin91: posts big blind 120
*** HOLE CARDS ***
Dealt to JJin91 [8h 9d]
YourRobotDad: folds=20
BENN DOVERR: folds=20
Drsnap31: folds=20
braheemin: raises 120 to 240
TobogganM.D.: folds=20
bethere1923: folds=20
failboat1231: folds=20
JJin91: calls 120
*** FLOP *** [3s 2h Ah]
JJin91: checks=20
braheemin: bets 300
JJin91: folds=20
Uncalled bet (300) returned to braheemin
braheemin collected 660 from pot
braheemin: doesn't show hand=20
*** SUMMARY ***
Total pot 660 | Rake 0=20
Board [3s 2h Ah]
Seat 1: Drsnap31 folded before Flop (didn't bet)
Seat 2: braheemin collected (660)
Seat 3: TobogganM.D. folded before Flop (didn't bet)
Seat 4: bethere1923 (button) folded before Flop (didn't bet)
Seat 5: failboat1231 (small blind) folded before Flop
Seat 7: JJin91 (big blind) folded on the Flop
Seat 8: YourRobotDad folded before Flop (didn't bet)
Seat 9: BENN DOVERR folded before Flop (didn't bet)


*********** # 28 **************
PokerStars Hand #176120105262: Tournament #1701843149, $18.20+$1.80 USD=
 Hold'em No Limit - Level V (60/120) - 2017/10/09 19:47:03 ET
Table '1701843149 1' 9-max Seat #5 is the button
Seat 1: Drsnap31 (6795 in chips)=20
Seat 2: braheemin (9350 in chips)=20
Seat 3: TobogganM.D. (13548 in chips)=20
Seat 4: bethere1923 (9664 in chips)=20
Seat 5: failboat1231 (11719 in chips)=20
Seat 7: JJin91 (9591 in chips)=20
Seat 8: YourRobotDad (16755 in chips)=20
Seat 9: BENN DOVERR (7130 in chips)=20
Drsnap31: posts the ante 15
braheemin: posts the ante 15
TobogganM.D.: posts the ante 15
bethere1923: posts the ante 15
failboat1231: posts the ante 15
JJin91: posts the ante 15
YourRobotDad: posts the ante 15
BENN DOVERR: posts the ante 15
JJin91: posts small blind 60
YourRobotDad: posts big blind 120
*** HOLE CARDS ***
Dealt to JJin91 [Qh Qd]
BENN DOVERR: folds=20
Drsnap31: folds=20
braheemin: folds=20
TobogganM.D.: raises 210 to 330
bethere1923: folds=20
failboat1231: folds=20
JJin91: raises 781 to 1111
YourRobotDad: folds=20
TobogganM.D.: calls 781
*** FLOP *** [Ac 2c As]
JJin91: checks=20
TobogganM.D.: checks=20
*** TURN *** [Ac 2c As] [9s]
JJin91: checks=20
TobogganM.D.: checks=20
*** RIVER *** [Ac 2c As 9s] [Jh]
JJin91: bets 888
TobogganM.D.: folds=20
Uncalled bet (888) returned to JJin91
JJin91 collected 2462 from pot
JJin91: doesn't show hand=20
*** SUMMARY ***
Total pot 2462 | Rake 0=20
Board [Ac 2c As 9s Jh]
Seat 1: Drsnap31 folded before Flop (didn't bet)
Seat 2: braheemin folded before Flop (didn't bet)
Seat 3: TobogganM.D. folded on the River
Seat 4: bethere1923 folded before Flop (didn't bet)
Seat 5: failboat1231 (button) folded before Flop (didn't bet)
Seat 7: JJin91 (small blind) collected (2462)
Seat 8: YourRobotDad (big blind) folded before Flop
Seat 9: BENN DOVERR folded before Flop (didn't bet)


*********** # 29 **************
PokerStars Hand #176120105522: Tournament #1701843149, $18.20+$1.80 USD=
 Hold'em No Limit - Level V (60/120) - 2017/10/09 19:48:12 ET
Table '1701843149 1' 9-max Seat #7 is the button
Seat 1: Drsnap31 (6780 in chips)=20
Seat 2: braheemin (9335 in chips)=20
Seat 3: TobogganM.D. (12422 in chips)=20
Seat 4: bethere1923 (9649 in chips)=20
Seat 5: failboat1231 (11704 in chips)=20
Seat 7: JJin91 (10927 in chips)=20
Seat 8: YourRobotDad (16620 in chips)=20
Seat 9: BENN DOVERR (7115 in chips)=20
Drsnap31: posts the ante 15
braheemin: posts the ante 15
TobogganM.D.: posts the ante 15
bethere1923: posts the ante 15
failboat1231: posts the ante 15
JJin91: posts the ante 15
YourRobotDad: posts the ante 15
BENN DOVERR: posts the ante 15
YourRobotDad: posts small blind 60
BENN DOVERR: posts big blind 120
*** HOLE CARDS ***
Dealt to JJin91 [Kc As]
Drsnap31: folds=20
braheemin: raises 120 to 240
TobogganM.D.: folds=20
bethere1923: folds=20
failboat1231: folds=20
JJin91: raises 871 to 1111
YourRobotDad: folds=20
BENN DOVERR: folds=20
braheemin: calls 871
*** FLOP *** [3h 7c Kd]
braheemin: checks=20
JJin91: bets 1111
braheemin: folds=20
Uncalled bet (1111) returned to JJin91
JJin91 collected 2522 from pot
JJin91: doesn't show hand=20
*** SUMMARY ***
Total pot 2522 | Rake 0=20
Board [3h 7c Kd]
Seat 1: Drsnap31 folded before Flop (didn't bet)
Seat 2: braheemin folded on the Flop
Seat 3: TobogganM.D. folded before Flop (didn't bet)
Seat 4: bethere1923 folded before Flop (didn't bet)
Seat 5: failboat1231 folded before Flop (didn't bet)
Seat 7: JJin91 (button) collected (2522)
Seat 8: YourRobotDad (small blind) folded before Flop
Seat 9: BENN DOVERR (big blind) folded before Flop


*********** # 30 **************
PokerStars Hand #176120105748: Tournament #1701843149, $18.20+$1.80 USD=
 Hold'em No Limit - Level V (60/120) - 2017/10/09 19:49:08 ET
Table '1701843149 1' 9-max Seat #8 is the button
Seat 1: Drsnap31 (6765 in chips)=20
Seat 2: braheemin (8209 in chips)=20
Seat 3: TobogganM.D. (12407 in chips)=20
Seat 4: bethere1923 (9634 in chips)=20
Seat 5: failboat1231 (11689 in chips)=20
Seat 7: JJin91 (12323 in chips)=20
Seat 8: YourRobotDad (16545 in chips)=20
Seat 9: BENN DOVERR (6980 in chips)=20
Drsnap31: posts the ante 15
braheemin: posts the ante 15
TobogganM.D.: posts the ante 15
bethere1923: posts the ante 15
failboat1231: posts the ante 15
JJin91: posts the ante 15
YourRobotDad: posts the ante 15
BENN DOVERR: posts the ante 15
BENN DOVERR: posts small blind 60
Drsnap31: posts big blind 120
*** HOLE CARDS ***
Dealt to JJin91 [6c 6s]
braheemin: calls 120
TobogganM.D.: raises 210 to 330
bethere1923: folds=20
failboat1231: folds=20
JJin91: folds=20
YourRobotDad: folds=20
BENN DOVERR: folds=20
Drsnap31: folds=20
braheemin: calls 210
*** FLOP *** [3s 3d 4d]
braheemin: checks=20
TobogganM.D.: bets 460
braheemin: raises 1240 to 1700
TobogganM.D.: calls 1240
*** TURN *** [3s 3d 4d] [5c]
braheemin: bets 1900
TobogganM.D.: folds=20
Uncalled bet (1900) returned to braheemin
braheemin collected 4360 from pot
braheemin: doesn't show hand=20
*** SUMMARY ***
Total pot 4360 | Rake 0=20
Board [3s 3d 4d 5c]
Seat 1: Drsnap31 (big blind) folded before Flop
Seat 2: braheemin collected (4360)
Seat 3: TobogganM.D. folded on the Turn
Seat 4: bethere1923 folded before Flop (didn't bet)
Seat 5: failboat1231 folded before Flop (didn't bet)
Seat 7: JJin91 folded before Flop (didn't bet)
Seat 8: YourRobotDad (button) folded before Flop (didn't bet)
Seat 9: BENN DOVERR (small blind) folded before Flop


*********** # 31 **************
PokerStars Hand #176120106009: Tournament #1701843149, $18.20+$1.80 USD=
 Hold'em No Limit - Level VI (75/150) - 2017/10/09 19:50:13 ET
Table '1701843149 1' 9-max Seat #9 is the button
Seat 1: Drsnap31 (6630 in chips)=20
Seat 2: braheemin (10524 in chips)=20
Seat 3: TobogganM.D. (10362 in chips)=20
Seat 4: bethere1923 (9619 in chips)=20
Seat 5: failboat1231 (11674 in chips)=20
Seat 7: JJin91 (12308 in chips)=20
Seat 8: YourRobotDad (16530 in chips)=20
Seat 9: BENN DOVERR (6905 in chips)=20
Drsnap31: posts the ante 20
braheemin: posts the ante 20
TobogganM.D.: posts the ante 20
bethere1923: posts the ante 20
failboat1231: posts the ante 20
JJin91: posts the ante 20
YourRobotDad: posts the ante 20
BENN DOVERR: posts the ante 20
Drsnap31: posts small blind 75
braheemin: posts big blind 150
*** HOLE CARDS ***
Dealt to JJin91 [Td Jd]
TobogganM.D.: folds=20
bethere1923: folds=20
failboat1231: folds=20
JJin91: raises 175 to 325
YourRobotDad: folds=20
BENN DOVERR: folds=20
Drsnap31: folds=20
braheemin: calls 175
*** FLOP *** [Jc 5c 9s]
braheemin: checks=20
JJin91: bets 555
braheemin: folds=20
Uncalled bet (555) returned to JJin91
JJin91 collected 885 from pot
JJin91: doesn't show hand=20
*** SUMMARY ***
Total pot 885 | Rake 0=20
Board [Jc 5c 9s]
Seat 1: Drsnap31 (small blind) folded before Flop
Seat 2: braheemin (big blind) folded on the Flop
Seat 3: TobogganM.D. folded before Flop (didn't bet)
Seat 4: bethere1923 folded before Flop (didn't bet)
Seat 5: failboat1231 folded before Flop (didn't bet)
Seat 7: JJin91 collected (885)
Seat 8: YourRobotDad folded before Flop (didn't bet)
Seat 9: BENN DOVERR (button) folded before Flop (didn't bet)


*********** # 32 **************
PokerStars Hand #176120106176: Tournament #1701843149, $18.20+$1.80 USD=
 Hold'em No Limit - Level VI (75/150) - 2017/10/09 19:50:52 ET
Table '1701843149 1' 9-max Seat #1 is the button
Seat 1: Drsnap31 (6535 in chips)=20
Seat 2: braheemin (10179 in chips)=20
Seat 3: TobogganM.D. (10342 in chips)=20
Seat 4: bethere1923 (9599 in chips)=20
Seat 5: failboat1231 (11654 in chips)=20
Seat 7: JJin91 (12848 in chips)=20
Seat 8: YourRobotDad (16510 in chips)=20
Seat 9: BENN DOVERR (6885 in chips)=20
Drsnap31: posts the ante 20
braheemin: posts the ante 20
TobogganM.D.: posts the ante 20
bethere1923: posts the ante 20
failboat1231: posts the ante 20
JJin91: posts the ante 20
YourRobotDad: posts the ante 20
BENN DOVERR: posts the ante 20
braheemin: posts small blind 75
TobogganM.D.: posts big blind 150
*** HOLE CARDS ***
Dealt to JJin91 [Kh As]
bethere1923: folds=20
failboat1231: folds=20
JJin91: raises 175 to 325
YourRobotDad: folds=20
BENN DOVERR: folds=20
Drsnap31: folds=20
braheemin: calls 250
TobogganM.D.: folds=20
*** FLOP *** [3c Ac Kd]
braheemin: checks=20
JJin91: checks=20
*** TURN *** [3c Ac Kd] [5d]
braheemin: bets 500
JJin91: calls 500
*** RIVER *** [3c Ac Kd 5d] [Th]
braheemin: bets 900
JJin91: calls 900
*** SHOW DOWN ***
braheemin: shows [2d Ah] (a pair of Aces)
JJin91: shows [Kh As] (two pair, Aces and Kings)
JJin91 collected 3760 from pot
*** SUMMARY ***
Total pot 3760 | Rake 0=20
Board [3c Ac Kd 5d Th]
Seat 1: Drsnap31 (button) folded before Flop (didn't bet)
Seat 2: braheemin (small blind) showed [2d Ah] and lost with a pair of =
Aces
Seat 3: TobogganM.D. (big blind) folded before Flop
Seat 4: bethere1923 folded before Flop (didn't bet)
Seat 5: failboat1231 folded before Flop (didn't bet)
Seat 7: JJin91 showed [Kh As] and won (3760) with two pair, Aces and Ki=
ngs
Seat 8: YourRobotDad folded before Flop (didn't bet)
Seat 9: BENN DOVERR folded before Flop (didn't bet)


*********** # 33 **************
PokerStars Hand #176120106462: Tournament #1701843149, $18.20+$1.80 USD=
 Hold'em No Limit - Level VI (75/150) - 2017/10/09 19:52:08 ET
Table '1701843149 1' 9-max Seat #2 is the button
Seat 1: Drsnap31 (6515 in chips)=20
Seat 2: braheemin (8434 in chips)=20
Seat 3: TobogganM.D. (10172 in chips)=20
Seat 4: bethere1923 (9579 in chips)=20
Seat 5: failboat1231 (11634 in chips)=20
Seat 7: JJin91 (14863 in chips)=20
Seat 8: YourRobotDad (16490 in chips)=20
Seat 9: BENN DOVERR (6865 in chips)=20
Drsnap31: posts the ante 20
braheemin: posts the ante 20
TobogganM.D.: posts the ante 20
bethere1923: posts the ante 20
failboat1231: posts the ante 20
JJin91: posts the ante 20
YourRobotDad: posts the ante 20
BENN DOVERR: posts the ante 20
TobogganM.D.: posts small blind 75
bethere1923: posts big blind 150
*** HOLE CARDS ***
Dealt to JJin91 [Jc 2s]
failboat1231: raises 187 to 337
JJin91: folds=20
YourRobotDad: folds=20
BENN DOVERR: folds=20
Drsnap31: folds=20
braheemin: folds=20
TobogganM.D.: folds=20
bethere1923: calls 187
*** FLOP *** [5c As 7s]
bethere1923: checks=20
failboat1231: bets 600
bethere1923: folds=20
Uncalled bet (600) returned to failboat1231
failboat1231 collected 909 from pot
failboat1231: doesn't show hand=20
*** SUMMARY ***
Total pot 909 | Rake 0=20
Board [5c As 7s]
Seat 1: Drsnap31 folded before Flop (didn't bet)
Seat 2: braheemin (button) folded before Flop (didn't bet)
Seat 3: TobogganM.D. (small blind) folded before Flop
Seat 4: bethere1923 (big blind) folded on the Flop
Seat 5: failboat1231 collected (909)
Seat 7: JJin91 folded before Flop (didn't bet)
Seat 8: YourRobotDad folded before Flop (didn't bet)
Seat 9: BENN DOVERR folded before Flop (didn't bet)


*********** # 34 **************
PokerStars Hand #176120106567: Tournament #1701843149, $18.20+$1.80 USD=
 Hold'em No Limit - Level VI (75/150) - 2017/10/09 19:52:38 ET
Table '1701843149 1' 9-max Seat #3 is the button
Seat 1: Drsnap31 (6495 in chips)=20
Seat 2: braheemin (8414 in chips)=20
Seat 3: TobogganM.D. (10077 in chips)=20
Seat 4: bethere1923 (9222 in chips)=20
Seat 5: failboat1231 (12186 in chips)=20
Seat 7: JJin91 (14843 in chips)=20
Seat 8: YourRobotDad (16470 in chips)=20
Seat 9: BENN DOVERR (6845 in chips)=20
Drsnap31: posts the ante 20
braheemin: posts the ante 20
TobogganM.D.: posts the ante 20
bethere1923: posts the ante 20
failboat1231: posts the ante 20
JJin91: posts the ante 20
YourRobotDad: posts the ante 20
BENN DOVERR: posts the ante 20
bethere1923: posts small blind 75
failboat1231: posts big blind 150
*** HOLE CARDS ***
Dealt to JJin91 [2c 3h]
JJin91: folds=20
YourRobotDad: folds=20
BENN DOVERR: folds=20
Drsnap31: folds=20
braheemin: folds=20
TobogganM.D.: folds=20
bethere1923: calls 75
failboat1231: checks=20
*** FLOP *** [6d 4s Ts]
bethere1923: checks=20
failboat1231: bets 150
bethere1923: folds=20
Uncalled bet (150) returned to failboat1231
failboat1231 collected 460 from pot
failboat1231: doesn't show hand=20
*** SUMMARY ***
Total pot 460 | Rake 0=20
Board [6d 4s Ts]
Seat 1: Drsnap31 folded before Flop (didn't bet)
Seat 2: braheemin folded before Flop (didn't bet)
Seat 3: TobogganM.D. (button) folded before Flop (didn't bet)
Seat 4: bethere1923 (small blind) folded on the Flop
Seat 5: failboat1231 (big blind) collected (460)
Seat 7: JJin91 folded before Flop (didn't bet)
Seat 8: YourRobotDad folded before Flop (didn't bet)
Seat 9: BENN DOVERR folded before Flop (didn't bet)


*********** # 35 **************
PokerStars Hand #176120106657: Tournament #1701843149, $18.20+$1.80 USD=
 Hold'em No Limit - Level VI (75/150) - 2017/10/09 19:53:05 ET
Table '1701843149 1' 9-max Seat #4 is the button
Seat 1: Drsnap31 (6475 in chips)=20
Seat 2: braheemin (8394 in chips)=20
Seat 3: TobogganM.D. (10057 in chips)=20
Seat 4: bethere1923 (9052 in chips)=20
Seat 5: failboat1231 (12476 in chips)=20
Seat 7: JJin91 (14823 in chips)=20
Seat 8: YourRobotDad (16450 in chips)=20
Seat 9: BENN DOVERR (6825 in chips)=20
Drsnap31: posts the ante 20
braheemin: posts the ante 20
TobogganM.D.: posts the ante 20
bethere1923: posts the ante 20
failboat1231: posts the ante 20
JJin91: posts the ante 20
YourRobotDad: posts the ante 20
BENN DOVERR: posts the ante 20
failboat1231: posts small blind 75
JJin91: posts big blind 150
*** HOLE CARDS ***
Dealt to JJin91 [7s Ts]
YourRobotDad: folds=20
BENN DOVERR: folds=20
Drsnap31: folds=20
braheemin: folds=20
TobogganM.D.: folds=20
bethere1923: folds=20
failboat1231: folds=20
Uncalled bet (75) returned to JJin91
JJin91 collected 310 from pot
JJin91: doesn't show hand=20
*** SUMMARY ***
Total pot 310 | Rake 0=20
Seat 1: Drsnap31 folded before Flop (didn't bet)
Seat 2: braheemin folded before Flop (didn't bet)
Seat 3: TobogganM.D. folded before Flop (didn't bet)
Seat 4: bethere1923 (button) folded before Flop (didn't bet)
Seat 5: failboat1231 (small blind) folded before Flop
Seat 7: JJin91 (big blind) collected (310)
Seat 8: YourRobotDad folded before Flop (didn't bet)
Seat 9: BENN DOVERR folded before Flop (didn't bet)


*********** # 36 **************
PokerStars Hand #176120106718: Tournament #1701843149, $18.20+$1.80 USD=
 Hold'em No Limit - Level VI (75/150) - 2017/10/09 19:53:24 ET
Table '1701843149 1' 9-max Seat #5 is the button
Seat 1: Drsnap31 (6455 in chips)=20
Seat 2: braheemin (8374 in chips)=20
Seat 3: TobogganM.D. (10037 in chips)=20
Seat 4: bethere1923 (9032 in chips)=20
Seat 5: failboat1231 (12381 in chips)=20
Seat 7: JJin91 (15038 in chips)=20
Seat 8: YourRobotDad (16430 in chips)=20
Seat 9: BENN DOVERR (6805 in chips)=20
Drsnap31: posts the ante 20
braheemin: posts the ante 20
TobogganM.D.: posts the ante 20
bethere1923: posts the ante 20
failboat1231: posts the ante 20
JJin91: posts the ante 20
YourRobotDad: posts the ante 20
BENN DOVERR: posts the ante 20
JJin91: posts small blind 75
YourRobotDad: posts big blind 150
*** HOLE CARDS ***
Dealt to JJin91 [3h Kd]
BENN DOVERR: folds=20
Drsnap31: folds=20
braheemin: folds=20
TobogganM.D.: folds=20
bethere1923: folds=20
failboat1231: raises 187 to 337
JJin91: folds=20
YourRobotDad: calls 187
*** FLOP *** [2c Td 9c]
YourRobotDad: checks=20
failboat1231: bets 510
YourRobotDad: calls 510
*** TURN *** [2c Td 9c] [5s]
YourRobotDad: bets 900
failboat1231: calls 900
*** RIVER *** [2c Td 9c 5s] [Qd]
YourRobotDad: bets 1200
failboat1231: calls 1200
*** SHOW DOWN ***
YourRobotDad: shows [Ac Ks] (high card Ace)
failboat1231: shows [Js Ts] (a pair of Tens)
failboat1231 collected 6129 from pot
*** SUMMARY ***
Total pot 6129 | Rake 0=20
Board [2c Td 9c 5s Qd]
Seat 1: Drsnap31 folded before Flop (didn't bet)
Seat 2: braheemin folded before Flop (didn't bet)
Seat 3: TobogganM.D. folded before Flop (didn't bet)
Seat 4: bethere1923 folded before Flop (didn't bet)
Seat 5: failboat1231 (button) showed [Js Ts] and won (6129) with a pair=
 of Tens
Seat 7: JJin91 (small blind) folded before Flop
Seat 8: YourRobotDad (big blind) showed [Ac Ks] and lost with high card=
 Ace
Seat 9: BENN DOVERR folded before Flop (didn't bet)


*********** # 37 **************
PokerStars Hand #176120106919: Tournament #1701843149, $18.20+$1.80 USD=
 Hold'em No Limit - Level VI (75/150) - 2017/10/09 19:54:15 ET
Table '1701843149 1' 9-max Seat #7 is the button
Seat 1: Drsnap31 (6435 in chips)=20
Seat 2: braheemin (8354 in chips)=20
Seat 3: TobogganM.D. (10017 in chips)=20
Seat 4: bethere1923 (9012 in chips)=20
Seat 5: failboat1231 (15543 in chips)=20
Seat 7: JJin91 (14943 in chips)=20
Seat 8: YourRobotDad (13463 in chips)=20
Seat 9: BENN DOVERR (6785 in chips)=20
Drsnap31: posts the ante 20
braheemin: posts the ante 20
TobogganM.D.: posts the ante 20
bethere1923: posts the ante 20
failboat1231: posts the ante 20
JJin91: posts the ante 20
YourRobotDad: posts the ante 20
BENN DOVERR: posts the ante 20
YourRobotDad: posts small blind 75
BENN DOVERR: posts big blind 150
*** HOLE CARDS ***
Dealt to JJin91 [2s 7s]
Drsnap31: folds=20
braheemin: raises 150 to 300
TobogganM.D.: folds=20
bethere1923: raises 575 to 875
failboat1231: folds=20
JJin91: folds=20
YourRobotDad: folds=20
BENN DOVERR: folds=20
braheemin: folds=20
Uncalled bet (575) returned to bethere1923
bethere1923 collected 985 from pot
bethere1923: doesn't show hand=20
*** SUMMARY ***
Total pot 985 | Rake 0=20
Seat 1: Drsnap31 folded before Flop (didn't bet)
Seat 2: braheemin folded before Flop
Seat 3: TobogganM.D. folded before Flop (didn't bet)
Seat 4: bethere1923 collected (985)
Seat 5: failboat1231 folded before Flop (didn't bet)
Seat 7: JJin91 (button) folded before Flop (didn't bet)
Seat 8: YourRobotDad (small blind) folded before Flop
Seat 9: BENN DOVERR (big blind) folded before Flop


*********** # 38 **************
PokerStars Hand #176120107047: Tournament #1701843149, $18.20+$1.80 USD=
 Hold'em No Limit - Level VI (75/150) - 2017/10/09 19:54:51 ET
Table '1701843149 1' 9-max Seat #8 is the button
Seat 1: Drsnap31 (6415 in chips)=20
Seat 2: braheemin (8034 in chips)=20
Seat 3: TobogganM.D. (9997 in chips)=20
Seat 4: bethere1923 (9677 in chips)=20
Seat 5: failboat1231 (15523 in chips)=20
Seat 7: JJin91 (14923 in chips)=20
Seat 8: YourRobotDad (13368 in chips)=20
Seat 9: BENN DOVERR (6615 in chips)=20
Drsnap31: posts the ante 20
braheemin: posts the ante 20
TobogganM.D.: posts the ante 20
bethere1923: posts the ante 20
failboat1231: posts the ante 20
JJin91: posts the ante 20
YourRobotDad: posts the ante 20
BENN DOVERR: posts the ante 20
BENN DOVERR: posts small blind 75
Drsnap31: posts big blind 150
*** HOLE CARDS ***
Dealt to JJin91 [3s As]
braheemin: raises 150 to 300
TobogganM.D.: folds=20
bethere1923: folds=20
failboat1231: calls 300
JJin91: folds=20
YourRobotDad: calls 300
BENN DOVERR: folds=20
Drsnap31: calls 150
*** FLOP *** [Tc 5d 8s]
Drsnap31: checks=20
braheemin: bets 800
failboat1231: calls 800
YourRobotDad: calls 800
Drsnap31: calls 800
*** TURN *** [Tc 5d 8s] [9d]
Drsnap31: checks=20
braheemin: checks=20
failboat1231: checks=20
YourRobotDad: bets 1650
Drsnap31: folds=20
braheemin: calls 1650
failboat1231: calls 1650
*** RIVER *** [Tc 5d 8s 9d] [2h]
braheemin: checks=20
failboat1231: checks=20
YourRobotDad: bets 3750
braheemin: folds=20
failboat1231: calls 3750
*** SHOW DOWN ***
YourRobotDad: shows [Qc Jc] (a straight, Eight to Queen)
failboat1231: mucks hand=20
YourRobotDad collected 17085 from pot
*** SUMMARY ***
Total pot 17085 | Rake 0=20
Board [Tc 5d 8s 9d 2h]
Seat 1: Drsnap31 (big blind) folded on the Turn
Seat 2: braheemin folded on the River
Seat 3: TobogganM.D. folded before Flop (didn't bet)
Seat 4: bethere1923 folded before Flop (didn't bet)
Seat 5: failboat1231 mucked [Qh Th]
Seat 7: JJin91 folded before Flop (didn't bet)
Seat 8: YourRobotDad (button) showed [Qc Jc] and won (17085) with a str=
aight, Eight to Queen
Seat 9: BENN DOVERR (small blind) folded before Flop


*********** # 39 **************
PokerStars Hand #176120108273: Tournament #1701843149, $18.20+$1.80 USD=
 Hold'em No Limit - Level VI (75/150) - 2017/10/09 20:01:33 ET
Table '1701843149 1' 9-max Seat #9 is the button
Seat 1: Drsnap31 (5295 in chips)=20
Seat 2: braheemin (5264 in chips)=20
Seat 3: TobogganM.D. (9977 in chips)=20
Seat 4: bethere1923 (9657 in chips)=20
Seat 5: failboat1231 (9003 in chips) is sitting out
Seat 7: JJin91 (14903 in chips)=20
Seat 8: YourRobotDad (23933 in chips)=20
Seat 9: BENN DOVERR (6520 in chips)=20
Drsnap31: posts the ante 20
braheemin: posts the ante 20
TobogganM.D.: posts the ante 20
bethere1923: posts the ante 20
failboat1231: posts the ante 20
JJin91: posts the ante 20
YourRobotDad: posts the ante 20
BENN DOVERR: posts the ante 20
Drsnap31: posts small blind 75
braheemin: posts big blind 150
*** HOLE CARDS ***
Dealt to JJin91 [5d 9d]
TobogganM.D.: folds=20
bethere1923: folds=20
failboat1231: folds=20
JJin91 has timed out
JJin91: folds=20
JJin91 is sitting out
YourRobotDad: raises 150 to 300
JJin91 has returned
BENN DOVERR: raises 600 to 900
Drsnap31: folds=20
braheemin: folds=20
YourRobotDad: folds=20
Uncalled bet (600) returned to BENN DOVERR
BENN DOVERR collected 985 from pot
*** SUMMARY ***
Total pot 985 | Rake 0=20
Seat 1: Drsnap31 (small blind) folded before Flop
Seat 2: braheemin (big blind) folded before Flop
Seat 3: TobogganM.D. folded before Flop (didn't bet)
Seat 4: bethere1923 folded before Flop (didn't bet)
Seat 5: failboat1231 folded before Flop (didn't bet)
Seat 7: JJin91 folded before Flop (didn't bet)
Seat 8: YourRobotDad folded before Flop
Seat 9: BENN DOVERR (button) collected (985)


*********** # 40 **************
PokerStars Hand #176120108616: Tournament #1701843149, $18.20+$1.80 USD=
 Hold'em No Limit - Level VI (75/150) - 2017/10/09 20:03:07 ET
Table '1701843149 1' 9-max Seat #1 is the button
Seat 1: Drsnap31 (5200 in chips)=20
Seat 2: braheemin (5094 in chips)=20
Seat 3: TobogganM.D. (9957 in chips)=20
Seat 4: bethere1923 (9637 in chips)=20
Seat 5: failboat1231 (8983 in chips) is sitting out
Seat 6: Romet05 (10000 in chips)=20
Seat 7: JJin91 (14883 in chips)=20
Seat 8: YourRobotDad (23613 in chips)=20
Seat 9: BENN DOVERR (7185 in chips)=20
Drsnap31: posts the ante 20
braheemin: posts the ante 20
TobogganM.D.: posts the ante 20
bethere1923: posts the ante 20
failboat1231: posts the ante 20
Romet05: posts the ante 20
JJin91: posts the ante 20
YourRobotDad: posts the ante 20
BENN DOVERR: posts the ante 20
braheemin: posts small blind 75
TobogganM.D.: posts big blind 150
*** HOLE CARDS ***
Dealt to JJin91 [4d 4c]
bethere1923: folds=20
failboat1231: folds=20
Romet05: folds=20
JJin91: folds=20
YourRobotDad: folds=20
BENN DOVERR: raises 300 to 450
Drsnap31: calls 450
braheemin: folds=20
TobogganM.D.: folds=20
*** FLOP *** [9d 5c 5s]
BENN DOVERR: bets 470
Drsnap31: folds=20
Uncalled bet (470) returned to BENN DOVERR
BENN DOVERR collected 1305 from pot
*** SUMMARY ***
Total pot 1305 | Rake 0=20
Board [9d 5c 5s]
Seat 1: Drsnap31 (button) folded on the Flop
Seat 2: braheemin (small blind) folded before Flop
Seat 3: TobogganM.D. (big blind) folded before Flop
Seat 4: bethere1923 folded before Flop (didn't bet)
Seat 5: failboat1231 folded before Flop (didn't bet)
Seat 6: Romet05 folded before Flop (didn't bet)
Seat 7: JJin91 folded before Flop (didn't bet)
Seat 8: YourRobotDad folded before Flop (didn't bet)
Seat 9: BENN DOVERR collected (1305)


*********** # 41 **************
PokerStars Hand #176120108797: Tournament #1701843149, $18.20+$1.80 USD=
 Hold'em No Limit - Level VI (75/150) - 2017/10/09 20:03:56 ET
Table '1701843149 1' 9-max Seat #2 is the button
Seat 1: Drsnap31 (4730 in chips)=20
Seat 2: braheemin (4999 in chips)=20
Seat 3: TobogganM.D. (9787 in chips)=20
Seat 4: bethere1923 (9617 in chips)=20
Seat 5: failboat1231 (8963 in chips) is sitting out
Seat 6: Romet05 (9980 in chips)=20
Seat 7: JJin91 (14863 in chips)=20
Seat 8: YourRobotDad (23593 in chips)=20
Seat 9: BENN DOVERR (8020 in chips)=20
Drsnap31: posts the ante 20
braheemin: posts the ante 20
TobogganM.D.: posts the ante 20
bethere1923: posts the ante 20
failboat1231: posts the ante 20
Romet05: posts the ante 20
JJin91: posts the ante 20
YourRobotDad: posts the ante 20
BENN DOVERR: posts the ante 20
TobogganM.D.: posts small blind 75
bethere1923: posts big blind 150
*** HOLE CARDS ***
Dealt to JJin91 [Th 7s]
failboat1231: folds=20
Romet05: folds=20
failboat1231 has returned
JJin91: folds=20
YourRobotDad: folds=20
BENN DOVERR: folds=20
Drsnap31: raises 450 to 600
braheemin: folds=20
TobogganM.D.: folds=20
bethere1923: folds=20
Uncalled bet (450) returned to Drsnap31
Drsnap31 collected 555 from pot
Drsnap31: doesn't show hand=20
*** SUMMARY ***
Total pot 555 | Rake 0=20
Seat 1: Drsnap31 collected (555)
Seat 2: braheemin (button) folded before Flop (didn't bet)
Seat 3: TobogganM.D. (small blind) folded before Flop
Seat 4: bethere1923 (big blind) folded before Flop
Seat 5: failboat1231 folded before Flop (didn't bet)
Seat 6: Romet05 folded before Flop (didn't bet)
Seat 7: JJin91 folded before Flop (didn't bet)
Seat 8: YourRobotDad folded before Flop (didn't bet)
Seat 9: BENN DOVERR folded before Flop (didn't bet)


*********** # 42 **************
PokerStars Hand #176120108919: Tournament #1701843149, $18.20+$1.80 USD=
 Hold'em No Limit - Level VI (75/150) - 2017/10/09 20:04:34 ET
Table '1701843149 1' 9-max Seat #3 is the button
Seat 1: Drsnap31 (5115 in chips)=20
Seat 2: braheemin (4979 in chips)=20
Seat 3: TobogganM.D. (9692 in chips)=20
Seat 4: bethere1923 (9447 in chips)=20
Seat 5: failboat1231 (8943 in chips)=20
Seat 6: Romet05 (9960 in chips)=20
Seat 7: JJin91 (14843 in chips)=20
Seat 8: YourRobotDad (23573 in chips)=20
Seat 9: BENN DOVERR (8000 in chips)=20
Drsnap31: posts the ante 20
braheemin: posts the ante 20
TobogganM.D.: posts the ante 20
bethere1923: posts the ante 20
failboat1231: posts the ante 20
Romet05: posts the ante 20
JJin91: posts the ante 20
YourRobotDad: posts the ante 20
BENN DOVERR: posts the ante 20
bethere1923: posts small blind 75
failboat1231: posts big blind 150
*** HOLE CARDS ***
Dealt to JJin91 [8c 6s]
Romet05: raises 225 to 375
JJin91: folds=20
YourRobotDad: calls 375
BENN DOVERR: folds=20
Drsnap31: folds=20
braheemin: calls 375
TobogganM.D.: folds=20
bethere1923: calls 300
failboat1231: calls 225
*** FLOP *** [5d 2s 5s]
bethere1923: checks=20
failboat1231: checks=20
Romet05: checks=20
YourRobotDad: checks=20
braheemin: checks=20
*** TURN *** [5d 2s 5s] [4s]
bethere1923: checks=20
failboat1231: checks=20
Romet05: checks=20
YourRobotDad: checks=20
braheemin: bets 1200
bethere1923: calls 1200
failboat1231: folds=20
Romet05: folds=20
YourRobotDad: folds=20
*** RIVER *** [5d 2s 5s 4s] [4h]
bethere1923: checks=20
braheemin: checks=20
*** SHOW DOWN ***
bethere1923: shows [Tc Td] (two pair, Tens and Fives)
braheemin: mucks hand=20
bethere1923 collected 4455 from pot
*** SUMMARY ***
Total pot 4455 | Rake 0=20
Board [5d 2s 5s 4s 4h]
Seat 1: Drsnap31 folded before Flop (didn't bet)
Seat 2: braheemin mucked [Js Th]
Seat 3: TobogganM.D. (button) folded before Flop (didn't bet)
Seat 4: bethere1923 (small blind) showed [Tc Td] and won (4455) with tw=
o pair, Tens and Fives
Seat 5: failboat1231 (big blind) folded on the Turn
Seat 6: Romet05 folded on the Turn
Seat 7: JJin91 folded before Flop (didn't bet)
Seat 8: YourRobotDad folded on the Turn
Seat 9: BENN DOVERR folded before Flop (didn't bet)


*********** # 43 **************
PokerStars Hand #176120109285: Tournament #1701843149, $18.20+$1.80 USD=
 Hold'em No Limit - Level VI (75/150) - 2017/10/09 20:06:11 ET
Table '1701843149 1' 9-max Seat #4 is the button
Seat 1: Drsnap31 (5095 in chips)=20
Seat 2: braheemin (3384 in chips)=20
Seat 3: TobogganM.D. (9672 in chips)=20
Seat 4: bethere1923 (12307 in chips)=20
Seat 5: failboat1231 (8548 in chips)=20
Seat 6: Romet05 (9565 in chips)=20
Seat 7: JJin91 (14823 in chips)=20
Seat 8: YourRobotDad (23178 in chips)=20
Seat 9: BENN DOVERR (7980 in chips)=20
Drsnap31: posts the ante 20
braheemin: posts the ante 20
TobogganM.D.: posts the ante 20
bethere1923: posts the ante 20
failboat1231: posts the ante 20
Romet05: posts the ante 20
JJin91: posts the ante 20
YourRobotDad: posts the ante 20
BENN DOVERR: posts the ante 20
failboat1231: posts small blind 75
Romet05: posts big blind 150
*** HOLE CARDS ***
Dealt to JJin91 [9c 7h]
JJin91: folds=20
YourRobotDad: folds=20
BENN DOVERR: raises 300 to 450
Drsnap31: folds=20
braheemin: folds=20
TobogganM.D.: folds=20
bethere1923: folds=20
failboat1231: folds=20
Romet05: folds=20
Uncalled bet (300) returned to BENN DOVERR
BENN DOVERR collected 555 from pot
*** SUMMARY ***
Total pot 555 | Rake 0=20
Seat 1: Drsnap31 folded before Flop (didn't bet)
Seat 2: braheemin folded before Flop (didn't bet)
Seat 3: TobogganM.D. folded before Flop (didn't bet)
Seat 4: bethere1923 (button) folded before Flop (didn't bet)
Seat 5: failboat1231 (small blind) folded before Flop
Seat 6: Romet05 (big blind) folded before Flop
Seat 7: JJin91 folded before Flop (didn't bet)
Seat 8: YourRobotDad folded before Flop (didn't bet)
Seat 9: BENN DOVERR collected (555)


*********** # 44 **************
PokerStars Hand #176120109373: Tournament #1701843149, $18.20+$1.80 USD=
 Hold'em No Limit - Level VI (75/150) - 2017/10/09 20:06:31 ET
Table '1701843149 1' 9-max Seat #5 is the button
Seat 1: Drsnap31 (5075 in chips)=20
Seat 2: braheemin (3364 in chips)=20
Seat 3: TobogganM.D. (9652 in chips)=20
Seat 4: bethere1923 (12287 in chips)=20
Seat 5: failboat1231 (8453 in chips)=20
Seat 6: Romet05 (9395 in chips)=20
Seat 7: JJin91 (14803 in chips)=20
Seat 8: YourRobotDad (23158 in chips)=20
Seat 9: BENN DOVERR (8365 in chips)=20
Drsnap31: posts the ante 20
braheemin: posts the ante 20
TobogganM.D.: posts the ante 20
bethere1923: posts the ante 20
failboat1231: posts the ante 20
Romet05: posts the ante 20
JJin91: posts the ante 20
YourRobotDad: posts the ante 20
BENN DOVERR: posts the ante 20
Romet05: posts small blind 75
JJin91: posts big blind 150
*** HOLE CARDS ***
Dealt to JJin91 [5d Js]
YourRobotDad: folds=20
BENN DOVERR: folds=20
Drsnap31: folds=20
braheemin: folds=20
TobogganM.D.: folds=20
bethere1923: folds=20
failboat1231: folds=20
Romet05: calls 75
JJin91: checks=20
*** FLOP *** [4h 2d Ts]
Romet05: checks=20
JJin91: checks=20
*** TURN *** [4h 2d Ts] [9h]
Romet05: checks=20
JJin91: bets 245
Romet05: calls 245
*** RIVER *** [4h 2d Ts 9h] [Qh]
Romet05: checks=20
JJin91: checks=20
*** SHOW DOWN ***
Romet05: shows [4s 8s] (a pair of Fours)
JJin91: mucks hand=20
Romet05 collected 970 from pot
*** SUMMARY ***
Total pot 970 | Rake 0=20
Board [4h 2d Ts 9h Qh]
Seat 1: Drsnap31 folded before Flop (didn't bet)
Seat 2: braheemin folded before Flop (didn't bet)
Seat 3: TobogganM.D. folded before Flop (didn't bet)
Seat 4: bethere1923 folded before Flop (didn't bet)
Seat 5: failboat1231 (button) folded before Flop (didn't bet)
Seat 6: Romet05 (small blind) showed [4s 8s] and won (970) with a pair =
of Fours
Seat 7: JJin91 (big blind) mucked [5d Js]
Seat 8: YourRobotDad folded before Flop (didn't bet)
Seat 9: BENN DOVERR folded before Flop (didn't bet)


*********** # 45 **************
PokerStars Hand #176120109610: Tournament #1701843149, $18.20+$1.80 USD=
 Hold'em No Limit - Level VII (100/200) - 2017/10/09 20:07:29 ET
Table '1701843149 1' 9-max Seat #6 is the button
Seat 2: braheemin (3344 in chips)=20
Seat 3: TobogganM.D. (9632 in chips)=20
Seat 4: bethere1923 (12267 in chips)=20
Seat 5: failboat1231 (8433 in chips)=20
Seat 6: Romet05 (9950 in chips)=20
Seat 7: JJin91 (14388 in chips)=20
Seat 8: YourRobotDad (23138 in chips)=20
Seat 9: BENN DOVERR (8345 in chips)=20
braheemin: posts the ante 25
TobogganM.D.: posts the ante 25
bethere1923: posts the ante 25
failboat1231: posts the ante 25
Romet05: posts the ante 25
JJin91: posts the ante 25
YourRobotDad: posts the ante 25
BENN DOVERR: posts the ante 25
JJin91: posts small blind 100
YourRobotDad: posts big blind 200
*** HOLE CARDS ***
Dealt to JJin91 [Ah Kh]
BENN DOVERR: folds=20
braheemin: folds=20
TobogganM.D.: folds=20
bethere1923: raises 204 to 404
failboat1231: folds=20
Romet05: folds=20
JJin91: raises 940 to 1344
YourRobotDad: folds=20
bethere1923: folds=20
Uncalled bet (940) returned to JJin91
JJin91 collected 1208 from pot
JJin91: doesn't show hand=20
*** SUMMARY ***
Total pot 1208 | Rake 0=20
Seat 2: braheemin folded before Flop (didn't bet)
Seat 3: TobogganM.D. folded before Flop (didn't bet)
Seat 4: bethere1923 folded before Flop
Seat 5: failboat1231 folded before Flop (didn't bet)
Seat 6: Romet05 (button) folded before Flop (didn't bet)
Seat 7: JJin91 (small blind) collected (1208)
Seat 8: YourRobotDad (big blind) folded before Flop
Seat 9: BENN DOVERR folded before Flop (didn't bet)


*********** # 46 **************
PokerStars Hand #176120109797: Tournament #1701843149, $18.20+$1.80 USD=
 Hold'em No Limit - Level VII (100/200) - 2017/10/09 20:08:13 ET
Table '1701843149 1' 9-max Seat #7 is the button
Seat 2: braheemin (3319 in chips)=20
Seat 3: TobogganM.D. (9607 in chips)=20
Seat 4: bethere1923 (11838 in chips)=20
Seat 5: failboat1231 (8408 in chips)=20
Seat 6: Romet05 (9925 in chips)=20
Seat 7: JJin91 (15167 in chips)=20
Seat 8: YourRobotDad (22913 in chips)=20
Seat 9: BENN DOVERR (8320 in chips)=20
braheemin: posts the ante 25
TobogganM.D.: posts the ante 25
bethere1923: posts the ante 25
failboat1231: posts the ante 25
Romet05: posts the ante 25
JJin91: posts the ante 25
YourRobotDad: posts the ante 25
BENN DOVERR: posts the ante 25
YourRobotDad: posts small blind 100
BENN DOVERR: posts big blind 200
*** HOLE CARDS ***
Dealt to JJin91 [6h 2c]
braheemin: folds=20
TobogganM.D.: folds=20
bethere1923: folds=20
failboat1231: folds=20
Romet05: raises 300 to 500
JJin91: folds=20
YourRobotDad: folds=20
BENN DOVERR: calls 300
*** FLOP *** [Jd 7d As]
BENN DOVERR: checks=20
Romet05: checks=20
*** TURN *** [Jd 7d As] [2d]
BENN DOVERR: checks=20
Romet05: checks=20
*** RIVER *** [Jd 7d As 2d] [5c]
BENN DOVERR: checks=20
Romet05: checks=20
*** SHOW DOWN ***
BENN DOVERR: shows [9s Ks] (high card Ace)
Romet05: mucks hand=20
BENN DOVERR collected 1300 from pot
*** SUMMARY ***
Total pot 1300 | Rake 0=20
Board [Jd 7d As 2d 5c]
Seat 2: braheemin folded before Flop (didn't bet)
Seat 3: TobogganM.D. folded before Flop (didn't bet)
Seat 4: bethere1923 folded before Flop (didn't bet)
Seat 5: failboat1231 folded before Flop (didn't bet)
Seat 6: Romet05 mucked [9d 8c]
Seat 7: JJin91 (button) folded before Flop (didn't bet)
Seat 8: YourRobotDad (small blind) folded before Flop
Seat 9: BENN DOVERR (big blind) showed [9s Ks] and won (1300) with high=
 card Ace


*********** # 47 **************
PokerStars Hand #176122137341: Tournament #1701843149, $18.20+$1.80 USD=
 Hold'em No Limit - Level VII (100/200) - 2017/10/09 20:09:13 ET
Table '1701843149 1' 9-max Seat #8 is the button
Seat 2: braheemin (3294 in chips)=20
Seat 3: TobogganM.D. (9582 in chips)=20
Seat 4: bethere1923 (11813 in chips)=20
Seat 5: failboat1231 (8383 in chips)=20
Seat 6: Romet05 (9400 in chips)=20
Seat 7: JJin91 (15142 in chips)=20
Seat 8: YourRobotDad (22788 in chips)=20
Seat 9: BENN DOVERR (9095 in chips)=20
braheemin: posts the ante 25
TobogganM.D.: posts the ante 25
bethere1923: posts the ante 25
failboat1231: posts the ante 25
Romet05: posts the ante 25
JJin91: posts the ante 25
YourRobotDad: posts the ante 25
BENN DOVERR: posts the ante 25
BENN DOVERR: posts small blind 100
braheemin: posts big blind 200
*** HOLE CARDS ***
Dealt to JJin91 [7s 3c]
TobogganM.D.: folds=20
bethere1923: folds=20
failboat1231: raises 250 to 450
Romet05: calls 450
JJin91: folds=20
YourRobotDad: folds=20
BENN DOVERR: folds=20
braheemin: folds=20
*** FLOP *** [4d Kc 6d]
failboat1231: bets 800
Romet05: calls 800
*** TURN *** [4d Kc 6d] [5c]
failboat1231: checks=20
Romet05: bets 1200
failboat1231: calls 1200
*** RIVER *** [4d Kc 6d 5c] [2s]
failboat1231: checks=20
Romet05: checks=20
*** SHOW DOWN ***
failboat1231: shows [Ad Qh] (high card Ace)
Romet05: shows [Kh Js] (a pair of Kings)
Romet05 collected 5400 from pot
*** SUMMARY ***
Total pot 5400 | Rake 0=20
Board [4d Kc 6d 5c 2s]
Seat 2: braheemin (big blind) folded before Flop
Seat 3: TobogganM.D. folded before Flop (didn't bet)
Seat 4: bethere1923 folded before Flop (didn't bet)
Seat 5: failboat1231 showed [Ad Qh] and lost with high card Ace
Seat 6: Romet05 showed [Kh Js] and won (5400) with a pair of Kings
Seat 7: JJin91 folded before Flop (didn't bet)
Seat 8: YourRobotDad (button) folded before Flop (didn't bet)
Seat 9: BENN DOVERR (small blind) folded before Flop


*********** # 48 **************
PokerStars Hand #176122137535: Tournament #1701843149, $18.20+$1.80 USD=
 Hold'em No Limit - Level VII (100/200) - 2017/10/09 20:10:01 ET
Table '1701843149 1' 9-max Seat #9 is the button
Seat 2: braheemin (3069 in chips)=20
Seat 3: TobogganM.D. (9557 in chips)=20
Seat 4: bethere1923 (11788 in chips)=20
Seat 5: failboat1231 (5908 in chips)=20
Seat 6: Romet05 (12325 in chips)=20
Seat 7: JJin91 (15117 in chips)=20
Seat 8: YourRobotDad (22763 in chips)=20
Seat 9: BENN DOVERR (8970 in chips)=20
braheemin: posts the ante 25
TobogganM.D.: posts the ante 25
bethere1923: posts the ante 25
failboat1231: posts the ante 25
Romet05: posts the ante 25
JJin91: posts the ante 25
YourRobotDad: posts the ante 25
BENN DOVERR: posts the ante 25
braheemin: posts small blind 100
TobogganM.D.: posts big blind 200
*** HOLE CARDS ***
Dealt to JJin91 [9d 9h]
bethere1923: folds=20
failboat1231: folds=20
Romet05: raises 300 to 500
JJin91: calls 500
YourRobotDad: folds=20
BENN DOVERR: folds=20
braheemin: calls 400
TobogganM.D.: folds=20
*** FLOP *** [3h Ah 6d]
braheemin: checks=20
Romet05: checks=20
JJin91: bets 777
braheemin: folds=20
Romet05: folds=20
Uncalled bet (777) returned to JJin91
JJin91 collected 1900 from pot
JJin91: doesn't show hand=20
*** SUMMARY ***
Total pot 1900 | Rake 0=20
Board [3h Ah 6d]
Seat 2: braheemin (small blind) folded on the Flop
Seat 3: TobogganM.D. (big blind) folded before Flop
Seat 4: bethere1923 folded before Flop (didn't bet)
Seat 5: failboat1231 folded before Flop (didn't bet)
Seat 6: Romet05 folded on the Flop
Seat 7: JJin91 collected (1900)
Seat 8: YourRobotDad folded before Flop (didn't bet)
Seat 9: BENN DOVERR (button) folded before Flop (didn't bet)


*********** # 49 **************
PokerStars Hand #176122137743: Tournament #1701843149, $18.20+$1.80 USD=
 Hold'em No Limit - Level VII (100/200) - 2017/10/09 20:10:48 ET
Table '1701843149 1' 9-max Seat #2 is the button
Seat 2: braheemin (2544 in chips)=20
Seat 3: TobogganM.D. (9332 in chips)=20
Seat 4: bethere1923 (11763 in chips)=20
Seat 5: failboat1231 (5883 in chips)=20
Seat 6: Romet05 (11800 in chips)=20
Seat 7: JJin91 (16492 in chips)=20
Seat 8: YourRobotDad (22738 in chips)=20
Seat 9: BENN DOVERR (8945 in chips)=20
braheemin: posts the ante 25
TobogganM.D.: posts the ante 25
bethere1923: posts the ante 25
failboat1231: posts the ante 25
Romet05: posts the ante 25
JJin91: posts the ante 25
YourRobotDad: posts the ante 25
BENN DOVERR: posts the ante 25
TobogganM.D.: posts small blind 100
bethere1923: posts big blind 200
*** HOLE CARDS ***
Dealt to JJin91 [Qd 4d]
failboat1231: folds=20
Romet05: folds=20
JJin91: folds=20
YourRobotDad: folds=20
BENN DOVERR: folds=20
braheemin: calls 200
TobogganM.D.: calls 100
bethere1923: checks=20
*** FLOP *** [7s 6d 3h]
TobogganM.D.: bets 400
bethere1923: folds=20
braheemin: folds=20
Uncalled bet (400) returned to TobogganM.D.
TobogganM.D. collected 800 from pot
TobogganM.D.: doesn't show hand=20
*** SUMMARY ***
Total pot 800 | Rake 0=20
Board [7s 6d 3h]
Seat 2: braheemin (button) folded on the Flop
Seat 3: TobogganM.D. (small blind) collected (800)
Seat 4: bethere1923 (big blind) folded on the Flop
Seat 5: failboat1231 folded before Flop (didn't bet)
Seat 6: Romet05 folded before Flop (didn't bet)
Seat 7: JJin91 folded before Flop (didn't bet)
Seat 8: YourRobotDad folded before Flop (didn't bet)
Seat 9: BENN DOVERR folded before Flop (didn't bet)


*********** # 50 **************
PokerStars Hand #176122137897: Tournament #1701843149, $18.20+$1.80 USD=
 Hold'em No Limit - Level VII (100/200) - 2017/10/09 20:11:24 ET
Table '1701843149 1' 9-max Seat #3 is the button
Seat 1: smokrface420 (11828 in chips)=20
Seat 2: braheemin (2319 in chips)=20
Seat 3: TobogganM.D. (9907 in chips)=20
Seat 4: bethere1923 (11538 in chips)=20
Seat 5: failboat1231 (5858 in chips)=20
Seat 6: Romet05 (11775 in chips)=20
Seat 7: JJin91 (16467 in chips)=20
Seat 8: YourRobotDad (22713 in chips)=20
Seat 9: BENN DOVERR (8920 in chips)=20
smokrface420: posts the ante 25
braheemin: posts the ante 25
TobogganM.D.: posts the ante 25
bethere1923: posts the ante 25
failboat1231: posts the ante 25
Romet05: posts the ante 25
JJin91: posts the ante 25
YourRobotDad: posts the ante 25
BENN DOVERR: posts the ante 25
bethere1923: posts small blind 100
failboat1231: posts big blind 200
*** HOLE CARDS ***
Dealt to JJin91 [9d 5c]
Romet05: folds=20
JJin91: folds=20
YourRobotDad: folds=20
BENN DOVERR: folds=20
smokrface420: folds=20
braheemin: folds=20
TobogganM.D.: folds=20
bethere1923: folds=20
Uncalled bet (100) returned to failboat1231
failboat1231 collected 425 from pot
failboat1231: doesn't show hand=20
*** SUMMARY ***
Total pot 425 | Rake 0=20
Seat 1: smokrface420 folded before Flop (didn't bet)
Seat 2: braheemin folded before Flop (didn't bet)
Seat 3: TobogganM.D. (button) folded before Flop (didn't bet)
Seat 4: bethere1923 (small blind) folded before Flop
Seat 5: failboat1231 (big blind) collected (425)
Seat 6: Romet05 folded before Flop (didn't bet)
Seat 7: JJin91 folded before Flop (didn't bet)
Seat 8: YourRobotDad folded before Flop (didn't bet)
Seat 9: BENN DOVERR folded before Flop (didn't bet)


*********** # 51 **************
PokerStars Hand #176122138034: Tournament #1701843149, $18.20+$1.80 USD=
 Hold'em No Limit - Level VII (100/200) - 2017/10/09 20:11:53 ET
Table '1701843149 1' 9-max Seat #4 is the button
Seat 1: smokrface420 (11803 in chips)=20
Seat 2: braheemin (2294 in chips)=20
Seat 3: TobogganM.D. (9882 in chips)=20
Seat 4: bethere1923 (11413 in chips)=20
Seat 5: failboat1231 (6158 in chips)=20
Seat 7: JJin91 (16442 in chips)=20
Seat 8: YourRobotDad (22688 in chips)=20
Seat 9: BENN DOVERR (8895 in chips)=20
smokrface420: posts the ante 25
braheemin: posts the ante 25
TobogganM.D.: posts the ante 25
bethere1923: posts the ante 25
failboat1231: posts the ante 25
JJin91: posts the ante 25
YourRobotDad: posts the ante 25
BENN DOVERR: posts the ante 25
failboat1231: posts small blind 100
JJin91: posts big blind 200
*** HOLE CARDS ***
Dealt to JJin91 [8d Ad]
YourRobotDad: folds=20
BENN DOVERR: folds=20
smokrface420: folds=20
braheemin: folds=20
TobogganM.D.: folds=20
bethere1923: raises 240 to 440
failboat1231: calls 340
JJin91: calls 240
*** FLOP *** [3c 3d 2s]
failboat1231: checks=20
JJin91: checks=20
bethere1923: checks=20
*** TURN *** [3c 3d 2s] [2c]
failboat1231: checks=20
JJin91: checks=20
bethere1923: checks=20
*** RIVER *** [3c 3d 2s 2c] [Ts]
failboat1231: bets 600
JJin91: calls 600
bethere1923: folds=20
bethere1923 is sitting out
*** SHOW DOWN ***
failboat1231: shows [Th Qh] (two pair, Tens and Threes)
JJin91: mucks hand=20
failboat1231 collected 2720 from pot
*** SUMMARY ***
Total pot 2720 | Rake 0=20
Board [3c 3d 2s 2c Ts]
Seat 1: smokrface420 folded before Flop (didn't bet)
Seat 2: braheemin folded before Flop (didn't bet)
Seat 3: TobogganM.D. folded before Flop (didn't bet)
Seat 4: bethere1923 (button) folded on the River
Seat 5: failboat1231 (small blind) showed [Th Qh] and won (2720) with t=
wo pair, Tens and Threes
Seat 7: JJin91 (big blind) mucked [8d Ad]
Seat 8: YourRobotDad folded before Flop (didn't bet)
Seat 9: BENN DOVERR folded before Flop (didn't bet)


*********** # 52 **************
PokerStars Hand #176122138284: Tournament #1701843149, $18.20+$1.80 USD=
 Hold'em No Limit - Level VII (100/200) - 2017/10/09 20:12:50 ET
Table '1701843149 1' 9-max Seat #5 is the button
Seat 1: smokrface420 (11778 in chips)=20
Seat 2: braheemin (2269 in chips)=20
Seat 3: TobogganM.D. (9857 in chips)=20
Seat 4: bethere1923 (10948 in chips) is sitting out
Seat 5: failboat1231 (7813 in chips)=20
Seat 7: JJin91 (15377 in chips)=20
Seat 8: YourRobotDad (22663 in chips)=20
Seat 9: BENN DOVERR (8870 in chips)=20
smokrface420: posts the ante 25
braheemin: posts the ante 25
TobogganM.D.: posts the ante 25
bethere1923: posts the ante 25
failboat1231: posts the ante 25
JJin91: posts the ante 25
YourRobotDad: posts the ante 25
BENN DOVERR: posts the ante 25
JJin91: posts small blind 100
YourRobotDad: posts big blind 200
*** HOLE CARDS ***
Dealt to JJin91 [As 6d]
BENN DOVERR: folds=20
smokrface420: folds=20
braheemin: folds=20
TobogganM.D.: folds=20
bethere1923: folds=20
failboat1231: folds=20
JJin91: raises 234 to 434
YourRobotDad: calls 234
*** FLOP *** [Ac 9s Kd]
JJin91: bets 444
YourRobotDad: calls 444
*** TURN *** [Ac 9s Kd] [Jh]
JJin91: checks=20
YourRobotDad: bets 800
JJin91: calls 800
*** RIVER *** [Ac 9s Kd Jh] [2c]
JJin91: checks=20
YourRobotDad: bets 1600
bethere1923 has returned
JJin91: calls 1600
*** SHOW DOWN ***
YourRobotDad: shows [5d Ad] (a pair of Aces)
JJin91: shows [As 6d] (a pair of Aces)
JJin91 collected 3378 from pot
YourRobotDad collected 3378 from pot
*** SUMMARY ***
Total pot 6756 | Rake 0=20
Board [Ac 9s Kd Jh 2c]
Seat 1: smokrface420 folded before Flop (didn't bet)
Seat 2: braheemin folded before Flop (didn't bet)
Seat 3: TobogganM.D. folded before Flop (didn't bet)
Seat 4: bethere1923 folded before Flop (didn't bet)
Seat 5: failboat1231 (button) folded before Flop (didn't bet)
Seat 7: JJin91 (small blind) showed [As 6d] and won (3378) with a pair =
of Aces
Seat 8: YourRobotDad (big blind) showed [5d Ad] and won (3378) with a p=
air of Aces
Seat 9: BENN DOVERR folded before Flop (didn't bet)


*********** # 53 **************
PokerStars Hand #176122138674: Tournament #1701843149, $18.20+$1.80 USD=
 Hold'em No Limit - Level VII (100/200) - 2017/10/09 20:14:17 ET
Table '1701843149 1' 9-max Seat #7 is the button
Seat 1: smokrface420 (11753 in chips)=20
Seat 2: braheemin (2244 in chips)=20
Seat 3: TobogganM.D. (9832 in chips)=20
Seat 4: bethere1923 (10923 in chips)=20
Seat 5: failboat1231 (7788 in chips)=20
Seat 7: JJin91 (15452 in chips)=20
Seat 8: YourRobotDad (22738 in chips)=20
Seat 9: BENN DOVERR (8845 in chips)=20
smokrface420: posts the ante 25
braheemin: posts the ante 25
TobogganM.D.: posts the ante 25
bethere1923: posts the ante 25
failboat1231: posts the ante 25
JJin91: posts the ante 25
YourRobotDad: posts the ante 25
BENN DOVERR: posts the ante 25
YourRobotDad: posts small blind 100
BENN DOVERR: posts big blind 200
*** HOLE CARDS ***
Dealt to JJin91 [2c 8h]
smokrface420: folds=20
braheemin: folds=20
TobogganM.D.: folds=20
bethere1923: folds=20
failboat1231: raises 250 to 450
JJin91: folds=20
YourRobotDad: folds=20
BENN DOVERR: calls 250
*** FLOP *** [9d Ts 5c]
BENN DOVERR: checks=20
failboat1231: bets 700
BENN DOVERR: folds=20
Uncalled bet (700) returned to failboat1231
failboat1231 collected 1200 from pot
failboat1231: doesn't show hand=20
*** SUMMARY ***
Total pot 1200 | Rake 0=20
Board [9d Ts 5c]
Seat 1: smokrface420 folded before Flop (didn't bet)
Seat 2: braheemin folded before Flop (didn't bet)
Seat 3: TobogganM.D. folded before Flop (didn't bet)
Seat 4: bethere1923 folded before Flop (didn't bet)
Seat 5: failboat1231 collected (1200)
Seat 7: JJin91 (button) folded before Flop (didn't bet)
Seat 8: YourRobotDad (small blind) folded before Flop
Seat 9: BENN DOVERR (big blind) folded on the Flop


*********** # 54 **************
PokerStars Hand #176122138905: Tournament #1701843149, $18.20+$1.80 USD=
 Hold'em No Limit - Level VII (100/200) - 2017/10/09 20:15:09 ET
Table '1701843149 1' 9-max Seat #8 is the button
Seat 1: smokrface420 (11728 in chips)=20
Seat 2: braheemin (2219 in chips)=20
Seat 3: TobogganM.D. (9807 in chips)=20
Seat 4: bethere1923 (10898 in chips)=20
Seat 5: failboat1231 (8513 in chips)=20
Seat 7: JJin91 (15427 in chips)=20
Seat 8: YourRobotDad (22613 in chips)=20
Seat 9: BENN DOVERR (8370 in chips)=20
smokrface420: posts the ante 25
braheemin: posts the ante 25
TobogganM.D.: posts the ante 25
bethere1923: posts the ante 25
failboat1231: posts the ante 25
JJin91: posts the ante 25
YourRobotDad: posts the ante 25
BENN DOVERR: posts the ante 25
BENN DOVERR: posts small blind 100
smokrface420: posts big blind 200
*** HOLE CARDS ***
Dealt to JJin91 [2h As]
braheemin: folds=20
TobogganM.D.: folds=20
bethere1923: folds=20
failboat1231: folds=20
JJin91: folds=20
YourRobotDad: folds=20
BENN DOVERR: folds=20
Uncalled bet (100) returned to smokrface420
smokrface420 collected 400 from pot
*** SUMMARY ***
Total pot 400 | Rake 0=20
Seat 1: smokrface420 (big blind) collected (400)
Seat 2: braheemin folded before Flop (didn't bet)
Seat 3: TobogganM.D. folded before Flop (didn't bet)
Seat 4: bethere1923 folded before Flop (didn't bet)
Seat 5: failboat1231 folded before Flop (didn't bet)
Seat 7: JJin91 folded before Flop (didn't bet)
Seat 8: YourRobotDad (button) folded before Flop (didn't bet)
Seat 9: BENN DOVERR (small blind) folded before Flop


*********** # 55 **************
PokerStars Hand #176122139060: Tournament #1701843149, $18.20+$1.80 USD=
 Hold'em No Limit - Level VII (100/200) - 2017/10/09 20:15:46 ET
Table '1701843149 1' 9-max Seat #9 is the button
Seat 1: smokrface420 (12003 in chips)=20
Seat 2: braheemin (2194 in chips)=20
Seat 3: TobogganM.D. (9782 in chips)=20
Seat 4: bethere1923 (10873 in chips)=20
Seat 5: failboat1231 (8488 in chips)=20
Seat 7: JJin91 (15402 in chips)=20
Seat 8: YourRobotDad (22588 in chips)=20
Seat 9: BENN DOVERR (8245 in chips)=20
smokrface420: posts the ante 25
braheemin: posts the ante 25
TobogganM.D.: posts the ante 25
bethere1923: posts the ante 25
failboat1231: posts the ante 25
JJin91: posts the ante 25
YourRobotDad: posts the ante 25
BENN DOVERR: posts the ante 25
smokrface420: posts small blind 100
braheemin: posts big blind 200
*** HOLE CARDS ***
Dealt to JJin91 [2c 4h]
TobogganM.D.: folds=20
bethere1923: folds=20
failboat1231: folds=20
JJin91: folds=20
YourRobotDad: folds=20
BENN DOVERR: raises 300 to 500
smokrface420: folds=20
braheemin: folds=20
Uncalled bet (300) returned to BENN DOVERR
BENN DOVERR collected 700 from pot
*** SUMMARY ***
Total pot 700 | Rake 0=20
Seat 1: smokrface420 (small blind) folded before Flop
Seat 2: braheemin (big blind) folded before Flop
Seat 3: TobogganM.D. folded before Flop (didn't bet)
Seat 4: bethere1923 folded before Flop (didn't bet)
Seat 5: failboat1231 folded before Flop (didn't bet)
Seat 7: JJin91 folded before Flop (didn't bet)
Seat 8: YourRobotDad folded before Flop (didn't bet)
Seat 9: BENN DOVERR (button) collected (700)


*********** # 56 **************
PokerStars Hand #176122139265: Tournament #1701843149, $18.20+$1.80 USD=
 Hold'em No Limit - Level VII (100/200) - 2017/10/09 20:16:33 ET
Table '1701843149 1' 9-max Seat #1 is the button
Seat 1: smokrface420 (11878 in chips)=20
Seat 2: braheemin (1969 in chips)=20
Seat 3: TobogganM.D. (9757 in chips)=20
Seat 4: bethere1923 (10848 in chips)=20
Seat 5: failboat1231 (8463 in chips)=20
Seat 7: JJin91 (15377 in chips)=20
Seat 8: YourRobotDad (22563 in chips)=20
Seat 9: BENN DOVERR (8720 in chips)=20
smokrface420: posts the ante 25
braheemin: posts the ante 25
TobogganM.D.: posts the ante 25
bethere1923: posts the ante 25
failboat1231: posts the ante 25
JJin91: posts the ante 25
YourRobotDad: posts the ante 25
BENN DOVERR: posts the ante 25
braheemin: posts small blind 100
TobogganM.D.: posts big blind 200
*** HOLE CARDS ***
Dealt to JJin91 [7c 8s]
bethere1923: folds=20
failboat1231: folds=20
JJin91: folds=20
YourRobotDad: folds=20
BENN DOVERR: folds=20
smokrface420: folds=20
braheemin: folds=20
Uncalled bet (100) returned to TobogganM.D.
TobogganM.D. collected 400 from pot
TobogganM.D.: doesn't show hand=20
*** SUMMARY ***
Total pot 400 | Rake 0=20
Seat 1: smokrface420 (button) folded before Flop (didn't bet)
Seat 2: braheemin (small blind) folded before Flop
Seat 3: TobogganM.D. (big blind) collected (400)
Seat 4: bethere1923 folded before Flop (didn't bet)
Seat 5: failboat1231 folded before Flop (didn't bet)
Seat 7: JJin91 folded before Flop (didn't bet)
Seat 8: YourRobotDad folded before Flop (didn't bet)
Seat 9: BENN DOVERR folded before Flop (didn't bet)


*********** # 57 **************
PokerStars Hand #176122139484: Tournament #1701843149, $18.20+$1.80 USD=
 Hold'em No Limit - Level VIII (125/250) - 2017/10/09 20:17:28 ET
Table '1701843149 1' 9-max Seat #2 is the button
Seat 1: smokrface420 (11853 in chips)=20
Seat 2: braheemin (1844 in chips)=20
Seat 3: TobogganM.D. (10032 in chips)=20
Seat 4: bethere1923 (10823 in chips)=20
Seat 5: failboat1231 (8438 in chips)=20
Seat 7: JJin91 (15352 in chips)=20
Seat 8: YourRobotDad (22538 in chips)=20
Seat 9: BENN DOVERR (8695 in chips)=20
smokrface420: posts the ante 30
braheemin: posts the ante 30
TobogganM.D.: posts the ante 30
bethere1923: posts the ante 30
failboat1231: posts the ante 30
JJin91: posts the ante 30
YourRobotDad: posts the ante 30
BENN DOVERR: posts the ante 30
TobogganM.D.: posts small blind 125
bethere1923: posts big blind 250
*** HOLE CARDS ***
Dealt to JJin91 [Qs 9d]
failboat1231: raises 312 to 562
JJin91: folds=20
YourRobotDad: folds=20
BENN DOVERR: folds=20
smokrface420: folds=20
braheemin: raises 1252 to 1814 and is all-in
TobogganM.D.: folds=20
bethere1923: folds=20
failboat1231: calls 1252
*** FLOP *** [Td Qh Jh]
*** TURN *** [Td Qh Jh] [2h]
*** RIVER *** [Td Qh Jh 2h] [2s]
*** SHOW DOWN ***
failboat1231: shows [8h 8s] (two pair, Eights and Deuces)
braheemin: shows [As 6d] (a pair of Deuces)
failboat1231 collected 4243 from pot
braheemin finished the tournament in 94th place
*** SUMMARY ***
Total pot 4243 | Rake 0=20
Board [Td Qh Jh 2h 2s]
Seat 1: smokrface420 folded before Flop (didn't bet)
Seat 2: braheemin (button) showed [As 6d] and lost with a pair of Deuces
Seat 3: TobogganM.D. (small blind) folded before Flop
Seat 4: bethere1923 (big blind) folded before Flop
Seat 5: failboat1231 showed [8h 8s] and won (4243) with two pair, Eight=
s and Deuces
Seat 7: JJin91 folded before Flop (didn't bet)
Seat 8: YourRobotDad folded before Flop (didn't bet)
Seat 9: BENN DOVERR folded before Flop (didn't bet)


*********** # 58 **************
PokerStars Hand #176122139685: Tournament #1701843149, $18.20+$1.80 USD=
 Hold'em No Limit - Level VIII (125/250) - 2017/10/09 20:18:16 ET
Table '1701843149 1' 9-max Seat #3 is the button
Seat 1: smokrface420 (11823 in chips)=20
Seat 3: TobogganM.D. (9877 in chips)=20
Seat 4: bethere1923 (10543 in chips)=20
Seat 5: failboat1231 (10837 in chips)=20
Seat 7: JJin91 (15322 in chips)=20
Seat 8: YourRobotDad (22508 in chips)=20
Seat 9: BENN DOVERR (8665 in chips)=20
smokrface420: posts the ante 30
TobogganM.D.: posts the ante 30
bethere1923: posts the ante 30
failboat1231: posts the ante 30
JJin91: posts the ante 30
YourRobotDad: posts the ante 30
BENN DOVERR: posts the ante 30
bethere1923: posts small blind 125
failboat1231: posts big blind 250
*** HOLE CARDS ***
Dealt to JJin91 [Kd 9s]
JJin91: folds=20
YourRobotDad: raises 250 to 500
BENN DOVERR: calls 500
smokrface420: folds=20
TobogganM.D.: calls 500
bethere1923: folds=20
failboat1231: calls 250
*** FLOP *** [2c 7d Jh]
failboat1231: checks=20
YourRobotDad: bets 750
BENN DOVERR: calls 750
TobogganM.D.: folds=20
failboat1231: folds=20
*** TURN *** [2c 7d Jh] [Tc]
YourRobotDad: bets 1750
BENN DOVERR: folds=20
Uncalled bet (1750) returned to YourRobotDad
YourRobotDad collected 3835 from pot
*** SUMMARY ***
Total pot 3835 | Rake 0=20
Board [2c 7d Jh Tc]
Seat 1: smokrface420 folded before Flop (didn't bet)
Seat 3: TobogganM.D. (button) folded on the Flop
Seat 4: bethere1923 (small blind) folded before Flop
Seat 5: failboat1231 (big blind) folded on the Flop
Seat 7: JJin91 folded before Flop (didn't bet)
Seat 8: YourRobotDad collected (3835)
Seat 9: BENN DOVERR folded on the Turn


*********** # 59 **************
PokerStars Hand #176122139965: Tournament #1701843149, $18.20+$1.80 USD=
 Hold'em No Limit - Level VIII (125/250) - 2017/10/09 20:19:22 ET
Table '1701843149 1' 9-max Seat #4 is the button
Seat 1: smokrface420 (11793 in chips)=20
Seat 3: TobogganM.D. (9347 in chips)=20
Seat 4: bethere1923 (10388 in chips)=20
Seat 5: failboat1231 (10307 in chips)=20
Seat 7: JJin91 (15292 in chips)=20
Seat 8: YourRobotDad (25063 in chips)=20
Seat 9: BENN DOVERR (7385 in chips)=20
smokrface420: posts the ante 30
TobogganM.D.: posts the ante 30
bethere1923: posts the ante 30
failboat1231: posts the ante 30
JJin91: posts the ante 30
YourRobotDad: posts the ante 30
BENN DOVERR: posts the ante 30
failboat1231: posts small blind 125
JJin91: posts big blind 250
*** HOLE CARDS ***
Dealt to JJin91 [8s 7h]
YourRobotDad: folds=20
BENN DOVERR: folds=20
smokrface420: folds=20
TobogganM.D.: folds=20
bethere1923: raises 250 to 500
failboat1231: folds=20
JJin91: folds=20
Uncalled bet (250) returned to bethere1923
bethere1923 collected 835 from pot
*** SUMMARY ***
Total pot 835 | Rake 0=20
Seat 1: smokrface420 folded before Flop (didn't bet)
Seat 3: TobogganM.D. folded before Flop (didn't bet)
Seat 4: bethere1923 (button) collected (835)
Seat 5: failboat1231 (small blind) folded before Flop
Seat 7: JJin91 (big blind) folded before Flop
Seat 8: YourRobotDad folded before Flop (didn't bet)
Seat 9: BENN DOVERR folded before Flop (didn't bet)


*********** # 60 **************
PokerStars Hand #176122998041: Tournament #1701843149, $18.20+$1.80 USD=
 Hold'em No Limit - Level VIII (125/250) - 2017/10/09 20:19:58 ET
Table '1701843149 1' 9-max Seat #5 is the button
Seat 1: smokrface420 (11763 in chips)=20
Seat 3: TobogganM.D. (9317 in chips)=20
Seat 4: bethere1923 (10943 in chips)=20
Seat 5: failboat1231 (10152 in chips)=20
Seat 6: xNEMESISx04 (10000 in chips) out of hand (moved from another ta=
ble into small blind)
Seat 7: JJin91 (15012 in chips)=20
Seat 8: YourRobotDad (25033 in chips)=20
Seat 9: BENN DOVERR (7355 in chips)=20
smokrface420: posts the ante 30
TobogganM.D.: posts the ante 30
bethere1923: posts the ante 30
failboat1231: posts the ante 30
JJin91: posts the ante 30
YourRobotDad: posts the ante 30
BENN DOVERR: posts the ante 30
JJin91: posts small blind 125
YourRobotDad: posts big blind 250
*** HOLE CARDS ***
Dealt to JJin91 [Qs 7h]
BENN DOVERR: raises 375 to 625
smokrface420: folds=20
TobogganM.D.: folds=20
bethere1923: folds=20
failboat1231: folds=20
JJin91: folds=20
YourRobotDad: folds=20
Uncalled bet (375) returned to BENN DOVERR
BENN DOVERR collected 835 from pot
*** SUMMARY ***
Total pot 835 | Rake 0=20
Seat 1: smokrface420 folded before Flop (didn't bet)
Seat 3: TobogganM.D. folded before Flop (didn't bet)
Seat 4: bethere1923 folded before Flop (didn't bet)
Seat 5: failboat1231 (button) folded before Flop (didn't bet)
Seat 7: JJin91 (small blind) folded before Flop
Seat 8: YourRobotDad (big blind) folded before Flop
Seat 9: BENN DOVERR collected (835)


*********** # 61 **************
PokerStars Hand #176122998166: Tournament #1701843149, $18.20+$1.80 USD=
 Hold'em No Limit - Level VIII (125/250) - 2017/10/09 20:20:30 ET
Table '1701843149 1' 9-max Seat #7 is the button
Seat 1: smokrface420 (11733 in chips)=20
Seat 2: Booge013 (10000 in chips)=20
Seat 3: TobogganM.D. (9287 in chips)=20
Seat 4: bethere1923 (10913 in chips)=20
Seat 5: failboat1231 (10122 in chips)=20
Seat 6: xNEMESISx04 (10000 in chips)=20
Seat 7: JJin91 (14857 in chips)=20
Seat 8: YourRobotDad (24753 in chips)=20
Seat 9: BENN DOVERR (7910 in chips)=20
smokrface420: posts the ante 30
Booge013: posts the ante 30
TobogganM.D.: posts the ante 30
bethere1923: posts the ante 30
failboat1231: posts the ante 30
xNEMESISx04: posts the ante 30
JJin91: posts the ante 30
YourRobotDad: posts the ante 30
BENN DOVERR: posts the ante 30
YourRobotDad: posts small blind 125
BENN DOVERR: posts big blind 250
*** HOLE CARDS ***
Dealt to JJin91 [8c Qd]
smokrface420: folds=20
Booge013: folds=20
TobogganM.D.: folds=20
bethere1923: folds=20
failboat1231: folds=20
xNEMESISx04: folds=20
JJin91: folds=20
YourRobotDad: folds=20
Uncalled bet (125) returned to BENN DOVERR
BENN DOVERR collected 520 from pot
*** SUMMARY ***
Total pot 520 | Rake 0=20
Seat 1: smokrface420 folded before Flop (didn't bet)
Seat 2: Booge013 folded before Flop (didn't bet)
Seat 3: TobogganM.D. folded before Flop (didn't bet)
Seat 4: bethere1923 folded before Flop (didn't bet)
Seat 5: failboat1231 folded before Flop (didn't bet)
Seat 6: xNEMESISx04 folded before Flop (didn't bet)
Seat 7: JJin91 (button) folded before Flop (didn't bet)
Seat 8: YourRobotDad (small blind) folded before Flop
Seat 9: BENN DOVERR (big blind) collected (520)


*********** # 62 **************
PokerStars Hand #176122998252: Tournament #1701843149, $18.20+$1.80 USD=
 Hold'em No Limit - Level VIII (125/250) - 2017/10/09 20:20:49 ET
Table '1701843149 1' 9-max Seat #8 is the button
Seat 1: smokrface420 (11703 in chips)=20
Seat 2: Booge013 (9970 in chips)=20
Seat 3: TobogganM.D. (9257 in chips)=20
Seat 4: bethere1923 (10883 in chips)=20
Seat 5: failboat1231 (10092 in chips)=20
Seat 6: xNEMESISx04 (9970 in chips)=20
Seat 7: JJin91 (14827 in chips)=20
Seat 8: YourRobotDad (24598 in chips)=20
Seat 9: BENN DOVERR (8275 in chips)=20
smokrface420: posts the ante 30
Booge013: posts the ante 30
TobogganM.D.: posts the ante 30
bethere1923: posts the ante 30
failboat1231: posts the ante 30
xNEMESISx04: posts the ante 30
JJin91: posts the ante 30
YourRobotDad: posts the ante 30
BENN DOVERR: posts the ante 30
BENN DOVERR: posts small blind 125
smokrface420: posts big blind 250
*** HOLE CARDS ***
Dealt to JJin91 [7c 6s]
Booge013: folds=20
TobogganM.D.: folds=20
bethere1923: raises 300 to 550
failboat1231: folds=20
xNEMESISx04: folds=20
JJin91: folds=20
YourRobotDad: folds=20
BENN DOVERR: folds=20
smokrface420: folds=20
Uncalled bet (300) returned to bethere1923
bethere1923 collected 895 from pot
*** SUMMARY ***
Total pot 895 | Rake 0=20
Seat 1: smokrface420 (big blind) folded before Flop
Seat 2: Booge013 folded before Flop (didn't bet)
Seat 3: TobogganM.D. folded before Flop (didn't bet)
Seat 4: bethere1923 collected (895)
Seat 5: failboat1231 folded before Flop (didn't bet)
Seat 6: xNEMESISx04 folded before Flop (didn't bet)
Seat 7: JJin91 folded before Flop (didn't bet)
Seat 8: YourRobotDad (button) folded before Flop (didn't bet)
Seat 9: BENN DOVERR (small blind) folded before Flop


*********** # 63 **************
PokerStars Hand #176122998451: Tournament #1701843149, $18.20+$1.80 USD=
 Hold'em No Limit - Level VIII (125/250) - 2017/10/09 20:21:34 ET
Table '1701843149 1' 9-max Seat #9 is the button
Seat 1: smokrface420 (11423 in chips)=20
Seat 2: Booge013 (9940 in chips)=20
Seat 3: TobogganM.D. (9227 in chips)=20
Seat 4: bethere1923 (11498 in chips)=20
Seat 5: failboat1231 (10062 in chips)=20
Seat 6: xNEMESISx04 (9940 in chips)=20
Seat 7: JJin91 (14797 in chips)=20
Seat 8: YourRobotDad (24568 in chips)=20
Seat 9: BENN DOVERR (8120 in chips)=20
smokrface420: posts the ante 30
Booge013: posts the ante 30
TobogganM.D.: posts the ante 30
bethere1923: posts the ante 30
failboat1231: posts the ante 30
xNEMESISx04: posts the ante 30
JJin91: posts the ante 30
YourRobotDad: posts the ante 30
BENN DOVERR: posts the ante 30
smokrface420: posts small blind 125
Booge013: posts big blind 250
*** HOLE CARDS ***
Dealt to JJin91 [6c Kd]
TobogganM.D.: folds=20
bethere1923: folds=20
failboat1231: folds=20
xNEMESISx04: folds=20
JJin91: folds=20
YourRobotDad: folds=20
BENN DOVERR: folds=20
smokrface420: folds=20
Uncalled bet (125) returned to Booge013
Booge013 collected 520 from pot
Booge013: doesn't show hand=20
*** SUMMARY ***
Total pot 520 | Rake 0=20
Seat 1: smokrface420 (small blind) folded before Flop
Seat 2: Booge013 (big blind) collected (520)
Seat 3: TobogganM.D. folded before Flop (didn't bet)
Seat 4: bethere1923 folded before Flop (didn't bet)
Seat 5: failboat1231 folded before Flop (didn't bet)
Seat 6: xNEMESISx04 folded before Flop (didn't bet)
Seat 7: JJin91 folded before Flop (didn't bet)
Seat 8: YourRobotDad folded before Flop (didn't bet)
Seat 9: BENN DOVERR (button) folded before Flop (didn't bet)


*********** # 64 **************
PokerStars Hand #176122998635: Tournament #1701843149, $18.20+$1.80 USD=
 Hold'em No Limit - Level VIII (125/250) - 2017/10/09 20:22:13 ET
Table '1701843149 1' 9-max Seat #1 is the button
Seat 1: smokrface420 (11268 in chips)=20
Seat 2: Booge013 (10305 in chips)=20
Seat 3: TobogganM.D. (9197 in chips)=20
Seat 4: bethere1923 (11468 in chips)=20
Seat 5: failboat1231 (10032 in chips)=20
Seat 6: xNEMESISx04 (9910 in chips)=20
Seat 7: JJin91 (14767 in chips)=20
Seat 8: YourRobotDad (24538 in chips)=20
Seat 9: BENN DOVERR (8090 in chips)=20
smokrface420: posts the ante 30
Booge013: posts the ante 30
TobogganM.D.: posts the ante 30
bethere1923: posts the ante 30
failboat1231: posts the ante 30
xNEMESISx04: posts the ante 30
JJin91: posts the ante 30
YourRobotDad: posts the ante 30
BENN DOVERR: posts the ante 30
Booge013: posts small blind 125
TobogganM.D.: posts big blind 250
*** HOLE CARDS ***
Dealt to JJin91 [Kd Td]
bethere1923: folds=20
failboat1231: folds=20
xNEMESISx04: folds=20
JJin91: raises 292 to 542
YourRobotDad: folds=20
BENN DOVERR: folds=20
smokrface420: folds=20
Booge013: calls 417
TobogganM.D.: folds=20
*** FLOP *** [8h Th Js]
Booge013: checks=20
JJin91: bets 777
Booge013: folds=20
Uncalled bet (777) returned to JJin91
JJin91 collected 1604 from pot
JJin91: doesn't show hand=20
*** SUMMARY ***
Total pot 1604 | Rake 0=20
Board [8h Th Js]
Seat 1: smokrface420 (button) folded before Flop (didn't bet)
Seat 2: Booge013 (small blind) folded on the Flop
Seat 3: TobogganM.D. (big blind) folded before Flop
Seat 4: bethere1923 folded before Flop (didn't bet)
Seat 5: failboat1231 folded before Flop (didn't bet)
Seat 6: xNEMESISx04 folded before Flop (didn't bet)
Seat 7: JJin91 collected (1604)
Seat 8: YourRobotDad folded before Flop (didn't bet)
Seat 9: BENN DOVERR folded before Flop (didn't bet)


*********** # 65 **************
PokerStars Hand #176122998835: Tournament #1701843149, $18.20+$1.80 USD=
 Hold'em No Limit - Level VIII (125/250) - 2017/10/09 20:22:56 ET
Table '1701843149 1' 9-max Seat #2 is the button
Seat 1: smokrface420 (11238 in chips)=20
Seat 2: Booge013 (9733 in chips)=20
Seat 3: TobogganM.D. (8917 in chips)=20
Seat 4: bethere1923 (11438 in chips)=20
Seat 5: failboat1231 (10002 in chips)=20
Seat 6: xNEMESISx04 (9880 in chips)=20
Seat 7: JJin91 (15799 in chips)=20
Seat 8: YourRobotDad (24508 in chips)=20
Seat 9: BENN DOVERR (8060 in chips)=20
smokrface420: posts the ante 30
Booge013: posts the ante 30
TobogganM.D.: posts the ante 30
bethere1923: posts the ante 30
failboat1231: posts the ante 30
xNEMESISx04: posts the ante 30
JJin91: posts the ante 30
YourRobotDad: posts the ante 30
BENN DOVERR: posts the ante 30
TobogganM.D.: posts small blind 125
bethere1923: posts big blind 250
*** HOLE CARDS ***
Dealt to JJin91 [Jd 3s]
failboat1231: raises 312 to 562
xNEMESISx04: folds=20
JJin91: folds=20
YourRobotDad: calls 562
BENN DOVERR: folds=20
smokrface420: folds=20
Booge013: folds=20
TobogganM.D.: folds=20
bethere1923: calls 312
*** FLOP *** [Ks 9c 6c]
bethere1923: checks=20
failboat1231: checks=20
YourRobotDad: bets 1000
bethere1923: folds=20
failboat1231: folds=20
Uncalled bet (1000) returned to YourRobotDad
YourRobotDad collected 2081 from pot
*** SUMMARY ***
Total pot 2081 | Rake 0=20
Board [Ks 9c 6c]
Seat 1: smokrface420 folded before Flop (didn't bet)
Seat 2: Booge013 (button) folded before Flop (didn't bet)
Seat 3: TobogganM.D. (small blind) folded before Flop
Seat 4: bethere1923 (big blind) folded on the Flop
Seat 5: failboat1231 folded on the Flop
Seat 6: xNEMESISx04 folded before Flop (didn't bet)
Seat 7: JJin91 folded before Flop (didn't bet)
Seat 8: YourRobotDad collected (2081)
Seat 9: BENN DOVERR folded before Flop (didn't bet)


*********** # 66 **************
PokerStars Hand #176122999088: Tournament #1701843149, $18.20+$1.80 USD=
 Hold'em No Limit - Level VIII (125/250) - 2017/10/09 20:23:53 ET
Table '1701843149 1' 9-max Seat #3 is the button
Seat 1: smokrface420 (11208 in chips)=20
Seat 2: Booge013 (9703 in chips)=20
Seat 3: TobogganM.D. (8762 in chips)=20
Seat 4: bethere1923 (10846 in chips)=20
Seat 5: failboat1231 (9410 in chips)=20
Seat 6: xNEMESISx04 (9850 in chips)=20
Seat 7: JJin91 (15769 in chips)=20
Seat 8: YourRobotDad (25997 in chips)=20
Seat 9: BENN DOVERR (8030 in chips)=20
smokrface420: posts the ante 30
Booge013: posts the ante 30
TobogganM.D.: posts the ante 30
bethere1923: posts the ante 30
failboat1231: posts the ante 30
xNEMESISx04: posts the ante 30
JJin91: posts the ante 30
YourRobotDad: posts the ante 30
BENN DOVERR: posts the ante 30
bethere1923: posts small blind 125
failboat1231: posts big blind 250
*** HOLE CARDS ***
Dealt to JJin91 [Td 9s]
xNEMESISx04: folds=20
JJin91: folds=20
YourRobotDad: folds=20
BENN DOVERR: raises 375 to 625
smokrface420: raises 625 to 1250
Booge013: folds=20
TobogganM.D.: folds=20
bethere1923: folds=20
failboat1231: folds=20
BENN DOVERR: calls 625
*** FLOP *** [5d 7d 2c]
BENN DOVERR: checks=20
smokrface420: checks=20
*** TURN *** [5d 7d 2c] [Tc]
BENN DOVERR: checks=20
smokrface420: bets 1573
BENN DOVERR: folds=20
Uncalled bet (1573) returned to smokrface420
smokrface420 collected 3145 from pot
*** SUMMARY ***
Total pot 3145 | Rake 0=20
Board [5d 7d 2c Tc]
Seat 1: smokrface420 collected (3145)
Seat 2: Booge013 folded before Flop (didn't bet)
Seat 3: TobogganM.D. (button) folded before Flop (didn't bet)
Seat 4: bethere1923 (small blind) folded before Flop
Seat 5: failboat1231 (big blind) folded before Flop
Seat 6: xNEMESISx04 folded before Flop (didn't bet)
Seat 7: JJin91 folded before Flop (didn't bet)
Seat 8: YourRobotDad folded before Flop (didn't bet)
Seat 9: BENN DOVERR folded on the Turn


*********** # 67 **************
PokerStars Hand #176122999334: Tournament #1701843149, $18.20+$1.80 USD=
 Hold'em No Limit - Level VIII (125/250) - 2017/10/09 20:24:47 ET
Table '1701843149 1' 9-max Seat #4 is the button
Seat 1: smokrface420 (13073 in chips)=20
Seat 3: TobogganM.D. (8732 in chips)=20
Seat 4: bethere1923 (10691 in chips)=20
Seat 5: failboat1231 (9130 in chips)=20
Seat 6: xNEMESISx04 (9820 in chips)=20
Seat 7: JJin91 (15739 in chips)=20
Seat 8: YourRobotDad (25967 in chips)=20
Seat 9: BENN DOVERR (6750 in chips)=20
smokrface420: posts the ante 30
TobogganM.D.: posts the ante 30
bethere1923: posts the ante 30
failboat1231: posts the ante 30
xNEMESISx04: posts the ante 30
JJin91: posts the ante 30
YourRobotDad: posts the ante 30
BENN DOVERR: posts the ante 30
failboat1231: posts small blind 125
xNEMESISx04: posts big blind 250
*** HOLE CARDS ***
Dealt to JJin91 [3h Jc]
JJin91: folds=20
YourRobotDad: folds=20
BENN DOVERR: folds=20
smokrface420: folds=20
TobogganM.D.: raises 370 to 620
bethere1923: calls 620
failboat1231: calls 495
xNEMESISx04: folds=20
*** FLOP *** [2c 8d Qd]
failboat1231: checks=20
TobogganM.D.: checks=20
bethere1923: bets 1034
failboat1231: folds=20
TobogganM.D.: folds=20
Uncalled bet (1034) returned to bethere1923
bethere1923 collected 2350 from pot
*** SUMMARY ***
Total pot 2350 | Rake 0=20
Board [2c 8d Qd]
Seat 1: smokrface420 folded before Flop (didn't bet)
Seat 3: TobogganM.D. folded on the Flop
Seat 4: bethere1923 (button) collected (2350)
Seat 5: failboat1231 (small blind) folded on the Flop
Seat 6: xNEMESISx04 (big blind) folded before Flop
Seat 7: JJin91 folded before Flop (didn't bet)
Seat 8: YourRobotDad folded before Flop (didn't bet)
Seat 9: BENN DOVERR folded before Flop (didn't bet)


*********** # 68 **************
PokerStars Hand #176122999550: Tournament #1701843149, $18.20+$1.80 USD=
 Hold'em No Limit - Level VIII (125/250) - 2017/10/09 20:25:36 ET
Table '1701843149 1' 9-max Seat #5 is the button
Seat 1: smokrface420 (13043 in chips)=20
Seat 3: TobogganM.D. (8082 in chips)=20
Seat 4: bethere1923 (12391 in chips)=20
Seat 5: failboat1231 (8480 in chips)=20
Seat 6: xNEMESISx04 (9540 in chips)=20
Seat 7: JJin91 (15709 in chips)=20
Seat 8: YourRobotDad (25937 in chips)=20
Seat 9: BENN DOVERR (6720 in chips)=20
smokrface420: posts the ante 30
TobogganM.D.: posts the ante 30
bethere1923: posts the ante 30
failboat1231: posts the ante 30
xNEMESISx04: posts the ante 30
JJin91: posts the ante 30
YourRobotDad: posts the ante 30
BENN DOVERR: posts the ante 30
xNEMESISx04: posts small blind 125
JJin91: posts big blind 250
*** HOLE CARDS ***
Dealt to JJin91 [Td Qh]
YourRobotDad: folds=20
BENN DOVERR: raises 375 to 625
smokrface420: folds=20
TobogganM.D.: calls 625
bethere1923: folds=20
failboat1231: folds=20
xNEMESISx04: folds=20
JJin91: folds=20
*** FLOP *** [Ac 8c Jh]
BENN DOVERR: checks=20
TobogganM.D.: bets 770
BENN DOVERR: calls 770
*** TURN *** [Ac 8c Jh] [4h]
BENN DOVERR: checks=20
TobogganM.D.: checks=20
*** RIVER *** [Ac 8c Jh 4h] [6h]
BENN DOVERR: bets 1498
TobogganM.D.: raises 5159 to 6657 and is all-in
BENN DOVERR: calls 3797 and is all-in
Uncalled bet (1362) returned to TobogganM.D.
*** SHOW DOWN ***
TobogganM.D.: shows [6d 6s] (three of a kind, Sixes)
BENN DOVERR: shows [As Js] (two pair, Aces and Jacks)
TobogganM.D. collected 13995 from pot
BENN DOVERR finished the tournament in 91st place
*** SUMMARY ***
Total pot 13995 | Rake 0=20
Board [Ac 8c Jh 4h 6h]
Seat 1: smokrface420 folded before Flop (didn't bet)
Seat 3: TobogganM.D. showed [6d 6s] and won (13995) with three of a kin=
d, Sixes
Seat 4: bethere1923 folded before Flop (didn't bet)
Seat 5: failboat1231 (button) folded before Flop (didn't bet)
Seat 6: xNEMESISx04 (small blind) folded before Flop
Seat 7: JJin91 (big blind) folded before Flop
Seat 8: YourRobotDad folded before Flop (didn't bet)
Seat 9: BENN DOVERR showed [As Js] and lost with two pair, Aces and Jac=
ks


*********** # 69 **************
PokerStars Hand #176122999889: Tournament #1701843149, $18.20+$1.80 USD=
 Hold'em No Limit - Level IX (150/300) - 2017/10/09 20:26:54 ET
Table '1701843149 1' 9-max Seat #6 is the button
Seat 1: smokrface420 (13013 in chips)=20
Seat 2: BENN DOVERR (10000 in chips)=20
Seat 3: TobogganM.D. (15357 in chips)=20
Seat 4: bethere1923 (12361 in chips)=20
Seat 5: failboat1231 (8450 in chips)=20
Seat 6: xNEMESISx04 (9385 in chips)=20
Seat 7: JJin91 (15429 in chips)=20
Seat 8: YourRobotDad (25907 in chips)=20
smokrface420: posts the ante 40
BENN DOVERR: posts the ante 40
TobogganM.D.: posts the ante 40
bethere1923: posts the ante 40
failboat1231: posts the ante 40
xNEMESISx04: posts the ante 40
JJin91: posts the ante 40
YourRobotDad: posts the ante 40
JJin91: posts small blind 150
YourRobotDad: posts big blind 300
*** HOLE CARDS ***
Dealt to JJin91 [Qh 3d]
smokrface420: folds=20
BENN DOVERR: folds=20
TobogganM.D.: folds=20
bethere1923: folds=20
failboat1231: raises 375 to 675
xNEMESISx04: folds=20
JJin91: folds=20
YourRobotDad: folds=20
Uncalled bet (375) returned to failboat1231
failboat1231 collected 1070 from pot
failboat1231: doesn't show hand=20
*** SUMMARY ***
Total pot 1070 | Rake 0=20
Seat 1: smokrface420 folded before Flop (didn't bet)
Seat 2: BENN DOVERR folded before Flop (didn't bet)
Seat 3: TobogganM.D. folded before Flop (didn't bet)
Seat 4: bethere1923 folded before Flop (didn't bet)
Seat 5: failboat1231 collected (1070)
Seat 6: xNEMESISx04 (button) folded before Flop (didn't bet)
Seat 7: JJin91 (small blind) folded before Flop
Seat 8: YourRobotDad (big blind) folded before Flop


*********** # 70 **************
PokerStars Hand #176123588870: Tournament #1701843149, $18.20+$1.80 USD=
 Hold'em No Limit - Level IX (150/300) - 2017/10/09 20:27:38 ET
Table '1701843149 1' 9-max Seat #7 is the button
Seat 1: smokrface420 (12973 in chips)=20
Seat 2: BENN DOVERR (9960 in chips)=20
Seat 3: TobogganM.D. (15317 in chips)=20
Seat 4: bethere1923 (12321 in chips)=20
Seat 5: failboat1231 (9180 in chips)=20
Seat 6: xNEMESISx04 (9345 in chips)=20
Seat 7: JJin91 (15239 in chips)=20
Seat 8: YourRobotDad (25567 in chips)=20
smokrface420: posts the ante 40
BENN DOVERR: posts the ante 40
TobogganM.D.: posts the ante 40
bethere1923: posts the ante 40
failboat1231: posts the ante 40
xNEMESISx04: posts the ante 40
JJin91: posts the ante 40
YourRobotDad: posts the ante 40
YourRobotDad: posts small blind 150
smokrface420: posts big blind 300
*** HOLE CARDS ***
Dealt to JJin91 [Qd 6d]
BENN DOVERR: folds=20
TobogganM.D.: folds=20
bethere1923: folds=20
failboat1231: folds=20
xNEMESISx04: raises 360 to 660
JJin91: folds=20
YourRobotDad: folds=20
smokrface420: folds=20
Uncalled bet (360) returned to xNEMESISx04
xNEMESISx04 collected 1070 from pot
xNEMESISx04: doesn't show hand=20
*** SUMMARY ***
Total pot 1070 | Rake 0=20
Seat 1: smokrface420 (big blind) folded before Flop
Seat 2: BENN DOVERR folded before Flop (didn't bet)
Seat 3: TobogganM.D. folded before Flop (didn't bet)
Seat 4: bethere1923 folded before Flop (didn't bet)
Seat 5: failboat1231 folded before Flop (didn't bet)
Seat 6: xNEMESISx04 collected (1070)
Seat 7: JJin91 (button) folded before Flop (didn't bet)
Seat 8: YourRobotDad (small blind) folded before Flop


*********** # 71 **************
PokerStars Hand #176123589036: Tournament #1701843149, $18.20+$1.80 USD=
 Hold'em No Limit - Level IX (150/300) - 2017/10/09 20:28:22 ET
Table '1701843149 1' 9-max Seat #8 is the button
Seat 1: smokrface420 (12633 in chips)=20
Seat 2: BENN DOVERR (9920 in chips)=20
Seat 3: TobogganM.D. (15277 in chips)=20
Seat 4: bethere1923 (12281 in chips)=20
Seat 5: failboat1231 (9140 in chips)=20
Seat 6: xNEMESISx04 (10075 in chips)=20
Seat 7: JJin91 (15199 in chips)=20
Seat 8: YourRobotDad (25377 in chips)=20
Seat 9: 4Aces518 (10000 in chips) out of hand (moved from another table=
 into small blind)
smokrface420: posts the ante 40
BENN DOVERR: posts the ante 40
TobogganM.D.: posts the ante 40
bethere1923: posts the ante 40
failboat1231: posts the ante 40
xNEMESISx04: posts the ante 40
JJin91: posts the ante 40
YourRobotDad: posts the ante 40
smokrface420: posts small blind 150
BENN DOVERR: posts big blind 300
*** HOLE CARDS ***
Dealt to JJin91 [Th 7h]
TobogganM.D.: folds=20
bethere1923: folds=20
failboat1231: folds=20
xNEMESISx04: folds=20
JJin91: folds=20
YourRobotDad: folds=20
smokrface420: folds=20
Uncalled bet (150) returned to BENN DOVERR
BENN DOVERR collected 620 from pot
*** SUMMARY ***
Total pot 620 | Rake 0=20
Seat 1: smokrface420 (small blind) folded before Flop
Seat 2: BENN DOVERR (big blind) collected (620)
Seat 3: TobogganM.D. folded before Flop (didn't bet)
Seat 4: bethere1923 folded before Flop (didn't bet)
Seat 5: failboat1231 folded before Flop (didn't bet)
Seat 6: xNEMESISx04 folded before Flop (didn't bet)
Seat 7: JJin91 folded before Flop (didn't bet)
Seat 8: YourRobotDad (button) folded before Flop (didn't bet)


*********** # 72 **************
PokerStars Hand #176123589105: Tournament #1701843149, $18.20+$1.80 USD=
 Hold'em No Limit - Level IX (150/300) - 2017/10/09 20:28:39 ET
Table '1701843149 1' 9-max Seat #1 is the button
Seat 1: smokrface420 (12443 in chips)=20
Seat 2: BENN DOVERR (10350 in chips)=20
Seat 3: TobogganM.D. (15237 in chips)=20
Seat 4: bethere1923 (12241 in chips)=20
Seat 5: failboat1231 (9100 in chips)=20
Seat 6: xNEMESISx04 (10035 in chips)=20
Seat 7: JJin91 (15159 in chips)=20
Seat 8: YourRobotDad (25337 in chips)=20
Seat 9: 4Aces518 (10000 in chips)=20
smokrface420: posts the ante 40
BENN DOVERR: posts the ante 40
TobogganM.D.: posts the ante 40
bethere1923: posts the ante 40
failboat1231: posts the ante 40
xNEMESISx04: posts the ante 40
JJin91: posts the ante 40
YourRobotDad: posts the ante 40
4Aces518: posts the ante 40
BENN DOVERR: posts small blind 150
TobogganM.D.: posts big blind 300
*** HOLE CARDS ***
Dealt to JJin91 [7s 9d]
bethere1923: folds=20
failboat1231: folds=20
xNEMESISx04: raises 360 to 660
JJin91: folds=20
YourRobotDad: folds=20
4Aces518: folds=20
smokrface420: folds=20
BENN DOVERR: folds=20
TobogganM.D.: folds=20
Uncalled bet (360) returned to xNEMESISx04
xNEMESISx04 collected 1110 from pot
xNEMESISx04: doesn't show hand=20
*** SUMMARY ***
Total pot 1110 | Rake 0=20
Seat 1: smokrface420 (button) folded before Flop (didn't bet)
Seat 2: BENN DOVERR (small blind) folded before Flop
Seat 3: TobogganM.D. (big blind) folded before Flop
Seat 4: bethere1923 folded before Flop (didn't bet)
Seat 5: failboat1231 folded before Flop (didn't bet)
Seat 6: xNEMESISx04 collected (1110)
Seat 7: JJin91 folded before Flop (didn't bet)
Seat 8: YourRobotDad folded before Flop (didn't bet)
Seat 9: 4Aces518 folded before Flop (didn't bet)


*********** # 73 **************
PokerStars Hand #176123589202: Tournament #1701843149, $18.20+$1.80 USD=
 Hold'em No Limit - Level IX (150/300) - 2017/10/09 20:29:03 ET
Table '1701843149 1' 9-max Seat #2 is the button
Seat 1: smokrface420 (12403 in chips)=20
Seat 2: BENN DOVERR (10160 in chips)=20
Seat 3: TobogganM.D. (14897 in chips)=20
Seat 4: bethere1923 (12201 in chips)=20
Seat 5: failboat1231 (9060 in chips)=20
Seat 6: xNEMESISx04 (10805 in chips)=20
Seat 7: JJin91 (15119 in chips)=20
Seat 8: YourRobotDad (25297 in chips)=20
Seat 9: 4Aces518 (9960 in chips)=20
smokrface420: posts the ante 40
BENN DOVERR: posts the ante 40
TobogganM.D.: posts the ante 40
bethere1923: posts the ante 40
failboat1231: posts the ante 40
xNEMESISx04: posts the ante 40
JJin91: posts the ante 40
YourRobotDad: posts the ante 40
4Aces518: posts the ante 40
TobogganM.D.: posts small blind 150
bethere1923: posts big blind 300
*** HOLE CARDS ***
Dealt to JJin91 [Jc 3c]
failboat1231: folds=20
xNEMESISx04: folds=20
JJin91: folds=20
YourRobotDad: folds=20
4Aces518: folds=20
smokrface420: folds=20
BENN DOVERR: folds=20
TobogganM.D.: raises 500 to 800
bethere1923: calls 500
*** FLOP *** [5h Kc 6s]
TobogganM.D.: bets 970
bethere1923: calls 970
*** TURN *** [5h Kc 6s] [8c]
TobogganM.D.: checks=20
bethere1923: checks=20
*** RIVER *** [5h Kc 6s 8c] [6h]
TobogganM.D.: checks=20
bethere1923: bets 2496
TobogganM.D.: folds=20
Uncalled bet (2496) returned to bethere1923
bethere1923 collected 3900 from pot
*** SUMMARY ***
Total pot 3900 | Rake 0=20
Board [5h Kc 6s 8c 6h]
Seat 1: smokrface420 folded before Flop (didn't bet)
Seat 2: BENN DOVERR (button) folded before Flop (didn't bet)
Seat 3: TobogganM.D. (small blind) folded on the River
Seat 4: bethere1923 (big blind) collected (3900)
Seat 5: failboat1231 folded before Flop (didn't bet)
Seat 6: xNEMESISx04 folded before Flop (didn't bet)
Seat 7: JJin91 folded before Flop (didn't bet)
Seat 8: YourRobotDad folded before Flop (didn't bet)
Seat 9: 4Aces518 folded before Flop (didn't bet)


*********** # 74 **************
PokerStars Hand #176123589596: Tournament #1701843149, $18.20+$1.80 USD=
 Hold'em No Limit - Level IX (150/300) - 2017/10/09 20:30:28 ET
Table '1701843149 1' 9-max Seat #3 is the button
Seat 1: smokrface420 (12363 in chips)=20
Seat 2: BENN DOVERR (10120 in chips)=20
Seat 3: TobogganM.D. (13087 in chips)=20
Seat 4: bethere1923 (14291 in chips)=20
Seat 5: failboat1231 (9020 in chips)=20
Seat 6: xNEMESISx04 (10765 in chips)=20
Seat 7: JJin91 (15079 in chips)=20
Seat 8: YourRobotDad (25257 in chips)=20
Seat 9: 4Aces518 (9920 in chips)=20
smokrface420: posts the ante 40
BENN DOVERR: posts the ante 40
TobogganM.D.: posts the ante 40
bethere1923: posts the ante 40
failboat1231: posts the ante 40
xNEMESISx04: posts the ante 40
JJin91: posts the ante 40
YourRobotDad: posts the ante 40
4Aces518: posts the ante 40
bethere1923: posts small blind 150
failboat1231: posts big blind 300
*** HOLE CARDS ***
Dealt to JJin91 [Qd Kd]
xNEMESISx04: folds=20
JJin91: raises 351 to 651
YourRobotDad: folds=20
4Aces518: folds=20
smokrface420: calls 651
BENN DOVERR: folds=20
TobogganM.D.: folds=20
bethere1923: calls 501
failboat1231: folds=20
*** FLOP *** [8s 7d 2d]
bethere1923: checks=20
JJin91: checks=20
smokrface420: bets 1500
bethere1923: folds=20
JJin91: calls 1500
*** TURN *** [8s 7d 2d] [Td]
JJin91: checks=20
smokrface420: checks=20
*** RIVER *** [8s 7d 2d Td] [5c]
JJin91: bets 3555
smokrface420: folds=20
Uncalled bet (3555) returned to JJin91
JJin91 collected 5613 from pot
JJin91: doesn't show hand=20
*** SUMMARY ***
Total pot 5613 | Rake 0=20
Board [8s 7d 2d Td 5c]
Seat 1: smokrface420 folded on the River
Seat 2: BENN DOVERR folded before Flop (didn't bet)
Seat 3: TobogganM.D. (button) folded before Flop (didn't bet)
Seat 4: bethere1923 (small blind) folded on the Flop
Seat 5: failboat1231 (big blind) folded before Flop
Seat 6: xNEMESISx04 folded before Flop (didn't bet)
Seat 7: JJin91 collected (5613)
Seat 8: YourRobotDad folded before Flop (didn't bet)
Seat 9: 4Aces518 folded before Flop (didn't bet)


*********** # 75 **************
PokerStars Hand #176123589909: Tournament #1701843149, $18.20+$1.80 USD=
 Hold'em No Limit - Level IX (150/300) - 2017/10/09 20:31:51 ET
Table '1701843149 1' 9-max Seat #4 is the button
Seat 1: smokrface420 (10172 in chips)=20
Seat 2: BENN DOVERR (10080 in chips)=20
Seat 3: TobogganM.D. (13047 in chips)=20
Seat 4: bethere1923 (13600 in chips)=20
Seat 5: failboat1231 (8680 in chips)=20
Seat 6: xNEMESISx04 (10725 in chips)=20
Seat 7: JJin91 (18501 in chips)=20
Seat 8: YourRobotDad (25217 in chips)=20
Seat 9: 4Aces518 (9880 in chips)=20
smokrface420: posts the ante 40
BENN DOVERR: posts the ante 40
TobogganM.D.: posts the ante 40
bethere1923: posts the ante 40
failboat1231: posts the ante 40
xNEMESISx04: posts the ante 40
JJin91: posts the ante 40
YourRobotDad: posts the ante 40
4Aces518: posts the ante 40
failboat1231: posts small blind 150
xNEMESISx04: posts big blind 300
*** HOLE CARDS ***
Dealt to JJin91 [2d 6d]
JJin91: folds=20
YourRobotDad: folds=20
4Aces518: calls 300
smokrface420: folds=20
BENN DOVERR: raises 900 to 1200
TobogganM.D.: folds=20
bethere1923: folds=20
failboat1231: folds=20
xNEMESISx04: folds=20
4Aces518: folds=20
Uncalled bet (900) returned to BENN DOVERR
BENN DOVERR collected 1410 from pot
*** SUMMARY ***
Total pot 1410 | Rake 0=20
Seat 1: smokrface420 folded before Flop (didn't bet)
Seat 2: BENN DOVERR collected (1410)
Seat 3: TobogganM.D. folded before Flop (didn't bet)
Seat 4: bethere1923 (button) folded before Flop (didn't bet)
Seat 5: failboat1231 (small blind) folded before Flop
Seat 6: xNEMESISx04 (big blind) folded before Flop
Seat 7: JJin91 folded before Flop (didn't bet)
Seat 8: YourRobotDad folded before Flop (didn't bet)
Seat 9: 4Aces518 folded before Flop


*********** # 76 **************
PokerStars Hand #176123915042: Tournament #1701843149, $18.20+$1.80 USD=
 Hold'em No Limit - Level IX (150/300) - 2017/10/09 20:32:21 ET
Table '1701843149 1' 9-max Seat #5 is the button
Seat 1: smokrface420 (10132 in chips)=20
Seat 2: BENN DOVERR (11150 in chips)=20
Seat 3: TobogganM.D. (13007 in chips)=20
Seat 4: bethere1923 (13560 in chips)=20
Seat 5: failboat1231 (8490 in chips)=20
Seat 6: xNEMESISx04 (10385 in chips)=20
Seat 7: JJin91 (18461 in chips)=20
Seat 8: YourRobotDad (25177 in chips)=20
Seat 9: 4Aces518 (9540 in chips)=20
smokrface420: posts the ante 40
BENN DOVERR: posts the ante 40
TobogganM.D.: posts the ante 40
bethere1923: posts the ante 40
failboat1231: posts the ante 40
xNEMESISx04: posts the ante 40
JJin91: posts the ante 40
YourRobotDad: posts the ante 40
4Aces518: posts the ante 40
xNEMESISx04: posts small blind 150
JJin91: posts big blind 300
*** HOLE CARDS ***
Dealt to JJin91 [2d Kd]
YourRobotDad: folds=20
4Aces518: folds=20
smokrface420: folds=20
BENN DOVERR: raises 450 to 750
TobogganM.D.: folds=20
bethere1923: folds=20
failboat1231: calls 750
xNEMESISx04: folds=20
JJin91: folds=20
*** FLOP *** [7s 9h 9s]
BENN DOVERR: bets 832
failboat1231: calls 832
*** TURN *** [7s 9h 9s] [5c]
BENN DOVERR: checks=20
failboat1231: checks=20
*** RIVER *** [7s 9h 9s 5c] [4d]
BENN DOVERR: bets 3179
failboat1231: raises 3689 to 6868 and is all-in
BENN DOVERR: folds=20
Uncalled bet (3689) returned to failboat1231
failboat1231 collected 10332 from pot
failboat1231: doesn't show hand=20
*** SUMMARY ***
Total pot 10332 | Rake 0=20
Board [7s 9h 9s 5c 4d]
Seat 1: smokrface420 folded before Flop (didn't bet)
Seat 2: BENN DOVERR folded on the River
Seat 3: TobogganM.D. folded before Flop (didn't bet)
Seat 4: bethere1923 folded before Flop (didn't bet)
Seat 5: failboat1231 (button) collected (10332)
Seat 6: xNEMESISx04 (small blind) folded before Flop
Seat 7: JJin91 (big blind) folded before Flop
Seat 8: YourRobotDad folded before Flop (didn't bet)
Seat 9: 4Aces518 folded before Flop (didn't bet)


*********** # 77 **************
PokerStars Hand #176123915337: Tournament #1701843149, $18.20+$1.80 USD=
 Hold'em No Limit - Level IX (150/300) - 2017/10/09 20:33:36 ET
Table '1701843149 1' 9-max Seat #6 is the button
Seat 1: smokrface420 (10092 in chips)=20
Seat 2: BENN DOVERR (6349 in chips)=20
Seat 3: TobogganM.D. (12967 in chips)=20
Seat 4: bethere1923 (13520 in chips)=20
Seat 5: failboat1231 (14021 in chips)=20
Seat 6: xNEMESISx04 (10195 in chips)=20
Seat 7: JJin91 (18121 in chips)=20
Seat 8: YourRobotDad (25137 in chips)=20
Seat 9: 4Aces518 (9500 in chips)=20
smokrface420: posts the ante 40
BENN DOVERR: posts the ante 40
TobogganM.D.: posts the ante 40
bethere1923: posts the ante 40
failboat1231: posts the ante 40
xNEMESISx04: posts the ante 40
JJin91: posts the ante 40
YourRobotDad: posts the ante 40
4Aces518: posts the ante 40
JJin91: posts small blind 150
YourRobotDad: posts big blind 300
*** HOLE CARDS ***
Dealt to JJin91 [6c Ts]
4Aces518: folds=20
smokrface420: folds=20
BENN DOVERR: folds=20
TobogganM.D.: raises 420 to 720
bethere1923: raises 1380 to 2100
failboat1231: folds=20
xNEMESISx04: folds=20
JJin91: folds=20
YourRobotDad: folds=20
TobogganM.D.: calls 1380
*** FLOP *** [9h 7d 5s]
TobogganM.D.: checks=20
bethere1923: bets 2204
TobogganM.D.: folds=20
Uncalled bet (2204) returned to bethere1923
bethere1923 collected 5010 from pot
*** SUMMARY ***
Total pot 5010 | Rake 0=20
Board [9h 7d 5s]
Seat 1: smokrface420 folded before Flop (didn't bet)
Seat 2: BENN DOVERR folded before Flop (didn't bet)
Seat 3: TobogganM.D. folded on the Flop
Seat 4: bethere1923 collected (5010)
Seat 5: failboat1231 folded before Flop (didn't bet)
Seat 6: xNEMESISx04 (button) folded before Flop (didn't bet)
Seat 7: JJin91 (small blind) folded before Flop
Seat 8: YourRobotDad (big blind) folded before Flop
Seat 9: 4Aces518 folded before Flop (didn't bet)


*********** # 78 **************
PokerStars Hand #176123915607: Tournament #1701843149, $18.20+$1.80 USD=
 Hold'em No Limit - Level IX (150/300) - 2017/10/09 20:34:43 ET
Table '1701843149 1' 9-max Seat #7 is the button
Seat 1: smokrface420 (10052 in chips)=20
Seat 2: BENN DOVERR (6309 in chips)=20
Seat 3: TobogganM.D. (10827 in chips)=20
Seat 4: bethere1923 (16390 in chips)=20
Seat 5: failboat1231 (13981 in chips)=20
Seat 6: xNEMESISx04 (10155 in chips)=20
Seat 7: JJin91 (17931 in chips)=20
Seat 8: YourRobotDad (24797 in chips)=20
Seat 9: 4Aces518 (9460 in chips)=20
smokrface420: posts the ante 40
BENN DOVERR: posts the ante 40
TobogganM.D.: posts the ante 40
bethere1923: posts the ante 40
failboat1231: posts the ante 40
xNEMESISx04: posts the ante 40
JJin91: posts the ante 40
YourRobotDad: posts the ante 40
4Aces518: posts the ante 40
YourRobotDad: posts small blind 150
4Aces518: posts big blind 300
*** HOLE CARDS ***
Dealt to JJin91 [Qs 5h]
smokrface420: raises 600 to 900
BENN DOVERR: calls 900
TobogganM.D.: folds=20
bethere1923: calls 900
failboat1231: folds=20
xNEMESISx04: folds=20
JJin91: folds=20
YourRobotDad: folds=20
4Aces518: calls 600
*** FLOP *** [9c As 4s]
4Aces518: checks=20
smokrface420: checks=20
BENN DOVERR: checks=20
bethere1923: checks=20
*** TURN *** [9c As 4s] [3h]
4Aces518: checks=20
smokrface420: checks=20
BENN DOVERR: checks=20
bethere1923: checks=20
*** RIVER *** [9c As 4s 3h] [6c]
4Aces518: checks=20
smokrface420: bets 2055
BENN DOVERR: folds=20
bethere1923: folds=20
4Aces518: folds=20
Uncalled bet (2055) returned to smokrface420
smokrface420 collected 4110 from pot
*** SUMMARY ***
Total pot 4110 | Rake 0=20
Board [9c As 4s 3h 6c]
Seat 1: smokrface420 collected (4110)
Seat 2: BENN DOVERR folded on the River
Seat 3: TobogganM.D. folded before Flop (didn't bet)
Seat 4: bethere1923 folded on the River
Seat 5: failboat1231 folded before Flop (didn't bet)
Seat 6: xNEMESISx04 folded before Flop (didn't bet)
Seat 7: JJin91 (button) folded before Flop (didn't bet)
Seat 8: YourRobotDad (small blind) folded before Flop
Seat 9: 4Aces518 (big blind) folded on the River


*********** # 79 **************
PokerStars Hand #176123915950: Tournament #1701843149, $18.20+$1.80 USD=
 Hold'em No Limit - Level IX (150/300) - 2017/10/09 20:36:08 ET
Table '1701843149 1' 9-max Seat #8 is the button
Seat 1: smokrface420 (13222 in chips)=20
Seat 2: BENN DOVERR (5369 in chips)=20
Seat 3: TobogganM.D. (10787 in chips)=20
Seat 4: bethere1923 (15450 in chips)=20
Seat 5: failboat1231 (13941 in chips)=20
Seat 6: xNEMESISx04 (10115 in chips)=20
Seat 7: JJin91 (17891 in chips)=20
Seat 8: YourRobotDad (24607 in chips)=20
Seat 9: 4Aces518 (8520 in chips)=20
smokrface420: posts the ante 40
BENN DOVERR: posts the ante 40
TobogganM.D.: posts the ante 40
bethere1923: posts the ante 40
failboat1231: posts the ante 40
xNEMESISx04: posts the ante 40
JJin91: posts the ante 40
YourRobotDad: posts the ante 40
4Aces518: posts the ante 40
4Aces518: posts small blind 150
smokrface420: posts big blind 300
*** HOLE CARDS ***
Dealt to JJin91 [Kc 9d]
BENN DOVERR: folds=20
TobogganM.D.: folds=20
bethere1923: folds=20
failboat1231: folds=20
xNEMESISx04: raises 600 to 900
JJin91: folds=20
YourRobotDad: folds=20
4Aces518: folds=20
smokrface420: folds=20
Uncalled bet (600) returned to xNEMESISx04
xNEMESISx04 collected 1110 from pot
xNEMESISx04: doesn't show hand=20
*** SUMMARY ***
Total pot 1110 | Rake 0=20
Seat 1: smokrface420 (big blind) folded before Flop
Seat 2: BENN DOVERR folded before Flop (didn't bet)
Seat 3: TobogganM.D. folded before Flop (didn't bet)
Seat 4: bethere1923 folded before Flop (didn't bet)
Seat 5: failboat1231 folded before Flop (didn't bet)
Seat 6: xNEMESISx04 collected (1110)
Seat 7: JJin91 folded before Flop (didn't bet)
Seat 8: YourRobotDad (button) folded before Flop (didn't bet)
Seat 9: 4Aces518 (small blind) folded before Flop


*********** # 80 **************
PokerStars Hand #176123916028: Tournament #1701843149, $18.20+$1.80 USD=
 Hold'em No Limit - Level IX (150/300) - 2017/10/09 20:36:28 ET
Table '1701843149 1' 9-max Seat #9 is the button
Seat 1: smokrface420 (12882 in chips)=20
Seat 2: BENN DOVERR (5329 in chips)=20
Seat 3: TobogganM.D. (10747 in chips)=20
Seat 4: bethere1923 (15410 in chips)=20
Seat 5: failboat1231 (13901 in chips)=20
Seat 6: xNEMESISx04 (10885 in chips)=20
Seat 7: JJin91 (17851 in chips)=20
Seat 8: YourRobotDad (24567 in chips)=20
Seat 9: 4Aces518 (8330 in chips)=20
smokrface420: posts the ante 40
BENN DOVERR: posts the ante 40
TobogganM.D.: posts the ante 40
bethere1923: posts the ante 40
failboat1231: posts the ante 40
xNEMESISx04: posts the ante 40
JJin91: posts the ante 40
YourRobotDad: posts the ante 40
4Aces518: posts the ante 40
smokrface420: posts small blind 150
BENN DOVERR: posts big blind 300
*** HOLE CARDS ***
Dealt to JJin91 [9s 4d]
TobogganM.D.: folds=20
bethere1923: folds=20
failboat1231: folds=20
xNEMESISx04: raises 600 to 900
JJin91: folds=20
YourRobotDad: folds=20
4Aces518: calls 900
smokrface420: folds=20
BENN DOVERR: calls 600
*** FLOP *** [Qs 5h Kh]
BENN DOVERR: checks=20
xNEMESISx04: bets 1200
4Aces518: calls 1200
BENN DOVERR: raises 3189 to 4389 and is all-in
xNEMESISx04: calls 3189
4Aces518: folds=20
*** TURN *** [Qs 5h Kh] [Ts]
*** RIVER *** [Qs 5h Kh Ts] [Kd]
*** SHOW DOWN ***
BENN DOVERR: shows [Td Js] (two pair, Kings and Tens)
xNEMESISx04: shows [Ad Qd] (two pair, Kings and Queens)
xNEMESISx04 collected 13188 from pot
BENN DOVERR finished the tournament in 84th place
*** SUMMARY ***
Total pot 13188 | Rake 0=20
Board [Qs 5h Kh Ts Kd]
Seat 1: smokrface420 (small blind) folded before Flop
Seat 2: BENN DOVERR (big blind) showed [Td Js] and lost with two pair, =
Kings and Tens
Seat 3: TobogganM.D. folded before Flop (didn't bet)
Seat 4: bethere1923 folded before Flop (didn't bet)
Seat 5: failboat1231 folded before Flop (didn't bet)
Seat 6: xNEMESISx04 showed [Ad Qd] and won (13188) with two pair, Kings=
 and Queens
Seat 7: JJin91 folded before Flop (didn't bet)
Seat 8: YourRobotDad folded before Flop (didn't bet)
Seat 9: 4Aces518 (button) folded on the Flop


*********** # 81 **************
PokerStars Hand #176123916323: Tournament #1701843149, $18.20+$1.80 USD=
 Hold'em No Limit - Level X (200/400) - 2017/10/09 20:37:44 ET
Table '1701843149 1' 9-max Seat #1 is the button
Seat 1: smokrface420 (12692 in chips)=20
Seat 2: BENN DOVERR (10000 in chips) out of hand (moved from another ta=
ble into small blind)
Seat 3: TobogganM.D. (10707 in chips)=20
Seat 4: bethere1923 (15370 in chips)=20
Seat 5: failboat1231 (13861 in chips)=20
Seat 6: xNEMESISx04 (18744 in chips)=20
Seat 7: JJin91 (17811 in chips)=20
Seat 8: YourRobotDad (24527 in chips)=20
Seat 9: 4Aces518 (6190 in chips)=20
smokrface420: posts the ante 50
TobogganM.D.: posts the ante 50
bethere1923: posts the ante 50
failboat1231: posts the ante 50
xNEMESISx04: posts the ante 50
JJin91: posts the ante 50
YourRobotDad: posts the ante 50
4Aces518: posts the ante 50
TobogganM.D.: posts small blind 200
bethere1923: posts big blind 400
*** HOLE CARDS ***
Dealt to JJin91 [Kc Ks]
failboat1231: folds=20
xNEMESISx04: folds=20
JJin91: raises 468 to 868
YourRobotDad: folds=20
4Aces518: folds=20
smokrface420: folds=20
TobogganM.D.: folds=20
bethere1923: folds=20
Uncalled bet (468) returned to JJin91
JJin91 collected 1400 from pot
JJin91: doesn't show hand=20
*** SUMMARY ***
Total pot 1400 | Rake 0=20
Seat 1: smokrface420 (button) folded before Flop (didn't bet)
Seat 3: TobogganM.D. (small blind) folded before Flop
Seat 4: bethere1923 (big blind) folded before Flop
Seat 5: failboat1231 folded before Flop (didn't bet)
Seat 6: xNEMESISx04 folded before Flop (didn't bet)
Seat 7: JJin91 collected (1400)
Seat 8: YourRobotDad folded before Flop (didn't bet)
Seat 9: 4Aces518 folded before Flop (didn't bet)


*********** # 82 **************
PokerStars Hand #176123916433: Tournament #1701843149, $18.20+$1.80 USD=
 Hold'em No Limit - Level X (200/400) - 2017/10/09 20:38:08 ET
Table '1701843149 1' 9-max Seat #3 is the button
Seat 1: smokrface420 (12642 in chips)=20
Seat 2: BENN DOVERR (10000 in chips)=20
Seat 3: TobogganM.D. (10457 in chips)=20
Seat 4: bethere1923 (14920 in chips)=20
Seat 5: failboat1231 (13811 in chips)=20
Seat 6: xNEMESISx04 (18694 in chips)=20
Seat 7: JJin91 (18761 in chips)=20
Seat 8: YourRobotDad (24477 in chips)=20
Seat 9: 4Aces518 (6140 in chips)=20
smokrface420: posts the ante 50
BENN DOVERR: posts the ante 50
TobogganM.D.: posts the ante 50
bethere1923: posts the ante 50
failboat1231: posts the ante 50
xNEMESISx04: posts the ante 50
JJin91: posts the ante 50
YourRobotDad: posts the ante 50
4Aces518: posts the ante 50
bethere1923: posts small blind 200
failboat1231: posts big blind 400
*** HOLE CARDS ***
Dealt to JJin91 [Jd 7c]
xNEMESISx04: folds=20
JJin91: folds=20
YourRobotDad: raises 400 to 800
4Aces518: calls 800
smokrface420: folds=20
BENN DOVERR: folds=20
TobogganM.D.: folds=20
bethere1923: folds=20
failboat1231: calls 400
*** FLOP *** [8s 2d 5h]
failboat1231: checks=20
YourRobotDad: bets 1600
4Aces518: calls 1600
failboat1231: calls 1600
*** TURN *** [8s 2d 5h] [2h]
failboat1231: checks=20
YourRobotDad: checks=20
4Aces518: bets 3690 and is all-in
failboat1231: calls 3690
YourRobotDad: folds=20
*** RIVER *** [8s 2d 5h 2h] [4c]
*** SHOW DOWN ***
failboat1231: shows [8c Ac] (two pair, Eights and Deuces)
4Aces518: shows [Ah 8h] (two pair, Eights and Deuces)
failboat1231 collected 7615 from pot
4Aces518 collected 7615 from pot
*** SUMMARY ***
Total pot 15230 | Rake 0=20
Board [8s 2d 5h 2h 4c]
Seat 1: smokrface420 folded before Flop (didn't bet)
Seat 2: BENN DOVERR folded before Flop (didn't bet)
Seat 3: TobogganM.D. (button) folded before Flop (didn't bet)
Seat 4: bethere1923 (small blind) folded before Flop
Seat 5: failboat1231 (big blind) showed [8c Ac] and won (7615) with two=
 pair, Eights and Deuces
Seat 6: xNEMESISx04 folded before Flop (didn't bet)
Seat 7: JJin91 folded before Flop (didn't bet)
Seat 8: YourRobotDad folded on the Turn
Seat 9: 4Aces518 showed [Ah 8h] and won (7615) with two pair, Eights an=
d Deuces


*********** # 83 **************
PokerStars Hand #176123916583: Tournament #1701843149, $18.20+$1.80 USD=
 Hold'em No Limit - Level X (200/400) - 2017/10/09 20:38:47 ET
Table '1701843149 1' 9-max Seat #4 is the button
Seat 1: smokrface420 (12592 in chips)=20
Seat 2: BENN DOVERR (9950 in chips)=20
Seat 3: TobogganM.D. (10407 in chips)=20
Seat 4: bethere1923 (14670 in chips)=20
Seat 5: failboat1231 (15286 in chips)=20
Seat 6: xNEMESISx04 (18644 in chips)=20
Seat 7: JJin91 (18711 in chips)=20
Seat 8: YourRobotDad (22027 in chips)=20
Seat 9: 4Aces518 (7615 in chips)=20
smokrface420: posts the ante 50
BENN DOVERR: posts the ante 50
TobogganM.D.: posts the ante 50
bethere1923: posts the ante 50
failboat1231: posts the ante 50
xNEMESISx04: posts the ante 50
JJin91: posts the ante 50
YourRobotDad: posts the ante 50
4Aces518: posts the ante 50
failboat1231: posts small blind 200
xNEMESISx04: posts big blind 400
*** HOLE CARDS ***
Dealt to JJin91 [9h 7c]
JJin91: folds=20
YourRobotDad: folds=20
4Aces518: folds=20
smokrface420: folds=20
BENN DOVERR: folds=20
TobogganM.D.: folds=20
bethere1923: folds=20
failboat1231: folds=20
Uncalled bet (200) returned to xNEMESISx04
xNEMESISx04 collected 850 from pot
xNEMESISx04: doesn't show hand=20
*** SUMMARY ***
Total pot 850 | Rake 0=20
Seat 1: smokrface420 folded before Flop (didn't bet)
Seat 2: BENN DOVERR folded before Flop (didn't bet)
Seat 3: TobogganM.D. folded before Flop (didn't bet)
Seat 4: bethere1923 (button) folded before Flop (didn't bet)
Seat 5: failboat1231 (small blind) folded before Flop
Seat 6: xNEMESISx04 (big blind) collected (850)
Seat 7: JJin91 folded before Flop (didn't bet)
Seat 8: YourRobotDad folded before Flop (didn't bet)
Seat 9: 4Aces518 folded before Flop (didn't bet)


*********** # 84 **************
PokerStars Hand #176123916693: Tournament #1701843149, $18.20+$1.80 USD=
 Hold'em No Limit - Level X (200/400) - 2017/10/09 20:39:14 ET
Table '1701843149 1' 9-max Seat #5 is the button
Seat 1: smokrface420 (12542 in chips)=20
Seat 2: BENN DOVERR (9900 in chips)=20
Seat 3: TobogganM.D. (10357 in chips)=20
Seat 4: bethere1923 (14620 in chips)=20
Seat 5: failboat1231 (15036 in chips)=20
Seat 6: xNEMESISx04 (19244 in chips)=20
Seat 7: JJin91 (18661 in chips)=20
Seat 8: YourRobotDad (21977 in chips)=20
Seat 9: 4Aces518 (7565 in chips)=20
smokrface420: posts the ante 50
BENN DOVERR: posts the ante 50
TobogganM.D.: posts the ante 50
bethere1923: posts the ante 50
failboat1231: posts the ante 50
xNEMESISx04: posts the ante 50
JJin91: posts the ante 50
YourRobotDad: posts the ante 50
4Aces518: posts the ante 50
xNEMESISx04: posts small blind 200
JJin91: posts big blind 400
*** HOLE CARDS ***
Dealt to JJin91 [Ks 8h]
YourRobotDad: folds=20
4Aces518: calls 400
smokrface420: raises 1600 to 2000
BENN DOVERR: folds=20
TobogganM.D.: folds=20
bethere1923: raises 12570 to 14570 and is all-in
failboat1231: folds=20
xNEMESISx04: folds=20
JJin91: folds=20
4Aces518: calls 7115 and is all-in
smokrface420: calls 10492 and is all-in
Uncalled bet (2078) returned to bethere1923
*** FLOP *** [7s Jd 8s]
*** TURN *** [7s Jd 8s] [3d]
*** RIVER *** [7s Jd 8s 3d] [5d]
*** SHOW DOWN ***
smokrface420: shows [Ah Qd] (high card Ace)
bethere1923: shows [Ad Kc] (high card Ace - King kicker)
bethere1923 collected 9954 from side pot
4Aces518: shows [Jc Ac] (a pair of Jacks)
4Aces518 collected 23595 from main pot
smokrface420 finished the tournament in 83rd place
*** SUMMARY ***
Total pot 33549 Main pot 23595. Side pot 9954. | Rake 0=20
Board [7s Jd 8s 3d 5d]
Seat 1: smokrface420 showed [Ah Qd] and lost with high card Ace
Seat 2: BENN DOVERR folded before Flop (didn't bet)
Seat 3: TobogganM.D. folded before Flop (didn't bet)
Seat 4: bethere1923 showed [Ad Kc] and won (9954) with high card Ace
Seat 5: failboat1231 (button) folded before Flop (didn't bet)
Seat 6: xNEMESISx04 (small blind) folded before Flop
Seat 7: JJin91 (big blind) folded before Flop
Seat 8: YourRobotDad folded before Flop (didn't bet)
Seat 9: 4Aces518 showed [Jc Ac] and won (23595) with a pair of Jacks


*********** # 85 **************
PokerStars Hand #176123916960: Tournament #1701843149, $18.20+$1.80 USD=
 Hold'em No Limit - Level X (200/400) - 2017/10/09 20:40:10 ET
Table '1701843149 1' 9-max Seat #6 is the button
Seat 2: BENN DOVERR (9850 in chips)=20
Seat 3: TobogganM.D. (10307 in chips)=20
Seat 4: bethere1923 (12032 in chips)=20
Seat 5: failboat1231 (14986 in chips)=20
Seat 6: xNEMESISx04 (18994 in chips)=20
Seat 7: JJin91 (18211 in chips)=20
Seat 8: YourRobotDad (21927 in chips)=20
Seat 9: 4Aces518 (23595 in chips)=20
BENN DOVERR: posts the ante 50
TobogganM.D.: posts the ante 50
bethere1923: posts the ante 50
failboat1231: posts the ante 50
xNEMESISx04: posts the ante 50
JJin91: posts the ante 50
YourRobotDad: posts the ante 50
4Aces518: posts the ante 50
JJin91: posts small blind 200
YourRobotDad: posts big blind 400
*** HOLE CARDS ***
Dealt to JJin91 [8d Js]
4Aces518: folds=20
BENN DOVERR: raises 600 to 1000
TobogganM.D.: folds=20
bethere1923: folds=20
failboat1231: folds=20
xNEMESISx04: folds=20
JJin91: folds=20
YourRobotDad: folds=20
Uncalled bet (600) returned to BENN DOVERR
BENN DOVERR collected 1400 from pot
*** SUMMARY ***
Total pot 1400 | Rake 0=20
Seat 2: BENN DOVERR collected (1400)
Seat 3: TobogganM.D. folded before Flop (didn't bet)
Seat 4: bethere1923 folded before Flop (didn't bet)
Seat 5: failboat1231 folded before Flop (didn't bet)
Seat 6: xNEMESISx04 (button) folded before Flop (didn't bet)
Seat 7: JJin91 (small blind) folded before Flop
Seat 8: YourRobotDad (big blind) folded before Flop
Seat 9: 4Aces518 folded before Flop (didn't bet)


*********** # 86 **************
PokerStars Hand #176123917092: Tournament #1701843149, $18.20+$1.80 USD=
 Hold'em No Limit - Level X (200/400) - 2017/10/09 20:40:42 ET
Table '1701843149 1' 9-max Seat #7 is the button
Seat 1: SLICK0057 (10000 in chips)=20
Seat 2: BENN DOVERR (10800 in chips)=20
Seat 3: TobogganM.D. (10257 in chips)=20
Seat 4: bethere1923 (11982 in chips)=20
Seat 5: failboat1231 (14936 in chips)=20
Seat 6: xNEMESISx04 (18944 in chips)=20
Seat 7: JJin91 (17961 in chips)=20
Seat 8: YourRobotDad (21477 in chips)=20
Seat 9: 4Aces518 (23545 in chips)=20
SLICK0057: posts the ante 50
BENN DOVERR: posts the ante 50
TobogganM.D.: posts the ante 50
bethere1923: posts the ante 50
failboat1231: posts the ante 50
xNEMESISx04: posts the ante 50
JJin91: posts the ante 50
YourRobotDad: posts the ante 50
4Aces518: posts the ante 50
YourRobotDad: posts small blind 200
4Aces518: posts big blind 400
*** HOLE CARDS ***
Dealt to JJin91 [Qc 3s]
SLICK0057: calls 400
BENN DOVERR: folds=20
TobogganM.D.: folds=20
bethere1923: folds=20
failboat1231: raises 500 to 900
xNEMESISx04: folds=20
JJin91: folds=20
YourRobotDad: folds=20
4Aces518: folds=20
SLICK0057: calls 500
*** FLOP *** [Kh Tc Ks]
SLICK0057: checks=20
failboat1231: bets 1200
SLICK0057: calls 1200
*** TURN *** [Kh Tc Ks] [Td]
SLICK0057: checks=20
failboat1231: checks=20
*** RIVER *** [Kh Tc Ks Td] [Th]
SLICK0057: bets 3600
failboat1231: calls 3600
*** SHOW DOWN ***
SLICK0057: shows [Jd Kd] (a full house, Kings full of Tens)
failboat1231: mucks hand=20
SLICK0057 collected 12450 from pot
*** SUMMARY ***
Total pot 12450 | Rake 0=20
Board [Kh Tc Ks Td Th]
Seat 1: SLICK0057 showed [Jd Kd] and won (12450) with a full house, Kin=
gs full of Tens
Seat 2: BENN DOVERR folded before Flop (didn't bet)
Seat 3: TobogganM.D. folded before Flop (didn't bet)
Seat 4: bethere1923 folded before Flop (didn't bet)
Seat 5: failboat1231 mucked [6c 6d]
Seat 6: xNEMESISx04 folded before Flop (didn't bet)
Seat 7: JJin91 (button) folded before Flop (didn't bet)
Seat 8: YourRobotDad (small blind) folded before Flop
Seat 9: 4Aces518 (big blind) folded before Flop


*********** # 87 **************
PokerStars Hand #176123917353: Tournament #1701843149, $18.20+$1.80 USD=
 Hold'em No Limit - Level X (200/400) - 2017/10/09 20:41:41 ET
Table '1701843149 1' 9-max Seat #8 is the button
Seat 1: SLICK0057 (16700 in chips)=20
Seat 2: BENN DOVERR (10750 in chips)=20
Seat 4: bethere1923 (11932 in chips)=20
Seat 5: failboat1231 (9186 in chips)=20
Seat 6: xNEMESISx04 (18894 in chips)=20
Seat 7: JJin91 (17911 in chips)=20
Seat 8: YourRobotDad (21227 in chips)=20
Seat 9: 4Aces518 (23095 in chips)=20
SLICK0057: posts the ante 50
BENN DOVERR: posts the ante 50
bethere1923: posts the ante 50
failboat1231: posts the ante 50
xNEMESISx04: posts the ante 50
JJin91: posts the ante 50
YourRobotDad: posts the ante 50
4Aces518: posts the ante 50
4Aces518: posts small blind 200
SLICK0057: posts big blind 400
*** HOLE CARDS ***
Dealt to JJin91 [Th Jc]
BENN DOVERR: folds=20
bethere1923: folds=20
failboat1231: raises 500 to 900
xNEMESISx04: folds=20
JJin91: folds=20
YourRobotDad: calls 900
4Aces518: folds=20
SLICK0057: folds=20
*** FLOP *** [7h As 8d]
failboat1231: checks=20
YourRobotDad: checks=20
*** TURN *** [7h As 8d] [5h]
failboat1231: bets 1200
YourRobotDad: calls 1200
*** RIVER *** [7h As 8d 5h] [Qh]
failboat1231: bets 2800
YourRobotDad: calls 2800
*** SHOW DOWN ***
failboat1231: shows [Ah 8h] (a flush, Ace high)
YourRobotDad: mucks hand=20
failboat1231 collected 10800 from pot
*** SUMMARY ***
Total pot 10800 | Rake 0=20
Board [7h As 8d 5h Qh]
Seat 1: SLICK0057 (big blind) folded before Flop
Seat 2: BENN DOVERR folded before Flop (didn't bet)
Seat 4: bethere1923 folded before Flop (didn't bet)
Seat 5: failboat1231 showed [Ah 8h] and won (10800) with a flush, Ace h=
igh
Seat 6: xNEMESISx04 folded before Flop (didn't bet)
Seat 7: JJin91 folded before Flop (didn't bet)
Seat 8: YourRobotDad (button) mucked [Ad Kc]
Seat 9: 4Aces518 (small blind) folded before Flop


*********** # 88 **************
PokerStars Hand #176123917557: Tournament #1701843149, $18.20+$1.80 USD=
 Hold'em No Limit - Level X (200/400) - 2017/10/09 20:42:26 ET
Table '1701843149 1' 9-max Seat #9 is the button
Seat 1: SLICK0057 (16250 in chips)=20
Seat 2: BENN DOVERR (10700 in chips)=20
Seat 4: bethere1923 (11882 in chips)=20
Seat 5: failboat1231 (15036 in chips)=20
Seat 6: xNEMESISx04 (18844 in chips)=20
Seat 7: JJin91 (17861 in chips)=20
Seat 8: YourRobotDad (16277 in chips)=20
Seat 9: 4Aces518 (22845 in chips)=20
SLICK0057: posts the ante 50
BENN DOVERR: posts the ante 50
bethere1923: posts the ante 50
failboat1231: posts the ante 50
xNEMESISx04: posts the ante 50
JJin91: posts the ante 50
YourRobotDad: posts the ante 50
4Aces518: posts the ante 50
SLICK0057: posts small blind 200
BENN DOVERR: posts big blind 400
*** HOLE CARDS ***
Dealt to JJin91 [Ad 6s]
bethere1923: folds=20
failboat1231: folds=20
xNEMESISx04: folds=20
JJin91: folds=20
YourRobotDad: folds=20
4Aces518: folds=20
SLICK0057: calls 200
BENN DOVERR: checks=20
*** FLOP *** [As 6c 7s]
SLICK0057: checks=20
BENN DOVERR: checks=20
*** TURN *** [As 6c 7s] [9h]
SLICK0057: bets 800
BENN DOVERR: calls 800
*** RIVER *** [As 6c 7s 9h] [4c]
SLICK0057: checks=20
BENN DOVERR: checks=20
*** SHOW DOWN ***
SLICK0057: shows [Ac 7h] (two pair, Aces and Sevens)
BENN DOVERR: mucks hand=20
SLICK0057 collected 2800 from pot
*** SUMMARY ***
Total pot 2800 | Rake 0=20
Board [As 6c 7s 9h 4c]
Seat 1: SLICK0057 (small blind) showed [Ac 7h] and won (2800) with two =
pair, Aces and Sevens
Seat 2: BENN DOVERR (big blind) mucked [9d Tc]
Seat 4: bethere1923 folded before Flop (didn't bet)
Seat 5: failboat1231 folded before Flop (didn't bet)
Seat 6: xNEMESISx04 folded before Flop (didn't bet)
Seat 7: JJin91 folded before Flop (didn't bet)
Seat 8: YourRobotDad folded before Flop (didn't bet)
Seat 9: 4Aces518 (button) folded before Flop (didn't bet)


*********** # 89 **************
PokerStars Hand #176123917793: Tournament #1701843149, $18.20+$1.80 USD=
 Hold'em No Limit - Level X (200/400) - 2017/10/09 20:43:18 ET
Table '1701843149 1' 9-max Seat #1 is the button
Seat 1: SLICK0057 (17800 in chips)=20
Seat 2: BENN DOVERR (9450 in chips)=20
Seat 4: bethere1923 (11832 in chips)=20
Seat 5: failboat1231 (14986 in chips)=20
Seat 6: xNEMESISx04 (18794 in chips)=20
Seat 7: JJin91 (17811 in chips)=20
Seat 8: YourRobotDad (16227 in chips)=20
Seat 9: 4Aces518 (22795 in chips)=20
SLICK0057: posts the ante 50
BENN DOVERR: posts the ante 50
bethere1923: posts the ante 50
failboat1231: posts the ante 50
xNEMESISx04: posts the ante 50
JJin91: posts the ante 50
YourRobotDad: posts the ante 50
4Aces518: posts the ante 50
BENN DOVERR: posts small blind 200
bethere1923: posts big blind 400
*** HOLE CARDS ***
Dealt to JJin91 [4c 3c]
failboat1231: folds=20
xNEMESISx04: raises 480 to 880
JJin91: folds=20
YourRobotDad: folds=20
4Aces518: folds=20
SLICK0057: folds=20
BENN DOVERR: folds=20
bethere1923: calls 480
*** FLOP *** [Ah 8c 2c]
bethere1923: checks=20
xNEMESISx04: bets 800
bethere1923: folds=20
Uncalled bet (800) returned to xNEMESISx04
xNEMESISx04 collected 2360 from pot
xNEMESISx04: doesn't show hand=20
*** SUMMARY ***
Total pot 2360 | Rake 0=20
Board [Ah 8c 2c]
Seat 1: SLICK0057 (button) folded before Flop (didn't bet)
Seat 2: BENN DOVERR (small blind) folded before Flop
Seat 4: bethere1923 (big blind) folded on the Flop
Seat 5: failboat1231 folded before Flop (didn't bet)
Seat 6: xNEMESISx04 collected (2360)
Seat 7: JJin91 folded before Flop (didn't bet)
Seat 8: YourRobotDad folded before Flop (didn't bet)
Seat 9: 4Aces518 folded before Flop (didn't bet)


*********** # 90 **************
PokerStars Hand #176123917955: Tournament #1701843149, $18.20+$1.80 USD=
 Hold'em No Limit - Level X (200/400) - 2017/10/09 20:43:51 ET
Table '1701843149 1' 9-max Seat #2 is the button
Seat 1: SLICK0057 (17750 in chips)=20
Seat 2: BENN DOVERR (9200 in chips)=20
Seat 4: bethere1923 (10902 in chips)=20
Seat 5: failboat1231 (14936 in chips)=20
Seat 6: xNEMESISx04 (20224 in chips)=20
Seat 7: JJin91 (17761 in chips)=20
Seat 8: YourRobotDad (16177 in chips)=20
Seat 9: 4Aces518 (22745 in chips)=20
SLICK0057: posts the ante 50
BENN DOVERR: posts the ante 50
bethere1923: posts the ante 50
failboat1231: posts the ante 50
xNEMESISx04: posts the ante 50
JJin91: posts the ante 50
YourRobotDad: posts the ante 50
4Aces518: posts the ante 50
bethere1923: posts small blind 200
failboat1231: posts big blind 400
*** HOLE CARDS ***
Dealt to JJin91 [Qs 9c]
xNEMESISx04: folds=20
JJin91: folds=20
YourRobotDad: folds=20
4Aces518: calls 400
SLICK0057: calls 400
BENN DOVERR: folds=20
bethere1923: folds=20
failboat1231: checks=20
*** FLOP *** [5s 8s Jh]
failboat1231: checks=20
4Aces518: checks=20
SLICK0057: checks=20
*** TURN *** [5s 8s Jh] [4s]
failboat1231: checks=20
4Aces518: checks=20
SLICK0057: bets 1200
failboat1231: calls 1200
4Aces518: folds=20
*** RIVER *** [5s 8s Jh 4s] [2c]
failboat1231: checks=20
SLICK0057: checks=20
*** SHOW DOWN ***
failboat1231: shows [8h Th] (a pair of Eights)
SLICK0057: mucks hand=20
failboat1231 collected 4200 from pot
*** SUMMARY ***
Total pot 4200 | Rake 0=20
Board [5s 8s Jh 4s 2c]
Seat 1: SLICK0057 mucked [Ah 6s]
Seat 2: BENN DOVERR (button) folded before Flop (didn't bet)
Seat 4: bethere1923 (small blind) folded before Flop
Seat 5: failboat1231 (big blind) showed [8h Th] and won (4200) with a p=
air of Eights
Seat 6: xNEMESISx04 folded before Flop (didn't bet)
Seat 7: JJin91 folded before Flop (didn't bet)
Seat 8: YourRobotDad folded before Flop (didn't bet)
Seat 9: 4Aces518 folded on the Turn


*********** # 91 **************
PokerStars Hand #176123918150: Tournament #1701843149, $18.20+$1.80 USD=
 Hold'em No Limit - Level X (200/400) - 2017/10/09 20:44:38 ET
Table '1701843149 1' 9-max Seat #4 is the button
Seat 1: SLICK0057 (16100 in chips)=20
Seat 2: BENN DOVERR (9150 in chips)=20
Seat 4: bethere1923 (10652 in chips)=20
Seat 5: failboat1231 (17486 in chips)=20
Seat 6: xNEMESISx04 (20174 in chips)=20
Seat 7: JJin91 (17711 in chips)=20
Seat 8: YourRobotDad (16127 in chips)=20
Seat 9: 4Aces518 (22295 in chips)=20
SLICK0057: posts the ante 50
BENN DOVERR: posts the ante 50
bethere1923: posts the ante 50
failboat1231: posts the ante 50
xNEMESISx04: posts the ante 50
JJin91: posts the ante 50
YourRobotDad: posts the ante 50
4Aces518: posts the ante 50
failboat1231: posts small blind 200
xNEMESISx04: posts big blind 400
*** HOLE CARDS ***
Dealt to JJin91 [6h 6d]
JJin91: folds=20
YourRobotDad: raises 800 to 1200
4Aces518: folds=20
SLICK0057: calls 1200
BENN DOVERR: folds=20
bethere1923: folds=20
failboat1231: folds=20
xNEMESISx04: calls 800
*** FLOP *** [2c 4d 5c]
xNEMESISx04: checks=20
YourRobotDad: bets 4000
SLICK0057: folds=20
xNEMESISx04: folds=20
Uncalled bet (4000) returned to YourRobotDad
YourRobotDad collected 4200 from pot
YourRobotDad: shows [Ks Kd] (a pair of Kings)
*** SUMMARY ***
Total pot 4200 | Rake 0=20
Board [2c 4d 5c]
Seat 1: SLICK0057 folded on the Flop
Seat 2: BENN DOVERR folded before Flop (didn't bet)
Seat 4: bethere1923 (button) folded before Flop (didn't bet)
Seat 5: failboat1231 (small blind) folded before Flop
Seat 6: xNEMESISx04 (big blind) folded on the Flop
Seat 7: JJin91 folded before Flop (didn't bet)
Seat 8: YourRobotDad collected (4200)
Seat 9: 4Aces518 folded before Flop (didn't bet)


*********** # 92 **************
PokerStars Hand #176123918386: Tournament #1701843149, $18.20+$1.80 USD=
 Hold'em No Limit - Level X (200/400) - 2017/10/09 20:45:32 ET
Table '1701843149 1' 9-max Seat #5 is the button
Seat 1: SLICK0057 (14850 in chips)=20
Seat 2: BENN DOVERR (9100 in chips)=20
Seat 3: Scooo13zzz (16262 in chips)=20
Seat 4: bethere1923 (10602 in chips)=20
Seat 5: failboat1231 (17236 in chips)=20
Seat 6: xNEMESISx04 (18924 in chips)=20
Seat 7: JJin91 (17661 in chips)=20
Seat 8: YourRobotDad (19077 in chips)=20
Seat 9: 4Aces518 (22245 in chips)=20
SLICK0057: posts the ante 50
BENN DOVERR: posts the ante 50
Scooo13zzz: posts the ante 50
bethere1923: posts the ante 50
failboat1231: posts the ante 50
xNEMESISx04: posts the ante 50
JJin91: posts the ante 50
YourRobotDad: posts the ante 50
4Aces518: posts the ante 50
xNEMESISx04: posts small blind 200
JJin91: posts big blind 400
*** HOLE CARDS ***
Dealt to JJin91 [2s Jc]
YourRobotDad: calls 400
4Aces518: calls 400
SLICK0057: folds=20
BENN DOVERR: folds=20
Scooo13zzz: calls 400
bethere1923: folds=20
failboat1231: folds=20
xNEMESISx04: raises 1600 to 2000
JJin91: folds=20
YourRobotDad: folds=20
Scooo13zzz said, "joe text me!!!! 973 524 1194"
4Aces518: calls 1600
Scooo13zzz: folds=20
*** FLOP *** [Qd 6d 9d]
xNEMESISx04: bets 2400
4Aces518: folds=20
Uncalled bet (2400) returned to xNEMESISx04
xNEMESISx04 collected 5650 from pot
xNEMESISx04: doesn't show hand=20
*** SUMMARY ***
Total pot 5650 | Rake 0=20
Board [Qd 6d 9d]
Seat 1: SLICK0057 folded before Flop (didn't bet)
Seat 2: BENN DOVERR folded before Flop (didn't bet)
Seat 3: Scooo13zzz folded before Flop
Seat 4: bethere1923 folded before Flop (didn't bet)
Seat 5: failboat1231 (button) folded before Flop (didn't bet)
Seat 6: xNEMESISx04 (small blind) collected (5650)
Seat 7: JJin91 (big blind) folded before Flop
Seat 8: YourRobotDad folded before Flop
Seat 9: 4Aces518 folded on the Flop


*********** # 93 **************
PokerStars Hand #176123918729: Tournament #1701843149, $18.20+$1.80 USD=
 Hold'em No Limit - Level XI (250/500) - 2017/10/09 20:46:43 ET
Table '1701843149 1' 9-max Seat #6 is the button
Seat 1: SLICK0057 (14800 in chips)=20
Seat 2: BENN DOVERR (9050 in chips)=20
Seat 3: Scooo13zzz (15812 in chips)=20
Seat 4: bethere1923 (10552 in chips)=20
Seat 5: failboat1231 (17186 in chips)=20
Seat 6: xNEMESISx04 (22524 in chips)=20
Seat 7: JJin91 (17211 in chips)=20
Seat 8: YourRobotDad (18627 in chips)=20
Seat 9: 4Aces518 (20195 in chips)=20
SLICK0057: posts the ante 60
BENN DOVERR: posts the ante 60
Scooo13zzz: posts the ante 60
bethere1923: posts the ante 60
failboat1231: posts the ante 60
xNEMESISx04: posts the ante 60
JJin91: posts the ante 60
YourRobotDad: posts the ante 60
4Aces518: posts the ante 60
JJin91: posts small blind 250
YourRobotDad: posts big blind 500
*** HOLE CARDS ***
Dealt to JJin91 [7h 6s]
4Aces518: folds=20
SLICK0057: folds=20
BENN DOVERR: raises 750 to 1250
Scooo13zzz: folds=20
bethere1923: folds=20
failboat1231: folds=20
xNEMESISx04: folds=20
JJin91: folds=20
YourRobotDad: folds=20
Uncalled bet (750) returned to BENN DOVERR
BENN DOVERR collected 1790 from pot
*** SUMMARY ***
Total pot 1790 | Rake 0=20
Seat 1: SLICK0057 folded before Flop (didn't bet)
Seat 2: BENN DOVERR collected (1790)
Seat 3: Scooo13zzz folded before Flop (didn't bet)
Seat 4: bethere1923 folded before Flop (didn't bet)
Seat 5: failboat1231 folded before Flop (didn't bet)
Seat 6: xNEMESISx04 (button) folded before Flop (didn't bet)
Seat 7: JJin91 (small blind) folded before Flop
Seat 8: YourRobotDad (big blind) folded before Flop
Seat 9: 4Aces518 folded before Flop (didn't bet)


*********** # 94 **************
PokerStars Hand #176123918845: Tournament #1701843149, $18.20+$1.80 USD=
 Hold'em No Limit - Level XI (250/500) - 2017/10/09 20:47:09 ET
Table '1701843149 1' 9-max Seat #7 is the button
Seat 1: SLICK0057 (14740 in chips)=20
Seat 2: BENN DOVERR (10280 in chips)=20
Seat 3: Scooo13zzz (15752 in chips)=20
Seat 4: bethere1923 (10492 in chips)=20
Seat 5: failboat1231 (17126 in chips)=20
Seat 6: xNEMESISx04 (22464 in chips)=20
Seat 7: JJin91 (16901 in chips)=20
Seat 8: YourRobotDad (18067 in chips)=20
Seat 9: 4Aces518 (20135 in chips)=20
SLICK0057: posts the ante 60
BENN DOVERR: posts the ante 60
Scooo13zzz: posts the ante 60
bethere1923: posts the ante 60
failboat1231: posts the ante 60
xNEMESISx04: posts the ante 60
JJin91: posts the ante 60
YourRobotDad: posts the ante 60
4Aces518: posts the ante 60
YourRobotDad: posts small blind 250
4Aces518: posts big blind 500
*** HOLE CARDS ***
Dealt to JJin91 [6d 3s]
SLICK0057: calls 500
BENN DOVERR: folds=20
Scooo13zzz: folds=20
bethere1923: folds=20
failboat1231: folds=20
xNEMESISx04: folds=20
JJin91: folds=20
YourRobotDad: calls 250
4Aces518: checks=20
*** FLOP *** [7h 2d As]
YourRobotDad: checks=20
4Aces518: checks=20
SLICK0057: checks=20
*** TURN *** [7h 2d As] [3h]
YourRobotDad: checks=20
4Aces518: checks=20
SLICK0057: bets 1000
YourRobotDad: folds=20
4Aces518: calls 1000
*** RIVER *** [7h 2d As 3h] [3c]
4Aces518: checks=20
SLICK0057: checks=20
*** SHOW DOWN ***
4Aces518: shows [5c Kh] (a pair of Threes)
SLICK0057: mucks hand=20
4Aces518 collected 4040 from pot
*** SUMMARY ***
Total pot 4040 | Rake 0=20
Board [7h 2d As 3h 3c]
Seat 1: SLICK0057 mucked [8h 9h]
Seat 2: BENN DOVERR folded before Flop (didn't bet)
Seat 3: Scooo13zzz folded before Flop (didn't bet)
Seat 4: bethere1923 folded before Flop (didn't bet)
Seat 5: failboat1231 folded before Flop (didn't bet)
Seat 6: xNEMESISx04 folded before Flop (didn't bet)
Seat 7: JJin91 (button) folded before Flop (didn't bet)
Seat 8: YourRobotDad (small blind) folded on the Turn
Seat 9: 4Aces518 (big blind) showed [5c Kh] and won (4040) with a pair =
of Threes


*********** # 95 **************
PokerStars Hand #176123919049: Tournament #1701843149, $18.20+$1.80 USD=
 Hold'em No Limit - Level XI (250/500) - 2017/10/09 20:47:51 ET
Table '1701843149 1' 9-max Seat #8 is the button
Seat 1: SLICK0057 (13180 in chips)=20
Seat 2: BENN DOVERR (10220 in chips)=20
Seat 3: Scooo13zzz (15692 in chips)=20
Seat 4: bethere1923 (10432 in chips)=20
Seat 5: failboat1231 (17066 in chips)=20
Seat 6: xNEMESISx04 (22404 in chips)=20
Seat 7: JJin91 (16841 in chips)=20
Seat 8: YourRobotDad (17507 in chips)=20
Seat 9: 4Aces518 (22615 in chips)=20
SLICK0057: posts the ante 60
BENN DOVERR: posts the ante 60
Scooo13zzz: posts the ante 60
bethere1923: posts the ante 60
failboat1231: posts the ante 60
xNEMESISx04: posts the ante 60
JJin91: posts the ante 60
YourRobotDad: posts the ante 60
4Aces518: posts the ante 60
4Aces518: posts small blind 250
SLICK0057: posts big blind 500
*** HOLE CARDS ***
Dealt to JJin91 [8d 4c]
BENN DOVERR: raises 750 to 1250
Scooo13zzz: folds=20
bethere1923: folds=20
failboat1231: folds=20
xNEMESISx04: folds=20
JJin91: folds=20
YourRobotDad: folds=20
4Aces518: folds=20
SLICK0057: folds=20
Uncalled bet (750) returned to BENN DOVERR
BENN DOVERR collected 1790 from pot
*** SUMMARY ***
Total pot 1790 | Rake 0=20
Seat 1: SLICK0057 (big blind) folded before Flop
Seat 2: BENN DOVERR collected (1790)
Seat 3: Scooo13zzz folded before Flop (didn't bet)
Seat 4: bethere1923 folded before Flop (didn't bet)
Seat 5: failboat1231 folded before Flop (didn't bet)
Seat 6: xNEMESISx04 folded before Flop (didn't bet)
Seat 7: JJin91 folded before Flop (didn't bet)
Seat 8: YourRobotDad (button) folded before Flop (didn't bet)
Seat 9: 4Aces518 (small blind) folded before Flop


*********** # 96 **************
PokerStars Hand #176123919183: Tournament #1701843149, $18.20+$1.80 USD=
 Hold'em No Limit - Level XI (250/500) - 2017/10/09 20:48:19 ET
Table '1701843149 1' 9-max Seat #9 is the button
Seat 1: SLICK0057 (12620 in chips)=20
Seat 2: BENN DOVERR (11450 in chips)=20
Seat 3: Scooo13zzz (15632 in chips)=20
Seat 4: bethere1923 (10372 in chips)=20
Seat 5: failboat1231 (17006 in chips)=20
Seat 6: xNEMESISx04 (22344 in chips)=20
Seat 7: JJin91 (16781 in chips)=20
Seat 8: YourRobotDad (17447 in chips)=20
Seat 9: 4Aces518 (22305 in chips)=20
SLICK0057: posts the ante 60
BENN DOVERR: posts the ante 60
Scooo13zzz: posts the ante 60
bethere1923: posts the ante 60
failboat1231: posts the ante 60
xNEMESISx04: posts the ante 60
JJin91: posts the ante 60
YourRobotDad: posts the ante 60
4Aces518: posts the ante 60
SLICK0057: posts small blind 250
BENN DOVERR: posts big blind 500
*** HOLE CARDS ***
Dealt to JJin91 [2c 3c]
Scooo13zzz: folds=20
bethere1923: raises 510 to 1010
failboat1231: folds=20
xNEMESISx04: folds=20
JJin91: folds=20
YourRobotDad: folds=20
4Aces518: folds=20
SLICK0057: calls 760
BENN DOVERR: calls 510
*** FLOP *** [Qd 7h Td]
SLICK0057: checks=20
BENN DOVERR: checks=20
bethere1923: bets 1571
SLICK0057: calls 1571
BENN DOVERR: folds=20
*** TURN *** [Qd 7h Td] [2h]
SLICK0057: checks=20
bethere1923: checks=20
*** RIVER *** [Qd 7h Td 2h] [Th]
SLICK0057: bets 3000
bethere1923: folds=20
Uncalled bet (3000) returned to SLICK0057
SLICK0057 collected 6712 from pot
SLICK0057: doesn't show hand=20
*** SUMMARY ***
Total pot 6712 | Rake 0=20
Board [Qd 7h Td 2h Th]
Seat 1: SLICK0057 (small blind) collected (6712)
Seat 2: BENN DOVERR (big blind) folded on the Flop
Seat 3: Scooo13zzz folded before Flop (didn't bet)
Seat 4: bethere1923 folded on the River
Seat 5: failboat1231 folded before Flop (didn't bet)
Seat 6: xNEMESISx04 folded before Flop (didn't bet)
Seat 7: JJin91 folded before Flop (didn't bet)
Seat 8: YourRobotDad folded before Flop (didn't bet)
Seat 9: 4Aces518 (button) folded before Flop (didn't bet)


*********** # 97 **************
PokerStars Hand #176123919392: Tournament #1701843149, $18.20+$1.80 USD=
 Hold'em No Limit - Level XI (250/500) - 2017/10/09 20:49:05 ET
Table '1701843149 1' 9-max Seat #1 is the button
Seat 1: SLICK0057 (16691 in chips)=20
Seat 2: BENN DOVERR (10380 in chips)=20
Seat 3: Scooo13zzz (15572 in chips)=20
Seat 4: bethere1923 (7731 in chips)=20
Seat 5: failboat1231 (16946 in chips)=20
Seat 6: xNEMESISx04 (22284 in chips)=20
Seat 7: JJin91 (16721 in chips)=20
Seat 8: YourRobotDad (17387 in chips)=20
Seat 9: 4Aces518 (22245 in chips)=20
SLICK0057: posts the ante 60
BENN DOVERR: posts the ante 60
Scooo13zzz: posts the ante 60
bethere1923: posts the ante 60
failboat1231: posts the ante 60
xNEMESISx04: posts the ante 60
JJin91: posts the ante 60
YourRobotDad: posts the ante 60
4Aces518: posts the ante 60
BENN DOVERR: posts small blind 250
Scooo13zzz: posts big blind 500
*** HOLE CARDS ***
Dealt to JJin91 [3h 4d]
bethere1923: folds=20
failboat1231: folds=20
xNEMESISx04: folds=20
JJin91: folds=20
YourRobotDad: folds=20
4Aces518: folds=20
SLICK0057: calls 500
BENN DOVERR: folds=20
Scooo13zzz: checks=20
*** FLOP *** [Qd 9h 9d]
Scooo13zzz: checks=20
SLICK0057: checks=20
*** TURN *** [Qd 9h 9d] [Jc]
Scooo13zzz: checks=20
SLICK0057: checks=20
*** RIVER *** [Qd 9h 9d Jc] [Qs]
Scooo13zzz: checks=20
SLICK0057: bets 1500
Scooo13zzz: raises 2156 to 3656
SLICK0057: calls 2156
*** SHOW DOWN ***
Scooo13zzz: shows [2h Qc] (a full house, Queens full of Nines)
SLICK0057: mucks hand=20
Scooo13zzz collected 9102 from pot
*** SUMMARY ***
Total pot 9102 | Rake 0=20
Board [Qd 9h 9d Jc Qs]
Seat 1: SLICK0057 (button) mucked [6d Ah]
Seat 2: BENN DOVERR (small blind) folded before Flop
Seat 3: Scooo13zzz (big blind) showed [2h Qc] and won (9102) with a ful=
l house, Queens full of Nines
Seat 4: bethere1923 folded before Flop (didn't bet)
Seat 5: failboat1231 folded before Flop (didn't bet)
Seat 6: xNEMESISx04 folded before Flop (didn't bet)
Seat 7: JJin91 folded before Flop (didn't bet)
Seat 8: YourRobotDad folded before Flop (didn't bet)
Seat 9: 4Aces518 folded before Flop (didn't bet)


*********** # 98 **************
PokerStars Hand #176123919835: Tournament #1701843149, $18.20+$1.80 USD=
 Hold'em No Limit - Level XI (250/500) - 2017/10/09 20:50:41 ET
Table '1701843149 1' 9-max Seat #2 is the button
Seat 1: SLICK0057 (12475 in chips)=20
Seat 2: BENN DOVERR (10070 in chips)=20
Seat 3: Scooo13zzz (20458 in chips)=20
Seat 4: bethere1923 (7671 in chips)=20
Seat 5: failboat1231 (16886 in chips)=20
Seat 6: xNEMESISx04 (22224 in chips)=20
Seat 7: JJin91 (16661 in chips)=20
Seat 8: YourRobotDad (17327 in chips)=20
Seat 9: 4Aces518 (22185 in chips)=20
SLICK0057: posts the ante 60
BENN DOVERR: posts the ante 60
Scooo13zzz: posts the ante 60
bethere1923: posts the ante 60
failboat1231: posts the ante 60
xNEMESISx04: posts the ante 60
JJin91: posts the ante 60
YourRobotDad: posts the ante 60
4Aces518: posts the ante 60
Scooo13zzz: posts small blind 250
bethere1923: posts big blind 500
*** HOLE CARDS ***
Dealt to JJin91 [Ah Ks]
failboat1231: folds=20
xNEMESISx04: folds=20
JJin91: raises 585 to 1085
YourRobotDad: folds=20
4Aces518: folds=20
SLICK0057: raises 585 to 1670
BENN DOVERR: folds=20
Scooo13zzz: folds=20
bethere1923: folds=20
JJin91: raises 2774 to 4444
SLICK0057: calls 2774
*** FLOP *** [Ts 3s 3d]
Scooo13zzz said, "yo joe"
JJin91: bets 2111
SLICK0057: folds [Ad]
Uncalled bet (2111) returned to JJin91
JJin91 collected 10178 from pot
JJin91: doesn't show hand=20
*** SUMMARY ***
Total pot 10178 | Rake 0=20
Board [Ts 3s 3d]
Seat 1: SLICK0057 folded on the Flop
Seat 2: BENN DOVERR (button) folded before Flop (didn't bet)
Seat 3: Scooo13zzz (small blind) folded before Flop
Seat 4: bethere1923 (big blind) folded before Flop
Seat 5: failboat1231 folded before Flop (didn't bet)
Seat 6: xNEMESISx04 folded before Flop (didn't bet)
Seat 7: JJin91 collected (10178)
Seat 8: YourRobotDad folded before Flop (didn't bet)
Seat 9: 4Aces518 folded before Flop (didn't bet)


*********** # 99 **************
PokerStars Hand #176125138806: Tournament #1701843149, $18.20+$1.80 USD=
 Hold'em No Limit - Level XI (250/500) - 2017/10/09 20:51:34 ET
Table '1701843149 1' 9-max Seat #3 is the button
Seat 1: SLICK0057 (7971 in chips)=20
Seat 2: BENN DOVERR (10010 in chips)=20
Seat 3: Scooo13zzz (20148 in chips)=20
Seat 4: bethere1923 (7111 in chips)=20
Seat 5: failboat1231 (16826 in chips)=20
Seat 6: xNEMESISx04 (22164 in chips)=20
Seat 7: JJin91 (22335 in chips)=20
Seat 8: YourRobotDad (17267 in chips)=20
Seat 9: 4Aces518 (22125 in chips)=20
SLICK0057: posts the ante 60
BENN DOVERR: posts the ante 60
Scooo13zzz: posts the ante 60
bethere1923: posts the ante 60
failboat1231: posts the ante 60
xNEMESISx04: posts the ante 60
JJin91: posts the ante 60
YourRobotDad: posts the ante 60
4Aces518: posts the ante 60
bethere1923: posts small blind 250
failboat1231: posts big blind 500
*** HOLE CARDS ***
Dealt to JJin91 [Ad 5s]
xNEMESISx04: folds=20
JJin91: folds=20
YourRobotDad: folds=20
4Aces518: folds=20
SLICK0057: folds=20
BENN DOVERR: raises 750 to 1250
Scooo13zzz: folds=20
bethere1923: folds=20
failboat1231: folds=20
Uncalled bet (750) returned to BENN DOVERR
BENN DOVERR collected 1790 from pot
*** SUMMARY ***
Total pot 1790 | Rake 0=20
Seat 1: SLICK0057 folded before Flop (didn't bet)
Seat 2: BENN DOVERR collected (1790)
Seat 3: Scooo13zzz (button) folded before Flop (didn't bet)
Seat 4: bethere1923 (small blind) folded before Flop
Seat 5: failboat1231 (big blind) folded before Flop
Seat 6: xNEMESISx04 folded before Flop (didn't bet)
Seat 7: JJin91 folded before Flop (didn't bet)
Seat 8: YourRobotDad folded before Flop (didn't bet)
Seat 9: 4Aces518 folded before Flop (didn't bet)


*********** # 100 **************
PokerStars Hand #176125138908: Tournament #1701843149, $18.20+$1.80 USD=
 Hold'em No Limit - Level XI (250/500) - 2017/10/09 20:51:57 ET
Table '1701843149 1' 9-max Seat #4 is the button
Seat 1: SLICK0057 (7911 in chips)=20
Seat 2: BENN DOVERR (11240 in chips)=20
Seat 3: Scooo13zzz (20088 in chips)=20
Seat 4: bethere1923 (6801 in chips)=20
Seat 5: failboat1231 (16266 in chips)=20
Seat 6: xNEMESISx04 (22104 in chips)=20
Seat 7: JJin91 (22275 in chips)=20
Seat 8: YourRobotDad (17207 in chips)=20
Seat 9: 4Aces518 (22065 in chips)=20
SLICK0057: posts the ante 60
BENN DOVERR: posts the ante 60
Scooo13zzz: posts the ante 60
bethere1923: posts the ante 60
failboat1231: posts the ante 60
xNEMESISx04: posts the ante 60
JJin91: posts the ante 60
YourRobotDad: posts the ante 60
4Aces518: posts the ante 60
failboat1231: posts small blind 250
xNEMESISx04: posts big blind 500
*** HOLE CARDS ***
Dealt to JJin91 [4c 6h]
JJin91: folds=20
YourRobotDad: raises 500 to 1000
4Aces518: folds=20
SLICK0057: calls 1000
BENN DOVERR: calls 1000
Scooo13zzz: folds=20
bethere1923: folds=20
failboat1231: folds=20
xNEMESISx04: folds=20
*** FLOP *** [4d Tc 3h]
YourRobotDad: bets 2000
SLICK0057: folds=20
BENN DOVERR: folds=20
Uncalled bet (2000) returned to YourRobotDad
YourRobotDad collected 4290 from pot
*** SUMMARY ***
Total pot 4290 | Rake 0=20
Board [4d Tc 3h]
Seat 1: SLICK0057 folded on the Flop
Seat 2: BENN DOVERR folded on the Flop
Seat 3: Scooo13zzz folded before Flop (didn't bet)
Seat 4: bethere1923 (button) folded before Flop (didn't bet)
Seat 5: failboat1231 (small blind) folded before Flop
Seat 6: xNEMESISx04 (big blind) folded before Flop
Seat 7: JJin91 folded before Flop (didn't bet)
Seat 8: YourRobotDad collected (4290)
Seat 9: 4Aces518 folded before Flop (didn't bet)


*********** # 101 **************
PokerStars Hand #176125139060: Tournament #1701843149, $18.20+$1.80 USD=
 Hold'em No Limit - Level XI (250/500) - 2017/10/09 20:52:29 ET
Table '1701843149 1' 9-max Seat #5 is the button
Seat 1: SLICK0057 (6851 in chips)=20
Seat 2: BENN DOVERR (10180 in chips)=20
Seat 3: Scooo13zzz (20028 in chips)=20
Seat 4: bethere1923 (6741 in chips)=20
Seat 5: failboat1231 (15956 in chips)=20
Seat 6: xNEMESISx04 (21544 in chips)=20
Seat 7: JJin91 (22215 in chips)=20
Seat 8: YourRobotDad (20437 in chips)=20
Seat 9: 4Aces518 (22005 in chips)=20
SLICK0057: posts the ante 60
BENN DOVERR: posts the ante 60
Scooo13zzz: posts the ante 60
bethere1923: posts the ante 60
failboat1231: posts the ante 60
xNEMESISx04: posts the ante 60
JJin91: posts the ante 60
YourRobotDad: posts the ante 60
4Aces518: posts the ante 60
xNEMESISx04: posts small blind 250
JJin91: posts big blind 500
*** HOLE CARDS ***
Dealt to JJin91 [7d Qc]
YourRobotDad: folds=20
4Aces518: folds=20
SLICK0057: raises 500 to 1000
BENN DOVERR: folds=20
Scooo13zzz: folds=20
bethere1923: folds=20
failboat1231: folds=20
xNEMESISx04: folds=20
JJin91: folds=20
Uncalled bet (500) returned to SLICK0057
SLICK0057 collected 1790 from pot
SLICK0057: doesn't show hand=20
*** SUMMARY ***
Total pot 1790 | Rake 0=20
Seat 1: SLICK0057 collected (1790)
Seat 2: BENN DOVERR folded before Flop (didn't bet)
Seat 3: Scooo13zzz folded before Flop (didn't bet)
Seat 4: bethere1923 folded before Flop (didn't bet)
Seat 5: failboat1231 (button) folded before Flop (didn't bet)
Seat 6: xNEMESISx04 (small blind) folded before Flop
Seat 7: JJin91 (big blind) folded before Flop
Seat 8: YourRobotDad folded before Flop (didn't bet)
Seat 9: 4Aces518 folded before Flop (didn't bet)


*********** # 102 **************
PokerStars Hand #176125139173: Tournament #1701843149, $18.20+$1.80 USD=
 Hold'em No Limit - Level XI (250/500) - 2017/10/09 20:52:53 ET
Table '1701843149 1' 9-max Seat #6 is the button
Seat 1: SLICK0057 (8081 in chips)=20
Seat 2: BENN DOVERR (10120 in chips)=20
Seat 3: Scooo13zzz (19968 in chips)=20
Seat 4: bethere1923 (6681 in chips)=20
Seat 5: failboat1231 (15896 in chips)=20
Seat 6: xNEMESISx04 (21234 in chips)=20
Seat 7: JJin91 (21655 in chips)=20
Seat 8: YourRobotDad (20377 in chips)=20
Seat 9: 4Aces518 (21945 in chips)=20
SLICK0057: posts the ante 60
BENN DOVERR: posts the ante 60
Scooo13zzz: posts the ante 60
bethere1923: posts the ante 60
failboat1231: posts the ante 60
xNEMESISx04: posts the ante 60
JJin91: posts the ante 60
YourRobotDad: posts the ante 60
4Aces518: posts the ante 60
JJin91: posts small blind 250
YourRobotDad: posts big blind 500
*** HOLE CARDS ***
Dealt to JJin91 [3h 5d]
4Aces518: folds=20
SLICK0057: folds=20
BENN DOVERR: folds=20
Scooo13zzz: folds=20
bethere1923: folds=20
failboat1231: folds=20
xNEMESISx04: raises 600 to 1100
JJin91: folds=20
YourRobotDad: calls 600
*** FLOP *** [3c 5s Td]
YourRobotDad: checks=20
xNEMESISx04: checks=20
*** TURN *** [3c 5s Td] [4h]
YourRobotDad: checks=20
xNEMESISx04: bets 1000
YourRobotDad: raises 2500 to 3500
xNEMESISx04: folds=20
Uncalled bet (2500) returned to YourRobotDad
YourRobotDad collected 4990 from pot
*** SUMMARY ***
Total pot 4990 | Rake 0=20
Board [3c 5s Td 4h]
Seat 1: SLICK0057 folded before Flop (didn't bet)
Seat 2: BENN DOVERR folded before Flop (didn't bet)
Seat 3: Scooo13zzz folded before Flop (didn't bet)
Seat 4: bethere1923 folded before Flop (didn't bet)
Seat 5: failboat1231 folded before Flop (didn't bet)
Seat 6: xNEMESISx04 (button) folded on the Turn
Seat 7: JJin91 (small blind) folded before Flop
Seat 8: YourRobotDad (big blind) collected (4990)
Seat 9: 4Aces518 folded before Flop (didn't bet)


*********** # 103 **************
PokerStars Hand #176125139469: Tournament #1701843149, $18.20+$1.80 USD=
 Hold'em No Limit - Level XI (250/500) - 2017/10/09 20:53:57 ET
Table '1701843149 1' 9-max Seat #7 is the button
Seat 1: SLICK0057 (8021 in chips)=20
Seat 2: BENN DOVERR (10060 in chips)=20
Seat 3: Scooo13zzz (19908 in chips)=20
Seat 4: bethere1923 (6621 in chips)=20
Seat 5: failboat1231 (15836 in chips)=20
Seat 6: xNEMESISx04 (19074 in chips)=20
Seat 7: JJin91 (21345 in chips)=20
Seat 8: YourRobotDad (23207 in chips)=20
Seat 9: 4Aces518 (21885 in chips)=20
SLICK0057: posts the ante 60
BENN DOVERR: posts the ante 60
Scooo13zzz: posts the ante 60
bethere1923: posts the ante 60
failboat1231: posts the ante 60
xNEMESISx04: posts the ante 60
JJin91: posts the ante 60
YourRobotDad: posts the ante 60
4Aces518: posts the ante 60
YourRobotDad: posts small blind 250
4Aces518: posts big blind 500
*** HOLE CARDS ***
Dealt to JJin91 [8h 4h]
SLICK0057: folds=20
BENN DOVERR: folds=20
Scooo13zzz: folds=20
bethere1923: folds=20
failboat1231: raises 625 to 1125
xNEMESISx04: folds=20
JJin91: folds=20
YourRobotDad: folds=20
4Aces518: calls 625
*** FLOP *** [9s Ah 6s]
4Aces518: bets 3040
failboat1231: raises 11611 to 14651 and is all-in
4Aces518: calls 11611
*** TURN *** [9s Ah 6s] [Jc]
*** RIVER *** [9s Ah 6s Jc] [3c]
*** SHOW DOWN ***
4Aces518: shows [Jd Ad] (two pair, Aces and Jacks)
failboat1231: shows [Ks As] (a pair of Aces)
4Aces518 collected 32342 from pot
failboat1231 finished the tournament in 67th place
*** SUMMARY ***
Total pot 32342 | Rake 0=20
Board [9s Ah 6s Jc 3c]
Seat 1: SLICK0057 folded before Flop (didn't bet)
Seat 2: BENN DOVERR folded before Flop (didn't bet)
Seat 3: Scooo13zzz folded before Flop (didn't bet)
Seat 4: bethere1923 folded before Flop (didn't bet)
Seat 5: failboat1231 showed [Ks As] and lost with a pair of Aces
Seat 6: xNEMESISx04 folded before Flop (didn't bet)
Seat 7: JJin91 (button) folded before Flop (didn't bet)
Seat 8: YourRobotDad (small blind) folded before Flop
Seat 9: 4Aces518 (big blind) showed [Jd Ad] and won (32342) with two pa=
ir, Aces and Jacks


*********** # 104 **************
PokerStars Hand #176125139654: Tournament #1701843149, $18.20+$1.80 USD=
 Hold'em No Limit - Level XI (250/500) - 2017/10/09 20:54:35 ET
Table '1701843149 1' 9-max Seat #8 is the button
Seat 1: SLICK0057 (7961 in chips)=20
Seat 2: BENN DOVERR (10000 in chips)=20
Seat 3: Scooo13zzz (19848 in chips)=20
Seat 4: bethere1923 (6561 in chips)=20
Seat 6: xNEMESISx04 (19014 in chips)=20
Seat 7: JJin91 (21285 in chips)=20
Seat 8: YourRobotDad (22897 in chips)=20
Seat 9: 4Aces518 (38391 in chips)=20
SLICK0057: posts the ante 60
BENN DOVERR: posts the ante 60
Scooo13zzz: posts the ante 60
bethere1923: posts the ante 60
xNEMESISx04: posts the ante 60
JJin91: posts the ante 60
YourRobotDad: posts the ante 60
4Aces518: posts the ante 60
4Aces518: posts small blind 250
SLICK0057: posts big blind 500
*** HOLE CARDS ***
Dealt to JJin91 [Tc Qs]
BENN DOVERR: folds=20
Scooo13zzz: folds=20
bethere1923: folds=20
xNEMESISx04: folds=20
JJin91: folds=20
YourRobotDad: calls 500
4Aces518: folds=20
SLICK0057: checks=20
*** FLOP *** [Jc Qc 7c]
SLICK0057: checks=20
YourRobotDad: checks=20
*** TURN *** [Jc Qc 7c] [9c]
SLICK0057: checks=20
YourRobotDad: checks=20
*** RIVER *** [Jc Qc 7c 9c] [2c]
SLICK0057: checks=20
YourRobotDad: bets 1000
SLICK0057: folds=20
Uncalled bet (1000) returned to YourRobotDad
YourRobotDad collected 1730 from pot
*** SUMMARY ***
Total pot 1730 | Rake 0=20
Board [Jc Qc 7c 9c 2c]
Seat 1: SLICK0057 (big blind) folded on the River
Seat 2: BENN DOVERR folded before Flop (didn't bet)
Seat 3: Scooo13zzz folded before Flop (didn't bet)
Seat 4: bethere1923 folded before Flop (didn't bet)
Seat 6: xNEMESISx04 folded before Flop (didn't bet)
Seat 7: JJin91 folded before Flop (didn't bet)
Seat 8: YourRobotDad (button) collected (1730)
Seat 9: 4Aces518 (small blind) folded before Flop


*********** # 105 **************
PokerStars Hand #176125416789: Tournament #1701843149, $18.20+$1.80 USD=
 Hold'em No Limit - Level XI (250/500) - 2017/10/09 21:00:44 ET
Table '1701843149 1' 9-max Seat #9 is the button
Seat 1: SLICK0057 (7401 in chips)=20
Seat 2: BENN DOVERR (9940 in chips)=20
Seat 3: Scooo13zzz (19788 in chips)=20
Seat 4: bethere1923 (6501 in chips)=20
Seat 7: JJin91 (21225 in chips)=20
Seat 8: YourRobotDad (24067 in chips)=20
Seat 9: 4Aces518 (38081 in chips)=20
SLICK0057: posts the ante 60
BENN DOVERR: posts the ante 60
Scooo13zzz: posts the ante 60
bethere1923: posts the ante 60
JJin91: posts the ante 60
YourRobotDad: posts the ante 60
4Aces518: posts the ante 60
SLICK0057: posts small blind 250
BENN DOVERR: posts big blind 500
*** HOLE CARDS ***
Dealt to JJin91 [2h 3h]
Scooo13zzz: folds=20
bethere1923: raises 5941 to 6441 and is all-in
JJin91: folds=20
YourRobotDad: folds=20
4Aces518: folds=20
SLICK0057: folds=20
BENN DOVERR: folds=20
Uncalled bet (5941) returned to bethere1923
bethere1923 collected 1670 from pot
*** SUMMARY ***
Total pot 1670 | Rake 0=20
Seat 1: SLICK0057 (small blind) folded before Flop
Seat 2: BENN DOVERR (big blind) folded before Flop
Seat 3: Scooo13zzz folded before Flop (didn't bet)
Seat 4: bethere1923 collected (1670)
Seat 7: JJin91 folded before Flop (didn't bet)
Seat 8: YourRobotDad folded before Flop (didn't bet)
Seat 9: 4Aces518 (button) folded before Flop (didn't bet)


*********** # 106 **************
PokerStars Hand #176125416923: Tournament #1701843149, $18.20+$1.80 USD=
 Hold'em No Limit - Level XI (250/500) - 2017/10/09 21:01:13 ET
Table '1701843149 1' 9-max Seat #1 is the button
Seat 1: SLICK0057 (7091 in chips)=20
Seat 2: BENN DOVERR (9380 in chips)=20
Seat 3: Scooo13zzz (19728 in chips)=20
Seat 4: bethere1923 (7611 in chips)=20
Seat 7: JJin91 (21165 in chips)=20
Seat 8: YourRobotDad (24007 in chips)=20
Seat 9: 4Aces518 (38021 in chips)=20
SLICK0057: posts the ante 60
BENN DOVERR: posts the ante 60
Scooo13zzz: posts the ante 60
bethere1923: posts the ante 60
JJin91: posts the ante 60
YourRobotDad: posts the ante 60
4Aces518: posts the ante 60
BENN DOVERR: posts small blind 250
Scooo13zzz: posts big blind 500
*** HOLE CARDS ***
Dealt to JJin91 [7d Tc]
bethere1923: folds=20
JJin91: folds=20
YourRobotDad: folds=20
4Aces518: folds=20
SLICK0057: folds=20
BENN DOVERR: folds=20
Uncalled bet (250) returned to Scooo13zzz
Scooo13zzz collected 920 from pot
*** SUMMARY ***
Total pot 920 | Rake 0=20
Seat 1: SLICK0057 (button) folded before Flop (didn't bet)
Seat 2: BENN DOVERR (small blind) folded before Flop
Seat 3: Scooo13zzz (big blind) collected (920)
Seat 4: bethere1923 folded before Flop (didn't bet)
Seat 7: JJin91 folded before Flop (didn't bet)
Seat 8: YourRobotDad folded before Flop (didn't bet)
Seat 9: 4Aces518 folded before Flop (didn't bet)


*********** # 107 **************
PokerStars Hand #176125417006: Tournament #1701843149, $18.20+$1.80 USD=
 Hold'em No Limit - Level XI (250/500) - 2017/10/09 21:01:30 ET
Table '1701843149 1' 9-max Seat #2 is the button
Seat 1: SLICK0057 (7031 in chips)=20
Seat 2: BENN DOVERR (9070 in chips)=20
Seat 3: Scooo13zzz (20338 in chips)=20
Seat 4: bethere1923 (7551 in chips)=20
Seat 7: JJin91 (21105 in chips)=20
Seat 8: YourRobotDad (23947 in chips)=20
Seat 9: 4Aces518 (37961 in chips)=20
SLICK0057: posts the ante 60
BENN DOVERR: posts the ante 60
Scooo13zzz: posts the ante 60
bethere1923: posts the ante 60
JJin91: posts the ante 60
YourRobotDad: posts the ante 60
4Aces518: posts the ante 60
Scooo13zzz: posts small blind 250
bethere1923: posts big blind 500
*** HOLE CARDS ***
Dealt to JJin91 [5s 2d]
JJin91: folds=20
YourRobotDad: folds=20
4Aces518: folds=20
SLICK0057: calls 500
BENN DOVERR: calls 500
Scooo13zzz: folds=20
bethere1923: checks=20
*** FLOP *** [5h Js 9d]
bethere1923: checks=20
SLICK0057: checks=20
BENN DOVERR: bets 781
bethere1923: folds=20
SLICK0057: calls 781
*** TURN *** [5h Js 9d] [Qs]
SLICK0057: checks=20
BENN DOVERR: bets 1344
SLICK0057: folds=20
Uncalled bet (1344) returned to BENN DOVERR
BENN DOVERR collected 3732 from pot
*** SUMMARY ***
Total pot 3732 | Rake 0=20
Board [5h Js 9d Qs]
Seat 1: SLICK0057 folded on the Turn
Seat 2: BENN DOVERR (button) collected (3732)
Seat 3: Scooo13zzz (small blind) folded before Flop
Seat 4: bethere1923 (big blind) folded on the Flop
Seat 7: JJin91 folded before Flop (didn't bet)
Seat 8: YourRobotDad folded before Flop (didn't bet)
Seat 9: 4Aces518 folded before Flop (didn't bet)


*********** # 108 **************
PokerStars Hand #176125417248: Tournament #1701843149, $18.20+$1.80 USD=
 Hold'em No Limit - Level XII (300/600) - 2017/10/09 21:02:21 ET
Table '1701843149 1' 9-max Seat #3 is the button
Seat 1: SLICK0057 (5690 in chips)=20
Seat 2: BENN DOVERR (11461 in chips)=20
Seat 3: Scooo13zzz (20028 in chips)=20
Seat 4: bethere1923 (6991 in chips)=20
Seat 5: eatthis40 (9458 in chips)=20
Seat 6: xNEMESISx04 (18894 in chips)=20
Seat 7: JJin91 (21045 in chips)=20
Seat 8: YourRobotDad (23887 in chips)=20
Seat 9: 4Aces518 (37901 in chips)=20
SLICK0057: posts the ante 70
BENN DOVERR: posts the ante 70
Scooo13zzz: posts the ante 70
bethere1923: posts the ante 70
eatthis40: posts the ante 70
xNEMESISx04: posts the ante 70
JJin91: posts the ante 70
YourRobotDad: posts the ante 70
4Aces518: posts the ante 70
bethere1923: posts small blind 300
eatthis40: posts big blind 600
*** HOLE CARDS ***
Dealt to JJin91 [Jh Ah]
xNEMESISx04: folds=20
JJin91: raises 702 to 1302
YourRobotDad: folds=20
4Aces518: folds=20
SLICK0057: folds=20
BENN DOVERR: folds=20
Scooo13zzz: calls 1302
bethere1923: folds=20
eatthis40: calls 702
*** FLOP *** [5h 8h Ad]
eatthis40: checks=20
JJin91: checks=20
Scooo13zzz: checks=20
*** TURN *** [5h 8h Ad] [8s]
eatthis40: checks=20
JJin91: checks=20
Scooo13zzz: bets 2176
eatthis40: folds=20
JJin91: raises 3379 to 5555
Scooo13zzz: folds=20
Uncalled bet (3379) returned to JJin91
JJin91 collected 9188 from pot
JJin91: doesn't show hand=20
*** SUMMARY ***
Total pot 9188 | Rake 0=20
Board [5h 8h Ad 8s]
Seat 1: SLICK0057 folded before Flop (didn't bet)
Seat 2: BENN DOVERR folded before Flop (didn't bet)
Seat 3: Scooo13zzz (button) folded on the Turn
Seat 4: bethere1923 (small blind) folded before Flop
Seat 5: eatthis40 (big blind) folded on the Turn
Seat 6: xNEMESISx04 folded before Flop (didn't bet)
Seat 7: JJin91 collected (9188)
Seat 8: YourRobotDad folded before Flop (didn't bet)
Seat 9: 4Aces518 folded before Flop (didn't bet)


*********** # 109 **************
PokerStars Hand #176125417657: Tournament #1701843149, $18.20+$1.80 USD=
 Hold'em No Limit - Level XII (300/600) - 2017/10/09 21:03:40 ET
Table '1701843149 1' 9-max Seat #4 is the button
Seat 1: SLICK0057 (5620 in chips)=20
Seat 2: BENN DOVERR (11391 in chips)=20
Seat 3: Scooo13zzz (16480 in chips)=20
Seat 4: bethere1923 (6621 in chips)=20
Seat 5: eatthis40 (8086 in chips)=20
Seat 6: xNEMESISx04 (18824 in chips)=20
Seat 7: JJin91 (26685 in chips)=20
Seat 8: YourRobotDad (23817 in chips)=20
Seat 9: 4Aces518 (37831 in chips)=20
SLICK0057: posts the ante 70
BENN DOVERR: posts the ante 70
Scooo13zzz: posts the ante 70
bethere1923: posts the ante 70
eatthis40: posts the ante 70
xNEMESISx04: posts the ante 70
JJin91: posts the ante 70
YourRobotDad: posts the ante 70
4Aces518: posts the ante 70
eatthis40: posts small blind 300
xNEMESISx04: posts big blind 600
*** HOLE CARDS ***
Dealt to JJin91 [7h 9h]
JJin91: folds=20
YourRobotDad: folds=20
4Aces518: calls 600
SLICK0057: calls 600
BENN DOVERR: folds=20
Scooo13zzz: folds=20
bethere1923: folds=20
eatthis40: calls 300
xNEMESISx04: checks=20
*** FLOP *** [3h 3s Kd]
eatthis40: checks=20
xNEMESISx04: checks=20
4Aces518: checks=20
SLICK0057: checks=20
*** TURN *** [3h 3s Kd] [2h]
eatthis40: bets 7416 and is all-in
xNEMESISx04: folds=20
4Aces518: folds=20
SLICK0057: folds=20
Uncalled bet (7416) returned to eatthis40
eatthis40 collected 3030 from pot
eatthis40: doesn't show hand=20
*** SUMMARY ***
Total pot 3030 | Rake 0=20
Board [3h 3s Kd 2h]
Seat 1: SLICK0057 folded on the Turn
Seat 2: BENN DOVERR folded before Flop (didn't bet)
Seat 3: Scooo13zzz folded before Flop (didn't bet)
Seat 4: bethere1923 (button) folded before Flop (didn't bet)
Seat 5: eatthis40 (small blind) collected (3030)
Seat 6: xNEMESISx04 (big blind) folded on the Turn
Seat 7: JJin91 folded before Flop (didn't bet)
Seat 8: YourRobotDad folded before Flop (didn't bet)
Seat 9: 4Aces518 folded on the Turn


*********** # 110 **************
PokerStars Hand #176125417988: Tournament #1701843149, $18.20+$1.80 USD=
 Hold'em No Limit - Level XII (300/600) - 2017/10/09 21:04:41 ET
Table '1701843149 1' 9-max Seat #5 is the button
Seat 1: SLICK0057 (4950 in chips)=20
Seat 2: BENN DOVERR (11321 in chips)=20
Seat 3: Scooo13zzz (16410 in chips)=20
Seat 4: bethere1923 (6551 in chips)=20
Seat 5: eatthis40 (10446 in chips)=20
Seat 6: xNEMESISx04 (18154 in chips)=20
Seat 7: JJin91 (26615 in chips)=20
Seat 8: YourRobotDad (23747 in chips)=20
Seat 9: 4Aces518 (37161 in chips)=20
SLICK0057: posts the ante 70
BENN DOVERR: posts the ante 70
Scooo13zzz: posts the ante 70
bethere1923: posts the ante 70
eatthis40: posts the ante 70
xNEMESISx04: posts the ante 70
JJin91: posts the ante 70
YourRobotDad: posts the ante 70
4Aces518: posts the ante 70
xNEMESISx04: posts small blind 300
JJin91: posts big blind 600
*** HOLE CARDS ***
Dealt to JJin91 [Jd Kd]
YourRobotDad: folds=20
4Aces518: folds=20
SLICK0057: raises 1200 to 1800
BENN DOVERR: folds=20
Scooo13zzz: folds=20
bethere1923: folds=20
eatthis40: folds=20
xNEMESISx04: folds=20
JJin91: calls 1200
*** FLOP *** [9c 4d Ad]
JJin91: bets 24745 and is all-in
SLICK0057: calls 3080 and is all-in
Uncalled bet (21665) returned to JJin91
*** TURN *** [9c 4d Ad] [Ts]
*** RIVER *** [9c 4d Ad Ts] [9d]
*** SHOW DOWN ***
JJin91: shows [Jd Kd] (a flush, Ace high)
SLICK0057: shows [As Ks] (two pair, Aces and Nines)
JJin91 collected 10690 from pot
SLICK0057 finished the tournament in 61st place
*** SUMMARY ***
Total pot 10690 | Rake 0=20
Board [9c 4d Ad Ts 9d]
Seat 1: SLICK0057 showed [As Ks] and lost with two pair, Aces and Nines
Seat 2: BENN DOVERR folded before Flop (didn't bet)
Seat 3: Scooo13zzz folded before Flop (didn't bet)
Seat 4: bethere1923 folded before Flop (didn't bet)
Seat 5: eatthis40 (button) folded before Flop (didn't bet)
Seat 6: xNEMESISx04 (small blind) folded before Flop
Seat 7: JJin91 (big blind) showed [Jd Kd] and won (10690) with a flush,=
 Ace high
Seat 8: YourRobotDad folded before Flop (didn't bet)
Seat 9: 4Aces518 folded before Flop (didn't bet)


*********** # 111 **************
PokerStars Hand #176125418187: Tournament #1701843149, $18.20+$1.80 USD=
 Hold'em No Limit - Level XII (300/600) - 2017/10/09 21:05:20 ET
Table '1701843149 1' 9-max Seat #6 is the button
Seat 2: BENN DOVERR (11251 in chips)=20
Seat 3: Scooo13zzz (16340 in chips)=20
Seat 4: bethere1923 (6481 in chips)=20
Seat 5: eatthis40 (10376 in chips)=20
Seat 6: xNEMESISx04 (17784 in chips)=20
Seat 7: JJin91 (32355 in chips)=20
Seat 8: YourRobotDad (23677 in chips)=20
Seat 9: 4Aces518 (37091 in chips)=20
BENN DOVERR: posts the ante 70
Scooo13zzz: posts the ante 70
bethere1923: posts the ante 70
eatthis40: posts the ante 70
xNEMESISx04: posts the ante 70
JJin91: posts the ante 70
YourRobotDad: posts the ante 70
4Aces518: posts the ante 70
JJin91: posts small blind 300
YourRobotDad: posts big blind 600
*** HOLE CARDS ***
Dealt to JJin91 [6c 8d]
4Aces518: folds=20
BENN DOVERR: folds=20
Scooo13zzz: folds=20
bethere1923: folds=20
eatthis40: folds=20
xNEMESISx04: folds=20
JJin91: folds=20
Uncalled bet (300) returned to YourRobotDad
YourRobotDad collected 1160 from pot
*** SUMMARY ***
Total pot 1160 | Rake 0=20
Seat 2: BENN DOVERR folded before Flop (didn't bet)
Seat 3: Scooo13zzz folded before Flop (didn't bet)
Seat 4: bethere1923 folded before Flop (didn't bet)
Seat 5: eatthis40 folded before Flop (didn't bet)
Seat 6: xNEMESISx04 (button) folded before Flop (didn't bet)
Seat 7: JJin91 (small blind) folded before Flop
Seat 8: YourRobotDad (big blind) collected (1160)
Seat 9: 4Aces518 folded before Flop (didn't bet)


*********** # 112 **************
PokerStars Hand #176125418339: Tournament #1701843149, $18.20+$1.80 USD=
 Hold'em No Limit - Level XII (300/600) - 2017/10/09 21:05:49 ET
Table '1701843149 1' 9-max Seat #7 is the button
Seat 2: BENN DOVERR (11181 in chips)=20
Seat 3: Scooo13zzz (16270 in chips)=20
Seat 4: bethere1923 (6411 in chips)=20
Seat 5: eatthis40 (10306 in chips)=20
Seat 6: xNEMESISx04 (17714 in chips)=20
Seat 7: JJin91 (31985 in chips)=20
Seat 8: YourRobotDad (24467 in chips)=20
Seat 9: 4Aces518 (37021 in chips)=20
BENN DOVERR: posts the ante 70
Scooo13zzz: posts the ante 70
bethere1923: posts the ante 70
eatthis40: posts the ante 70
xNEMESISx04: posts the ante 70
JJin91: posts the ante 70
YourRobotDad: posts the ante 70
4Aces518: posts the ante 70
YourRobotDad: posts small blind 300
4Aces518: posts big blind 600
*** HOLE CARDS ***
Dealt to JJin91 [Ks 2c]
BENN DOVERR: folds=20
Scooo13zzz: folds=20
bethere1923: folds=20
eatthis40: calls 600
xNEMESISx04: raises 1200 to 1800
JJin91: folds=20
YourRobotDad: folds=20
4Aces518: folds=20
eatthis40: calls 1200
*** FLOP *** [8d Kh Js]
eatthis40: checks=20
xNEMESISx04: checks=20
*** TURN *** [8d Kh Js] [3d]
eatthis40: checks=20
xNEMESISx04: checks=20
*** RIVER *** [8d Kh Js 3d] [Jh]
eatthis40: bets 8436 and is all-in
xNEMESISx04: folds=20
Uncalled bet (8436) returned to eatthis40
eatthis40 collected 5060 from pot
eatthis40: doesn't show hand=20
*** SUMMARY ***
Total pot 5060 | Rake 0=20
Board [8d Kh Js 3d Jh]
Seat 2: BENN DOVERR folded before Flop (didn't bet)
Seat 3: Scooo13zzz folded before Flop (didn't bet)
Seat 4: bethere1923 folded before Flop (didn't bet)
Seat 5: eatthis40 collected (5060)
Seat 6: xNEMESISx04 folded on the River
Seat 7: JJin91 (button) folded before Flop (didn't bet)
Seat 8: YourRobotDad (small blind) folded before Flop
Seat 9: 4Aces518 (big blind) folded before Flop


*********** # 113 **************
PokerStars Hand #176125418628: Tournament #1701843149, $18.20+$1.80 USD=
 Hold'em No Limit - Level XII (300/600) - 2017/10/09 21:06:45 ET
Table '1701843149 1' 9-max Seat #8 is the button
Seat 2: BENN DOVERR (11111 in chips)=20
Seat 3: Scooo13zzz (16200 in chips)=20
Seat 4: bethere1923 (6341 in chips)=20
Seat 5: eatthis40 (13496 in chips)=20
Seat 6: xNEMESISx04 (15844 in chips)=20
Seat 7: JJin91 (31915 in chips)=20
Seat 8: YourRobotDad (24097 in chips)=20
Seat 9: 4Aces518 (36351 in chips)=20
BENN DOVERR: posts the ante 70
Scooo13zzz: posts the ante 70
bethere1923: posts the ante 70
eatthis40: posts the ante 70
xNEMESISx04: posts the ante 70
JJin91: posts the ante 70
YourRobotDad: posts the ante 70
4Aces518: posts the ante 70
4Aces518: posts small blind 300
BENN DOVERR: posts big blind 600
*** HOLE CARDS ***
Dealt to JJin91 [Ts 6c]
Scooo13zzz: folds=20
bethere1923: raises 5671 to 6271 and is all-in
eatthis40: folds=20
xNEMESISx04: folds=20
JJin91: folds=20
YourRobotDad: folds=20
4Aces518: folds=20
BENN DOVERR: folds=20
Uncalled bet (5671) returned to bethere1923
bethere1923 collected 2060 from pot
*** SUMMARY ***
Total pot 2060 | Rake 0=20
Seat 2: BENN DOVERR (big blind) folded before Flop
Seat 3: Scooo13zzz folded before Flop (didn't bet)
Seat 4: bethere1923 collected (2060)
Seat 5: eatthis40 folded before Flop (didn't bet)
Seat 6: xNEMESISx04 folded before Flop (didn't bet)
Seat 7: JJin91 folded before Flop (didn't bet)
Seat 8: YourRobotDad (button) folded before Flop (didn't bet)
Seat 9: 4Aces518 (small blind) folded before Flop


*********** # 114 **************
PokerStars Hand #176125418795: Tournament #1701843149, $18.20+$1.80 USD=
 Hold'em No Limit - Level XII (300/600) - 2017/10/09 21:07:15 ET
Table '1701843149 1' 9-max Seat #9 is the button
Seat 2: BENN DOVERR (10441 in chips)=20
Seat 3: Scooo13zzz (16130 in chips)=20
Seat 4: bethere1923 (7731 in chips)=20
Seat 5: eatthis40 (13426 in chips)=20
Seat 6: xNEMESISx04 (15774 in chips)=20
Seat 7: JJin91 (31845 in chips)=20
Seat 8: YourRobotDad (24027 in chips)=20
Seat 9: 4Aces518 (35981 in chips)=20
BENN DOVERR: posts the ante 70
Scooo13zzz: posts the ante 70
bethere1923: posts the ante 70
eatthis40: posts the ante 70
xNEMESISx04: posts the ante 70
JJin91: posts the ante 70
YourRobotDad: posts the ante 70
4Aces518: posts the ante 70
BENN DOVERR: posts small blind 300
Scooo13zzz: posts big blind 600
*** HOLE CARDS ***
Dealt to JJin91 [Ts 3h]
bethere1923: raises 7061 to 7661 and is all-in
eatthis40: calls 7661
xNEMESISx04: folds=20
JJin91: folds=20
YourRobotDad: folds=20
4Aces518: folds=20
BENN DOVERR: folds=20
Scooo13zzz: folds=20
*** FLOP *** [Jh Kc Kh]
*** TURN *** [Jh Kc Kh] [Ah]
*** RIVER *** [Jh Kc Kh Ah] [Ad]
*** SHOW DOWN ***
bethere1923: shows [Js Jc] (a full house, Jacks full of Aces)
eatthis40: shows [6d 6c] (two pair, Aces and Kings)
bethere1923 collected 16782 from pot
*** SUMMARY ***
Total pot 16782 | Rake 0=20
Board [Jh Kc Kh Ah Ad]
Seat 2: BENN DOVERR (small blind) folded before Flop
Seat 3: Scooo13zzz (big blind) folded before Flop
Seat 4: bethere1923 showed [Js Jc] and won (16782) with a full house, J=
acks full of Aces
Seat 5: eatthis40 showed [6d 6c] and lost with two pair, Aces and Kings
Seat 6: xNEMESISx04 folded before Flop (didn't bet)
Seat 7: JJin91 folded before Flop (didn't bet)
Seat 8: YourRobotDad folded before Flop (didn't bet)
Seat 9: 4Aces518 (button) folded before Flop (didn't bet)


*********** # 115 **************
PokerStars Hand #176125418959: Tournament #1701843149, $18.20+$1.80 USD=
 Hold'em No Limit - Level XII (300/600) - 2017/10/09 21:07:43 ET
Table '1701843149 1' 9-max Seat #2 is the button
Seat 2: BENN DOVERR (10071 in chips)=20
Seat 3: Scooo13zzz (15460 in chips)=20
Seat 4: bethere1923 (16782 in chips)=20
Seat 5: eatthis40 (5695 in chips)=20
Seat 6: xNEMESISx04 (15704 in chips)=20
Seat 7: JJin91 (31775 in chips)=20
Seat 8: YourRobotDad (23957 in chips)=20
Seat 9: 4Aces518 (35911 in chips)=20
BENN DOVERR: posts the ante 70
Scooo13zzz: posts the ante 70
bethere1923: posts the ante 70
eatthis40: posts the ante 70
xNEMESISx04: posts the ante 70
JJin91: posts the ante 70
YourRobotDad: posts the ante 70
4Aces518: posts the ante 70
Scooo13zzz: posts small blind 300
bethere1923: posts big blind 600
*** HOLE CARDS ***
Dealt to JJin91 [5c Js]
eatthis40: folds=20
xNEMESISx04: folds=20
JJin91: folds=20
YourRobotDad: folds=20
4Aces518: calls 600
BENN DOVERR: folds=20
Scooo13zzz: calls 300
bethere1923: raises 1655 to 2255
4Aces518: folds=20
Scooo13zzz: calls 1655
*** FLOP *** [4c Kd 8s]
Scooo13zzz: checks=20
bethere1923: bets 2255
Scooo13zzz: calls 2255
*** TURN *** [4c Kd 8s] [Ac]
Scooo13zzz: checks=20
bethere1923: bets 12202 and is all-in
Scooo13zzz: calls 10880 and is all-in
Uncalled bet (1322) returned to bethere1923
*** RIVER *** [4c Kd 8s Ac] [6s]
*** SHOW DOWN ***
Scooo13zzz: shows [8c 8d] (three of a kind, Eights)
bethere1923: shows [Qs Ad] (a pair of Aces)
Scooo13zzz collected 31940 from pot
*** SUMMARY ***
Total pot 31940 | Rake 0=20
Board [4c Kd 8s Ac 6s]
Seat 2: BENN DOVERR (button) folded before Flop (didn't bet)
Seat 3: Scooo13zzz (small blind) showed [8c 8d] and won (31940) with th=
ree of a kind, Eights
Seat 4: bethere1923 (big blind) showed [Qs Ad] and lost with a pair of =
Aces
Seat 5: eatthis40 folded before Flop (didn't bet)
Seat 6: xNEMESISx04 folded before Flop (didn't bet)
Seat 7: JJin91 folded before Flop (didn't bet)
Seat 8: YourRobotDad folded before Flop (didn't bet)
Seat 9: 4Aces518 folded before Flop


*********** # 116 **************
PokerStars Hand #176125419396: Tournament #1701843149, $18.20+$1.80 USD=
 Hold'em No Limit - Level XII (300/600) - 2017/10/09 21:09:07 ET
Table '1701843149 1' 9-max Seat #3 is the button
Seat 2: BENN DOVERR (10001 in chips)=20
Seat 3: Scooo13zzz (31940 in chips)=20
Seat 4: bethere1923 (1322 in chips)=20
Seat 5: eatthis40 (5625 in chips)=20
Seat 6: xNEMESISx04 (15634 in chips)=20
Seat 7: JJin91 (31705 in chips)=20
Seat 8: YourRobotDad (23887 in chips)=20
Seat 9: 4Aces518 (35241 in chips)=20
BENN DOVERR: posts the ante 70
Scooo13zzz: posts the ante 70
bethere1923: posts the ante 70
eatthis40: posts the ante 70
xNEMESISx04: posts the ante 70
JJin91: posts the ante 70
YourRobotDad: posts the ante 70
4Aces518: posts the ante 70
bethere1923: posts small blind 300
eatthis40: posts big blind 600
*** HOLE CARDS ***
Dealt to JJin91 [9c Kc]
xNEMESISx04: folds=20
JJin91: folds=20
YourRobotDad: folds=20
4Aces518: folds=20
BENN DOVERR: folds=20
Scooo13zzz: raises 600 to 1200
bethere1923: raises 52 to 1252 and is all-in
eatthis40: calls 652
Scooo13zzz: calls 52
*** FLOP *** [9d Th 6h]
eatthis40: checks=20
Scooo13zzz: checks=20
*** TURN *** [9d Th 6h] [Ts]
eatthis40: checks=20
Scooo13zzz: checks=20
*** RIVER *** [9d Th 6h Ts] [2s]
eatthis40: checks=20
Scooo13zzz: checks=20
*** SHOW DOWN ***
bethere1923: shows [2h 2c] (a full house, Deuces full of Tens)
eatthis40: mucks hand=20
Scooo13zzz: mucks hand=20
bethere1923 collected 4316 from pot
*** SUMMARY ***
Total pot 4316 | Rake 0=20
Board [9d Th 6h Ts 2s]
Seat 2: BENN DOVERR folded before Flop (didn't bet)
Seat 3: Scooo13zzz (button) mucked [As Jc]
Seat 4: bethere1923 (small blind) showed [2h 2c] and won (4316) with a =
full house, Deuces full of Tens
Seat 5: eatthis40 (big blind) mucked [8c 2d]
Seat 6: xNEMESISx04 folded before Flop (didn't bet)
Seat 7: JJin91 folded before Flop (didn't bet)
Seat 8: YourRobotDad folded before Flop (didn't bet)
Seat 9: 4Aces518 folded before Flop (didn't bet)


*********** # 117 **************
PokerStars Hand #176125419940: Tournament #1701843149, $18.20+$1.80 USD=
 Hold'em No Limit - Level XII (300/600) - 2017/10/09 21:10:48 ET
Table '1701843149 1' 9-max Seat #4 is the button
Seat 2: BENN DOVERR (9931 in chips)=20
Seat 3: Scooo13zzz (30618 in chips)=20
Seat 4: bethere1923 (4316 in chips)=20
Seat 5: eatthis40 (4303 in chips)=20
Seat 6: xNEMESISx04 (15564 in chips)=20
Seat 7: JJin91 (31635 in chips)=20
Seat 8: YourRobotDad (23817 in chips)=20
Seat 9: 4Aces518 (35171 in chips)=20
BENN DOVERR: posts the ante 70
Scooo13zzz: posts the ante 70
bethere1923: posts the ante 70
eatthis40: posts the ante 70
xNEMESISx04: posts the ante 70
JJin91: posts the ante 70
YourRobotDad: posts the ante 70
4Aces518: posts the ante 70
eatthis40: posts small blind 300
xNEMESISx04: posts big blind 600
*** HOLE CARDS ***
Dealt to JJin91 [3h Kd]
JJin91: folds=20
YourRobotDad: folds=20
4Aces518: folds=20
BENN DOVERR: folds=20
Scooo13zzz: folds=20
bethere1923: raises 3646 to 4246 and is all-in
eatthis40: folds=20
xNEMESISx04: folds=20
Uncalled bet (3646) returned to bethere1923
bethere1923 collected 2060 from pot
*** SUMMARY ***
Total pot 2060 | Rake 0=20
Seat 2: BENN DOVERR folded before Flop (didn't bet)
Seat 3: Scooo13zzz folded before Flop (didn't bet)
Seat 4: bethere1923 (button) collected (2060)
Seat 5: eatthis40 (small blind) folded before Flop
Seat 6: xNEMESISx04 (big blind) folded before Flop
Seat 7: JJin91 folded before Flop (didn't bet)
Seat 8: YourRobotDad folded before Flop (didn't bet)
Seat 9: 4Aces518 folded before Flop (didn't bet)


*********** # 118 **************
PokerStars Hand #176126167472: Tournament #1701843149, $18.20+$1.80 USD=
 Hold'em No Limit - Level XII (300/600) - 2017/10/09 21:11:13 ET
Table '1701843149 1' 9-max Seat #5 is the button
Seat 2: BENN DOVERR (9861 in chips)=20
Seat 3: Scooo13zzz (30548 in chips)=20
Seat 4: bethere1923 (5706 in chips)=20
Seat 5: eatthis40 (3933 in chips)=20
Seat 6: xNEMESISx04 (14894 in chips)=20
Seat 7: JJin91 (31565 in chips)=20
Seat 8: YourRobotDad (23747 in chips)=20
Seat 9: 4Aces518 (35101 in chips)=20
BENN DOVERR: posts the ante 70
Scooo13zzz: posts the ante 70
bethere1923: posts the ante 70
eatthis40: posts the ante 70
xNEMESISx04: posts the ante 70
JJin91: posts the ante 70
YourRobotDad: posts the ante 70
4Aces518: posts the ante 70
xNEMESISx04: posts small blind 300
JJin91: posts big blind 600
*** HOLE CARDS ***
Dealt to JJin91 [Ad Tc]
YourRobotDad: folds=20
4Aces518: calls 600
BENN DOVERR: folds=20
Scooo13zzz: raises 900 to 1500
bethere1923: folds=20
eatthis40: raises 2363 to 3863 and is all-in
xNEMESISx04: folds=20
JJin91: folds=20
4Aces518: folds=20
Scooo13zzz: calls 2363
*** FLOP *** [4d Td 7s]
*** TURN *** [4d Td 7s] [Kh]
*** RIVER *** [4d Td 7s Kh] [5h]
*** SHOW DOWN ***
Scooo13zzz: shows [Kc Qd] (a pair of Kings)
eatthis40: shows [Qc Jh] (high card King)
Scooo13zzz collected 9786 from pot
eatthis40 finished the tournament in 57th place
*** SUMMARY ***
Total pot 9786 | Rake 0=20
Board [4d Td 7s Kh 5h]
Seat 2: BENN DOVERR folded before Flop (didn't bet)
Seat 3: Scooo13zzz showed [Kc Qd] and won (9786) with a pair of Kings
Seat 4: bethere1923 folded before Flop (didn't bet)
Seat 5: eatthis40 (button) showed [Qc Jh] and lost with high card King
Seat 6: xNEMESISx04 (small blind) folded before Flop
Seat 7: JJin91 (big blind) folded before Flop
Seat 8: YourRobotDad folded before Flop (didn't bet)
Seat 9: 4Aces518 folded before Flop


*********** # 119 **************
PokerStars Hand #176126167679: Tournament #1701843149, $18.20+$1.80 USD=
 Hold'em No Limit - Level XII (300/600) - 2017/10/09 21:11:50 ET
Table '1701843149 1' 9-max Seat #6 is the button
Seat 2: BENN DOVERR (9791 in chips)=20
Seat 3: Scooo13zzz (36401 in chips)=20
Seat 4: bethere1923 (5636 in chips)=20
Seat 6: xNEMESISx04 (14524 in chips)=20
Seat 7: JJin91 (30895 in chips)=20
Seat 8: YourRobotDad (23677 in chips)=20
Seat 9: 4Aces518 (34431 in chips)=20
BENN DOVERR: posts the ante 70
Scooo13zzz: posts the ante 70
bethere1923: posts the ante 70
xNEMESISx04: posts the ante 70
JJin91: posts the ante 70
YourRobotDad: posts the ante 70
4Aces518: posts the ante 70
JJin91: posts small blind 300
YourRobotDad: posts big blind 600
*** HOLE CARDS ***
Dealt to JJin91 [9c 7d]
4Aces518: folds=20
BENN DOVERR: folds=20
Scooo13zzz: raises 720 to 1320
bethere1923: folds=20
xNEMESISx04: raises 2880 to 4200
JJin91: folds=20
YourRobotDad: folds=20
Scooo13zzz: folds=20
Uncalled bet (2880) returned to xNEMESISx04
xNEMESISx04 collected 4030 from pot
xNEMESISx04: doesn't show hand=20
*** SUMMARY ***
Total pot 4030 | Rake 0=20
Seat 2: BENN DOVERR folded before Flop (didn't bet)
Seat 3: Scooo13zzz folded before Flop
Seat 4: bethere1923 folded before Flop (didn't bet)
Seat 6: xNEMESISx04 (button) collected (4030)
Seat 7: JJin91 (small blind) folded before Flop
Seat 8: YourRobotDad (big blind) folded before Flop
Seat 9: 4Aces518 folded before Flop (didn't bet)


*********** # 120 **************
PokerStars Hand #176126167892: Tournament #1701843149, $18.20+$1.80 USD=
 Hold'em No Limit - Level XIII (350/700) - 2017/10/09 21:12:28 ET
Table '1701843149 1' 9-max Seat #7 is the button
Seat 2: BENN DOVERR (9721 in chips)=20
Seat 3: Scooo13zzz (35011 in chips)=20
Seat 4: bethere1923 (5566 in chips)=20
Seat 6: xNEMESISx04 (17164 in chips)=20
Seat 7: JJin91 (30525 in chips)=20
Seat 8: YourRobotDad (23007 in chips)=20
Seat 9: 4Aces518 (34361 in chips)=20
BENN DOVERR: posts the ante 85
Scooo13zzz: posts the ante 85
bethere1923: posts the ante 85
xNEMESISx04: posts the ante 85
JJin91: posts the ante 85
YourRobotDad: posts the ante 85
4Aces518: posts the ante 85
YourRobotDad: posts small blind 350
4Aces518: posts big blind 700
*** HOLE CARDS ***
Dealt to JJin91 [Jc Th]
BENN DOVERR: folds=20
Scooo13zzz: folds=20
bethere1923: folds=20
xNEMESISx04: folds=20
JJin91: folds=20
YourRobotDad: calls 350
4Aces518: checks=20
*** FLOP *** [3h Ah 3c]
YourRobotDad: checks=20
4Aces518: checks=20
*** TURN *** [3h Ah 3c] [Tc]
YourRobotDad: checks=20
4Aces518: checks=20
*** RIVER *** [3h Ah 3c Tc] [6h]
YourRobotDad: bets 700
4Aces518: calls 700
*** SHOW DOWN ***
YourRobotDad: shows [9c Ad] (two pair, Aces and Threes)
4Aces518: mucks hand=20
YourRobotDad collected 3395 from pot
*** SUMMARY ***
Total pot 3395 | Rake 0=20
Board [3h Ah 3c Tc 6h]
Seat 2: BENN DOVERR folded before Flop (didn't bet)
Seat 3: Scooo13zzz folded before Flop (didn't bet)
Seat 4: bethere1923 folded before Flop (didn't bet)
Seat 6: xNEMESISx04 folded before Flop (didn't bet)
Seat 7: JJin91 (button) folded before Flop (didn't bet)
Seat 8: YourRobotDad (small blind) showed [9c Ad] and won (3395) with t=
wo pair, Aces and Threes
Seat 9: 4Aces518 (big blind) mucked [Kh Ts]


*********** # 121 **************
PokerStars Hand #176126168088: Tournament #1701843149, $18.20+$1.80 USD=
 Hold'em No Limit - Level XIII (350/700) - 2017/10/09 21:13:05 ET
Table '1701843149 1' 9-max Seat #8 is the button
Seat 1: Paceman2jr (33627 in chips)=20
Seat 2: BENN DOVERR (9636 in chips)=20
Seat 3: Scooo13zzz (34926 in chips)=20
Seat 4: bethere1923 (5481 in chips)=20
Seat 5: SJMayhem11 (20925 in chips)=20
Seat 6: xNEMESISx04 (17079 in chips)=20
Seat 7: JJin91 (30440 in chips)=20
Seat 8: YourRobotDad (24917 in chips)=20
Seat 9: 4Aces518 (32876 in chips)=20
Paceman2jr: posts the ante 85
BENN DOVERR: posts the ante 85
Scooo13zzz: posts the ante 85
bethere1923: posts the ante 85
SJMayhem11: posts the ante 85
xNEMESISx04: posts the ante 85
JJin91: posts the ante 85
YourRobotDad: posts the ante 85
4Aces518: posts the ante 85
4Aces518: posts small blind 350
Paceman2jr: posts big blind 700
*** HOLE CARDS ***
Dealt to JJin91 [8d 3d]
BENN DOVERR: folds=20
Scooo13zzz: folds=20
bethere1923: raises 4696 to 5396 and is all-in
SJMayhem11: folds=20
xNEMESISx04: folds=20
JJin91: folds=20
YourRobotDad: folds=20
4Aces518: folds=20
Paceman2jr: folds=20
Uncalled bet (4696) returned to bethere1923
bethere1923 collected 2515 from pot
*** SUMMARY ***
Total pot 2515 | Rake 0=20
Seat 1: Paceman2jr (big blind) folded before Flop
Seat 2: BENN DOVERR folded before Flop (didn't bet)
Seat 3: Scooo13zzz folded before Flop (didn't bet)
Seat 4: bethere1923 collected (2515)
Seat 5: SJMayhem11 folded before Flop (didn't bet)
Seat 6: xNEMESISx04 folded before Flop (didn't bet)
Seat 7: JJin91 folded before Flop (didn't bet)
Seat 8: YourRobotDad (button) folded before Flop (didn't bet)
Seat 9: 4Aces518 (small blind) folded before Flop


*********** # 122 **************
PokerStars Hand #176126168214: Tournament #1701843149, $18.20+$1.80 USD=
 Hold'em No Limit - Level XIII (350/700) - 2017/10/09 21:13:26 ET
Table '1701843149 1' 9-max Seat #9 is the button
Seat 1: Paceman2jr (32842 in chips)=20
Seat 2: BENN DOVERR (9551 in chips)=20
Seat 3: Scooo13zzz (34841 in chips)=20
Seat 4: bethere1923 (7211 in chips)=20
Seat 5: SJMayhem11 (20840 in chips)=20
Seat 6: xNEMESISx04 (16994 in chips)=20
Seat 7: JJin91 (30355 in chips)=20
Seat 8: YourRobotDad (24832 in chips)=20
Seat 9: 4Aces518 (32441 in chips)=20
Paceman2jr: posts the ante 85
BENN DOVERR: posts the ante 85
Scooo13zzz: posts the ante 85
bethere1923: posts the ante 85
SJMayhem11: posts the ante 85
xNEMESISx04: posts the ante 85
JJin91: posts the ante 85
YourRobotDad: posts the ante 85
4Aces518: posts the ante 85
Paceman2jr: posts small blind 350
BENN DOVERR: posts big blind 700
*** HOLE CARDS ***
Dealt to JJin91 [7h 2c]
Scooo13zzz: folds=20
bethere1923: folds=20
SJMayhem11: folds=20
xNEMESISx04: folds=20
JJin91: folds=20
YourRobotDad: folds=20
4Aces518: folds=20
Paceman2jr: raises 32057 to 32757 and is all-in
BENN DOVERR: folds=20
Uncalled bet (32057) returned to Paceman2jr
Paceman2jr collected 2165 from pot
Paceman2jr: doesn't show hand=20
*** SUMMARY ***
Total pot 2165 | Rake 0=20
Seat 1: Paceman2jr (small blind) collected (2165)
Seat 2: BENN DOVERR (big blind) folded before Flop
Seat 3: Scooo13zzz folded before Flop (didn't bet)
Seat 4: bethere1923 folded before Flop (didn't bet)
Seat 5: SJMayhem11 folded before Flop (didn't bet)
Seat 6: xNEMESISx04 folded before Flop (didn't bet)
Seat 7: JJin91 folded before Flop (didn't bet)
Seat 8: YourRobotDad folded before Flop (didn't bet)
Seat 9: 4Aces518 (button) folded before Flop (didn't bet)


*********** # 123 **************
PokerStars Hand #176126168422: Tournament #1701843149, $18.20+$1.80 USD=
 Hold'em No Limit - Level XIII (350/700) - 2017/10/09 21:14:06 ET
Table '1701843149 1' 9-max Seat #1 is the button
Seat 1: Paceman2jr (34222 in chips)=20
Seat 2: BENN DOVERR (8766 in chips)=20
Seat 3: Scooo13zzz (34756 in chips)=20
Seat 4: bethere1923 (7126 in chips)=20
Seat 5: SJMayhem11 (20755 in chips)=20
Seat 6: xNEMESISx04 (16909 in chips)=20
Seat 7: JJin91 (30270 in chips)=20
Seat 8: YourRobotDad (24747 in chips)=20
Seat 9: 4Aces518 (32356 in chips)=20
Paceman2jr: posts the ante 85
BENN DOVERR: posts the ante 85
Scooo13zzz: posts the ante 85
bethere1923: posts the ante 85
SJMayhem11: posts the ante 85
xNEMESISx04: posts the ante 85
JJin91: posts the ante 85
YourRobotDad: posts the ante 85
4Aces518: posts the ante 85
BENN DOVERR: posts small blind 350
Scooo13zzz: posts big blind 700
*** HOLE CARDS ***
Dealt to JJin91 [Qh Qd]
bethere1923: folds=20
SJMayhem11: raises 1400 to 2100
xNEMESISx04: folds=20
JJin91: calls 2100
YourRobotDad: folds=20
4Aces518: calls 2100
Paceman2jr: folds=20
BENN DOVERR: folds=20
Scooo13zzz: folds=20
*** FLOP *** [7h Qs 9h]
SJMayhem11: bets 4058
JJin91: calls 4058
4Aces518: calls 4058
*** TURN *** [7h Qs 9h] [6s]
SJMayhem11: checks=20
JJin91: bets 10347
4Aces518: calls 10347
SJMayhem11: folds=20
*** RIVER *** [7h Qs 9h 6s] [2c]
JJin91: bets 13680 and is all-in
4Aces518: calls 13680
*** SHOW DOWN ***
JJin91: shows [Qh Qd] (three of a kind, Queens)
4Aces518: shows [As Qc] (a pair of Queens)
JJin91 collected 68343 from pot
*** SUMMARY ***
Total pot 68343 | Rake 0=20
Board [7h Qs 9h 6s 2c]
Seat 1: Paceman2jr (button) folded before Flop (didn't bet)
Seat 2: BENN DOVERR (small blind) folded before Flop
Seat 3: Scooo13zzz (big blind) folded before Flop
Seat 4: bethere1923 folded before Flop (didn't bet)
Seat 5: SJMayhem11 folded on the Turn
Seat 6: xNEMESISx04 folded before Flop (didn't bet)
Seat 7: JJin91 showed [Qh Qd] and won (68343) with three of a kind, Que=
ens
Seat 8: YourRobotDad folded before Flop (didn't bet)
Seat 9: 4Aces518 showed [As Qc] and lost with a pair of Queens


*********** # 124 **************
PokerStars Hand #176126168784: Tournament #1701843149, $18.20+$1.80 USD=
 Hold'em No Limit - Level XIII (350/700) - 2017/10/09 21:15:22 ET
Table '1701843149 1' 9-max Seat #2 is the button
Seat 1: Paceman2jr (34137 in chips)=20
Seat 2: BENN DOVERR (8331 in chips)=20
Seat 3: Scooo13zzz (33971 in chips)=20
Seat 4: bethere1923 (7041 in chips)=20
Seat 5: SJMayhem11 (14512 in chips)=20
Seat 6: xNEMESISx04 (16824 in chips)=20
Seat 7: JJin91 (68343 in chips)=20
Seat 8: YourRobotDad (24662 in chips)=20
Seat 9: 4Aces518 (2086 in chips)=20
Paceman2jr: posts the ante 85
BENN DOVERR: posts the ante 85
Scooo13zzz: posts the ante 85
bethere1923: posts the ante 85
SJMayhem11: posts the ante 85
xNEMESISx04: posts the ante 85
JJin91: posts the ante 85
YourRobotDad: posts the ante 85
4Aces518: posts the ante 85
Scooo13zzz: posts small blind 350
bethere1923: posts big blind 700
*** HOLE CARDS ***
Dealt to JJin91 [6d 5s]
SJMayhem11: folds=20
xNEMESISx04: folds=20
JJin91: folds=20
YourRobotDad: folds=20
4Aces518: raises 1301 to 2001 and is all-in
Paceman2jr: folds=20
BENN DOVERR: folds=20
Scooo13zzz: folds=20
bethere1923: folds=20
Uncalled bet (1301) returned to 4Aces518
4Aces518 collected 2515 from pot
4Aces518: doesn't show hand=20
*** SUMMARY ***
Total pot 2515 | Rake 0=20
Seat 1: Paceman2jr folded before Flop (didn't bet)
Seat 2: BENN DOVERR (button) folded before Flop (didn't bet)
Seat 3: Scooo13zzz (small blind) folded before Flop
Seat 4: bethere1923 (big blind) folded before Flop
Seat 5: SJMayhem11 folded before Flop (didn't bet)
Seat 6: xNEMESISx04 folded before Flop (didn't bet)
Seat 7: JJin91 folded before Flop (didn't bet)
Seat 8: YourRobotDad folded before Flop (didn't bet)
Seat 9: 4Aces518 collected (2515)


*********** # 125 **************
PokerStars Hand #176126169020: Tournament #1701843149, $18.20+$1.80 USD=
 Hold'em No Limit - Level XIII (350/700) - 2017/10/09 21:16:05 ET
Table '1701843149 1' 9-max Seat #3 is the button
Seat 1: Paceman2jr (34052 in chips)=20
Seat 2: BENN DOVERR (8246 in chips)=20
Seat 3: Scooo13zzz (33536 in chips)=20
Seat 4: bethere1923 (6256 in chips)=20
Seat 5: SJMayhem11 (14427 in chips)=20
Seat 6: xNEMESISx04 (16739 in chips)=20
Seat 7: JJin91 (68258 in chips)=20
Seat 8: YourRobotDad (24577 in chips)=20
Seat 9: 4Aces518 (3816 in chips)=20
Paceman2jr: posts the ante 85
BENN DOVERR: posts the ante 85
Scooo13zzz: posts the ante 85
bethere1923: posts the ante 85
SJMayhem11: posts the ante 85
xNEMESISx04: posts the ante 85
JJin91: posts the ante 85
YourRobotDad: posts the ante 85
4Aces518: posts the ante 85
bethere1923: posts small blind 350
SJMayhem11: posts big blind 700
*** HOLE CARDS ***
Dealt to JJin91 [2c 7d]
xNEMESISx04: folds=20
JJin91: folds=20
YourRobotDad: calls 700
4Aces518: raises 3031 to 3731 and is all-in
Paceman2jr: folds=20
BENN DOVERR: folds=20
Scooo13zzz: folds=20
bethere1923: raises 2440 to 6171 and is all-in
SJMayhem11: folds=20
YourRobotDad: folds=20
Uncalled bet (2440) returned to bethere1923
*** FLOP *** [Jd Th 3s]
*** TURN *** [Jd Th 3s] [2h]
*** RIVER *** [Jd Th 3s 2h] [Kd]
*** SHOW DOWN ***
bethere1923: shows [5d 5h] (a pair of Fives)
4Aces518: shows [Qd Ks] (a pair of Kings)
4Aces518 collected 9627 from pot
*** SUMMARY ***
Total pot 9627 | Rake 0=20
Board [Jd Th 3s 2h Kd]
Seat 1: Paceman2jr folded before Flop (didn't bet)
Seat 2: BENN DOVERR folded before Flop (didn't bet)
Seat 3: Scooo13zzz (button) folded before Flop (didn't bet)
Seat 4: bethere1923 (small blind) showed [5d 5h] and lost with a pair o=
f Fives
Seat 5: SJMayhem11 (big blind) folded before Flop
Seat 6: xNEMESISx04 folded before Flop (didn't bet)
Seat 7: JJin91 folded before Flop (didn't bet)
Seat 8: YourRobotDad folded before Flop
Seat 9: 4Aces518 showed [Qd Ks] and won (9627) with a pair of Kings


*********** # 126 **************
PokerStars Hand #176126169265: Tournament #1701843149, $18.20+$1.80 USD=
 Hold'em No Limit - Level XIII (350/700) - 2017/10/09 21:16:52 ET
Table '1701843149 1' 9-max Seat #4 is the button
Seat 1: Paceman2jr (33967 in chips)=20
Seat 2: BENN DOVERR (8161 in chips)=20
Seat 3: Scooo13zzz (33451 in chips)=20
Seat 4: bethere1923 (2440 in chips)=20
Seat 5: SJMayhem11 (13642 in chips)=20
Seat 6: xNEMESISx04 (16654 in chips)=20
Seat 7: JJin91 (68173 in chips)=20
Seat 9: 4Aces518 (9627 in chips)=20
Paceman2jr: posts the ante 85
BENN DOVERR: posts the ante 85
Scooo13zzz: posts the ante 85
bethere1923: posts the ante 85
SJMayhem11: posts the ante 85
xNEMESISx04: posts the ante 85
JJin91: posts the ante 85
4Aces518: posts the ante 85
SJMayhem11: posts small blind 350
xNEMESISx04: posts big blind 700
*** HOLE CARDS ***
Dealt to JJin91 [9d 5c]
JJin91: folds=20
4Aces518: folds=20
Paceman2jr: calls 700
BENN DOVERR: folds=20
Scooo13zzz: folds=20
bethere1923: folds=20
SJMayhem11: calls 350
xNEMESISx04: checks=20
*** FLOP *** [4d 2c 7s]
SJMayhem11: checks=20
xNEMESISx04: checks=20
Paceman2jr: checks=20
*** TURN *** [4d 2c 7s] [Ts]
SJMayhem11: bets 1390
xNEMESISx04: folds=20
Paceman2jr: calls 1390
*** RIVER *** [4d 2c 7s Ts] [9s]
SJMayhem11: bets 2780
Paceman2jr: folds=20
Uncalled bet (2780) returned to SJMayhem11
SJMayhem11 collected 5560 from pot
SJMayhem11: doesn't show hand=20
*** SUMMARY ***
Total pot 5560 | Rake 0=20
Board [4d 2c 7s Ts 9s]
Seat 1: Paceman2jr folded on the River
Seat 2: BENN DOVERR folded before Flop (didn't bet)
Seat 3: Scooo13zzz folded before Flop (didn't bet)
Seat 4: bethere1923 (button) folded before Flop (didn't bet)
Seat 5: SJMayhem11 (small blind) collected (5560)
Seat 6: xNEMESISx04 (big blind) folded on the Turn
Seat 7: JJin91 folded before Flop (didn't bet)
Seat 9: 4Aces518 folded before Flop (didn't bet)


*********** # 127 **************
PokerStars Hand #176126169540: Tournament #1701843149, $18.20+$1.80 USD=
 Hold'em No Limit - Level XIII (350/700) - 2017/10/09 21:17:45 ET
Table '1701843149 1' 9-max Seat #5 is the button
Seat 1: Paceman2jr (31792 in chips)=20
Seat 2: BENN DOVERR (8076 in chips)=20
Seat 3: Scooo13zzz (33366 in chips)=20
Seat 4: bethere1923 (2355 in chips)=20
Seat 5: SJMayhem11 (17027 in chips)=20
Seat 6: xNEMESISx04 (15869 in chips)=20
Seat 7: JJin91 (68088 in chips)=20
Seat 9: 4Aces518 (9542 in chips)=20
Paceman2jr: posts the ante 85
BENN DOVERR: posts the ante 85
Scooo13zzz: posts the ante 85
bethere1923: posts the ante 85
SJMayhem11: posts the ante 85
xNEMESISx04: posts the ante 85
JJin91: posts the ante 85
4Aces518: posts the ante 85
xNEMESISx04: posts small blind 350
JJin91: posts big blind 700
*** HOLE CARDS ***
Dealt to JJin91 [Td 6s]
4Aces518: folds=20
Paceman2jr: folds=20
BENN DOVERR: folds=20
Scooo13zzz: folds=20
bethere1923: folds=20
SJMayhem11: folds=20
xNEMESISx04: calls 350
JJin91: checks=20
*** FLOP *** [4c Ks 3d]
xNEMESISx04: checks=20
JJin91: bets 777
xNEMESISx04: folds=20
Uncalled bet (777) returned to JJin91
JJin91 collected 2080 from pot
JJin91: doesn't show hand=20
*** SUMMARY ***
Total pot 2080 | Rake 0=20
Board [4c Ks 3d]
Seat 1: Paceman2jr folded before Flop (didn't bet)
Seat 2: BENN DOVERR folded before Flop (didn't bet)
Seat 3: Scooo13zzz folded before Flop (didn't bet)
Seat 4: bethere1923 folded before Flop (didn't bet)
Seat 5: SJMayhem11 (button) folded before Flop (didn't bet)
Seat 6: xNEMESISx04 (small blind) folded on the Flop
Seat 7: JJin91 (big blind) collected (2080)
Seat 9: 4Aces518 folded before Flop (didn't bet)


*********** # 128 **************
PokerStars Hand #176126169696: Tournament #1701843149, $18.20+$1.80 USD=
 Hold'em No Limit - Level XIII (350/700) - 2017/10/09 21:18:18 ET
Table '1701843149 1' 9-max Seat #6 is the button
Seat 1: Paceman2jr (31707 in chips)=20
Seat 2: BENN DOVERR (7991 in chips)=20
Seat 3: Scooo13zzz (33281 in chips)=20
Seat 4: bethere1923 (2270 in chips)=20
Seat 5: SJMayhem11 (16942 in chips)=20
Seat 6: xNEMESISx04 (15084 in chips)=20
Seat 7: JJin91 (69383 in chips)=20
Seat 9: 4Aces518 (9457 in chips)=20
Paceman2jr: posts the ante 85
BENN DOVERR: posts the ante 85
Scooo13zzz: posts the ante 85
bethere1923: posts the ante 85
SJMayhem11: posts the ante 85
xNEMESISx04: posts the ante 85
JJin91: posts the ante 85
4Aces518: posts the ante 85
JJin91: posts small blind 350
4Aces518: posts big blind 700
*** HOLE CARDS ***
Dealt to JJin91 [3d 4c]
Paceman2jr: folds=20
BENN DOVERR: folds=20
Scooo13zzz: folds=20
bethere1923: raises 1485 to 2185 and is all-in
SJMayhem11: folds=20
xNEMESISx04: folds=20
JJin91: folds=20
4Aces518: folds=20
Uncalled bet (1485) returned to bethere1923
bethere1923 collected 2430 from pot
*** SUMMARY ***
Total pot 2430 | Rake 0=20
Seat 1: Paceman2jr folded before Flop (didn't bet)
Seat 2: BENN DOVERR folded before Flop (didn't bet)
Seat 3: Scooo13zzz folded before Flop (didn't bet)
Seat 4: bethere1923 collected (2430)
Seat 5: SJMayhem11 folded before Flop (didn't bet)
Seat 6: xNEMESISx04 (button) folded before Flop (didn't bet)
Seat 7: JJin91 (small blind) folded before Flop
Seat 9: 4Aces518 (big blind) folded before Flop


*********** # 129 **************
PokerStars Hand #176126169808: Tournament #1701843149, $18.20+$1.80 USD=
 Hold'em No Limit - Level XIII (350/700) - 2017/10/09 21:18:35 ET
Table '1701843149 1' 9-max Seat #7 is the button
Seat 1: Paceman2jr (31622 in chips)=20
Seat 2: BENN DOVERR (7906 in chips)=20
Seat 3: Scooo13zzz (33196 in chips)=20
Seat 4: bethere1923 (3915 in chips)=20
Seat 5: SJMayhem11 (16857 in chips)=20
Seat 6: xNEMESISx04 (14999 in chips)=20
Seat 7: JJin91 (68948 in chips)=20
Seat 9: 4Aces518 (8672 in chips)=20
Paceman2jr: posts the ante 85
BENN DOVERR: posts the ante 85
Scooo13zzz: posts the ante 85
bethere1923: posts the ante 85
SJMayhem11: posts the ante 85
xNEMESISx04: posts the ante 85
JJin91: posts the ante 85
4Aces518: posts the ante 85
4Aces518: posts small blind 350
Paceman2jr: posts big blind 700
*** HOLE CARDS ***
Dealt to JJin91 [7c Th]
BENN DOVERR: folds=20
Scooo13zzz: folds=20
bethere1923: folds=20
SJMayhem11: raises 700 to 1400
xNEMESISx04: folds=20
JJin91: folds=20
4Aces518: folds=20
Paceman2jr: calls 700
*** FLOP *** [Js 3c 7d]
Paceman2jr: checks=20
SJMayhem11: bets 1915
Paceman2jr: folds=20
Uncalled bet (1915) returned to SJMayhem11
SJMayhem11 collected 3830 from pot
SJMayhem11: doesn't show hand=20
*** SUMMARY ***
Total pot 3830 | Rake 0=20
Board [Js 3c 7d]
Seat 1: Paceman2jr (big blind) folded on the Flop
Seat 2: BENN DOVERR folded before Flop (didn't bet)
Seat 3: Scooo13zzz folded before Flop (didn't bet)
Seat 4: bethere1923 folded before Flop (didn't bet)
Seat 5: SJMayhem11 collected (3830)
Seat 6: xNEMESISx04 folded before Flop (didn't bet)
Seat 7: JJin91 (button) folded before Flop (didn't bet)
Seat 9: 4Aces518 (small blind) folded before Flop


*********** # 130 **************
PokerStars Hand #176126169975: Tournament #1701843149, $18.20+$1.80 USD=
 Hold'em No Limit - Level XIII (350/700) - 2017/10/09 21:19:06 ET
Table '1701843149 1' 9-max Seat #9 is the button
Seat 1: Paceman2jr (30137 in chips)=20
Seat 2: BENN DOVERR (7821 in chips)=20
Seat 3: Scooo13zzz (33111 in chips)=20
Seat 4: bethere1923 (3830 in chips)=20
Seat 5: SJMayhem11 (19202 in chips)=20
Seat 6: xNEMESISx04 (14914 in chips)=20
Seat 7: JJin91 (68863 in chips)=20
Seat 9: 4Aces518 (8237 in chips)=20
Paceman2jr: posts the ante 85
BENN DOVERR: posts the ante 85
Scooo13zzz: posts the ante 85
bethere1923: posts the ante 85
SJMayhem11: posts the ante 85
xNEMESISx04: posts the ante 85
JJin91: posts the ante 85
4Aces518: posts the ante 85
Paceman2jr: posts small blind 350
BENN DOVERR: posts big blind 700
*** HOLE CARDS ***
Dealt to JJin91 [Qc Ts]
Scooo13zzz: folds=20
bethere1923: folds=20
SJMayhem11: folds=20
xNEMESISx04: folds=20
JJin91: folds=20
4Aces518: folds=20
Paceman2jr: calls 350
BENN DOVERR: checks=20
*** FLOP *** [8d 7s 9c]
Paceman2jr: bets 700
BENN DOVERR: raises 1253 to 1953
Paceman2jr: folds=20
Uncalled bet (1253) returned to BENN DOVERR
BENN DOVERR collected 3480 from pot
*** SUMMARY ***
Total pot 3480 | Rake 0=20
Board [8d 7s 9c]
Seat 1: Paceman2jr (small blind) folded on the Flop
Seat 2: BENN DOVERR (big blind) collected (3480)
Seat 3: Scooo13zzz folded before Flop (didn't bet)
Seat 4: bethere1923 folded before Flop (didn't bet)
Seat 5: SJMayhem11 folded before Flop (didn't bet)
Seat 6: xNEMESISx04 folded before Flop (didn't bet)
Seat 7: JJin91 folded before Flop (didn't bet)
Seat 9: 4Aces518 (button) folded before Flop (didn't bet)


*********** # 131 **************
PokerStars Hand #176126599625: Tournament #1701843149, $18.20+$1.80 USD=
 Hold'em No Limit - Level XIII (350/700) - 2017/10/09 21:19:55 ET
Table '1701843149 1' 9-max Seat #1 is the button
Seat 1: Paceman2jr (28652 in chips)=20
Seat 2: BENN DOVERR (9816 in chips)=20
Seat 3: Scooo13zzz (33026 in chips)=20
Seat 4: bethere1923 (3745 in chips)=20
Seat 5: SJMayhem11 (19117 in chips)=20
Seat 6: xNEMESISx04 (14829 in chips)=20
Seat 7: JJin91 (68778 in chips)=20
Seat 9: 4Aces518 (8152 in chips)=20
Paceman2jr: posts the ante 85
BENN DOVERR: posts the ante 85
Scooo13zzz: posts the ante 85
bethere1923: posts the ante 85
SJMayhem11: posts the ante 85
xNEMESISx04: posts the ante 85
JJin91: posts the ante 85
4Aces518: posts the ante 85
BENN DOVERR: posts small blind 350
Scooo13zzz: posts big blind 700
*** HOLE CARDS ***
Dealt to JJin91 [4d Ts]
bethere1923: raises 2960 to 3660 and is all-in
SJMayhem11: folds=20
xNEMESISx04: folds=20
JJin91: folds=20
4Aces518: folds=20
Paceman2jr: folds=20
BENN DOVERR: folds=20
Scooo13zzz: calls 2960
*** FLOP *** [Ks 5h 4s]
*** TURN *** [Ks 5h 4s] [Qd]
*** RIVER *** [Ks 5h 4s Qd] [Th]
*** SHOW DOWN ***
Scooo13zzz: shows [7h 7s] (a pair of Sevens)
bethere1923: shows [9d Jd] (a straight, Nine to King)
bethere1923 collected 8350 from pot
*** SUMMARY ***
Total pot 8350 | Rake 0=20
Board [Ks 5h 4s Qd Th]
Seat 1: Paceman2jr (button) folded before Flop (didn't bet)
Seat 2: BENN DOVERR (small blind) folded before Flop
Seat 3: Scooo13zzz (big blind) showed [7h 7s] and lost with a pair of S=
evens
Seat 4: bethere1923 showed [9d Jd] and won (8350) with a straight, Nine=
 to King
Seat 5: SJMayhem11 folded before Flop (didn't bet)
Seat 6: xNEMESISx04 folded before Flop (didn't bet)
Seat 7: JJin91 folded before Flop (didn't bet)
Seat 9: 4Aces518 folded before Flop (didn't bet)


*********** # 132 **************
PokerStars Hand #176126599769: Tournament #1701843149, $18.20+$1.80 USD=
 Hold'em No Limit - Level XIII (350/700) - 2017/10/09 21:20:24 ET
Table '1701843149 1' 9-max Seat #2 is the button
Seat 1: Paceman2jr (28567 in chips)=20
Seat 2: BENN DOVERR (9381 in chips)=20
Seat 3: Scooo13zzz (29281 in chips)=20
Seat 4: bethere1923 (8350 in chips)=20
Seat 5: SJMayhem11 (19032 in chips)=20
Seat 6: xNEMESISx04 (14744 in chips)=20
Seat 7: JJin91 (68693 in chips)=20
Seat 9: 4Aces518 (8067 in chips)=20
Paceman2jr: posts the ante 85
BENN DOVERR: posts the ante 85
Scooo13zzz: posts the ante 85
bethere1923: posts the ante 85
SJMayhem11: posts the ante 85
xNEMESISx04: posts the ante 85
JJin91: posts the ante 85
4Aces518: posts the ante 85
Scooo13zzz: posts small blind 350
bethere1923: posts big blind 700
*** HOLE CARDS ***
Dealt to JJin91 [As Kc]
SJMayhem11: folds=20
xNEMESISx04: folds=20
JJin91: raises 819 to 1519
4Aces518: folds=20
Paceman2jr: folds=20
BENN DOVERR: folds=20
Scooo13zzz: calls 1169
bethere1923: folds=20
*** FLOP *** [4s 5d Qc]
Scooo13zzz: checks=20
JJin91: checks=20
*** TURN *** [4s 5d Qc] [4c]
Scooo13zzz: checks=20
JJin91: checks=20
*** RIVER *** [4s 5d Qc 4c] [3d]
Scooo13zzz: bets 2651
JJin91: calls 2651
*** SHOW DOWN ***
Scooo13zzz: shows [Ts Td] (two pair, Tens and Fours)
JJin91: mucks hand=20
Scooo13zzz collected 9720 from pot
*** SUMMARY ***
Total pot 9720 | Rake 0=20
Board [4s 5d Qc 4c 3d]
Seat 1: Paceman2jr folded before Flop (didn't bet)
Seat 2: BENN DOVERR (button) folded before Flop (didn't bet)
Seat 3: Scooo13zzz (small blind) showed [Ts Td] and won (9720) with two=
 pair, Tens and Fours
Seat 4: bethere1923 (big blind) folded before Flop
Seat 5: SJMayhem11 folded before Flop (didn't bet)
Seat 6: xNEMESISx04 folded before Flop (didn't bet)
Seat 7: JJin91 mucked [As Kc]
Seat 9: 4Aces518 folded before Flop (didn't bet)


*********** # 133 **************
PokerStars Hand #176126687568: Tournament #1701843149, $18.20+$1.80 USD=
 Hold'em No Limit - Level XIII (350/700) - 2017/10/09 21:21:45 ET
Table '1701843149 1' 9-max Seat #3 is the button
Seat 1: Paceman2jr (28482 in chips)=20
Seat 2: BENN DOVERR (9296 in chips)=20
Seat 3: Scooo13zzz (34746 in chips)=20
Seat 4: bethere1923 (7565 in chips)=20
Seat 5: SJMayhem11 (18947 in chips)=20
Seat 6: xNEMESISx04 (14659 in chips)=20
Seat 7: JJin91 (64438 in chips)=20
Seat 9: 4Aces518 (7982 in chips)=20
Paceman2jr: posts the ante 85
BENN DOVERR: posts the ante 85
Scooo13zzz: posts the ante 85
bethere1923: posts the ante 85
SJMayhem11: posts the ante 85
xNEMESISx04: posts the ante 85
JJin91: posts the ante 85
4Aces518: posts the ante 85
bethere1923: posts small blind 350
SJMayhem11: posts big blind 700
*** HOLE CARDS ***
Dealt to JJin91 [Ad Ts]
xNEMESISx04: folds=20
JJin91: raises 819 to 1519
4Aces518: folds=20
Paceman2jr: folds=20
BENN DOVERR: folds=20
Scooo13zzz: folds=20
bethere1923: folds=20
SJMayhem11: calls 819
*** FLOP *** [Kc Kh Qc]
SJMayhem11: checks=20
JJin91: bets 1888
SJMayhem11: calls 1888
*** TURN *** [Kc Kh Qc] [Ah]
SJMayhem11: checks=20
JJin91: checks=20
*** RIVER *** [Kc Kh Qc Ah] [4s]
SJMayhem11: bets 3500
JJin91: calls 3500
*** SHOW DOWN ***
SJMayhem11: shows [Js As] (two pair, Aces and Kings)
JJin91: shows [Ad Ts] (two pair, Aces and Kings)
SJMayhem11 collected 7422 from pot
JJin91 collected 7422 from pot
*** SUMMARY ***
Total pot 14844 | Rake 0=20
Board [Kc Kh Qc Ah 4s]
Seat 1: Paceman2jr folded before Flop (didn't bet)
Seat 2: BENN DOVERR folded before Flop (didn't bet)
Seat 3: Scooo13zzz (button) folded before Flop (didn't bet)
Seat 4: bethere1923 (small blind) folded before Flop
Seat 5: SJMayhem11 (big blind) showed [Js As] and won (7422) with two p=
air, Aces and Kings
Seat 6: xNEMESISx04 folded before Flop (didn't bet)
Seat 7: JJin91 showed [Ad Ts] and won (7422) with two pair, Aces and Ki=
ngs
Seat 9: 4Aces518 folded before Flop (didn't bet)


*********** # 134 **************
PokerStars Hand #176126687894: Tournament #1701843149, $18.20+$1.80 USD=
 Hold'em No Limit - Level XIV (400/800) - 2017/10/09 21:22:52 ET
Table '1701843149 1' 9-max Seat #4 is the button
Seat 1: Paceman2jr (28397 in chips)=20
Seat 2: BENN DOVERR (9211 in chips)=20
Seat 3: Scooo13zzz (34661 in chips)=20
Seat 4: bethere1923 (7130 in chips)=20
Seat 5: SJMayhem11 (19377 in chips)=20
Seat 6: xNEMESISx04 (14574 in chips)=20
Seat 7: JJin91 (64868 in chips)=20
Seat 9: 4Aces518 (7897 in chips)=20
Paceman2jr: posts the ante 100
BENN DOVERR: posts the ante 100
Scooo13zzz: posts the ante 100
bethere1923: posts the ante 100
SJMayhem11: posts the ante 100
xNEMESISx04: posts the ante 100
JJin91: posts the ante 100
4Aces518: posts the ante 100
SJMayhem11: posts small blind 400
xNEMESISx04: posts big blind 800
*** HOLE CARDS ***
Dealt to JJin91 [Qc Js]
JJin91: folds=20
4Aces518: folds=20
Paceman2jr: raises 2800 to 3600
BENN DOVERR: folds=20
Scooo13zzz: folds=20
bethere1923: folds=20
SJMayhem11: folds=20
xNEMESISx04: folds=20
Uncalled bet (2800) returned to Paceman2jr
Paceman2jr collected 2800 from pot
Paceman2jr: doesn't show hand=20
*** SUMMARY ***
Total pot 2800 | Rake 0=20
Seat 1: Paceman2jr collected (2800)
Seat 2: BENN DOVERR folded before Flop (didn't bet)
Seat 3: Scooo13zzz folded before Flop (didn't bet)
Seat 4: bethere1923 (button) folded before Flop (didn't bet)
Seat 5: SJMayhem11 (small blind) folded before Flop
Seat 6: xNEMESISx04 (big blind) folded before Flop
Seat 7: JJin91 folded before Flop (didn't bet)
Seat 9: 4Aces518 folded before Flop (didn't bet)


*********** # 135 **************
PokerStars Hand #176126688015: Tournament #1701843149, $18.20+$1.80 USD=
 Hold'em No Limit - Level XIV (400/800) - 2017/10/09 21:23:15 ET
Table '1701843149 1' 9-max Seat #5 is the button
Seat 1: Paceman2jr (30297 in chips)=20
Seat 2: BENN DOVERR (9111 in chips)=20
Seat 3: Scooo13zzz (34561 in chips)=20
Seat 4: bethere1923 (7030 in chips)=20
Seat 5: SJMayhem11 (18877 in chips)=20
Seat 6: xNEMESISx04 (13674 in chips)=20
Seat 7: JJin91 (64768 in chips)=20
Seat 9: 4Aces518 (7797 in chips)=20
Paceman2jr: posts the ante 100
BENN DOVERR: posts the ante 100
Scooo13zzz: posts the ante 100
bethere1923: posts the ante 100
SJMayhem11: posts the ante 100
xNEMESISx04: posts the ante 100
JJin91: posts the ante 100
4Aces518: posts the ante 100
xNEMESISx04: posts small blind 400
JJin91: posts big blind 800
*** HOLE CARDS ***
Dealt to JJin91 [Qs 8c]
4Aces518: folds=20
Paceman2jr: folds=20
BENN DOVERR: folds=20
Scooo13zzz: raises 960 to 1760
bethere1923: folds=20
SJMayhem11: folds=20
xNEMESISx04: raises 11814 to 13574 and is all-in
JJin91: folds=20
Scooo13zzz: folds=20
Uncalled bet (11814) returned to xNEMESISx04
xNEMESISx04 collected 5120 from pot
xNEMESISx04: doesn't show hand=20
*** SUMMARY ***
Total pot 5120 | Rake 0=20
Seat 1: Paceman2jr folded before Flop (didn't bet)
Seat 2: BENN DOVERR folded before Flop (didn't bet)
Seat 3: Scooo13zzz folded before Flop
Seat 4: bethere1923 folded before Flop (didn't bet)
Seat 5: SJMayhem11 (button) folded before Flop (didn't bet)
Seat 6: xNEMESISx04 (small blind) collected (5120)
Seat 7: JJin91 (big blind) folded before Flop
Seat 9: 4Aces518 folded before Flop (didn't bet)


*********** # 136 **************
PokerStars Hand #176126688338: Tournament #1701843149, $18.20+$1.80 USD=
 Hold'em No Limit - Level XIV (400/800) - 2017/10/09 21:24:15 ET
Table '1701843149 1' 9-max Seat #6 is the button
Seat 1: Paceman2jr (30197 in chips)=20
Seat 2: BENN DOVERR (9011 in chips)=20
Seat 3: Scooo13zzz (32701 in chips)=20
Seat 4: bethere1923 (6930 in chips)=20
Seat 5: SJMayhem11 (18777 in chips)=20
Seat 6: xNEMESISx04 (16934 in chips)=20
Seat 7: JJin91 (63868 in chips)=20
Seat 9: 4Aces518 (7697 in chips)=20
Paceman2jr: posts the ante 100
BENN DOVERR: posts the ante 100
Scooo13zzz: posts the ante 100
bethere1923: posts the ante 100
SJMayhem11: posts the ante 100
xNEMESISx04: posts the ante 100
JJin91: posts the ante 100
4Aces518: posts the ante 100
JJin91: posts small blind 400
4Aces518: posts big blind 800
*** HOLE CARDS ***
Dealt to JJin91 [Kd 2d]
Paceman2jr: folds=20
BENN DOVERR: folds=20
Scooo13zzz: folds=20
bethere1923: folds=20
SJMayhem11: folds=20
xNEMESISx04: folds=20
JJin91: raises 62968 to 63768 and is all-in
4Aces518: folds=20
Uncalled bet (62968) returned to JJin91
JJin91 collected 2400 from pot
JJin91: doesn't show hand=20
*** SUMMARY ***
Total pot 2400 | Rake 0=20
Seat 1: Paceman2jr folded before Flop (didn't bet)
Seat 2: BENN DOVERR folded before Flop (didn't bet)
Seat 3: Scooo13zzz folded before Flop (didn't bet)
Seat 4: bethere1923 folded before Flop (didn't bet)
Seat 5: SJMayhem11 folded before Flop (didn't bet)
Seat 6: xNEMESISx04 (button) folded before Flop (didn't bet)
Seat 7: JJin91 (small blind) collected (2400)
Seat 9: 4Aces518 (big blind) folded before Flop


*********** # 137 **************
PokerStars Hand #176126688484: Tournament #1701843149, $18.20+$1.80 USD=
 Hold'em No Limit - Level XIV (400/800) - 2017/10/09 21:24:46 ET
Table '1701843149 1' 9-max Seat #7 is the button
Seat 1: Paceman2jr (30097 in chips)=20
Seat 2: BENN DOVERR (8911 in chips)=20
Seat 3: Scooo13zzz (32601 in chips)=20
Seat 4: bethere1923 (6830 in chips)=20
Seat 5: SJMayhem11 (18677 in chips)=20
Seat 6: xNEMESISx04 (16834 in chips)=20
Seat 7: JJin91 (65368 in chips)=20
Seat 9: 4Aces518 (6797 in chips)=20
Paceman2jr: posts the ante 100
BENN DOVERR: posts the ante 100
Scooo13zzz: posts the ante 100
bethere1923: posts the ante 100
SJMayhem11: posts the ante 100
xNEMESISx04: posts the ante 100
JJin91: posts the ante 100
4Aces518: posts the ante 100
4Aces518: posts small blind 400
Paceman2jr: posts big blind 800
*** HOLE CARDS ***
Dealt to JJin91 [Js Kd]
BENN DOVERR: folds=20
Scooo13zzz: folds=20
bethere1923: raises 5600 to 6400
SJMayhem11: folds=20
xNEMESISx04: folds=20
JJin91: folds=20
4Aces518: folds=20
Paceman2jr: folds=20
Uncalled bet (5600) returned to bethere1923
bethere1923 collected 2800 from pot
*** SUMMARY ***
Total pot 2800 | Rake 0=20
Seat 1: Paceman2jr (big blind) folded before Flop
Seat 2: BENN DOVERR folded before Flop (didn't bet)
Seat 3: Scooo13zzz folded before Flop (didn't bet)
Seat 4: bethere1923 collected (2800)
Seat 5: SJMayhem11 folded before Flop (didn't bet)
Seat 6: xNEMESISx04 folded before Flop (didn't bet)
Seat 7: JJin91 (button) folded before Flop (didn't bet)
Seat 9: 4Aces518 (small blind) folded before Flop


*********** # 138 **************
PokerStars Hand #176126688638: Tournament #1701843149, $18.20+$1.80 USD=
 Hold'em No Limit - Level XIV (400/800) - 2017/10/09 21:25:19 ET
Table '1701843149 1' 9-max Seat #9 is the button
Seat 1: Paceman2jr (29197 in chips)=20
Seat 2: BENN DOVERR (8811 in chips)=20
Seat 3: Scooo13zzz (32501 in chips)=20
Seat 4: bethere1923 (8730 in chips)=20
Seat 5: SJMayhem11 (18577 in chips)=20
Seat 6: xNEMESISx04 (16734 in chips)=20
Seat 7: JJin91 (65268 in chips)=20
Seat 9: 4Aces518 (6297 in chips)=20
Paceman2jr: posts the ante 100
BENN DOVERR: posts the ante 100
Scooo13zzz: posts the ante 100
bethere1923: posts the ante 100
SJMayhem11: posts the ante 100
xNEMESISx04: posts the ante 100
JJin91: posts the ante 100
4Aces518: posts the ante 100
Paceman2jr: posts small blind 400
BENN DOVERR: posts big blind 800
*** HOLE CARDS ***
Dealt to JJin91 [Ac 7s]
Scooo13zzz: folds=20
bethere1923: folds=20
SJMayhem11: calls 800
xNEMESISx04: folds=20
JJin91: folds=20
4Aces518: folds=20
Paceman2jr: folds=20
BENN DOVERR: checks=20
*** FLOP *** [As Ad 7d]
BENN DOVERR: checks=20
SJMayhem11: bets 800
BENN DOVERR: folds=20
Uncalled bet (800) returned to SJMayhem11
SJMayhem11 collected 2800 from pot
SJMayhem11: doesn't show hand=20
*** SUMMARY ***
Total pot 2800 | Rake 0=20
Board [As Ad 7d]
Seat 1: Paceman2jr (small blind) folded before Flop
Seat 2: BENN DOVERR (big blind) folded on the Flop
Seat 3: Scooo13zzz folded before Flop (didn't bet)
Seat 4: bethere1923 folded before Flop (didn't bet)
Seat 5: SJMayhem11 collected (2800)
Seat 6: xNEMESISx04 folded before Flop (didn't bet)
Seat 7: JJin91 folded before Flop (didn't bet)
Seat 9: 4Aces518 (button) folded before Flop (didn't bet)


*********** # 139 **************
PokerStars Hand #176126688811: Tournament #1701843149, $18.20+$1.80 USD=
 Hold'em No Limit - Level XIV (400/800) - 2017/10/09 21:25:57 ET
Table '1701843149 1' 9-max Seat #1 is the button
Seat 1: Paceman2jr (28697 in chips)=20
Seat 2: BENN DOVERR (7911 in chips)=20
Seat 3: Scooo13zzz (32401 in chips)=20
Seat 4: bethere1923 (8630 in chips)=20
Seat 5: SJMayhem11 (20477 in chips)=20
Seat 6: xNEMESISx04 (16634 in chips)=20
Seat 7: JJin91 (65168 in chips)=20
Seat 9: 4Aces518 (6197 in chips)=20
Paceman2jr: posts the ante 100
BENN DOVERR: posts the ante 100
Scooo13zzz: posts the ante 100
bethere1923: posts the ante 100
SJMayhem11: posts the ante 100
xNEMESISx04: posts the ante 100
JJin91: posts the ante 100
4Aces518: posts the ante 100
BENN DOVERR: posts small blind 400
Scooo13zzz: posts big blind 800
*** HOLE CARDS ***
Dealt to JJin91 [7s 6s]
bethere1923: folds=20
SJMayhem11: calls 800
xNEMESISx04: folds=20
JJin91: folds=20
4Aces518: raises 5297 to 6097 and is all-in
Paceman2jr: folds=20
BENN DOVERR: raises 1714 to 7811 and is all-in
Scooo13zzz: folds=20
SJMayhem11: folds=20
Uncalled bet (1714) returned to BENN DOVERR
*** FLOP *** [Kc 7h 8c]
*** TURN *** [Kc 7h 8c] [5s]
*** RIVER *** [Kc 7h 8c 5s] [2h]
*** SHOW DOWN ***
BENN DOVERR: shows [Jh Ah] (high card Ace)
4Aces518: shows [Th Td] (a pair of Tens)
4Aces518 collected 14594 from pot
*** SUMMARY ***
Total pot 14594 | Rake 0=20
Board [Kc 7h 8c 5s 2h]
Seat 1: Paceman2jr (button) folded before Flop (didn't bet)
Seat 2: BENN DOVERR (small blind) showed [Jh Ah] and lost with high car=
d Ace
Seat 3: Scooo13zzz (big blind) folded before Flop
Seat 4: bethere1923 folded before Flop (didn't bet)
Seat 5: SJMayhem11 folded before Flop
Seat 6: xNEMESISx04 folded before Flop (didn't bet)
Seat 7: JJin91 folded before Flop (didn't bet)
Seat 9: 4Aces518 showed [Th Td] and won (14594) with a pair of Tens


*********** # 140 **************
PokerStars Hand #176126689113: Tournament #1701843149, $18.20+$1.80 USD=
 Hold'em No Limit - Level XIV (400/800) - 2017/10/09 21:27:02 ET
Table '1701843149 1' 9-max Seat #2 is the button
Seat 1: Paceman2jr (28597 in chips)=20
Seat 2: BENN DOVERR (1714 in chips)=20
Seat 3: Scooo13zzz (31501 in chips)=20
Seat 4: bethere1923 (8530 in chips)=20
Seat 5: SJMayhem11 (19577 in chips)=20
Seat 6: xNEMESISx04 (16534 in chips)=20
Seat 7: JJin91 (65068 in chips)=20
Seat 9: 4Aces518 (14594 in chips)=20
Paceman2jr: posts the ante 100
BENN DOVERR: posts the ante 100
Scooo13zzz: posts the ante 100
bethere1923: posts the ante 100
SJMayhem11: posts the ante 100
xNEMESISx04: posts the ante 100
JJin91: posts the ante 100
4Aces518: posts the ante 100
Scooo13zzz: posts small blind 400
bethere1923: posts big blind 800
*** HOLE CARDS ***
Dealt to JJin91 [9c Ks]
SJMayhem11: folds=20
xNEMESISx04: folds=20
JJin91: folds=20
4Aces518: folds=20
Paceman2jr has timed out
Paceman2jr: folds=20
Paceman2jr is sitting out
Paceman2jr has returned
BENN DOVERR: raises 814 to 1614 and is all-in
Scooo13zzz: folds=20
bethere1923: calls 814
*** FLOP *** [Tc 2h 6s]
*** TURN *** [Tc 2h 6s] [2s]
*** RIVER *** [Tc 2h 6s 2s] [6c]
*** SHOW DOWN ***
bethere1923: shows [Jh 6h] (a full house, Sixes full of Deuces)
BENN DOVERR: shows [5h 7h] (two pair, Sixes and Deuces)
bethere1923 collected 4428 from pot
BENN DOVERR finished the tournament in 40th place
*** SUMMARY ***
Total pot 4428 | Rake 0=20
Board [Tc 2h 6s 2s 6c]
Seat 1: Paceman2jr folded before Flop (didn't bet)
Seat 2: BENN DOVERR (button) showed [5h 7h] and lost with two pair, Six=
es and Deuces
Seat 3: Scooo13zzz (small blind) folded before Flop
Seat 4: bethere1923 (big blind) showed [Jh 6h] and won (4428) with a fu=
ll house, Sixes full of Deuces
Seat 5: SJMayhem11 folded before Flop (didn't bet)
Seat 6: xNEMESISx04 folded before Flop (didn't bet)
Seat 7: JJin91 folded before Flop (didn't bet)
Seat 9: 4Aces518 folded before Flop (didn't bet)


*********** # 141 **************
PokerStars Hand #176126689367: Tournament #1701843149, $18.20+$1.80 USD=
 Hold'em No Limit - Level XIV (400/800) - 2017/10/09 21:27:58 ET
Table '1701843149 1' 9-max Seat #3 is the button
Seat 1: Paceman2jr (28497 in chips)=20
Seat 3: Scooo13zzz (31001 in chips)=20
Seat 4: bethere1923 (11244 in chips)=20
Seat 5: SJMayhem11 (19477 in chips)=20
Seat 6: xNEMESISx04 (16434 in chips)=20
Seat 7: JJin91 (64968 in chips)=20
Seat 9: 4Aces518 (14494 in chips)=20
Paceman2jr: posts the ante 100
Scooo13zzz: posts the ante 100
bethere1923: posts the ante 100
SJMayhem11: posts the ante 100
xNEMESISx04: posts the ante 100
JJin91: posts the ante 100
4Aces518: posts the ante 100
bethere1923: posts small blind 400
SJMayhem11: posts big blind 800
*** HOLE CARDS ***
Dealt to JJin91 [6d 9h]
xNEMESISx04: folds=20
JJin91: folds=20
4Aces518: calls 800
Paceman2jr: folds=20
Scooo13zzz: folds=20
bethere1923: calls 400
SJMayhem11: checks=20
*** FLOP *** [Jc Ts 7h]
bethere1923: checks=20
SJMayhem11: bets 1550
4Aces518: calls 1550
bethere1923: folds=20
*** TURN *** [Jc Ts 7h] [9c]
SJMayhem11: checks=20
4Aces518: bets 12044 and is all-in
SJMayhem11: folds=20
Uncalled bet (12044) returned to 4Aces518
4Aces518 collected 6200 from pot
4Aces518: doesn't show hand=20
*** SUMMARY ***
Total pot 6200 | Rake 0=20
Board [Jc Ts 7h 9c]
Seat 1: Paceman2jr folded before Flop (didn't bet)
Seat 3: Scooo13zzz (button) folded before Flop (didn't bet)
Seat 4: bethere1923 (small blind) folded on the Flop
Seat 5: SJMayhem11 (big blind) folded on the Turn
Seat 6: xNEMESISx04 folded before Flop (didn't bet)
Seat 7: JJin91 folded before Flop (didn't bet)
Seat 9: 4Aces518 collected (6200)


*********** # 142 **************
PokerStars Hand #176126689588: Tournament #1701843149, $18.20+$1.80 USD=
 Hold'em No Limit - Level XIV (400/800) - 2017/10/09 21:28:48 ET
Table '1701843149 1' 9-max Seat #4 is the button
Seat 1: Paceman2jr (28397 in chips)=20
Seat 3: Scooo13zzz (30901 in chips)=20
Seat 4: bethere1923 (10344 in chips)=20
Seat 5: SJMayhem11 (17027 in chips)=20
Seat 6: xNEMESISx04 (16334 in chips)=20
Seat 7: JJin91 (64868 in chips)=20
Seat 9: 4Aces518 (18244 in chips)=20
Paceman2jr: posts the ante 100
Scooo13zzz: posts the ante 100
bethere1923: posts the ante 100
SJMayhem11: posts the ante 100
xNEMESISx04: posts the ante 100
JJin91: posts the ante 100
4Aces518: posts the ante 100
SJMayhem11: posts small blind 400
xNEMESISx04: posts big blind 800
*** HOLE CARDS ***
Dealt to JJin91 [As 8c]
JJin91: folds=20
4Aces518: folds=20
Paceman2jr has timed out
Paceman2jr: folds=20
Paceman2jr is sitting out
Scooo13zzz: folds=20
bethere1923: folds=20
SJMayhem11: raises 800 to 1600
xNEMESISx04: folds=20
Uncalled bet (800) returned to SJMayhem11
SJMayhem11 collected 2300 from pot
SJMayhem11: shows [Kc Kd] (a pair of Kings)
*** SUMMARY ***
Total pot 2300 | Rake 0=20
Seat 1: Paceman2jr folded before Flop (didn't bet)
Seat 3: Scooo13zzz folded before Flop (didn't bet)
Seat 4: bethere1923 (button) folded before Flop (didn't bet)
Seat 5: SJMayhem11 (small blind) collected (2300)
Seat 6: xNEMESISx04 (big blind) folded before Flop
Seat 7: JJin91 folded before Flop (didn't bet)
Seat 9: 4Aces518 folded before Flop (didn't bet)


*********** # 143 **************
PokerStars Hand #176126689746: Tournament #1701843149, $18.20+$1.80 USD=
 Hold'em No Limit - Level XIV (400/800) - 2017/10/09 21:29:28 ET
Table '1701843149 1' 9-max Seat #5 is the button
Seat 1: Paceman2jr (28297 in chips) is sitting out
Seat 3: Scooo13zzz (30801 in chips)=20
Seat 4: bethere1923 (10244 in chips)=20
Seat 5: SJMayhem11 (18427 in chips)=20
Seat 6: xNEMESISx04 (15434 in chips)=20
Seat 7: JJin91 (64768 in chips)=20
Seat 9: 4Aces518 (18144 in chips)=20
Paceman2jr: posts the ante 100
Scooo13zzz: posts the ante 100
bethere1923: posts the ante 100
SJMayhem11: posts the ante 100
xNEMESISx04: posts the ante 100
JJin91: posts the ante 100
4Aces518: posts the ante 100
xNEMESISx04: posts small blind 400
JJin91: posts big blind 800
*** HOLE CARDS ***
Dealt to JJin91 [5d 8d]
4Aces518: folds=20
Paceman2jr: folds=20
Scooo13zzz: folds=20
bethere1923: raises 9344 to 10144 and is all-in
SJMayhem11: folds=20
xNEMESISx04: folds=20
JJin91: folds=20
Uncalled bet (9344) returned to bethere1923
bethere1923 collected 2700 from pot
*** SUMMARY ***
Total pot 2700 | Rake 0=20
Seat 1: Paceman2jr folded before Flop (didn't bet)
Seat 3: Scooo13zzz folded before Flop (didn't bet)
Seat 4: bethere1923 collected (2700)
Seat 5: SJMayhem11 (button) folded before Flop (didn't bet)
Seat 6: xNEMESISx04 (small blind) folded before Flop
Seat 7: JJin91 (big blind) folded before Flop
Seat 9: 4Aces518 folded before Flop (didn't bet)


*********** # 144 **************
PokerStars Hand #176126689883: Tournament #1701843149, $18.20+$1.80 USD=
 Hold'em No Limit - Level XIV (400/800) - 2017/10/09 21:30:02 ET
Table '1701843149 1' 9-max Seat #6 is the button
Seat 1: Paceman2jr (28197 in chips) is sitting out
Seat 3: Scooo13zzz (30701 in chips)=20
Seat 4: bethere1923 (12044 in chips)=20
Seat 5: SJMayhem11 (18327 in chips)=20
Seat 6: xNEMESISx04 (14934 in chips)=20
Seat 7: JJin91 (63868 in chips)=20
Seat 9: 4Aces518 (18044 in chips)=20
Paceman2jr: posts the ante 100
Scooo13zzz: posts the ante 100
bethere1923: posts the ante 100
SJMayhem11: posts the ante 100
xNEMESISx04: posts the ante 100
JJin91: posts the ante 100
4Aces518: posts the ante 100
JJin91: posts small blind 400
4Aces518: posts big blind 800
*** HOLE CARDS ***
Dealt to JJin91 [7d 5s]
Paceman2jr: folds=20
Paceman2jr has returned
Scooo13zzz: folds=20
bethere1923: folds=20
SJMayhem11: folds=20
xNEMESISx04: folds=20
JJin91: raises 936 to 1736
4Aces518: folds=20
Uncalled bet (936) returned to JJin91
JJin91 collected 2300 from pot
JJin91: doesn't show hand=20
*** SUMMARY ***
Total pot 2300 | Rake 0=20
Seat 1: Paceman2jr folded before Flop (didn't bet)
Seat 3: Scooo13zzz folded before Flop (didn't bet)
Seat 4: bethere1923 folded before Flop (didn't bet)
Seat 5: SJMayhem11 folded before Flop (didn't bet)
Seat 6: xNEMESISx04 (button) folded before Flop (didn't bet)
Seat 7: JJin91 (small blind) collected (2300)
Seat 9: 4Aces518 (big blind) folded before Flop


*********** # 145 **************
PokerStars Hand #176126689981: Tournament #1701843149, $18.20+$1.80 USD=
 Hold'em No Limit - Level XIV (400/800) - 2017/10/09 21:30:25 ET
Table '1701843149 1' 9-max Seat #7 is the button
Seat 1: Paceman2jr (28097 in chips)=20
Seat 3: Scooo13zzz (30601 in chips)=20
Seat 4: bethere1923 (11944 in chips)=20
Seat 5: SJMayhem11 (18227 in chips)=20
Seat 6: xNEMESISx04 (14834 in chips)=20
Seat 7: JJin91 (65268 in chips)=20
Seat 9: 4Aces518 (17144 in chips)=20
Paceman2jr: posts the ante 100
Scooo13zzz: posts the ante 100
bethere1923: posts the ante 100
SJMayhem11: posts the ante 100
xNEMESISx04: posts the ante 100
JJin91: posts the ante 100
4Aces518: posts the ante 100
4Aces518: posts small blind 400
Paceman2jr: posts big blind 800
*** HOLE CARDS ***
Dealt to JJin91 [8d Jc]
Scooo13zzz: folds=20
bethere1923: folds=20
SJMayhem11: folds=20
xNEMESISx04: folds=20
JJin91: raises 936 to 1736
4Aces518: calls 1336
Paceman2jr: folds=20
*** FLOP *** [Jd 8h Ad]
4Aces518: checks=20
JJin91: bets 2777
4Aces518: calls 2777
*** TURN *** [Jd 8h Ad] [Th]
4Aces518: checks=20
JJin91: bets 4222
4Aces518: calls 4222
*** RIVER *** [Jd 8h Ad Th] [Kd]
4Aces518: checks=20
JJin91: checks=20
*** SHOW DOWN ***
4Aces518: shows [Td Qc] (a straight, Ten to Ace)
JJin91: mucks hand=20
4Aces518 collected 18970 from pot
*** SUMMARY ***
Total pot 18970 | Rake 0=20
Board [Jd 8h Ad Th Kd]
Seat 1: Paceman2jr (big blind) folded before Flop
Seat 3: Scooo13zzz folded before Flop (didn't bet)
Seat 4: bethere1923 folded before Flop (didn't bet)
Seat 5: SJMayhem11 folded before Flop (didn't bet)
Seat 6: xNEMESISx04 folded before Flop (didn't bet)
Seat 7: JJin91 (button) mucked [8d Jc]
Seat 9: 4Aces518 (small blind) showed [Td Qc] and won (18970) with a st=
raight, Ten to Ace


*********** # 146 **************
PokerStars Hand #176127076758: Tournament #1701843149, $18.20+$1.80 USD=
 Hold'em No Limit - Level XIV (400/800) - 2017/10/09 21:31:26 ET
Table '1701843149 1' 9-max Seat #9 is the button
Seat 1: Paceman2jr (27197 in chips)=20
Seat 3: Scooo13zzz (30501 in chips)=20
Seat 4: bethere1923 (11844 in chips)=20
Seat 5: SJMayhem11 (18127 in chips)=20
Seat 6: xNEMESISx04 (14734 in chips)=20
Seat 7: JJin91 (56433 in chips)=20
Seat 9: 4Aces518 (27279 in chips)=20
Paceman2jr: posts the ante 100
Scooo13zzz: posts the ante 100
bethere1923: posts the ante 100
SJMayhem11: posts the ante 100
xNEMESISx04: posts the ante 100
JJin91: posts the ante 100
4Aces518: posts the ante 100
Paceman2jr: posts small blind 400
Scooo13zzz: posts big blind 800
*** HOLE CARDS ***
Dealt to JJin91 [5s 4h]
bethere1923: raises 10944 to 11744 and is all-in
SJMayhem11: folds=20
xNEMESISx04: folds=20
JJin91: folds=20
4Aces518: folds=20
Paceman2jr: folds=20
Scooo13zzz: folds=20
Uncalled bet (10944) returned to bethere1923
bethere1923 collected 2700 from pot
*** SUMMARY ***
Total pot 2700 | Rake 0=20
Seat 1: Paceman2jr (small blind) folded before Flop
Seat 3: Scooo13zzz (big blind) folded before Flop
Seat 4: bethere1923 collected (2700)
Seat 5: SJMayhem11 folded before Flop (didn't bet)
Seat 6: xNEMESISx04 folded before Flop (didn't bet)
Seat 7: JJin91 folded before Flop (didn't bet)
Seat 9: 4Aces518 (button) folded before Flop (didn't bet)


*********** # 147 **************
PokerStars Hand #176127076916: Tournament #1701843149, $18.20+$1.80 USD=
 Hold'em No Limit - Level XIV (400/800) - 2017/10/09 21:32:01 ET
Table '1701843149 1' 9-max Seat #1 is the button
Seat 1: Paceman2jr (26697 in chips)=20
Seat 3: Scooo13zzz (29601 in chips)=20
Seat 4: bethere1923 (13644 in chips)=20
Seat 5: SJMayhem11 (18027 in chips)=20
Seat 6: xNEMESISx04 (14634 in chips)=20
Seat 7: JJin91 (56333 in chips)=20
Seat 9: 4Aces518 (27179 in chips)=20
Paceman2jr: posts the ante 100
Scooo13zzz: posts the ante 100
bethere1923: posts the ante 100
SJMayhem11: posts the ante 100
xNEMESISx04: posts the ante 100
JJin91: posts the ante 100
4Aces518: posts the ante 100
Scooo13zzz: posts small blind 400
bethere1923: posts big blind 800
*** HOLE CARDS ***
Dealt to JJin91 [9c 4c]
SJMayhem11: folds=20
xNEMESISx04: folds=20
JJin91: folds=20
4Aces518: folds=20
Paceman2jr: folds=20
Scooo13zzz: raises 1600 to 2400
bethere1923: folds [2d 9h]
Uncalled bet (1600) returned to Scooo13zzz
Scooo13zzz collected 2300 from pot
Scooo13zzz: shows [5h Kc]
*** SUMMARY ***
Total pot 2300 | Rake 0=20
Seat 1: Paceman2jr (button) folded before Flop (didn't bet)
Seat 3: Scooo13zzz (small blind) collected (2300)
Seat 4: bethere1923 (big blind) folded before Flop
Seat 5: SJMayhem11 folded before Flop (didn't bet)
Seat 6: xNEMESISx04 folded before Flop (didn't bet)
Seat 7: JJin91 folded before Flop (didn't bet)
Seat 9: 4Aces518 folded before Flop (didn't bet)


*********** # 148 **************
PokerStars Hand #176127077093: Tournament #1701843149, $18.20+$1.80 USD=
 Hold'em No Limit - Level XV (500/1000) - 2017/10/09 21:32:40 ET
Table '1701843149 1' 9-max Seat #3 is the button
Seat 1: Paceman2jr (26597 in chips)=20
Seat 3: Scooo13zzz (31001 in chips)=20
Seat 4: bethere1923 (12744 in chips)=20
Seat 5: SJMayhem11 (17927 in chips)=20
Seat 6: xNEMESISx04 (14534 in chips)=20
Seat 7: JJin91 (56233 in chips)=20
Seat 9: 4Aces518 (27079 in chips)=20
Paceman2jr: posts the ante 125
Scooo13zzz: posts the ante 125
bethere1923: posts the ante 125
SJMayhem11: posts the ante 125
xNEMESISx04: posts the ante 125
JJin91: posts the ante 125
4Aces518: posts the ante 125
bethere1923: posts small blind 500
SJMayhem11: posts big blind 1000
*** HOLE CARDS ***
Dealt to JJin91 [5d Tc]
xNEMESISx04: folds=20
JJin91: folds=20
4Aces518: folds=20
Paceman2jr has timed out
Paceman2jr: folds=20
Paceman2jr is sitting out
Scooo13zzz: raises 1200 to 2200
Paceman2jr has returned
bethere1923: folds=20
SJMayhem11: folds=20
Uncalled bet (1200) returned to Scooo13zzz
Scooo13zzz collected 3375 from pot
*** SUMMARY ***
Total pot 3375 | Rake 0=20
Seat 1: Paceman2jr folded before Flop (didn't bet)
Seat 3: Scooo13zzz (button) collected (3375)
Seat 4: bethere1923 (small blind) folded before Flop
Seat 5: SJMayhem11 (big blind) folded before Flop
Seat 6: xNEMESISx04 folded before Flop (didn't bet)
Seat 7: JJin91 folded before Flop (didn't bet)
Seat 9: 4Aces518 folded before Flop (didn't bet)


*********** # 149 **************
PokerStars Hand #176127077303: Tournament #1701843149, $18.20+$1.80 USD=
 Hold'em No Limit - Level XV (500/1000) - 2017/10/09 21:33:29 ET
Table '1701843149 1' 9-max Seat #4 is the button
Seat 1: Paceman2jr (26472 in chips)=20
Seat 3: Scooo13zzz (33251 in chips)=20
Seat 4: bethere1923 (12119 in chips)=20
Seat 5: SJMayhem11 (16802 in chips)=20
Seat 6: xNEMESISx04 (14409 in chips)=20
Seat 7: JJin91 (56108 in chips)=20
Seat 9: 4Aces518 (26954 in chips)=20
Paceman2jr: posts the ante 125
Scooo13zzz: posts the ante 125
bethere1923: posts the ante 125
SJMayhem11: posts the ante 125
xNEMESISx04: posts the ante 125
JJin91: posts the ante 125
4Aces518: posts the ante 125
SJMayhem11: posts small blind 500
xNEMESISx04: posts big blind 1000
*** HOLE CARDS ***
Dealt to JJin91 [9h Ad]
JJin91: raises 1170 to 2170
4Aces518: folds=20
Paceman2jr: folds=20
Scooo13zzz: folds=20
bethere1923: folds=20
SJMayhem11: folds=20
xNEMESISx04: folds=20
Uncalled bet (1170) returned to JJin91
JJin91 collected 3375 from pot
JJin91: doesn't show hand=20
*** SUMMARY ***
Total pot 3375 | Rake 0=20
Seat 1: Paceman2jr folded before Flop (didn't bet)
Seat 3: Scooo13zzz folded before Flop (didn't bet)
Seat 4: bethere1923 (button) folded before Flop (didn't bet)
Seat 5: SJMayhem11 (small blind) folded before Flop
Seat 6: xNEMESISx04 (big blind) folded before Flop
Seat 7: JJin91 collected (3375)
Seat 9: 4Aces518 folded before Flop (didn't bet)


*********** # 150 **************
PokerStars Hand #176127077468: Tournament #1701843149, $18.20+$1.80 USD=
 Hold'em No Limit - Level XV (500/1000) - 2017/10/09 21:34:05 ET
Table '1701843149 1' 9-max Seat #5 is the button
Seat 1: Paceman2jr (26347 in chips)=20
Seat 3: Scooo13zzz (33126 in chips)=20
Seat 4: bethere1923 (11994 in chips)=20
Seat 5: SJMayhem11 (16177 in chips)=20
Seat 6: xNEMESISx04 (13284 in chips)=20
Seat 7: JJin91 (58358 in chips)=20
Seat 9: 4Aces518 (26829 in chips)=20
Paceman2jr: posts the ante 125
Scooo13zzz: posts the ante 125
bethere1923: posts the ante 125
SJMayhem11: posts the ante 125
xNEMESISx04: posts the ante 125
JJin91: posts the ante 125
4Aces518: posts the ante 125
xNEMESISx04: posts small blind 500
JJin91: posts big blind 1000
*** HOLE CARDS ***
Dealt to JJin91 [7s 3d]
4Aces518: calls 1000
Paceman2jr: folds=20
Scooo13zzz: folds=20
bethere1923: folds=20
SJMayhem11: folds=20
xNEMESISx04: folds=20
JJin91: checks=20
*** FLOP *** [7h Qd Qs]
JJin91: bets 1333
4Aces518: folds=20
Uncalled bet (1333) returned to JJin91
JJin91 collected 3375 from pot
JJin91: doesn't show hand=20
*** SUMMARY ***
Total pot 3375 | Rake 0=20
Board [7h Qd Qs]
Seat 1: Paceman2jr folded before Flop (didn't bet)
Seat 3: Scooo13zzz folded before Flop (didn't bet)
Seat 4: bethere1923 folded before Flop (didn't bet)
Seat 5: SJMayhem11 (button) folded before Flop (didn't bet)
Seat 6: xNEMESISx04 (small blind) folded before Flop
Seat 7: JJin91 (big blind) collected (3375)
Seat 9: 4Aces518 folded on the Flop


*********** # 151 **************
PokerStars Hand #176127077662: Tournament #1701843149, $18.20+$1.80 USD=
 Hold'em No Limit - Level XV (500/1000) - 2017/10/09 21:34:50 ET
Table '1701843149 1' 9-max Seat #6 is the button
Seat 1: Paceman2jr (26222 in chips)=20
Seat 3: Scooo13zzz (33001 in chips)=20
Seat 4: bethere1923 (11869 in chips)=20
Seat 5: SJMayhem11 (16052 in chips)=20
Seat 6: xNEMESISx04 (12659 in chips)=20
Seat 7: JJin91 (60608 in chips)=20
Seat 9: 4Aces518 (25704 in chips)=20
Paceman2jr: posts the ante 125
Scooo13zzz: posts the ante 125
bethere1923: posts the ante 125
SJMayhem11: posts the ante 125
xNEMESISx04: posts the ante 125
JJin91: posts the ante 125
4Aces518: posts the ante 125
JJin91: posts small blind 500
4Aces518: posts big blind 1000
*** HOLE CARDS ***
Dealt to JJin91 [4d 5c]
Paceman2jr: folds=20
Scooo13zzz: folds=20
bethere1923: raises 10744 to 11744 and is all-in
SJMayhem11: folds=20
xNEMESISx04: folds=20
JJin91: folds=20
4Aces518: folds=20
Uncalled bet (10744) returned to bethere1923
bethere1923 collected 3375 from pot
*** SUMMARY ***
Total pot 3375 | Rake 0=20
Seat 1: Paceman2jr folded before Flop (didn't bet)
Seat 3: Scooo13zzz folded before Flop (didn't bet)
Seat 4: bethere1923 collected (3375)
Seat 5: SJMayhem11 folded before Flop (didn't bet)
Seat 6: xNEMESISx04 (button) folded before Flop (didn't bet)
Seat 7: JJin91 (small blind) folded before Flop
Seat 9: 4Aces518 (big blind) folded before Flop


*********** # 152 **************
PokerStars Hand #176127077846: Tournament #1701843149, $18.20+$1.80 USD=
 Hold'em No Limit - Level XV (500/1000) - 2017/10/09 21:35:28 ET
Table '1701843149 1' 9-max Seat #7 is the button
Seat 1: Paceman2jr (26097 in chips)=20
Seat 3: Scooo13zzz (32876 in chips)=20
Seat 4: bethere1923 (14119 in chips)=20
Seat 5: SJMayhem11 (15927 in chips)=20
Seat 6: xNEMESISx04 (12534 in chips)=20
Seat 7: JJin91 (59983 in chips)=20
Seat 9: 4Aces518 (24579 in chips)=20
Paceman2jr: posts the ante 125
Scooo13zzz: posts the ante 125
bethere1923: posts the ante 125
SJMayhem11: posts the ante 125
xNEMESISx04: posts the ante 125
JJin91: posts the ante 125
4Aces518: posts the ante 125
4Aces518: posts small blind 500
Paceman2jr: posts big blind 1000
*** HOLE CARDS ***
Dealt to JJin91 [Kc Tc]
Scooo13zzz: folds=20
bethere1923: folds=20
SJMayhem11: folds=20
xNEMESISx04: raises 11409 to 12409 and is all-in
JJin91: folds=20
4Aces518: folds=20
Paceman2jr: folds=20
Uncalled bet (11409) returned to xNEMESISx04
xNEMESISx04 collected 3375 from pot
xNEMESISx04: doesn't show hand=20
*** SUMMARY ***
Total pot 3375 | Rake 0=20
Seat 1: Paceman2jr (big blind) folded before Flop
Seat 3: Scooo13zzz folded before Flop (didn't bet)
Seat 4: bethere1923 folded before Flop (didn't bet)
Seat 5: SJMayhem11 folded before Flop (didn't bet)
Seat 6: xNEMESISx04 collected (3375)
Seat 7: JJin91 (button) folded before Flop (didn't bet)
Seat 9: 4Aces518 (small blind) folded before Flop


*********** # 153 **************
PokerStars Hand #176127078028: Tournament #1701843149, $18.20+$1.80 USD=
 Hold'em No Limit - Level XV (500/1000) - 2017/10/09 21:36:13 ET
Table '1701843149 1' 9-max Seat #9 is the button
Seat 1: Paceman2jr (24972 in chips)=20
Seat 3: Scooo13zzz (32751 in chips)=20
Seat 4: bethere1923 (13994 in chips)=20
Seat 5: SJMayhem11 (15802 in chips)=20
Seat 6: xNEMESISx04 (14784 in chips)=20
Seat 7: JJin91 (59858 in chips)=20
Seat 9: 4Aces518 (23954 in chips)=20
Paceman2jr: posts the ante 125
Scooo13zzz: posts the ante 125
bethere1923: posts the ante 125
SJMayhem11: posts the ante 125
xNEMESISx04: posts the ante 125
JJin91: posts the ante 125
4Aces518: posts the ante 125
Paceman2jr: posts small blind 500
Scooo13zzz: posts big blind 1000
*** HOLE CARDS ***
Dealt to JJin91 [7c Th]
bethere1923: folds=20
SJMayhem11: folds=20
xNEMESISx04: folds=20
JJin91: folds=20
4Aces518: folds=20
Paceman2jr: folds=20
Uncalled bet (500) returned to Scooo13zzz
Scooo13zzz collected 1875 from pot
*** SUMMARY ***
Total pot 1875 | Rake 0=20
Seat 1: Paceman2jr (small blind) folded before Flop
Seat 3: Scooo13zzz (big blind) collected (1875)
Seat 4: bethere1923 folded before Flop (didn't bet)
Seat 5: SJMayhem11 folded before Flop (didn't bet)
Seat 6: xNEMESISx04 folded before Flop (didn't bet)
Seat 7: JJin91 folded before Flop (didn't bet)
Seat 9: 4Aces518 (button) folded before Flop (didn't bet)


*********** # 154 **************
PokerStars Hand #176127078127: Tournament #1701843149, $18.20+$1.80 USD=
 Hold'em No Limit - Level XV (500/1000) - 2017/10/09 21:36:38 ET
Table '1701843149 1' 9-max Seat #1 is the button
Seat 1: Paceman2jr (24347 in chips)=20
Seat 3: Scooo13zzz (34001 in chips)=20
Seat 4: bethere1923 (13869 in chips)=20
Seat 5: SJMayhem11 (15677 in chips)=20
Seat 6: xNEMESISx04 (14659 in chips)=20
Seat 7: JJin91 (59733 in chips)=20
Seat 9: 4Aces518 (23829 in chips)=20
Paceman2jr: posts the ante 125
Scooo13zzz: posts the ante 125
bethere1923: posts the ante 125
SJMayhem11: posts the ante 125
xNEMESISx04: posts the ante 125
JJin91: posts the ante 125
4Aces518: posts the ante 125
Scooo13zzz: posts small blind 500
bethere1923: posts big blind 1000
*** HOLE CARDS ***
Dealt to JJin91 [7c 9s]
SJMayhem11: folds=20
xNEMESISx04: raises 13534 to 14534 and is all-in
JJin91: folds=20
4Aces518: folds=20
Paceman2jr: folds=20
Scooo13zzz: folds=20
bethere1923: folds=20
Uncalled bet (13534) returned to xNEMESISx04
xNEMESISx04 collected 3375 from pot
xNEMESISx04: doesn't show hand=20
*** SUMMARY ***
Total pot 3375 | Rake 0=20
Seat 1: Paceman2jr (button) folded before Flop (didn't bet)
Seat 3: Scooo13zzz (small blind) folded before Flop
Seat 4: bethere1923 (big blind) folded before Flop
Seat 5: SJMayhem11 folded before Flop (didn't bet)
Seat 6: xNEMESISx04 collected (3375)
Seat 7: JJin91 folded before Flop (didn't bet)
Seat 9: 4Aces518 folded before Flop (didn't bet)


*********** # 155 **************
PokerStars Hand #176127078253: Tournament #1701843149, $18.20+$1.80 USD=
 Hold'em No Limit - Level XV (500/1000) - 2017/10/09 21:37:08 ET
Table '1701843149 1' 9-max Seat #3 is the button
Seat 1: Paceman2jr (24222 in chips)=20
Seat 3: Scooo13zzz (33376 in chips)=20
Seat 4: bethere1923 (12744 in chips)=20
Seat 5: SJMayhem11 (15552 in chips)=20
Seat 6: xNEMESISx04 (16909 in chips)=20
Seat 7: JJin91 (59608 in chips)=20
Seat 9: 4Aces518 (23704 in chips)=20
Paceman2jr: posts the ante 125
Scooo13zzz: posts the ante 125
bethere1923: posts the ante 125
SJMayhem11: posts the ante 125
xNEMESISx04: posts the ante 125
JJin91: posts the ante 125
4Aces518: posts the ante 125
bethere1923: posts small blind 500
SJMayhem11: posts big blind 1000
*** HOLE CARDS ***
Dealt to JJin91 [2s Qh]
xNEMESISx04: raises 15784 to 16784 and is all-in
JJin91: folds=20
4Aces518: folds=20
Paceman2jr: folds=20
Scooo13zzz: folds=20
bethere1923: folds=20
SJMayhem11: folds=20
Uncalled bet (15784) returned to xNEMESISx04
xNEMESISx04 collected 3375 from pot
xNEMESISx04: doesn't show hand=20
*** SUMMARY ***
Total pot 3375 | Rake 0=20
Seat 1: Paceman2jr folded before Flop (didn't bet)
Seat 3: Scooo13zzz (button) folded before Flop (didn't bet)
Seat 4: bethere1923 (small blind) folded before Flop
Seat 5: SJMayhem11 (big blind) folded before Flop
Seat 6: xNEMESISx04 collected (3375)
Seat 7: JJin91 folded before Flop (didn't bet)
Seat 9: 4Aces518 folded before Flop (didn't bet)


*********** # 156 **************
PokerStars Hand #176127078353: Tournament #1701843149, $18.20+$1.80 USD=
 Hold'em No Limit - Level XV (500/1000) - 2017/10/09 21:37:33 ET
Table '1701843149 1' 9-max Seat #4 is the button
Seat 1: Paceman2jr (24097 in chips)=20
Seat 2: Romet05 (14895 in chips)=20
Seat 3: Scooo13zzz (33251 in chips)=20
Seat 4: bethere1923 (12119 in chips)=20
Seat 5: SJMayhem11 (14427 in chips)=20
Seat 6: xNEMESISx04 (19159 in chips)=20
Seat 7: JJin91 (59483 in chips)=20
Seat 8: andypants8 (15887 in chips)=20
Seat 9: 4Aces518 (23579 in chips)=20
Paceman2jr: posts the ante 125
Romet05: posts the ante 125
Scooo13zzz: posts the ante 125
bethere1923: posts the ante 125
SJMayhem11: posts the ante 125
xNEMESISx04: posts the ante 125
JJin91: posts the ante 125
andypants8: posts the ante 125
4Aces518: posts the ante 125
SJMayhem11: posts small blind 500
xNEMESISx04: posts big blind 1000
*** HOLE CARDS ***
Dealt to JJin91 [6s 8d]
JJin91: folds=20
andypants8: folds=20
4Aces518: folds=20
Paceman2jr: folds=20
Romet05: folds=20
Scooo13zzz: folds=20
bethere1923: raises 10994 to 11994 and is all-in
SJMayhem11: folds=20
xNEMESISx04: folds=20
Uncalled bet (10994) returned to bethere1923
bethere1923 collected 3625 from pot
bethere1923: doesn't show hand=20
*** SUMMARY ***
Total pot 3625 | Rake 0=20
Seat 1: Paceman2jr folded before Flop (didn't bet)
Seat 2: Romet05 folded before Flop (didn't bet)
Seat 3: Scooo13zzz folded before Flop (didn't bet)
Seat 4: bethere1923 (button) collected (3625)
Seat 5: SJMayhem11 (small blind) folded before Flop
Seat 6: xNEMESISx04 (big blind) folded before Flop
Seat 7: JJin91 folded before Flop (didn't bet)
Seat 8: andypants8 folded before Flop (didn't bet)
Seat 9: 4Aces518 folded before Flop (didn't bet)


*********** # 157 **************
PokerStars Hand #176127078493: Tournament #1701843149, $18.20+$1.80 USD=
 Hold'em No Limit - Level XV (500/1000) - 2017/10/09 21:38:04 ET
Table '1701843149 1' 9-max Seat #5 is the button
Seat 1: Paceman2jr (23972 in chips)=20
Seat 2: Romet05 (14770 in chips)=20
Seat 3: Scooo13zzz (33126 in chips)=20
Seat 4: bethere1923 (14619 in chips)=20
Seat 5: SJMayhem11 (13802 in chips)=20
Seat 6: xNEMESISx04 (18034 in chips)=20
Seat 7: JJin91 (59358 in chips)=20
Seat 8: andypants8 (15762 in chips)=20
Seat 9: 4Aces518 (23454 in chips)=20
Paceman2jr: posts the ante 125
Romet05: posts the ante 125
Scooo13zzz: posts the ante 125
bethere1923: posts the ante 125
SJMayhem11: posts the ante 125
xNEMESISx04: posts the ante 125
JJin91: posts the ante 125
andypants8: posts the ante 125
4Aces518: posts the ante 125
xNEMESISx04: posts small blind 500
JJin91: posts big blind 1000
*** HOLE CARDS ***
Dealt to JJin91 [4h 4d]
andypants8: folds=20
4Aces518: folds=20
Paceman2jr: raises 2000 to 3000
Romet05: folds=20
Scooo13zzz: folds=20
bethere1923: folds=20
SJMayhem11: folds=20
xNEMESISx04: folds=20
JJin91: folds=20
Uncalled bet (2000) returned to Paceman2jr
Paceman2jr collected 3625 from pot
Paceman2jr: doesn't show hand=20
*** SUMMARY ***
Total pot 3625 | Rake 0=20
Seat 1: Paceman2jr collected (3625)
Seat 2: Romet05 folded before Flop (didn't bet)
Seat 3: Scooo13zzz folded before Flop (didn't bet)
Seat 4: bethere1923 folded before Flop (didn't bet)
Seat 5: SJMayhem11 (button) folded before Flop (didn't bet)
Seat 6: xNEMESISx04 (small blind) folded before Flop
Seat 7: JJin91 (big blind) folded before Flop
Seat 8: andypants8 folded before Flop (didn't bet)
Seat 9: 4Aces518 folded before Flop (didn't bet)


*********** # 158 **************
PokerStars Hand #176127078617: Tournament #1701843149, $18.20+$1.80 USD=
 Hold'em No Limit - Level XV (500/1000) - 2017/10/09 21:38:31 ET
Table '1701843149 1' 9-max Seat #6 is the button
Seat 1: Paceman2jr (26472 in chips)=20
Seat 2: Romet05 (14645 in chips)=20
Seat 3: Scooo13zzz (33001 in chips)=20
Seat 4: bethere1923 (14494 in chips)=20
Seat 5: SJMayhem11 (13677 in chips)=20
Seat 6: xNEMESISx04 (17409 in chips)=20
Seat 7: JJin91 (58233 in chips)=20
Seat 8: andypants8 (15637 in chips)=20
Seat 9: 4Aces518 (23329 in chips)=20
Paceman2jr: posts the ante 125
Romet05: posts the ante 125
Scooo13zzz: posts the ante 125
bethere1923: posts the ante 125
SJMayhem11: posts the ante 125
xNEMESISx04: posts the ante 125
JJin91: posts the ante 125
andypants8: posts the ante 125
4Aces518: posts the ante 125
JJin91: posts small blind 500
andypants8: posts big blind 1000
*** HOLE CARDS ***
Dealt to JJin91 [9h Td]
4Aces518: folds=20
Paceman2jr: folds=20
Romet05: folds=20
Scooo13zzz: folds=20
bethere1923: folds=20
SJMayhem11: folds=20
xNEMESISx04: raises 1200 to 2200
JJin91: folds=20
andypants8: raises 13312 to 15512 and is all-in
xNEMESISx04: folds=20
Uncalled bet (13312) returned to andypants8
andypants8 collected 6025 from pot
andypants8: doesn't show hand=20
*** SUMMARY ***
Total pot 6025 | Rake 0=20
Seat 1: Paceman2jr folded before Flop (didn't bet)
Seat 2: Romet05 folded before Flop (didn't bet)
Seat 3: Scooo13zzz folded before Flop (didn't bet)
Seat 4: bethere1923 folded before Flop (didn't bet)
Seat 5: SJMayhem11 folded before Flop (didn't bet)
Seat 6: xNEMESISx04 (button) folded before Flop
Seat 7: JJin91 (small blind) folded before Flop
Seat 8: andypants8 (big blind) collected (6025)
Seat 9: 4Aces518 folded before Flop (didn't bet)


*********** # 159 **************
PokerStars Hand #176127078870: Tournament #1701843149, $18.20+$1.80 USD=
 Hold'em No Limit - Level XV (500/1000) - 2017/10/09 21:39:20 ET
Table '1701843149 1' 9-max Seat #7 is the button
Seat 1: Paceman2jr (26347 in chips)=20
Seat 2: Romet05 (14520 in chips)=20
Seat 3: Scooo13zzz (32876 in chips)=20
Seat 4: bethere1923 (14369 in chips)=20
Seat 5: SJMayhem11 (13552 in chips)=20
Seat 6: xNEMESISx04 (15084 in chips)=20
Seat 7: JJin91 (57608 in chips)=20
Seat 8: andypants8 (19337 in chips)=20
Seat 9: 4Aces518 (23204 in chips)=20
Paceman2jr: posts the ante 125
Romet05: posts the ante 125
Scooo13zzz: posts the ante 125
bethere1923: posts the ante 125
SJMayhem11: posts the ante 125
xNEMESISx04: posts the ante 125
JJin91: posts the ante 125
andypants8: posts the ante 125
4Aces518: posts the ante 125
andypants8: posts small blind 500
4Aces518: posts big blind 1000
*** HOLE CARDS ***
Dealt to JJin91 [Jd 3s]
Paceman2jr: calls 1000
Romet05: folds=20
Scooo13zzz: folds=20
bethere1923: raises 13244 to 14244 and is all-in
SJMayhem11: folds=20
xNEMESISx04: folds=20
JJin91: folds=20
andypants8: folds=20
4Aces518: folds=20
Paceman2jr: folds=20
Uncalled bet (13244) returned to bethere1923
bethere1923 collected 4625 from pot
bethere1923: doesn't show hand=20
*** SUMMARY ***
Total pot 4625 | Rake 0=20
Seat 1: Paceman2jr folded before Flop
Seat 2: Romet05 folded before Flop (didn't bet)
Seat 3: Scooo13zzz folded before Flop (didn't bet)
Seat 4: bethere1923 collected (4625)
Seat 5: SJMayhem11 folded before Flop (didn't bet)
Seat 6: xNEMESISx04 folded before Flop (didn't bet)
Seat 7: JJin91 (button) folded before Flop (didn't bet)
Seat 8: andypants8 (small blind) folded before Flop
Seat 9: 4Aces518 (big blind) folded before Flop


*********** # 160 **************
PokerStars Hand #176127079029: Tournament #1701843149, $18.20+$1.80 USD=
 Hold'em No Limit - Level XV (500/1000) - 2017/10/09 21:39:56 ET
Table '1701843149 1' 9-max Seat #8 is the button
Seat 1: Paceman2jr (25222 in chips)=20
Seat 2: Romet05 (14395 in chips)=20
Seat 3: Scooo13zzz (32751 in chips)=20
Seat 4: bethere1923 (17869 in chips)=20
Seat 5: SJMayhem11 (13427 in chips)=20
Seat 6: xNEMESISx04 (14959 in chips)=20
Seat 7: JJin91 (57483 in chips)=20
Seat 8: andypants8 (18712 in chips)=20
Seat 9: 4Aces518 (22079 in chips)=20
Paceman2jr: posts the ante 125
Romet05: posts the ante 125
Scooo13zzz: posts the ante 125
bethere1923: posts the ante 125
SJMayhem11: posts the ante 125
xNEMESISx04: posts the ante 125
JJin91: posts the ante 125
andypants8: posts the ante 125
4Aces518: posts the ante 125
4Aces518: posts small blind 500
Paceman2jr: posts big blind 1000
*** HOLE CARDS ***
Dealt to JJin91 [Qs 4s]
Romet05: folds=20
Scooo13zzz: folds=20
bethere1923: raises 1020 to 2020
SJMayhem11: folds=20
xNEMESISx04: folds=20
JJin91: folds=20
andypants8: folds=20
4Aces518: folds=20
Paceman2jr: folds=20
Uncalled bet (1020) returned to bethere1923
bethere1923 collected 3625 from pot
*** SUMMARY ***
Total pot 3625 | Rake 0=20
Seat 1: Paceman2jr (big blind) folded before Flop
Seat 2: Romet05 folded before Flop (didn't bet)
Seat 3: Scooo13zzz folded before Flop (didn't bet)
Seat 4: bethere1923 collected (3625)
Seat 5: SJMayhem11 folded before Flop (didn't bet)
Seat 6: xNEMESISx04 folded before Flop (didn't bet)
Seat 7: JJin91 folded before Flop (didn't bet)
Seat 8: andypants8 (button) folded before Flop (didn't bet)
Seat 9: 4Aces518 (small blind) folded before Flop


*********** # 161 **************
PokerStars Hand #176127079183: Tournament #1701843149, $18.20+$1.80 USD=
 Hold'em No Limit - Level XV (500/1000) - 2017/10/09 21:40:26 ET
Table '1701843149 1' 9-max Seat #9 is the button
Seat 1: Paceman2jr (24097 in chips)=20
Seat 2: Romet05 (14270 in chips)=20
Seat 3: Scooo13zzz (32626 in chips)=20
Seat 4: bethere1923 (20369 in chips)=20
Seat 5: SJMayhem11 (13302 in chips)=20
Seat 6: xNEMESISx04 (14834 in chips)=20
Seat 7: JJin91 (57358 in chips)=20
Seat 8: andypants8 (18587 in chips)=20
Seat 9: 4Aces518 (21454 in chips)=20
Paceman2jr: posts the ante 125
Romet05: posts the ante 125
Scooo13zzz: posts the ante 125
bethere1923: posts the ante 125
SJMayhem11: posts the ante 125
xNEMESISx04: posts the ante 125
JJin91: posts the ante 125
andypants8: posts the ante 125
4Aces518: posts the ante 125
Paceman2jr: posts small blind 500
Romet05: posts big blind 1000
*** HOLE CARDS ***
Dealt to JJin91 [3h Jh]
Scooo13zzz: folds=20
bethere1923: folds=20
SJMayhem11: raises 1000 to 2000
xNEMESISx04: folds=20
JJin91: folds=20
andypants8: folds=20
4Aces518: folds=20
Paceman2jr: raises 21972 to 23972 and is all-in
Romet05: folds=20
SJMayhem11: calls 11177 and is all-in
Uncalled bet (10795) returned to Paceman2jr
*** FLOP *** [Jd 8h 2d]
*** TURN *** [Jd 8h 2d] [6s]
*** RIVER *** [Jd 8h 2d 6s] [4s]
*** SHOW DOWN ***
Paceman2jr: shows [Ks As] (high card Ace)
SJMayhem11: shows [Qh Qc] (a pair of Queens)
SJMayhem11 collected 28479 from pot
*** SUMMARY ***
Total pot 28479 | Rake 0=20
Board [Jd 8h 2d 6s 4s]
Seat 1: Paceman2jr (small blind) showed [Ks As] and lost with high card=
 Ace
Seat 2: Romet05 (big blind) folded before Flop
Seat 3: Scooo13zzz folded before Flop (didn't bet)
Seat 4: bethere1923 folded before Flop (didn't bet)
Seat 5: SJMayhem11 showed [Qh Qc] and won (28479) with a pair of Queens
Seat 6: xNEMESISx04 folded before Flop (didn't bet)
Seat 7: JJin91 folded before Flop (didn't bet)
Seat 8: andypants8 folded before Flop (didn't bet)
Seat 9: 4Aces518 (button) folded before Flop (didn't bet)


*********** # 162 **************
PokerStars Hand #176127079317: Tournament #1701843149, $18.20+$1.80 USD=
 Hold'em No Limit - Level XV (500/1000) - 2017/10/09 21:40:56 ET
Table '1701843149 1' 9-max Seat #1 is the button
Seat 1: Paceman2jr (10795 in chips)=20
Seat 2: Romet05 (13145 in chips)=20
Seat 3: Scooo13zzz (32501 in chips)=20
Seat 4: bethere1923 (20244 in chips)=20
Seat 5: SJMayhem11 (28479 in chips)=20
Seat 6: xNEMESISx04 (14709 in chips)=20
Seat 7: JJin91 (57233 in chips)=20
Seat 8: andypants8 (18462 in chips)=20
Seat 9: 4Aces518 (21329 in chips)=20
Paceman2jr: posts the ante 125
Romet05: posts the ante 125
Scooo13zzz: posts the ante 125
bethere1923: posts the ante 125
SJMayhem11: posts the ante 125
xNEMESISx04: posts the ante 125
JJin91: posts the ante 125
andypants8: posts the ante 125
4Aces518: posts the ante 125
Romet05: posts small blind 500
Scooo13zzz: posts big blind 1000
*** HOLE CARDS ***
Dealt to JJin91 [6c 4h]
bethere1923: folds=20
SJMayhem11: folds=20
xNEMESISx04: raises 13584 to 14584 and is all-in
JJin91: folds=20
andypants8: folds=20
4Aces518: folds=20
Paceman2jr: calls 10670 and is all-in
Romet05: folds=20
Scooo13zzz: folds=20
Uncalled bet (3914) returned to xNEMESISx04
*** FLOP *** [2s 7d 3d]
*** TURN *** [2s 7d 3d] [Qs]
*** RIVER *** [2s 7d 3d Qs] [7c]
*** SHOW DOWN ***
xNEMESISx04: shows [6h 6d] (two pair, Sevens and Sixes)
Paceman2jr: shows [Jc Kh] (a pair of Sevens)
xNEMESISx04 collected 23965 from pot
Paceman2jr finished the tournament in 35th place
*** SUMMARY ***
Total pot 23965 | Rake 0=20
Board [2s 7d 3d Qs 7c]
Seat 1: Paceman2jr (button) showed [Jc Kh] and lost with a pair of Seve=
ns
Seat 2: Romet05 (small blind) folded before Flop
Seat 3: Scooo13zzz (big blind) folded before Flop
Seat 4: bethere1923 folded before Flop (didn't bet)
Seat 5: SJMayhem11 folded before Flop (didn't bet)
Seat 6: xNEMESISx04 showed [6h 6d] and won (23965) with two pair, Seven=
s and Sixes
Seat 7: JJin91 folded before Flop (didn't bet)
Seat 8: andypants8 folded before Flop (didn't bet)
Seat 9: 4Aces518 folded before Flop (didn't bet)


*********** # 163 **************
PokerStars Hand #176127079436: Tournament #1701843149, $18.20+$1.80 USD=
 Hold'em No Limit - Level XV (500/1000) - 2017/10/09 21:41:21 ET
Table '1701843149 1' 9-max Seat #2 is the button
Seat 2: Romet05 (12520 in chips)=20
Seat 3: Scooo13zzz (31376 in chips)=20
Seat 4: bethere1923 (20119 in chips)=20
Seat 5: SJMayhem11 (28354 in chips)=20
Seat 6: xNEMESISx04 (27879 in chips)=20
Seat 7: JJin91 (57108 in chips)=20
Seat 8: andypants8 (18337 in chips)=20
Seat 9: 4Aces518 (21204 in chips)=20
Romet05: posts the ante 125
Scooo13zzz: posts the ante 125
bethere1923: posts the ante 125
SJMayhem11: posts the ante 125
xNEMESISx04: posts the ante 125
JJin91: posts the ante 125
andypants8: posts the ante 125
4Aces518: posts the ante 125
Scooo13zzz: posts small blind 500
bethere1923: posts big blind 1000
*** HOLE CARDS ***
Dealt to JJin91 [6d Jd]
SJMayhem11: folds=20
xNEMESISx04: folds=20
JJin91: folds=20
andypants8: folds=20
4Aces518: folds=20
Romet05: folds=20
Scooo13zzz: calls 500
bethere1923: checks=20
*** FLOP *** [Jc Qc 2c]
Scooo13zzz: checks=20
bethere1923: checks=20
*** TURN *** [Jc Qc 2c] [4h]
Scooo13zzz: checks=20
bethere1923: checks=20
*** RIVER *** [Jc Qc 2c 4h] [8s]
Scooo13zzz: checks=20
bethere1923: checks=20
*** SHOW DOWN ***
Scooo13zzz: shows [Ad Td] (high card Ace)
bethere1923: mucks hand=20
Scooo13zzz collected 3000 from pot
*** SUMMARY ***
Total pot 3000 | Rake 0=20
Board [Jc Qc 2c 4h 8s]
Seat 2: Romet05 (button) folded before Flop (didn't bet)
Seat 3: Scooo13zzz (small blind) showed [Ad Td] and won (3000) with hig=
h card Ace
Seat 4: bethere1923 (big blind) mucked [3h 5d]
Seat 5: SJMayhem11 folded before Flop (didn't bet)
Seat 6: xNEMESISx04 folded before Flop (didn't bet)
Seat 7: JJin91 folded before Flop (didn't bet)
Seat 8: andypants8 folded before Flop (didn't bet)
Seat 9: 4Aces518 folded before Flop (didn't bet)


*********** # 164 **************
PokerStars Hand #176127079616: Tournament #1701843149, $18.20+$1.80 USD=
 Hold'em No Limit - Level XV (500/1000) - 2017/10/09 21:41:59 ET
Table '1701843149 1' 9-max Seat #3 is the button
Seat 2: Romet05 (12395 in chips)=20
Seat 3: Scooo13zzz (33251 in chips)=20
Seat 4: bethere1923 (18994 in chips)=20
Seat 5: SJMayhem11 (28229 in chips)=20
Seat 6: xNEMESISx04 (27754 in chips)=20
Seat 7: JJin91 (56983 in chips)=20
Seat 8: andypants8 (18212 in chips)=20
Seat 9: 4Aces518 (21079 in chips)=20
Romet05: posts the ante 125
Scooo13zzz: posts the ante 125
bethere1923: posts the ante 125
SJMayhem11: posts the ante 125
xNEMESISx04: posts the ante 125
JJin91: posts the ante 125
andypants8: posts the ante 125
4Aces518: posts the ante 125
bethere1923: posts small blind 500
SJMayhem11: posts big blind 1000
*** HOLE CARDS ***
Dealt to JJin91 [9s Jc]
xNEMESISx04: folds=20
JJin91: folds=20
andypants8: raises 1222 to 2222
4Aces518: folds=20
Romet05: folds=20
Scooo13zzz: folds=20
bethere1923: folds=20
SJMayhem11: raises 5944 to 8166
andypants8: raises 9921 to 18087 and is all-in
SJMayhem11: calls 9921
*** FLOP *** [7s Ah 8h]
*** TURN *** [7s Ah 8h] [3c]
*** RIVER *** [7s Ah 8h 3c] [9d]
*** SHOW DOWN ***
SJMayhem11: shows [Td Th] (a pair of Tens)
andypants8: shows [7c 7h] (three of a kind, Sevens)
andypants8 collected 37674 from pot
SJMayhem11 said, "yup"
*** SUMMARY ***
Total pot 37674 | Rake 0=20
Board [7s Ah 8h 3c 9d]
Seat 2: Romet05 folded before Flop (didn't bet)
Seat 3: Scooo13zzz (button) folded before Flop (didn't bet)
Seat 4: bethere1923 (small blind) folded before Flop
Seat 5: SJMayhem11 (big blind) showed [Td Th] and lost with a pair of T=
ens
Seat 6: xNEMESISx04 folded before Flop (didn't bet)
Seat 7: JJin91 folded before Flop (didn't bet)
Seat 8: andypants8 showed [7c 7h] and won (37674) with three of a kind,=
 Sevens
Seat 9: 4Aces518 folded before Flop (didn't bet)


*********** # 165 **************
PokerStars Hand #176127079867: Tournament #1701843149, $18.20+$1.80 USD=
 Hold'em No Limit - Level XVI (600/1200) - 2017/10/09 21:42:50 ET
Table '1701843149 1' 9-max Seat #4 is the button
Seat 2: Romet05 (12270 in chips)=20
Seat 3: Scooo13zzz (33126 in chips)=20
Seat 4: bethere1923 (18369 in chips)=20
Seat 5: SJMayhem11 (10017 in chips)=20
Seat 6: xNEMESISx04 (27629 in chips)=20
Seat 7: JJin91 (56858 in chips)=20
Seat 8: andypants8 (37674 in chips)=20
Seat 9: 4Aces518 (20954 in chips)=20
Romet05: posts the ante 150
Scooo13zzz: posts the ante 150
bethere1923: posts the ante 150
SJMayhem11: posts the ante 150
xNEMESISx04: posts the ante 150
JJin91: posts the ante 150
andypants8: posts the ante 150
4Aces518: posts the ante 150
SJMayhem11: posts small blind 600
xNEMESISx04: posts big blind 1200
*** HOLE CARDS ***
Dealt to JJin91 [8c 6c]
JJin91: folds=20
andypants8: folds=20
4Aces518: folds=20
Romet05: folds=20
Scooo13zzz: folds=20
bethere1923: raises 1200 to 2400
SJMayhem11: folds=20
xNEMESISx04: folds=20
Uncalled bet (1200) returned to bethere1923
bethere1923 collected 4200 from pot
bethere1923: doesn't show hand=20
*** SUMMARY ***
Total pot 4200 | Rake 0=20
Seat 2: Romet05 folded before Flop (didn't bet)
Seat 3: Scooo13zzz folded before Flop (didn't bet)
Seat 4: bethere1923 (button) collected (4200)
Seat 5: SJMayhem11 (small blind) folded before Flop
Seat 6: xNEMESISx04 (big blind) folded before Flop
Seat 7: JJin91 folded before Flop (didn't bet)
Seat 8: andypants8 folded before Flop (didn't bet)
Seat 9: 4Aces518 folded before Flop (didn't bet)


*********** # 166 **************
PokerStars Hand #176127079986: Tournament #1701843149, $18.20+$1.80 USD=
 Hold'em No Limit - Level XVI (600/1200) - 2017/10/09 21:43:13 ET
Table '1701843149 1' 9-max Seat #5 is the button
Seat 2: Romet05 (12120 in chips)=20
Seat 3: Scooo13zzz (32976 in chips)=20
Seat 4: bethere1923 (21219 in chips)=20
Seat 5: SJMayhem11 (9267 in chips)=20
Seat 6: xNEMESISx04 (26279 in chips)=20
Seat 7: JJin91 (56708 in chips)=20
Seat 8: andypants8 (37524 in chips)=20
Seat 9: 4Aces518 (20804 in chips)=20
Romet05: posts the ante 150
Scooo13zzz: posts the ante 150
bethere1923: posts the ante 150
SJMayhem11: posts the ante 150
xNEMESISx04: posts the ante 150
JJin91: posts the ante 150
andypants8: posts the ante 150
4Aces518: posts the ante 150
xNEMESISx04: posts small blind 600
JJin91: posts big blind 1200
*** HOLE CARDS ***
Dealt to JJin91 [5s Ac]
andypants8: folds=20
4Aces518: folds=20
Romet05: folds=20
Scooo13zzz: folds=20
bethere1923: folds=20
SJMayhem11: folds=20
xNEMESISx04: raises 2400 to 3600
JJin91: calls 2400
*** FLOP *** [Td 2d Qh]
xNEMESISx04: bets 4100
JJin91: folds=20
Uncalled bet (4100) returned to xNEMESISx04
xNEMESISx04 collected 8400 from pot
xNEMESISx04: doesn't show hand=20
*** SUMMARY ***
Total pot 8400 | Rake 0=20
Board [Td 2d Qh]
Seat 2: Romet05 folded before Flop (didn't bet)
Seat 3: Scooo13zzz folded before Flop (didn't bet)
Seat 4: bethere1923 folded before Flop (didn't bet)
Seat 5: SJMayhem11 (button) folded before Flop (didn't bet)
Seat 6: xNEMESISx04 (small blind) collected (8400)
Seat 7: JJin91 (big blind) folded on the Flop
Seat 8: andypants8 folded before Flop (didn't bet)
Seat 9: 4Aces518 folded before Flop (didn't bet)


*********** # 167 **************
PokerStars Hand #176127571523: Tournament #1701843149, $18.20+$1.80 USD=
 Hold'em No Limit - Level XVI (600/1200) - 2017/10/09 21:43:55 ET
Table '1701843149 1' 9-max Seat #6 is the button
Seat 2: Romet05 (11970 in chips)=20
Seat 3: Scooo13zzz (32826 in chips)=20
Seat 4: bethere1923 (21069 in chips)=20
Seat 5: SJMayhem11 (9117 in chips)=20
Seat 6: xNEMESISx04 (30929 in chips)=20
Seat 7: JJin91 (52958 in chips)=20
Seat 8: andypants8 (37374 in chips)=20
Seat 9: 4Aces518 (20654 in chips)=20
Romet05: posts the ante 150
Scooo13zzz: posts the ante 150
bethere1923: posts the ante 150
SJMayhem11: posts the ante 150
xNEMESISx04: posts the ante 150
JJin91: posts the ante 150
andypants8: posts the ante 150
4Aces518: posts the ante 150
JJin91: posts small blind 600
andypants8: posts big blind 1200
*** HOLE CARDS ***
Dealt to JJin91 [6d Jd]
4Aces518: folds=20
Romet05: folds=20
Scooo13zzz: folds=20
bethere1923: folds=20
SJMayhem11: folds=20
xNEMESISx04: raises 1440 to 2640
JJin91: folds=20
andypants8: folds=20
Uncalled bet (1440) returned to xNEMESISx04
xNEMESISx04 collected 4200 from pot
xNEMESISx04: doesn't show hand=20
*** SUMMARY ***
Total pot 4200 | Rake 0=20
Seat 2: Romet05 folded before Flop (didn't bet)
Seat 3: Scooo13zzz folded before Flop (didn't bet)
Seat 4: bethere1923 folded before Flop (didn't bet)
Seat 5: SJMayhem11 folded before Flop (didn't bet)
Seat 6: xNEMESISx04 (button) collected (4200)
Seat 7: JJin91 (small blind) folded before Flop
Seat 8: andypants8 (big blind) folded before Flop
Seat 9: 4Aces518 folded before Flop (didn't bet)


*********** # 168 **************
PokerStars Hand #176127571626: Tournament #1701843149, $18.20+$1.80 USD=
 Hold'em No Limit - Level XVI (600/1200) - 2017/10/09 21:44:12 ET
Table '1701843149 1' 9-max Seat #7 is the button
Seat 2: Romet05 (11820 in chips)=20
Seat 3: Scooo13zzz (32676 in chips)=20
Seat 4: bethere1923 (20919 in chips)=20
Seat 5: SJMayhem11 (8967 in chips)=20
Seat 6: xNEMESISx04 (33779 in chips)=20
Seat 7: JJin91 (52208 in chips)=20
Seat 8: andypants8 (36024 in chips)=20
Seat 9: 4Aces518 (20504 in chips)=20
Romet05: posts the ante 150
Scooo13zzz: posts the ante 150
bethere1923: posts the ante 150
SJMayhem11: posts the ante 150
xNEMESISx04: posts the ante 150
JJin91: posts the ante 150
andypants8: posts the ante 150
4Aces518: posts the ante 150
andypants8: posts small blind 600
4Aces518: posts big blind 1200
*** HOLE CARDS ***
Dealt to JJin91 [9c 8s]
Romet05: folds=20
Scooo13zzz: folds=20
bethere1923: folds=20
SJMayhem11: folds=20
xNEMESISx04: folds=20
JJin91: raises 1404 to 2604
andypants8: folds=20
4Aces518: calls 1404
*** FLOP *** [Th 9s 5h]
4Aces518: checks=20
JJin91: bets 5111
4Aces518: folds=20
Uncalled bet (5111) returned to JJin91
JJin91 collected 7008 from pot
JJin91: doesn't show hand=20
*** SUMMARY ***
Total pot 7008 | Rake 0=20
Board [Th 9s 5h]
Seat 2: Romet05 folded before Flop (didn't bet)
Seat 3: Scooo13zzz folded before Flop (didn't bet)
Seat 4: bethere1923 folded before Flop (didn't bet)
Seat 5: SJMayhem11 folded before Flop (didn't bet)
Seat 6: xNEMESISx04 folded before Flop (didn't bet)
Seat 7: JJin91 (button) collected (7008)
Seat 8: andypants8 (small blind) folded before Flop
Seat 9: 4Aces518 (big blind) folded on the Flop


*********** # 169 **************
PokerStars Hand #176127571879: Tournament #1701843149, $18.20+$1.80 USD=
 Hold'em No Limit - Level XVI (600/1200) - 2017/10/09 21:45:04 ET
Table '1701843149 1' 9-max Seat #8 is the button
Seat 2: Romet05 (11670 in chips)=20
Seat 3: Scooo13zzz (32526 in chips)=20
Seat 4: bethere1923 (20769 in chips)=20
Seat 5: SJMayhem11 (8817 in chips)=20
Seat 6: xNEMESISx04 (33629 in chips)=20
Seat 7: JJin91 (56462 in chips)=20
Seat 8: andypants8 (35274 in chips)=20
Seat 9: 4Aces518 (17750 in chips)=20
Romet05: posts the ante 150
Scooo13zzz: posts the ante 150
bethere1923: posts the ante 150
SJMayhem11: posts the ante 150
xNEMESISx04: posts the ante 150
JJin91: posts the ante 150
andypants8: posts the ante 150
4Aces518: posts the ante 150
4Aces518: posts small blind 600
Romet05: posts big blind 1200
*** HOLE CARDS ***
Dealt to JJin91 [3s 6h]
Scooo13zzz: folds=20
bethere1923: folds=20
SJMayhem11: folds=20
xNEMESISx04: folds=20
JJin91: folds=20
andypants8: folds=20
4Aces518: raises 1200 to 2400
Romet05: folds=20
Uncalled bet (1200) returned to 4Aces518
4Aces518 collected 3600 from pot
4Aces518: doesn't show hand=20
*** SUMMARY ***
Total pot 3600 | Rake 0=20
Seat 2: Romet05 (big blind) folded before Flop
Seat 3: Scooo13zzz folded before Flop (didn't bet)
Seat 4: bethere1923 folded before Flop (didn't bet)
Seat 5: SJMayhem11 folded before Flop (didn't bet)
Seat 6: xNEMESISx04 folded before Flop (didn't bet)
Seat 7: JJin91 folded before Flop (didn't bet)
Seat 8: andypants8 (button) folded before Flop (didn't bet)
Seat 9: 4Aces518 (small blind) collected (3600)


*********** # 170 **************
PokerStars Hand #176127572010: Tournament #1701843149, $18.20+$1.80 USD=
 Hold'em No Limit - Level XVI (600/1200) - 2017/10/09 21:45:31 ET
Table '1701843149 1' 9-max Seat #9 is the button
Seat 2: Romet05 (10320 in chips)=20
Seat 3: Scooo13zzz (32376 in chips)=20
Seat 4: bethere1923 (20619 in chips)=20
Seat 5: SJMayhem11 (8667 in chips)=20
Seat 6: xNEMESISx04 (33479 in chips)=20
Seat 7: JJin91 (56312 in chips)=20
Seat 8: andypants8 (35124 in chips)=20
Seat 9: 4Aces518 (20000 in chips)=20
Romet05: posts the ante 150
Scooo13zzz: posts the ante 150
bethere1923: posts the ante 150
SJMayhem11: posts the ante 150
xNEMESISx04: posts the ante 150
JJin91: posts the ante 150
andypants8: posts the ante 150
4Aces518: posts the ante 150
Romet05: posts small blind 600
Scooo13zzz: posts big blind 1200
*** HOLE CARDS ***
Dealt to JJin91 [9s 7d]
bethere1923: folds=20
SJMayhem11: raises 7317 to 8517 and is all-in
xNEMESISx04: folds=20
JJin91: folds=20
andypants8: folds=20
4Aces518: folds=20
Romet05: folds=20
Scooo13zzz: folds=20
Uncalled bet (7317) returned to SJMayhem11
SJMayhem11 collected 4200 from pot
SJMayhem11: doesn't show hand=20
*** SUMMARY ***
Total pot 4200 | Rake 0=20
Seat 2: Romet05 (small blind) folded before Flop
Seat 3: Scooo13zzz (big blind) folded before Flop
Seat 4: bethere1923 folded before Flop (didn't bet)
Seat 5: SJMayhem11 collected (4200)
Seat 6: xNEMESISx04 folded before Flop (didn't bet)
Seat 7: JJin91 folded before Flop (didn't bet)
Seat 8: andypants8 folded before Flop (didn't bet)
Seat 9: 4Aces518 (button) folded before Flop (didn't bet)


*********** # 171 **************
PokerStars Hand #176127572096: Tournament #1701843149, $18.20+$1.80 USD=
 Hold'em No Limit - Level XVI (600/1200) - 2017/10/09 21:45:47 ET
Table '1701843149 1' 9-max Seat #2 is the button
Seat 2: Romet05 (9570 in chips)=20
Seat 3: Scooo13zzz (31026 in chips)=20
Seat 4: bethere1923 (20469 in chips)=20
Seat 5: SJMayhem11 (11517 in chips)=20
Seat 6: xNEMESISx04 (33329 in chips)=20
Seat 7: JJin91 (56162 in chips)=20
Seat 8: andypants8 (34974 in chips)=20
Seat 9: 4Aces518 (19850 in chips)=20
Romet05: posts the ante 150
Scooo13zzz: posts the ante 150
bethere1923: posts the ante 150
SJMayhem11: posts the ante 150
xNEMESISx04: posts the ante 150
JJin91: posts the ante 150
andypants8: posts the ante 150
4Aces518: posts the ante 150
Scooo13zzz: posts small blind 600
bethere1923: posts big blind 1200
*** HOLE CARDS ***
Dealt to JJin91 [As 4h]
SJMayhem11: folds=20
xNEMESISx04: folds=20
JJin91: folds=20
andypants8: folds=20
4Aces518: folds=20
Romet05: folds=20
Scooo13zzz: calls 600
bethere1923: checks=20
*** FLOP *** [2d Ac 7s]
Scooo13zzz: checks=20
bethere1923: checks=20
*** TURN *** [2d Ac 7s] [6d]
Scooo13zzz: checks=20
bethere1923: checks=20
*** RIVER *** [2d Ac 7s 6d] [5c]
Scooo13zzz: checks=20
bethere1923: checks=20
*** SHOW DOWN ***
Scooo13zzz: shows [Kd Js] (high card Ace)
bethere1923: mucks hand=20
Scooo13zzz collected 3600 from pot
*** SUMMARY ***
Total pot 3600 | Rake 0=20
Board [2d Ac 7s 6d 5c]
Seat 2: Romet05 (button) folded before Flop (didn't bet)
Seat 3: Scooo13zzz (small blind) showed [Kd Js] and won (3600) with hig=
h card Ace
Seat 4: bethere1923 (big blind) mucked [Qc 3c]
Seat 5: SJMayhem11 folded before Flop (didn't bet)
Seat 6: xNEMESISx04 folded before Flop (didn't bet)
Seat 7: JJin91 folded before Flop (didn't bet)
Seat 8: andypants8 folded before Flop (didn't bet)
Seat 9: 4Aces518 folded before Flop (didn't bet)


*********** # 172 **************
PokerStars Hand #176127572491: Tournament #1701843149, $18.20+$1.80 USD=
 Hold'em No Limit - Level XVI (600/1200) - 2017/10/09 21:47:02 ET
Table '1701843149 1' 9-max Seat #3 is the button
Seat 2: Romet05 (9420 in chips)=20
Seat 3: Scooo13zzz (33276 in chips)=20
Seat 4: bethere1923 (19119 in chips)=20
Seat 5: SJMayhem11 (11367 in chips)=20
Seat 6: xNEMESISx04 (33179 in chips)=20
Seat 7: JJin91 (56012 in chips)=20
Seat 8: andypants8 (34824 in chips)=20
Seat 9: 4Aces518 (19700 in chips)=20
Romet05: posts the ante 150
Scooo13zzz: posts the ante 150
bethere1923: posts the ante 150
SJMayhem11: posts the ante 150
xNEMESISx04: posts the ante 150
JJin91: posts the ante 150
andypants8: posts the ante 150
4Aces518: posts the ante 150
bethere1923: posts small blind 600
SJMayhem11: posts big blind 1200
*** HOLE CARDS ***
Dealt to JJin91 [7c Qd]
xNEMESISx04: folds=20
JJin91: folds=20
andypants8: folds=20
4Aces518: folds=20
Romet05: folds=20
Scooo13zzz: folds=20
bethere1923: raises 17769 to 18969 and is all-in
SJMayhem11: folds=20
Uncalled bet (17769) returned to bethere1923
bethere1923 collected 3600 from pot
*** SUMMARY ***
Total pot 3600 | Rake 0=20
Seat 2: Romet05 folded before Flop (didn't bet)
Seat 3: Scooo13zzz (button) folded before Flop (didn't bet)
Seat 4: bethere1923 (small blind) collected (3600)
Seat 5: SJMayhem11 (big blind) folded before Flop
Seat 6: xNEMESISx04 folded before Flop (didn't bet)
Seat 7: JJin91 folded before Flop (didn't bet)
Seat 8: andypants8 folded before Flop (didn't bet)
Seat 9: 4Aces518 folded before Flop (didn't bet)


*********** # 173 **************
PokerStars Hand #176127572630: Tournament #1701843149, $18.20+$1.80 USD=
 Hold'em No Limit - Level XVI (600/1200) - 2017/10/09 21:47:29 ET
Table '1701843149 1' 9-max Seat #4 is the button
Seat 2: Romet05 (9270 in chips)=20
Seat 3: Scooo13zzz (33126 in chips)=20
Seat 4: bethere1923 (21369 in chips)=20
Seat 5: SJMayhem11 (10017 in chips)=20
Seat 6: xNEMESISx04 (33029 in chips)=20
Seat 7: JJin91 (55862 in chips)=20
Seat 8: andypants8 (34674 in chips)=20
Seat 9: 4Aces518 (19550 in chips)=20
Romet05: posts the ante 150
Scooo13zzz: posts the ante 150
bethere1923: posts the ante 150
SJMayhem11: posts the ante 150
xNEMESISx04: posts the ante 150
JJin91: posts the ante 150
andypants8: posts the ante 150
4Aces518: posts the ante 150
SJMayhem11: posts small blind 600
xNEMESISx04: posts big blind 1200
*** HOLE CARDS ***
Dealt to JJin91 [5s Qd]
JJin91: folds=20
andypants8: folds=20
4Aces518: folds=20
Romet05: folds=20
Scooo13zzz: folds=20
bethere1923: folds=20
SJMayhem11: raises 8667 to 9867 and is all-in
xNEMESISx04: calls 8667
*** FLOP *** [4d Jc 8c]
*** TURN *** [4d Jc 8c] [6h]
*** RIVER *** [4d Jc 8c 6h] [4s]
*** SHOW DOWN ***
SJMayhem11: shows [Kh 6c] (two pair, Sixes and Fours)
xNEMESISx04: shows [Tc Td] (two pair, Tens and Fours)
xNEMESISx04 collected 20934 from pot
SJMayhem11 finished the tournament in 31st place
*** SUMMARY ***
Total pot 20934 | Rake 0=20
Board [4d Jc 8c 6h 4s]
Seat 2: Romet05 folded before Flop (didn't bet)
Seat 3: Scooo13zzz folded before Flop (didn't bet)
Seat 4: bethere1923 (button) folded before Flop (didn't bet)
Seat 5: SJMayhem11 (small blind) showed [Kh 6c] and lost with two pair,=
 Sixes and Fours
Seat 6: xNEMESISx04 (big blind) showed [Tc Td] and won (20934) with two=
 pair, Tens and Fours
Seat 7: JJin91 folded before Flop (didn't bet)
Seat 8: andypants8 folded before Flop (didn't bet)
Seat 9: 4Aces518 folded before Flop (didn't bet)


*********** # 174 **************
PokerStars Hand #176127572791: Tournament #1701843149, $18.20+$1.80 USD=
 Hold'em No Limit - Level XVI (600/1200) - 2017/10/09 21:48:00 ET
Table '1701843149 1' 9-max Seat #6 is the button
Seat 2: Romet05 (9120 in chips)=20
Seat 3: Scooo13zzz (32976 in chips)=20
Seat 4: bethere1923 (21219 in chips)=20
Seat 6: xNEMESISx04 (43946 in chips)=20
Seat 7: JJin91 (55712 in chips)=20
Seat 8: andypants8 (34524 in chips)=20
Seat 9: 4Aces518 (19400 in chips)=20
Romet05: posts the ante 150
Scooo13zzz: posts the ante 150
bethere1923: posts the ante 150
xNEMESISx04: posts the ante 150
JJin91: posts the ante 150
andypants8: posts the ante 150
4Aces518: posts the ante 150
JJin91: posts small blind 600
andypants8: posts big blind 1200
*** HOLE CARDS ***
Dealt to JJin91 [3d 3c]
4Aces518: folds=20
Romet05: raises 7770 to 8970 and is all-in
Scooo13zzz: folds=20
bethere1923: raises 12099 to 21069 and is all-in
xNEMESISx04: folds=20
JJin91: folds=20
andypants8: calls 19869
*** FLOP *** [Js 4d 8d]
*** TURN *** [Js 4d 8d] [2s]
Romet05 said, "2 morons"
*** RIVER *** [Js 4d 8d 2s] [5c]
*** SHOW DOWN ***
andypants8: shows [Ah Ac] (a pair of Aces)
bethere1923: shows [Kd Qc] (high card King)
andypants8 collected 24198 from side pot
Romet05: shows [9c 7c] (high card Jack)
andypants8 collected 28560 from main pot
bethere1923 finished the tournament in 28th place
Romet05 finished the tournament in 29th place
*** SUMMARY ***
Total pot 52758 Main pot 28560. Side pot 24198. | Rake 0=20
Board [Js 4d 8d 2s 5c]
Seat 2: Romet05 showed [9c 7c] and lost with high card Jack
Seat 3: Scooo13zzz folded before Flop (didn't bet)
Seat 4: bethere1923 showed [Kd Qc] and lost with high card King
Seat 6: xNEMESISx04 (button) folded before Flop (didn't bet)
Seat 7: JJin91 (small blind) folded before Flop
Seat 8: andypants8 (big blind) showed [Ah Ac] and won (52758) with a pa=
ir of Aces
Seat 9: 4Aces518 folded before Flop (didn't bet)


*********** # 175 **************
PokerStars Hand #176127572983: Tournament #1701843149, $18.20+$1.80 USD=
 Hold'em No Limit - Level XVI (600/1200) - 2017/10/09 21:48:36 ET
Table '1701843149 2' 9-max Seat #2 is the button
Seat 1: Bsgwolfpack4 (55860 in chips)=20
Seat 2: eitanisdaman (40840 in chips) is sitting out
Seat 3: wallstwst (22468 in chips)=20
Seat 4: xNEMESISx04 (43796 in chips)=20
Seat 5: apoch19 (36180 in chips)=20
Seat 6: JJin91 (54962 in chips)=20
Seat 7: YourRobotDad (20116 in chips)=20
Seat 8: eggstatic (55152 in chips)=20
Seat 9: Snookers8 (72510 in chips)=20
Bsgwolfpack4: posts the ante 150
eitanisdaman: posts the ante 150
wallstwst: posts the ante 150
xNEMESISx04: posts the ante 150
apoch19: posts the ante 150
JJin91: posts the ante 150
YourRobotDad: posts the ante 150
eggstatic: posts the ante 150
Snookers8: posts the ante 150
wallstwst: posts small blind 600
xNEMESISx04: posts big blind 1200
*** HOLE CARDS ***
Dealt to JJin91 [Js 2s]
apoch19: folds=20
JJin91: folds=20
YourRobotDad: folds=20
eggstatic: folds=20
Snookers8: folds=20
Bsgwolfpack4: folds=20
eitanisdaman: folds=20
wallstwst: raises 1200 to 2400
xNEMESISx04: calls 1200
*** FLOP *** [Kh 5c 8c]
wallstwst: bets 2030
xNEMESISx04: folds=20
Uncalled bet (2030) returned to wallstwst
wallstwst collected 6150 from pot
wallstwst: doesn't show hand=20
*** SUMMARY ***
Total pot 6150 | Rake 0=20
Board [Kh 5c 8c]
Seat 1: Bsgwolfpack4 folded before Flop (didn't bet)
Seat 2: eitanisdaman (button) folded before Flop (didn't bet)
Seat 3: wallstwst (small blind) collected (6150)
Seat 4: xNEMESISx04 (big blind) folded on the Flop
Seat 5: apoch19 folded before Flop (didn't bet)
Seat 6: JJin91 folded before Flop (didn't bet)
Seat 7: YourRobotDad folded before Flop (didn't bet)
Seat 8: eggstatic folded before Flop (didn't bet)
Seat 9: Snookers8 folded before Flop (didn't bet)


*********** # 176 **************
PokerStars Hand #176127573150: Tournament #1701843149, $18.20+$1.80 USD=
 Hold'em No Limit - Level XVI (600/1200) - 2017/10/09 21:49:10 ET
Table '1701843149 2' 9-max Seat #3 is the button
Seat 1: Bsgwolfpack4 (55710 in chips)=20
Seat 2: eitanisdaman (40690 in chips) is sitting out
Seat 3: wallstwst (26068 in chips)=20
Seat 4: xNEMESISx04 (41246 in chips)=20
Seat 5: apoch19 (36030 in chips)=20
Seat 6: JJin91 (54812 in chips)=20
Seat 7: YourRobotDad (19966 in chips)=20
Seat 8: eggstatic (55002 in chips)=20
Seat 9: Snookers8 (72360 in chips)=20
Bsgwolfpack4: posts the ante 150
eitanisdaman: posts the ante 150
wallstwst: posts the ante 150
xNEMESISx04: posts the ante 150
apoch19: posts the ante 150
JJin91: posts the ante 150
YourRobotDad: posts the ante 150
eggstatic: posts the ante 150
Snookers8: posts the ante 150
xNEMESISx04: posts small blind 600
apoch19: posts big blind 1200
*** HOLE CARDS ***
Dealt to JJin91 [8s Ac]
JJin91: folds=20
YourRobotDad: folds=20
eggstatic: folds=20
Snookers8: raises 2400 to 3600
Bsgwolfpack4: folds=20
eitanisdaman: folds=20
wallstwst: folds=20
xNEMESISx04: folds=20
apoch19: calls 2400
*** FLOP *** [5h 6d 8c]
apoch19: checks=20
Snookers8: checks=20
*** TURN *** [5h 6d 8c] [Jh]
apoch19: checks=20
Snookers8: checks=20
*** RIVER *** [5h 6d 8c Jh] [7d]
apoch19: bets 3950
Snookers8: folds=20
Uncalled bet (3950) returned to apoch19
apoch19 collected 9150 from pot
apoch19: doesn't show hand=20
*** SUMMARY ***
Total pot 9150 | Rake 0=20
Board [5h 6d 8c Jh 7d]
Seat 1: Bsgwolfpack4 folded before Flop (didn't bet)
Seat 2: eitanisdaman folded before Flop (didn't bet)
Seat 3: wallstwst (button) folded before Flop (didn't bet)
Seat 4: xNEMESISx04 (small blind) folded before Flop
Seat 5: apoch19 (big blind) collected (9150)
Seat 6: JJin91 folded before Flop (didn't bet)
Seat 7: YourRobotDad folded before Flop (didn't bet)
Seat 8: eggstatic folded before Flop (didn't bet)
Seat 9: Snookers8 folded on the River


*********** # 177 **************
PokerStars Hand #176127573434: Tournament #1701843149, $18.20+$1.80 USD=
 Hold'em No Limit - Level XVI (600/1200) - 2017/10/09 21:50:16 ET
Table '1701843149 2' 9-max Seat #4 is the button
Seat 1: Bsgwolfpack4 (55560 in chips)=20
Seat 2: eitanisdaman (40540 in chips) is sitting out
Seat 3: wallstwst (25918 in chips)=20
Seat 4: xNEMESISx04 (40496 in chips)=20
Seat 5: apoch19 (41430 in chips)=20
Seat 6: JJin91 (54662 in chips)=20
Seat 7: YourRobotDad (19816 in chips)=20
Seat 8: eggstatic (54852 in chips)=20
Seat 9: Snookers8 (68610 in chips)=20
Bsgwolfpack4: posts the ante 150
eitanisdaman: posts the ante 150
wallstwst: posts the ante 150
xNEMESISx04: posts the ante 150
apoch19: posts the ante 150
JJin91: posts the ante 150
YourRobotDad: posts the ante 150
eggstatic: posts the ante 150
Snookers8: posts the ante 150
apoch19: posts small blind 600
JJin91: posts big blind 1200
*** HOLE CARDS ***
Dealt to JJin91 [Jc Qc]
YourRobotDad: calls 1200
eggstatic: folds=20
Snookers8: folds=20
Bsgwolfpack4: folds=20
eitanisdaman: folds=20
wallstwst: folds=20
xNEMESISx04: raises 1440 to 2640
apoch19: folds=20
JJin91: calls 1440
YourRobotDad: calls 1440
*** FLOP *** [Kh 6h 8c]
JJin91: checks=20
YourRobotDad: checks=20
xNEMESISx04: checks=20
*** TURN *** [Kh 6h 8c] [Ac]
JJin91: checks=20
YourRobotDad: bets 4800
eitanisdaman has returned
xNEMESISx04: folds=20
JJin91: calls 4800
*** RIVER *** [Kh 6h 8c Ac] [Jd]
JJin91: checks=20
YourRobotDad: checks=20
*** SHOW DOWN ***
JJin91: shows [Jc Qc] (a pair of Jacks)
YourRobotDad: shows [2s As] (a pair of Aces)
YourRobotDad collected 19470 from pot
*** SUMMARY ***
Total pot 19470 | Rake 0=20
Board [Kh 6h 8c Ac Jd]
Seat 1: Bsgwolfpack4 folded before Flop (didn't bet)
Seat 2: eitanisdaman folded before Flop (didn't bet)
Seat 3: wallstwst folded before Flop (didn't bet)
Seat 4: xNEMESISx04 (button) folded on the Turn
Seat 5: apoch19 (small blind) folded before Flop
Seat 6: JJin91 (big blind) showed [Jc Qc] and lost with a pair of Jacks
Seat 7: YourRobotDad showed [2s As] and won (19470) with a pair of Aces
Seat 8: eggstatic folded before Flop (didn't bet)
Seat 9: Snookers8 folded before Flop (didn't bet)


*********** # 178 **************
PokerStars Hand #176127573758: Tournament #1701843149, $18.20+$1.80 USD=
 Hold'em No Limit - Level XVI (600/1200) - 2017/10/09 21:51:28 ET
Table '1701843149 2' 9-max Seat #5 is the button
Seat 1: Bsgwolfpack4 (55410 in chips)=20
Seat 2: eitanisdaman (40390 in chips)=20
Seat 3: wallstwst (25768 in chips)=20
Seat 4: xNEMESISx04 (37706 in chips)=20
Seat 5: apoch19 (40680 in chips)=20
Seat 6: JJin91 (47072 in chips)=20
Seat 7: YourRobotDad (31696 in chips)=20
Seat 8: eggstatic (54702 in chips)=20
Seat 9: Snookers8 (68460 in chips)=20
Bsgwolfpack4: posts the ante 150
eitanisdaman: posts the ante 150
wallstwst: posts the ante 150
xNEMESISx04: posts the ante 150
apoch19: posts the ante 150
JJin91: posts the ante 150
YourRobotDad: posts the ante 150
eggstatic: posts the ante 150
Snookers8: posts the ante 150
JJin91: posts small blind 600
YourRobotDad: posts big blind 1200
*** HOLE CARDS ***
Dealt to JJin91 [Jd 9d]
eggstatic: folds=20
Snookers8: folds=20
Bsgwolfpack4: folds=20
eitanisdaman: folds=20
wallstwst: folds=20
xNEMESISx04: folds=20
apoch19: folds=20
JJin91: raises 1404 to 2604
YourRobotDad: folds=20
Uncalled bet (1404) returned to JJin91
JJin91 collected 3750 from pot
JJin91: doesn't show hand=20
*** SUMMARY ***
Total pot 3750 | Rake 0=20
Seat 1: Bsgwolfpack4 folded before Flop (didn't bet)
Seat 2: eitanisdaman folded before Flop (didn't bet)
Seat 3: wallstwst folded before Flop (didn't bet)
Seat 4: xNEMESISx04 folded before Flop (didn't bet)
Seat 5: apoch19 (button) folded before Flop (didn't bet)
Seat 6: JJin91 (small blind) collected (3750)
Seat 7: YourRobotDad (big blind) folded before Flop
Seat 8: eggstatic folded before Flop (didn't bet)
Seat 9: Snookers8 folded before Flop (didn't bet)


*********** # 179 **************
PokerStars Hand #176127573930: Tournament #1701843149, $18.20+$1.80 USD=
 Hold'em No Limit - Level XVI (600/1200) - 2017/10/09 21:52:06 ET
Table '1701843149 2' 9-max Seat #6 is the button
Seat 1: Bsgwolfpack4 (55260 in chips)=20
Seat 2: eitanisdaman (40240 in chips)=20
Seat 3: wallstwst (25618 in chips)=20
Seat 4: xNEMESISx04 (37556 in chips)=20
Seat 5: apoch19 (40530 in chips)=20
Seat 6: JJin91 (49472 in chips)=20
Seat 7: YourRobotDad (30346 in chips)=20
Seat 8: eggstatic (54552 in chips)=20
Seat 9: Snookers8 (68310 in chips)=20
Bsgwolfpack4: posts the ante 150
eitanisdaman: posts the ante 150
wallstwst: posts the ante 150
xNEMESISx04: posts the ante 150
apoch19: posts the ante 150
JJin91: posts the ante 150
YourRobotDad: posts the ante 150
eggstatic: posts the ante 150
Snookers8: posts the ante 150
YourRobotDad: posts small blind 600
eggstatic: posts big blind 1200
*** HOLE CARDS ***
Dealt to JJin91 [4s 5c]
Snookers8: folds=20
Bsgwolfpack4: folds=20
eitanisdaman: folds=20
wallstwst: folds=20
xNEMESISx04: folds=20
apoch19: raises 1550 to 2750
JJin91: folds=20
YourRobotDad: folds=20
eggstatic: calls 1550
*** FLOP *** [6s Kd As]
eggstatic: checks=20
apoch19: checks=20
*** TURN *** [6s Kd As] [3d]
eggstatic: checks=20
apoch19: checks=20
*** RIVER *** [6s Kd As 3d] [5h]
eggstatic: bets 3725
apoch19: calls 3725
*** SHOW DOWN ***
eggstatic: shows [Ac Ks] (two pair, Aces and Kings)
apoch19: mucks hand=20
eggstatic collected 14900 from pot
*** SUMMARY ***
Total pot 14900 | Rake 0=20
Board [6s Kd As 3d 5h]
Seat 1: Bsgwolfpack4 folded before Flop (didn't bet)
Seat 2: eitanisdaman folded before Flop (didn't bet)
Seat 3: wallstwst folded before Flop (didn't bet)
Seat 4: xNEMESISx04 folded before Flop (didn't bet)
Seat 5: apoch19 mucked [Qd Kc]
Seat 6: JJin91 (button) folded before Flop (didn't bet)
Seat 7: YourRobotDad (small blind) folded before Flop
Seat 8: eggstatic (big blind) showed [Ac Ks] and won (14900) with two p=
air, Aces and Kings
Seat 9: Snookers8 folded before Flop (didn't bet)


*********** # 180 **************
PokerStars Hand #176127574249: Tournament #1701843149, $18.20+$1.80 USD=
 Hold'em No Limit - Level XVII (700/1400) - 2017/10/09 21:53:11 ET
Table '1701843149 2' 9-max Seat #7 is the button
Seat 1: Bsgwolfpack4 (55110 in chips)=20
Seat 3: wallstwst (25468 in chips)=20
Seat 4: xNEMESISx04 (37406 in chips)=20
Seat 5: apoch19 (33905 in chips)=20
Seat 6: JJin91 (49322 in chips)=20
Seat 7: YourRobotDad (29596 in chips)=20
Seat 8: eggstatic (62827 in chips)=20
Seat 9: Snookers8 (68160 in chips)=20
Bsgwolfpack4: posts the ante 175
wallstwst: posts the ante 175
xNEMESISx04: posts the ante 175
apoch19: posts the ante 175
JJin91: posts the ante 175
YourRobotDad: posts the ante 175
eggstatic: posts the ante 175
Snookers8: posts the ante 175
eggstatic: posts small blind 700
Snookers8: posts big blind 1400
*** HOLE CARDS ***
Dealt to JJin91 [Kh 7h]
Bsgwolfpack4: folds=20
wallstwst: folds=20
xNEMESISx04: folds=20
apoch19: folds=20
JJin91: raises 1638 to 3038
YourRobotDad: folds=20
eggstatic: folds=20
Snookers8: folds=20
Uncalled bet (1638) returned to JJin91
JJin91 collected 4900 from pot
JJin91: doesn't show hand=20
*** SUMMARY ***
Total pot 4900 | Rake 0=20
Seat 1: Bsgwolfpack4 folded before Flop (didn't bet)
Seat 3: wallstwst folded before Flop (didn't bet)
Seat 4: xNEMESISx04 folded before Flop (didn't bet)
Seat 5: apoch19 folded before Flop (didn't bet)
Seat 6: JJin91 collected (4900)
Seat 7: YourRobotDad (button) folded before Flop (didn't bet)
Seat 8: eggstatic (small blind) folded before Flop
Seat 9: Snookers8 (big blind) folded before Flop


*********** # 181 **************
PokerStars Hand #176127574332: Tournament #1701843149, $18.20+$1.80 USD=
 Hold'em No Limit - Level XVII (700/1400) - 2017/10/09 21:53:33 ET
Table '1701843149 2' 9-max Seat #8 is the button
Seat 1: Bsgwolfpack4 (54935 in chips)=20
Seat 3: wallstwst (25293 in chips)=20
Seat 4: xNEMESISx04 (37231 in chips)=20
Seat 5: apoch19 (33730 in chips)=20
Seat 6: JJin91 (52647 in chips)=20
Seat 7: YourRobotDad (29421 in chips)=20
Seat 8: eggstatic (61952 in chips)=20
Seat 9: Snookers8 (66585 in chips)=20
Bsgwolfpack4: posts the ante 175
wallstwst: posts the ante 175
xNEMESISx04: posts the ante 175
apoch19: posts the ante 175
JJin91: posts the ante 175
YourRobotDad: posts the ante 175
eggstatic: posts the ante 175
Snookers8: posts the ante 175
Snookers8: posts small blind 700
Bsgwolfpack4: posts big blind 1400
*** HOLE CARDS ***
Dealt to JJin91 [8h 9c]
wallstwst: raises 1400 to 2800
xNEMESISx04: folds=20
apoch19: folds=20
JJin91: folds=20
YourRobotDad: folds=20
eggstatic: folds=20
Snookers8: folds=20
Bsgwolfpack4: folds=20
Uncalled bet (1400) returned to wallstwst
wallstwst collected 4900 from pot
wallstwst: doesn't show hand=20
*** SUMMARY ***
Total pot 4900 | Rake 0=20
Seat 1: Bsgwolfpack4 (big blind) folded before Flop
Seat 3: wallstwst collected (4900)
Seat 4: xNEMESISx04 folded before Flop (didn't bet)
Seat 5: apoch19 folded before Flop (didn't bet)
Seat 6: JJin91 folded before Flop (didn't bet)
Seat 7: YourRobotDad folded before Flop (didn't bet)
Seat 8: eggstatic (button) folded before Flop (didn't bet)
Seat 9: Snookers8 (small blind) folded before Flop


*********** # 182 **************
PokerStars Hand #176127574449: Tournament #1701843149, $18.20+$1.80 USD=
 Hold'em No Limit - Level XVII (700/1400) - 2017/10/09 21:53:58 ET
Table '1701843149 2' 9-max Seat #9 is the button
Seat 1: Bsgwolfpack4 (53360 in chips)=20
Seat 3: wallstwst (28618 in chips)=20
Seat 4: xNEMESISx04 (37056 in chips)=20
Seat 5: apoch19 (33555 in chips)=20
Seat 6: JJin91 (52472 in chips)=20
Seat 7: YourRobotDad (29246 in chips)=20
Seat 8: eggstatic (61777 in chips)=20
Seat 9: Snookers8 (65710 in chips)=20
Bsgwolfpack4: posts the ante 175
wallstwst: posts the ante 175
xNEMESISx04: posts the ante 175
apoch19: posts the ante 175
JJin91: posts the ante 175
YourRobotDad: posts the ante 175
eggstatic: posts the ante 175
Snookers8: posts the ante 175
Bsgwolfpack4: posts small blind 700
wallstwst: posts big blind 1400
*** HOLE CARDS ***
Dealt to JJin91 [8s 5h]
xNEMESISx04: folds=20
apoch19: folds=20
JJin91: folds=20
YourRobotDad: folds=20
eggstatic: folds=20
Snookers8: folds=20
Bsgwolfpack4: folds=20
Uncalled bet (700) returned to wallstwst
wallstwst collected 2800 from pot
wallstwst: doesn't show hand=20
*** SUMMARY ***
Total pot 2800 | Rake 0=20
Seat 1: Bsgwolfpack4 (small blind) folded before Flop
Seat 3: wallstwst (big blind) collected (2800)
Seat 4: xNEMESISx04 folded before Flop (didn't bet)
Seat 5: apoch19 folded before Flop (didn't bet)
Seat 6: JJin91 folded before Flop (didn't bet)
Seat 7: YourRobotDad folded before Flop (didn't bet)
Seat 8: eggstatic folded before Flop (didn't bet)
Seat 9: Snookers8 (button) folded before Flop (didn't bet)


*********** # 183 **************
PokerStars Hand #176127574536: Tournament #1701843149, $18.20+$1.80 USD=
 Hold'em No Limit - Level XVII (700/1400) - 2017/10/09 21:54:17 ET
Table '1701843149 2' 9-max Seat #1 is the button
Seat 1: Bsgwolfpack4 (52485 in chips)=20
Seat 3: wallstwst (30543 in chips)=20
Seat 4: xNEMESISx04 (36881 in chips)=20
Seat 5: apoch19 (33380 in chips)=20
Seat 6: JJin91 (52297 in chips)=20
Seat 7: YourRobotDad (29071 in chips)=20
Seat 8: eggstatic (61602 in chips)=20
Seat 9: Snookers8 (65535 in chips)=20
Bsgwolfpack4: posts the ante 175
wallstwst: posts the ante 175
xNEMESISx04: posts the ante 175
apoch19: posts the ante 175
JJin91: posts the ante 175
YourRobotDad: posts the ante 175
eggstatic: posts the ante 175
Snookers8: posts the ante 175
wallstwst: posts small blind 700
xNEMESISx04: posts big blind 1400
*** HOLE CARDS ***
Dealt to JJin91 [7c Kc]
apoch19: folds=20
JJin91: folds=20
YourRobotDad: folds=20
eggstatic: folds=20
Snookers8: folds=20
Bsgwolfpack4: raises 2800 to 4200
wallstwst: folds=20
xNEMESISx04: calls 2800
*** FLOP *** [2h 6c 4d]
xNEMESISx04: checks=20
Bsgwolfpack4: bets 5925
xNEMESISx04: calls 5925
*** TURN *** [2h 6c 4d] [4c]
xNEMESISx04: bets 11200
Bsgwolfpack4: raises 30985 to 42185 and is all-in
xNEMESISx04: calls 15381 and is all-in
Uncalled bet (15604) returned to Bsgwolfpack4
*** RIVER *** [2h 6c 4d 4c] [Qs]
*** SHOW DOWN ***
xNEMESISx04: shows [3h 3s] (two pair, Fours and Threes)
Bsgwolfpack4: shows [Ac Qc] (two pair, Queens and Fours)
Bsgwolfpack4 collected 75512 from pot
xNEMESISx04 finished the tournament in 25th place
*** SUMMARY ***
Total pot 75512 | Rake 0=20
Board [2h 6c 4d 4c Qs]
Seat 1: Bsgwolfpack4 (button) showed [Ac Qc] and won (75512) with two p=
air, Queens and Fours
Seat 3: wallstwst (small blind) folded before Flop
Seat 4: xNEMESISx04 (big blind) showed [3h 3s] and lost with two pair, =
Fours and Threes
Seat 5: apoch19 folded before Flop (didn't bet)
Seat 6: JJin91 folded before Flop (didn't bet)
Seat 7: YourRobotDad folded before Flop (didn't bet)
Seat 8: eggstatic folded before Flop (didn't bet)
Seat 9: Snookers8 folded before Flop (didn't bet)


*********** # 184 **************
PokerStars Hand #176127575845: Tournament #1701843149, $18.20+$1.80 USD=
 Hold'em No Limit - Level XVII (700/1400) - 2017/10/09 22:00:41 ET
Table '1701843149 2' 9-max Seat #3 is the button
Seat 1: Bsgwolfpack4 (91116 in chips)=20
Seat 3: wallstwst (29668 in chips)=20
Seat 5: apoch19 (33205 in chips)=20
Seat 6: JJin91 (52122 in chips)=20
Seat 7: YourRobotDad (28896 in chips)=20
Seat 8: eggstatic (61427 in chips)=20
Seat 9: Snookers8 (65360 in chips)=20
Bsgwolfpack4: posts the ante 175
wallstwst: posts the ante 175
apoch19: posts the ante 175
JJin91: posts the ante 175
YourRobotDad: posts the ante 175
eggstatic: posts the ante 175
Snookers8: posts the ante 175
apoch19: posts small blind 700
JJin91: posts big blind 1400
*** HOLE CARDS ***
Dealt to JJin91 [Kc 2h]
YourRobotDad: folds=20
eggstatic: folds=20
Snookers8: folds=20
Bsgwolfpack4: folds=20
wallstwst: raises 1400 to 2800
apoch19: folds=20
JJin91: raises 4977 to 7777
wallstwst: folds=20
Uncalled bet (4977) returned to JJin91
JJin91 collected 7525 from pot
JJin91: doesn't show hand=20
*** SUMMARY ***
Total pot 7525 | Rake 0=20
Seat 1: Bsgwolfpack4 folded before Flop (didn't bet)
Seat 3: wallstwst (button) folded before Flop
Seat 5: apoch19 (small blind) folded before Flop
Seat 6: JJin91 (big blind) collected (7525)
Seat 7: YourRobotDad folded before Flop (didn't bet)
Seat 8: eggstatic folded before Flop (didn't bet)
Seat 9: Snookers8 folded before Flop (didn't bet)


*********** # 185 **************
PokerStars Hand #176127576105: Tournament #1701843149, $18.20+$1.80 USD=
 Hold'em No Limit - Level XVII (700/1400) - 2017/10/09 22:01:39 ET
Table '1701843149 2' 9-max Seat #5 is the button
Seat 1: Bsgwolfpack4 (90941 in chips)=20
Seat 3: wallstwst (26693 in chips)=20
Seat 5: apoch19 (32330 in chips)=20
Seat 6: JJin91 (56672 in chips)=20
Seat 7: YourRobotDad (28721 in chips)=20
Seat 8: eggstatic (61252 in chips)=20
Seat 9: Snookers8 (65185 in chips)=20
Bsgwolfpack4: posts the ante 175
wallstwst: posts the ante 175
apoch19: posts the ante 175
JJin91: posts the ante 175
YourRobotDad: posts the ante 175
eggstatic: posts the ante 175
Snookers8: posts the ante 175
JJin91: posts small blind 700
YourRobotDad: posts big blind 1400
*** HOLE CARDS ***
Dealt to JJin91 [3d Qc]
eggstatic: folds=20
Snookers8: folds=20
Bsgwolfpack4: raises 2800 to 4200
wallstwst: folds=20
apoch19: folds=20
JJin91: folds=20
YourRobotDad: folds=20
Uncalled bet (2800) returned to Bsgwolfpack4
Bsgwolfpack4 collected 4725 from pot
*** SUMMARY ***
Total pot 4725 | Rake 0=20
Seat 1: Bsgwolfpack4 collected (4725)
Seat 3: wallstwst folded before Flop (didn't bet)
Seat 5: apoch19 (button) folded before Flop (didn't bet)
Seat 6: JJin91 (small blind) folded before Flop
Seat 7: YourRobotDad (big blind) folded before Flop
Seat 8: eggstatic folded before Flop (didn't bet)
Seat 9: Snookers8 folded before Flop (didn't bet)


*********** # 186 **************
PokerStars Hand #176127576203: Tournament #1701843149, $18.20+$1.80 USD=
 Hold'em No Limit - Level XVII (700/1400) - 2017/10/09 22:02:02 ET
Table '1701843149 2' 9-max Seat #6 is the button
Seat 1: Bsgwolfpack4 (94091 in chips)=20
Seat 3: wallstwst (26518 in chips)=20
Seat 5: apoch19 (32155 in chips)=20
Seat 6: JJin91 (55797 in chips)=20
Seat 7: YourRobotDad (27146 in chips)=20
Seat 8: eggstatic (61077 in chips)=20
Seat 9: Snookers8 (65010 in chips)=20
Bsgwolfpack4: posts the ante 175
wallstwst: posts the ante 175
apoch19: posts the ante 175
JJin91: posts the ante 175
YourRobotDad: posts the ante 175
eggstatic: posts the ante 175
Snookers8: posts the ante 175
YourRobotDad: posts small blind 700
eggstatic: posts big blind 1400
*** HOLE CARDS ***
Dealt to JJin91 [9d 9s]
Snookers8: folds=20
Bsgwolfpack4: folds=20
wallstwst: folds=20
apoch19: folds=20
JJin91: raises 1638 to 3038
YourRobotDad: folds=20
eggstatic: folds=20
Uncalled bet (1638) returned to JJin91
JJin91 collected 4725 from pot
JJin91: doesn't show hand=20
*** SUMMARY ***
Total pot 4725 | Rake 0=20
Seat 1: Bsgwolfpack4 folded before Flop (didn't bet)
Seat 3: wallstwst folded before Flop (didn't bet)
Seat 5: apoch19 folded before Flop (didn't bet)
Seat 6: JJin91 (button) collected (4725)
Seat 7: YourRobotDad (small blind) folded before Flop
Seat 8: eggstatic (big blind) folded before Flop
Seat 9: Snookers8 folded before Flop (didn't bet)


*********** # 187 **************
PokerStars Hand #176127576292: Tournament #1701843149, $18.20+$1.80 USD=
 Hold'em No Limit - Level XVII (700/1400) - 2017/10/09 22:02:25 ET
Table '1701843149 2' 9-max Seat #7 is the button
Seat 1: Bsgwolfpack4 (93916 in chips)=20
Seat 3: wallstwst (26343 in chips)=20
Seat 5: apoch19 (31980 in chips)=20
Seat 6: JJin91 (58947 in chips)=20
Seat 7: YourRobotDad (26271 in chips)=20
Seat 8: eggstatic (59502 in chips)=20
Seat 9: Snookers8 (64835 in chips)=20
Bsgwolfpack4: posts the ante 175
wallstwst: posts the ante 175
apoch19: posts the ante 175
JJin91: posts the ante 175
YourRobotDad: posts the ante 175
eggstatic: posts the ante 175
Snookers8: posts the ante 175
eggstatic: posts small blind 700
Snookers8: posts big blind 1400
*** HOLE CARDS ***
Dealt to JJin91 [Ac Qd]
Bsgwolfpack4: folds=20
wallstwst: folds=20
apoch19: folds=20
JJin91: raises 1638 to 3038
YourRobotDad: folds=20
eggstatic: folds=20
Snookers8: raises 8001 to 11039
JJin91: calls 8001
*** FLOP *** [Jc 4s 9d]
Snookers8: bets 28000
JJin91: folds=20
Uncalled bet (28000) returned to Snookers8
Snookers8 collected 24003 from pot
Snookers8: doesn't show hand=20
*** SUMMARY ***
Total pot 24003 | Rake 0=20
Board [Jc 4s 9d]
Seat 1: Bsgwolfpack4 folded before Flop (didn't bet)
Seat 3: wallstwst folded before Flop (didn't bet)
Seat 5: apoch19 folded before Flop (didn't bet)
Seat 6: JJin91 folded on the Flop
Seat 7: YourRobotDad (button) folded before Flop (didn't bet)
Seat 8: eggstatic (small blind) folded before Flop
Seat 9: Snookers8 (big blind) collected (24003)


*********** # 188 **************
PokerStars Hand #176127576514: Tournament #1701843149, $18.20+$1.80 USD=
 Hold'em No Limit - Level XVII (700/1400) - 2017/10/09 22:03:14 ET
Table '1701843149 2' 9-max Seat #8 is the button
Seat 1: Bsgwolfpack4 (93741 in chips)=20
Seat 3: wallstwst (26168 in chips)=20
Seat 4: GUUUULP (22774 in chips)=20
Seat 5: apoch19 (31805 in chips)=20
Seat 6: JJin91 (47733 in chips)=20
Seat 7: YourRobotDad (26096 in chips)=20
Seat 8: eggstatic (58627 in chips)=20
Seat 9: Snookers8 (77624 in chips)=20
Bsgwolfpack4: posts the ante 175
wallstwst: posts the ante 175
GUUUULP: posts the ante 175
apoch19: posts the ante 175
JJin91: posts the ante 175
YourRobotDad: posts the ante 175
eggstatic: posts the ante 175
Snookers8: posts the ante 175
Snookers8: posts small blind 700
Bsgwolfpack4: posts big blind 1400
*** HOLE CARDS ***
Dealt to JJin91 [Jc 8c]
wallstwst: folds=20
GUUUULP: raises 1400 to 2800
apoch19: folds=20
JJin91: folds=20
YourRobotDad: folds=20
eggstatic: folds=20
Snookers8: folds=20
Bsgwolfpack4: folds=20
Uncalled bet (1400) returned to GUUUULP
GUUUULP collected 4900 from pot
*** SUMMARY ***
Total pot 4900 | Rake 0=20
Seat 1: Bsgwolfpack4 (big blind) folded before Flop
Seat 3: wallstwst folded before Flop (didn't bet)
Seat 4: GUUUULP collected (4900)
Seat 5: apoch19 folded before Flop (didn't bet)
Seat 6: JJin91 folded before Flop (didn't bet)
Seat 7: YourRobotDad folded before Flop (didn't bet)
Seat 8: eggstatic (button) folded before Flop (didn't bet)
Seat 9: Snookers8 (small blind) folded before Flop


*********** # 189 **************
PokerStars Hand #176127576608: Tournament #1701843149, $18.20+$1.80 USD=
 Hold'em No Limit - Level XVII (700/1400) - 2017/10/09 22:03:32 ET
Table '1701843149 2' 9-max Seat #9 is the button
Seat 1: Bsgwolfpack4 (92166 in chips)=20
Seat 3: wallstwst (25993 in chips)=20
Seat 4: GUUUULP (26099 in chips)=20
Seat 5: apoch19 (31630 in chips)=20
Seat 6: JJin91 (47558 in chips)=20
Seat 7: YourRobotDad (25921 in chips)=20
Seat 8: eggstatic (58452 in chips)=20
Seat 9: Snookers8 (76749 in chips)=20
Bsgwolfpack4: posts the ante 175
wallstwst: posts the ante 175
GUUUULP: posts the ante 175
apoch19: posts the ante 175
JJin91: posts the ante 175
YourRobotDad: posts the ante 175
eggstatic: posts the ante 175
Snookers8: posts the ante 175
Bsgwolfpack4: posts small blind 700
wallstwst: posts big blind 1400
*** HOLE CARDS ***
Dealt to JJin91 [Th 5s]
GUUUULP: folds=20
apoch19: folds=20
JJin91: folds=20
YourRobotDad: folds=20
eggstatic: raises 2800 to 4200
Snookers8: folds=20
Bsgwolfpack4: folds=20
wallstwst: calls 2800
*** FLOP *** [7s As Kd]
wallstwst: checks=20
eggstatic: checks=20
*** TURN *** [7s As Kd] [Kc]
wallstwst: checks=20
eggstatic: checks=20
*** RIVER *** [7s As Kd Kc] [7d]
wallstwst: bets 3465
eggstatic: folds=20
Uncalled bet (3465) returned to wallstwst
wallstwst collected 10500 from pot
wallstwst: doesn't show hand=20
*** SUMMARY ***
Total pot 10500 | Rake 0=20
Board [7s As Kd Kc 7d]
Seat 1: Bsgwolfpack4 (small blind) folded before Flop
Seat 3: wallstwst (big blind) collected (10500)
Seat 4: GUUUULP folded before Flop (didn't bet)
Seat 5: apoch19 folded before Flop (didn't bet)
Seat 6: JJin91 folded before Flop (didn't bet)
Seat 7: YourRobotDad folded before Flop (didn't bet)
Seat 8: eggstatic folded on the River
Seat 9: Snookers8 (button) folded before Flop (didn't bet)


*********** # 190 **************
PokerStars Hand #176127576809: Tournament #1701843149, $18.20+$1.80 USD=
 Hold'em No Limit - Level XVII (700/1400) - 2017/10/09 22:04:14 ET
Table '1701843149 2' 9-max Seat #1 is the button
Seat 1: Bsgwolfpack4 (91291 in chips)=20
Seat 3: wallstwst (32118 in chips)=20
Seat 4: GUUUULP (25924 in chips)=20
Seat 5: apoch19 (31455 in chips)=20
Seat 6: JJin91 (47383 in chips)=20
Seat 7: YourRobotDad (25746 in chips)=20
Seat 8: eggstatic (54077 in chips)=20
Seat 9: Snookers8 (76574 in chips)=20
Bsgwolfpack4: posts the ante 175
wallstwst: posts the ante 175
GUUUULP: posts the ante 175
apoch19: posts the ante 175
JJin91: posts the ante 175
YourRobotDad: posts the ante 175
eggstatic: posts the ante 175
Snookers8: posts the ante 175
wallstwst: posts small blind 700
GUUUULP: posts big blind 1400
*** HOLE CARDS ***
Dealt to JJin91 [Qc 6c]
apoch19: folds=20
JJin91: folds=20
YourRobotDad: folds=20
eggstatic: folds=20
Snookers8: folds=20
Bsgwolfpack4: folds=20
wallstwst: raises 1400 to 2800
GUUUULP: folds=20
Uncalled bet (1400) returned to wallstwst
wallstwst collected 4200 from pot
wallstwst: doesn't show hand=20
*** SUMMARY ***
Total pot 4200 | Rake 0=20
Seat 1: Bsgwolfpack4 (button) folded before Flop (didn't bet)
Seat 3: wallstwst (small blind) collected (4200)
Seat 4: GUUUULP (big blind) folded before Flop
Seat 5: apoch19 folded before Flop (didn't bet)
Seat 6: JJin91 folded before Flop (didn't bet)
Seat 7: YourRobotDad folded before Flop (didn't bet)
Seat 8: eggstatic folded before Flop (didn't bet)
Seat 9: Snookers8 folded before Flop (didn't bet)


*********** # 191 **************
PokerStars Hand #176127577043: Tournament #1701843149, $18.20+$1.80 USD=
 Hold'em No Limit - Level XVII (700/1400) - 2017/10/09 22:05:06 ET
Table '1701843149 2' 9-max Seat #3 is the button
Seat 1: Bsgwolfpack4 (91116 in chips)=20
Seat 3: wallstwst (34743 in chips)=20
Seat 4: GUUUULP (24349 in chips)=20
Seat 5: apoch19 (31280 in chips)=20
Seat 6: JJin91 (47208 in chips)=20
Seat 7: YourRobotDad (25571 in chips)=20
Seat 8: eggstatic (53902 in chips)=20
Seat 9: Snookers8 (76399 in chips)=20
Bsgwolfpack4: posts the ante 175
wallstwst: posts the ante 175
GUUUULP: posts the ante 175
apoch19: posts the ante 175
JJin91: posts the ante 175
YourRobotDad: posts the ante 175
eggstatic: posts the ante 175
Snookers8: posts the ante 175
GUUUULP: posts small blind 700
apoch19: posts big blind 1400
*** HOLE CARDS ***
Dealt to JJin91 [Ts 7c]
JJin91: folds=20
YourRobotDad: folds=20
eggstatic: folds=20
Snookers8: folds=20
Bsgwolfpack4: folds=20
wallstwst: folds=20
GUUUULP: calls 700
apoch19: raises 29705 to 31105 and is all-in
GUUUULP: folds=20
Uncalled bet (29705) returned to apoch19
apoch19 collected 4200 from pot
apoch19: doesn't show hand=20
*** SUMMARY ***
Total pot 4200 | Rake 0=20
Seat 1: Bsgwolfpack4 folded before Flop (didn't bet)
Seat 3: wallstwst (button) folded before Flop (didn't bet)
Seat 4: GUUUULP (small blind) folded before Flop
Seat 5: apoch19 (big blind) collected (4200)
Seat 6: JJin91 folded before Flop (didn't bet)
Seat 7: YourRobotDad folded before Flop (didn't bet)
Seat 8: eggstatic folded before Flop (didn't bet)
Seat 9: Snookers8 folded before Flop (didn't bet)


*********** # 192 **************
PokerStars Hand #176127577160: Tournament #1701843149, $18.20+$1.80 USD=
 Hold'em No Limit - Level XVII (700/1400) - 2017/10/09 22:05:33 ET
Table '1701843149 2' 9-max Seat #4 is the button
Seat 1: Bsgwolfpack4 (90941 in chips)=20
Seat 3: wallstwst (34568 in chips)=20
Seat 4: GUUUULP (22774 in chips)=20
Seat 5: apoch19 (33905 in chips)=20
Seat 6: JJin91 (47033 in chips)=20
Seat 7: YourRobotDad (25396 in chips)=20
Seat 8: eggstatic (53727 in chips)=20
Seat 9: Snookers8 (76224 in chips)=20
Bsgwolfpack4: posts the ante 175
wallstwst: posts the ante 175
GUUUULP: posts the ante 175
apoch19: posts the ante 175
JJin91: posts the ante 175
YourRobotDad: posts the ante 175
eggstatic: posts the ante 175
Snookers8: posts the ante 175
apoch19: posts small blind 700
JJin91: posts big blind 1400
*** HOLE CARDS ***
Dealt to JJin91 [Qd Jh]
YourRobotDad: folds=20
eggstatic: folds=20
Snookers8: folds=20
Bsgwolfpack4: raises 3100 to 4500
wallstwst: calls 4500
JJin91 is disconnected=20
GUUUULP: folds=20
apoch19: folds=20
JJin91 is connected=20
JJin91: folds=20
*** FLOP *** [Ks Jc 7c]
Bsgwolfpack4: bets 6675
wallstwst: folds=20
Uncalled bet (6675) returned to Bsgwolfpack4
Bsgwolfpack4 collected 12500 from pot
*** SUMMARY ***
Total pot 12500 | Rake 0=20
Board [Ks Jc 7c]
Seat 1: Bsgwolfpack4 collected (12500)
Seat 3: wallstwst folded on the Flop
Seat 4: GUUUULP (button) folded before Flop (didn't bet)
Seat 5: apoch19 (small blind) folded before Flop
Seat 6: JJin91 (big blind) folded before Flop
Seat 7: YourRobotDad folded before Flop (didn't bet)
Seat 8: eggstatic folded before Flop (didn't bet)
Seat 9: Snookers8 folded before Flop (didn't bet)


*********** # 193 **************
PokerStars Hand #176127577422: Tournament #1701843149, $18.20+$1.80 USD=
 Hold'em No Limit - Level XVII (700/1400) - 2017/10/09 22:06:33 ET
Table '1701843149 2' 9-max Seat #5 is the button
Seat 1: Bsgwolfpack4 (98766 in chips)=20
Seat 3: wallstwst (29893 in chips)=20
Seat 4: GUUUULP (22599 in chips)=20
Seat 5: apoch19 (33030 in chips)=20
Seat 6: JJin91 (45458 in chips)=20
Seat 7: YourRobotDad (25221 in chips)=20
Seat 8: eggstatic (53552 in chips)=20
Seat 9: Snookers8 (76049 in chips)=20
Bsgwolfpack4: posts the ante 175
wallstwst: posts the ante 175
GUUUULP: posts the ante 175
apoch19: posts the ante 175
JJin91: posts the ante 175
YourRobotDad: posts the ante 175
eggstatic: posts the ante 175
Snookers8: posts the ante 175
JJin91: posts small blind 700
YourRobotDad: posts big blind 1400
*** HOLE CARDS ***
Dealt to JJin91 [7h 8c]
eggstatic: folds=20
Snookers8: folds=20
Bsgwolfpack4: folds=20
wallstwst: raises 1400 to 2800
GUUUULP: folds=20
apoch19: folds=20
JJin91: folds=20
YourRobotDad: calls 1400
*** FLOP *** [Tc 2d 5c]
YourRobotDad: checks=20
wallstwst: bets 2800
YourRobotDad: calls 2800
*** TURN *** [Tc 2d 5c] [4c]
YourRobotDad: bets 7000
wallstwst: calls 7000
*** RIVER *** [Tc 2d 5c 4c] [Ks]
YourRobotDad: bets 12446 and is all-in
wallstwst: calls 12446
*** SHOW DOWN ***
YourRobotDad: shows [3c 3d] (a pair of Threes)
wallstwst: shows [Qh Kc] (a pair of Kings)
wallstwst collected 52192 from pot
YourRobotDad finished the tournament in 22nd place
*** SUMMARY ***
Total pot 52192 | Rake 0=20
Board [Tc 2d 5c 4c Ks]
Seat 1: Bsgwolfpack4 folded before Flop (didn't bet)
Seat 3: wallstwst showed [Qh Kc] and won (52192) with a pair of Kings
Seat 4: GUUUULP folded before Flop (didn't bet)
Seat 5: apoch19 (button) folded before Flop (didn't bet)
Seat 6: JJin91 (small blind) folded before Flop
Seat 7: YourRobotDad (big blind) showed [3c 3d] and lost with a pair of=
 Threes
Seat 8: eggstatic folded before Flop (didn't bet)
Seat 9: Snookers8 folded before Flop (didn't bet)


*********** # 194 **************
PokerStars Hand #176127577822: Tournament #1701843149, $18.20+$1.80 USD=
 Hold'em No Limit - Level XVIII (800/1600) - 2017/10/09 22:08:02 ET
Table '1701843149 2' 9-max Seat #6 is the button
Seat 1: Bsgwolfpack4 (98591 in chips)=20
Seat 3: wallstwst (56864 in chips)=20
Seat 4: GUUUULP (22424 in chips)=20
Seat 5: apoch19 (32855 in chips)=20
Seat 6: JJin91 (44583 in chips)=20
Seat 8: eggstatic (53377 in chips)=20
Seat 9: Snookers8 (75874 in chips)=20
Bsgwolfpack4: posts the ante 200
wallstwst: posts the ante 200
GUUUULP: posts the ante 200
apoch19: posts the ante 200
JJin91: posts the ante 200
eggstatic: posts the ante 200
Snookers8: posts the ante 200
eggstatic: posts small blind 800
Snookers8: posts big blind 1600
*** HOLE CARDS ***
Dealt to JJin91 [6c 9d]
Bsgwolfpack4: folds=20
wallstwst: folds=20
GUUUULP: folds=20
apoch19: folds=20
JJin91: folds=20
eggstatic: raises 1600 to 3200
Snookers8: raises 7800 to 11000
eggstatic: folds=20
Uncalled bet (7800) returned to Snookers8
Snookers8 collected 7800 from pot
Snookers8: doesn't show hand=20
*** SUMMARY ***
Total pot 7800 | Rake 0=20
Seat 1: Bsgwolfpack4 folded before Flop (didn't bet)
Seat 3: wallstwst folded before Flop (didn't bet)
Seat 4: GUUUULP folded before Flop (didn't bet)
Seat 5: apoch19 folded before Flop (didn't bet)
Seat 6: JJin91 (button) folded before Flop (didn't bet)
Seat 8: eggstatic (small blind) folded before Flop
Seat 9: Snookers8 (big blind) collected (7800)


*********** # 195 **************
PokerStars Hand #176127577997: Tournament #1701843149, $18.20+$1.80 USD=
 Hold'em No Limit - Level XVIII (800/1600) - 2017/10/09 22:08:38 ET
Table '1701843149 2' 9-max Seat #8 is the button
Seat 1: Bsgwolfpack4 (98391 in chips)=20
Seat 3: wallstwst (56664 in chips)=20
Seat 4: GUUUULP (22224 in chips)=20
Seat 5: apoch19 (32655 in chips)=20
Seat 6: JJin91 (44383 in chips)=20
Seat 8: eggstatic (49977 in chips)=20
Seat 9: Snookers8 (80274 in chips)=20
Bsgwolfpack4: posts the ante 200
wallstwst: posts the ante 200
GUUUULP: posts the ante 200
apoch19: posts the ante 200
JJin91: posts the ante 200
eggstatic: posts the ante 200
Snookers8: posts the ante 200
Snookers8: posts small blind 800
Bsgwolfpack4: posts big blind 1600
*** HOLE CARDS ***
Dealt to JJin91 [As Kd]
wallstwst: folds=20
GUUUULP: folds=20
apoch19: folds=20
JJin91: raises 1872 to 3472
eggstatic: calls 3472
Snookers8: folds=20
Bsgwolfpack4: calls 1872
*** FLOP *** [5d Kc Jh]
Bsgwolfpack4: checks=20
JJin91: bets 9210
eggstatic: folds=20
Bsgwolfpack4: folds=20
Uncalled bet (9210) returned to JJin91
JJin91 collected 12616 from pot
JJin91: doesn't show hand=20
*** SUMMARY ***
Total pot 12616 | Rake 0=20
Board [5d Kc Jh]
Seat 1: Bsgwolfpack4 (big blind) folded on the Flop
Seat 3: wallstwst folded before Flop (didn't bet)
Seat 4: GUUUULP folded before Flop (didn't bet)
Seat 5: apoch19 folded before Flop (didn't bet)
Seat 6: JJin91 collected (12616)
Seat 8: eggstatic (button) folded on the Flop
Seat 9: Snookers8 (small blind) folded before Flop


*********** # 196 **************
PokerStars Hand #176127578231: Tournament #1701843149, $18.20+$1.80 USD=
 Hold'em No Limit - Level XVIII (800/1600) - 2017/10/09 22:09:27 ET
Table '1701843149 2' 9-max Seat #9 is the button
Seat 1: Bsgwolfpack4 (94719 in chips)=20
Seat 3: wallstwst (56464 in chips)=20
Seat 4: GUUUULP (22024 in chips)=20
Seat 5: apoch19 (32455 in chips)=20
Seat 6: JJin91 (53327 in chips)=20
Seat 8: eggstatic (46305 in chips)=20
Seat 9: Snookers8 (79274 in chips)=20
Bsgwolfpack4: posts the ante 200
wallstwst: posts the ante 200
GUUUULP: posts the ante 200
apoch19: posts the ante 200
JJin91: posts the ante 200
eggstatic: posts the ante 200
Snookers8: posts the ante 200
Bsgwolfpack4: posts small blind 800
wallstwst: posts big blind 1600
*** HOLE CARDS ***
Dealt to JJin91 [Kd 2c]
GUUUULP: raises 1600 to 3200
apoch19: folds=20
JJin91: folds=20
eggstatic: folds=20
Snookers8: folds=20
Bsgwolfpack4: calls 2400
wallstwst: calls 1600
*** FLOP *** [Th 2d Jd]
Bsgwolfpack4: checks=20
wallstwst: checks=20
GUUUULP: bets 5830
Bsgwolfpack4: raises 5830 to 11660
wallstwst: folds=20
GUUUULP: raises 6964 to 18624 and is all-in
Bsgwolfpack4: calls 6964
*** TURN *** [Th 2d Jd] [Tc]
*** RIVER *** [Th 2d Jd Tc] [6s]
*** SHOW DOWN ***
Bsgwolfpack4: shows [Kc Jc] (two pair, Jacks and Tens)
GUUUULP: shows [Ac Ah] (two pair, Aces and Tens)
GUUUULP collected 48248 from pot
*** SUMMARY ***
Total pot 48248 | Rake 0=20
Board [Th 2d Jd Tc 6s]
Seat 1: Bsgwolfpack4 (small blind) showed [Kc Jc] and lost with two pai=
r, Jacks and Tens
Seat 3: wallstwst (big blind) folded on the Flop
Seat 4: GUUUULP showed [Ac Ah] and won (48248) with two pair, Aces and =
Tens
Seat 5: apoch19 folded before Flop (didn't bet)
Seat 6: JJin91 folded before Flop (didn't bet)
Seat 8: eggstatic folded before Flop (didn't bet)
Seat 9: Snookers8 (button) folded before Flop (didn't bet)


*********** # 197 **************
PokerStars Hand #176127578554: Tournament #1701843149, $18.20+$1.80 USD=
 Hold'em No Limit - Level XVIII (800/1600) - 2017/10/09 22:10:43 ET
Table '1701843149 2' 9-max Seat #1 is the button
Seat 1: Bsgwolfpack4 (72695 in chips)=20
Seat 3: wallstwst (53064 in chips)=20
Seat 4: GUUUULP (48248 in chips)=20
Seat 5: apoch19 (32255 in chips)=20
Seat 6: JJin91 (53127 in chips)=20
Seat 8: eggstatic (46105 in chips)=20
Seat 9: Snookers8 (79074 in chips)=20
Bsgwolfpack4: posts the ante 200
wallstwst: posts the ante 200
GUUUULP: posts the ante 200
apoch19: posts the ante 200
JJin91: posts the ante 200
eggstatic: posts the ante 200
Snookers8: posts the ante 200
wallstwst: posts small blind 800
GUUUULP: posts big blind 1600
*** HOLE CARDS ***
Dealt to JJin91 [9c 8c]
apoch19: folds=20
JJin91: raises 1872 to 3472
eggstatic: folds=20
Snookers8: folds=20
Bsgwolfpack4: folds=20
wallstwst: folds=20
GUUUULP: folds=20
Uncalled bet (1872) returned to JJin91
JJin91 collected 5400 from pot
JJin91: doesn't show hand=20
*** SUMMARY ***
Total pot 5400 | Rake 0=20
Seat 1: Bsgwolfpack4 (button) folded before Flop (didn't bet)
Seat 3: wallstwst (small blind) folded before Flop
Seat 4: GUUUULP (big blind) folded before Flop
Seat 5: apoch19 folded before Flop (didn't bet)
Seat 6: JJin91 collected (5400)
Seat 8: eggstatic folded before Flop (didn't bet)
Seat 9: Snookers8 folded before Flop (didn't bet)


*********** # 198 **************
PokerStars Hand #176127578803: Tournament #1701843149, $18.20+$1.80 USD=
 Hold'em No Limit - Level XVIII (800/1600) - 2017/10/09 22:11:34 ET
Table '1701843149 2' 9-max Seat #3 is the button
Seat 1: Bsgwolfpack4 (72495 in chips)=20
Seat 3: wallstwst (52064 in chips)=20
Seat 4: GUUUULP (46448 in chips)=20
Seat 5: apoch19 (32055 in chips)=20
Seat 6: JJin91 (56727 in chips)=20
Seat 8: eggstatic (45905 in chips)=20
Seat 9: Snookers8 (78874 in chips)=20
Bsgwolfpack4: posts the ante 200
wallstwst: posts the ante 200
GUUUULP: posts the ante 200
apoch19: posts the ante 200
JJin91: posts the ante 200
eggstatic: posts the ante 200
Snookers8: posts the ante 200
GUUUULP: posts small blind 800
apoch19: posts big blind 1600
*** HOLE CARDS ***
Dealt to JJin91 [Ad 7h]
JJin91: folds=20
eggstatic: folds=20
Snookers8: folds=20
Bsgwolfpack4: folds=20
wallstwst: folds=20
GUUUULP: raises 2704 to 4304
apoch19: folds=20
Uncalled bet (2704) returned to GUUUULP
GUUUULP collected 4600 from pot
*** SUMMARY ***
Total pot 4600 | Rake 0=20
Seat 1: Bsgwolfpack4 folded before Flop (didn't bet)
Seat 3: wallstwst (button) folded before Flop (didn't bet)
Seat 4: GUUUULP (small blind) collected (4600)
Seat 5: apoch19 (big blind) folded before Flop
Seat 6: JJin91 folded before Flop (didn't bet)
Seat 8: eggstatic folded before Flop (didn't bet)
Seat 9: Snookers8 folded before Flop (didn't bet)


*********** # 199 **************
PokerStars Hand #176127578929: Tournament #1701843149, $18.20+$1.80 USD=
 Hold'em No Limit - Level XVIII (800/1600) - 2017/10/09 22:12:05 ET
Table '1701843149 2' 9-max Seat #4 is the button
Seat 1: Bsgwolfpack4 (72295 in chips)=20
Seat 3: wallstwst (51864 in chips)=20
Seat 4: GUUUULP (49248 in chips)=20
Seat 5: apoch19 (30255 in chips)=20
Seat 6: JJin91 (56527 in chips)=20
Seat 8: eggstatic (45705 in chips)=20
Seat 9: Snookers8 (78674 in chips)=20
Bsgwolfpack4: posts the ante 200
wallstwst: posts the ante 200
GUUUULP: posts the ante 200
apoch19: posts the ante 200
JJin91: posts the ante 200
eggstatic: posts the ante 200
Snookers8: posts the ante 200
apoch19: posts small blind 800
JJin91: posts big blind 1600
*** HOLE CARDS ***
Dealt to JJin91 [4d Ks]
eggstatic: folds=20
Snookers8: raises 2400 to 4000
Bsgwolfpack4: folds=20
wallstwst: folds=20
GUUUULP: folds=20
apoch19: folds=20
JJin91: folds=20
Uncalled bet (2400) returned to Snookers8
Snookers8 collected 5400 from pot
Snookers8: doesn't show hand=20
*** SUMMARY ***
Total pot 5400 | Rake 0=20
Seat 1: Bsgwolfpack4 folded before Flop (didn't bet)
Seat 3: wallstwst folded before Flop (didn't bet)
Seat 4: GUUUULP (button) folded before Flop (didn't bet)
Seat 5: apoch19 (small blind) folded before Flop
Seat 6: JJin91 (big blind) folded before Flop
Seat 8: eggstatic folded before Flop (didn't bet)
Seat 9: Snookers8 collected (5400)


*********** # 200 **************
PokerStars Hand #176127579054: Tournament #1701843149, $18.20+$1.80 USD=
 Hold'em No Limit - Level XVIII (800/1600) - 2017/10/09 22:12:34 ET
Table '1701843149 2' 9-max Seat #5 is the button
Seat 1: Bsgwolfpack4 (72095 in chips)=20
Seat 3: wallstwst (51664 in chips)=20
Seat 4: GUUUULP (49048 in chips)=20
Seat 5: apoch19 (29255 in chips)=20
Seat 6: JJin91 (54727 in chips)=20
Seat 8: eggstatic (45505 in chips)=20
Seat 9: Snookers8 (82274 in chips)=20
Bsgwolfpack4: posts the ante 200
wallstwst: posts the ante 200
GUUUULP: posts the ante 200
apoch19: posts the ante 200
JJin91: posts the ante 200
eggstatic: posts the ante 200
Snookers8: posts the ante 200
JJin91: posts small blind 800
eggstatic: posts big blind 1600
*** HOLE CARDS ***
Dealt to JJin91 [8s Ks]
Snookers8: folds=20
Bsgwolfpack4: folds=20
wallstwst: folds=20
GUUUULP: folds=20
apoch19: folds=20
JJin91: raises 1872 to 3472
eggstatic: raises 41833 to 45305 and is all-in
JJin91: folds=20
Uncalled bet (41833) returned to eggstatic
eggstatic collected 8344 from pot
eggstatic: doesn't show hand=20
*** SUMMARY ***
Total pot 8344 | Rake 0=20
Seat 1: Bsgwolfpack4 folded before Flop (didn't bet)
Seat 3: wallstwst folded before Flop (didn't bet)
Seat 4: GUUUULP folded before Flop (didn't bet)
Seat 5: apoch19 (button) folded before Flop (didn't bet)
Seat 6: JJin91 (small blind) folded before Flop
Seat 8: eggstatic (big blind) collected (8344)
Seat 9: Snookers8 folded before Flop (didn't bet)


*********** # 201 **************
PokerStars Hand #176127579164: Tournament #1701843149, $18.20+$1.80 USD=
 Hold'em No Limit - Level XVIII (800/1600) - 2017/10/09 22:12:58 ET
Table '1701843149 2' 9-max Seat #6 is the button
Seat 1: Bsgwolfpack4 (71895 in chips)=20
Seat 3: wallstwst (51464 in chips)=20
Seat 4: GUUUULP (48848 in chips)=20
Seat 5: apoch19 (29055 in chips)=20
Seat 6: JJin91 (51055 in chips)=20
Seat 8: eggstatic (50177 in chips)=20
Seat 9: Snookers8 (82074 in chips)=20
Bsgwolfpack4: posts the ante 200
wallstwst: posts the ante 200
GUUUULP: posts the ante 200
apoch19: posts the ante 200
JJin91: posts the ante 200
eggstatic: posts the ante 200
Snookers8: posts the ante 200
eggstatic: posts small blind 800
Snookers8: posts big blind 1600
*** HOLE CARDS ***
Dealt to JJin91 [Kc 7d]
Bsgwolfpack4: folds=20
wallstwst: folds=20
GUUUULP: folds=20
apoch19: raises 2250 to 3850
JJin91: folds=20
eggstatic: folds=20
Snookers8: folds=20
Uncalled bet (2250) returned to apoch19
apoch19 collected 5400 from pot
apoch19: doesn't show hand=20
*** SUMMARY ***
Total pot 5400 | Rake 0=20
Seat 1: Bsgwolfpack4 folded before Flop (didn't bet)
Seat 3: wallstwst folded before Flop (didn't bet)
Seat 4: GUUUULP folded before Flop (didn't bet)
Seat 5: apoch19 collected (5400)
Seat 6: JJin91 (button) folded before Flop (didn't bet)
Seat 8: eggstatic (small blind) folded before Flop
Seat 9: Snookers8 (big blind) folded before Flop


*********** # 202 **************
PokerStars Hand #176127579562: Tournament #1701843149, $18.20+$1.80 USD=
 Hold'em No Limit - Level XVIII (800/1600) - 2017/10/09 22:14:30 ET
Table '1701843149 2' 9-max Seat #8 is the button
Seat 1: Bsgwolfpack4 (71695 in chips)=20
Seat 3: wallstwst (51264 in chips)=20
Seat 4: GUUUULP (48648 in chips)=20
Seat 6: JJin91 (50855 in chips)=20
Seat 8: eggstatic (49177 in chips)=20
Seat 9: Snookers8 (80274 in chips)=20
Bsgwolfpack4: posts the ante 200
wallstwst: posts the ante 200
GUUUULP: posts the ante 200
JJin91: posts the ante 200
eggstatic: posts the ante 200
Snookers8: posts the ante 200
Snookers8: posts small blind 800
Bsgwolfpack4: posts big blind 1600
*** HOLE CARDS ***
Dealt to JJin91 [Kc 5d]
wallstwst: folds=20
GUUUULP: raises 1936 to 3536
JJin91: folds=20
eggstatic: folds=20
Snookers8: folds=20
Bsgwolfpack4: folds=20
Uncalled bet (1936) returned to GUUUULP
GUUUULP collected 5200 from pot
*** SUMMARY ***
Total pot 5200 | Rake 0=20
Seat 1: Bsgwolfpack4 (big blind) folded before Flop
Seat 3: wallstwst folded before Flop (didn't bet)
Seat 4: GUUUULP collected (5200)
Seat 6: JJin91 folded before Flop (didn't bet)
Seat 8: eggstatic (button) folded before Flop (didn't bet)
Seat 9: Snookers8 (small blind) folded before Flop


*********** # 203 **************
PokerStars Hand #176127579896: Tournament #1701843149, $18.20+$1.80 USD=
 Hold'em No Limit - Level XVIII (800/1600) - 2017/10/09 22:15:47 ET
Table '1701843149 2' 9-max Seat #9 is the button
Seat 1: Bsgwolfpack4 (69895 in chips)=20
Seat 3: wallstwst (51064 in chips)=20
Seat 4: GUUUULP (52048 in chips)=20
Seat 6: JJin91 (50655 in chips)=20
Seat 8: eggstatic (48977 in chips)=20
Seat 9: Snookers8 (79274 in chips)=20
Bsgwolfpack4: posts the ante 200
wallstwst: posts the ante 200
GUUUULP: posts the ante 200
JJin91: posts the ante 200
eggstatic: posts the ante 200
Snookers8: posts the ante 200
Bsgwolfpack4: posts small blind 800
wallstwst: posts big blind 1600
*** HOLE CARDS ***
Dealt to JJin91 [As 8c]
GUUUULP: folds=20
JJin91: raises 1872 to 3472
eggstatic: folds=20
Snookers8: folds=20
Bsgwolfpack4: folds=20
wallstwst: calls 1872
*** FLOP *** [Th 2s Ah]
wallstwst: checks=20
JJin91: checks=20
*** TURN *** [Th 2s Ah] [Qh]
wallstwst: checks=20
JJin91: bets 4444
wallstwst: folds=20
Uncalled bet (4444) returned to JJin91
JJin91 collected 8944 from pot
JJin91: doesn't show hand=20
*** SUMMARY ***
Total pot 8944 | Rake 0=20
Board [Th 2s Ah Qh]
Seat 1: Bsgwolfpack4 (small blind) folded before Flop
Seat 3: wallstwst (big blind) folded on the Turn
Seat 4: GUUUULP folded before Flop (didn't bet)
Seat 6: JJin91 collected (8944)
Seat 8: eggstatic folded before Flop (didn't bet)
Seat 9: Snookers8 (button) folded before Flop (didn't bet)


*********** # 204 **************
PokerStars Hand #176128627053: Tournament #1701843149, $18.20+$1.80 USD=
 Hold'em No Limit - Level XVIII (800/1600) - 2017/10/09 22:16:44 ET
Table '1701843149 2' 9-max Seat #1 is the button
Seat 1: Bsgwolfpack4 (68895 in chips)=20
Seat 3: wallstwst (47392 in chips)=20
Seat 4: GUUUULP (51848 in chips)=20
Seat 6: JJin91 (55927 in chips)=20
Seat 8: eggstatic (48777 in chips)=20
Seat 9: Snookers8 (79074 in chips)=20
Bsgwolfpack4: posts the ante 200
wallstwst: posts the ante 200
GUUUULP: posts the ante 200
JJin91: posts the ante 200
eggstatic: posts the ante 200
Snookers8: posts the ante 200
wallstwst: posts small blind 800
GUUUULP: posts big blind 1600
*** HOLE CARDS ***
Dealt to JJin91 [8s Kc]
JJin91: folds=20
eggstatic: folds=20
Snookers8: folds=20
Bsgwolfpack4: raises 3200 to 4800
wallstwst: folds=20
GUUUULP: folds=20
Uncalled bet (3200) returned to Bsgwolfpack4
Bsgwolfpack4 collected 5200 from pot
*** SUMMARY ***
Total pot 5200 | Rake 0=20
Seat 1: Bsgwolfpack4 (button) collected (5200)
Seat 3: wallstwst (small blind) folded before Flop
Seat 4: GUUUULP (big blind) folded before Flop
Seat 6: JJin91 folded before Flop (didn't bet)
Seat 8: eggstatic folded before Flop (didn't bet)
Seat 9: Snookers8 folded before Flop (didn't bet)


*********** # 205 **************
PokerStars Hand #176128627237: Tournament #1701843149, $18.20+$1.80 USD=
 Hold'em No Limit - Level XVIII (800/1600) - 2017/10/09 22:17:23 ET
Table '1701843149 2' 9-max Seat #3 is the button
Seat 1: Bsgwolfpack4 (72295 in chips)=20
Seat 3: wallstwst (46392 in chips)=20
Seat 4: GUUUULP (50048 in chips)=20
Seat 6: JJin91 (55727 in chips)=20
Seat 8: eggstatic (48577 in chips)=20
Seat 9: Snookers8 (78874 in chips)=20
Bsgwolfpack4: posts the ante 200
wallstwst: posts the ante 200
GUUUULP: posts the ante 200
JJin91: posts the ante 200
eggstatic: posts the ante 200
Snookers8: posts the ante 200
GUUUULP: posts small blind 800
JJin91: posts big blind 1600
*** HOLE CARDS ***
Dealt to JJin91 [7c Qc]
eggstatic: folds=20
Snookers8: folds=20
Bsgwolfpack4: folds=20
wallstwst: folds=20
GUUUULP: folds=20
Uncalled bet (800) returned to JJin91
JJin91 collected 2800 from pot
JJin91: doesn't show hand=20
*** SUMMARY ***
Total pot 2800 | Rake 0=20
Seat 1: Bsgwolfpack4 folded before Flop (didn't bet)
Seat 3: wallstwst (button) folded before Flop (didn't bet)
Seat 4: GUUUULP (small blind) folded before Flop
Seat 6: JJin91 (big blind) collected (2800)
Seat 8: eggstatic folded before Flop (didn't bet)
Seat 9: Snookers8 folded before Flop (didn't bet)


*********** # 206 **************
PokerStars Hand #176128627428: Tournament #1701843149, $18.20+$1.80 USD=
 Hold'em No Limit - Level XIX (1000/2000) - 2017/10/09 22:18:06 ET
Table '1701843149 2' 9-max Seat #4 is the button
Seat 1: Bsgwolfpack4 (72095 in chips)=20
Seat 3: wallstwst (46192 in chips)=20
Seat 4: GUUUULP (49048 in chips)=20
Seat 6: JJin91 (57527 in chips)=20
Seat 8: eggstatic (48377 in chips)=20
Seat 9: Snookers8 (78674 in chips)=20
Bsgwolfpack4: posts the ante 250
wallstwst: posts the ante 250
GUUUULP: posts the ante 250
JJin91: posts the ante 250
eggstatic: posts the ante 250
Snookers8: posts the ante 250
JJin91: posts small blind 1000
eggstatic: posts big blind 2000
*** HOLE CARDS ***
Dealt to JJin91 [8s 5h]
Snookers8: folds=20
Bsgwolfpack4: raises 4500 to 6500
wallstwst: folds=20
GUUUULP: folds=20
JJin91: folds=20
eggstatic: folds=20
Uncalled bet (4500) returned to Bsgwolfpack4
Bsgwolfpack4 collected 6500 from pot
*** SUMMARY ***
Total pot 6500 | Rake 0=20
Seat 1: Bsgwolfpack4 collected (6500)
Seat 3: wallstwst folded before Flop (didn't bet)
Seat 4: GUUUULP (button) folded before Flop (didn't bet)
Seat 6: JJin91 (small blind) folded before Flop
Seat 8: eggstatic (big blind) folded before Flop
Seat 9: Snookers8 folded before Flop (didn't bet)


*********** # 207 **************
PokerStars Hand #176128627697: Tournament #1701843149, $18.20+$1.80 USD=
 Hold'em No Limit - Level XIX (1000/2000) - 2017/10/09 22:19:12 ET
Table '1701843149 2' 9-max Seat #6 is the button
Seat 1: Bsgwolfpack4 (76345 in chips)=20
Seat 3: wallstwst (45942 in chips)=20
Seat 4: GUUUULP (48798 in chips)=20
Seat 6: JJin91 (56277 in chips)=20
Seat 8: eggstatic (46127 in chips)=20
Seat 9: Snookers8 (78424 in chips)=20
Bsgwolfpack4: posts the ante 250
wallstwst: posts the ante 250
GUUUULP: posts the ante 250
JJin91: posts the ante 250
eggstatic: posts the ante 250
Snookers8: posts the ante 250
eggstatic: posts small blind 1000
Snookers8: posts big blind 2000
*** HOLE CARDS ***
Dealt to JJin91 [6h As]
Bsgwolfpack4: raises 4600 to 6600
wallstwst: folds=20
GUUUULP: folds=20
JJin91: folds=20
eggstatic: raises 39277 to 45877 and is all-in
Snookers8: folds=20
Bsgwolfpack4: folds [Ad]
Uncalled bet (39277) returned to eggstatic
eggstatic collected 16700 from pot
eggstatic: doesn't show hand=20
*** SUMMARY ***
Total pot 16700 | Rake 0=20
Seat 1: Bsgwolfpack4 folded before Flop
Seat 3: wallstwst folded before Flop (didn't bet)
Seat 4: GUUUULP folded before Flop (didn't bet)
Seat 6: JJin91 (button) folded before Flop (didn't bet)
Seat 8: eggstatic (small blind) collected (16700)
Seat 9: Snookers8 (big blind) folded before Flop


*********** # 208 **************
PokerStars Hand #176128627991: Tournament #1701843149, $18.20+$1.80 USD=
 Hold'em No Limit - Level XIX (1000/2000) - 2017/10/09 22:20:24 ET
Table '1701843149 2' 9-max Seat #8 is the button
Seat 1: Bsgwolfpack4 (69495 in chips)=20
Seat 3: wallstwst (45692 in chips)=20
Seat 4: GUUUULP (48548 in chips)=20
Seat 6: JJin91 (56027 in chips)=20
Seat 8: eggstatic (55977 in chips)=20
Seat 9: Snookers8 (76174 in chips)=20
Bsgwolfpack4: posts the ante 250
wallstwst: posts the ante 250
GUUUULP: posts the ante 250
JJin91: posts the ante 250
eggstatic: posts the ante 250
Snookers8: posts the ante 250
Snookers8: posts small blind 1000
Bsgwolfpack4: posts big blind 2000
*** HOLE CARDS ***
Dealt to JJin91 [Qc Kc]
wallstwst: folds=20
GUUUULP: folds=20
JJin91 is disconnected=20
JJin91 is connected=20
JJin91: raises 2340 to 4340
eggstatic: folds=20
Snookers8: folds=20
Bsgwolfpack4: folds=20
Uncalled bet (2340) returned to JJin91
JJin91 collected 6500 from pot
JJin91: doesn't show hand=20
*** SUMMARY ***
Total pot 6500 | Rake 0=20
Seat 1: Bsgwolfpack4 (big blind) folded before Flop
Seat 3: wallstwst folded before Flop (didn't bet)
Seat 4: GUUUULP folded before Flop (didn't bet)
Seat 6: JJin91 collected (6500)
Seat 8: eggstatic (button) folded before Flop (didn't bet)
Seat 9: Snookers8 (small blind) folded before Flop


*********** # 209 **************
PokerStars Hand #176128628268: Tournament #1701843149, $18.20+$1.80 USD=
 Hold'em No Limit - Level XIX (1000/2000) - 2017/10/09 22:21:25 ET
Table '1701843149 2' 9-max Seat #9 is the button
Seat 1: Bsgwolfpack4 (67245 in chips)=20
Seat 3: wallstwst (45442 in chips)=20
Seat 4: GUUUULP (48298 in chips)=20
Seat 6: JJin91 (60277 in chips)=20
Seat 8: eggstatic (55727 in chips)=20
Seat 9: Snookers8 (74924 in chips)=20
Bsgwolfpack4: posts the ante 250
wallstwst: posts the ante 250
GUUUULP: posts the ante 250
JJin91: posts the ante 250
eggstatic: posts the ante 250
Snookers8: posts the ante 250
Bsgwolfpack4: posts small blind 1000
wallstwst: posts big blind 2000
*** HOLE CARDS ***
Dealt to JJin91 [6s 8h]
GUUUULP: folds=20
JJin91: folds=20
eggstatic: folds=20
Snookers8: folds=20
Bsgwolfpack4: folds=20
Uncalled bet (1000) returned to wallstwst
wallstwst collected 3500 from pot
wallstwst: doesn't show hand=20
*** SUMMARY ***
Total pot 3500 | Rake 0=20
Seat 1: Bsgwolfpack4 (small blind) folded before Flop
Seat 3: wallstwst (big blind) collected (3500)
Seat 4: GUUUULP folded before Flop (didn't bet)
Seat 6: JJin91 folded before Flop (didn't bet)
Seat 8: eggstatic folded before Flop (didn't bet)
Seat 9: Snookers8 (button) folded before Flop (didn't bet)


*********** # 210 **************
PokerStars Hand #176128628549: Tournament #1701843149, $18.20+$1.80 USD=
 Hold'em No Limit - Level XIX (1000/2000) - 2017/10/09 22:22:33 ET
Table '1701843149 2' 9-max Seat #1 is the button
Seat 1: Bsgwolfpack4 (65995 in chips)=20
Seat 3: wallstwst (47692 in chips)=20
Seat 4: GUUUULP (48048 in chips)=20
Seat 6: JJin91 (60027 in chips)=20
Seat 8: eggstatic (55477 in chips)=20
Seat 9: Snookers8 (74674 in chips)=20
Bsgwolfpack4: posts the ante 250
wallstwst: posts the ante 250
GUUUULP: posts the ante 250
JJin91: posts the ante 250
eggstatic: posts the ante 250
Snookers8: posts the ante 250
wallstwst: posts small blind 1000
GUUUULP: posts big blind 2000
*** HOLE CARDS ***
Dealt to JJin91 [Js Kd]
JJin91: raises 2340 to 4340
eggstatic: folds=20
Snookers8: folds=20
Bsgwolfpack4: folds=20
wallstwst: folds=20
GUUUULP: folds=20
Uncalled bet (2340) returned to JJin91
JJin91 collected 6500 from pot
JJin91: doesn't show hand=20
*** SUMMARY ***
Total pot 6500 | Rake 0=20
Seat 1: Bsgwolfpack4 (button) folded before Flop (didn't bet)
Seat 3: wallstwst (small blind) folded before Flop
Seat 4: GUUUULP (big blind) folded before Flop
Seat 6: JJin91 collected (6500)
Seat 8: eggstatic folded before Flop (didn't bet)
Seat 9: Snookers8 folded before Flop (didn't bet)


*********** # 211 **************
PokerStars Hand #176128628822: Tournament #1701843149, $18.20+$1.80 USD=
 Hold'em No Limit - Level XIX (1000/2000) - 2017/10/09 22:23:41 ET
Table '1701843149 2' 9-max Seat #3 is the button
Seat 1: Bsgwolfpack4 (65745 in chips)=20
Seat 3: wallstwst (46442 in chips)=20
Seat 4: GUUUULP (45798 in chips)=20
Seat 6: JJin91 (64277 in chips)=20
Seat 8: eggstatic (55227 in chips)=20
Seat 9: Snookers8 (74424 in chips)=20
Bsgwolfpack4: posts the ante 250
wallstwst: posts the ante 250
GUUUULP: posts the ante 250
JJin91: posts the ante 250
eggstatic: posts the ante 250
Snookers8: posts the ante 250
GUUUULP: posts small blind 1000
JJin91: posts big blind 2000
*** HOLE CARDS ***
Dealt to JJin91 [Qd 6s]
eggstatic: raises 4000 to 6000
Snookers8: folds=20
Bsgwolfpack4: folds=20
wallstwst: folds=20
GUUUULP: folds=20
JJin91: folds=20
Uncalled bet (4000) returned to eggstatic
eggstatic collected 6500 from pot
eggstatic: doesn't show hand=20
*** SUMMARY ***
Total pot 6500 | Rake 0=20
Seat 1: Bsgwolfpack4 folded before Flop (didn't bet)
Seat 3: wallstwst (button) folded before Flop (didn't bet)
Seat 4: GUUUULP (small blind) folded before Flop
Seat 6: JJin91 (big blind) folded before Flop
Seat 8: eggstatic collected (6500)
Seat 9: Snookers8 folded before Flop (didn't bet)


*********** # 212 **************
PokerStars Hand #176128628959: Tournament #1701843149, $18.20+$1.80 USD=
 Hold'em No Limit - Level XIX (1000/2000) - 2017/10/09 22:24:13 ET
Table '1701843149 2' 9-max Seat #4 is the button
Seat 1: Bsgwolfpack4 (65495 in chips)=20
Seat 3: wallstwst (46192 in chips)=20
Seat 4: GUUUULP (44548 in chips)=20
Seat 6: JJin91 (62027 in chips)=20
Seat 8: eggstatic (59477 in chips)=20
Seat 9: Snookers8 (74174 in chips)=20
Bsgwolfpack4: posts the ante 250
wallstwst: posts the ante 250
GUUUULP: posts the ante 250
JJin91: posts the ante 250
eggstatic: posts the ante 250
Snookers8: posts the ante 250
JJin91: posts small blind 1000
eggstatic: posts big blind 2000
*** HOLE CARDS ***
Dealt to JJin91 [3s 7s]
Snookers8: folds=20
Bsgwolfpack4: folds=20
wallstwst: folds=20
GUUUULP: raises 2420 to 4420
JJin91: folds=20
eggstatic: folds=20
Uncalled bet (2420) returned to GUUUULP
GUUUULP collected 6500 from pot
*** SUMMARY ***
Total pot 6500 | Rake 0=20
Seat 1: Bsgwolfpack4 folded before Flop (didn't bet)
Seat 3: wallstwst folded before Flop (didn't bet)
Seat 4: GUUUULP (button) collected (6500)
Seat 6: JJin91 (small blind) folded before Flop
Seat 8: eggstatic (big blind) folded before Flop
Seat 9: Snookers8 folded before Flop (didn't bet)


*********** # 213 **************
PokerStars Hand #176128629164: Tournament #1701843149, $18.20+$1.80 USD=
 Hold'em No Limit - Level XIX (1000/2000) - 2017/10/09 22:24:57 ET
Table '1701843149 2' 9-max Seat #6 is the button
Seat 1: Bsgwolfpack4 (65245 in chips)=20
Seat 3: wallstwst (45942 in chips)=20
Seat 4: GUUUULP (48798 in chips)=20
Seat 6: JJin91 (60777 in chips)=20
Seat 8: eggstatic (57227 in chips)=20
Seat 9: Snookers8 (73924 in chips)=20
Bsgwolfpack4: posts the ante 250
wallstwst: posts the ante 250
GUUUULP: posts the ante 250
JJin91: posts the ante 250
eggstatic: posts the ante 250
Snookers8: posts the ante 250
eggstatic: posts small blind 1000
Snookers8: posts big blind 2000
*** HOLE CARDS ***
Dealt to JJin91 [3d Th]
Bsgwolfpack4: folds=20
wallstwst: folds=20
GUUUULP: folds=20
JJin91: folds=20
eggstatic: folds=20
Uncalled bet (1000) returned to Snookers8
Snookers8 collected 3500 from pot
Snookers8: doesn't show hand=20
*** SUMMARY ***
Total pot 3500 | Rake 0=20
Seat 1: Bsgwolfpack4 folded before Flop (didn't bet)
Seat 3: wallstwst folded before Flop (didn't bet)
Seat 4: GUUUULP folded before Flop (didn't bet)
Seat 6: JJin91 (button) folded before Flop (didn't bet)
Seat 8: eggstatic (small blind) folded before Flop
Seat 9: Snookers8 (big blind) collected (3500)


*********** # 214 **************
PokerStars Hand #176128629302: Tournament #1701843149, $18.20+$1.80 USD=
 Hold'em No Limit - Level XIX (1000/2000) - 2017/10/09 22:25:31 ET
Table '1701843149 2' 9-max Seat #8 is the button
Seat 1: Bsgwolfpack4 (64995 in chips)=20
Seat 2: Booge013 (35627 in chips)=20
Seat 3: wallstwst (45692 in chips)=20
Seat 4: GUUUULP (48548 in chips)=20
Seat 5: apoch19 (64875 in chips)=20
Seat 6: JJin91 (60527 in chips)=20
Seat 7: thereugo14 (119433 in chips)=20
Seat 8: eggstatic (55977 in chips)=20
Seat 9: Snookers8 (76174 in chips)=20
Bsgwolfpack4: posts the ante 250
Booge013: posts the ante 250
wallstwst: posts the ante 250
GUUUULP: posts the ante 250
apoch19: posts the ante 250
JJin91: posts the ante 250
thereugo14: posts the ante 250
eggstatic: posts the ante 250
Snookers8: posts the ante 250
Snookers8: posts small blind 1000
Bsgwolfpack4: posts big blind 2000
*** HOLE CARDS ***
Dealt to JJin91 [5h Ks]
Booge013: folds=20
wallstwst: raises 2000 to 4000
GUUUULP: folds=20
apoch19: calls 4000
JJin91: folds=20
thereugo14: folds=20
eggstatic: folds=20
Snookers8: folds=20
Bsgwolfpack4: folds=20
*** FLOP *** [Ts 3s 8c]
wallstwst: bets 4373
apoch19: raises 6869 to 11242
wallstwst: folds=20
Uncalled bet (6869) returned to apoch19
apoch19 collected 21996 from pot
apoch19: doesn't show hand=20
*** SUMMARY ***
Total pot 21996 | Rake 0=20
Board [Ts 3s 8c]
Seat 1: Bsgwolfpack4 (big blind) folded before Flop
Seat 2: Booge013 folded before Flop (didn't bet)
Seat 3: wallstwst folded on the Flop
Seat 4: GUUUULP folded before Flop (didn't bet)
Seat 5: apoch19 collected (21996)
Seat 6: JJin91 folded before Flop (didn't bet)
Seat 7: thereugo14 folded before Flop (didn't bet)
Seat 8: eggstatic (button) folded before Flop (didn't bet)
Seat 9: Snookers8 (small blind) folded before Flop


*********** # 215 **************
PokerStars Hand #176128629536: Tournament #1701843149, $18.20+$1.80 USD=
 Hold'em No Limit - Level XIX (1000/2000) - 2017/10/09 22:26:26 ET
Table '1701843149 2' 9-max Seat #9 is the button
Seat 1: Bsgwolfpack4 (62745 in chips)=20
Seat 2: Booge013 (35377 in chips)=20
Seat 3: wallstwst (37069 in chips)=20
Seat 4: GUUUULP (48298 in chips)=20
Seat 5: apoch19 (78248 in chips)=20
Seat 6: JJin91 (60277 in chips)=20
Seat 7: thereugo14 (119183 in chips)=20
Seat 8: eggstatic (55727 in chips)=20
Seat 9: Snookers8 (74924 in chips)=20
Bsgwolfpack4: posts the ante 250
Booge013: posts the ante 250
wallstwst: posts the ante 250
GUUUULP: posts the ante 250
apoch19: posts the ante 250
JJin91: posts the ante 250
thereugo14: posts the ante 250
eggstatic: posts the ante 250
Snookers8: posts the ante 250
Bsgwolfpack4: posts small blind 1000
Booge013: posts big blind 2000
*** HOLE CARDS ***
Dealt to JJin91 [4d Td]
wallstwst: folds=20
GUUUULP: folds=20
apoch19: folds=20
JJin91: folds=20
thereugo14: calls 2000
eggstatic: folds=20
Snookers8: folds=20
Bsgwolfpack4: folds=20
Booge013: checks=20
*** FLOP *** [Jh 6d Ah]
Booge013: checks=20
thereugo14: checks=20
*** TURN *** [Jh 6d Ah] [7s]
Booge013: checks=20
thereugo14: bets 2000
Booge013: calls 2000
*** RIVER *** [Jh 6d Ah 7s] [9d]
Booge013: checks=20
thereugo14: bets 5625
Booge013: calls 5625
*** SHOW DOWN ***
thereugo14: shows [6h 7h] (two pair, Sevens and Sixes)
Booge013: mucks hand=20
thereugo14 collected 22500 from pot
*** SUMMARY ***
Total pot 22500 | Rake 0=20
Board [Jh 6d Ah 7s 9d]
Seat 1: Bsgwolfpack4 (small blind) folded before Flop
Seat 2: Booge013 (big blind) mucked [7c 3h]
Seat 3: wallstwst folded before Flop (didn't bet)
Seat 4: GUUUULP folded before Flop (didn't bet)
Seat 5: apoch19 folded before Flop (didn't bet)
Seat 6: JJin91 folded before Flop (didn't bet)
Seat 7: thereugo14 showed [6h 7h] and won (22500) with two pair, Sevens=
 and Sixes
Seat 8: eggstatic folded before Flop (didn't bet)
Seat 9: Snookers8 (button) folded before Flop (didn't bet)


*********** # 216 **************
PokerStars Hand #176128629865: Tournament #1701843149, $18.20+$1.80 USD=
 Hold'em No Limit - Level XIX (1000/2000) - 2017/10/09 22:27:43 ET
Table '1701843149 2' 9-max Seat #1 is the button
Seat 1: Bsgwolfpack4 (61495 in chips)=20
Seat 2: Booge013 (25502 in chips)=20
Seat 3: wallstwst (36819 in chips)=20
Seat 4: GUUUULP (48048 in chips)=20
Seat 5: apoch19 (77998 in chips)=20
Seat 6: JJin91 (60027 in chips)=20
Seat 7: thereugo14 (131808 in chips)=20
Seat 8: eggstatic (55477 in chips)=20
Seat 9: Snookers8 (74674 in chips)=20
Bsgwolfpack4: posts the ante 250
Booge013: posts the ante 250
wallstwst: posts the ante 250
GUUUULP: posts the ante 250
apoch19: posts the ante 250
JJin91: posts the ante 250
thereugo14: posts the ante 250
eggstatic: posts the ante 250
Snookers8: posts the ante 250
Booge013: posts small blind 1000
wallstwst: posts big blind 2000
*** HOLE CARDS ***
Dealt to JJin91 [6s 7c]
GUUUULP has timed out
GUUUULP: folds=20
GUUUULP is sitting out
apoch19: folds=20
JJin91: folds=20
thereugo14: folds=20
eggstatic: folds=20
GUUUULP has returned
Snookers8: folds=20
Bsgwolfpack4: folds=20
Booge013: raises 23252 to 25252 and is all-in
wallstwst: calls 23252
*** FLOP *** [9c 9h 5d]
*** TURN *** [9c 9h 5d] [Kd]
*** RIVER *** [9c 9h 5d Kd] [3c]
*** SHOW DOWN ***
Booge013: shows [Js Ac] (a pair of Nines)
wallstwst: shows [Td Kh] (two pair, Kings and Nines)
wallstwst collected 52754 from pot
Booge013 finished the tournament in 18th place and received $42.16.
*** SUMMARY ***
Total pot 52754 | Rake 0=20
Board [9c 9h 5d Kd 3c]
Seat 1: Bsgwolfpack4 (button) folded before Flop (didn't bet)
Seat 2: Booge013 (small blind) showed [Js Ac] and lost with a pair of N=
ines
Seat 3: wallstwst (big blind) showed [Td Kh] and won (52754) with two p=
air, Kings and Nines
Seat 4: GUUUULP folded before Flop (didn't bet)
Seat 5: apoch19 folded before Flop (didn't bet)
Seat 6: JJin91 folded before Flop (didn't bet)
Seat 7: thereugo14 folded before Flop (didn't bet)
Seat 8: eggstatic folded before Flop (didn't bet)
Seat 9: Snookers8 folded before Flop (didn't bet)


*********** # 217 **************
PokerStars Hand #176128916705: Tournament #1701843149, $18.20+$1.80 USD=
 Hold'em No Limit - Level XX (1250/2500) - 2017/10/09 22:28:36 ET
Table '1701843149 2' 9-max Seat #3 is the button
Seat 1: Bsgwolfpack4 (61245 in chips)=20
Seat 3: wallstwst (64071 in chips)=20
Seat 4: GUUUULP (47798 in chips)=20
Seat 5: apoch19 (77748 in chips)=20
Seat 6: JJin91 (59777 in chips)=20
Seat 7: thereugo14 (131558 in chips)=20
Seat 8: eggstatic (55227 in chips)=20
Seat 9: Snookers8 (74424 in chips)=20
Bsgwolfpack4: posts the ante 325
wallstwst: posts the ante 325
GUUUULP: posts the ante 325
apoch19: posts the ante 325
JJin91: posts the ante 325
thereugo14: posts the ante 325
eggstatic: posts the ante 325
Snookers8: posts the ante 325
GUUUULP: posts small blind 1250
apoch19: posts big blind 2500
*** HOLE CARDS ***
Dealt to JJin91 [Ac 4h]
JJin91: folds=20
thereugo14: calls 2500
eggstatic: folds=20
Snookers8: folds=20
Bsgwolfpack4: folds=20
wallstwst: folds=20
GUUUULP has timed out
GUUUULP: folds=20
GUUUULP is sitting out
apoch19: checks=20
*** FLOP *** [2h Jd 7h]
GUUUULP has returned
apoch19: checks=20
thereugo14: checks=20
*** TURN *** [2h Jd 7h] [6c]
apoch19: bets 3440
thereugo14: calls 3440
*** RIVER *** [2h Jd 7h 6c] [Ad]
apoch19: bets 7865
thereugo14: calls 7865
*** SHOW DOWN ***
apoch19: shows [2s 6h] (two pair, Sixes and Deuces)
thereugo14: mucks hand=20
apoch19 collected 31460 from pot
*** SUMMARY ***
Total pot 31460 | Rake 0=20
Board [2h Jd 7h 6c Ad]
Seat 1: Bsgwolfpack4 folded before Flop (didn't bet)
Seat 3: wallstwst (button) folded before Flop (didn't bet)
Seat 4: GUUUULP (small blind) folded before Flop
Seat 5: apoch19 (big blind) showed [2s 6h] and won (31460) with two pai=
r, Sixes and Deuces
Seat 6: JJin91 folded before Flop (didn't bet)
Seat 7: thereugo14 mucked [As Td]
Seat 8: eggstatic folded before Flop (didn't bet)
Seat 9: Snookers8 folded before Flop (didn't bet)


*********** # 218 **************
PokerStars Hand #176128917012: Tournament #1701843149, $18.20+$1.80 USD=
 Hold'em No Limit - Level XX (1250/2500) - 2017/10/09 22:29:40 ET
Table '1701843149 2' 9-max Seat #4 is the button
Seat 1: Bsgwolfpack4 (60920 in chips)=20
Seat 3: wallstwst (63746 in chips)=20
Seat 4: GUUUULP (46223 in chips)=20
Seat 5: apoch19 (95078 in chips)=20
Seat 6: JJin91 (59452 in chips)=20
Seat 7: thereugo14 (117428 in chips)=20
Seat 8: eggstatic (54902 in chips)=20
Seat 9: Snookers8 (74099 in chips)=20
Bsgwolfpack4: posts the ante 325
wallstwst: posts the ante 325
GUUUULP: posts the ante 325
apoch19: posts the ante 325
JJin91: posts the ante 325
thereugo14: posts the ante 325
eggstatic: posts the ante 325
Snookers8: posts the ante 325
apoch19: posts small blind 1250
JJin91: posts big blind 2500
*** HOLE CARDS ***
Dealt to JJin91 [Kc 8s]
thereugo14: calls 2500
eggstatic: raises 7500 to 10000
Snookers8: folds=20
Bsgwolfpack4: folds=20
wallstwst: folds=20
GUUUULP has timed out
GUUUULP: folds=20
GUUUULP is sitting out
apoch19: folds=20
JJin91: folds=20
thereugo14: folds=20
Uncalled bet (7500) returned to eggstatic
eggstatic collected 11350 from pot
eggstatic: doesn't show hand=20
GUUUULP has returned
*** SUMMARY ***
Total pot 11350 | Rake 0=20
Seat 1: Bsgwolfpack4 folded before Flop (didn't bet)
Seat 3: wallstwst folded before Flop (didn't bet)
Seat 4: GUUUULP (button) folded before Flop (didn't bet)
Seat 5: apoch19 (small blind) folded before Flop
Seat 6: JJin91 (big blind) folded before Flop
Seat 7: thereugo14 folded before Flop
Seat 8: eggstatic collected (11350)
Seat 9: Snookers8 folded before Flop (didn't bet)


*********** # 219 **************
PokerStars Hand #176128917204: Tournament #1701843149, $18.20+$1.80 USD=
 Hold'em No Limit - Level XX (1250/2500) - 2017/10/09 22:30:24 ET
Table '1701843149 2' 9-max Seat #5 is the button
Seat 1: Bsgwolfpack4 (60595 in chips)=20
Seat 3: wallstwst (63421 in chips)=20
Seat 4: GUUUULP (45898 in chips)=20
Seat 5: apoch19 (93503 in chips)=20
Seat 6: JJin91 (56627 in chips)=20
Seat 7: thereugo14 (114603 in chips)=20
Seat 8: eggstatic (63427 in chips)=20
Seat 9: Snookers8 (73774 in chips)=20
Bsgwolfpack4: posts the ante 325
wallstwst: posts the ante 325
GUUUULP: posts the ante 325
apoch19: posts the ante 325
JJin91: posts the ante 325
thereugo14: posts the ante 325
eggstatic: posts the ante 325
Snookers8: posts the ante 325
JJin91: posts small blind 1250
thereugo14: posts big blind 2500
*** HOLE CARDS ***
Dealt to JJin91 [Kc Ad]
eggstatic: folds=20
Snookers8: folds=20
Bsgwolfpack4: folds=20
wallstwst: folds=20
GUUUULP has timed out
GUUUULP: folds=20
GUUUULP is sitting out
GUUUULP has returned
apoch19: raises 3350 to 5850
JJin91: raises 13038 to 18888
thereugo14: folds=20
apoch19: folds=20
Uncalled bet (13038) returned to JJin91
JJin91 collected 16800 from pot
JJin91: doesn't show hand=20
*** SUMMARY ***
Total pot 16800 | Rake 0=20
Seat 1: Bsgwolfpack4 folded before Flop (didn't bet)
Seat 3: wallstwst folded before Flop (didn't bet)
Seat 4: GUUUULP folded before Flop (didn't bet)
Seat 5: apoch19 (button) folded before Flop
Seat 6: JJin91 (small blind) collected (16800)
Seat 7: thereugo14 (big blind) folded before Flop
Seat 8: eggstatic folded before Flop (didn't bet)
Seat 9: Snookers8 folded before Flop (didn't bet)


*********** # 220 **************
PokerStars Hand #176128917532: Tournament #1701843149, $18.20+$1.80 USD=
 Hold'em No Limit - Level XX (1250/2500) - 2017/10/09 22:31:43 ET
Table '1701843149 2' 9-max Seat #6 is the button
Seat 1: Bsgwolfpack4 (60270 in chips)=20
Seat 3: wallstwst (63096 in chips)=20
Seat 4: GUUUULP (45573 in chips)=20
Seat 5: apoch19 (87328 in chips)=20
Seat 6: JJin91 (67252 in chips)=20
Seat 7: thereugo14 (111778 in chips)=20
Seat 8: eggstatic (63102 in chips)=20
Seat 9: Snookers8 (73449 in chips)=20
Bsgwolfpack4: posts the ante 325
wallstwst: posts the ante 325
GUUUULP: posts the ante 325
apoch19: posts the ante 325
JJin91: posts the ante 325
thereugo14: posts the ante 325
eggstatic: posts the ante 325
Snookers8: posts the ante 325
thereugo14: posts small blind 1250
eggstatic: posts big blind 2500
*** HOLE CARDS ***
Dealt to JJin91 [9h Qh]
Snookers8: folds=20
Bsgwolfpack4: folds=20
wallstwst: folds=20
GUUUULP: folds=20
apoch19: raises 3350 to 5850
JJin91: calls 5850
thereugo14: folds=20
eggstatic: folds=20
*** FLOP *** [Jh Jc 5d]
apoch19: bets 7500
JJin91: folds=20
Uncalled bet (7500) returned to apoch19
apoch19 collected 18050 from pot
apoch19: doesn't show hand=20
*** SUMMARY ***
Total pot 18050 | Rake 0=20
Board [Jh Jc 5d]
Seat 1: Bsgwolfpack4 folded before Flop (didn't bet)
Seat 3: wallstwst folded before Flop (didn't bet)
Seat 4: GUUUULP folded before Flop (didn't bet)
Seat 5: apoch19 collected (18050)
Seat 6: JJin91 (button) folded on the Flop
Seat 7: thereugo14 (small blind) folded before Flop
Seat 8: eggstatic (big blind) folded before Flop
Seat 9: Snookers8 folded before Flop (didn't bet)


*********** # 221 **************
PokerStars Hand #176128917769: Tournament #1701843149, $18.20+$1.80 USD=
 Hold'em No Limit - Level XX (1250/2500) - 2017/10/09 22:32:42 ET
Table '1701843149 2' 9-max Seat #7 is the button
Seat 1: Bsgwolfpack4 (59945 in chips)=20
Seat 3: wallstwst (62771 in chips)=20
Seat 4: GUUUULP (45248 in chips)=20
Seat 5: apoch19 (99203 in chips)=20
Seat 6: JJin91 (61077 in chips)=20
Seat 7: thereugo14 (110203 in chips)=20
Seat 8: eggstatic (60277 in chips)=20
Seat 9: Snookers8 (73124 in chips)=20
Bsgwolfpack4: posts the ante 325
wallstwst: posts the ante 325
GUUUULP: posts the ante 325
apoch19: posts the ante 325
JJin91: posts the ante 325
thereugo14: posts the ante 325
eggstatic: posts the ante 325
Snookers8: posts the ante 325
eggstatic: posts small blind 1250
Snookers8: posts big blind 2500
*** HOLE CARDS ***
Dealt to JJin91 [7c Jh]
Bsgwolfpack4: folds=20
wallstwst: folds=20
GUUUULP has timed out
GUUUULP: folds=20
GUUUULP is sitting out
GUUUULP has returned
apoch19: raises 3350 to 5850
JJin91: folds=20
thereugo14: folds=20
eggstatic: folds=20
Snookers8: folds=20
Uncalled bet (3350) returned to apoch19
apoch19 collected 8850 from pot
apoch19: doesn't show hand=20
*** SUMMARY ***
Total pot 8850 | Rake 0=20
Seat 1: Bsgwolfpack4 folded before Flop (didn't bet)
Seat 3: wallstwst folded before Flop (didn't bet)
Seat 4: GUUUULP folded before Flop (didn't bet)
Seat 5: apoch19 collected (8850)
Seat 6: JJin91 folded before Flop (didn't bet)
Seat 7: thereugo14 (button) folded before Flop (didn't bet)
Seat 8: eggstatic (small blind) folded before Flop
Seat 9: Snookers8 (big blind) folded before Flop


*********** # 222 **************
PokerStars Hand #176128917933: Tournament #1701843149, $18.20+$1.80 USD=
 Hold'em No Limit - Level XX (1250/2500) - 2017/10/09 22:33:22 ET
Table '1701843149 2' 9-max Seat #8 is the button
Seat 1: Bsgwolfpack4 (59620 in chips)=20
Seat 3: wallstwst (62446 in chips)=20
Seat 4: GUUUULP (44923 in chips)=20
Seat 5: apoch19 (105228 in chips)=20
Seat 6: JJin91 (60752 in chips)=20
Seat 7: thereugo14 (109878 in chips)=20
Seat 8: eggstatic (58702 in chips)=20
Seat 9: Snookers8 (70299 in chips)=20
Bsgwolfpack4: posts the ante 325
wallstwst: posts the ante 325
GUUUULP: posts the ante 325
apoch19: posts the ante 325
JJin91: posts the ante 325
thereugo14: posts the ante 325
eggstatic: posts the ante 325
Snookers8: posts the ante 325
Snookers8: posts small blind 1250
Bsgwolfpack4: posts big blind 2500
*** HOLE CARDS ***
Dealt to JJin91 [Th 5d]
wallstwst: raises 2500 to 5000
GUUUULP: folds=20
apoch19: folds=20
JJin91: folds=20
thereugo14: folds=20
eggstatic: folds=20
Snookers8: folds=20
Bsgwolfpack4: calls 2500
*** FLOP *** [9s 6h Ts]
Bsgwolfpack4: checks=20
wallstwst: bets 7064
Bsgwolfpack4: calls 7064
*** TURN *** [9s 6h Ts] [Ac]
Bsgwolfpack4: checks=20
wallstwst: bets 10000
Bsgwolfpack4: folds=20
Uncalled bet (10000) returned to wallstwst
wallstwst collected 27978 from pot
wallstwst: doesn't show hand=20
*** SUMMARY ***
Total pot 27978 | Rake 0=20
Board [9s 6h Ts Ac]
Seat 1: Bsgwolfpack4 (big blind) folded on the Turn
Seat 3: wallstwst collected (27978)
Seat 4: GUUUULP folded before Flop (didn't bet)
Seat 5: apoch19 folded before Flop (didn't bet)
Seat 6: JJin91 folded before Flop (didn't bet)
Seat 7: thereugo14 folded before Flop (didn't bet)
Seat 8: eggstatic (button) folded before Flop (didn't bet)
Seat 9: Snookers8 (small blind) folded before Flop


*********** # 223 **************
PokerStars Hand #176128918186: Tournament #1701843149, $18.20+$1.80 USD=
 Hold'em No Limit - Level XX (1250/2500) - 2017/10/09 22:34:23 ET
Table '1701843149 2' 9-max Seat #9 is the button
Seat 1: Bsgwolfpack4 (47231 in chips)=20
Seat 3: wallstwst (78035 in chips)=20
Seat 4: GUUUULP (44598 in chips)=20
Seat 5: apoch19 (104903 in chips)=20
Seat 6: JJin91 (60427 in chips)=20
Seat 7: thereugo14 (109553 in chips)=20
Seat 8: eggstatic (58377 in chips)=20
Seat 9: Snookers8 (68724 in chips)=20
Bsgwolfpack4: posts the ante 325
wallstwst: posts the ante 325
GUUUULP: posts the ante 325
apoch19: posts the ante 325
JJin91: posts the ante 325
thereugo14: posts the ante 325
eggstatic: posts the ante 325
Snookers8: posts the ante 325
Bsgwolfpack4: posts small blind 1250
wallstwst: posts big blind 2500
*** HOLE CARDS ***
Dealt to JJin91 [Kc Kh]
GUUUULP: folds=20
apoch19: folds=20
JJin91: raises 2925 to 5425
thereugo14: folds=20
eggstatic: folds=20
Snookers8: folds=20
Bsgwolfpack4: folds=20
wallstwst: folds=20
Uncalled bet (2925) returned to JJin91
JJin91 collected 8850 from pot
JJin91: doesn't show hand=20
*** SUMMARY ***
Total pot 8850 | Rake 0=20
Seat 1: Bsgwolfpack4 (small blind) folded before Flop
Seat 3: wallstwst (big blind) folded before Flop
Seat 4: GUUUULP folded before Flop (didn't bet)
Seat 5: apoch19 folded before Flop (didn't bet)
Seat 6: JJin91 collected (8850)
Seat 7: thereugo14 folded before Flop (didn't bet)
Seat 8: eggstatic folded before Flop (didn't bet)
Seat 9: Snookers8 (button) folded before Flop (didn't bet)


*********** # 224 **************
PokerStars Hand #176128918288: Tournament #1701843149, $18.20+$1.80 USD=
 Hold'em No Limit - Level XX (1250/2500) - 2017/10/09 22:34:47 ET
Table '1701843149 2' 9-max Seat #1 is the button
Seat 1: Bsgwolfpack4 (45656 in chips)=20
Seat 3: wallstwst (75210 in chips)=20
Seat 4: GUUUULP (44273 in chips)=20
Seat 5: apoch19 (104578 in chips)=20
Seat 6: JJin91 (66452 in chips)=20
Seat 7: thereugo14 (109228 in chips)=20
Seat 8: eggstatic (58052 in chips)=20
Seat 9: Snookers8 (68399 in chips)=20
Bsgwolfpack4: posts the ante 325
wallstwst: posts the ante 325
GUUUULP: posts the ante 325
apoch19: posts the ante 325
JJin91: posts the ante 325
thereugo14: posts the ante 325
eggstatic: posts the ante 325
Snookers8: posts the ante 325
wallstwst: posts small blind 1250
GUUUULP: posts big blind 2500
*** HOLE CARDS ***
Dealt to JJin91 [Jc 2h]
apoch19: raises 3300 to 5800
JJin91: folds=20
thereugo14: folds=20
eggstatic: folds=20
Snookers8: folds=20
Bsgwolfpack4: folds=20
wallstwst: folds=20
GUUUULP: calls 3300
*** FLOP *** [Qs 8s Ks]
GUUUULP: checks=20
apoch19: checks=20
*** TURN *** [Qs 8s Ks] [9d]
GUUUULP: bets 10506
apoch19: folds=20
Uncalled bet (10506) returned to GUUUULP
GUUUULP collected 15450 from pot
*** SUMMARY ***
Total pot 15450 | Rake 0=20
Board [Qs 8s Ks 9d]
Seat 1: Bsgwolfpack4 (button) folded before Flop (didn't bet)
Seat 3: wallstwst (small blind) folded before Flop
Seat 4: GUUUULP (big blind) collected (15450)
Seat 5: apoch19 folded on the Turn
Seat 6: JJin91 folded before Flop (didn't bet)
Seat 7: thereugo14 folded before Flop (didn't bet)
Seat 8: eggstatic folded before Flop (didn't bet)
Seat 9: Snookers8 folded before Flop (didn't bet)


*********** # 225 **************
PokerStars Hand #176128918443: Tournament #1701843149, $18.20+$1.80 USD=
 Hold'em No Limit - Level XX (1250/2500) - 2017/10/09 22:35:24 ET
Table '1701843149 2' 9-max Seat #3 is the button
Seat 1: Bsgwolfpack4 (45331 in chips)=20
Seat 3: wallstwst (73635 in chips)=20
Seat 4: GUUUULP (53598 in chips)=20
Seat 5: apoch19 (98453 in chips)=20
Seat 6: JJin91 (66127 in chips)=20
Seat 7: thereugo14 (108903 in chips)=20
Seat 8: eggstatic (57727 in chips)=20
Seat 9: Snookers8 (68074 in chips)=20
Bsgwolfpack4: posts the ante 325
wallstwst: posts the ante 325
GUUUULP: posts the ante 325
apoch19: posts the ante 325
JJin91: posts the ante 325
thereugo14: posts the ante 325
eggstatic: posts the ante 325
Snookers8: posts the ante 325
GUUUULP: posts small blind 1250
apoch19: posts big blind 2500
*** HOLE CARDS ***
Dealt to JJin91 [6d Kh]
JJin91: folds=20
thereugo14: folds=20
eggstatic: folds=20
Snookers8: folds=20
Bsgwolfpack4: folds=20
wallstwst: folds=20
GUUUULP: calls 1250
apoch19: raises 5000 to 7500
GUUUULP: folds=20
Uncalled bet (5000) returned to apoch19
apoch19 collected 7600 from pot
apoch19: doesn't show hand=20
*** SUMMARY ***
Total pot 7600 | Rake 0=20
Seat 1: Bsgwolfpack4 folded before Flop (didn't bet)
Seat 3: wallstwst (button) folded before Flop (didn't bet)
Seat 4: GUUUULP (small blind) folded before Flop
Seat 5: apoch19 (big blind) collected (7600)
Seat 6: JJin91 folded before Flop (didn't bet)
Seat 7: thereugo14 folded before Flop (didn't bet)
Seat 8: eggstatic folded before Flop (didn't bet)
Seat 9: Snookers8 folded before Flop (didn't bet)


*********** # 226 **************
PokerStars Hand #176128918569: Tournament #1701843149, $18.20+$1.80 USD=
 Hold'em No Limit - Level XX (1250/2500) - 2017/10/09 22:35:55 ET
Table '1701843149 2' 9-max Seat #4 is the button
Seat 1: Bsgwolfpack4 (45006 in chips)=20
Seat 3: wallstwst (73310 in chips)=20
Seat 4: GUUUULP (50773 in chips)=20
Seat 5: apoch19 (103228 in chips)=20
Seat 6: JJin91 (65802 in chips)=20
Seat 7: thereugo14 (108578 in chips)=20
Seat 8: eggstatic (57402 in chips)=20
Seat 9: Snookers8 (67749 in chips)=20
Bsgwolfpack4: posts the ante 325
wallstwst: posts the ante 325
GUUUULP: posts the ante 325
apoch19: posts the ante 325
JJin91: posts the ante 325
thereugo14: posts the ante 325
eggstatic: posts the ante 325
Snookers8: posts the ante 325
apoch19: posts small blind 1250
JJin91: posts big blind 2500
*** HOLE CARDS ***
Dealt to JJin91 [Qh 7h]
thereugo14: calls 2500
eggstatic: calls 2500
Snookers8: folds=20
Bsgwolfpack4: folds=20
wallstwst: folds=20
GUUUULP: folds=20
apoch19: calls 1250
JJin91: checks=20
*** FLOP *** [Kh 2d Js]
apoch19: checks=20
JJin91: checks=20
thereugo14: bets 2500
eggstatic: calls 2500
apoch19: calls 2500
JJin91: folds=20
*** TURN *** [Kh 2d Js] [Jc]
apoch19: checks=20
thereugo14: checks=20
eggstatic: bets 7500
apoch19: folds=20
thereugo14: folds=20
Uncalled bet (7500) returned to eggstatic
eggstatic collected 20100 from pot
eggstatic: doesn't show hand=20
*** SUMMARY ***
Total pot 20100 | Rake 0=20
Board [Kh 2d Js Jc]
Seat 1: Bsgwolfpack4 folded before Flop (didn't bet)
Seat 3: wallstwst folded before Flop (didn't bet)
Seat 4: GUUUULP (button) folded before Flop (didn't bet)
Seat 5: apoch19 (small blind) folded on the Turn
Seat 6: JJin91 (big blind) folded on the Flop
Seat 7: thereugo14 folded on the Turn
Seat 8: eggstatic collected (20100)
Seat 9: Snookers8 folded before Flop (didn't bet)


*********** # 227 **************
PokerStars Hand #176128918857: Tournament #1701843149, $18.20+$1.80 USD=
 Hold'em No Limit - Level XX (1250/2500) - 2017/10/09 22:37:09 ET
Table '1701843149 2' 9-max Seat #5 is the button
Seat 1: Bsgwolfpack4 (44681 in chips)=20
Seat 3: wallstwst (72985 in chips)=20
Seat 4: GUUUULP (50448 in chips)=20
Seat 5: apoch19 (97903 in chips)=20
Seat 6: JJin91 (62977 in chips)=20
Seat 7: thereugo14 (103253 in chips)=20
Seat 8: eggstatic (72177 in chips)=20
Seat 9: Snookers8 (67424 in chips)=20
Bsgwolfpack4: posts the ante 325
wallstwst: posts the ante 325
GUUUULP: posts the ante 325
apoch19: posts the ante 325
JJin91: posts the ante 325
thereugo14: posts the ante 325
eggstatic: posts the ante 325
Snookers8: posts the ante 325
JJin91: posts small blind 1250
thereugo14: posts big blind 2500
*** HOLE CARDS ***
Dealt to JJin91 [3c 7s]
eggstatic: folds=20
Snookers8: folds=20
Bsgwolfpack4: raises 5700 to 8200
wallstwst: folds=20
GUUUULP has timed out
GUUUULP: folds=20
GUUUULP is sitting out
apoch19: folds=20
JJin91: folds=20
thereugo14: folds=20
Uncalled bet (5700) returned to Bsgwolfpack4
Bsgwolfpack4 collected 8850 from pot
GUUUULP has returned
*** SUMMARY ***
Total pot 8850 | Rake 0=20
Seat 1: Bsgwolfpack4 collected (8850)
Seat 3: wallstwst folded before Flop (didn't bet)
Seat 4: GUUUULP folded before Flop (didn't bet)
Seat 5: apoch19 (button) folded before Flop (didn't bet)
Seat 6: JJin91 (small blind) folded before Flop
Seat 7: thereugo14 (big blind) folded before Flop
Seat 8: eggstatic folded before Flop (didn't bet)
Seat 9: Snookers8 folded before Flop (didn't bet)


*********** # 228 **************
PokerStars Hand #176128919077: Tournament #1701843149, $18.20+$1.80 USD=
 Hold'em No Limit - Level XXI (1500/3000) - 2017/10/09 22:37:59 ET
Table '1701843149 2' 9-max Seat #6 is the button
Seat 1: Bsgwolfpack4 (50706 in chips)=20
Seat 3: wallstwst (72660 in chips)=20
Seat 4: GUUUULP (50123 in chips)=20
Seat 5: apoch19 (97578 in chips)=20
Seat 6: JJin91 (61402 in chips)=20
Seat 7: thereugo14 (100428 in chips)=20
Seat 8: eggstatic (71852 in chips)=20
Seat 9: Snookers8 (67099 in chips)=20
Bsgwolfpack4: posts the ante 375
wallstwst: posts the ante 375
GUUUULP: posts the ante 375
apoch19: posts the ante 375
JJin91: posts the ante 375
thereugo14: posts the ante 375
eggstatic: posts the ante 375
Snookers8: posts the ante 375
thereugo14: posts small blind 1500
eggstatic: posts big blind 3000
*** HOLE CARDS ***
Dealt to JJin91 [2c Jc]
Snookers8: folds=20
Bsgwolfpack4: folds=20
wallstwst: folds=20
GUUUULP: folds=20
apoch19: folds=20
JJin91: raises 3510 to 6510
thereugo14: folds=20
eggstatic: folds=20
Uncalled bet (3510) returned to JJin91
JJin91 collected 10500 from pot
JJin91: doesn't show hand=20
*** SUMMARY ***
Total pot 10500 | Rake 0=20
Seat 1: Bsgwolfpack4 folded before Flop (didn't bet)
Seat 3: wallstwst folded before Flop (didn't bet)
Seat 4: GUUUULP folded before Flop (didn't bet)
Seat 5: apoch19 folded before Flop (didn't bet)
Seat 6: JJin91 (button) collected (10500)
Seat 7: thereugo14 (small blind) folded before Flop
Seat 8: eggstatic (big blind) folded before Flop
Seat 9: Snookers8 folded before Flop (didn't bet)


*********** # 229 **************
PokerStars Hand #176128919175: Tournament #1701843149, $18.20+$1.80 USD=
 Hold'em No Limit - Level XXI (1500/3000) - 2017/10/09 22:38:26 ET
Table '1701843149 2' 9-max Seat #7 is the button
Seat 1: Bsgwolfpack4 (50331 in chips)=20
Seat 3: wallstwst (72285 in chips)=20
Seat 4: GUUUULP (49748 in chips)=20
Seat 5: apoch19 (97203 in chips)=20
Seat 6: JJin91 (68527 in chips)=20
Seat 7: thereugo14 (98553 in chips)=20
Seat 8: eggstatic (68477 in chips)=20
Seat 9: Snookers8 (66724 in chips)=20
Bsgwolfpack4: posts the ante 375
wallstwst: posts the ante 375
GUUUULP: posts the ante 375
apoch19: posts the ante 375
JJin91: posts the ante 375
thereugo14: posts the ante 375
eggstatic: posts the ante 375
Snookers8: posts the ante 375
eggstatic: posts small blind 1500
Snookers8: posts big blind 3000
*** HOLE CARDS ***
Dealt to JJin91 [2h Ac]
Bsgwolfpack4: folds=20
wallstwst: folds=20
GUUUULP: folds=20
apoch19: raises 3880 to 6880
JJin91: folds=20
thereugo14: folds=20
eggstatic: folds=20
Snookers8: folds=20
Uncalled bet (3880) returned to apoch19
apoch19 collected 10500 from pot
apoch19: doesn't show hand=20
*** SUMMARY ***
Total pot 10500 | Rake 0=20
Seat 1: Bsgwolfpack4 folded before Flop (didn't bet)
Seat 3: wallstwst folded before Flop (didn't bet)
Seat 4: GUUUULP folded before Flop (didn't bet)
Seat 5: apoch19 collected (10500)
Seat 6: JJin91 folded before Flop (didn't bet)
Seat 7: thereugo14 (button) folded before Flop (didn't bet)
Seat 8: eggstatic (small blind) folded before Flop
Seat 9: Snookers8 (big blind) folded before Flop


*********** # 230 **************
PokerStars Hand #176128919271: Tournament #1701843149, $18.20+$1.80 USD=
 Hold'em No Limit - Level XXI (1500/3000) - 2017/10/09 22:38:47 ET
Table '1701843149 2' 9-max Seat #8 is the button
Seat 1: Bsgwolfpack4 (49956 in chips)=20
Seat 3: wallstwst (71910 in chips)=20
Seat 4: GUUUULP (49373 in chips)=20
Seat 5: apoch19 (104328 in chips)=20
Seat 6: JJin91 (68152 in chips)=20
Seat 7: thereugo14 (98178 in chips)=20
Seat 8: eggstatic (66602 in chips)=20
Seat 9: Snookers8 (63349 in chips)=20
Bsgwolfpack4: posts the ante 375
wallstwst: posts the ante 375
GUUUULP: posts the ante 375
apoch19: posts the ante 375
JJin91: posts the ante 375
thereugo14: posts the ante 375
eggstatic: posts the ante 375
Snookers8: posts the ante 375
Snookers8: posts small blind 1500
Bsgwolfpack4: posts big blind 3000
*** HOLE CARDS ***
Dealt to JJin91 [9c 3c]
wallstwst: folds=20
GUUUULP: folds=20
apoch19: folds=20
JJin91: folds=20
thereugo14: calls 3000
eggstatic: folds=20
Snookers8: folds=20
Bsgwolfpack4: checks=20
*** FLOP *** [2d Jc Th]
Bsgwolfpack4: checks=20
thereugo14: bets 3000
Bsgwolfpack4: calls 3000
*** TURN *** [2d Jc Th] [8d]
Bsgwolfpack4: checks=20
thereugo14: checks=20
*** RIVER *** [2d Jc Th 8d] [4h]
Bsgwolfpack4: bets 3000
thereugo14: calls 3000
*** SHOW DOWN ***
Bsgwolfpack4: shows [Qh 8c] (a pair of Eights)
thereugo14: mucks hand=20
Bsgwolfpack4 collected 22500 from pot
*** SUMMARY ***
Total pot 22500 | Rake 0=20
Board [2d Jc Th 8d 4h]
Seat 1: Bsgwolfpack4 (big blind) showed [Qh 8c] and won (22500) with a =
pair of Eights
Seat 3: wallstwst folded before Flop (didn't bet)
Seat 4: GUUUULP folded before Flop (didn't bet)
Seat 5: apoch19 folded before Flop (didn't bet)
Seat 6: JJin91 folded before Flop (didn't bet)
Seat 7: thereugo14 mucked [Kh 6s]
Seat 8: eggstatic (button) folded before Flop (didn't bet)
Seat 9: Snookers8 (small blind) folded before Flop


*********** # 231 **************
PokerStars Hand #176128919453: Tournament #1701843149, $18.20+$1.80 USD=
 Hold'em No Limit - Level XXI (1500/3000) - 2017/10/09 22:39:29 ET
Table '1701843149 2' 9-max Seat #9 is the button
Seat 1: Bsgwolfpack4 (63081 in chips)=20
Seat 3: wallstwst (71535 in chips)=20
Seat 4: GUUUULP (48998 in chips)=20
Seat 5: apoch19 (103953 in chips)=20
Seat 6: JJin91 (67777 in chips)=20
Seat 7: thereugo14 (88803 in chips)=20
Seat 8: eggstatic (66227 in chips)=20
Seat 9: Snookers8 (61474 in chips)=20
Bsgwolfpack4: posts the ante 375
wallstwst: posts the ante 375
GUUUULP: posts the ante 375
apoch19: posts the ante 375
JJin91: posts the ante 375
thereugo14: posts the ante 375
eggstatic: posts the ante 375
Snookers8: posts the ante 375
Bsgwolfpack4: posts small blind 1500
wallstwst: posts big blind 3000
*** HOLE CARDS ***
Dealt to JJin91 [Jh 7h]
GUUUULP: folds=20
apoch19: folds=20
JJin91: folds=20
thereugo14: raises 3000 to 6000
eggstatic: folds=20
Snookers8: folds=20
Bsgwolfpack4: folds=20
wallstwst: calls 3000
*** FLOP *** [Jd 2c 2s]
wallstwst: checks=20
thereugo14: bets 3000
wallstwst: raises 7425 to 10425
thereugo14: folds=20
Uncalled bet (7425) returned to wallstwst
wallstwst collected 22500 from pot
wallstwst: doesn't show hand=20
*** SUMMARY ***
Total pot 22500 | Rake 0=20
Board [Jd 2c 2s]
Seat 1: Bsgwolfpack4 (small blind) folded before Flop
Seat 3: wallstwst (big blind) collected (22500)
Seat 4: GUUUULP folded before Flop (didn't bet)
Seat 5: apoch19 folded before Flop (didn't bet)
Seat 6: JJin91 folded before Flop (didn't bet)
Seat 7: thereugo14 folded on the Flop
Seat 8: eggstatic folded before Flop (didn't bet)
Seat 9: Snookers8 (button) folded before Flop (didn't bet)


*********** # 232 **************
PokerStars Hand #176128919634: Tournament #1701843149, $18.20+$1.80 USD=
 Hold'em No Limit - Level XXI (1500/3000) - 2017/10/09 22:40:11 ET
Table '1701843149 2' 9-max Seat #1 is the button
Seat 1: Bsgwolfpack4 (61206 in chips)=20
Seat 3: wallstwst (84660 in chips)=20
Seat 4: GUUUULP (48623 in chips)=20
Seat 5: apoch19 (103578 in chips)=20
Seat 6: JJin91 (67402 in chips)=20
Seat 7: thereugo14 (79428 in chips)=20
Seat 8: eggstatic (65852 in chips)=20
Seat 9: Snookers8 (61099 in chips)=20
Bsgwolfpack4: posts the ante 375
wallstwst: posts the ante 375
GUUUULP: posts the ante 375
apoch19: posts the ante 375
JJin91: posts the ante 375
thereugo14: posts the ante 375
eggstatic: posts the ante 375
Snookers8: posts the ante 375
wallstwst: posts small blind 1500
GUUUULP: posts big blind 3000
*** HOLE CARDS ***
Dealt to JJin91 [6s Qd]
apoch19: folds=20
JJin91: folds=20
thereugo14: calls 3000
eggstatic: folds=20
Snookers8: folds=20
Bsgwolfpack4: calls 3000
wallstwst: calls 1500
GUUUULP: checks=20
*** FLOP *** [Qh 6h Td]
wallstwst: checks=20
GUUUULP: checks=20
thereugo14: checks=20
Bsgwolfpack4: bets 10400
wallstwst: calls 10400
GUUUULP: folds=20
thereugo14: folds=20
*** TURN *** [Qh 6h Td] [4c]
wallstwst: checks=20
Bsgwolfpack4: bets 19990
wallstwst: folds=20
Uncalled bet (19990) returned to Bsgwolfpack4
Bsgwolfpack4 collected 35800 from pot
*** SUMMARY ***
Total pot 35800 | Rake 0=20
Board [Qh 6h Td 4c]
Seat 1: Bsgwolfpack4 (button) collected (35800)
Seat 3: wallstwst (small blind) folded on the Turn
Seat 4: GUUUULP (big blind) folded on the Flop
Seat 5: apoch19 folded before Flop (didn't bet)
Seat 6: JJin91 folded before Flop (didn't bet)
Seat 7: thereugo14 folded on the Flop
Seat 8: eggstatic folded before Flop (didn't bet)
Seat 9: Snookers8 folded before Flop (didn't bet)


*********** # 233 **************
PokerStars Hand #176128919952: Tournament #1701843149, $18.20+$1.80 USD=
 Hold'em No Limit - Level XXI (1500/3000) - 2017/10/09 22:41:30 ET
Table '1701843149 2' 9-max Seat #3 is the button
Seat 1: Bsgwolfpack4 (83231 in chips)=20
Seat 3: wallstwst (70885 in chips)=20
Seat 4: GUUUULP (45248 in chips)=20
Seat 5: apoch19 (103203 in chips)=20
Seat 6: JJin91 (67027 in chips)=20
Seat 7: thereugo14 (76053 in chips)=20
Seat 8: eggstatic (65477 in chips)=20
Seat 9: Snookers8 (60724 in chips)=20
Bsgwolfpack4: posts the ante 375
wallstwst: posts the ante 375
GUUUULP: posts the ante 375
apoch19: posts the ante 375
JJin91: posts the ante 375
thereugo14: posts the ante 375
eggstatic: posts the ante 375
Snookers8: posts the ante 375
GUUUULP: posts small blind 1500
apoch19: posts big blind 3000
*** HOLE CARDS ***
Dealt to JJin91 [Qh 7s]
JJin91: folds=20
thereugo14: raises 3000 to 6000
eggstatic: folds=20
Snookers8: folds=20
Bsgwolfpack4: folds=20
wallstwst: folds=20
GUUUULP: calls 4500
apoch19: calls 3000
*** FLOP *** [5d 8h 7c]
GUUUULP: checks=20
apoch19: checks=20
thereugo14: bets 3000
GUUUULP: folds=20
apoch19: calls 3000
*** TURN *** [5d 8h 7c] [Ts]
apoch19: checks=20
thereugo14: bets 3000
apoch19: calls 3000
*** RIVER *** [5d 8h 7c Ts] [4h]
apoch19: bets 14200
thereugo14: calls 14200
*** SHOW DOWN ***
apoch19: shows [As 6c] (a straight, Four to Eight)
thereugo14: shows [9d Jh] (a straight, Seven to Jack)
thereugo14 collected 61400 from pot
*** SUMMARY ***
Total pot 61400 | Rake 0=20
Board [5d 8h 7c Ts 4h]
Seat 1: Bsgwolfpack4 folded before Flop (didn't bet)
Seat 3: wallstwst (button) folded before Flop (didn't bet)
Seat 4: GUUUULP (small blind) folded on the Flop
Seat 5: apoch19 (big blind) showed [As 6c] and lost with a straight, Fo=
ur to Eight
Seat 6: JJin91 folded before Flop (didn't bet)
Seat 7: thereugo14 showed [9d Jh] and won (61400) with a straight, Seve=
n to Jack
Seat 8: eggstatic folded before Flop (didn't bet)
Seat 9: Snookers8 folded before Flop (didn't bet)


*********** # 234 **************
PokerStars Hand #176129251251: Tournament #1701843149, $18.20+$1.80 USD=
 Hold'em No Limit - Level XXI (1500/3000) - 2017/10/09 22:42:21 ET
Table '1701843149 2' 9-max Seat #4 is the button
Seat 1: Bsgwolfpack4 (82856 in chips)=20
Seat 3: wallstwst (70510 in chips)=20
Seat 4: GUUUULP (38873 in chips)=20
Seat 5: apoch19 (76628 in chips)=20
Seat 6: JJin91 (66652 in chips)=20
Seat 7: thereugo14 (110878 in chips)=20
Seat 8: eggstatic (65102 in chips)=20
Seat 9: Snookers8 (60349 in chips)=20
Bsgwolfpack4: posts the ante 375
wallstwst: posts the ante 375
GUUUULP: posts the ante 375
apoch19: posts the ante 375
JJin91: posts the ante 375
thereugo14: posts the ante 375
eggstatic: posts the ante 375
Snookers8: posts the ante 375
apoch19: posts small blind 1500
JJin91: posts big blind 3000
*** HOLE CARDS ***
Dealt to JJin91 [2d 5h]
thereugo14: calls 3000
eggstatic: calls 3000
Snookers8: folds=20
Bsgwolfpack4: folds=20
wallstwst: calls 3000
GUUUULP: folds=20
apoch19: calls 1500
JJin91: checks=20
*** FLOP *** [Td Qs 3d]
apoch19: checks=20
JJin91: checks=20
thereugo14: checks=20
eggstatic: checks=20
wallstwst: checks=20
*** TURN *** [Td Qs 3d] [Qc]
apoch19: checks=20
JJin91: bets 12332
thereugo14: folds=20
eggstatic: folds=20
wallstwst: folds=20
apoch19: folds=20
Uncalled bet (12332) returned to JJin91
JJin91 collected 18000 from pot
JJin91: doesn't show hand=20
*** SUMMARY ***
Total pot 18000 | Rake 0=20
Board [Td Qs 3d Qc]
Seat 1: Bsgwolfpack4 folded before Flop (didn't bet)
Seat 3: wallstwst folded on the Turn
Seat 4: GUUUULP (button) folded before Flop (didn't bet)
Seat 5: apoch19 (small blind) folded on the Turn
Seat 6: JJin91 (big blind) collected (18000)
Seat 7: thereugo14 folded on the Turn
Seat 8: eggstatic folded on the Turn
Seat 9: Snookers8 folded before Flop (didn't bet)


*********** # 235 **************
PokerStars Hand #176129251507: Tournament #1701843149, $18.20+$1.80 USD=
 Hold'em No Limit - Level XXI (1500/3000) - 2017/10/09 22:43:22 ET
Table '1701843149 2' 9-max Seat #5 is the button
Seat 1: Bsgwolfpack4 (82481 in chips)=20
Seat 3: wallstwst (67135 in chips)=20
Seat 4: GUUUULP (38498 in chips)=20
Seat 5: apoch19 (73253 in chips)=20
Seat 6: JJin91 (81277 in chips)=20
Seat 7: thereugo14 (107503 in chips)=20
Seat 8: eggstatic (61727 in chips)=20
Seat 9: Snookers8 (59974 in chips)=20
Bsgwolfpack4: posts the ante 375
wallstwst: posts the ante 375
GUUUULP: posts the ante 375
apoch19: posts the ante 375
JJin91: posts the ante 375
thereugo14: posts the ante 375
eggstatic: posts the ante 375
Snookers8: posts the ante 375
JJin91: posts small blind 1500
thereugo14: posts big blind 3000
*** HOLE CARDS ***
Dealt to JJin91 [5c 5s]
eggstatic: folds=20
Snookers8: folds=20
Bsgwolfpack4: folds=20
wallstwst: folds=20
GUUUULP: raises 35123 to 38123 and is all-in
apoch19: folds=20
JJin91: folds=20
thereugo14: folds=20
Uncalled bet (35123) returned to GUUUULP
GUUUULP collected 10500 from pot
*** SUMMARY ***
Total pot 10500 | Rake 0=20
Seat 1: Bsgwolfpack4 folded before Flop (didn't bet)
Seat 3: wallstwst folded before Flop (didn't bet)
Seat 4: GUUUULP collected (10500)
Seat 5: apoch19 (button) folded before Flop (didn't bet)
Seat 6: JJin91 (small blind) folded before Flop
Seat 7: thereugo14 (big blind) folded before Flop
Seat 8: eggstatic folded before Flop (didn't bet)
Seat 9: Snookers8 folded before Flop (didn't bet)


*********** # 236 **************
PokerStars Hand #176129251592: Tournament #1701843149, $18.20+$1.80 USD=
 Hold'em No Limit - Level XXI (1500/3000) - 2017/10/09 22:43:44 ET
Table '1701843149 2' 9-max Seat #6 is the button
Seat 1: Bsgwolfpack4 (82106 in chips)=20
Seat 3: wallstwst (66760 in chips)=20
Seat 4: GUUUULP (45623 in chips)=20
Seat 5: apoch19 (72878 in chips)=20
Seat 6: JJin91 (79402 in chips)=20
Seat 7: thereugo14 (104128 in chips)=20
Seat 8: eggstatic (61352 in chips)=20
Seat 9: Snookers8 (59599 in chips)=20
Bsgwolfpack4: posts the ante 375
wallstwst: posts the ante 375
GUUUULP: posts the ante 375
apoch19: posts the ante 375
JJin91: posts the ante 375
thereugo14: posts the ante 375
eggstatic: posts the ante 375
Snookers8: posts the ante 375
thereugo14: posts small blind 1500
eggstatic: posts big blind 3000
*** HOLE CARDS ***
Dealt to JJin91 [8d 6h]
Snookers8: folds=20
Bsgwolfpack4: folds=20
wallstwst: folds=20
GUUUULP: folds=20
apoch19: raises 3880 to 6880
JJin91: folds=20
thereugo14: calls 5380
eggstatic: folds=20
*** FLOP *** [Kc 4c 6d]
thereugo14: bets 3000
apoch19: calls 3000
*** TURN *** [Kc 4c 6d] [7s]
thereugo14: bets 3000
apoch19: calls 3000
*** RIVER *** [Kc 4c 6d 7s] [Kd]
thereugo14: bets 3000
apoch19: calls 3000
*** SHOW DOWN ***
thereugo14: shows [3h 4d] (two pair, Kings and Fours)
apoch19: shows [Ad 7c] (two pair, Kings and Sevens)
apoch19 collected 37760 from pot
*** SUMMARY ***
Total pot 37760 | Rake 0=20
Board [Kc 4c 6d 7s Kd]
Seat 1: Bsgwolfpack4 folded before Flop (didn't bet)
Seat 3: wallstwst folded before Flop (didn't bet)
Seat 4: GUUUULP folded before Flop (didn't bet)
Seat 5: apoch19 showed [Ad 7c] and won (37760) with two pair, Kings and=
 Sevens
Seat 6: JJin91 (button) folded before Flop (didn't bet)
Seat 7: thereugo14 (small blind) showed [3h 4d] and lost with two pair,=
 Kings and Fours
Seat 8: eggstatic (big blind) folded before Flop
Seat 9: Snookers8 folded before Flop (didn't bet)


*********** # 237 **************
PokerStars Hand #176129251777: Tournament #1701843149, $18.20+$1.80 USD=
 Hold'em No Limit - Level XXI (1500/3000) - 2017/10/09 22:44:33 ET
Table '1701843149 2' 9-max Seat #7 is the button
Seat 1: Bsgwolfpack4 (81731 in chips)=20
Seat 3: wallstwst (66385 in chips)=20
Seat 4: GUUUULP (45248 in chips)=20
Seat 5: apoch19 (94383 in chips)=20
Seat 6: JJin91 (79027 in chips)=20
Seat 7: thereugo14 (87873 in chips)=20
Seat 8: eggstatic (57977 in chips)=20
Seat 9: Snookers8 (59224 in chips)=20
Bsgwolfpack4: posts the ante 375
wallstwst: posts the ante 375
GUUUULP: posts the ante 375
apoch19: posts the ante 375
JJin91: posts the ante 375
thereugo14: posts the ante 375
eggstatic: posts the ante 375
Snookers8: posts the ante 375
eggstatic: posts small blind 1500
Snookers8: posts big blind 3000
*** HOLE CARDS ***
Dealt to JJin91 [Qc 9h]
Bsgwolfpack4: folds=20
wallstwst: folds=20
GUUUULP: raises 41873 to 44873 and is all-in
apoch19: folds=20
JJin91: folds=20
thereugo14: folds=20
eggstatic: folds=20
Snookers8: folds=20
Uncalled bet (41873) returned to GUUUULP
GUUUULP collected 10500 from pot
*** SUMMARY ***
Total pot 10500 | Rake 0=20
Seat 1: Bsgwolfpack4 folded before Flop (didn't bet)
Seat 3: wallstwst folded before Flop (didn't bet)
Seat 4: GUUUULP collected (10500)
Seat 5: apoch19 folded before Flop (didn't bet)
Seat 6: JJin91 folded before Flop (didn't bet)
Seat 7: thereugo14 (button) folded before Flop (didn't bet)
Seat 8: eggstatic (small blind) folded before Flop
Seat 9: Snookers8 (big blind) folded before Flop


*********** # 238 **************
PokerStars Hand #176129251845: Tournament #1701843149, $18.20+$1.80 USD=
 Hold'em No Limit - Level XXI (1500/3000) - 2017/10/09 22:44:50 ET
Table '1701843149 2' 9-max Seat #8 is the button
Seat 1: Bsgwolfpack4 (81356 in chips)=20
Seat 3: wallstwst (66010 in chips)=20
Seat 4: GUUUULP (52373 in chips)=20
Seat 5: apoch19 (94008 in chips)=20
Seat 6: JJin91 (78652 in chips)=20
Seat 7: thereugo14 (87498 in chips)=20
Seat 8: eggstatic (56102 in chips)=20
Seat 9: Snookers8 (55849 in chips)=20
Bsgwolfpack4: posts the ante 375
wallstwst: posts the ante 375
GUUUULP: posts the ante 375
apoch19: posts the ante 375
JJin91: posts the ante 375
thereugo14: posts the ante 375
eggstatic: posts the ante 375
Snookers8: posts the ante 375
Snookers8: posts small blind 1500
Bsgwolfpack4: posts big blind 3000
*** HOLE CARDS ***
Dealt to JJin91 [8d 9s]
wallstwst: folds=20
GUUUULP: folds=20
apoch19: folds=20
JJin91: raises 3510 to 6510
thereugo14: calls 6510
eggstatic: folds=20
Snookers8: folds=20
Bsgwolfpack4: folds=20
*** FLOP *** [8s 4c 7d]
JJin91: bets 8888
thereugo14: folds=20
Uncalled bet (8888) returned to JJin91
JJin91 collected 20520 from pot
JJin91: doesn't show hand=20
*** SUMMARY ***
Total pot 20520 | Rake 0=20
Board [8s 4c 7d]
Seat 1: Bsgwolfpack4 (big blind) folded before Flop
Seat 3: wallstwst folded before Flop (didn't bet)
Seat 4: GUUUULP folded before Flop (didn't bet)
Seat 5: apoch19 folded before Flop (didn't bet)
Seat 6: JJin91 collected (20520)
Seat 7: thereugo14 folded on the Flop
Seat 8: eggstatic (button) folded before Flop (didn't bet)
Seat 9: Snookers8 (small blind) folded before Flop


*********** # 239 **************
PokerStars Hand #176129251971: Tournament #1701843149, $18.20+$1.80 USD=
 Hold'em No Limit - Level XXI (1500/3000) - 2017/10/09 22:45:24 ET
Table '1701843149 2' 9-max Seat #9 is the button
Seat 1: Bsgwolfpack4 (77981 in chips)=20
Seat 3: wallstwst (65635 in chips)=20
Seat 4: GUUUULP (51998 in chips)=20
Seat 5: apoch19 (93633 in chips)=20
Seat 6: JJin91 (92287 in chips)=20
Seat 7: thereugo14 (80613 in chips)=20
Seat 8: eggstatic (55727 in chips)=20
Seat 9: Snookers8 (53974 in chips)=20
Bsgwolfpack4: posts the ante 375
wallstwst: posts the ante 375
GUUUULP: posts the ante 375
apoch19: posts the ante 375
JJin91: posts the ante 375
thereugo14: posts the ante 375
eggstatic: posts the ante 375
Snookers8: posts the ante 375
Bsgwolfpack4: posts small blind 1500
wallstwst: posts big blind 3000
*** HOLE CARDS ***
Dealt to JJin91 [2s Qh]
GUUUULP: folds=20
apoch19: raises 3880 to 6880
JJin91: folds=20
thereugo14: folds=20
eggstatic: folds=20
Snookers8: folds=20
Bsgwolfpack4: folds=20
wallstwst: folds=20
Uncalled bet (3880) returned to apoch19
apoch19 collected 10500 from pot
apoch19: doesn't show hand=20
*** SUMMARY ***
Total pot 10500 | Rake 0=20
Seat 1: Bsgwolfpack4 (small blind) folded before Flop
Seat 3: wallstwst (big blind) folded before Flop
Seat 4: GUUUULP folded before Flop (didn't bet)
Seat 5: apoch19 collected (10500)
Seat 6: JJin91 folded before Flop (didn't bet)
Seat 7: thereugo14 folded before Flop (didn't bet)
Seat 8: eggstatic folded before Flop (didn't bet)
Seat 9: Snookers8 (button) folded before Flop (didn't bet)


*********** # 240 **************
PokerStars Hand #176129252033: Tournament #1701843149, $18.20+$1.80 USD=
 Hold'em No Limit - Level XXI (1500/3000) - 2017/10/09 22:45:39 ET
Table '1701843149 2' 9-max Seat #1 is the button
Seat 1: Bsgwolfpack4 (76106 in chips)=20
Seat 3: wallstwst (62260 in chips)=20
Seat 4: GUUUULP (51623 in chips)=20
Seat 5: apoch19 (100758 in chips)=20
Seat 6: JJin91 (91912 in chips)=20
Seat 7: thereugo14 (80238 in chips)=20
Seat 8: eggstatic (55352 in chips)=20
Seat 9: Snookers8 (53599 in chips)=20
Bsgwolfpack4: posts the ante 375
wallstwst: posts the ante 375
GUUUULP: posts the ante 375
apoch19: posts the ante 375
JJin91: posts the ante 375
thereugo14: posts the ante 375
eggstatic: posts the ante 375
Snookers8: posts the ante 375
wallstwst: posts small blind 1500
GUUUULP: posts big blind 3000
*** HOLE CARDS ***
Dealt to JJin91 [4d 6h]
apoch19: raises 3880 to 6880
JJin91: folds=20
thereugo14: folds=20
eggstatic: folds=20
Snookers8: folds=20
Bsgwolfpack4: folds=20
wallstwst: folds=20
GUUUULP: folds=20
Uncalled bet (3880) returned to apoch19
apoch19 collected 10500 from pot
apoch19: doesn't show hand=20
*** SUMMARY ***
Total pot 10500 | Rake 0=20
Seat 1: Bsgwolfpack4 (button) folded before Flop (didn't bet)
Seat 3: wallstwst (small blind) folded before Flop
Seat 4: GUUUULP (big blind) folded before Flop
Seat 5: apoch19 collected (10500)
Seat 6: JJin91 folded before Flop (didn't bet)
Seat 7: thereugo14 folded before Flop (didn't bet)
Seat 8: eggstatic folded before Flop (didn't bet)
Seat 9: Snookers8 folded before Flop (didn't bet)


*********** # 241 **************
PokerStars Hand #176129252141: Tournament #1701843149, $18.20+$1.80 USD=
 Hold'em No Limit - Level XXI (1500/3000) - 2017/10/09 22:46:03 ET
Table '1701843149 2' 9-max Seat #3 is the button
Seat 1: Bsgwolfpack4 (75731 in chips)=20
Seat 3: wallstwst (60385 in chips)=20
Seat 4: GUUUULP (48248 in chips)=20
Seat 5: apoch19 (107883 in chips)=20
Seat 6: JJin91 (91537 in chips)=20
Seat 7: thereugo14 (79863 in chips)=20
Seat 8: eggstatic (54977 in chips)=20
Seat 9: Snookers8 (53224 in chips)=20
Bsgwolfpack4: posts the ante 375
wallstwst: posts the ante 375
GUUUULP: posts the ante 375
apoch19: posts the ante 375
JJin91: posts the ante 375
thereugo14: posts the ante 375
eggstatic: posts the ante 375
Snookers8: posts the ante 375
GUUUULP: posts small blind 1500
apoch19: posts big blind 3000
*** HOLE CARDS ***
Dealt to JJin91 [5h 5c]
JJin91: raises 3510 to 6510
thereugo14: calls 6510
eggstatic: folds=20
Snookers8: folds=20
Bsgwolfpack4: folds=20
wallstwst: folds=20
GUUUULP: folds=20
apoch19: folds=20
*** FLOP *** [9c 8d 7s]
JJin91: checks=20
thereugo14: bets 3000
JJin91: calls 3000
*** TURN *** [9c 8d 7s] [Kh]
JJin91: bets 11111
thereugo14: calls 11111
*** RIVER *** [9c 8d 7s Kh] [Qh]
JJin91: checks=20
thereugo14: checks=20
*** SHOW DOWN ***
JJin91: shows [5h 5c] (a pair of Fives)
thereugo14: shows [Qd Tc] (a pair of Queens)
thereugo14 collected 48742 from pot
*** SUMMARY ***
Total pot 48742 | Rake 0=20
Board [9c 8d 7s Kh Qh]
Seat 1: Bsgwolfpack4 folded before Flop (didn't bet)
Seat 3: wallstwst (button) folded before Flop (didn't bet)
Seat 4: GUUUULP (small blind) folded before Flop
Seat 5: apoch19 (big blind) folded before Flop
Seat 6: JJin91 showed [5h 5c] and lost with a pair of Fives
Seat 7: thereugo14 showed [Qd Tc] and won (48742) with a pair of Queens
Seat 8: eggstatic folded before Flop (didn't bet)
Seat 9: Snookers8 folded before Flop (didn't bet)


*********** # 242 **************
PokerStars Hand #176129252393: Tournament #1701843149, $18.20+$1.80 USD=
 Hold'em No Limit - Level XXI (1500/3000) - 2017/10/09 22:47:06 ET
Table '1701843149 2' 9-max Seat #4 is the button
Seat 1: Bsgwolfpack4 (75356 in chips)=20
Seat 3: wallstwst (60010 in chips)=20
Seat 4: GUUUULP (46373 in chips)=20
Seat 5: apoch19 (104508 in chips)=20
Seat 6: JJin91 (70541 in chips)=20
Seat 7: thereugo14 (107609 in chips)=20
Seat 8: eggstatic (54602 in chips)=20
Seat 9: Snookers8 (52849 in chips)=20
Bsgwolfpack4: posts the ante 375
wallstwst: posts the ante 375
GUUUULP: posts the ante 375
apoch19: posts the ante 375
JJin91: posts the ante 375
thereugo14: posts the ante 375
eggstatic: posts the ante 375
Snookers8: posts the ante 375
apoch19: posts small blind 1500
JJin91: posts big blind 3000
*** HOLE CARDS ***
Dealt to JJin91 [2d Ad]
thereugo14: folds=20
eggstatic: folds=20
Snookers8: folds=20
Bsgwolfpack4: raises 6125 to 9125
wallstwst: folds=20
GUUUULP: folds=20
apoch19: folds=20
JJin91: calls 6125
*** FLOP *** [4c 7s 5c]
JJin91: checks=20
Bsgwolfpack4: bets 13950
JJin91: folds=20
Uncalled bet (13950) returned to Bsgwolfpack4
Bsgwolfpack4 collected 22750 from pot
*** SUMMARY ***
Total pot 22750 | Rake 0=20
Board [4c 7s 5c]
Seat 1: Bsgwolfpack4 collected (22750)
Seat 3: wallstwst folded before Flop (didn't bet)
Seat 4: GUUUULP (button) folded before Flop (didn't bet)
Seat 5: apoch19 (small blind) folded before Flop
Seat 6: JJin91 (big blind) folded on the Flop
Seat 7: thereugo14 folded before Flop (didn't bet)
Seat 8: eggstatic folded before Flop (didn't bet)
Seat 9: Snookers8 folded before Flop (didn't bet)


*********** # 243 **************
PokerStars Hand #176129252601: Tournament #1701843149, $18.20+$1.80 USD=
 Hold'em No Limit - Level XXII (2000/4000) - 2017/10/09 22:47:53 ET
Table '1701843149 2' 9-max Seat #5 is the button
Seat 1: Bsgwolfpack4 (88606 in chips)=20
Seat 3: wallstwst (59635 in chips)=20
Seat 4: GUUUULP (45998 in chips)=20
Seat 5: apoch19 (102633 in chips)=20
Seat 6: JJin91 (61041 in chips)=20
Seat 7: thereugo14 (107234 in chips)=20
Seat 8: eggstatic (54227 in chips)=20
Seat 9: Snookers8 (52474 in chips)=20
Bsgwolfpack4: posts the ante 500
wallstwst: posts the ante 500
GUUUULP: posts the ante 500
apoch19: posts the ante 500
JJin91: posts the ante 500
thereugo14: posts the ante 500
eggstatic: posts the ante 500
Snookers8: posts the ante 500
JJin91: posts small blind 2000
thereugo14: posts big blind 4000
*** HOLE CARDS ***
Dealt to JJin91 [6c 7h]
eggstatic: folds=20
Snookers8: raises 47974 to 51974 and is all-in
Bsgwolfpack4: folds=20
wallstwst: folds=20
GUUUULP: folds=20
apoch19: folds=20
JJin91: folds=20
thereugo14: folds=20
Uncalled bet (47974) returned to Snookers8
Snookers8 collected 14000 from pot
Snookers8: doesn't show hand=20
*** SUMMARY ***
Total pot 14000 | Rake 0=20
Seat 1: Bsgwolfpack4 folded before Flop (didn't bet)
Seat 3: wallstwst folded before Flop (didn't bet)
Seat 4: GUUUULP folded before Flop (didn't bet)
Seat 5: apoch19 (button) folded before Flop (didn't bet)
Seat 6: JJin91 (small blind) folded before Flop
Seat 7: thereugo14 (big blind) folded before Flop
Seat 8: eggstatic folded before Flop (didn't bet)
Seat 9: Snookers8 collected (14000)


*********** # 244 **************
PokerStars Hand #176129252724: Tournament #1701843149, $18.20+$1.80 USD=
 Hold'em No Limit - Level XXII (2000/4000) - 2017/10/09 22:48:21 ET
Table '1701843149 2' 9-max Seat #6 is the button
Seat 1: Bsgwolfpack4 (88106 in chips)=20
Seat 3: wallstwst (59135 in chips)=20
Seat 4: GUUUULP (45498 in chips)=20
Seat 5: apoch19 (102133 in chips)=20
Seat 6: JJin91 (58541 in chips)=20
Seat 7: thereugo14 (102734 in chips)=20
Seat 9: Snookers8 (61974 in chips)=20
Bsgwolfpack4: posts the ante 500
wallstwst: posts the ante 500
GUUUULP: posts the ante 500
apoch19: posts the ante 500
JJin91: posts the ante 500
thereugo14: posts the ante 500
Snookers8: posts the ante 500
thereugo14: posts small blind 2000
Snookers8: posts big blind 4000
*** HOLE CARDS ***
Dealt to JJin91 [7h 7d]
Bsgwolfpack4: folds=20
wallstwst: folds=20
GUUUULP: folds=20
apoch19: raises 5500 to 9500
JJin91: raises 48541 to 58041 and is all-in
thereugo14: folds=20
Snookers8: folds=20
apoch19: folds=20
Uncalled bet (48541) returned to JJin91
JJin91 collected 28500 from pot
JJin91: doesn't show hand=20
*** SUMMARY ***
Total pot 28500 | Rake 0=20
Seat 1: Bsgwolfpack4 folded before Flop (didn't bet)
Seat 3: wallstwst folded before Flop (didn't bet)
Seat 4: GUUUULP folded before Flop (didn't bet)
Seat 5: apoch19 folded before Flop
Seat 6: JJin91 (button) collected (28500)
Seat 7: thereugo14 (small blind) folded before Flop
Seat 9: Snookers8 (big blind) folded before Flop


*********** # 245 **************
PokerStars Hand #176129252923: Tournament #1701843149, $18.20+$1.80 USD=
 Hold'em No Limit - Level XXII (2000/4000) - 2017/10/09 22:49:10 ET
Table '1701843149 2' 9-max Seat #7 is the button
Seat 1: Bsgwolfpack4 (87606 in chips)=20
Seat 3: wallstwst (58635 in chips)=20
Seat 4: GUUUULP (44998 in chips)=20
Seat 5: apoch19 (92133 in chips)=20
Seat 6: JJin91 (77041 in chips)=20
Seat 7: thereugo14 (100234 in chips)=20
Seat 9: Snookers8 (57474 in chips)=20
Bsgwolfpack4: posts the ante 500
wallstwst: posts the ante 500
GUUUULP: posts the ante 500
apoch19: posts the ante 500
JJin91: posts the ante 500
thereugo14: posts the ante 500
Snookers8: posts the ante 500
Snookers8: posts small blind 2000
Bsgwolfpack4: posts big blind 4000
*** HOLE CARDS ***
Dealt to JJin91 [6c 9c]
wallstwst: folds=20
GUUUULP: folds=20
apoch19: folds=20
JJin91: folds=20
thereugo14: calls 4000
Snookers8: raises 52974 to 56974 and is all-in
Bsgwolfpack4: folds=20
thereugo14: folds=20
Uncalled bet (52974) returned to Snookers8
Snookers8 collected 15500 from pot
Snookers8: doesn't show hand=20
*** SUMMARY ***
Total pot 15500 | Rake 0=20
Seat 1: Bsgwolfpack4 (big blind) folded before Flop
Seat 3: wallstwst folded before Flop (didn't bet)
Seat 4: GUUUULP folded before Flop (didn't bet)
Seat 5: apoch19 folded before Flop (didn't bet)
Seat 6: JJin91 folded before Flop (didn't bet)
Seat 7: thereugo14 (button) folded before Flop
Seat 9: Snookers8 (small blind) collected (15500)


*********** # 246 **************
PokerStars Hand #176129253021: Tournament #1701843149, $18.20+$1.80 USD=
 Hold'em No Limit - Level XXII (2000/4000) - 2017/10/09 22:49:35 ET
Table '1701843149 2' 9-max Seat #9 is the button
Seat 1: Bsgwolfpack4 (83106 in chips)=20
Seat 3: wallstwst (58135 in chips)=20
Seat 4: GUUUULP (44498 in chips)=20
Seat 5: apoch19 (91633 in chips)=20
Seat 6: JJin91 (76541 in chips)=20
Seat 7: thereugo14 (95734 in chips)=20
Seat 9: Snookers8 (68474 in chips)=20
Bsgwolfpack4: posts the ante 500
wallstwst: posts the ante 500
GUUUULP: posts the ante 500
apoch19: posts the ante 500
JJin91: posts the ante 500
thereugo14: posts the ante 500
Snookers8: posts the ante 500
Bsgwolfpack4: posts small blind 2000
wallstwst: posts big blind 4000
*** HOLE CARDS ***
Dealt to JJin91 [3d Jh]
GUUUULP: folds=20
apoch19: folds=20
JJin91: folds=20
thereugo14: folds=20
Snookers8: folds=20
Bsgwolfpack4: folds=20
Uncalled bet (2000) returned to wallstwst
wallstwst collected 7500 from pot
wallstwst: doesn't show hand=20
*** SUMMARY ***
Total pot 7500 | Rake 0=20
Seat 1: Bsgwolfpack4 (small blind) folded before Flop
Seat 3: wallstwst (big blind) collected (7500)
Seat 4: GUUUULP folded before Flop (didn't bet)
Seat 5: apoch19 folded before Flop (didn't bet)
Seat 6: JJin91 folded before Flop (didn't bet)
Seat 7: thereugo14 folded before Flop (didn't bet)
Seat 9: Snookers8 (button) folded before Flop (didn't bet)


*********** # 247 **************
PokerStars Hand #176129253053: Tournament #1701843149, $18.20+$1.80 USD=
 Hold'em No Limit - Level XXII (2000/4000) - 2017/10/09 22:49:45 ET
Table '1701843149 2' 9-max Seat #1 is the button
Seat 1: Bsgwolfpack4 (80606 in chips)=20
Seat 3: wallstwst (63135 in chips)=20
Seat 4: GUUUULP (43998 in chips)=20
Seat 5: apoch19 (91133 in chips)=20
Seat 6: JJin91 (76041 in chips)=20
Seat 7: thereugo14 (95234 in chips)=20
Seat 9: Snookers8 (67974 in chips)=20
Bsgwolfpack4: posts the ante 500
wallstwst: posts the ante 500
GUUUULP: posts the ante 500
apoch19: posts the ante 500
JJin91: posts the ante 500
thereugo14: posts the ante 500
Snookers8: posts the ante 500
wallstwst: posts small blind 2000
GUUUULP: posts big blind 4000
*** HOLE CARDS ***
Dealt to JJin91 [Td As]
apoch19: folds=20
JJin91: raises 4680 to 8680
thereugo14: folds=20
Snookers8: folds=20
Bsgwolfpack4: folds=20
wallstwst: folds=20
GUUUULP: folds=20
Uncalled bet (4680) returned to JJin91
JJin91 collected 13500 from pot
JJin91: doesn't show hand=20
*** SUMMARY ***
Total pot 13500 | Rake 0=20
Seat 1: Bsgwolfpack4 (button) folded before Flop (didn't bet)
Seat 3: wallstwst (small blind) folded before Flop
Seat 4: GUUUULP (big blind) folded before Flop
Seat 5: apoch19 folded before Flop (didn't bet)
Seat 6: JJin91 collected (13500)
Seat 7: thereugo14 folded before Flop (didn't bet)
Seat 9: Snookers8 folded before Flop (didn't bet)


*********** # 248 **************
PokerStars Hand #176129253185: Tournament #1701843149, $18.20+$1.80 USD=
 Hold'em No Limit - Level XXII (2000/4000) - 2017/10/09 22:50:19 ET
Table '1701843149 2' 9-max Seat #3 is the button
Seat 1: Bsgwolfpack4 (80106 in chips)=20
Seat 3: wallstwst (60635 in chips)=20
Seat 4: GUUUULP (39498 in chips)=20
Seat 5: apoch19 (90633 in chips)=20
Seat 6: JJin91 (85041 in chips)=20
Seat 7: thereugo14 (94734 in chips)=20
Seat 9: Snookers8 (67474 in chips)=20
Bsgwolfpack4: posts the ante 500
wallstwst: posts the ante 500
GUUUULP: posts the ante 500
apoch19: posts the ante 500
JJin91: posts the ante 500
thereugo14: posts the ante 500
Snookers8: posts the ante 500
GUUUULP: posts small blind 2000
apoch19: posts big blind 4000
*** HOLE CARDS ***
Dealt to JJin91 [3d Tc]
JJin91: folds=20
thereugo14: folds=20
Snookers8: folds=20
Bsgwolfpack4: folds=20
wallstwst: folds=20
GUUUULP: raises 34998 to 38998 and is all-in
apoch19: calls 34998
*** FLOP *** [8c 5c 7d]
*** TURN *** [8c 5c 7d] [Ac]
*** RIVER *** [8c 5c 7d Ac] [Qc]
*** SHOW DOWN ***
GUUUULP: shows [9h Qs] (a pair of Queens)
apoch19: shows [Jh Kd] (high card Ace)
GUUUULP collected 81496 from pot
*** SUMMARY ***
Total pot 81496 | Rake 0=20
Board [8c 5c 7d Ac Qc]
Seat 1: Bsgwolfpack4 folded before Flop (didn't bet)
Seat 3: wallstwst (button) folded before Flop (didn't bet)
Seat 4: GUUUULP (small blind) showed [9h Qs] and won (81496) with a pai=
r of Queens
Seat 5: apoch19 (big blind) showed [Jh Kd] and lost with high card Ace
Seat 6: JJin91 folded before Flop (didn't bet)
Seat 7: thereugo14 folded before Flop (didn't bet)
Seat 9: Snookers8 folded before Flop (didn't bet)


*********** # 249 **************
PokerStars Hand #176129253272: Tournament #1701843149, $18.20+$1.80 USD=
 Hold'em No Limit - Level XXII (2000/4000) - 2017/10/09 22:50:42 ET
Table '1701843149 2' 9-max Seat #4 is the button
Seat 1: Bsgwolfpack4 (79606 in chips)=20
Seat 3: wallstwst (60135 in chips)=20
Seat 4: GUUUULP (81496 in chips)=20
Seat 5: apoch19 (51135 in chips)=20
Seat 6: JJin91 (84541 in chips)=20
Seat 7: thereugo14 (94234 in chips)=20
Seat 9: Snookers8 (66974 in chips)=20
Bsgwolfpack4: posts the ante 500
wallstwst: posts the ante 500
GUUUULP: posts the ante 500
apoch19: posts the ante 500
JJin91: posts the ante 500
thereugo14: posts the ante 500
Snookers8: posts the ante 500
apoch19: posts small blind 2000
JJin91: posts big blind 4000
*** HOLE CARDS ***
Dealt to JJin91 [6s Qs]
thereugo14: calls 4000
Snookers8: folds=20
Bsgwolfpack4: folds=20
wallstwst: calls 4000
GUUUULP: folds=20
apoch19: calls 2000
JJin91: checks=20
*** FLOP *** [2h Jh 7d]
apoch19: checks=20
JJin91: checks=20
thereugo14: bets 4000
wallstwst: calls 4000
apoch19: folds=20
JJin91: folds=20
*** TURN *** [2h Jh 7d] [As]
thereugo14: bets 4000
wallstwst: raises 8000 to 12000
thereugo14: folds=20
Uncalled bet (8000) returned to wallstwst
wallstwst collected 35500 from pot
wallstwst: doesn't show hand=20
*** SUMMARY ***
Total pot 35500 | Rake 0=20
Board [2h Jh 7d As]
Seat 1: Bsgwolfpack4 folded before Flop (didn't bet)
Seat 3: wallstwst collected (35500)
Seat 4: GUUUULP (button) folded before Flop (didn't bet)
Seat 5: apoch19 (small blind) folded on the Flop
Seat 6: JJin91 (big blind) folded on the Flop
Seat 7: thereugo14 folded on the Turn
Seat 9: Snookers8 folded before Flop (didn't bet)


*********** # 250 **************
PokerStars Hand #176129253494: Tournament #1701843149, $18.20+$1.80 USD=
 Hold'em No Limit - Level XXII (2000/4000) - 2017/10/09 22:51:34 ET
Table '1701843149 2' 9-max Seat #5 is the button
Seat 1: Bsgwolfpack4 (79106 in chips)=20
Seat 3: wallstwst (83135 in chips)=20
Seat 4: GUUUULP (80996 in chips)=20
Seat 5: apoch19 (46635 in chips)=20
Seat 6: JJin91 (80041 in chips)=20
Seat 7: thereugo14 (81734 in chips)=20
Seat 9: Snookers8 (66474 in chips)=20
Bsgwolfpack4: posts the ante 500
wallstwst: posts the ante 500
GUUUULP: posts the ante 500
apoch19: posts the ante 500
JJin91: posts the ante 500
thereugo14: posts the ante 500
Snookers8: posts the ante 500
JJin91: posts small blind 2000
thereugo14: posts big blind 4000
*** HOLE CARDS ***
Dealt to JJin91 [Qs 8h]
Snookers8: folds=20
Bsgwolfpack4: folds=20
wallstwst: folds=20
GUUUULP: folds=20
apoch19: raises 42135 to 46135 and is all-in
JJin91: folds=20
thereugo14: calls 42135
*** FLOP *** [2d 3s Kh]
*** TURN *** [2d 3s Kh] [7s]
*** RIVER *** [2d 3s Kh 7s] [7h]
*** SHOW DOWN ***
thereugo14: shows [Ks Kd] (a full house, Kings full of Sevens)
apoch19: shows [As Kc] (two pair, Kings and Sevens)
thereugo14 collected 97770 from pot
apoch19 finished the tournament in 13th place and received $44.21.
*** SUMMARY ***
Total pot 97770 | Rake 0=20
Board [2d 3s Kh 7s 7h]
Seat 1: Bsgwolfpack4 folded before Flop (didn't bet)
Seat 3: wallstwst folded before Flop (didn't bet)
Seat 4: GUUUULP folded before Flop (didn't bet)
Seat 5: apoch19 (button) showed [As Kc] and lost with two pair, Kings a=
nd Sevens
Seat 6: JJin91 (small blind) folded before Flop
Seat 7: thereugo14 (big blind) showed [Ks Kd] and won (97770) with a fu=
ll house, Kings full of Sevens
Seat 9: Snookers8 folded before Flop (didn't bet)


*********** # 251 **************
PokerStars Hand #176129253597: Tournament #1701843149, $18.20+$1.80 USD=
 Hold'em No Limit - Level XXII (2000/4000) - 2017/10/09 22:52:01 ET
Table '1701843149 2' 9-max Seat #6 is the button
Seat 1: Bsgwolfpack4 (78606 in chips)=20
Seat 3: wallstwst (82635 in chips)=20
Seat 4: GUUUULP (80496 in chips)=20
Seat 6: JJin91 (77541 in chips)=20
Seat 7: thereugo14 (132869 in chips)=20
Seat 9: Snookers8 (65974 in chips)=20
Bsgwolfpack4: posts the ante 500
wallstwst: posts the ante 500
GUUUULP: posts the ante 500
JJin91: posts the ante 500
thereugo14: posts the ante 500
Snookers8: posts the ante 500
thereugo14: posts small blind 2000
Snookers8: posts big blind 4000
*** HOLE CARDS ***
Dealt to JJin91 [Jd 3d]
Bsgwolfpack4: folds=20
wallstwst: folds=20
GUUUULP: folds=20
JJin91: folds=20
thereugo14: calls 2000
Snookers8: checks=20
*** FLOP *** [Js As 3c]
thereugo14: bets 4000
Snookers8: calls 4000
*** TURN *** [Js As 3c] [Kh]
thereugo14: bets 4000
Snookers8: folds=20
Uncalled bet (4000) returned to thereugo14
thereugo14 collected 19000 from pot
thereugo14: doesn't show hand=20
*** SUMMARY ***
Total pot 19000 | Rake 0=20
Board [Js As 3c Kh]
Seat 1: Bsgwolfpack4 folded before Flop (didn't bet)
Seat 3: wallstwst folded before Flop (didn't bet)
Seat 4: GUUUULP folded before Flop (didn't bet)
Seat 6: JJin91 (button) folded before Flop (didn't bet)
Seat 7: thereugo14 (small blind) collected (19000)
Seat 9: Snookers8 (big blind) folded on the Turn


*********** # 252 **************
PokerStars Hand #176129253715: Tournament #1701843149, $18.20+$1.80 USD=
 Hold'em No Limit - Level XXII (2000/4000) - 2017/10/09 22:52:28 ET
Table '1701843149 2' 9-max Seat #7 is the button
Seat 1: Bsgwolfpack4 (78106 in chips)=20
Seat 3: wallstwst (82135 in chips)=20
Seat 4: GUUUULP (79996 in chips)=20
Seat 6: JJin91 (77041 in chips)=20
Seat 7: thereugo14 (143369 in chips)=20
Seat 9: Snookers8 (57474 in chips)=20
Bsgwolfpack4: posts the ante 500
wallstwst: posts the ante 500
GUUUULP: posts the ante 500
JJin91: posts the ante 500
thereugo14: posts the ante 500
Snookers8: posts the ante 500
Snookers8: posts small blind 2000
Bsgwolfpack4: posts big blind 4000
*** HOLE CARDS ***
Dealt to JJin91 [4s 5s]
wallstwst: folds=20
GUUUULP: folds=20
JJin91: raises 4680 to 8680
thereugo14: folds=20
Snookers8: raises 48294 to 56974 and is all-in
Bsgwolfpack4: folds=20
JJin91: folds=20
Uncalled bet (48294) returned to Snookers8
Snookers8 collected 24360 from pot
Snookers8: doesn't show hand=20
*** SUMMARY ***
Total pot 24360 | Rake 0=20
Seat 1: Bsgwolfpack4 (big blind) folded before Flop
Seat 3: wallstwst folded before Flop (didn't bet)
Seat 4: GUUUULP folded before Flop (didn't bet)
Seat 6: JJin91 folded before Flop
Seat 7: thereugo14 (button) folded before Flop (didn't bet)
Seat 9: Snookers8 (small blind) collected (24360)


*********** # 253 **************
PokerStars Hand #176129253766: Tournament #1701843149, $18.20+$1.80 USD=
 Hold'em No Limit - Level XXII (2000/4000) - 2017/10/09 22:52:41 ET
Table '1701843149 2' 9-max Seat #9 is the button
Seat 1: Bsgwolfpack4 (73606 in chips)=20
Seat 3: wallstwst (81635 in chips)=20
Seat 4: GUUUULP (79496 in chips)=20
Seat 6: JJin91 (67861 in chips)=20
Seat 7: thereugo14 (142869 in chips)=20
Seat 9: Snookers8 (72654 in chips)=20
Bsgwolfpack4: posts the ante 500
wallstwst: posts the ante 500
GUUUULP: posts the ante 500
JJin91: posts the ante 500
thereugo14: posts the ante 500
Snookers8: posts the ante 500
Bsgwolfpack4: posts small blind 2000
wallstwst: posts big blind 4000
*** HOLE CARDS ***
Dealt to JJin91 [7c Jd]
GUUUULP: raises 4000 to 8000
JJin91: folds=20
thereugo14: folds=20
Snookers8: folds=20
Bsgwolfpack4: folds=20
wallstwst: folds=20
Uncalled bet (4000) returned to GUUUULP
GUUUULP collected 13000 from pot
*** SUMMARY ***
Total pot 13000 | Rake 0=20
Seat 1: Bsgwolfpack4 (small blind) folded before Flop
Seat 3: wallstwst (big blind) folded before Flop
Seat 4: GUUUULP collected (13000)
Seat 6: JJin91 folded before Flop (didn't bet)
Seat 7: thereugo14 folded before Flop (didn't bet)
Seat 9: Snookers8 (button) folded before Flop (didn't bet)


*********** # 254 **************
PokerStars Hand #176129253898: Tournament #1701843149, $18.20+$1.80 USD=
 Hold'em No Limit - Level XXII (2000/4000) - 2017/10/09 22:53:12 ET
Table '1701843149 2' 9-max Seat #1 is the button
Seat 1: Bsgwolfpack4 (71106 in chips)=20
Seat 3: wallstwst (77135 in chips)=20
Seat 4: GUUUULP (87996 in chips)=20
Seat 6: JJin91 (67361 in chips)=20
Seat 7: thereugo14 (142369 in chips)=20
Seat 9: Snookers8 (72154 in chips)=20
Bsgwolfpack4: posts the ante 500
wallstwst: posts the ante 500
GUUUULP: posts the ante 500
JJin91: posts the ante 500
thereugo14: posts the ante 500
Snookers8: posts the ante 500
wallstwst: posts small blind 2000
GUUUULP: posts big blind 4000
*** HOLE CARDS ***
Dealt to JJin91 [5s 4c]
JJin91: folds=20
thereugo14: calls 4000
Snookers8: folds=20
Bsgwolfpack4: folds=20
wallstwst: calls 2000
GUUUULP: checks=20
*** FLOP *** [Jd Ks 2c]
wallstwst: checks=20
GUUUULP: checks=20
thereugo14: bets 4000
wallstwst: raises 7590 to 11590
GUUUULP has timed out
GUUUULP: folds=20
GUUUULP is sitting out
thereugo14: folds=20
Uncalled bet (7590) returned to wallstwst
GUUUULP has returned
wallstwst collected 23000 from pot
wallstwst: doesn't show hand=20
*** SUMMARY ***
Total pot 23000 | Rake 0=20
Board [Jd Ks 2c]
Seat 1: Bsgwolfpack4 (button) folded before Flop (didn't bet)
Seat 3: wallstwst (small blind) collected (23000)
Seat 4: GUUUULP (big blind) folded on the Flop
Seat 6: JJin91 folded before Flop (didn't bet)
Seat 7: thereugo14 folded on the Flop
Seat 9: Snookers8 folded before Flop (didn't bet)


*********** # 255 **************
PokerStars Hand #176129254186: Tournament #1701843149, $18.20+$1.80 USD=
 Hold'em No Limit - Level XXII (2000/4000) - 2017/10/09 22:54:24 ET
Table '1701843149 2' 9-max Seat #3 is the button
Seat 1: Bsgwolfpack4 (70606 in chips)=20
Seat 3: wallstwst (91635 in chips)=20
Seat 4: GUUUULP (83496 in chips)=20
Seat 6: JJin91 (66861 in chips)=20
Seat 7: thereugo14 (133869 in chips)=20
Seat 9: Snookers8 (71654 in chips)=20
Bsgwolfpack4: posts the ante 500
wallstwst: posts the ante 500
GUUUULP: posts the ante 500
JJin91: posts the ante 500
thereugo14: posts the ante 500
Snookers8: posts the ante 500
GUUUULP: posts small blind 2000
JJin91: posts big blind 4000
*** HOLE CARDS ***
Dealt to JJin91 [4h 3d]
thereugo14: calls 4000
Snookers8: folds=20
Bsgwolfpack4: folds=20
wallstwst: folds=20
GUUUULP: calls 2000
JJin91: checks=20
*** FLOP *** [9c 8h Jd]
GUUUULP has timed out
GUUUULP: checks=20
JJin91: bets 8111
thereugo14: calls 8111
GUUUULP: folds=20
*** TURN *** [9c 8h Jd] [7s]
JJin91: checks=20
thereugo14: bets 4000
JJin91: folds=20
Uncalled bet (4000) returned to thereugo14
thereugo14 collected 31222 from pot
thereugo14: doesn't show hand=20
*** SUMMARY ***
Total pot 31222 | Rake 0=20
Board [9c 8h Jd 7s]
Seat 1: Bsgwolfpack4 folded before Flop (didn't bet)
Seat 3: wallstwst (button) folded before Flop (didn't bet)
Seat 4: GUUUULP (small blind) folded on the Flop
Seat 6: JJin91 (big blind) folded on the Turn
Seat 7: thereugo14 collected (31222)
Seat 9: Snookers8 folded before Flop (didn't bet)


*********** # 256 **************
PokerStars Hand #176129255278: Tournament #1701843149, $18.20+$1.80 USD=
 Hold'em No Limit - Level XXII (2000/4000) - 2017/10/09 23:00:54 ET
Table '1701843149 2' 9-max Seat #4 is the button
Seat 1: Bsgwolfpack4 (70106 in chips)=20
Seat 3: wallstwst (91135 in chips)=20
Seat 4: GUUUULP (78996 in chips)=20
Seat 6: JJin91 (54250 in chips)=20
Seat 7: thereugo14 (152480 in chips)=20
Seat 9: Snookers8 (71154 in chips)=20
Bsgwolfpack4: posts the ante 500
wallstwst: posts the ante 500
GUUUULP: posts the ante 500
JJin91: posts the ante 500
thereugo14: posts the ante 500
Snookers8: posts the ante 500
JJin91: posts small blind 2000
thereugo14: posts big blind 4000
*** HOLE CARDS ***
Dealt to JJin91 [3s Qh]
Snookers8: folds=20
Bsgwolfpack4: folds=20
wallstwst: folds=20
GUUUULP has timed out
GUUUULP: folds=20
GUUUULP is sitting out
GUUUULP has returned
JJin91: raises 49750 to 53750 and is all-in
thereugo14: calls 49750
*** FLOP *** [8h Tc Kc]
*** TURN *** [8h Tc Kc] [5h]
*** RIVER *** [8h Tc Kc 5h] [2c]
*** SHOW DOWN ***
JJin91: shows [3s Qh] (high card King)
thereugo14: shows [Ah 9c] (high card Ace)
thereugo14 collected 110500 from pot
JJin91 finished the tournament in 12th place and received $46.27.
*** SUMMARY ***
Total pot 110500 | Rake 0=20
Board [8h Tc Kc 5h 2c]
Seat 1: Bsgwolfpack4 folded before Flop (didn't bet)
Seat 3: wallstwst folded before Flop (didn't bet)
Seat 4: GUUUULP (button) folded before Flop (didn't bet)
Seat 6: JJin91 (small blind) showed [3s Qh] and lost with high card King
Seat 7: thereugo14 (big blind) showed [Ah 9c] and won (110500) with hig=
h card Ace
Seat 9: Snookers8 folded before Flop (didn't bet)



If you have any questions, please contact us at "PokerStars Support" <s=
upport@pokerstarsnj.com>


